time,subj_course_id,sec_code,sec_id,prof,available,waitlist,total,enrolled_ct
1653392014384,COGS 200,A01,087991,Staff,48,0,50,2
1653392014909,COGS 201,A01,094504,Rangel; Lara M,17,0,25,8
1653392015435,COGS 203,A00,087992,Coulson; Seana M,19,0,20,1
1653392015967,COGS 210A,001,087993,Greene; Deanna Jacquelyn,9998,0,9999,1
1653392015967,COGS 210A,002,087994,Saygin; Ayse P,9999,0,9999,0
1653392015967,COGS 210A,003,087995,Xia; Haijun,9999,0,9999,0
1653392015967,COGS 210A,004,087996,Nitz; Douglas A.,9999,0,9999,0
1653392015967,COGS 210A,005,087997,Hollan; James D.,9999,0,9999,0
1653392015967,COGS 210A,006,087998,Deak; Gedeon O.,9998,0,9999,1
1653392015967,COGS 210A,007,087999,Rossano; Federico,9999,0,9999,0
1653392016494,COGS 211A,A00,088000,Coulson; Seana M,9997,0,9999,2
1653392017020,COGS 229,A00,088002,Staff,23,0,25,2
1653392017547,COGS 260,B00,094231,Staff,17,0,20,3
1653392017547,COGS 260,A00,088004,Nitz; Douglas A.,9998,0,9999,1
1653392018074,CSE 202,A00,090110,Paturi; Ramamohan,0,0,0,0
1653392018074,CSE 202,B00,090111,Paturi; Ramamohan,0,0,0,0
1653392018599,CSE 207B,A00,090112,Heninger; Nadia A,0,0,0,0
1653392019126,CSE 208,A00,094858,Micciancio; Daniele,0,0,0,0
1653392019653,CSE 210,A00,090113,Powell; Thomas Allan,0,0,0,0
1653392020182,CSE 219,A00,090898,Staff,0,0,0,0
1653392020710,CSE 221,A00,090114,Zhou; Yuan-Yuan,0,0,0,0
1653392021235,CSE 229A,A00,090115,Porter; George M,0,0,0,0
1653392021760,CSE 229C,A00,090116,Savage; Stefan,0,0,0,0
1653392022288,CSE 230,A00,090117,Jhala; Ranjit,0,0,0,0
1653392022813,CSE 232,A00,090118,Papakonstantinou; Yannis,0,0,0,0
1653392023338,CSE 239A,A00,090121,Kumar; Arun Kumar,0,0,0,0
1653392023862,CSE 239B,A00,090122,Jhala; Ranjit,0,0,0,0
1653392024392,CSE 240A,A00,090123,Zhao; Jishen,0,0,189,189
1653392024917,CSE 243A,A00,090124,Orailoglu; Alex,3,0,15,12
1653392025442,CSE 249B,A00,090125,Kahng; Andrew Byun,14,0,20,6
1653392025966,CSE 250A,A00,090126,Berg-Kirkpatrick; Taylor D,0,0,0,0
1653392026492,CSE 252A,A00,090127,Ochoa; Benjamin Lawrence,0,0,0,0
1653392027022,CSE 258,A01,090129,McAuley; Julian John,0,0,0,0
1653392027547,CSE 258R,A01,090131,McAuley; Julian John,0,0,0,0
1653392028076,CSE 274,A00,090132,Ramamoorthi; Ravi,0,0,0,0
1653392028604,CSE 276A,A00,090133,Christensen; Henrik I,0,0,0,0
1653392029128,CSE 276C,A00,090134,Christensen; Henrik I,0,0,0,0
1653392029661,CSE 290,A00,090135,Bafna; Vineet,0,0,0,0
1653392029661,CSE 290,B00,090136,Ramamoorthi; Ravi,0,0,0,0
1653392029661,CSE 290,C00,090137,Li; Tzumao,10,0,10,0
1653392029661,CSE 290,D00,090138,Zhou; Yuan-Yuan,10,0,10,0
1653392029661,CSE 290,E00,090139,Christensen; Henrik I,10,0,10,0
1653392029661,CSE 290,F00,094053,Shalev; Aaron D,0,0,0,0
1653392030194,CSE 291,A00,090140,Munyaka; Imani N. S.,0,0,0,0
1653392030194,CSE 291,B00,094880,Yu; Qi,0,0,0,0
1653392030194,CSE 291,C00,090142,Pannuto; Patrick William,0,0,0,0
1653392030194,CSE 291,D00,094881,Zhang; Yiying,0,0,0,0
1653392030194,CSE 291,E00,095118,Su; Hao,0,0,0,0
1653392030735,CSE 293,001,094905,Bafna; Vineet,9999,0,9999,0
1653392030735,CSE 293,002,094906,Bellare; Mihir,9999,0,9999,0
1653392030735,CSE 293,003,094907,Berg-Kirkpatrick; Taylor D,9999,0,9999,0
1653392030735,CSE 293,004,094908,Christensen; Henrik I,9999,0,9999,0
1653392030735,CSE 293,005,094909,Cottrell; Garrison W,9999,0,9999,0
1653392030735,CSE 293,006,094910,Deutsch; Alin Bernard,9999,0,9999,0
1653392030735,CSE 293,007,094911,Esmaeilzadeh; Hadi,9999,0,9999,0
1653392030735,CSE 293,008,094912,Freund; Yoav,9999,0,9999,0
1653392030735,CSE 293,009,094913,Griswold; William G.,9999,0,9999,0
1653392030735,CSE 293,010,094914,Gymrek; Melissa Ann,9999,0,9999,0
1653392030735,CSE 293,011,094915,Heninger; Nadia A,9999,0,9999,0
1653392030735,CSE 293,012,094916,Impagliazzo; Russell,9999,0,9999,0
1653392030735,CSE 293,013,094917,Jhala; Ranjit,9999,0,9999,0
1653392030735,CSE 293,014,094918,Kahng; Andrew Byun,9999,0,9999,0
1653392030735,CSE 293,015,094919,Kane; Daniel Mertz,9999,0,9999,0
1653392030735,CSE 293,016,094920,Kriegman; David J,9999,0,9999,0
1653392030735,CSE 293,017,094921,Kumar; Arun Kumar,9999,0,9999,0
1653392030735,CSE 293,018,094922,Lerner; Sorin,9999,0,9999,0
1653392030735,CSE 293,019,094923,Lovett; Shachar,9999,0,9999,0
1653392030735,CSE 293,020,094924,McAuley; Julian John,9999,0,9999,0
1653392030735,CSE 293,021,094925,Micciancio; Daniele,9999,0,9999,0
1653392030735,CSE 293,022,094926,Orailoglu; Alex,9999,0,9999,0
1653392030735,CSE 293,023,094927,Paturi; Ramamohan,9999,0,9999,0
1653392030735,CSE 293,024,094928,Polikarpova; Nadezhda,9999,0,9999,0
1653392030735,CSE 293,025,094929,Politz; Joseph Gibbs,9999,0,9999,0
1653392030735,CSE 293,026,094930,Porter; George M,9999,0,9999,0
1653392030735,CSE 293,027,094931,Porter; Leonard Emerson,9999,0,9999,0
1653392030735,CSE 293,028,094932,Ramamoorthi; Ravi,9999,0,9999,0
1653392030735,CSE 293,029,094933,Sahoo; Debashis,9999,0,9999,0
1653392030735,CSE 293,030,094934,Saul; Lawrence,9999,0,9999,0
1653392030735,CSE 293,031,094935,Savage; Stefan,9999,0,9999,0
1653392030735,CSE 293,032,094936,Schulze; Jurgen P.,9999,0,9999,0
1653392030735,CSE 293,033,094937,Snoeren; Alex C.,9999,0,9999,0
1653392030735,CSE 293,034,094938,Shang; Jingbo,9999,0,9999,0
1653392030735,CSE 293,035,094939,Stefan; Deian,9999,0,9999,0
1653392030735,CSE 293,036,094940,Su; Hao,9999,0,9999,0
1653392030735,CSE 293,037,094941,Swanson; Steven James,9999,0,9999,0
1653392030735,CSE 293,038,094942,Tullsen; Dean Michael,9999,0,9999,0
1653392030735,CSE 293,039,094943,Voelker; Geoffrey M.,9999,0,9999,0
1653392030735,CSE 293,040,094944,Zhao; Jishen,9999,0,9999,0
1653392030735,CSE 293,041,094945,Zhou; Yuan-Yuan,9999,0,9999,0
1653392030735,CSE 293,042,094946,Gao; Sicun,9998,0,9999,1
1653392030735,CSE 293,043,094947,Weibel; Nadir,9999,0,9999,0
1653392030735,CSE 293,044,094948,Gupta; Rajesh K.,9999,0,9999,0
1653392031261,CSE 294,A00,090143,Porter; George M,9,0,10,1
1653392031788,DSE 200,A00,091799,Staff,50,0,50,0
1653392032313,DSE 203,A00,091800,Gupta; Amarnath,30,0,30,0
1653392032840,DSE 250,A00,091801,Deutsch; Alin Bernard,30,0,30,0
1653392033365,DSE 290,A00,091802,Altintas De Callaf; Ilkay,50,0,50,0
1653392033957,ECE 200,001,091003,Antipa; Nicholas A,9999,0,9999,0
1653392033957,ECE 200,002,091004,Atanasov; Nikolay A.,9999,0,9999,0
1653392033957,ECE 200,003,091005,Bharadia; Dinesh,9999,0,9999,0
1653392033957,ECE 200,004,091006,Cheng; Chung Kuan,9999,0,9999,0
1653392033957,ECE 200,005,091007,Cosman; Pamela C.,9999,0,9999,0
1653392033957,ECE 200,006,091008,Staff,9999,0,9999,0
1653392033957,ECE 200,007,091009,Dayeh; Shadi Ahmad,9999,0,9999,0
1653392033957,ECE 200,008,091010,Fainman; Yeshaiahu,9999,0,9999,0
1653392033957,ECE 200,009,091011,Ford; Joseph Earl,9999,0,9999,0
1653392033957,ECE 200,010,091012,Franceschetti; Massimo,9999,0,9999,0
1653392033957,ECE 200,011,091013,Fullerton; Eric E,9999,0,9999,0
1653392033957,ECE 200,012,091014,Galton; Ian A,9999,0,9999,0
1653392033957,ECE 200,013,091015,Gilja; Vikash,9999,0,9999,0
1653392033957,ECE 200,014,091016,Hall; Drew A.,9999,0,9999,0
1653392033957,ECE 200,015,091017,Hsueh; Tzu-Chien,9999,0,9999,0
1653392033957,ECE 200,016,091018,Javidi; Tara,9999,0,9999,0
1653392033957,ECE 200,017,091019,Kahng; Andrew Byun,9999,0,9999,0
1653392033957,ECE 200,018,091020,Kim; Young-Han,9999,0,9999,0
1653392033957,ECE 200,019,091021,Koushanfar; Farinaz,9999,0,9999,0
1653392033957,ECE 200,020,091022,Kuzum; Duygu,9999,0,9999,0
1653392033957,ECE 200,021,091023,Le; Hanh-Phuc,9999,0,9999,0
1653392033957,ECE 200,022,091024,Lin; Bill,9999,0,9999,0
1653392033957,ECE 200,023,091025,Liu; Zhaowei,9999,0,9999,0
1653392033957,ECE 200,024,091026,Lo; Yu-Hwa,9999,0,9999,0
1653392033957,ECE 200,025,091027,Lomakin; Vitaliy,9999,0,9999,0
1653392033957,ECE 200,026,091028,Mercier; Patrick Philip,9999,0,9999,0
1653392033957,ECE 200,027,091029,Meyer; Florian,9999,0,9999,0
1653392033957,ECE 200,028,091030,Milstein; Laurence B.,9999,0,9999,0
1653392033957,ECE 200,029,091031,Mir Arabbaygi; Siavash,9999,0,9999,0
1653392033957,ECE 200,030,091032,Mookherjea; Shayan,9999,0,9999,0
1653392033957,ECE 200,031,091033,Morris; Karcher William,9999,0,9999,0
1653392033957,ECE 200,032,091034,Ng; Tse Nga,9999,0,9999,0
1653392033957,ECE 200,033,091035,Nguyen; Truong Quang,9999,0,9999,0
1653392033957,ECE 200,034,091036,Nomura; Kenji,9999,0,9999,0
1653392033957,ECE 200,035,091037,Orlitsky; Alon,9999,0,9999,0
1653392033957,ECE 200,036,091038,Pal; Piya,9999,0,9999,0
1653392033957,ECE 200,037,091039,Papen; George C.,9999,0,9999,0
1653392033957,ECE 200,038,091040,Radic; Stojan,9999,0,9999,0
1653392033957,ECE 200,039,091041,Rao; Bhaskar D.,9999,0,9999,0
1653392033957,ECE 200,040,091042,Rao; Ramesh R,9999,0,9999,0
1653392033957,ECE 200,041,091043,Rebeiz; Gabriel,9999,0,9999,0
1653392033957,ECE 200,042,091044,Sanford; John R,9999,0,9999,0
1653392033957,ECE 200,043,091045,Siegel; Paul H.,9999,0,9999,0
1653392033957,ECE 200,044,091046,Sievenpiper; Daniel F.,9999,0,9999,0
1653392033957,ECE 200,045,091047,Sworder; David D.,9999,0,9999,0
1653392033957,ECE 200,046,091048,Taur; Yuan,9999,0,9999,0
1653392033957,ECE 200,047,091049,Touri; Behrouz,9999,0,9999,0
1653392033957,ECE 200,048,091050,Trivedi; Mohan M.,9999,0,9999,0
1653392033957,ECE 200,049,091051,Vardy; Alexander,9999,0,9999,0
1653392033957,ECE 200,050,091052,Vasconcelos; Nuno,9999,0,9999,0
1653392033957,ECE 200,051,091053,Wang; Xiaolong,9999,0,9999,0
1653392033957,ECE 200,052,091054,Xie; Pengtao,9999,0,9999,0
1653392033957,ECE 200,053,091055,Yip; Michael,9999,0,9999,0
1653392033957,ECE 200,054,091056,Zeger; Kenneth A.,9999,0,9999,0
1653392033957,ECE 200,055,091057,Zhang; Xinyu,9999,0,9999,0
1653392033957,ECE 200,056,091058,Turakhia; Yatish Girish,9999,0,9999,0
1653392033957,ECE 200,057,091059,Kang; Mingu,9999,0,9999,0
1653392033957,ECE 200,058,091060,Shi; Yuanyuan,9999,0,9999,0
1653392033957,ECE 200,059,091061,Wang; Edward Jay,9999,0,9999,0
1653392033957,ECE 200,060,091062,Zheng; Yang,9999,0,9999,0
1653392034488,ECE 203,A00,091065,Mercier; Patrick Philip,0,0,0,0
1653392035015,ECE 207A,A00,091605,Liu; Thomas Tao-Ming,0,0,0,0
1653392035542,ECE 212AN,A00,091068,Nomura; Kenji,0,0,0,0
1653392036066,ECE 222A,A00,091069,Rebeiz; Gabriel,0,0,0,0
1653392036594,ECE 225A,A00,091070,Orlitsky; Alon,0,0,0,0
1653392037122,ECE 230A,A00,091071,Nomura; Kenji,0,0,0,0
1653392037653,ECE 236A,A00,091072,Dayeh; Shadi Ahmad,0,0,0,0
1653392038179,ECE 238A,A00,091073,Luo; Jian,0,0,0,0
1653392038179,ECE 238A,B00,091074,Luo; Jian,0,0,0,0
1653392038710,ECE 240A,A00,091075,Radic; Stojan,0,0,0,0
1653392039236,ECE 247A,A00,091592,Shi; Lingyan,0,0,0,0
1653392039769,ECE 250,A00,091076,Touri; Behrouz,0,0,0,0
1653392040301,ECE 251C,A00,091078,Nguyen; Truong Quang,0,0,0,0
1653392040919,ECE 253,A00,091079,Cosman; Pamela C.,0,0,0,0
1653392041449,ECE 255A,A00,091080,Orlitsky; Alon,0,0,0,0
1653392041974,ECE 257A,A00,091081,Zhang; Xinyu,0,0,0,0
1653392042507,ECE 260A,A01,091084,Eldon; John,0,0,0,0
1653392043033,ECE 264C,A00,091085,Galton; Ian A,0,0,0,0
1653392043559,ECE 265C,A00,094889,Presti; Calogero Davide,0,0,0,9
1653392044089,ECE 266,A01,091087,Hall; Drew A.,0,0,0,0
1653392045145,ECE 271A,A00,091090,Vasconcelos; Nuno,0,0,0,0
1653392045669,ECE 272B,A00,091091,Sworder; David D.,0,0,0,0
1653392046196,ECE 275A,A00,091092,Meyer; Florian,0,0,0,0
1653392046721,ECE 277,A00,091093,An; Cheolhong,0,0,0,0
1653392047244,ECE 283,A00,091094,Le; Hanh-Phuc,0,0,0,0
1653392047770,ECE 284,A00,091095,Kang; Mingu,0,0,0,0
1653392047770,ECE 284,B00,091096,Wang; Edward Jay,0,0,0,0
1653392048299,ECE 285,A00,094334,Touri; Behrouz,0,0,0,0
1653392048826,ECE 289,A00,091097,Whelan; David Arthur,0,0,0,0
1653392049351,MATH 200A,A00,087414,Salehi Golsefidy; Alireza,7,0,8,1
1653392049876,MATH 202A,A00,087415,Gill; Philip E.,3,0,8,5
1653392050407,MATH 203A,A00,087416,Oprea; Dragos N.,6,0,8,2
1653392050933,MATH 204A,A00,087417,Kedlaya; Kiran S.,6,0,8,2
1653392051459,MATH 205,A00,087418,Sorensen; Claus M,6,0,8,2
1653392051990,MATH 206A,A00,087419,Izadi; Elham,7,0,8,1
1653392052516,MATH 207A,A00,087420,Mohammadi; Amir,6,0,8,2
1653392053041,MATH 208,A00,087421,Staff,9,0,10,1
1653392053571,MATH 209,A00,087422,Staff,10,0,10,0
1653392054100,MATH 218,A00,087423,Staff,10,0,10,0
1653392054627,MATH 220A,A00,087424,Novak; Jonathan I,7,0,8,1
1653392055154,MATH 231A,A00,087425,Bejenaru; Ioan,4,0,8,4
1653392055685,MATH 240A,A00,087426,Ebenfelt; Peter F,5,0,8,3
1653392056212,MATH 243,A00,087427,Staff,9,0,10,1
1653392056737,MATH 248,A00,087429,Staff,10,0,10,0
1653392057263,MATH 250A,A00,087430,Spolaor; Luca,5,0,8,3
1653392057788,MATH 257A,A00,087431,Spolaor; Luca,7,0,8,1
1653392058312,MATH 258,A00,087432,Staff,9,0,10,1
1653392058839,MATH 264A,A00,087433,Warnke; Lutz Peter,5,0,8,3
1653392059366,MATH 268,A00,087434,Staff,15,0,15,0
1653392059892,MATH 269,A00,087435,Staff,14,0,15,1
1653392060421,MATH 270A,A00,087436,Nie; Jiawang,0,0,8,8
1653392060947,MATH 272A,A00,087437,Tian; Xiaochuan,2,0,8,6
1653392061483,MATH 274,A01,087439,Cheng; Li-Tien,9,0,10,1
1653392061483,MATH 274,A02,087440,Cheng; Li-Tien,10,0,10,0
1653392062008,MATH 278A,A00,087441,Staff,8,0,10,2
1653392062535,MATH 278B,A00,087442,Staff,8,0,10,2
1653392063060,MATH 278C,A00,087443,Staff,8,0,10,2
1653392063585,MATH 280A,A00,087444,Zheng; Tianyi,0,0,8,8
1653392064114,MATH 281A,A00,087445,Bradic; Jelena,0,0,8,8
1653392064642,MATH 282A,A00,087446,Zhang; Danna,0,0,8,8
1653392065170,MATH 283,A00,087447,Tesler; Glenn,0,0,0,13
1653392065697,MATH 286,A00,087448,Kemp; Todd Aahron,6,0,8,2
1653392066223,MATH 287D,A00,087449,Bradic; Jelena,8,0,8,0
1653392066748,MATH 288,A00,087450,Staff,14,0,15,1
1653392066748,MATH 288,B00,087451,Staff,15,0,15,0
1653392066748,MATH 288,C00,087452,Staff,15,0,15,0
1653392067274,MATH 290A,A00,087453,Xu; Zhouli,7,0,8,1
1653392067799,MATH 291A,A00,087454,Xu; Zhouli,7,0,8,1
1653392068334,MATH 292,A00,087455,Staff,10,0,10,0
1653392068860,MATH 295,A00,087456,Staff,50,0,50,0
1653392069386,MATH 297,001,087457,Staff,998,0,999,1
1653392630820,COGS 200,A01,087991,Staff,48,0,50,2
1653392631346,COGS 201,A01,094504,Rangel; Lara M,17,0,25,8
1653392631874,COGS 203,A00,087992,Coulson; Seana M,19,0,20,1
1653392632403,COGS 210A,001,087993,Greene; Deanna Jacquelyn,9998,0,9999,1
1653392632403,COGS 210A,002,087994,Saygin; Ayse P,9999,0,9999,0
1653392632403,COGS 210A,003,087995,Xia; Haijun,9999,0,9999,0
1653392632403,COGS 210A,004,087996,Nitz; Douglas A.,9999,0,9999,0
1653392632403,COGS 210A,005,087997,Hollan; James D.,9999,0,9999,0
1653392632403,COGS 210A,006,087998,Deak; Gedeon O.,9998,0,9999,1
1653392632403,COGS 210A,007,087999,Rossano; Federico,9999,0,9999,0
1653392632930,COGS 211A,A00,088000,Coulson; Seana M,9997,0,9999,2
1653392633454,COGS 229,A00,088002,Staff,23,0,25,2
1653392633988,COGS 260,B00,094231,Staff,17,0,20,3
1653392633988,COGS 260,A00,088004,Nitz; Douglas A.,9998,0,9999,1
1653392634515,CSE 202,A00,090110,Paturi; Ramamohan,0,0,0,0
1653392634515,CSE 202,B00,090111,Paturi; Ramamohan,0,0,0,0
1653392635043,CSE 207B,A00,090112,Heninger; Nadia A,0,0,0,0
1653392635575,CSE 208,A00,094858,Micciancio; Daniele,0,0,0,0
1653392636107,CSE 210,A00,090113,Powell; Thomas Allan,0,0,0,0
1653392636630,CSE 219,A00,090898,Staff,0,0,0,0
1653392637170,CSE 221,A00,090114,Zhou; Yuan-Yuan,0,0,0,0
1653392637695,CSE 229A,A00,090115,Porter; George M,0,0,0,0
1653392638218,CSE 229C,A00,090116,Savage; Stefan,0,0,0,0
1653392638747,CSE 230,A00,090117,Jhala; Ranjit,0,0,0,0
1653392639272,CSE 232,A00,090118,Papakonstantinou; Yannis,0,0,0,0
1653392639796,CSE 239A,A00,090121,Kumar; Arun Kumar,0,0,0,0
1653392640326,CSE 239B,A00,090122,Jhala; Ranjit,0,0,0,0
1653392640849,CSE 240A,A00,090123,Zhao; Jishen,0,0,189,189
1653392641386,CSE 243A,A00,090124,Orailoglu; Alex,3,0,15,12
1653392641911,CSE 249B,A00,090125,Kahng; Andrew Byun,14,0,20,6
1653392642436,CSE 250A,A00,090126,Berg-Kirkpatrick; Taylor D,0,0,0,0
1653392642967,CSE 252A,A00,090127,Ochoa; Benjamin Lawrence,0,0,0,0
1653392643494,CSE 258,A01,090129,McAuley; Julian John,0,0,0,0
1653392644022,CSE 258R,A01,090131,McAuley; Julian John,0,0,0,0
1653392644548,CSE 274,A00,090132,Ramamoorthi; Ravi,0,0,0,0
1653392645073,CSE 276A,A00,090133,Christensen; Henrik I,0,0,0,0
1653392645602,CSE 276C,A00,090134,Christensen; Henrik I,0,0,0,0
1653392646129,CSE 290,A00,090135,Bafna; Vineet,0,0,0,0
1653392646129,CSE 290,B00,090136,Ramamoorthi; Ravi,0,0,0,0
1653392646129,CSE 290,C00,090137,Li; Tzumao,10,0,10,0
1653392646129,CSE 290,D00,090138,Zhou; Yuan-Yuan,10,0,10,0
1653392646129,CSE 290,E00,090139,Christensen; Henrik I,10,0,10,0
1653392646129,CSE 290,F00,094053,Shalev; Aaron D,0,0,0,0
1653392646666,CSE 291,A00,090140,Munyaka; Imani N. S.,0,0,0,0
1653392646666,CSE 291,B00,094880,Yu; Qi,0,0,0,0
1653392646666,CSE 291,C00,090142,Pannuto; Patrick William,0,0,0,0
1653392646666,CSE 291,D00,094881,Zhang; Yiying,0,0,0,0
1653392646666,CSE 291,E00,095118,Su; Hao,0,0,0,0
1653392647205,CSE 293,001,094905,Bafna; Vineet,9999,0,9999,0
1653392647205,CSE 293,002,094906,Bellare; Mihir,9999,0,9999,0
1653392647205,CSE 293,003,094907,Berg-Kirkpatrick; Taylor D,9999,0,9999,0
1653392647205,CSE 293,004,094908,Christensen; Henrik I,9999,0,9999,0
1653392647205,CSE 293,005,094909,Cottrell; Garrison W,9999,0,9999,0
1653392647205,CSE 293,006,094910,Deutsch; Alin Bernard,9999,0,9999,0
1653392647205,CSE 293,007,094911,Esmaeilzadeh; Hadi,9999,0,9999,0
1653392647205,CSE 293,008,094912,Freund; Yoav,9999,0,9999,0
1653392647205,CSE 293,009,094913,Griswold; William G.,9999,0,9999,0
1653392647205,CSE 293,010,094914,Gymrek; Melissa Ann,9999,0,9999,0
1653392647205,CSE 293,011,094915,Heninger; Nadia A,9999,0,9999,0
1653392647205,CSE 293,012,094916,Impagliazzo; Russell,9999,0,9999,0
1653392647205,CSE 293,013,094917,Jhala; Ranjit,9999,0,9999,0
1653392647205,CSE 293,014,094918,Kahng; Andrew Byun,9999,0,9999,0
1653392647205,CSE 293,015,094919,Kane; Daniel Mertz,9999,0,9999,0
1653392647205,CSE 293,016,094920,Kriegman; David J,9999,0,9999,0
1653392647205,CSE 293,017,094921,Kumar; Arun Kumar,9999,0,9999,0
1653392647205,CSE 293,018,094922,Lerner; Sorin,9999,0,9999,0
1653392647205,CSE 293,019,094923,Lovett; Shachar,9999,0,9999,0
1653392647205,CSE 293,020,094924,McAuley; Julian John,9999,0,9999,0
1653392647205,CSE 293,021,094925,Micciancio; Daniele,9999,0,9999,0
1653392647205,CSE 293,022,094926,Orailoglu; Alex,9999,0,9999,0
1653392647205,CSE 293,023,094927,Paturi; Ramamohan,9999,0,9999,0
1653392647205,CSE 293,024,094928,Polikarpova; Nadezhda,9999,0,9999,0
1653392647205,CSE 293,025,094929,Politz; Joseph Gibbs,9999,0,9999,0
1653392647205,CSE 293,026,094930,Porter; George M,9999,0,9999,0
1653392647205,CSE 293,027,094931,Porter; Leonard Emerson,9999,0,9999,0
1653392647205,CSE 293,028,094932,Ramamoorthi; Ravi,9999,0,9999,0
1653392647205,CSE 293,029,094933,Sahoo; Debashis,9999,0,9999,0
1653392647205,CSE 293,030,094934,Saul; Lawrence,9999,0,9999,0
1653392647205,CSE 293,031,094935,Savage; Stefan,9999,0,9999,0
1653392647205,CSE 293,032,094936,Schulze; Jurgen P.,9999,0,9999,0
1653392647205,CSE 293,033,094937,Snoeren; Alex C.,9999,0,9999,0
1653392647205,CSE 293,034,094938,Shang; Jingbo,9999,0,9999,0
1653392647205,CSE 293,035,094939,Stefan; Deian,9999,0,9999,0
1653392647205,CSE 293,036,094940,Su; Hao,9999,0,9999,0
1653392647205,CSE 293,037,094941,Swanson; Steven James,9999,0,9999,0
1653392647205,CSE 293,038,094942,Tullsen; Dean Michael,9999,0,9999,0
1653392647205,CSE 293,039,094943,Voelker; Geoffrey M.,9999,0,9999,0
1653392647205,CSE 293,040,094944,Zhao; Jishen,9999,0,9999,0
1653392647205,CSE 293,041,094945,Zhou; Yuan-Yuan,9999,0,9999,0
1653392647205,CSE 293,042,094946,Gao; Sicun,9998,0,9999,1
1653392647205,CSE 293,043,094947,Weibel; Nadir,9999,0,9999,0
1653392647205,CSE 293,044,094948,Gupta; Rajesh K.,9999,0,9999,0
1653392647729,CSE 294,A00,090143,Porter; George M,9,0,10,1
1653392648256,DSE 200,A00,091799,Staff,50,0,50,0
1653392648787,DSE 203,A00,091800,Gupta; Amarnath,30,0,30,0
1653392649311,DSE 250,A00,091801,Deutsch; Alin Bernard,30,0,30,0
1653392649836,DSE 290,A00,091802,Altintas De Callaf; Ilkay,50,0,50,0
1653392650388,ECE 200,001,091003,Antipa; Nicholas A,9999,0,9999,0
1653392650388,ECE 200,002,091004,Atanasov; Nikolay A.,9999,0,9999,0
1653392650388,ECE 200,003,091005,Bharadia; Dinesh,9999,0,9999,0
1653392650388,ECE 200,004,091006,Cheng; Chung Kuan,9999,0,9999,0
1653392650388,ECE 200,005,091007,Cosman; Pamela C.,9999,0,9999,0
1653392650388,ECE 200,006,091008,Staff,9999,0,9999,0
1653392650388,ECE 200,007,091009,Dayeh; Shadi Ahmad,9999,0,9999,0
1653392650388,ECE 200,008,091010,Fainman; Yeshaiahu,9999,0,9999,0
1653392650388,ECE 200,009,091011,Ford; Joseph Earl,9999,0,9999,0
1653392650388,ECE 200,010,091012,Franceschetti; Massimo,9999,0,9999,0
1653392650388,ECE 200,011,091013,Fullerton; Eric E,9999,0,9999,0
1653392650388,ECE 200,012,091014,Galton; Ian A,9999,0,9999,0
1653392650388,ECE 200,013,091015,Gilja; Vikash,9999,0,9999,0
1653392650388,ECE 200,014,091016,Hall; Drew A.,9999,0,9999,0
1653392650388,ECE 200,015,091017,Hsueh; Tzu-Chien,9999,0,9999,0
1653392650388,ECE 200,016,091018,Javidi; Tara,9999,0,9999,0
1653392650388,ECE 200,017,091019,Kahng; Andrew Byun,9999,0,9999,0
1653392650388,ECE 200,018,091020,Kim; Young-Han,9999,0,9999,0
1653392650388,ECE 200,019,091021,Koushanfar; Farinaz,9999,0,9999,0
1653392650388,ECE 200,020,091022,Kuzum; Duygu,9999,0,9999,0
1653392650388,ECE 200,021,091023,Le; Hanh-Phuc,9999,0,9999,0
1653392650388,ECE 200,022,091024,Lin; Bill,9999,0,9999,0
1653392650388,ECE 200,023,091025,Liu; Zhaowei,9999,0,9999,0
1653392650388,ECE 200,024,091026,Lo; Yu-Hwa,9999,0,9999,0
1653392650388,ECE 200,025,091027,Lomakin; Vitaliy,9999,0,9999,0
1653392650388,ECE 200,026,091028,Mercier; Patrick Philip,9999,0,9999,0
1653392650388,ECE 200,027,091029,Meyer; Florian,9999,0,9999,0
1653392650388,ECE 200,028,091030,Milstein; Laurence B.,9999,0,9999,0
1653392650388,ECE 200,029,091031,Mir Arabbaygi; Siavash,9999,0,9999,0
1653392650388,ECE 200,030,091032,Mookherjea; Shayan,9999,0,9999,0
1653392650388,ECE 200,031,091033,Morris; Karcher William,9999,0,9999,0
1653392650388,ECE 200,032,091034,Ng; Tse Nga,9999,0,9999,0
1653392650388,ECE 200,033,091035,Nguyen; Truong Quang,9999,0,9999,0
1653392650388,ECE 200,034,091036,Nomura; Kenji,9999,0,9999,0
1653392650388,ECE 200,035,091037,Orlitsky; Alon,9999,0,9999,0
1653392650388,ECE 200,036,091038,Pal; Piya,9999,0,9999,0
1653392650388,ECE 200,037,091039,Papen; George C.,9999,0,9999,0
1653392650388,ECE 200,038,091040,Radic; Stojan,9999,0,9999,0
1653392650388,ECE 200,039,091041,Rao; Bhaskar D.,9999,0,9999,0
1653392650388,ECE 200,040,091042,Rao; Ramesh R,9999,0,9999,0
1653392650388,ECE 200,041,091043,Rebeiz; Gabriel,9999,0,9999,0
1653392650388,ECE 200,042,091044,Sanford; John R,9999,0,9999,0
1653392650388,ECE 200,043,091045,Siegel; Paul H.,9999,0,9999,0
1653392650388,ECE 200,044,091046,Sievenpiper; Daniel F.,9999,0,9999,0
1653392650388,ECE 200,045,091047,Sworder; David D.,9999,0,9999,0
1653392650388,ECE 200,046,091048,Taur; Yuan,9999,0,9999,0
1653392650388,ECE 200,047,091049,Touri; Behrouz,9999,0,9999,0
1653392650388,ECE 200,048,091050,Trivedi; Mohan M.,9999,0,9999,0
1653392650388,ECE 200,049,091051,Vardy; Alexander,9999,0,9999,0
1653392650388,ECE 200,050,091052,Vasconcelos; Nuno,9999,0,9999,0
1653392650388,ECE 200,051,091053,Wang; Xiaolong,9999,0,9999,0
1653392650388,ECE 200,052,091054,Xie; Pengtao,9999,0,9999,0
1653392650388,ECE 200,053,091055,Yip; Michael,9999,0,9999,0
1653392650388,ECE 200,054,091056,Zeger; Kenneth A.,9999,0,9999,0
1653392650388,ECE 200,055,091057,Zhang; Xinyu,9999,0,9999,0
1653392650388,ECE 200,056,091058,Turakhia; Yatish Girish,9999,0,9999,0
1653392650388,ECE 200,057,091059,Kang; Mingu,9999,0,9999,0
1653392650388,ECE 200,058,091060,Shi; Yuanyuan,9999,0,9999,0
1653392650388,ECE 200,059,091061,Wang; Edward Jay,9999,0,9999,0
1653392650388,ECE 200,060,091062,Zheng; Yang,9999,0,9999,0
1653392650915,ECE 203,A00,091065,Mercier; Patrick Philip,0,0,0,0
1653392651441,ECE 207A,A00,091605,Liu; Thomas Tao-Ming,0,0,0,0
1653392651966,ECE 212AN,A00,091068,Nomura; Kenji,0,0,0,0
1653392652538,ECE 222A,A00,091069,Rebeiz; Gabriel,0,0,0,0
1653392653186,ECE 225A,A00,091070,Orlitsky; Alon,0,0,0,0
1653392653710,ECE 230A,A00,091071,Nomura; Kenji,0,0,0,0
1653392654236,ECE 236A,A00,091072,Dayeh; Shadi Ahmad,0,0,0,0
1653392654766,ECE 238A,A00,091073,Luo; Jian,0,0,0,0
1653392654766,ECE 238A,B00,091074,Luo; Jian,0,0,0,0
1653392655300,ECE 240A,A00,091075,Radic; Stojan,0,0,0,0
1653392655825,ECE 247A,A00,091592,Shi; Lingyan,0,0,0,0
1653392656351,ECE 250,A00,091076,Touri; Behrouz,0,0,0,0
1653392656874,ECE 251C,A00,091078,Nguyen; Truong Quang,0,0,0,0
1653392657405,ECE 253,A00,091079,Cosman; Pamela C.,0,0,0,0
1653392657929,ECE 255A,A00,091080,Orlitsky; Alon,0,0,0,0
1653392658457,ECE 257A,A00,091081,Zhang; Xinyu,0,0,0,0
1653392658987,ECE 260A,A01,091084,Eldon; John,0,0,0,0
1653392659512,ECE 264C,A00,091085,Galton; Ian A,0,0,0,0
1653392660042,ECE 265C,A00,094889,Presti; Calogero Davide,0,0,0,9
1653392660568,ECE 266,A01,091087,Hall; Drew A.,0,0,0,0
1653392661619,ECE 271A,A00,091090,Vasconcelos; Nuno,0,0,0,0
1653392662149,ECE 272B,A00,091091,Sworder; David D.,0,0,0,0
1653392662678,ECE 275A,A00,091092,Meyer; Florian,0,0,0,0
1653392663208,ECE 277,A00,091093,An; Cheolhong,0,0,0,0
1653392663737,ECE 283,A00,091094,Le; Hanh-Phuc,0,0,0,0
1653392664267,ECE 284,A00,091095,Kang; Mingu,0,0,0,0
1653392664267,ECE 284,B00,091096,Wang; Edward Jay,0,0,0,0
1653392664792,ECE 285,A00,094334,Touri; Behrouz,0,0,0,0
1653392665318,ECE 289,A00,091097,Whelan; David Arthur,0,0,0,0
1653392665857,MATH 200A,A00,087414,Salehi Golsefidy; Alireza,7,0,8,1
1653392666385,MATH 202A,A00,087415,Gill; Philip E.,3,0,8,5
1653392666919,MATH 203A,A00,087416,Oprea; Dragos N.,6,0,8,2
1653392667446,MATH 204A,A00,087417,Kedlaya; Kiran S.,6,0,8,2
1653392667975,MATH 205,A00,087418,Sorensen; Claus M,6,0,8,2
1653392668510,MATH 206A,A00,087419,Izadi; Elham,7,0,8,1
1653392669038,MATH 207A,A00,087420,Mohammadi; Amir,6,0,8,2
1653392669562,MATH 208,A00,087421,Staff,9,0,10,1
1653392670087,MATH 209,A00,087422,Staff,10,0,10,0
1653392670611,MATH 218,A00,087423,Staff,10,0,10,0
1653392671139,MATH 220A,A00,087424,Novak; Jonathan I,7,0,8,1
1653392671663,MATH 231A,A00,087425,Bejenaru; Ioan,4,0,8,4
1653392672188,MATH 240A,A00,087426,Ebenfelt; Peter F,5,0,8,3
1653392672716,MATH 243,A00,087427,Staff,9,0,10,1
1653392673253,MATH 248,A00,087429,Staff,10,0,10,0
1653392673782,MATH 250A,A00,087430,Spolaor; Luca,5,0,8,3
1653392674308,MATH 257A,A00,087431,Spolaor; Luca,7,0,8,1
1653392674832,MATH 258,A00,087432,Staff,9,0,10,1
1653392675361,MATH 264A,A00,087433,Warnke; Lutz Peter,5,0,8,3
1653392675885,MATH 268,A00,087434,Staff,15,0,15,0
1653392676410,MATH 269,A00,087435,Staff,14,0,15,1
1653392676932,MATH 270A,A00,087436,Nie; Jiawang,0,0,8,8
1653392677460,MATH 272A,A00,087437,Tian; Xiaochuan,2,0,8,6
1653392677992,MATH 274,A01,087439,Cheng; Li-Tien,9,0,10,1
1653392677992,MATH 274,A02,087440,Cheng; Li-Tien,10,0,10,0
1653392678516,MATH 278A,A00,087441,Staff,8,0,10,2
1653392679041,MATH 278B,A00,087442,Staff,8,0,10,2
1653392679567,MATH 278C,A00,087443,Staff,8,0,10,2
1653392680094,MATH 280A,A00,087444,Zheng; Tianyi,0,0,8,8
1653392680622,MATH 281A,A00,087445,Bradic; Jelena,0,0,8,8
1653392681147,MATH 282A,A00,087446,Zhang; Danna,0,0,8,8
1653392681672,MATH 283,A00,087447,Tesler; Glenn,0,0,0,13
1653392682197,MATH 286,A00,087448,Kemp; Todd Aahron,6,0,8,2
1653392682725,MATH 287D,A00,087449,Bradic; Jelena,8,0,8,0
1653392683323,MATH 288,A00,087450,Staff,14,0,15,1
1653392683323,MATH 288,B00,087451,Staff,15,0,15,0
1653392683323,MATH 288,C00,087452,Staff,15,0,15,0
1653392683848,MATH 290A,A00,087453,Xu; Zhouli,7,0,8,1
1653392684373,MATH 291A,A00,087454,Xu; Zhouli,7,0,8,1
1653392684907,MATH 292,A00,087455,Staff,10,0,10,0
1653392685435,MATH 295,A00,087456,Staff,50,0,50,0
1653392685958,MATH 297,001,087457,Staff,998,0,999,1
1653393249303,COGS 200,A01,087991,Staff,48,0,50,2
1653393249833,COGS 201,A01,094504,Rangel; Lara M,17,0,25,8
1653393250359,COGS 203,A00,087992,Coulson; Seana M,19,0,20,1
1653393250889,COGS 210A,001,087993,Greene; Deanna Jacquelyn,9998,0,9999,1
1653393250889,COGS 210A,002,087994,Saygin; Ayse P,9999,0,9999,0
1653393250889,COGS 210A,003,087995,Xia; Haijun,9999,0,9999,0
1653393250889,COGS 210A,004,087996,Nitz; Douglas A.,9999,0,9999,0
1653393250889,COGS 210A,005,087997,Hollan; James D.,9999,0,9999,0
1653393250889,COGS 210A,006,087998,Deak; Gedeon O.,9998,0,9999,1
1653393250889,COGS 210A,007,087999,Rossano; Federico,9999,0,9999,0
1653393251413,COGS 211A,A00,088000,Coulson; Seana M,9997,0,9999,2
1653393251942,COGS 229,A00,088002,Staff,23,0,25,2
1653393252470,COGS 260,B00,094231,Staff,17,0,20,3
1653393252470,COGS 260,A00,088004,Nitz; Douglas A.,9998,0,9999,1
1653393253012,CSE 202,A00,090110,Paturi; Ramamohan,0,0,0,0
1653393253012,CSE 202,B00,090111,Paturi; Ramamohan,0,0,0,0
1653393253541,CSE 207B,A00,090112,Heninger; Nadia A,0,0,0,0
1653393254066,CSE 208,A00,094858,Micciancio; Daniele,0,0,0,0
1653393254590,CSE 210,A00,090113,Powell; Thomas Allan,0,0,0,0
1653393255116,CSE 219,A00,090898,Staff,0,0,0,0
1653393255640,CSE 221,A00,090114,Zhou; Yuan-Yuan,0,0,0,0
1653393256169,CSE 229A,A00,090115,Porter; George M,0,0,0,0
1653393256693,CSE 229C,A00,090116,Savage; Stefan,0,0,0,0
1653393257222,CSE 230,A00,090117,Jhala; Ranjit,0,0,0,0
1653393257752,CSE 232,A00,090118,Papakonstantinou; Yannis,0,0,0,0
1653393258281,CSE 239A,A00,090121,Kumar; Arun Kumar,0,0,0,0
1653393258811,CSE 239B,A00,090122,Jhala; Ranjit,0,0,0,0
1653393259343,CSE 240A,A00,090123,Zhao; Jishen,0,0,189,189
1653393259867,CSE 243A,A00,090124,Orailoglu; Alex,3,0,15,12
1653393260396,CSE 249B,A00,090125,Kahng; Andrew Byun,14,0,20,6
1653393260924,CSE 250A,A00,090126,Berg-Kirkpatrick; Taylor D,0,0,0,0
1653393261448,CSE 252A,A00,090127,Ochoa; Benjamin Lawrence,0,0,0,0
1653393261973,CSE 258,A01,090129,McAuley; Julian John,0,0,0,0
1653393262499,CSE 258R,A01,090131,McAuley; Julian John,0,0,0,0
1653393263024,CSE 274,A00,090132,Ramamoorthi; Ravi,0,0,0,0
1653393263548,CSE 276A,A00,090133,Christensen; Henrik I,0,0,0,0
1653393264071,CSE 276C,A00,090134,Christensen; Henrik I,0,0,0,0
1653393264598,CSE 290,A00,090135,Bafna; Vineet,0,0,0,0
1653393264598,CSE 290,B00,090136,Ramamoorthi; Ravi,0,0,0,0
1653393264598,CSE 290,C00,090137,Li; Tzumao,10,0,10,0
1653393264598,CSE 290,D00,090138,Zhou; Yuan-Yuan,10,0,10,0
1653393264598,CSE 290,E00,090139,Christensen; Henrik I,10,0,10,0
1653393264598,CSE 290,F00,094053,Shalev; Aaron D,0,0,0,0
1653393265133,CSE 291,A00,090140,Munyaka; Imani N. S.,0,0,0,0
1653393265133,CSE 291,B00,094880,Yu; Qi,0,0,0,0
1653393265133,CSE 291,C00,090142,Pannuto; Patrick William,0,0,0,0
1653393265133,CSE 291,D00,094881,Zhang; Yiying,0,0,0,0
1653393265133,CSE 291,E00,095118,Su; Hao,0,0,0,0
1653393265699,CSE 293,001,094905,Bafna; Vineet,9999,0,9999,0
1653393265699,CSE 293,002,094906,Bellare; Mihir,9999,0,9999,0
1653393265699,CSE 293,003,094907,Berg-Kirkpatrick; Taylor D,9999,0,9999,0
1653393265699,CSE 293,004,094908,Christensen; Henrik I,9999,0,9999,0
1653393265699,CSE 293,005,094909,Cottrell; Garrison W,9999,0,9999,0
1653393265699,CSE 293,006,094910,Deutsch; Alin Bernard,9999,0,9999,0
1653393265699,CSE 293,007,094911,Esmaeilzadeh; Hadi,9999,0,9999,0
1653393265699,CSE 293,008,094912,Freund; Yoav,9999,0,9999,0
1653393265699,CSE 293,009,094913,Griswold; William G.,9999,0,9999,0
1653393265699,CSE 293,010,094914,Gymrek; Melissa Ann,9999,0,9999,0
1653393265699,CSE 293,011,094915,Heninger; Nadia A,9999,0,9999,0
1653393265699,CSE 293,012,094916,Impagliazzo; Russell,9999,0,9999,0
1653393265699,CSE 293,013,094917,Jhala; Ranjit,9999,0,9999,0
1653393265699,CSE 293,014,094918,Kahng; Andrew Byun,9999,0,9999,0
1653393265699,CSE 293,015,094919,Kane; Daniel Mertz,9999,0,9999,0
1653393265699,CSE 293,016,094920,Kriegman; David J,9999,0,9999,0
1653393265699,CSE 293,017,094921,Kumar; Arun Kumar,9999,0,9999,0
1653393265699,CSE 293,018,094922,Lerner; Sorin,9999,0,9999,0
1653393265699,CSE 293,019,094923,Lovett; Shachar,9999,0,9999,0
1653393265699,CSE 293,020,094924,McAuley; Julian John,9999,0,9999,0
1653393265699,CSE 293,021,094925,Micciancio; Daniele,9999,0,9999,0
1653393265699,CSE 293,022,094926,Orailoglu; Alex,9999,0,9999,0
1653393265699,CSE 293,023,094927,Paturi; Ramamohan,9999,0,9999,0
1653393265699,CSE 293,024,094928,Polikarpova; Nadezhda,9999,0,9999,0
1653393265699,CSE 293,025,094929,Politz; Joseph Gibbs,9999,0,9999,0
1653393265699,CSE 293,026,094930,Porter; George M,9999,0,9999,0
1653393265699,CSE 293,027,094931,Porter; Leonard Emerson,9999,0,9999,0
1653393265699,CSE 293,028,094932,Ramamoorthi; Ravi,9999,0,9999,0
1653393265699,CSE 293,029,094933,Sahoo; Debashis,9999,0,9999,0
1653393265699,CSE 293,030,094934,Saul; Lawrence,9999,0,9999,0
1653393265699,CSE 293,031,094935,Savage; Stefan,9999,0,9999,0
1653393265699,CSE 293,032,094936,Schulze; Jurgen P.,9999,0,9999,0
1653393265699,CSE 293,033,094937,Snoeren; Alex C.,9999,0,9999,0
1653393265699,CSE 293,034,094938,Shang; Jingbo,9999,0,9999,0
1653393265699,CSE 293,035,094939,Stefan; Deian,9999,0,9999,0
1653393265699,CSE 293,036,094940,Su; Hao,9999,0,9999,0
1653393265699,CSE 293,037,094941,Swanson; Steven James,9999,0,9999,0
1653393265699,CSE 293,038,094942,Tullsen; Dean Michael,9999,0,9999,0
1653393265699,CSE 293,039,094943,Voelker; Geoffrey M.,9999,0,9999,0
1653393265699,CSE 293,040,094944,Zhao; Jishen,9999,0,9999,0
1653393265699,CSE 293,041,094945,Zhou; Yuan-Yuan,9999,0,9999,0
1653393265699,CSE 293,042,094946,Gao; Sicun,9998,0,9999,1
1653393265699,CSE 293,043,094947,Weibel; Nadir,9999,0,9999,0
1653393265699,CSE 293,044,094948,Gupta; Rajesh K.,9999,0,9999,0
1653393266226,CSE 294,A00,090143,Porter; George M,9,0,10,1
1653393266752,DSE 200,A00,091799,Staff,50,0,50,0
1653393267281,DSE 203,A00,091800,Gupta; Amarnath,30,0,30,0
1653393267807,DSE 250,A00,091801,Deutsch; Alin Bernard,30,0,30,0
1653393268338,DSE 290,A00,091802,Altintas De Callaf; Ilkay,50,0,50,0
1653393268897,ECE 200,001,091003,Antipa; Nicholas A,9999,0,9999,0
1653393268897,ECE 200,002,091004,Atanasov; Nikolay A.,9999,0,9999,0
1653393268897,ECE 200,003,091005,Bharadia; Dinesh,9999,0,9999,0
1653393268897,ECE 200,004,091006,Cheng; Chung Kuan,9999,0,9999,0
1653393268897,ECE 200,005,091007,Cosman; Pamela C.,9999,0,9999,0
1653393268897,ECE 200,006,091008,Staff,9999,0,9999,0
1653393268897,ECE 200,007,091009,Dayeh; Shadi Ahmad,9999,0,9999,0
1653393268897,ECE 200,008,091010,Fainman; Yeshaiahu,9999,0,9999,0
1653393268897,ECE 200,009,091011,Ford; Joseph Earl,9999,0,9999,0
1653393268897,ECE 200,010,091012,Franceschetti; Massimo,9999,0,9999,0
1653393268897,ECE 200,011,091013,Fullerton; Eric E,9999,0,9999,0
1653393268897,ECE 200,012,091014,Galton; Ian A,9999,0,9999,0
1653393268897,ECE 200,013,091015,Gilja; Vikash,9999,0,9999,0
1653393268897,ECE 200,014,091016,Hall; Drew A.,9999,0,9999,0
1653393268897,ECE 200,015,091017,Hsueh; Tzu-Chien,9999,0,9999,0
1653393268897,ECE 200,016,091018,Javidi; Tara,9999,0,9999,0
1653393268897,ECE 200,017,091019,Kahng; Andrew Byun,9999,0,9999,0
1653393268897,ECE 200,018,091020,Kim; Young-Han,9999,0,9999,0
1653393268897,ECE 200,019,091021,Koushanfar; Farinaz,9999,0,9999,0
1653393268897,ECE 200,020,091022,Kuzum; Duygu,9999,0,9999,0
1653393268897,ECE 200,021,091023,Le; Hanh-Phuc,9999,0,9999,0
1653393268897,ECE 200,022,091024,Lin; Bill,9999,0,9999,0
1653393268897,ECE 200,023,091025,Liu; Zhaowei,9999,0,9999,0
1653393268897,ECE 200,024,091026,Lo; Yu-Hwa,9999,0,9999,0
1653393268897,ECE 200,025,091027,Lomakin; Vitaliy,9999,0,9999,0
1653393268897,ECE 200,026,091028,Mercier; Patrick Philip,9999,0,9999,0
1653393268897,ECE 200,027,091029,Meyer; Florian,9999,0,9999,0
1653393268897,ECE 200,028,091030,Milstein; Laurence B.,9999,0,9999,0
1653393268897,ECE 200,029,091031,Mir Arabbaygi; Siavash,9999,0,9999,0
1653393268897,ECE 200,030,091032,Mookherjea; Shayan,9999,0,9999,0
1653393268897,ECE 200,031,091033,Morris; Karcher William,9999,0,9999,0
1653393268897,ECE 200,032,091034,Ng; Tse Nga,9999,0,9999,0
1653393268897,ECE 200,033,091035,Nguyen; Truong Quang,9999,0,9999,0
1653393268897,ECE 200,034,091036,Nomura; Kenji,9999,0,9999,0
1653393268897,ECE 200,035,091037,Orlitsky; Alon,9999,0,9999,0
1653393268897,ECE 200,036,091038,Pal; Piya,9999,0,9999,0
1653393268897,ECE 200,037,091039,Papen; George C.,9999,0,9999,0
1653393268897,ECE 200,038,091040,Radic; Stojan,9999,0,9999,0
1653393268897,ECE 200,039,091041,Rao; Bhaskar D.,9999,0,9999,0
1653393268897,ECE 200,040,091042,Rao; Ramesh R,9999,0,9999,0
1653393268897,ECE 200,041,091043,Rebeiz; Gabriel,9999,0,9999,0
1653393268897,ECE 200,042,091044,Sanford; John R,9999,0,9999,0
1653393268897,ECE 200,043,091045,Siegel; Paul H.,9999,0,9999,0
1653393268897,ECE 200,044,091046,Sievenpiper; Daniel F.,9999,0,9999,0
1653393268897,ECE 200,045,091047,Sworder; David D.,9999,0,9999,0
1653393268897,ECE 200,046,091048,Taur; Yuan,9999,0,9999,0
1653393268897,ECE 200,047,091049,Touri; Behrouz,9999,0,9999,0
1653393268897,ECE 200,048,091050,Trivedi; Mohan M.,9999,0,9999,0
1653393268897,ECE 200,049,091051,Vardy; Alexander,9999,0,9999,0
1653393268897,ECE 200,050,091052,Vasconcelos; Nuno,9999,0,9999,0
1653393268897,ECE 200,051,091053,Wang; Xiaolong,9999,0,9999,0
1653393268897,ECE 200,052,091054,Xie; Pengtao,9999,0,9999,0
1653393268897,ECE 200,053,091055,Yip; Michael,9999,0,9999,0
1653393268897,ECE 200,054,091056,Zeger; Kenneth A.,9999,0,9999,0
1653393268897,ECE 200,055,091057,Zhang; Xinyu,9999,0,9999,0
1653393268897,ECE 200,056,091058,Turakhia; Yatish Girish,9999,0,9999,0
1653393268897,ECE 200,057,091059,Kang; Mingu,9999,0,9999,0
1653393268897,ECE 200,058,091060,Shi; Yuanyuan,9999,0,9999,0
1653393268897,ECE 200,059,091061,Wang; Edward Jay,9999,0,9999,0
1653393268897,ECE 200,060,091062,Zheng; Yang,9999,0,9999,0
1653393269422,ECE 203,A00,091065,Mercier; Patrick Philip,0,0,0,0
1653393269955,ECE 207A,A00,091605,Liu; Thomas Tao-Ming,0,0,0,0
1653393270480,ECE 212AN,A00,091068,Nomura; Kenji,0,0,0,0
1653393271008,ECE 222A,A00,091069,Rebeiz; Gabriel,0,0,0,0
1653393271532,ECE 225A,A00,091070,Orlitsky; Alon,0,0,0,0
1653393272062,ECE 230A,A00,091071,Nomura; Kenji,0,0,0,0
1653393272590,ECE 236A,A00,091072,Dayeh; Shadi Ahmad,0,0,0,0
1653393273113,ECE 238A,A00,091073,Luo; Jian,0,0,0,0
1653393273113,ECE 238A,B00,091074,Luo; Jian,0,0,0,0
1653393273640,ECE 240A,A00,091075,Radic; Stojan,0,0,0,0
1653393274261,ECE 247A,A00,091592,Shi; Lingyan,0,0,0,0
1653393274789,ECE 250,A00,091076,Touri; Behrouz,0,0,0,0
1653393275326,ECE 251C,A00,091078,Nguyen; Truong Quang,0,0,0,0
1653393275857,ECE 253,A00,091079,Cosman; Pamela C.,0,0,0,0
1653393276392,ECE 255A,A00,091080,Orlitsky; Alon,0,0,0,0
1653393276921,ECE 257A,A00,091081,Zhang; Xinyu,0,0,0,0
1653393277446,ECE 260A,A01,091084,Eldon; John,0,0,0,0
1653393277971,ECE 264C,A00,091085,Galton; Ian A,0,0,0,0
1653393278501,ECE 265C,A00,094889,Presti; Calogero Davide,0,0,0,9
1653393279027,ECE 266,A01,091087,Hall; Drew A.,0,0,0,0
1653393280079,ECE 271A,A00,091090,Vasconcelos; Nuno,0,0,0,0
1653393280602,ECE 272B,A00,091091,Sworder; David D.,0,0,0,0
1653393281127,ECE 275A,A00,091092,Meyer; Florian,0,0,0,0
1653393281656,ECE 277,A00,091093,An; Cheolhong,0,0,0,0
1653393282181,ECE 283,A00,091094,Le; Hanh-Phuc,0,0,0,0
1653393282710,ECE 284,A00,091095,Kang; Mingu,0,0,0,0
1653393282710,ECE 284,B00,091096,Wang; Edward Jay,0,0,0,0
1653393283239,ECE 285,A00,094334,Touri; Behrouz,0,0,0,0
1653393283764,ECE 289,A00,091097,Whelan; David Arthur,0,0,0,0
1653393284297,MATH 200A,A00,087414,Salehi Golsefidy; Alireza,7,0,8,1
1653393284830,MATH 202A,A00,087415,Gill; Philip E.,3,0,8,5
1653393285354,MATH 203A,A00,087416,Oprea; Dragos N.,6,0,8,2
1653393285881,MATH 204A,A00,087417,Kedlaya; Kiran S.,6,0,8,2
1653393286408,MATH 205,A00,087418,Sorensen; Claus M,6,0,8,2
1653393286939,MATH 206A,A00,087419,Izadi; Elham,7,0,8,1
1653393287472,MATH 207A,A00,087420,Mohammadi; Amir,6,0,8,2
1653393287999,MATH 208,A00,087421,Staff,9,0,10,1
1653393288522,MATH 209,A00,087422,Staff,10,0,10,0
1653393289056,MATH 218,A00,087423,Staff,10,0,10,0
1653393289581,MATH 220A,A00,087424,Novak; Jonathan I,7,0,8,1
1653393290106,MATH 231A,A00,087425,Bejenaru; Ioan,4,0,8,4
1653393290634,MATH 240A,A00,087426,Ebenfelt; Peter F,5,0,8,3
1653393291159,MATH 243,A00,087427,Staff,9,0,10,1
1653393291687,MATH 248,A00,087429,Staff,10,0,10,0
1653393292214,MATH 250A,A00,087430,Spolaor; Luca,5,0,8,3
1653393292743,MATH 257A,A00,087431,Spolaor; Luca,7,0,8,1
1653393293269,MATH 258,A00,087432,Staff,9,0,10,1
1653393293795,MATH 264A,A00,087433,Warnke; Lutz Peter,5,0,8,3
1653393294320,MATH 268,A00,087434,Staff,15,0,15,0
1653393294846,MATH 269,A00,087435,Staff,14,0,15,1
1653393295370,MATH 270A,A00,087436,Nie; Jiawang,0,0,8,8
1653393295893,MATH 272A,A00,087437,Tian; Xiaochuan,2,0,8,6
1653393296421,MATH 274,A01,087439,Cheng; Li-Tien,9,0,10,1
1653393296421,MATH 274,A02,087440,Cheng; Li-Tien,10,0,10,0
1653393296945,MATH 278A,A00,087441,Staff,8,0,10,2
1653393297476,MATH 278B,A00,087442,Staff,8,0,10,2
1653393298002,MATH 278C,A00,087443,Staff,8,0,10,2
1653393298530,MATH 280A,A00,087444,Zheng; Tianyi,0,0,8,8
1653393299056,MATH 281A,A00,087445,Bradic; Jelena,0,0,8,8
1653393299585,MATH 282A,A00,087446,Zhang; Danna,0,0,8,8
1653393300115,MATH 283,A00,087447,Tesler; Glenn,0,0,0,13
1653393300644,MATH 286,A00,087448,Kemp; Todd Aahron,6,0,8,2
1653393301175,MATH 287D,A00,087449,Bradic; Jelena,8,0,8,0
1653393301701,MATH 288,A00,087450,Staff,14,0,15,1
1653393301701,MATH 288,B00,087451,Staff,15,0,15,0
1653393301701,MATH 288,C00,087452,Staff,15,0,15,0
1653393302225,MATH 290A,A00,087453,Xu; Zhouli,7,0,8,1
1653393302754,MATH 291A,A00,087454,Xu; Zhouli,7,0,8,1
1653393303289,MATH 292,A00,087455,Staff,10,0,10,0
1653393303816,MATH 295,A00,087456,Staff,50,0,50,0
1653393304354,MATH 297,001,087457,Staff,998,0,999,1
1653393868646,COGS 200,A01,087991,Staff,48,0,50,2
1653393869182,COGS 201,A01,094504,Rangel; Lara M,17,0,25,8
1653393869709,COGS 203,A00,087992,Coulson; Seana M,19,0,20,1
1653393870238,COGS 210A,001,087993,Greene; Deanna Jacquelyn,9998,0,9999,1
1653393870238,COGS 210A,002,087994,Saygin; Ayse P,9999,0,9999,0
1653393870238,COGS 210A,003,087995,Xia; Haijun,9999,0,9999,0
1653393870238,COGS 210A,004,087996,Nitz; Douglas A.,9999,0,9999,0
1653393870238,COGS 210A,005,087997,Hollan; James D.,9999,0,9999,0
1653393870238,COGS 210A,006,087998,Deak; Gedeon O.,9998,0,9999,1
1653393870238,COGS 210A,007,087999,Rossano; Federico,9999,0,9999,0
1653393870764,COGS 211A,A00,088000,Coulson; Seana M,9997,0,9999,2
1653393871290,COGS 229,A00,088002,Staff,23,0,25,2
1653393871816,COGS 260,B00,094231,Staff,17,0,20,3
1653393871816,COGS 260,A00,088004,Nitz; Douglas A.,9998,0,9999,1
1653393872342,CSE 202,A00,090110,Paturi; Ramamohan,0,0,0,0
1653393872342,CSE 202,B00,090111,Paturi; Ramamohan,0,0,0,0
1653393872871,CSE 207B,A00,090112,Heninger; Nadia A,0,0,0,0
1653393873396,CSE 208,A00,094858,Micciancio; Daniele,0,0,0,0
1653393873922,CSE 210,A00,090113,Powell; Thomas Allan,0,0,0,0
1653393874449,CSE 219,A00,090898,Staff,0,0,0,0
1653393874979,CSE 221,A00,090114,Zhou; Yuan-Yuan,0,0,0,0
1653393875516,CSE 229A,A00,090115,Porter; George M,0,0,0,0
1653393876040,CSE 229C,A00,090116,Savage; Stefan,0,0,0,0
1653393876564,CSE 230,A00,090117,Jhala; Ranjit,0,0,0,0
1653393877091,CSE 232,A00,090118,Papakonstantinou; Yannis,0,0,0,0
1653393877615,CSE 239A,A00,090121,Kumar; Arun Kumar,0,0,0,0
1653393878141,CSE 239B,A00,090122,Jhala; Ranjit,0,0,0,0
1653393878671,CSE 240A,A00,090123,Zhao; Jishen,0,0,189,189
1653393879198,CSE 243A,A00,090124,Orailoglu; Alex,3,0,15,12
1653393879729,CSE 249B,A00,090125,Kahng; Andrew Byun,14,0,20,6
1653393880254,CSE 250A,A00,090126,Berg-Kirkpatrick; Taylor D,0,0,0,0
1653393880782,CSE 252A,A00,090127,Ochoa; Benjamin Lawrence,0,0,0,0
1653393881307,CSE 258,A01,090129,McAuley; Julian John,0,0,0,0
1653393881833,CSE 258R,A01,090131,McAuley; Julian John,0,0,0,0
1653393882358,CSE 274,A00,090132,Ramamoorthi; Ravi,0,0,0,0
1653393882884,CSE 276A,A00,090133,Christensen; Henrik I,0,0,0,0
1653393883411,CSE 276C,A00,090134,Christensen; Henrik I,0,0,0,0
1653393883941,CSE 290,A00,090135,Bafna; Vineet,0,0,0,0
1653393883941,CSE 290,B00,090136,Ramamoorthi; Ravi,0,0,0,0
1653393883941,CSE 290,C00,090137,Li; Tzumao,10,0,10,0
1653393883941,CSE 290,D00,090138,Zhou; Yuan-Yuan,10,0,10,0
1653393883941,CSE 290,E00,090139,Christensen; Henrik I,10,0,10,0
1653393883941,CSE 290,F00,094053,Shalev; Aaron D,0,0,0,0
1653393884467,CSE 291,A00,090140,Munyaka; Imani N. S.,0,0,0,0
1653393884467,CSE 291,B00,094880,Yu; Qi,0,0,0,0
1653393884467,CSE 291,C00,090142,Pannuto; Patrick William,0,0,0,0
1653393884467,CSE 291,D00,094881,Zhang; Yiying,0,0,0,0
1653393884467,CSE 291,E00,095118,Su; Hao,0,0,0,0
1653393885005,CSE 293,001,094905,Bafna; Vineet,9999,0,9999,0
1653393885005,CSE 293,002,094906,Bellare; Mihir,9999,0,9999,0
1653393885005,CSE 293,003,094907,Berg-Kirkpatrick; Taylor D,9999,0,9999,0
1653393885005,CSE 293,004,094908,Christensen; Henrik I,9999,0,9999,0
1653393885005,CSE 293,005,094909,Cottrell; Garrison W,9999,0,9999,0
1653393885005,CSE 293,006,094910,Deutsch; Alin Bernard,9999,0,9999,0
1653393885005,CSE 293,007,094911,Esmaeilzadeh; Hadi,9999,0,9999,0
1653393885005,CSE 293,008,094912,Freund; Yoav,9999,0,9999,0
1653393885005,CSE 293,009,094913,Griswold; William G.,9999,0,9999,0
1653393885005,CSE 293,010,094914,Gymrek; Melissa Ann,9999,0,9999,0
1653393885005,CSE 293,011,094915,Heninger; Nadia A,9999,0,9999,0
1653393885005,CSE 293,012,094916,Impagliazzo; Russell,9999,0,9999,0
1653393885005,CSE 293,013,094917,Jhala; Ranjit,9999,0,9999,0
1653393885005,CSE 293,014,094918,Kahng; Andrew Byun,9999,0,9999,0
1653393885005,CSE 293,015,094919,Kane; Daniel Mertz,9999,0,9999,0
1653393885005,CSE 293,016,094920,Kriegman; David J,9999,0,9999,0
1653393885005,CSE 293,017,094921,Kumar; Arun Kumar,9999,0,9999,0
1653393885005,CSE 293,018,094922,Lerner; Sorin,9999,0,9999,0
1653393885005,CSE 293,019,094923,Lovett; Shachar,9999,0,9999,0
1653393885005,CSE 293,020,094924,McAuley; Julian John,9999,0,9999,0
1653393885005,CSE 293,021,094925,Micciancio; Daniele,9999,0,9999,0
1653393885005,CSE 293,022,094926,Orailoglu; Alex,9999,0,9999,0
1653393885005,CSE 293,023,094927,Paturi; Ramamohan,9999,0,9999,0
1653393885005,CSE 293,024,094928,Polikarpova; Nadezhda,9999,0,9999,0
1653393885005,CSE 293,025,094929,Politz; Joseph Gibbs,9999,0,9999,0
1653393885005,CSE 293,026,094930,Porter; George M,9999,0,9999,0
1653393885005,CSE 293,027,094931,Porter; Leonard Emerson,9999,0,9999,0
1653393885005,CSE 293,028,094932,Ramamoorthi; Ravi,9999,0,9999,0
1653393885005,CSE 293,029,094933,Sahoo; Debashis,9999,0,9999,0
1653393885005,CSE 293,030,094934,Saul; Lawrence,9999,0,9999,0
1653393885005,CSE 293,031,094935,Savage; Stefan,9999,0,9999,0
1653393885005,CSE 293,032,094936,Schulze; Jurgen P.,9999,0,9999,0
1653393885005,CSE 293,033,094937,Snoeren; Alex C.,9999,0,9999,0
1653393885005,CSE 293,034,094938,Shang; Jingbo,9999,0,9999,0
1653393885005,CSE 293,035,094939,Stefan; Deian,9999,0,9999,0
1653393885005,CSE 293,036,094940,Su; Hao,9999,0,9999,0
1653393885005,CSE 293,037,094941,Swanson; Steven James,9999,0,9999,0
1653393885005,CSE 293,038,094942,Tullsen; Dean Michael,9999,0,9999,0
1653393885005,CSE 293,039,094943,Voelker; Geoffrey M.,9999,0,9999,0
1653393885005,CSE 293,040,094944,Zhao; Jishen,9999,0,9999,0
1653393885005,CSE 293,041,094945,Zhou; Yuan-Yuan,9999,0,9999,0
1653393885005,CSE 293,042,094946,Gao; Sicun,9998,0,9999,1
1653393885005,CSE 293,043,094947,Weibel; Nadir,9999,0,9999,0
1653393885005,CSE 293,044,094948,Gupta; Rajesh K.,9999,0,9999,0
1653393885532,CSE 294,A00,090143,Porter; George M,9,0,10,1
1653393886060,DSE 200,A00,091799,Staff,50,0,50,0
1653393886597,DSE 203,A00,091800,Gupta; Amarnath,30,0,30,0
1653393887120,DSE 250,A00,091801,Deutsch; Alin Bernard,30,0,30,0
1653393887644,DSE 290,A00,091802,Altintas De Callaf; Ilkay,50,0,50,0
1653393888227,ECE 200,001,091003,Antipa; Nicholas A,9999,0,9999,0
1653393888227,ECE 200,002,091004,Atanasov; Nikolay A.,9999,0,9999,0
1653393888227,ECE 200,003,091005,Bharadia; Dinesh,9999,0,9999,0
1653393888227,ECE 200,004,091006,Cheng; Chung Kuan,9999,0,9999,0
1653393888227,ECE 200,005,091007,Cosman; Pamela C.,9999,0,9999,0
1653393888227,ECE 200,006,091008,Staff,9999,0,9999,0
1653393888227,ECE 200,007,091009,Dayeh; Shadi Ahmad,9999,0,9999,0
1653393888227,ECE 200,008,091010,Fainman; Yeshaiahu,9999,0,9999,0
1653393888227,ECE 200,009,091011,Ford; Joseph Earl,9999,0,9999,0
1653393888227,ECE 200,010,091012,Franceschetti; Massimo,9999,0,9999,0
1653393888227,ECE 200,011,091013,Fullerton; Eric E,9999,0,9999,0
1653393888227,ECE 200,012,091014,Galton; Ian A,9999,0,9999,0
1653393888227,ECE 200,013,091015,Gilja; Vikash,9999,0,9999,0
1653393888227,ECE 200,014,091016,Hall; Drew A.,9999,0,9999,0
1653393888227,ECE 200,015,091017,Hsueh; Tzu-Chien,9999,0,9999,0
1653393888227,ECE 200,016,091018,Javidi; Tara,9999,0,9999,0
1653393888227,ECE 200,017,091019,Kahng; Andrew Byun,9999,0,9999,0
1653393888227,ECE 200,018,091020,Kim; Young-Han,9999,0,9999,0
1653393888227,ECE 200,019,091021,Koushanfar; Farinaz,9999,0,9999,0
1653393888227,ECE 200,020,091022,Kuzum; Duygu,9999,0,9999,0
1653393888227,ECE 200,021,091023,Le; Hanh-Phuc,9999,0,9999,0
1653393888227,ECE 200,022,091024,Lin; Bill,9999,0,9999,0
1653393888227,ECE 200,023,091025,Liu; Zhaowei,9999,0,9999,0
1653393888227,ECE 200,024,091026,Lo; Yu-Hwa,9999,0,9999,0
1653393888227,ECE 200,025,091027,Lomakin; Vitaliy,9999,0,9999,0
1653393888227,ECE 200,026,091028,Mercier; Patrick Philip,9999,0,9999,0
1653393888227,ECE 200,027,091029,Meyer; Florian,9999,0,9999,0
1653393888227,ECE 200,028,091030,Milstein; Laurence B.,9999,0,9999,0
1653393888227,ECE 200,029,091031,Mir Arabbaygi; Siavash,9999,0,9999,0
1653393888227,ECE 200,030,091032,Mookherjea; Shayan,9999,0,9999,0
1653393888227,ECE 200,031,091033,Morris; Karcher William,9999,0,9999,0
1653393888227,ECE 200,032,091034,Ng; Tse Nga,9999,0,9999,0
1653393888227,ECE 200,033,091035,Nguyen; Truong Quang,9999,0,9999,0
1653393888227,ECE 200,034,091036,Nomura; Kenji,9999,0,9999,0
1653393888227,ECE 200,035,091037,Orlitsky; Alon,9999,0,9999,0
1653393888227,ECE 200,036,091038,Pal; Piya,9999,0,9999,0
1653393888227,ECE 200,037,091039,Papen; George C.,9999,0,9999,0
1653393888227,ECE 200,038,091040,Radic; Stojan,9999,0,9999,0
1653393888227,ECE 200,039,091041,Rao; Bhaskar D.,9999,0,9999,0
1653393888227,ECE 200,040,091042,Rao; Ramesh R,9999,0,9999,0
1653393888227,ECE 200,041,091043,Rebeiz; Gabriel,9999,0,9999,0
1653393888227,ECE 200,042,091044,Sanford; John R,9999,0,9999,0
1653393888227,ECE 200,043,091045,Siegel; Paul H.,9999,0,9999,0
1653393888227,ECE 200,044,091046,Sievenpiper; Daniel F.,9999,0,9999,0
1653393888227,ECE 200,045,091047,Sworder; David D.,9999,0,9999,0
1653393888227,ECE 200,046,091048,Taur; Yuan,9999,0,9999,0
1653393888227,ECE 200,047,091049,Touri; Behrouz,9999,0,9999,0
1653393888227,ECE 200,048,091050,Trivedi; Mohan M.,9999,0,9999,0
1653393888227,ECE 200,049,091051,Vardy; Alexander,9999,0,9999,0
1653393888227,ECE 200,050,091052,Vasconcelos; Nuno,9999,0,9999,0
1653393888227,ECE 200,051,091053,Wang; Xiaolong,9999,0,9999,0
1653393888227,ECE 200,052,091054,Xie; Pengtao,9999,0,9999,0
1653393888227,ECE 200,053,091055,Yip; Michael,9999,0,9999,0
1653393888227,ECE 200,054,091056,Zeger; Kenneth A.,9999,0,9999,0
1653393888227,ECE 200,055,091057,Zhang; Xinyu,9999,0,9999,0
1653393888227,ECE 200,056,091058,Turakhia; Yatish Girish,9999,0,9999,0
1653393888227,ECE 200,057,091059,Kang; Mingu,9999,0,9999,0
1653393888227,ECE 200,058,091060,Shi; Yuanyuan,9999,0,9999,0
1653393888227,ECE 200,059,091061,Wang; Edward Jay,9999,0,9999,0
1653393888227,ECE 200,060,091062,Zheng; Yang,9999,0,9999,0
1653393888757,ECE 203,A00,091065,Mercier; Patrick Philip,0,0,0,0
1653393889290,ECE 207A,A00,091605,Liu; Thomas Tao-Ming,0,0,0,0
1653393889825,ECE 212AN,A00,091068,Nomura; Kenji,0,0,0,0
1653393890352,ECE 222A,A00,091069,Rebeiz; Gabriel,0,0,0,0
1653393890878,ECE 225A,A00,091070,Orlitsky; Alon,0,0,0,0
1653393891402,ECE 230A,A00,091071,Nomura; Kenji,0,0,0,0
1653393891929,ECE 236A,A00,091072,Dayeh; Shadi Ahmad,0,0,0,0
1653393892459,ECE 238A,A00,091073,Luo; Jian,0,0,0,0
1653393892459,ECE 238A,B00,091074,Luo; Jian,0,0,0,0
1653393892991,ECE 240A,A00,091075,Radic; Stojan,0,0,0,0
1653393893519,ECE 247A,A00,091592,Shi; Lingyan,0,0,0,0
1653393894044,ECE 250,A00,091076,Touri; Behrouz,0,0,0,0
1653393894569,ECE 251C,A00,091078,Nguyen; Truong Quang,0,0,0,0
1653393895098,ECE 253,A00,091079,Cosman; Pamela C.,0,0,0,0
1653393895622,ECE 255A,A00,091080,Orlitsky; Alon,0,0,0,0
1653393896151,ECE 257A,A00,091081,Zhang; Xinyu,0,0,0,0
1653393896681,ECE 260A,A01,091084,Eldon; John,0,0,0,0
1653393897209,ECE 264C,A00,091085,Galton; Ian A,0,0,0,0
1653393897734,ECE 265C,A00,094889,Presti; Calogero Davide,0,0,0,9
1653393898263,ECE 266,A01,091087,Hall; Drew A.,0,0,0,0
1653393899318,ECE 271A,A00,091090,Vasconcelos; Nuno,0,0,0,0
1653393899846,ECE 272B,A00,091091,Sworder; David D.,0,0,0,0
1653393900373,ECE 275A,A00,091092,Meyer; Florian,0,0,0,0
1653393900898,ECE 277,A00,091093,An; Cheolhong,0,0,0,0
1653393901426,ECE 283,A00,091094,Le; Hanh-Phuc,0,0,0,0
1653393901949,ECE 284,A00,091095,Kang; Mingu,0,0,0,0
1653393901949,ECE 284,B00,091096,Wang; Edward Jay,0,0,0,0
1653393902483,ECE 285,A00,094334,Touri; Behrouz,0,0,0,0
1653393903007,ECE 289,A00,091097,Whelan; David Arthur,0,0,0,0
1653393903531,MATH 200A,A00,087414,Salehi Golsefidy; Alireza,7,0,8,1
1653393904061,MATH 202A,A00,087415,Gill; Philip E.,3,0,8,5
1653393904589,MATH 203A,A00,087416,Oprea; Dragos N.,6,0,8,2
1653393905112,MATH 204A,A00,087417,Kedlaya; Kiran S.,6,0,8,2
1653393905637,MATH 205,A00,087418,Sorensen; Claus M,6,0,8,2
1653393906159,MATH 206A,A00,087419,Izadi; Elham,7,0,8,1
1653393906689,MATH 207A,A00,087420,Mohammadi; Amir,6,0,8,2
1653393907213,MATH 208,A00,087421,Staff,9,0,10,1
1653393907736,MATH 209,A00,087422,Staff,10,0,10,0
1653393908264,MATH 218,A00,087423,Staff,10,0,10,0
1653393908787,MATH 220A,A00,087424,Novak; Jonathan I,7,0,8,1
1653393909310,MATH 231A,A00,087425,Bejenaru; Ioan,4,0,8,4
1653393909835,MATH 240A,A00,087426,Ebenfelt; Peter F,5,0,8,3
1653393910362,MATH 243,A00,087427,Staff,9,0,10,1
1653393910887,MATH 248,A00,087429,Staff,10,0,10,0
1653393911411,MATH 250A,A00,087430,Spolaor; Luca,5,0,8,3
1653393911946,MATH 257A,A00,087431,Spolaor; Luca,7,0,8,1
1653393912471,MATH 258,A00,087432,Staff,9,0,10,1
1653393913002,MATH 264A,A00,087433,Warnke; Lutz Peter,5,0,8,3
1653393913529,MATH 268,A00,087434,Staff,15,0,15,0
1653393914066,MATH 269,A00,087435,Staff,14,0,15,1
1653393914592,MATH 270A,A00,087436,Nie; Jiawang,0,0,8,8
1653393915129,MATH 272A,A00,087437,Tian; Xiaochuan,2,0,8,6
1653393915659,MATH 274,A01,087439,Cheng; Li-Tien,9,0,10,1
1653393915659,MATH 274,A02,087440,Cheng; Li-Tien,10,0,10,0
1653393916184,MATH 278A,A00,087441,Staff,8,0,10,2
1653393916707,MATH 278B,A00,087442,Staff,8,0,10,2
1653393917230,MATH 278C,A00,087443,Staff,8,0,10,2
1653393917753,MATH 280A,A00,087444,Zheng; Tianyi,0,0,8,8
1653393918282,MATH 281A,A00,087445,Bradic; Jelena,0,0,8,8
1653393918811,MATH 282A,A00,087446,Zhang; Danna,0,0,8,8
1653393919421,MATH 283,A00,087447,Tesler; Glenn,0,0,0,13
1653393919948,MATH 286,A00,087448,Kemp; Todd Aahron,6,0,8,2
1653393920482,MATH 287D,A00,087449,Bradic; Jelena,8,0,8,0
1653393921011,MATH 288,A00,087450,Staff,14,0,15,1
1653393921011,MATH 288,B00,087451,Staff,15,0,15,0
1653393921011,MATH 288,C00,087452,Staff,15,0,15,0
1653393921544,MATH 290A,A00,087453,Xu; Zhouli,7,0,8,1
1653393922073,MATH 291A,A00,087454,Xu; Zhouli,7,0,8,1
1653393922604,MATH 292,A00,087455,Staff,10,0,10,0
1653393923145,MATH 295,A00,087456,Staff,50,0,50,0
1653393923678,MATH 297,001,087457,Staff,998,0,999,1
1653394485081,COGS 200,A01,087991,Staff,48,0,50,2
1653394485606,COGS 201,A01,094504,Rangel; Lara M,17,0,25,8
1653394486130,COGS 203,A00,087992,Coulson; Seana M,19,0,20,1
1653394486656,COGS 210A,001,087993,Greene; Deanna Jacquelyn,9998,0,9999,1
1653394486656,COGS 210A,002,087994,Saygin; Ayse P,9999,0,9999,0
1653394486656,COGS 210A,003,087995,Xia; Haijun,9999,0,9999,0
1653394486656,COGS 210A,004,087996,Nitz; Douglas A.,9999,0,9999,0
1653394486656,COGS 210A,005,087997,Hollan; James D.,9999,0,9999,0
1653394486656,COGS 210A,006,087998,Deak; Gedeon O.,9998,0,9999,1
1653394486656,COGS 210A,007,087999,Rossano; Federico,9999,0,9999,0
1653394487180,COGS 211A,A00,088000,Coulson; Seana M,9997,0,9999,2
1653394487706,COGS 229,A00,088002,Staff,23,0,25,2
1653394488232,COGS 260,B00,094231,Staff,17,0,20,3
1653394488232,COGS 260,A00,088004,Nitz; Douglas A.,9998,0,9999,1
1653394488764,CSE 202,A00,090110,Paturi; Ramamohan,0,0,0,0
1653394488764,CSE 202,B00,090111,Paturi; Ramamohan,0,0,0,0
1653394489289,CSE 207B,A00,090112,Heninger; Nadia A,0,0,0,0
1653394489820,CSE 208,A00,094858,Micciancio; Daniele,0,0,0,0
1653394490344,CSE 210,A00,090113,Powell; Thomas Allan,0,0,0,0
1653394490882,CSE 219,A00,090898,Staff,0,0,0,0
1653394491407,CSE 221,A00,090114,Zhou; Yuan-Yuan,0,0,0,0
1653394491936,CSE 229A,A00,090115,Porter; George M,0,0,0,0
1653394492461,CSE 229C,A00,090116,Savage; Stefan,0,0,0,0
1653394492991,CSE 230,A00,090117,Jhala; Ranjit,0,0,0,0
1653394493516,CSE 232,A00,090118,Papakonstantinou; Yannis,0,0,0,0
1653394494039,CSE 239A,A00,090121,Kumar; Arun Kumar,0,0,0,0
1653394494567,CSE 239B,A00,090122,Jhala; Ranjit,0,0,0,0
1653394495090,CSE 240A,A00,090123,Zhao; Jishen,0,0,189,189
1653394495613,CSE 243A,A00,090124,Orailoglu; Alex,3,0,15,12
1653394496138,CSE 249B,A00,090125,Kahng; Andrew Byun,14,0,20,6
1653394496661,CSE 250A,A00,090126,Berg-Kirkpatrick; Taylor D,0,0,0,0
1653394497205,CSE 252A,A00,090127,Ochoa; Benjamin Lawrence,0,0,0,0
1653394497729,CSE 258,A01,090129,McAuley; Julian John,0,0,0,0
1653394498254,CSE 258R,A01,090131,McAuley; Julian John,0,0,0,0
1653394498783,CSE 274,A00,090132,Ramamoorthi; Ravi,0,0,0,0
1653394499307,CSE 276A,A00,090133,Christensen; Henrik I,0,0,0,0
1653394499838,CSE 276C,A00,090134,Christensen; Henrik I,0,0,0,0
1653394500370,CSE 290,A00,090135,Bafna; Vineet,0,0,0,0
1653394500370,CSE 290,B00,090136,Ramamoorthi; Ravi,0,0,0,0
1653394500370,CSE 290,C00,090137,Li; Tzumao,10,0,10,0
1653394500370,CSE 290,D00,090138,Zhou; Yuan-Yuan,10,0,10,0
1653394500370,CSE 290,E00,090139,Christensen; Henrik I,10,0,10,0
1653394500370,CSE 290,F00,094053,Shalev; Aaron D,0,0,0,0
1653394500899,CSE 291,A00,090140,Munyaka; Imani N. S.,0,0,0,0
1653394500899,CSE 291,B00,094880,Yu; Qi,0,0,0,0
1653394500899,CSE 291,C00,090142,Pannuto; Patrick William,0,0,0,0
1653394500899,CSE 291,D00,094881,Zhang; Yiying,0,0,0,0
1653394500899,CSE 291,E00,095118,Su; Hao,0,0,0,0
1653394501465,CSE 293,001,094905,Bafna; Vineet,9999,0,9999,0
1653394501465,CSE 293,002,094906,Bellare; Mihir,9999,0,9999,0
1653394501465,CSE 293,003,094907,Berg-Kirkpatrick; Taylor D,9999,0,9999,0
1653394501465,CSE 293,004,094908,Christensen; Henrik I,9999,0,9999,0
1653394501465,CSE 293,005,094909,Cottrell; Garrison W,9999,0,9999,0
1653394501465,CSE 293,006,094910,Deutsch; Alin Bernard,9999,0,9999,0
1653394501465,CSE 293,007,094911,Esmaeilzadeh; Hadi,9999,0,9999,0
1653394501465,CSE 293,008,094912,Freund; Yoav,9999,0,9999,0
1653394501465,CSE 293,009,094913,Griswold; William G.,9999,0,9999,0
1653394501465,CSE 293,010,094914,Gymrek; Melissa Ann,9999,0,9999,0
1653394501465,CSE 293,011,094915,Heninger; Nadia A,9999,0,9999,0
1653394501465,CSE 293,012,094916,Impagliazzo; Russell,9999,0,9999,0
1653394501465,CSE 293,013,094917,Jhala; Ranjit,9999,0,9999,0
1653394501465,CSE 293,014,094918,Kahng; Andrew Byun,9999,0,9999,0
1653394501465,CSE 293,015,094919,Kane; Daniel Mertz,9999,0,9999,0
1653394501465,CSE 293,016,094920,Kriegman; David J,9999,0,9999,0
1653394501465,CSE 293,017,094921,Kumar; Arun Kumar,9999,0,9999,0
1653394501465,CSE 293,018,094922,Lerner; Sorin,9999,0,9999,0
1653394501465,CSE 293,019,094923,Lovett; Shachar,9999,0,9999,0
1653394501465,CSE 293,020,094924,McAuley; Julian John,9999,0,9999,0
1653394501465,CSE 293,021,094925,Micciancio; Daniele,9999,0,9999,0
1653394501465,CSE 293,022,094926,Orailoglu; Alex,9999,0,9999,0
1653394501465,CSE 293,023,094927,Paturi; Ramamohan,9999,0,9999,0
1653394501465,CSE 293,024,094928,Polikarpova; Nadezhda,9999,0,9999,0
1653394501465,CSE 293,025,094929,Politz; Joseph Gibbs,9999,0,9999,0
1653394501465,CSE 293,026,094930,Porter; George M,9999,0,9999,0
1653394501465,CSE 293,027,094931,Porter; Leonard Emerson,9999,0,9999,0
1653394501465,CSE 293,028,094932,Ramamoorthi; Ravi,9999,0,9999,0
1653394501465,CSE 293,029,094933,Sahoo; Debashis,9999,0,9999,0
1653394501465,CSE 293,030,094934,Saul; Lawrence,9999,0,9999,0
1653394501465,CSE 293,031,094935,Savage; Stefan,9999,0,9999,0
1653394501465,CSE 293,032,094936,Schulze; Jurgen P.,9999,0,9999,0
1653394501465,CSE 293,033,094937,Snoeren; Alex C.,9999,0,9999,0
1653394501465,CSE 293,034,094938,Shang; Jingbo,9999,0,9999,0
1653394501465,CSE 293,035,094939,Stefan; Deian,9999,0,9999,0
1653394501465,CSE 293,036,094940,Su; Hao,9999,0,9999,0
1653394501465,CSE 293,037,094941,Swanson; Steven James,9999,0,9999,0
1653394501465,CSE 293,038,094942,Tullsen; Dean Michael,9999,0,9999,0
1653394501465,CSE 293,039,094943,Voelker; Geoffrey M.,9999,0,9999,0
1653394501465,CSE 293,040,094944,Zhao; Jishen,9999,0,9999,0
1653394501465,CSE 293,041,094945,Zhou; Yuan-Yuan,9999,0,9999,0
1653394501465,CSE 293,042,094946,Gao; Sicun,9998,0,9999,1
1653394501465,CSE 293,043,094947,Weibel; Nadir,9999,0,9999,0
1653394501465,CSE 293,044,094948,Gupta; Rajesh K.,9999,0,9999,0
1653394501993,CSE 294,A00,090143,Porter; George M,9,0,10,1
1653394502521,DSE 200,A00,091799,Staff,50,0,50,0
1653394503044,DSE 203,A00,091800,Gupta; Amarnath,30,0,30,0
1653394503572,DSE 250,A00,091801,Deutsch; Alin Bernard,30,0,30,0
1653394504099,DSE 290,A00,091802,Altintas De Callaf; Ilkay,50,0,50,0
1653394504689,ECE 200,001,091003,Antipa; Nicholas A,9999,0,9999,0
1653394504689,ECE 200,002,091004,Atanasov; Nikolay A.,9999,0,9999,0
1653394504689,ECE 200,003,091005,Bharadia; Dinesh,9999,0,9999,0
1653394504689,ECE 200,004,091006,Cheng; Chung Kuan,9999,0,9999,0
1653394504689,ECE 200,005,091007,Cosman; Pamela C.,9999,0,9999,0
1653394504689,ECE 200,006,091008,Staff,9999,0,9999,0
1653394504689,ECE 200,007,091009,Dayeh; Shadi Ahmad,9999,0,9999,0
1653394504689,ECE 200,008,091010,Fainman; Yeshaiahu,9999,0,9999,0
1653394504689,ECE 200,009,091011,Ford; Joseph Earl,9999,0,9999,0
1653394504689,ECE 200,010,091012,Franceschetti; Massimo,9999,0,9999,0
1653394504689,ECE 200,011,091013,Fullerton; Eric E,9999,0,9999,0
1653394504689,ECE 200,012,091014,Galton; Ian A,9999,0,9999,0
1653394504689,ECE 200,013,091015,Gilja; Vikash,9999,0,9999,0
1653394504689,ECE 200,014,091016,Hall; Drew A.,9999,0,9999,0
1653394504689,ECE 200,015,091017,Hsueh; Tzu-Chien,9999,0,9999,0
1653394504689,ECE 200,016,091018,Javidi; Tara,9999,0,9999,0
1653394504689,ECE 200,017,091019,Kahng; Andrew Byun,9999,0,9999,0
1653394504689,ECE 200,018,091020,Kim; Young-Han,9999,0,9999,0
1653394504689,ECE 200,019,091021,Koushanfar; Farinaz,9999,0,9999,0
1653394504689,ECE 200,020,091022,Kuzum; Duygu,9999,0,9999,0
1653394504689,ECE 200,021,091023,Le; Hanh-Phuc,9999,0,9999,0
1653394504689,ECE 200,022,091024,Lin; Bill,9999,0,9999,0
1653394504689,ECE 200,023,091025,Liu; Zhaowei,9999,0,9999,0
1653394504689,ECE 200,024,091026,Lo; Yu-Hwa,9999,0,9999,0
1653394504689,ECE 200,025,091027,Lomakin; Vitaliy,9999,0,9999,0
1653394504689,ECE 200,026,091028,Mercier; Patrick Philip,9999,0,9999,0
1653394504689,ECE 200,027,091029,Meyer; Florian,9999,0,9999,0
1653394504689,ECE 200,028,091030,Milstein; Laurence B.,9999,0,9999,0
1653394504689,ECE 200,029,091031,Mir Arabbaygi; Siavash,9999,0,9999,0
1653394504689,ECE 200,030,091032,Mookherjea; Shayan,9999,0,9999,0
1653394504689,ECE 200,031,091033,Morris; Karcher William,9999,0,9999,0
1653394504689,ECE 200,032,091034,Ng; Tse Nga,9999,0,9999,0
1653394504689,ECE 200,033,091035,Nguyen; Truong Quang,9999,0,9999,0
1653394504689,ECE 200,034,091036,Nomura; Kenji,9999,0,9999,0
1653394504689,ECE 200,035,091037,Orlitsky; Alon,9999,0,9999,0
1653394504689,ECE 200,036,091038,Pal; Piya,9999,0,9999,0
1653394504689,ECE 200,037,091039,Papen; George C.,9999,0,9999,0
1653394504689,ECE 200,038,091040,Radic; Stojan,9999,0,9999,0
1653394504689,ECE 200,039,091041,Rao; Bhaskar D.,9999,0,9999,0
1653394504689,ECE 200,040,091042,Rao; Ramesh R,9999,0,9999,0
1653394504689,ECE 200,041,091043,Rebeiz; Gabriel,9999,0,9999,0
1653394504689,ECE 200,042,091044,Sanford; John R,9999,0,9999,0
1653394504689,ECE 200,043,091045,Siegel; Paul H.,9999,0,9999,0
1653394504689,ECE 200,044,091046,Sievenpiper; Daniel F.,9999,0,9999,0
1653394504689,ECE 200,045,091047,Sworder; David D.,9999,0,9999,0
1653394504689,ECE 200,046,091048,Taur; Yuan,9999,0,9999,0
1653394504689,ECE 200,047,091049,Touri; Behrouz,9999,0,9999,0
1653394504689,ECE 200,048,091050,Trivedi; Mohan M.,9999,0,9999,0
1653394504689,ECE 200,049,091051,Vardy; Alexander,9999,0,9999,0
1653394504689,ECE 200,050,091052,Vasconcelos; Nuno,9999,0,9999,0
1653394504689,ECE 200,051,091053,Wang; Xiaolong,9999,0,9999,0
1653394504689,ECE 200,052,091054,Xie; Pengtao,9999,0,9999,0
1653394504689,ECE 200,053,091055,Yip; Michael,9999,0,9999,0
1653394504689,ECE 200,054,091056,Zeger; Kenneth A.,9999,0,9999,0
1653394504689,ECE 200,055,091057,Zhang; Xinyu,9999,0,9999,0
1653394504689,ECE 200,056,091058,Turakhia; Yatish Girish,9999,0,9999,0
1653394504689,ECE 200,057,091059,Kang; Mingu,9999,0,9999,0
1653394504689,ECE 200,058,091060,Shi; Yuanyuan,9999,0,9999,0
1653394504689,ECE 200,059,091061,Wang; Edward Jay,9999,0,9999,0
1653394504689,ECE 200,060,091062,Zheng; Yang,9999,0,9999,0
1653394505217,ECE 203,A00,091065,Mercier; Patrick Philip,0,0,0,0
1653394505741,ECE 207A,A00,091605,Liu; Thomas Tao-Ming,0,0,0,0
1653394506263,ECE 212AN,A00,091068,Nomura; Kenji,0,0,0,0
1653394506791,ECE 222A,A00,091069,Rebeiz; Gabriel,0,0,0,0
1653394507315,ECE 225A,A00,091070,Orlitsky; Alon,0,0,0,0
1653394507842,ECE 230A,A00,091071,Nomura; Kenji,0,0,0,0
1653394508446,ECE 236A,A00,091072,Dayeh; Shadi Ahmad,0,0,0,0
1653394508975,ECE 238A,A00,091073,Luo; Jian,0,0,0,0
1653394508975,ECE 238A,B00,091074,Luo; Jian,0,0,0,0
1653394509500,ECE 240A,A00,091075,Radic; Stojan,0,0,0,0
1653394510031,ECE 247A,A00,091592,Shi; Lingyan,0,0,0,0
1653394510561,ECE 250,A00,091076,Touri; Behrouz,0,0,0,0
1653394511084,ECE 251C,A00,091078,Nguyen; Truong Quang,0,0,0,0
1653394511609,ECE 253,A00,091079,Cosman; Pamela C.,0,0,0,0
1653394512132,ECE 255A,A00,091080,Orlitsky; Alon,0,0,0,0
1653394512654,ECE 257A,A00,091081,Zhang; Xinyu,0,0,0,0
1653394513182,ECE 260A,A01,091084,Eldon; John,0,0,0,0
1653394513706,ECE 264C,A00,091085,Galton; Ian A,0,0,0,0
1653394514235,ECE 265C,A00,094889,Presti; Calogero Davide,0,0,0,9
1653394514762,ECE 266,A01,091087,Hall; Drew A.,0,0,0,0
1653394515809,ECE 271A,A00,091090,Vasconcelos; Nuno,0,0,0,0
1653394516333,ECE 272B,A00,091091,Sworder; David D.,0,0,0,0
1653394516858,ECE 275A,A00,091092,Meyer; Florian,0,0,0,0
1653394517387,ECE 277,A00,091093,An; Cheolhong,0,0,0,0
1653394517914,ECE 283,A00,091094,Le; Hanh-Phuc,0,0,0,0
1653394518450,ECE 284,A00,091095,Kang; Mingu,0,0,0,0
1653394518450,ECE 284,B00,091096,Wang; Edward Jay,0,0,0,0
1653394518980,ECE 285,A00,094334,Touri; Behrouz,0,0,0,0
1653394519509,ECE 289,A00,091097,Whelan; David Arthur,0,0,0,0
1653394520038,MATH 200A,A00,087414,Salehi Golsefidy; Alireza,7,0,8,1
1653394520562,MATH 202A,A00,087415,Gill; Philip E.,3,0,8,5
1653394521090,MATH 203A,A00,087416,Oprea; Dragos N.,6,0,8,2
1653394521624,MATH 204A,A00,087417,Kedlaya; Kiran S.,6,0,8,2
1653394522149,MATH 205,A00,087418,Sorensen; Claus M,6,0,8,2
1653394522675,MATH 206A,A00,087419,Izadi; Elham,7,0,8,1
1653394523203,MATH 207A,A00,087420,Mohammadi; Amir,6,0,8,2
1653394523726,MATH 208,A00,087421,Staff,9,0,10,1
1653394524248,MATH 209,A00,087422,Staff,10,0,10,0
1653394524775,MATH 218,A00,087423,Staff,10,0,10,0
1653394525303,MATH 220A,A00,087424,Novak; Jonathan I,7,0,8,1
1653394525830,MATH 231A,A00,087425,Bejenaru; Ioan,4,0,8,4
1653394526361,MATH 240A,A00,087426,Ebenfelt; Peter F,5,0,8,3
1653394526883,MATH 243,A00,087427,Staff,9,0,10,1
1653394527413,MATH 248,A00,087429,Staff,10,0,10,0
1653394527936,MATH 250A,A00,087430,Spolaor; Luca,5,0,8,3
1653394528465,MATH 257A,A00,087431,Spolaor; Luca,7,0,8,1
1653394528992,MATH 258,A00,087432,Staff,9,0,10,1
1653394529518,MATH 264A,A00,087433,Warnke; Lutz Peter,5,0,8,3
1653394530046,MATH 268,A00,087434,Staff,15,0,15,0
1653394530573,MATH 269,A00,087435,Staff,14,0,15,1
1653394531100,MATH 270A,A00,087436,Nie; Jiawang,0,0,8,8
1653394531628,MATH 272A,A00,087437,Tian; Xiaochuan,2,0,8,6
1653394532158,MATH 274,A01,087439,Cheng; Li-Tien,9,0,10,1
1653394532158,MATH 274,A02,087440,Cheng; Li-Tien,10,0,10,0
1653394532681,MATH 278A,A00,087441,Staff,8,0,10,2
1653394533203,MATH 278B,A00,087442,Staff,8,0,10,2
1653394533728,MATH 278C,A00,087443,Staff,8,0,10,2
1653394534255,MATH 280A,A00,087444,Zheng; Tianyi,0,0,8,8
1653394534782,MATH 281A,A00,087445,Bradic; Jelena,0,0,8,8
1653394535311,MATH 282A,A00,087446,Zhang; Danna,0,0,8,8
1653394535839,MATH 283,A00,087447,Tesler; Glenn,0,0,0,13
1653394536362,MATH 286,A00,087448,Kemp; Todd Aahron,6,0,8,2
1653394536884,MATH 287D,A00,087449,Bradic; Jelena,8,0,8,0
1653394537414,MATH 288,A00,087450,Staff,14,0,15,1
1653394537414,MATH 288,B00,087451,Staff,15,0,15,0
1653394537414,MATH 288,C00,087452,Staff,15,0,15,0
1653394537938,MATH 290A,A00,087453,Xu; Zhouli,7,0,8,1
1653394538461,MATH 291A,A00,087454,Xu; Zhouli,7,0,8,1
1653394538988,MATH 292,A00,087455,Staff,10,0,10,0
1653394539510,MATH 295,A00,087456,Staff,50,0,50,0
1653394540036,MATH 297,001,087457,Staff,998,0,999,1
1653395101965,COGS 200,A01,087991,Staff,48,0,50,2
1653395102495,COGS 201,A01,094504,Rangel; Lara M,17,0,25,8
1653395103020,COGS 203,A00,087992,Coulson; Seana M,19,0,20,1
1653395103556,COGS 210A,001,087993,Greene; Deanna Jacquelyn,9998,0,9999,1
1653395103556,COGS 210A,002,087994,Saygin; Ayse P,9999,0,9999,0
1653395103556,COGS 210A,003,087995,Xia; Haijun,9999,0,9999,0
1653395103556,COGS 210A,004,087996,Nitz; Douglas A.,9999,0,9999,0
1653395103556,COGS 210A,005,087997,Hollan; James D.,9999,0,9999,0
1653395103556,COGS 210A,006,087998,Deak; Gedeon O.,9998,0,9999,1
1653395103556,COGS 210A,007,087999,Rossano; Federico,9999,0,9999,0
1653395104081,COGS 211A,A00,088000,Coulson; Seana M,9997,0,9999,2
1653395104605,COGS 229,A00,088002,Staff,23,0,25,2
1653395105131,COGS 260,B00,094231,Staff,17,0,20,3
1653395105131,COGS 260,A00,088004,Nitz; Douglas A.,9998,0,9999,1
1653395105663,CSE 202,A00,090110,Paturi; Ramamohan,0,0,0,0
1653395105663,CSE 202,B00,090111,Paturi; Ramamohan,0,0,0,0
1653395106189,CSE 207B,A00,090112,Heninger; Nadia A,0,0,0,0
1653395106714,CSE 208,A00,094858,Micciancio; Daniele,0,0,0,0
1653395107243,CSE 210,A00,090113,Powell; Thomas Allan,0,0,0,0
1653395107766,CSE 219,A00,090898,Staff,0,0,0,0
1653395108289,CSE 221,A00,090114,Zhou; Yuan-Yuan,0,0,0,0
1653395108816,CSE 229A,A00,090115,Porter; George M,0,0,0,0
1653395109339,CSE 229C,A00,090116,Savage; Stefan,0,0,0,0
1653395109867,CSE 230,A00,090117,Jhala; Ranjit,0,0,0,0
1653395110400,CSE 232,A00,090118,Papakonstantinou; Yannis,0,0,0,0
1653395110933,CSE 239A,A00,090121,Kumar; Arun Kumar,0,0,0,0
1653395111457,CSE 239B,A00,090122,Jhala; Ranjit,0,0,0,0
1653395111980,CSE 240A,A00,090123,Zhao; Jishen,0,0,189,189
1653395112506,CSE 243A,A00,090124,Orailoglu; Alex,3,0,15,12
1653395113033,CSE 249B,A00,090125,Kahng; Andrew Byun,14,0,20,6
1653395113559,CSE 250A,A00,090126,Berg-Kirkpatrick; Taylor D,0,0,0,0
1653395114089,CSE 252A,A00,090127,Ochoa; Benjamin Lawrence,0,0,0,0
1653395114614,CSE 258,A01,090129,McAuley; Julian John,0,0,0,0
1653395115138,CSE 258R,A01,090131,McAuley; Julian John,0,0,0,0
1653395115663,CSE 274,A00,090132,Ramamoorthi; Ravi,0,0,0,0
1653395116186,CSE 276A,A00,090133,Christensen; Henrik I,0,0,0,0
1653395116717,CSE 276C,A00,090134,Christensen; Henrik I,0,0,0,0
1653395117246,CSE 290,A00,090135,Bafna; Vineet,0,0,0,0
1653395117246,CSE 290,B00,090136,Ramamoorthi; Ravi,0,0,0,0
1653395117246,CSE 290,C00,090137,Li; Tzumao,10,0,10,0
1653395117246,CSE 290,D00,090138,Zhou; Yuan-Yuan,10,0,10,0
1653395117246,CSE 290,E00,090139,Christensen; Henrik I,10,0,10,0
1653395117246,CSE 290,F00,094053,Shalev; Aaron D,0,0,0,0
1653395117775,CSE 291,A00,090140,Munyaka; Imani N. S.,0,0,0,0
1653395117775,CSE 291,B00,094880,Yu; Qi,0,0,0,0
1653395117775,CSE 291,C00,090142,Pannuto; Patrick William,0,0,0,0
1653395117775,CSE 291,D00,094881,Zhang; Yiying,0,0,0,0
1653395117775,CSE 291,E00,095118,Su; Hao,0,0,0,0
1653395118363,CSE 293,001,094905,Bafna; Vineet,9999,0,9999,0
1653395118363,CSE 293,002,094906,Bellare; Mihir,9999,0,9999,0
1653395118363,CSE 293,003,094907,Berg-Kirkpatrick; Taylor D,9999,0,9999,0
1653395118363,CSE 293,004,094908,Christensen; Henrik I,9999,0,9999,0
1653395118363,CSE 293,005,094909,Cottrell; Garrison W,9999,0,9999,0
1653395118363,CSE 293,006,094910,Deutsch; Alin Bernard,9999,0,9999,0
1653395118363,CSE 293,007,094911,Esmaeilzadeh; Hadi,9999,0,9999,0
1653395118363,CSE 293,008,094912,Freund; Yoav,9999,0,9999,0
1653395118363,CSE 293,009,094913,Griswold; William G.,9999,0,9999,0
1653395118363,CSE 293,010,094914,Gymrek; Melissa Ann,9999,0,9999,0
1653395118363,CSE 293,011,094915,Heninger; Nadia A,9999,0,9999,0
1653395118363,CSE 293,012,094916,Impagliazzo; Russell,9999,0,9999,0
1653395118363,CSE 293,013,094917,Jhala; Ranjit,9999,0,9999,0
1653395118363,CSE 293,014,094918,Kahng; Andrew Byun,9999,0,9999,0
1653395118363,CSE 293,015,094919,Kane; Daniel Mertz,9999,0,9999,0
1653395118363,CSE 293,016,094920,Kriegman; David J,9999,0,9999,0
1653395118363,CSE 293,017,094921,Kumar; Arun Kumar,9999,0,9999,0
1653395118363,CSE 293,018,094922,Lerner; Sorin,9999,0,9999,0
1653395118363,CSE 293,019,094923,Lovett; Shachar,9999,0,9999,0
1653395118363,CSE 293,020,094924,McAuley; Julian John,9999,0,9999,0
1653395118363,CSE 293,021,094925,Micciancio; Daniele,9999,0,9999,0
1653395118363,CSE 293,022,094926,Orailoglu; Alex,9999,0,9999,0
1653395118363,CSE 293,023,094927,Paturi; Ramamohan,9999,0,9999,0
1653395118363,CSE 293,024,094928,Polikarpova; Nadezhda,9999,0,9999,0
1653395118363,CSE 293,025,094929,Politz; Joseph Gibbs,9999,0,9999,0
1653395118363,CSE 293,026,094930,Porter; George M,9999,0,9999,0
1653395118363,CSE 293,027,094931,Porter; Leonard Emerson,9999,0,9999,0
1653395118363,CSE 293,028,094932,Ramamoorthi; Ravi,9999,0,9999,0
1653395118363,CSE 293,029,094933,Sahoo; Debashis,9999,0,9999,0
1653395118363,CSE 293,030,094934,Saul; Lawrence,9999,0,9999,0
1653395118363,CSE 293,031,094935,Savage; Stefan,9999,0,9999,0
1653395118363,CSE 293,032,094936,Schulze; Jurgen P.,9999,0,9999,0
1653395118363,CSE 293,033,094937,Snoeren; Alex C.,9999,0,9999,0
1653395118363,CSE 293,034,094938,Shang; Jingbo,9999,0,9999,0
1653395118363,CSE 293,035,094939,Stefan; Deian,9999,0,9999,0
1653395118363,CSE 293,036,094940,Su; Hao,9999,0,9999,0
1653395118363,CSE 293,037,094941,Swanson; Steven James,9999,0,9999,0
1653395118363,CSE 293,038,094942,Tullsen; Dean Michael,9999,0,9999,0
1653395118363,CSE 293,039,094943,Voelker; Geoffrey M.,9999,0,9999,0
1653395118363,CSE 293,040,094944,Zhao; Jishen,9999,0,9999,0
1653395118363,CSE 293,041,094945,Zhou; Yuan-Yuan,9999,0,9999,0
1653395118363,CSE 293,042,094946,Gao; Sicun,9998,0,9999,1
1653395118363,CSE 293,043,094947,Weibel; Nadir,9999,0,9999,0
1653395118363,CSE 293,044,094948,Gupta; Rajesh K.,9999,0,9999,0
1653395118888,CSE 294,A00,090143,Porter; George M,9,0,10,1
1653395119418,DSE 200,A00,091799,Staff,50,0,50,0
1653395119946,DSE 203,A00,091800,Gupta; Amarnath,30,0,30,0
1653395120479,DSE 250,A00,091801,Deutsch; Alin Bernard,30,0,30,0
1653395121006,DSE 290,A00,091802,Altintas De Callaf; Ilkay,50,0,50,0
1653395121589,ECE 200,001,091003,Antipa; Nicholas A,9999,0,9999,0
1653395121589,ECE 200,002,091004,Atanasov; Nikolay A.,9999,0,9999,0
1653395121589,ECE 200,003,091005,Bharadia; Dinesh,9999,0,9999,0
1653395121589,ECE 200,004,091006,Cheng; Chung Kuan,9999,0,9999,0
1653395121589,ECE 200,005,091007,Cosman; Pamela C.,9999,0,9999,0
1653395121589,ECE 200,006,091008,Staff,9999,0,9999,0
1653395121589,ECE 200,007,091009,Dayeh; Shadi Ahmad,9999,0,9999,0
1653395121589,ECE 200,008,091010,Fainman; Yeshaiahu,9999,0,9999,0
1653395121589,ECE 200,009,091011,Ford; Joseph Earl,9999,0,9999,0
1653395121589,ECE 200,010,091012,Franceschetti; Massimo,9999,0,9999,0
1653395121589,ECE 200,011,091013,Fullerton; Eric E,9999,0,9999,0
1653395121589,ECE 200,012,091014,Galton; Ian A,9999,0,9999,0
1653395121589,ECE 200,013,091015,Gilja; Vikash,9999,0,9999,0
1653395121589,ECE 200,014,091016,Hall; Drew A.,9999,0,9999,0
1653395121589,ECE 200,015,091017,Hsueh; Tzu-Chien,9999,0,9999,0
1653395121589,ECE 200,016,091018,Javidi; Tara,9999,0,9999,0
1653395121589,ECE 200,017,091019,Kahng; Andrew Byun,9999,0,9999,0
1653395121589,ECE 200,018,091020,Kim; Young-Han,9999,0,9999,0
1653395121589,ECE 200,019,091021,Koushanfar; Farinaz,9999,0,9999,0
1653395121589,ECE 200,020,091022,Kuzum; Duygu,9999,0,9999,0
1653395121589,ECE 200,021,091023,Le; Hanh-Phuc,9999,0,9999,0
1653395121589,ECE 200,022,091024,Lin; Bill,9999,0,9999,0
1653395121589,ECE 200,023,091025,Liu; Zhaowei,9999,0,9999,0
1653395121589,ECE 200,024,091026,Lo; Yu-Hwa,9999,0,9999,0
1653395121589,ECE 200,025,091027,Lomakin; Vitaliy,9999,0,9999,0
1653395121589,ECE 200,026,091028,Mercier; Patrick Philip,9999,0,9999,0
1653395121589,ECE 200,027,091029,Meyer; Florian,9999,0,9999,0
1653395121589,ECE 200,028,091030,Milstein; Laurence B.,9999,0,9999,0
1653395121589,ECE 200,029,091031,Mir Arabbaygi; Siavash,9999,0,9999,0
1653395121589,ECE 200,030,091032,Mookherjea; Shayan,9999,0,9999,0
1653395121589,ECE 200,031,091033,Morris; Karcher William,9999,0,9999,0
1653395121589,ECE 200,032,091034,Ng; Tse Nga,9999,0,9999,0
1653395121589,ECE 200,033,091035,Nguyen; Truong Quang,9999,0,9999,0
1653395121589,ECE 200,034,091036,Nomura; Kenji,9999,0,9999,0
1653395121589,ECE 200,035,091037,Orlitsky; Alon,9999,0,9999,0
1653395121589,ECE 200,036,091038,Pal; Piya,9999,0,9999,0
1653395121589,ECE 200,037,091039,Papen; George C.,9999,0,9999,0
1653395121589,ECE 200,038,091040,Radic; Stojan,9999,0,9999,0
1653395121589,ECE 200,039,091041,Rao; Bhaskar D.,9999,0,9999,0
1653395121589,ECE 200,040,091042,Rao; Ramesh R,9999,0,9999,0
1653395121589,ECE 200,041,091043,Rebeiz; Gabriel,9999,0,9999,0
1653395121589,ECE 200,042,091044,Sanford; John R,9999,0,9999,0
1653395121589,ECE 200,043,091045,Siegel; Paul H.,9999,0,9999,0
1653395121589,ECE 200,044,091046,Sievenpiper; Daniel F.,9999,0,9999,0
1653395121589,ECE 200,045,091047,Sworder; David D.,9999,0,9999,0
1653395121589,ECE 200,046,091048,Taur; Yuan,9999,0,9999,0
1653395121589,ECE 200,047,091049,Touri; Behrouz,9999,0,9999,0
1653395121589,ECE 200,048,091050,Trivedi; Mohan M.,9999,0,9999,0
1653395121589,ECE 200,049,091051,Vardy; Alexander,9999,0,9999,0
1653395121589,ECE 200,050,091052,Vasconcelos; Nuno,9999,0,9999,0
1653395121589,ECE 200,051,091053,Wang; Xiaolong,9999,0,9999,0
1653395121589,ECE 200,052,091054,Xie; Pengtao,9999,0,9999,0
1653395121589,ECE 200,053,091055,Yip; Michael,9999,0,9999,0
1653395121589,ECE 200,054,091056,Zeger; Kenneth A.,9999,0,9999,0
1653395121589,ECE 200,055,091057,Zhang; Xinyu,9999,0,9999,0
1653395121589,ECE 200,056,091058,Turakhia; Yatish Girish,9999,0,9999,0
1653395121589,ECE 200,057,091059,Kang; Mingu,9999,0,9999,0
1653395121589,ECE 200,058,091060,Shi; Yuanyuan,9999,0,9999,0
1653395121589,ECE 200,059,091061,Wang; Edward Jay,9999,0,9999,0
1653395121589,ECE 200,060,091062,Zheng; Yang,9999,0,9999,0
1653395122112,ECE 203,A00,091065,Mercier; Patrick Philip,0,0,0,0
1653395122638,ECE 207A,A00,091605,Liu; Thomas Tao-Ming,0,0,0,0
1653395123168,ECE 212AN,A00,091068,Nomura; Kenji,0,0,0,0
1653395123691,ECE 222A,A00,091069,Rebeiz; Gabriel,0,0,0,0
1653395124213,ECE 225A,A00,091070,Orlitsky; Alon,0,0,0,0
1653395124743,ECE 230A,A00,091071,Nomura; Kenji,0,0,0,0
1653395125265,ECE 236A,A00,091072,Dayeh; Shadi Ahmad,0,0,0,0
1653395125804,ECE 238A,A00,091073,Luo; Jian,0,0,0,0
1653395125804,ECE 238A,B00,091074,Luo; Jian,0,0,0,0
1653395126329,ECE 240A,A00,091075,Radic; Stojan,0,0,0,0
1653395126854,ECE 247A,A00,091592,Shi; Lingyan,0,0,0,0
1653395127386,ECE 250,A00,091076,Touri; Behrouz,0,0,0,0
1653395127915,ECE 251C,A00,091078,Nguyen; Truong Quang,0,0,0,0
1653395128441,ECE 253,A00,091079,Cosman; Pamela C.,0,0,0,0
1653395128964,ECE 255A,A00,091080,Orlitsky; Alon,0,0,0,0
1653395129486,ECE 257A,A00,091081,Zhang; Xinyu,0,0,0,0
1653395130008,ECE 260A,A01,091084,Eldon; John,0,0,0,0
1653395130536,ECE 264C,A00,091085,Galton; Ian A,0,0,0,0
1653395131061,ECE 265C,A00,094889,Presti; Calogero Davide,0,0,0,9
1653395131588,ECE 266,A01,091087,Hall; Drew A.,0,0,0,0
1653395132634,ECE 271A,A00,091090,Vasconcelos; Nuno,0,0,0,0
1653395133158,ECE 272B,A00,091091,Sworder; David D.,0,0,0,0
1653395133682,ECE 275A,A00,091092,Meyer; Florian,0,0,0,0
1653395134206,ECE 277,A00,091093,An; Cheolhong,0,0,0,0
1653395134730,ECE 283,A00,091094,Le; Hanh-Phuc,0,0,0,0
1653395135257,ECE 284,A00,091095,Kang; Mingu,0,0,0,0
1653395135257,ECE 284,B00,091096,Wang; Edward Jay,0,0,0,0
1653395135783,ECE 285,A00,094334,Touri; Behrouz,0,0,0,0
1653395136308,ECE 289,A00,091097,Whelan; David Arthur,0,0,0,0
1653395136836,MATH 200A,A00,087414,Salehi Golsefidy; Alireza,7,0,8,1
1653395137376,MATH 202A,A00,087415,Gill; Philip E.,3,0,8,5
1653395137905,MATH 203A,A00,087416,Oprea; Dragos N.,6,0,8,2
1653395138429,MATH 204A,A00,087417,Kedlaya; Kiran S.,6,0,8,2
1653395138956,MATH 205,A00,087418,Sorensen; Claus M,6,0,8,2
1653395139479,MATH 206A,A00,087419,Izadi; Elham,7,0,8,1
1653395140005,MATH 207A,A00,087420,Mohammadi; Amir,6,0,8,2
1653395140532,MATH 208,A00,087421,Staff,9,0,10,1
1653395141054,MATH 209,A00,087422,Staff,10,0,10,0
1653395141577,MATH 218,A00,087423,Staff,10,0,10,0
1653395142121,MATH 220A,A00,087424,Novak; Jonathan I,7,0,8,1
1653395142647,MATH 231A,A00,087425,Bejenaru; Ioan,4,0,8,4
1653395143171,MATH 240A,A00,087426,Ebenfelt; Peter F,5,0,8,3
1653395143695,MATH 243,A00,087427,Staff,9,0,10,1
1653395144218,MATH 248,A00,087429,Staff,10,0,10,0
1653395144743,MATH 250A,A00,087430,Spolaor; Luca,5,0,8,3
1653395145274,MATH 257A,A00,087431,Spolaor; Luca,7,0,8,1
1653395145799,MATH 258,A00,087432,Staff,9,0,10,1
1653395146327,MATH 264A,A00,087433,Warnke; Lutz Peter,5,0,8,3
1653395146852,MATH 268,A00,087434,Staff,15,0,15,0
1653395147378,MATH 269,A00,087435,Staff,14,0,15,1
1653395147902,MATH 270A,A00,087436,Nie; Jiawang,0,0,8,8
1653395148429,MATH 272A,A00,087437,Tian; Xiaochuan,2,0,8,6
1653395148953,MATH 274,A01,087439,Cheng; Li-Tien,9,0,10,1
1653395148953,MATH 274,A02,087440,Cheng; Li-Tien,10,0,10,0
1653395149478,MATH 278A,A00,087441,Staff,8,0,10,2
1653395150004,MATH 278B,A00,087442,Staff,8,0,10,2
1653395150528,MATH 278C,A00,087443,Staff,8,0,10,2
1653395151140,MATH 280A,A00,087444,Zheng; Tianyi,0,0,8,8
1653395151664,MATH 281A,A00,087445,Bradic; Jelena,0,0,8,8
1653395152192,MATH 282A,A00,087446,Zhang; Danna,0,0,8,8
1653395152717,MATH 283,A00,087447,Tesler; Glenn,0,0,0,13
1653395153244,MATH 286,A00,087448,Kemp; Todd Aahron,6,0,8,2
1653395153776,MATH 287D,A00,087449,Bradic; Jelena,8,0,8,0
1653395154301,MATH 288,A00,087450,Staff,14,0,15,1
1653395154301,MATH 288,B00,087451,Staff,15,0,15,0
1653395154301,MATH 288,C00,087452,Staff,15,0,15,0
1653395154824,MATH 290A,A00,087453,Xu; Zhouli,7,0,8,1
1653395155351,MATH 291A,A00,087454,Xu; Zhouli,7,0,8,1
1653395155874,MATH 292,A00,087455,Staff,10,0,10,0
1653395156405,MATH 295,A00,087456,Staff,50,0,50,0
1653395156933,MATH 297,001,087457,Staff,998,0,999,1
1653395718297,COGS 200,A01,087991,Staff,48,0,50,2
1653395718826,COGS 201,A01,094504,Rangel; Lara M,17,0,25,8
1653395719363,COGS 203,A00,087992,Coulson; Seana M,19,0,20,1
1653395719894,COGS 210A,001,087993,Greene; Deanna Jacquelyn,9998,0,9999,1
1653395719894,COGS 210A,002,087994,Saygin; Ayse P,9999,0,9999,0
1653395719894,COGS 210A,003,087995,Xia; Haijun,9999,0,9999,0
1653395719894,COGS 210A,004,087996,Nitz; Douglas A.,9999,0,9999,0
1653395719894,COGS 210A,005,087997,Hollan; James D.,9999,0,9999,0
1653395719894,COGS 210A,006,087998,Deak; Gedeon O.,9998,0,9999,1
1653395719894,COGS 210A,007,087999,Rossano; Federico,9999,0,9999,0
1653395720419,COGS 211A,A00,088000,Coulson; Seana M,9997,0,9999,2
1653395720946,COGS 229,A00,088002,Staff,23,0,25,2
1653395721470,COGS 260,B00,094231,Staff,17,0,20,3
1653395721470,COGS 260,A00,088004,Nitz; Douglas A.,9998,0,9999,1
1653395721998,CSE 202,A00,090110,Paturi; Ramamohan,0,0,0,0
1653395721998,CSE 202,B00,090111,Paturi; Ramamohan,0,0,0,0
1653395722521,CSE 207B,A00,090112,Heninger; Nadia A,0,0,0,0
1653395723049,CSE 208,A00,094858,Micciancio; Daniele,0,0,0,0
1653395723580,CSE 210,A00,090113,Powell; Thomas Allan,0,0,0,0
1653395724108,CSE 219,A00,090898,Staff,0,0,0,0
1653395724631,CSE 221,A00,090114,Zhou; Yuan-Yuan,0,0,0,0
1653395725158,CSE 229A,A00,090115,Porter; George M,0,0,0,0
1653395725683,CSE 229C,A00,090116,Savage; Stefan,0,0,0,0
1653395726209,CSE 230,A00,090117,Jhala; Ranjit,0,0,0,0
1653395726737,CSE 232,A00,090118,Papakonstantinou; Yannis,0,0,0,0
1653395727264,CSE 239A,A00,090121,Kumar; Arun Kumar,0,0,0,0
1653395727788,CSE 239B,A00,090122,Jhala; Ranjit,0,0,0,0
1653395728312,CSE 240A,A00,090123,Zhao; Jishen,0,0,189,189
1653395728836,CSE 243A,A00,090124,Orailoglu; Alex,3,0,15,12
1653395729359,CSE 249B,A00,090125,Kahng; Andrew Byun,14,0,20,6
1653395729883,CSE 250A,A00,090126,Berg-Kirkpatrick; Taylor D,0,0,0,0
1653395730419,CSE 252A,A00,090127,Ochoa; Benjamin Lawrence,0,0,0,0
1653395730943,CSE 258,A01,090129,McAuley; Julian John,0,0,0,0
1653395731466,CSE 258R,A01,090131,McAuley; Julian John,0,0,0,0
1653395732001,CSE 274,A00,090132,Ramamoorthi; Ravi,0,0,0,0
1653395732535,CSE 276A,A00,090133,Christensen; Henrik I,0,0,0,0
1653395733065,CSE 276C,A00,090134,Christensen; Henrik I,0,0,0,0
1653395733600,CSE 290,A00,090135,Bafna; Vineet,0,0,0,0
1653395733600,CSE 290,B00,090136,Ramamoorthi; Ravi,0,0,0,0
1653395733600,CSE 290,C00,090137,Li; Tzumao,10,0,10,0
1653395733600,CSE 290,D00,090138,Zhou; Yuan-Yuan,10,0,10,0
1653395733600,CSE 290,E00,090139,Christensen; Henrik I,10,0,10,0
1653395733600,CSE 290,F00,094053,Shalev; Aaron D,0,0,0,0
1653395734138,CSE 291,A00,090140,Munyaka; Imani N. S.,0,0,0,0
1653395734138,CSE 291,B00,094880,Yu; Qi,0,0,0,0
1653395734138,CSE 291,C00,090142,Pannuto; Patrick William,0,0,0,0
1653395734138,CSE 291,D00,094881,Zhang; Yiying,0,0,0,0
1653395734138,CSE 291,E00,095118,Su; Hao,0,0,0,0
1653395734687,CSE 293,001,094905,Bafna; Vineet,9999,0,9999,0
1653395734687,CSE 293,002,094906,Bellare; Mihir,9999,0,9999,0
1653395734687,CSE 293,003,094907,Berg-Kirkpatrick; Taylor D,9999,0,9999,0
1653395734687,CSE 293,004,094908,Christensen; Henrik I,9999,0,9999,0
1653395734687,CSE 293,005,094909,Cottrell; Garrison W,9999,0,9999,0
1653395734687,CSE 293,006,094910,Deutsch; Alin Bernard,9999,0,9999,0
1653395734687,CSE 293,007,094911,Esmaeilzadeh; Hadi,9999,0,9999,0
1653395734687,CSE 293,008,094912,Freund; Yoav,9999,0,9999,0
1653395734687,CSE 293,009,094913,Griswold; William G.,9999,0,9999,0
1653395734687,CSE 293,010,094914,Gymrek; Melissa Ann,9999,0,9999,0
1653395734687,CSE 293,011,094915,Heninger; Nadia A,9999,0,9999,0
1653395734687,CSE 293,012,094916,Impagliazzo; Russell,9999,0,9999,0
1653395734687,CSE 293,013,094917,Jhala; Ranjit,9999,0,9999,0
1653395734687,CSE 293,014,094918,Kahng; Andrew Byun,9999,0,9999,0
1653395734687,CSE 293,015,094919,Kane; Daniel Mertz,9999,0,9999,0
1653395734687,CSE 293,016,094920,Kriegman; David J,9999,0,9999,0
1653395734687,CSE 293,017,094921,Kumar; Arun Kumar,9999,0,9999,0
1653395734687,CSE 293,018,094922,Lerner; Sorin,9999,0,9999,0
1653395734687,CSE 293,019,094923,Lovett; Shachar,9999,0,9999,0
1653395734687,CSE 293,020,094924,McAuley; Julian John,9999,0,9999,0
1653395734687,CSE 293,021,094925,Micciancio; Daniele,9999,0,9999,0
1653395734687,CSE 293,022,094926,Orailoglu; Alex,9999,0,9999,0
1653395734687,CSE 293,023,094927,Paturi; Ramamohan,9999,0,9999,0
1653395734687,CSE 293,024,094928,Polikarpova; Nadezhda,9999,0,9999,0
1653395734687,CSE 293,025,094929,Politz; Joseph Gibbs,9999,0,9999,0
1653395734687,CSE 293,026,094930,Porter; George M,9999,0,9999,0
1653395734687,CSE 293,027,094931,Porter; Leonard Emerson,9999,0,9999,0
1653395734687,CSE 293,028,094932,Ramamoorthi; Ravi,9999,0,9999,0
1653395734687,CSE 293,029,094933,Sahoo; Debashis,9999,0,9999,0
1653395734687,CSE 293,030,094934,Saul; Lawrence,9999,0,9999,0
1653395734687,CSE 293,031,094935,Savage; Stefan,9999,0,9999,0
1653395734687,CSE 293,032,094936,Schulze; Jurgen P.,9999,0,9999,0
1653395734687,CSE 293,033,094937,Snoeren; Alex C.,9999,0,9999,0
1653395734687,CSE 293,034,094938,Shang; Jingbo,9999,0,9999,0
1653395734687,CSE 293,035,094939,Stefan; Deian,9999,0,9999,0
1653395734687,CSE 293,036,094940,Su; Hao,9999,0,9999,0
1653395734687,CSE 293,037,094941,Swanson; Steven James,9999,0,9999,0
1653395734687,CSE 293,038,094942,Tullsen; Dean Michael,9999,0,9999,0
1653395734687,CSE 293,039,094943,Voelker; Geoffrey M.,9999,0,9999,0
1653395734687,CSE 293,040,094944,Zhao; Jishen,9999,0,9999,0
1653395734687,CSE 293,041,094945,Zhou; Yuan-Yuan,9999,0,9999,0
1653395734687,CSE 293,042,094946,Gao; Sicun,9998,0,9999,1
1653395734687,CSE 293,043,094947,Weibel; Nadir,9999,0,9999,0
1653395734687,CSE 293,044,094948,Gupta; Rajesh K.,9999,0,9999,0
1653395735218,CSE 294,A00,090143,Porter; George M,9,0,10,1
1653395735742,DSE 200,A00,091799,Staff,50,0,50,0
1653395736268,DSE 203,A00,091800,Gupta; Amarnath,30,0,30,0
1653395736791,DSE 250,A00,091801,Deutsch; Alin Bernard,30,0,30,0
1653395737314,DSE 290,A00,091802,Altintas De Callaf; Ilkay,50,0,50,0
1653395737860,ECE 200,001,091003,Antipa; Nicholas A,9999,0,9999,0
1653395737860,ECE 200,002,091004,Atanasov; Nikolay A.,9999,0,9999,0
1653395737860,ECE 200,003,091005,Bharadia; Dinesh,9999,0,9999,0
1653395737860,ECE 200,004,091006,Cheng; Chung Kuan,9999,0,9999,0
1653395737860,ECE 200,005,091007,Cosman; Pamela C.,9999,0,9999,0
1653395737860,ECE 200,006,091008,Staff,9999,0,9999,0
1653395737860,ECE 200,007,091009,Dayeh; Shadi Ahmad,9999,0,9999,0
1653395737860,ECE 200,008,091010,Fainman; Yeshaiahu,9999,0,9999,0
1653395737860,ECE 200,009,091011,Ford; Joseph Earl,9999,0,9999,0
1653395737860,ECE 200,010,091012,Franceschetti; Massimo,9999,0,9999,0
1653395737860,ECE 200,011,091013,Fullerton; Eric E,9999,0,9999,0
1653395737860,ECE 200,012,091014,Galton; Ian A,9999,0,9999,0
1653395737860,ECE 200,013,091015,Gilja; Vikash,9999,0,9999,0
1653395737860,ECE 200,014,091016,Hall; Drew A.,9999,0,9999,0
1653395737860,ECE 200,015,091017,Hsueh; Tzu-Chien,9999,0,9999,0
1653395737860,ECE 200,016,091018,Javidi; Tara,9999,0,9999,0
1653395737860,ECE 200,017,091019,Kahng; Andrew Byun,9999,0,9999,0
1653395737860,ECE 200,018,091020,Kim; Young-Han,9999,0,9999,0
1653395737860,ECE 200,019,091021,Koushanfar; Farinaz,9999,0,9999,0
1653395737860,ECE 200,020,091022,Kuzum; Duygu,9999,0,9999,0
1653395737860,ECE 200,021,091023,Le; Hanh-Phuc,9999,0,9999,0
1653395737860,ECE 200,022,091024,Lin; Bill,9999,0,9999,0
1653395737860,ECE 200,023,091025,Liu; Zhaowei,9999,0,9999,0
1653395737860,ECE 200,024,091026,Lo; Yu-Hwa,9999,0,9999,0
1653395737860,ECE 200,025,091027,Lomakin; Vitaliy,9999,0,9999,0
1653395737860,ECE 200,026,091028,Mercier; Patrick Philip,9999,0,9999,0
1653395737860,ECE 200,027,091029,Meyer; Florian,9999,0,9999,0
1653395737860,ECE 200,028,091030,Milstein; Laurence B.,9999,0,9999,0
1653395737860,ECE 200,029,091031,Mir Arabbaygi; Siavash,9999,0,9999,0
1653395737860,ECE 200,030,091032,Mookherjea; Shayan,9999,0,9999,0
1653395737860,ECE 200,031,091033,Morris; Karcher William,9999,0,9999,0
1653395737860,ECE 200,032,091034,Ng; Tse Nga,9999,0,9999,0
1653395737860,ECE 200,033,091035,Nguyen; Truong Quang,9999,0,9999,0
1653395737860,ECE 200,034,091036,Nomura; Kenji,9999,0,9999,0
1653395737860,ECE 200,035,091037,Orlitsky; Alon,9999,0,9999,0
1653395737860,ECE 200,036,091038,Pal; Piya,9999,0,9999,0
1653395737860,ECE 200,037,091039,Papen; George C.,9999,0,9999,0
1653395737860,ECE 200,038,091040,Radic; Stojan,9999,0,9999,0
1653395737860,ECE 200,039,091041,Rao; Bhaskar D.,9999,0,9999,0
1653395737860,ECE 200,040,091042,Rao; Ramesh R,9999,0,9999,0
1653395737860,ECE 200,041,091043,Rebeiz; Gabriel,9999,0,9999,0
1653395737860,ECE 200,042,091044,Sanford; John R,9999,0,9999,0
1653395737860,ECE 200,043,091045,Siegel; Paul H.,9999,0,9999,0
1653395737860,ECE 200,044,091046,Sievenpiper; Daniel F.,9999,0,9999,0
1653395737860,ECE 200,045,091047,Sworder; David D.,9999,0,9999,0
1653395737860,ECE 200,046,091048,Taur; Yuan,9999,0,9999,0
1653395737860,ECE 200,047,091049,Touri; Behrouz,9999,0,9999,0
1653395737860,ECE 200,048,091050,Trivedi; Mohan M.,9999,0,9999,0
1653395737860,ECE 200,049,091051,Vardy; Alexander,9999,0,9999,0
1653395737860,ECE 200,050,091052,Vasconcelos; Nuno,9999,0,9999,0
1653395737860,ECE 200,051,091053,Wang; Xiaolong,9999,0,9999,0
1653395737860,ECE 200,052,091054,Xie; Pengtao,9999,0,9999,0
1653395737860,ECE 200,053,091055,Yip; Michael,9999,0,9999,0
1653395737860,ECE 200,054,091056,Zeger; Kenneth A.,9999,0,9999,0
1653395737860,ECE 200,055,091057,Zhang; Xinyu,9999,0,9999,0
1653395737860,ECE 200,056,091058,Turakhia; Yatish Girish,9999,0,9999,0
1653395737860,ECE 200,057,091059,Kang; Mingu,9999,0,9999,0
1653395737860,ECE 200,058,091060,Shi; Yuanyuan,9999,0,9999,0
1653395737860,ECE 200,059,091061,Wang; Edward Jay,9999,0,9999,0
1653395737860,ECE 200,060,091062,Zheng; Yang,9999,0,9999,0
1653395738386,ECE 203,A00,091065,Mercier; Patrick Philip,0,0,0,0
1653395738917,ECE 207A,A00,091605,Liu; Thomas Tao-Ming,0,0,0,0
1653395739446,ECE 212AN,A00,091068,Nomura; Kenji,0,0,0,0
1653395740044,ECE 222A,A00,091069,Rebeiz; Gabriel,0,0,0,0
1653395740570,ECE 225A,A00,091070,Orlitsky; Alon,0,0,0,0
1653395741093,ECE 230A,A00,091071,Nomura; Kenji,0,0,0,0
1653395741630,ECE 236A,A00,091072,Dayeh; Shadi Ahmad,0,0,0,0
1653395742168,ECE 238A,A00,091073,Luo; Jian,0,0,0,0
1653395742168,ECE 238A,B00,091074,Luo; Jian,0,0,0,0
1653395742692,ECE 240A,A00,091075,Radic; Stojan,0,0,0,0
1653395743217,ECE 247A,A00,091592,Shi; Lingyan,0,0,0,0
1653395743747,ECE 250,A00,091076,Touri; Behrouz,0,0,0,0
1653395744274,ECE 251C,A00,091078,Nguyen; Truong Quang,0,0,0,0
1653395744797,ECE 253,A00,091079,Cosman; Pamela C.,0,0,0,0
1653395745321,ECE 255A,A00,091080,Orlitsky; Alon,0,0,0,0
1653395745850,ECE 257A,A00,091081,Zhang; Xinyu,0,0,0,0
1653395746379,ECE 260A,A01,091084,Eldon; John,0,0,0,0
1653395746907,ECE 264C,A00,091085,Galton; Ian A,0,0,0,0
1653395747433,ECE 265C,A00,094889,Presti; Calogero Davide,0,0,0,9
1653395747961,ECE 266,A01,091087,Hall; Drew A.,0,0,0,0
1653395749013,ECE 271A,A00,091090,Vasconcelos; Nuno,0,0,0,0
1653395749541,ECE 272B,A00,091091,Sworder; David D.,0,0,0,0
1653395750072,ECE 275A,A00,091092,Meyer; Florian,0,0,0,0
1653395750598,ECE 277,A00,091093,An; Cheolhong,0,0,0,0
1653395751126,ECE 283,A00,091094,Le; Hanh-Phuc,0,0,0,0
1653395751656,ECE 284,A00,091095,Kang; Mingu,0,0,0,0
1653395751656,ECE 284,B00,091096,Wang; Edward Jay,0,0,0,0
1653395752181,ECE 285,A00,094334,Touri; Behrouz,0,0,0,0
1653395752718,ECE 289,A00,091097,Whelan; David Arthur,0,0,0,0
1653395753269,MATH 200A,A00,087414,Salehi Golsefidy; Alireza,7,0,8,1
1653395753794,MATH 202A,A00,087415,Gill; Philip E.,3,0,8,5
1653395754335,MATH 203A,A00,087416,Oprea; Dragos N.,6,0,8,2
1653395754860,MATH 204A,A00,087417,Kedlaya; Kiran S.,6,0,8,2
1653395755384,MATH 205,A00,087418,Sorensen; Claus M,6,0,8,2
1653395755908,MATH 206A,A00,087419,Izadi; Elham,7,0,8,1
1653395756436,MATH 207A,A00,087420,Mohammadi; Amir,6,0,8,2
1653395756961,MATH 208,A00,087421,Staff,9,0,10,1
1653395757488,MATH 209,A00,087422,Staff,10,0,10,0
1653395758015,MATH 218,A00,087423,Staff,10,0,10,0
1653395758547,MATH 220A,A00,087424,Novak; Jonathan I,7,0,8,1
1653395759078,MATH 231A,A00,087425,Bejenaru; Ioan,4,0,8,4
1653395759616,MATH 240A,A00,087426,Ebenfelt; Peter F,5,0,8,3
1653395760150,MATH 243,A00,087427,Staff,9,0,10,1
1653395760675,MATH 248,A00,087429,Staff,10,0,10,0
1653395761197,MATH 250A,A00,087430,Spolaor; Luca,5,0,8,3
1653395761724,MATH 257A,A00,087431,Spolaor; Luca,7,0,8,1
1653395762247,MATH 258,A00,087432,Staff,9,0,10,1
1653395762777,MATH 264A,A00,087433,Warnke; Lutz Peter,5,0,8,3
1653395763300,MATH 268,A00,087434,Staff,15,0,15,0
1653395763827,MATH 269,A00,087435,Staff,14,0,15,1
1653395764351,MATH 270A,A00,087436,Nie; Jiawang,0,0,8,8
1653395764895,MATH 272A,A00,087437,Tian; Xiaochuan,2,0,8,6
1653395765428,MATH 274,A01,087439,Cheng; Li-Tien,9,0,10,1
1653395765428,MATH 274,A02,087440,Cheng; Li-Tien,10,0,10,0
1653395765954,MATH 278A,A00,087441,Staff,8,0,10,2
1653395766482,MATH 278B,A00,087442,Staff,8,0,10,2
1653395767006,MATH 278C,A00,087443,Staff,8,0,10,2
1653395767551,MATH 280A,A00,087444,Zheng; Tianyi,0,0,8,8
1653395768087,MATH 281A,A00,087445,Bradic; Jelena,0,0,8,8
1653395768612,MATH 282A,A00,087446,Zhang; Danna,0,0,8,8
1653395769143,MATH 283,A00,087447,Tesler; Glenn,0,0,0,13
1653395769667,MATH 286,A00,087448,Kemp; Todd Aahron,6,0,8,2
1653395770190,MATH 287D,A00,087449,Bradic; Jelena,8,0,8,0
1653395770719,MATH 288,A00,087450,Staff,14,0,15,1
1653395770719,MATH 288,B00,087451,Staff,15,0,15,0
1653395770719,MATH 288,C00,087452,Staff,15,0,15,0
1653395771251,MATH 290A,A00,087453,Xu; Zhouli,7,0,8,1
1653395771774,MATH 291A,A00,087454,Xu; Zhouli,7,0,8,1
1653395772308,MATH 292,A00,087455,Staff,10,0,10,0
1653395772840,MATH 295,A00,087456,Staff,50,0,50,0
1653395773371,MATH 297,001,087457,Staff,998,0,999,1
1653396334738,COGS 200,A01,087991,Staff,48,0,50,2
1653396335262,COGS 201,A01,094504,Rangel; Lara M,17,0,25,8
1653396335787,COGS 203,A00,087992,Coulson; Seana M,19,0,20,1
1653396336316,COGS 210A,001,087993,Greene; Deanna Jacquelyn,9998,0,9999,1
1653396336316,COGS 210A,002,087994,Saygin; Ayse P,9999,0,9999,0
1653396336316,COGS 210A,003,087995,Xia; Haijun,9999,0,9999,0
1653396336316,COGS 210A,004,087996,Nitz; Douglas A.,9999,0,9999,0
1653396336316,COGS 210A,005,087997,Hollan; James D.,9999,0,9999,0
1653396336316,COGS 210A,006,087998,Deak; Gedeon O.,9998,0,9999,1
1653396336316,COGS 210A,007,087999,Rossano; Federico,9999,0,9999,0
1653396336842,COGS 211A,A00,088000,Coulson; Seana M,9997,0,9999,2
1653396337364,COGS 229,A00,088002,Staff,23,0,25,2
1653396337887,COGS 260,B00,094231,Staff,17,0,20,3
1653396337887,COGS 260,A00,088004,Nitz; Douglas A.,9998,0,9999,1
1653396338418,CSE 202,A00,090110,Paturi; Ramamohan,0,0,0,0
1653396338418,CSE 202,B00,090111,Paturi; Ramamohan,0,0,0,0
1653396338941,CSE 207B,A00,090112,Heninger; Nadia A,0,0,0,0
1653396339472,CSE 208,A00,094858,Micciancio; Daniele,0,0,0,0
1653396340000,CSE 210,A00,090113,Powell; Thomas Allan,0,0,0,0
1653396340526,CSE 219,A00,090898,Staff,0,0,0,0
1653396341050,CSE 221,A00,090114,Zhou; Yuan-Yuan,0,0,0,0
1653396341579,CSE 229A,A00,090115,Porter; George M,0,0,0,0
1653396342105,CSE 229C,A00,090116,Savage; Stefan,0,0,0,0
1653396342630,CSE 230,A00,090117,Jhala; Ranjit,0,0,0,0
1653396343162,CSE 232,A00,090118,Papakonstantinou; Yannis,0,0,0,0
1653396343686,CSE 239A,A00,090121,Kumar; Arun Kumar,0,0,0,0
1653396344214,CSE 239B,A00,090122,Jhala; Ranjit,0,0,0,0
1653396344747,CSE 240A,A00,090123,Zhao; Jishen,0,0,189,189
1653396345274,CSE 243A,A00,090124,Orailoglu; Alex,3,0,15,12
1653396345800,CSE 249B,A00,090125,Kahng; Andrew Byun,14,0,20,6
1653396346325,CSE 250A,A00,090126,Berg-Kirkpatrick; Taylor D,0,0,0,0
1653396346865,CSE 252A,A00,090127,Ochoa; Benjamin Lawrence,0,0,0,0
1653396347393,CSE 258,A01,090129,McAuley; Julian John,0,0,0,0
1653396347918,CSE 258R,A01,090131,McAuley; Julian John,0,0,0,0
1653396348444,CSE 274,A00,090132,Ramamoorthi; Ravi,0,0,0,0
1653396348972,CSE 276A,A00,090133,Christensen; Henrik I,0,0,0,0
1653396349496,CSE 276C,A00,090134,Christensen; Henrik I,0,0,0,0
1653396350032,CSE 290,A00,090135,Bafna; Vineet,0,0,0,0
1653396350032,CSE 290,B00,090136,Ramamoorthi; Ravi,0,0,0,0
1653396350032,CSE 290,C00,090137,Li; Tzumao,10,0,10,0
1653396350032,CSE 290,D00,090138,Zhou; Yuan-Yuan,10,0,10,0
1653396350032,CSE 290,E00,090139,Christensen; Henrik I,10,0,10,0
1653396350032,CSE 290,F00,094053,Shalev; Aaron D,0,0,0,0
1653396350558,CSE 291,A00,090140,Munyaka; Imani N. S.,0,0,0,0
1653396350558,CSE 291,B00,094880,Yu; Qi,0,0,0,0
1653396350558,CSE 291,C00,090142,Pannuto; Patrick William,0,0,0,0
1653396350558,CSE 291,D00,094881,Zhang; Yiying,0,0,0,0
1653396350558,CSE 291,E00,095118,Su; Hao,0,0,0,0
1653396351114,CSE 293,001,094905,Bafna; Vineet,9999,0,9999,0
1653396351114,CSE 293,002,094906,Bellare; Mihir,9999,0,9999,0
1653396351114,CSE 293,003,094907,Berg-Kirkpatrick; Taylor D,9999,0,9999,0
1653396351114,CSE 293,004,094908,Christensen; Henrik I,9999,0,9999,0
1653396351114,CSE 293,005,094909,Cottrell; Garrison W,9999,0,9999,0
1653396351114,CSE 293,006,094910,Deutsch; Alin Bernard,9999,0,9999,0
1653396351114,CSE 293,007,094911,Esmaeilzadeh; Hadi,9999,0,9999,0
1653396351114,CSE 293,008,094912,Freund; Yoav,9999,0,9999,0
1653396351114,CSE 293,009,094913,Griswold; William G.,9999,0,9999,0
1653396351114,CSE 293,010,094914,Gymrek; Melissa Ann,9999,0,9999,0
1653396351114,CSE 293,011,094915,Heninger; Nadia A,9999,0,9999,0
1653396351114,CSE 293,012,094916,Impagliazzo; Russell,9999,0,9999,0
1653396351114,CSE 293,013,094917,Jhala; Ranjit,9999,0,9999,0
1653396351114,CSE 293,014,094918,Kahng; Andrew Byun,9999,0,9999,0
1653396351114,CSE 293,015,094919,Kane; Daniel Mertz,9999,0,9999,0
1653396351114,CSE 293,016,094920,Kriegman; David J,9999,0,9999,0
1653396351114,CSE 293,017,094921,Kumar; Arun Kumar,9999,0,9999,0
1653396351114,CSE 293,018,094922,Lerner; Sorin,9999,0,9999,0
1653396351114,CSE 293,019,094923,Lovett; Shachar,9999,0,9999,0
1653396351114,CSE 293,020,094924,McAuley; Julian John,9999,0,9999,0
1653396351114,CSE 293,021,094925,Micciancio; Daniele,9999,0,9999,0
1653396351114,CSE 293,022,094926,Orailoglu; Alex,9999,0,9999,0
1653396351114,CSE 293,023,094927,Paturi; Ramamohan,9999,0,9999,0
1653396351114,CSE 293,024,094928,Polikarpova; Nadezhda,9999,0,9999,0
1653396351114,CSE 293,025,094929,Politz; Joseph Gibbs,9999,0,9999,0
1653396351114,CSE 293,026,094930,Porter; George M,9999,0,9999,0
1653396351114,CSE 293,027,094931,Porter; Leonard Emerson,9999,0,9999,0
1653396351114,CSE 293,028,094932,Ramamoorthi; Ravi,9999,0,9999,0
1653396351114,CSE 293,029,094933,Sahoo; Debashis,9999,0,9999,0
1653396351114,CSE 293,030,094934,Saul; Lawrence,9999,0,9999,0
1653396351114,CSE 293,031,094935,Savage; Stefan,9999,0,9999,0
1653396351114,CSE 293,032,094936,Schulze; Jurgen P.,9999,0,9999,0
1653396351114,CSE 293,033,094937,Snoeren; Alex C.,9999,0,9999,0
1653396351114,CSE 293,034,094938,Shang; Jingbo,9999,0,9999,0
1653396351114,CSE 293,035,094939,Stefan; Deian,9999,0,9999,0
1653396351114,CSE 293,036,094940,Su; Hao,9999,0,9999,0
1653396351114,CSE 293,037,094941,Swanson; Steven James,9999,0,9999,0
1653396351114,CSE 293,038,094942,Tullsen; Dean Michael,9999,0,9999,0
1653396351114,CSE 293,039,094943,Voelker; Geoffrey M.,9999,0,9999,0
1653396351114,CSE 293,040,094944,Zhao; Jishen,9999,0,9999,0
1653396351114,CSE 293,041,094945,Zhou; Yuan-Yuan,9999,0,9999,0
1653396351114,CSE 293,042,094946,Gao; Sicun,9998,0,9999,1
1653396351114,CSE 293,043,094947,Weibel; Nadir,9999,0,9999,0
1653396351114,CSE 293,044,094948,Gupta; Rajesh K.,9999,0,9999,0
1653396351637,CSE 294,A00,090143,Porter; George M,9,0,10,1
1653396352167,DSE 200,A00,091799,Staff,50,0,50,0
1653396352695,DSE 203,A00,091800,Gupta; Amarnath,30,0,30,0
1653396353220,DSE 250,A00,091801,Deutsch; Alin Bernard,30,0,30,0
1653396353744,DSE 290,A00,091802,Altintas De Callaf; Ilkay,50,0,50,0
1653396354291,ECE 200,001,091003,Antipa; Nicholas A,9999,0,9999,0
1653396354291,ECE 200,002,091004,Atanasov; Nikolay A.,9999,0,9999,0
1653396354291,ECE 200,003,091005,Bharadia; Dinesh,9999,0,9999,0
1653396354291,ECE 200,004,091006,Cheng; Chung Kuan,9999,0,9999,0
1653396354291,ECE 200,005,091007,Cosman; Pamela C.,9999,0,9999,0
1653396354291,ECE 200,006,091008,Staff,9999,0,9999,0
1653396354291,ECE 200,007,091009,Dayeh; Shadi Ahmad,9999,0,9999,0
1653396354291,ECE 200,008,091010,Fainman; Yeshaiahu,9999,0,9999,0
1653396354291,ECE 200,009,091011,Ford; Joseph Earl,9999,0,9999,0
1653396354291,ECE 200,010,091012,Franceschetti; Massimo,9999,0,9999,0
1653396354291,ECE 200,011,091013,Fullerton; Eric E,9999,0,9999,0
1653396354291,ECE 200,012,091014,Galton; Ian A,9999,0,9999,0
1653396354291,ECE 200,013,091015,Gilja; Vikash,9999,0,9999,0
1653396354291,ECE 200,014,091016,Hall; Drew A.,9999,0,9999,0
1653396354291,ECE 200,015,091017,Hsueh; Tzu-Chien,9999,0,9999,0
1653396354291,ECE 200,016,091018,Javidi; Tara,9999,0,9999,0
1653396354291,ECE 200,017,091019,Kahng; Andrew Byun,9999,0,9999,0
1653396354291,ECE 200,018,091020,Kim; Young-Han,9999,0,9999,0
1653396354291,ECE 200,019,091021,Koushanfar; Farinaz,9999,0,9999,0
1653396354291,ECE 200,020,091022,Kuzum; Duygu,9999,0,9999,0
1653396354291,ECE 200,021,091023,Le; Hanh-Phuc,9999,0,9999,0
1653396354291,ECE 200,022,091024,Lin; Bill,9999,0,9999,0
1653396354291,ECE 200,023,091025,Liu; Zhaowei,9999,0,9999,0
1653396354291,ECE 200,024,091026,Lo; Yu-Hwa,9999,0,9999,0
1653396354291,ECE 200,025,091027,Lomakin; Vitaliy,9999,0,9999,0
1653396354291,ECE 200,026,091028,Mercier; Patrick Philip,9999,0,9999,0
1653396354291,ECE 200,027,091029,Meyer; Florian,9999,0,9999,0
1653396354291,ECE 200,028,091030,Milstein; Laurence B.,9999,0,9999,0
1653396354291,ECE 200,029,091031,Mir Arabbaygi; Siavash,9999,0,9999,0
1653396354291,ECE 200,030,091032,Mookherjea; Shayan,9999,0,9999,0
1653396354291,ECE 200,031,091033,Morris; Karcher William,9999,0,9999,0
1653396354291,ECE 200,032,091034,Ng; Tse Nga,9999,0,9999,0
1653396354291,ECE 200,033,091035,Nguyen; Truong Quang,9999,0,9999,0
1653396354291,ECE 200,034,091036,Nomura; Kenji,9999,0,9999,0
1653396354291,ECE 200,035,091037,Orlitsky; Alon,9999,0,9999,0
1653396354291,ECE 200,036,091038,Pal; Piya,9999,0,9999,0
1653396354291,ECE 200,037,091039,Papen; George C.,9999,0,9999,0
1653396354291,ECE 200,038,091040,Radic; Stojan,9999,0,9999,0
1653396354291,ECE 200,039,091041,Rao; Bhaskar D.,9999,0,9999,0
1653396354291,ECE 200,040,091042,Rao; Ramesh R,9999,0,9999,0
1653396354291,ECE 200,041,091043,Rebeiz; Gabriel,9999,0,9999,0
1653396354291,ECE 200,042,091044,Sanford; John R,9999,0,9999,0
1653396354291,ECE 200,043,091045,Siegel; Paul H.,9999,0,9999,0
1653396354291,ECE 200,044,091046,Sievenpiper; Daniel F.,9999,0,9999,0
1653396354291,ECE 200,045,091047,Sworder; David D.,9999,0,9999,0
1653396354291,ECE 200,046,091048,Taur; Yuan,9999,0,9999,0
1653396354291,ECE 200,047,091049,Touri; Behrouz,9999,0,9999,0
1653396354291,ECE 200,048,091050,Trivedi; Mohan M.,9999,0,9999,0
1653396354291,ECE 200,049,091051,Vardy; Alexander,9999,0,9999,0
1653396354291,ECE 200,050,091052,Vasconcelos; Nuno,9999,0,9999,0
1653396354291,ECE 200,051,091053,Wang; Xiaolong,9999,0,9999,0
1653396354291,ECE 200,052,091054,Xie; Pengtao,9999,0,9999,0
1653396354291,ECE 200,053,091055,Yip; Michael,9999,0,9999,0
1653396354291,ECE 200,054,091056,Zeger; Kenneth A.,9999,0,9999,0
1653396354291,ECE 200,055,091057,Zhang; Xinyu,9999,0,9999,0
1653396354291,ECE 200,056,091058,Turakhia; Yatish Girish,9999,0,9999,0
1653396354291,ECE 200,057,091059,Kang; Mingu,9999,0,9999,0
1653396354291,ECE 200,058,091060,Shi; Yuanyuan,9999,0,9999,0
1653396354291,ECE 200,059,091061,Wang; Edward Jay,9999,0,9999,0
1653396354291,ECE 200,060,091062,Zheng; Yang,9999,0,9999,0
1653396354822,ECE 203,A00,091065,Mercier; Patrick Philip,0,0,0,0
1653396355353,ECE 207A,A00,091605,Liu; Thomas Tao-Ming,0,0,0,0
1653396355875,ECE 212AN,A00,091068,Nomura; Kenji,0,0,0,0
1653396356400,ECE 222A,A00,091069,Rebeiz; Gabriel,0,0,0,0
1653396356923,ECE 225A,A00,091070,Orlitsky; Alon,0,0,0,0
1653396357459,ECE 230A,A00,091071,Nomura; Kenji,0,0,0,0
1653396357985,ECE 236A,A00,091072,Dayeh; Shadi Ahmad,0,0,0,0
1653396358509,ECE 238A,A00,091073,Luo; Jian,0,0,0,0
1653396358509,ECE 238A,B00,091074,Luo; Jian,0,0,0,0
1653396359034,ECE 240A,A00,091075,Radic; Stojan,0,0,0,0
1653396359562,ECE 247A,A00,091592,Shi; Lingyan,0,0,0,0
1653396360086,ECE 250,A00,091076,Touri; Behrouz,0,0,0,0
1653396360613,ECE 251C,A00,091078,Nguyen; Truong Quang,0,0,0,0
1653396361145,ECE 253,A00,091079,Cosman; Pamela C.,0,0,0,0
1653396361670,ECE 255A,A00,091080,Orlitsky; Alon,0,0,0,0
1653396362196,ECE 257A,A00,091081,Zhang; Xinyu,0,0,0,0
1653396362723,ECE 260A,A01,091084,Eldon; John,0,0,0,0
1653396363248,ECE 264C,A00,091085,Galton; Ian A,0,0,0,0
1653396363779,ECE 265C,A00,094889,Presti; Calogero Davide,0,0,0,9
1653396364312,ECE 266,A01,091087,Hall; Drew A.,0,0,0,0
1653396365367,ECE 271A,A00,091090,Vasconcelos; Nuno,0,0,0,0
1653396365902,ECE 272B,A00,091091,Sworder; David D.,0,0,0,0
1653396366425,ECE 275A,A00,091092,Meyer; Florian,0,0,0,0
1653396366952,ECE 277,A00,091093,An; Cheolhong,0,0,0,0
1653396367479,ECE 283,A00,091094,Le; Hanh-Phuc,0,0,0,0
1653396368003,ECE 284,A00,091095,Kang; Mingu,0,0,0,0
1653396368003,ECE 284,B00,091096,Wang; Edward Jay,0,0,0,0
1653396368534,ECE 285,A00,094334,Touri; Behrouz,0,0,0,0
1653396369057,ECE 289,A00,091097,Whelan; David Arthur,0,0,0,0
1653396369587,MATH 200A,A00,087414,Salehi Golsefidy; Alireza,7,0,8,1
1653396370110,MATH 202A,A00,087415,Gill; Philip E.,3,0,8,5
1653396370640,MATH 203A,A00,087416,Oprea; Dragos N.,6,0,8,2
1653396371169,MATH 204A,A00,087417,Kedlaya; Kiran S.,6,0,8,2
1653396371697,MATH 205,A00,087418,Sorensen; Claus M,6,0,8,2
1653396372220,MATH 206A,A00,087419,Izadi; Elham,7,0,8,1
1653396372747,MATH 207A,A00,087420,Mohammadi; Amir,6,0,8,2
1653396373273,MATH 208,A00,087421,Staff,9,0,10,1
1653396373803,MATH 209,A00,087422,Staff,10,0,10,0
1653396374328,MATH 218,A00,087423,Staff,10,0,10,0
1653396374851,MATH 220A,A00,087424,Novak; Jonathan I,7,0,8,1
1653396375387,MATH 231A,A00,087425,Bejenaru; Ioan,4,0,8,4
1653396375911,MATH 240A,A00,087426,Ebenfelt; Peter F,5,0,8,3
1653396376437,MATH 243,A00,087427,Staff,9,0,10,1
1653396376966,MATH 248,A00,087429,Staff,10,0,10,0
1653396377490,MATH 250A,A00,087430,Spolaor; Luca,5,0,8,3
1653396378015,MATH 257A,A00,087431,Spolaor; Luca,7,0,8,1
1653396378538,MATH 258,A00,087432,Staff,9,0,10,1
1653396379062,MATH 264A,A00,087433,Warnke; Lutz Peter,5,0,8,3
1653396379591,MATH 268,A00,087434,Staff,15,0,15,0
1653396380117,MATH 269,A00,087435,Staff,14,0,15,1
1653396380646,MATH 270A,A00,087436,Nie; Jiawang,0,0,8,8
1653396381169,MATH 272A,A00,087437,Tian; Xiaochuan,2,0,8,6
1653396381699,MATH 274,A01,087439,Cheng; Li-Tien,9,0,10,1
1653396381699,MATH 274,A02,087440,Cheng; Li-Tien,10,0,10,0
1653396382297,MATH 278A,A00,087441,Staff,8,0,10,2
1653396382821,MATH 278B,A00,087442,Staff,8,0,10,2
1653396383347,MATH 278C,A00,087443,Staff,8,0,10,2
1653396383871,MATH 280A,A00,087444,Zheng; Tianyi,0,0,8,8
1653396384394,MATH 281A,A00,087445,Bradic; Jelena,0,0,8,8
1653396384924,MATH 282A,A00,087446,Zhang; Danna,0,0,8,8
1653396385447,MATH 283,A00,087447,Tesler; Glenn,0,0,0,13
1653396385971,MATH 286,A00,087448,Kemp; Todd Aahron,6,0,8,2
1653396386494,MATH 287D,A00,087449,Bradic; Jelena,8,0,8,0
1653396387021,MATH 288,A00,087450,Staff,14,0,15,1
1653396387021,MATH 288,B00,087451,Staff,15,0,15,0
1653396387021,MATH 288,C00,087452,Staff,15,0,15,0
1653396387547,MATH 290A,A00,087453,Xu; Zhouli,7,0,8,1
1653396388077,MATH 291A,A00,087454,Xu; Zhouli,7,0,8,1
1653396388601,MATH 292,A00,087455,Staff,10,0,10,0
1653396389125,MATH 295,A00,087456,Staff,50,0,50,0
1653396389649,MATH 297,001,087457,Staff,998,0,999,1
1653396951098,COGS 200,A01,087991,Staff,48,0,50,2
1653396951621,COGS 201,A01,094504,Rangel; Lara M,17,0,25,8
1653396952149,COGS 203,A00,087992,Coulson; Seana M,19,0,20,1
1653396952679,COGS 210A,001,087993,Greene; Deanna Jacquelyn,9998,0,9999,1
1653396952679,COGS 210A,002,087994,Saygin; Ayse P,9999,0,9999,0
1653396952679,COGS 210A,003,087995,Xia; Haijun,9999,0,9999,0
1653396952679,COGS 210A,004,087996,Nitz; Douglas A.,9999,0,9999,0
1653396952679,COGS 210A,005,087997,Hollan; James D.,9999,0,9999,0
1653396952679,COGS 210A,006,087998,Deak; Gedeon O.,9998,0,9999,1
1653396952679,COGS 210A,007,087999,Rossano; Federico,9999,0,9999,0
1653396953202,COGS 211A,A00,088000,Coulson; Seana M,9997,0,9999,2
1653396953727,COGS 229,A00,088002,Staff,23,0,25,2
1653396954250,COGS 260,B00,094231,Staff,17,0,20,3
1653396954250,COGS 260,A00,088004,Nitz; Douglas A.,9998,0,9999,1
1653396954784,CSE 202,A00,090110,Paturi; Ramamohan,0,0,0,0
1653396954784,CSE 202,B00,090111,Paturi; Ramamohan,0,0,0,0
1653396955308,CSE 207B,A00,090112,Heninger; Nadia A,0,0,0,0
1653396955836,CSE 208,A00,094858,Micciancio; Daniele,0,0,0,0
1653396956360,CSE 210,A00,090113,Powell; Thomas Allan,0,0,0,0
1653396956884,CSE 219,A00,090898,Staff,0,0,0,0
1653396957410,CSE 221,A00,090114,Zhou; Yuan-Yuan,0,0,0,0
1653396957943,CSE 229A,A00,090115,Porter; George M,0,0,0,0
1653396958468,CSE 229C,A00,090116,Savage; Stefan,0,0,0,0
1653396958993,CSE 230,A00,090117,Jhala; Ranjit,0,0,0,0
1653396959521,CSE 232,A00,090118,Papakonstantinou; Yannis,0,0,0,0
1653396960045,CSE 239A,A00,090121,Kumar; Arun Kumar,0,0,0,0
1653396960571,CSE 239B,A00,090122,Jhala; Ranjit,0,0,0,0
1653396961095,CSE 240A,A00,090123,Zhao; Jishen,0,0,189,189
1653396961622,CSE 243A,A00,090124,Orailoglu; Alex,3,0,15,12
1653396962145,CSE 249B,A00,090125,Kahng; Andrew Byun,14,0,20,6
1653396962674,CSE 250A,A00,090126,Berg-Kirkpatrick; Taylor D,0,0,0,0
1653396963201,CSE 252A,A00,090127,Ochoa; Benjamin Lawrence,0,0,0,0
1653396963728,CSE 258,A01,090129,McAuley; Julian John,0,0,0,0
1653396964252,CSE 258R,A01,090131,McAuley; Julian John,0,0,0,0
1653396964791,CSE 274,A00,090132,Ramamoorthi; Ravi,0,0,0,0
1653396965316,CSE 276A,A00,090133,Christensen; Henrik I,0,0,0,0
1653396965905,CSE 276C,A00,090134,Christensen; Henrik I,0,0,0,0
1653396966432,CSE 290,A00,090135,Bafna; Vineet,0,0,0,0
1653396966432,CSE 290,B00,090136,Ramamoorthi; Ravi,0,0,0,0
1653396966432,CSE 290,C00,090137,Li; Tzumao,10,0,10,0
1653396966432,CSE 290,D00,090138,Zhou; Yuan-Yuan,10,0,10,0
1653396966432,CSE 290,E00,090139,Christensen; Henrik I,10,0,10,0
1653396966432,CSE 290,F00,094053,Shalev; Aaron D,0,0,0,0
1653396966963,CSE 291,A00,090140,Munyaka; Imani N. S.,0,0,0,0
1653396966963,CSE 291,B00,094880,Yu; Qi,0,0,0,0
1653396966963,CSE 291,C00,090142,Pannuto; Patrick William,0,0,0,0
1653396966963,CSE 291,D00,094881,Zhang; Yiying,0,0,0,0
1653396966963,CSE 291,E00,095118,Su; Hao,0,0,0,0
1653396967513,CSE 293,001,094905,Bafna; Vineet,9999,0,9999,0
1653396967513,CSE 293,002,094906,Bellare; Mihir,9999,0,9999,0
1653396967513,CSE 293,003,094907,Berg-Kirkpatrick; Taylor D,9999,0,9999,0
1653396967513,CSE 293,004,094908,Christensen; Henrik I,9999,0,9999,0
1653396967513,CSE 293,005,094909,Cottrell; Garrison W,9999,0,9999,0
1653396967513,CSE 293,006,094910,Deutsch; Alin Bernard,9999,0,9999,0
1653396967513,CSE 293,007,094911,Esmaeilzadeh; Hadi,9999,0,9999,0
1653396967513,CSE 293,008,094912,Freund; Yoav,9999,0,9999,0
1653396967513,CSE 293,009,094913,Griswold; William G.,9999,0,9999,0
1653396967513,CSE 293,010,094914,Gymrek; Melissa Ann,9999,0,9999,0
1653396967513,CSE 293,011,094915,Heninger; Nadia A,9999,0,9999,0
1653396967513,CSE 293,012,094916,Impagliazzo; Russell,9999,0,9999,0
1653396967513,CSE 293,013,094917,Jhala; Ranjit,9999,0,9999,0
1653396967513,CSE 293,014,094918,Kahng; Andrew Byun,9999,0,9999,0
1653396967513,CSE 293,015,094919,Kane; Daniel Mertz,9999,0,9999,0
1653396967513,CSE 293,016,094920,Kriegman; David J,9999,0,9999,0
1653396967513,CSE 293,017,094921,Kumar; Arun Kumar,9999,0,9999,0
1653396967513,CSE 293,018,094922,Lerner; Sorin,9999,0,9999,0
1653396967513,CSE 293,019,094923,Lovett; Shachar,9999,0,9999,0
1653396967513,CSE 293,020,094924,McAuley; Julian John,9999,0,9999,0
1653396967513,CSE 293,021,094925,Micciancio; Daniele,9999,0,9999,0
1653396967513,CSE 293,022,094926,Orailoglu; Alex,9999,0,9999,0
1653396967513,CSE 293,023,094927,Paturi; Ramamohan,9999,0,9999,0
1653396967513,CSE 293,024,094928,Polikarpova; Nadezhda,9999,0,9999,0
1653396967513,CSE 293,025,094929,Politz; Joseph Gibbs,9999,0,9999,0
1653396967513,CSE 293,026,094930,Porter; George M,9999,0,9999,0
1653396967513,CSE 293,027,094931,Porter; Leonard Emerson,9999,0,9999,0
1653396967513,CSE 293,028,094932,Ramamoorthi; Ravi,9999,0,9999,0
1653396967513,CSE 293,029,094933,Sahoo; Debashis,9999,0,9999,0
1653396967513,CSE 293,030,094934,Saul; Lawrence,9999,0,9999,0
1653396967513,CSE 293,031,094935,Savage; Stefan,9999,0,9999,0
1653396967513,CSE 293,032,094936,Schulze; Jurgen P.,9999,0,9999,0
1653396967513,CSE 293,033,094937,Snoeren; Alex C.,9999,0,9999,0
1653396967513,CSE 293,034,094938,Shang; Jingbo,9999,0,9999,0
1653396967513,CSE 293,035,094939,Stefan; Deian,9999,0,9999,0
1653396967513,CSE 293,036,094940,Su; Hao,9999,0,9999,0
1653396967513,CSE 293,037,094941,Swanson; Steven James,9999,0,9999,0
1653396967513,CSE 293,038,094942,Tullsen; Dean Michael,9999,0,9999,0
1653396967513,CSE 293,039,094943,Voelker; Geoffrey M.,9999,0,9999,0
1653396967513,CSE 293,040,094944,Zhao; Jishen,9999,0,9999,0
1653396967513,CSE 293,041,094945,Zhou; Yuan-Yuan,9999,0,9999,0
1653396967513,CSE 293,042,094946,Gao; Sicun,9998,0,9999,1
1653396967513,CSE 293,043,094947,Weibel; Nadir,9999,0,9999,0
1653396967513,CSE 293,044,094948,Gupta; Rajesh K.,9999,0,9999,0
1653396968038,CSE 294,A00,090143,Porter; George M,9,0,10,1
1653396968562,DSE 200,A00,091799,Staff,50,0,50,0
1653396969085,DSE 203,A00,091800,Gupta; Amarnath,30,0,30,0
1653396969606,DSE 250,A00,091801,Deutsch; Alin Bernard,30,0,30,0
1653396970135,DSE 290,A00,091802,Altintas De Callaf; Ilkay,50,0,50,0
1653396970725,ECE 200,001,091003,Antipa; Nicholas A,9999,0,9999,0
1653396970725,ECE 200,002,091004,Atanasov; Nikolay A.,9999,0,9999,0
1653396970725,ECE 200,003,091005,Bharadia; Dinesh,9999,0,9999,0
1653396970725,ECE 200,004,091006,Cheng; Chung Kuan,9999,0,9999,0
1653396970725,ECE 200,005,091007,Cosman; Pamela C.,9999,0,9999,0
1653396970725,ECE 200,006,091008,Staff,9999,0,9999,0
1653396970725,ECE 200,007,091009,Dayeh; Shadi Ahmad,9999,0,9999,0
1653396970725,ECE 200,008,091010,Fainman; Yeshaiahu,9999,0,9999,0
1653396970725,ECE 200,009,091011,Ford; Joseph Earl,9999,0,9999,0
1653396970725,ECE 200,010,091012,Franceschetti; Massimo,9999,0,9999,0
1653396970725,ECE 200,011,091013,Fullerton; Eric E,9999,0,9999,0
1653396970725,ECE 200,012,091014,Galton; Ian A,9999,0,9999,0
1653396970725,ECE 200,013,091015,Gilja; Vikash,9999,0,9999,0
1653396970725,ECE 200,014,091016,Hall; Drew A.,9999,0,9999,0
1653396970725,ECE 200,015,091017,Hsueh; Tzu-Chien,9999,0,9999,0
1653396970725,ECE 200,016,091018,Javidi; Tara,9999,0,9999,0
1653396970725,ECE 200,017,091019,Kahng; Andrew Byun,9999,0,9999,0
1653396970725,ECE 200,018,091020,Kim; Young-Han,9999,0,9999,0
1653396970725,ECE 200,019,091021,Koushanfar; Farinaz,9999,0,9999,0
1653396970725,ECE 200,020,091022,Kuzum; Duygu,9999,0,9999,0
1653396970725,ECE 200,021,091023,Le; Hanh-Phuc,9999,0,9999,0
1653396970725,ECE 200,022,091024,Lin; Bill,9999,0,9999,0
1653396970725,ECE 200,023,091025,Liu; Zhaowei,9999,0,9999,0
1653396970725,ECE 200,024,091026,Lo; Yu-Hwa,9999,0,9999,0
1653396970725,ECE 200,025,091027,Lomakin; Vitaliy,9999,0,9999,0
1653396970725,ECE 200,026,091028,Mercier; Patrick Philip,9999,0,9999,0
1653396970725,ECE 200,027,091029,Meyer; Florian,9999,0,9999,0
1653396970725,ECE 200,028,091030,Milstein; Laurence B.,9999,0,9999,0
1653396970725,ECE 200,029,091031,Mir Arabbaygi; Siavash,9999,0,9999,0
1653396970725,ECE 200,030,091032,Mookherjea; Shayan,9999,0,9999,0
1653396970725,ECE 200,031,091033,Morris; Karcher William,9999,0,9999,0
1653396970725,ECE 200,032,091034,Ng; Tse Nga,9999,0,9999,0
1653396970725,ECE 200,033,091035,Nguyen; Truong Quang,9999,0,9999,0
1653396970725,ECE 200,034,091036,Nomura; Kenji,9999,0,9999,0
1653396970725,ECE 200,035,091037,Orlitsky; Alon,9999,0,9999,0
1653396970725,ECE 200,036,091038,Pal; Piya,9999,0,9999,0
1653396970725,ECE 200,037,091039,Papen; George C.,9999,0,9999,0
1653396970725,ECE 200,038,091040,Radic; Stojan,9999,0,9999,0
1653396970725,ECE 200,039,091041,Rao; Bhaskar D.,9999,0,9999,0
1653396970725,ECE 200,040,091042,Rao; Ramesh R,9999,0,9999,0
1653396970725,ECE 200,041,091043,Rebeiz; Gabriel,9999,0,9999,0
1653396970725,ECE 200,042,091044,Sanford; John R,9999,0,9999,0
1653396970725,ECE 200,043,091045,Siegel; Paul H.,9999,0,9999,0
1653396970725,ECE 200,044,091046,Sievenpiper; Daniel F.,9999,0,9999,0
1653396970725,ECE 200,045,091047,Sworder; David D.,9999,0,9999,0
1653396970725,ECE 200,046,091048,Taur; Yuan,9999,0,9999,0
1653396970725,ECE 200,047,091049,Touri; Behrouz,9999,0,9999,0
1653396970725,ECE 200,048,091050,Trivedi; Mohan M.,9999,0,9999,0
1653396970725,ECE 200,049,091051,Vardy; Alexander,9999,0,9999,0
1653396970725,ECE 200,050,091052,Vasconcelos; Nuno,9999,0,9999,0
1653396970725,ECE 200,051,091053,Wang; Xiaolong,9999,0,9999,0
1653396970725,ECE 200,052,091054,Xie; Pengtao,9999,0,9999,0
1653396970725,ECE 200,053,091055,Yip; Michael,9999,0,9999,0
1653396970725,ECE 200,054,091056,Zeger; Kenneth A.,9999,0,9999,0
1653396970725,ECE 200,055,091057,Zhang; Xinyu,9999,0,9999,0
1653396970725,ECE 200,056,091058,Turakhia; Yatish Girish,9999,0,9999,0
1653396970725,ECE 200,057,091059,Kang; Mingu,9999,0,9999,0
1653396970725,ECE 200,058,091060,Shi; Yuanyuan,9999,0,9999,0
1653396970725,ECE 200,059,091061,Wang; Edward Jay,9999,0,9999,0
1653396970725,ECE 200,060,091062,Zheng; Yang,9999,0,9999,0
1653396971338,ECE 203,A00,091065,Mercier; Patrick Philip,0,0,0,0
1653396971869,ECE 207A,A00,091605,Liu; Thomas Tao-Ming,0,0,0,0
1653396972394,ECE 212AN,A00,091068,Nomura; Kenji,0,0,0,0
1653396972919,ECE 222A,A00,091069,Rebeiz; Gabriel,0,0,0,0
1653396973448,ECE 225A,A00,091070,Orlitsky; Alon,0,0,0,0
1653396973970,ECE 230A,A00,091071,Nomura; Kenji,0,0,0,0
1653396974492,ECE 236A,A00,091072,Dayeh; Shadi Ahmad,0,0,0,0
1653396975018,ECE 238A,A00,091073,Luo; Jian,0,0,0,0
1653396975018,ECE 238A,B00,091074,Luo; Jian,0,0,0,0
1653396975547,ECE 240A,A00,091075,Radic; Stojan,0,0,0,0
1653396976071,ECE 247A,A00,091592,Shi; Lingyan,0,0,0,0
1653396976595,ECE 250,A00,091076,Touri; Behrouz,0,0,0,0
1653396977120,ECE 251C,A00,091078,Nguyen; Truong Quang,0,0,0,0
1653396977648,ECE 253,A00,091079,Cosman; Pamela C.,0,0,0,0
1653396978169,ECE 255A,A00,091080,Orlitsky; Alon,0,0,0,0
1653396978696,ECE 257A,A00,091081,Zhang; Xinyu,0,0,0,0
1653396979226,ECE 260A,A01,091084,Eldon; John,0,0,0,0
1653396979754,ECE 264C,A00,091085,Galton; Ian A,0,0,0,0
1653396980282,ECE 265C,A00,094889,Presti; Calogero Davide,0,0,0,9
1653396980809,ECE 266,A01,091087,Hall; Drew A.,0,0,0,0
1653396981861,ECE 271A,A00,091090,Vasconcelos; Nuno,0,0,0,0
1653396982387,ECE 272B,A00,091091,Sworder; David D.,0,0,0,0
1653396982927,ECE 275A,A00,091092,Meyer; Florian,0,0,0,0
1653396983455,ECE 277,A00,091093,An; Cheolhong,0,0,0,0
1653396983979,ECE 283,A00,091094,Le; Hanh-Phuc,0,0,0,0
1653396984505,ECE 284,A00,091095,Kang; Mingu,0,0,0,0
1653396984505,ECE 284,B00,091096,Wang; Edward Jay,0,0,0,0
1653396985030,ECE 285,A00,094334,Touri; Behrouz,0,0,0,0
1653396985553,ECE 289,A00,091097,Whelan; David Arthur,0,0,0,0
1653396986087,MATH 200A,A00,087414,Salehi Golsefidy; Alireza,7,0,8,1
1653396986614,MATH 202A,A00,087415,Gill; Philip E.,3,0,8,5
1653396987138,MATH 203A,A00,087416,Oprea; Dragos N.,6,0,8,2
1653396987661,MATH 204A,A00,087417,Kedlaya; Kiran S.,6,0,8,2
1653396988185,MATH 205,A00,087418,Sorensen; Claus M,6,0,8,2
1653396988708,MATH 206A,A00,087419,Izadi; Elham,7,0,8,1
1653396989232,MATH 207A,A00,087420,Mohammadi; Amir,6,0,8,2
1653396989757,MATH 208,A00,087421,Staff,9,0,10,1
1653396990285,MATH 209,A00,087422,Staff,10,0,10,0
1653396990808,MATH 218,A00,087423,Staff,10,0,10,0
1653396991333,MATH 220A,A00,087424,Novak; Jonathan I,7,0,8,1
1653396991856,MATH 231A,A00,087425,Bejenaru; Ioan,4,0,8,4
1653396992380,MATH 240A,A00,087426,Ebenfelt; Peter F,5,0,8,3
1653396992904,MATH 243,A00,087427,Staff,9,0,10,1
1653396993429,MATH 248,A00,087429,Staff,10,0,10,0
1653396993959,MATH 250A,A00,087430,Spolaor; Luca,5,0,8,3
1653396994494,MATH 257A,A00,087431,Spolaor; Luca,7,0,8,1
1653396995015,MATH 258,A00,087432,Staff,9,0,10,1
1653396995539,MATH 264A,A00,087433,Warnke; Lutz Peter,5,0,8,3
1653396996064,MATH 268,A00,087434,Staff,15,0,15,0
1653396996589,MATH 269,A00,087435,Staff,14,0,15,1
1653396997118,MATH 270A,A00,087436,Nie; Jiawang,0,0,8,8
1653396997642,MATH 272A,A00,087437,Tian; Xiaochuan,2,0,8,6
1653396998167,MATH 274,A01,087439,Cheng; Li-Tien,9,0,10,1
1653396998167,MATH 274,A02,087440,Cheng; Li-Tien,10,0,10,0
1653396998699,MATH 278A,A00,087441,Staff,8,0,10,2
1653396999221,MATH 278B,A00,087442,Staff,8,0,10,2
1653396999743,MATH 278C,A00,087443,Staff,8,0,10,2
1653397000270,MATH 280A,A00,087444,Zheng; Tianyi,0,0,8,8
1653397000795,MATH 281A,A00,087445,Bradic; Jelena,0,0,8,8
1653397001318,MATH 282A,A00,087446,Zhang; Danna,0,0,8,8
1653397001841,MATH 283,A00,087447,Tesler; Glenn,0,0,0,13
1653397002365,MATH 286,A00,087448,Kemp; Todd Aahron,6,0,8,2
1653397002898,MATH 287D,A00,087449,Bradic; Jelena,8,0,8,0
1653397003420,MATH 288,A00,087450,Staff,14,0,15,1
1653397003420,MATH 288,B00,087451,Staff,15,0,15,0
1653397003420,MATH 288,C00,087452,Staff,15,0,15,0
1653397003947,MATH 290A,A00,087453,Xu; Zhouli,7,0,8,1
1653397004480,MATH 291A,A00,087454,Xu; Zhouli,7,0,8,1
1653397005008,MATH 292,A00,087455,Staff,10,0,10,0
1653397005537,MATH 295,A00,087456,Staff,50,0,50,0
1653397006061,MATH 297,001,087457,Staff,998,0,999,1
1653397567197,COGS 200,A01,087991,Staff,48,0,50,2
1653397567727,COGS 201,A01,094504,Rangel; Lara M,17,0,25,8
1653397568252,COGS 203,A00,087992,Coulson; Seana M,19,0,20,1
1653397568789,COGS 210A,001,087993,Greene; Deanna Jacquelyn,9998,0,9999,1
1653397568789,COGS 210A,002,087994,Saygin; Ayse P,9999,0,9999,0
1653397568789,COGS 210A,003,087995,Xia; Haijun,9999,0,9999,0
1653397568789,COGS 210A,004,087996,Nitz; Douglas A.,9999,0,9999,0
1653397568789,COGS 210A,005,087997,Hollan; James D.,9999,0,9999,0
1653397568789,COGS 210A,006,087998,Deak; Gedeon O.,9998,0,9999,1
1653397568789,COGS 210A,007,087999,Rossano; Federico,9999,0,9999,0
1653397569310,COGS 211A,A00,088000,Coulson; Seana M,9997,0,9999,2
1653397569841,COGS 229,A00,088002,Staff,23,0,25,2
1653397570363,COGS 260,B00,094231,Staff,17,0,20,3
1653397570363,COGS 260,A00,088004,Nitz; Douglas A.,9998,0,9999,1
1653397570895,CSE 202,A00,090110,Paturi; Ramamohan,0,0,0,0
1653397570895,CSE 202,B00,090111,Paturi; Ramamohan,0,0,0,0
1653397571420,CSE 207B,A00,090112,Heninger; Nadia A,0,0,0,0
1653397571952,CSE 208,A00,094858,Micciancio; Daniele,0,0,0,0
1653397572477,CSE 210,A00,090113,Powell; Thomas Allan,0,0,0,0
1653397573002,CSE 219,A00,090898,Staff,0,0,0,0
1653397573524,CSE 221,A00,090114,Zhou; Yuan-Yuan,0,0,0,0
1653397574059,CSE 229A,A00,090115,Porter; George M,0,0,0,0
1653397574584,CSE 229C,A00,090116,Savage; Stefan,0,0,0,0
1653397575107,CSE 230,A00,090117,Jhala; Ranjit,0,0,0,0
1653397575637,CSE 232,A00,090118,Papakonstantinou; Yannis,0,0,0,0
1653397576160,CSE 239A,A00,090121,Kumar; Arun Kumar,0,0,0,0
1653397576686,CSE 239B,A00,090122,Jhala; Ranjit,0,0,0,0
1653397577217,CSE 240A,A00,090123,Zhao; Jishen,0,0,189,189
1653397577740,CSE 243A,A00,090124,Orailoglu; Alex,3,0,15,12
1653397578263,CSE 249B,A00,090125,Kahng; Andrew Byun,14,0,20,6
1653397578787,CSE 250A,A00,090126,Berg-Kirkpatrick; Taylor D,0,0,0,0
1653397579313,CSE 252A,A00,090127,Ochoa; Benjamin Lawrence,0,0,0,0
1653397579840,CSE 258,A01,090129,McAuley; Julian John,0,0,0,0
1653397580367,CSE 258R,A01,090131,McAuley; Julian John,0,0,0,0
1653397580893,CSE 274,A00,090132,Ramamoorthi; Ravi,0,0,0,0
1653397581414,CSE 276A,A00,090133,Christensen; Henrik I,0,0,0,0
1653397581939,CSE 276C,A00,090134,Christensen; Henrik I,0,0,0,0
1653397582468,CSE 290,A00,090135,Bafna; Vineet,0,0,0,0
1653397582468,CSE 290,B00,090136,Ramamoorthi; Ravi,0,0,0,0
1653397582468,CSE 290,C00,090137,Li; Tzumao,10,0,10,0
1653397582468,CSE 290,D00,090138,Zhou; Yuan-Yuan,10,0,10,0
1653397582468,CSE 290,E00,090139,Christensen; Henrik I,10,0,10,0
1653397582468,CSE 290,F00,094053,Shalev; Aaron D,0,0,0,0
1653397583002,CSE 291,A00,090140,Munyaka; Imani N. S.,0,0,0,0
1653397583002,CSE 291,B00,094880,Yu; Qi,0,0,0,0
1653397583002,CSE 291,C00,090142,Pannuto; Patrick William,0,0,0,0
1653397583002,CSE 291,D00,094881,Zhang; Yiying,0,0,0,0
1653397583002,CSE 291,E00,095118,Su; Hao,0,0,0,0
1653397583559,CSE 293,001,094905,Bafna; Vineet,9999,0,9999,0
1653397583559,CSE 293,002,094906,Bellare; Mihir,9999,0,9999,0
1653397583559,CSE 293,003,094907,Berg-Kirkpatrick; Taylor D,9999,0,9999,0
1653397583559,CSE 293,004,094908,Christensen; Henrik I,9999,0,9999,0
1653397583559,CSE 293,005,094909,Cottrell; Garrison W,9999,0,9999,0
1653397583559,CSE 293,006,094910,Deutsch; Alin Bernard,9999,0,9999,0
1653397583559,CSE 293,007,094911,Esmaeilzadeh; Hadi,9999,0,9999,0
1653397583559,CSE 293,008,094912,Freund; Yoav,9999,0,9999,0
1653397583559,CSE 293,009,094913,Griswold; William G.,9999,0,9999,0
1653397583559,CSE 293,010,094914,Gymrek; Melissa Ann,9999,0,9999,0
1653397583559,CSE 293,011,094915,Heninger; Nadia A,9999,0,9999,0
1653397583559,CSE 293,012,094916,Impagliazzo; Russell,9999,0,9999,0
1653397583559,CSE 293,013,094917,Jhala; Ranjit,9999,0,9999,0
1653397583559,CSE 293,014,094918,Kahng; Andrew Byun,9999,0,9999,0
1653397583559,CSE 293,015,094919,Kane; Daniel Mertz,9999,0,9999,0
1653397583559,CSE 293,016,094920,Kriegman; David J,9999,0,9999,0
1653397583559,CSE 293,017,094921,Kumar; Arun Kumar,9999,0,9999,0
1653397583559,CSE 293,018,094922,Lerner; Sorin,9999,0,9999,0
1653397583559,CSE 293,019,094923,Lovett; Shachar,9999,0,9999,0
1653397583559,CSE 293,020,094924,McAuley; Julian John,9999,0,9999,0
1653397583559,CSE 293,021,094925,Micciancio; Daniele,9999,0,9999,0
1653397583559,CSE 293,022,094926,Orailoglu; Alex,9999,0,9999,0
1653397583559,CSE 293,023,094927,Paturi; Ramamohan,9999,0,9999,0
1653397583559,CSE 293,024,094928,Polikarpova; Nadezhda,9999,0,9999,0
1653397583559,CSE 293,025,094929,Politz; Joseph Gibbs,9999,0,9999,0
1653397583559,CSE 293,026,094930,Porter; George M,9999,0,9999,0
1653397583559,CSE 293,027,094931,Porter; Leonard Emerson,9999,0,9999,0
1653397583559,CSE 293,028,094932,Ramamoorthi; Ravi,9999,0,9999,0
1653397583559,CSE 293,029,094933,Sahoo; Debashis,9999,0,9999,0
1653397583559,CSE 293,030,094934,Saul; Lawrence,9999,0,9999,0
1653397583559,CSE 293,031,094935,Savage; Stefan,9999,0,9999,0
1653397583559,CSE 293,032,094936,Schulze; Jurgen P.,9999,0,9999,0
1653397583559,CSE 293,033,094937,Snoeren; Alex C.,9999,0,9999,0
1653397583559,CSE 293,034,094938,Shang; Jingbo,9999,0,9999,0
1653397583559,CSE 293,035,094939,Stefan; Deian,9999,0,9999,0
1653397583559,CSE 293,036,094940,Su; Hao,9999,0,9999,0
1653397583559,CSE 293,037,094941,Swanson; Steven James,9999,0,9999,0
1653397583559,CSE 293,038,094942,Tullsen; Dean Michael,9999,0,9999,0
1653397583559,CSE 293,039,094943,Voelker; Geoffrey M.,9999,0,9999,0
1653397583559,CSE 293,040,094944,Zhao; Jishen,9999,0,9999,0
1653397583559,CSE 293,041,094945,Zhou; Yuan-Yuan,9999,0,9999,0
1653397583559,CSE 293,042,094946,Gao; Sicun,9998,0,9999,1
1653397583559,CSE 293,043,094947,Weibel; Nadir,9999,0,9999,0
1653397583559,CSE 293,044,094948,Gupta; Rajesh K.,9999,0,9999,0
1653397584080,CSE 294,A00,090143,Porter; George M,9,0,10,1
1653397584613,DSE 200,A00,091799,Staff,50,0,50,0
1653397585138,DSE 203,A00,091800,Gupta; Amarnath,30,0,30,0
1653397585660,DSE 250,A00,091801,Deutsch; Alin Bernard,30,0,30,0
1653397586184,DSE 290,A00,091802,Altintas De Callaf; Ilkay,50,0,50,0
1653397586808,ECE 200,001,091003,Antipa; Nicholas A,9999,0,9999,0
1653397586808,ECE 200,002,091004,Atanasov; Nikolay A.,9999,0,9999,0
1653397586808,ECE 200,003,091005,Bharadia; Dinesh,9999,0,9999,0
1653397586808,ECE 200,004,091006,Cheng; Chung Kuan,9999,0,9999,0
1653397586808,ECE 200,005,091007,Cosman; Pamela C.,9999,0,9999,0
1653397586808,ECE 200,006,091008,Staff,9999,0,9999,0
1653397586808,ECE 200,007,091009,Dayeh; Shadi Ahmad,9999,0,9999,0
1653397586808,ECE 200,008,091010,Fainman; Yeshaiahu,9999,0,9999,0
1653397586808,ECE 200,009,091011,Ford; Joseph Earl,9999,0,9999,0
1653397586808,ECE 200,010,091012,Franceschetti; Massimo,9999,0,9999,0
1653397586808,ECE 200,011,091013,Fullerton; Eric E,9999,0,9999,0
1653397586808,ECE 200,012,091014,Galton; Ian A,9999,0,9999,0
1653397586808,ECE 200,013,091015,Gilja; Vikash,9999,0,9999,0
1653397586808,ECE 200,014,091016,Hall; Drew A.,9999,0,9999,0
1653397586808,ECE 200,015,091017,Hsueh; Tzu-Chien,9999,0,9999,0
1653397586808,ECE 200,016,091018,Javidi; Tara,9999,0,9999,0
1653397586808,ECE 200,017,091019,Kahng; Andrew Byun,9999,0,9999,0
1653397586808,ECE 200,018,091020,Kim; Young-Han,9999,0,9999,0
1653397586808,ECE 200,019,091021,Koushanfar; Farinaz,9999,0,9999,0
1653397586808,ECE 200,020,091022,Kuzum; Duygu,9999,0,9999,0
1653397586808,ECE 200,021,091023,Le; Hanh-Phuc,9999,0,9999,0
1653397586808,ECE 200,022,091024,Lin; Bill,9999,0,9999,0
1653397586808,ECE 200,023,091025,Liu; Zhaowei,9999,0,9999,0
1653397586808,ECE 200,024,091026,Lo; Yu-Hwa,9999,0,9999,0
1653397586808,ECE 200,025,091027,Lomakin; Vitaliy,9999,0,9999,0
1653397586808,ECE 200,026,091028,Mercier; Patrick Philip,9999,0,9999,0
1653397586808,ECE 200,027,091029,Meyer; Florian,9999,0,9999,0
1653397586808,ECE 200,028,091030,Milstein; Laurence B.,9999,0,9999,0
1653397586808,ECE 200,029,091031,Mir Arabbaygi; Siavash,9999,0,9999,0
1653397586808,ECE 200,030,091032,Mookherjea; Shayan,9999,0,9999,0
1653397586808,ECE 200,031,091033,Morris; Karcher William,9999,0,9999,0
1653397586808,ECE 200,032,091034,Ng; Tse Nga,9999,0,9999,0
1653397586808,ECE 200,033,091035,Nguyen; Truong Quang,9999,0,9999,0
1653397586808,ECE 200,034,091036,Nomura; Kenji,9999,0,9999,0
1653397586808,ECE 200,035,091037,Orlitsky; Alon,9999,0,9999,0
1653397586808,ECE 200,036,091038,Pal; Piya,9999,0,9999,0
1653397586808,ECE 200,037,091039,Papen; George C.,9999,0,9999,0
1653397586808,ECE 200,038,091040,Radic; Stojan,9999,0,9999,0
1653397586808,ECE 200,039,091041,Rao; Bhaskar D.,9999,0,9999,0
1653397586808,ECE 200,040,091042,Rao; Ramesh R,9999,0,9999,0
1653397586808,ECE 200,041,091043,Rebeiz; Gabriel,9999,0,9999,0
1653397586808,ECE 200,042,091044,Sanford; John R,9999,0,9999,0
1653397586808,ECE 200,043,091045,Siegel; Paul H.,9999,0,9999,0
1653397586808,ECE 200,044,091046,Sievenpiper; Daniel F.,9999,0,9999,0
1653397586808,ECE 200,045,091047,Sworder; David D.,9999,0,9999,0
1653397586808,ECE 200,046,091048,Taur; Yuan,9999,0,9999,0
1653397586808,ECE 200,047,091049,Touri; Behrouz,9999,0,9999,0
1653397586808,ECE 200,048,091050,Trivedi; Mohan M.,9999,0,9999,0
1653397586808,ECE 200,049,091051,Vardy; Alexander,9999,0,9999,0
1653397586808,ECE 200,050,091052,Vasconcelos; Nuno,9999,0,9999,0
1653397586808,ECE 200,051,091053,Wang; Xiaolong,9999,0,9999,0
1653397586808,ECE 200,052,091054,Xie; Pengtao,9999,0,9999,0
1653397586808,ECE 200,053,091055,Yip; Michael,9999,0,9999,0
1653397586808,ECE 200,054,091056,Zeger; Kenneth A.,9999,0,9999,0
1653397586808,ECE 200,055,091057,Zhang; Xinyu,9999,0,9999,0
1653397586808,ECE 200,056,091058,Turakhia; Yatish Girish,9999,0,9999,0
1653397586808,ECE 200,057,091059,Kang; Mingu,9999,0,9999,0
1653397586808,ECE 200,058,091060,Shi; Yuanyuan,9999,0,9999,0
1653397586808,ECE 200,059,091061,Wang; Edward Jay,9999,0,9999,0
1653397586808,ECE 200,060,091062,Zheng; Yang,9999,0,9999,0
1653397587338,ECE 203,A00,091065,Mercier; Patrick Philip,0,0,0,0
1653397587870,ECE 207A,A00,091605,Liu; Thomas Tao-Ming,0,0,0,0
1653397588393,ECE 212AN,A00,091068,Nomura; Kenji,0,0,0,0
1653397588919,ECE 222A,A00,091069,Rebeiz; Gabriel,0,0,0,0
1653397589443,ECE 225A,A00,091070,Orlitsky; Alon,0,0,0,0
1653397589974,ECE 230A,A00,091071,Nomura; Kenji,0,0,0,0
1653397590500,ECE 236A,A00,091072,Dayeh; Shadi Ahmad,0,0,0,0
1653397591029,ECE 238A,A00,091073,Luo; Jian,0,0,0,0
1653397591029,ECE 238A,B00,091074,Luo; Jian,0,0,0,0
1653397591553,ECE 240A,A00,091075,Radic; Stojan,0,0,0,0
1653397592081,ECE 247A,A00,091592,Shi; Lingyan,0,0,0,0
1653397592606,ECE 250,A00,091076,Touri; Behrouz,0,0,0,0
1653397593136,ECE 251C,A00,091078,Nguyen; Truong Quang,0,0,0,0
1653397593660,ECE 253,A00,091079,Cosman; Pamela C.,0,0,0,0
1653397594183,ECE 255A,A00,091080,Orlitsky; Alon,0,0,0,0
1653397594712,ECE 257A,A00,091081,Zhang; Xinyu,0,0,0,0
1653397595235,ECE 260A,A01,091084,Eldon; John,0,0,0,0
1653397595760,ECE 264C,A00,091085,Galton; Ian A,0,0,0,0
1653397596283,ECE 265C,A00,094889,Presti; Calogero Davide,0,0,0,9
1653397596811,ECE 266,A01,091087,Hall; Drew A.,0,0,0,0
1653397597869,ECE 271A,A00,091090,Vasconcelos; Nuno,0,0,0,0
1653397598396,ECE 272B,A00,091091,Sworder; David D.,0,0,0,0
1653397598922,ECE 275A,A00,091092,Meyer; Florian,0,0,0,0
1653397599446,ECE 277,A00,091093,An; Cheolhong,0,0,0,0
1653397599968,ECE 283,A00,091094,Le; Hanh-Phuc,0,0,0,0
1653397600492,ECE 284,A00,091095,Kang; Mingu,0,0,0,0
1653397600492,ECE 284,B00,091096,Wang; Edward Jay,0,0,0,0
1653397601014,ECE 285,A00,094334,Touri; Behrouz,0,0,0,0
1653397601540,ECE 289,A00,091097,Whelan; David Arthur,0,0,0,0
1653397602071,MATH 200A,A00,087414,Salehi Golsefidy; Alireza,7,0,8,1
1653397602614,MATH 202A,A00,087415,Gill; Philip E.,3,0,8,5
1653397603142,MATH 203A,A00,087416,Oprea; Dragos N.,6,0,8,2
1653397603676,MATH 204A,A00,087417,Kedlaya; Kiran S.,6,0,8,2
1653397604200,MATH 205,A00,087418,Sorensen; Claus M,6,0,8,2
1653397604726,MATH 206A,A00,087419,Izadi; Elham,7,0,8,1
1653397605254,MATH 207A,A00,087420,Mohammadi; Amir,6,0,8,2
1653397605778,MATH 208,A00,087421,Staff,9,0,10,1
1653397606302,MATH 209,A00,087422,Staff,10,0,10,0
1653397606828,MATH 218,A00,087423,Staff,10,0,10,0
1653397607353,MATH 220A,A00,087424,Novak; Jonathan I,7,0,8,1
1653397607877,MATH 231A,A00,087425,Bejenaru; Ioan,4,0,8,4
1653397608424,MATH 240A,A00,087426,Ebenfelt; Peter F,5,0,8,3
1653397608946,MATH 243,A00,087427,Staff,9,0,10,1
1653397609470,MATH 248,A00,087429,Staff,10,0,10,0
1653397609992,MATH 250A,A00,087430,Spolaor; Luca,5,0,8,3
1653397610517,MATH 257A,A00,087431,Spolaor; Luca,7,0,8,1
1653397611039,MATH 258,A00,087432,Staff,9,0,10,1
1653397611564,MATH 264A,A00,087433,Warnke; Lutz Peter,5,0,8,3
1653397612093,MATH 268,A00,087434,Staff,15,0,15,0
1653397612616,MATH 269,A00,087435,Staff,14,0,15,1
1653397613211,MATH 270A,A00,087436,Nie; Jiawang,0,0,8,8
1653397613741,MATH 272A,A00,087437,Tian; Xiaochuan,2,0,8,6
1653397614264,MATH 274,A01,087439,Cheng; Li-Tien,9,0,10,1
1653397614264,MATH 274,A02,087440,Cheng; Li-Tien,10,0,10,0
1653397614786,MATH 278A,A00,087441,Staff,8,0,10,2
1653397615309,MATH 278B,A00,087442,Staff,8,0,10,2
1653397615832,MATH 278C,A00,087443,Staff,8,0,10,2
1653397616355,MATH 280A,A00,087444,Zheng; Tianyi,0,0,8,8
1653397616878,MATH 281A,A00,087445,Bradic; Jelena,0,0,8,8
1653397617402,MATH 282A,A00,087446,Zhang; Danna,0,0,8,8
1653397617932,MATH 283,A00,087447,Tesler; Glenn,0,0,0,13
1653397618459,MATH 286,A00,087448,Kemp; Todd Aahron,6,0,8,2
1653397618980,MATH 287D,A00,087449,Bradic; Jelena,8,0,8,0
1653397619506,MATH 288,A00,087450,Staff,14,0,15,1
1653397619506,MATH 288,B00,087451,Staff,15,0,15,0
1653397619506,MATH 288,C00,087452,Staff,15,0,15,0
1653397620033,MATH 290A,A00,087453,Xu; Zhouli,7,0,8,1
1653397620555,MATH 291A,A00,087454,Xu; Zhouli,7,0,8,1
1653397621081,MATH 292,A00,087455,Staff,10,0,10,0
1653397621605,MATH 295,A00,087456,Staff,50,0,50,0
1653397622126,MATH 297,001,087457,Staff,998,0,999,1
1653398183343,COGS 200,A01,087991,Staff,48,0,50,2
1653398183866,COGS 201,A01,094504,Rangel; Lara M,17,0,25,8
1653398184395,COGS 203,A00,087992,Coulson; Seana M,19,0,20,1
1653398184923,COGS 210A,001,087993,Greene; Deanna Jacquelyn,9998,0,9999,1
1653398184923,COGS 210A,002,087994,Saygin; Ayse P,9999,0,9999,0
1653398184923,COGS 210A,003,087995,Xia; Haijun,9999,0,9999,0
1653398184923,COGS 210A,004,087996,Nitz; Douglas A.,9999,0,9999,0
1653398184923,COGS 210A,005,087997,Hollan; James D.,9999,0,9999,0
1653398184923,COGS 210A,006,087998,Deak; Gedeon O.,9998,0,9999,1
1653398184923,COGS 210A,007,087999,Rossano; Federico,9999,0,9999,0
1653398185446,COGS 211A,A00,088000,Coulson; Seana M,9997,0,9999,2
1653398185972,COGS 229,A00,088002,Staff,23,0,25,2
1653398186500,COGS 260,B00,094231,Staff,17,0,20,3
1653398186500,COGS 260,A00,088004,Nitz; Douglas A.,9998,0,9999,1
1653398187028,CSE 202,A00,090110,Paturi; Ramamohan,0,0,0,0
1653398187028,CSE 202,B00,090111,Paturi; Ramamohan,0,0,0,0
1653398187553,CSE 207B,A00,090112,Heninger; Nadia A,0,0,0,0
1653398188093,CSE 208,A00,094858,Micciancio; Daniele,0,0,0,0
1653398188620,CSE 210,A00,090113,Powell; Thomas Allan,0,0,0,0
1653398189146,CSE 219,A00,090898,Staff,0,0,0,0
1653398189670,CSE 221,A00,090114,Zhou; Yuan-Yuan,0,0,0,0
1653398190192,CSE 229A,A00,090115,Porter; George M,0,0,0,0
1653398190714,CSE 229C,A00,090116,Savage; Stefan,0,0,0,0
1653398191240,CSE 230,A00,090117,Jhala; Ranjit,0,0,0,0
1653398191770,CSE 232,A00,090118,Papakonstantinou; Yannis,0,0,0,0
1653398192295,CSE 239A,A00,090121,Kumar; Arun Kumar,0,0,0,0
1653398192818,CSE 239B,A00,090122,Jhala; Ranjit,0,0,0,0
1653398193342,CSE 240A,A00,090123,Zhao; Jishen,0,0,189,189
1653398193871,CSE 243A,A00,090124,Orailoglu; Alex,3,0,15,12
1653398194401,CSE 249B,A00,090125,Kahng; Andrew Byun,14,0,20,6
1653398194925,CSE 250A,A00,090126,Berg-Kirkpatrick; Taylor D,0,0,0,0
1653398195458,CSE 252A,A00,090127,Ochoa; Benjamin Lawrence,0,0,0,0
1653398195983,CSE 258,A01,090129,McAuley; Julian John,0,0,0,0
1653398196511,CSE 258R,A01,090131,McAuley; Julian John,0,0,0,0
1653398197044,CSE 274,A00,090132,Ramamoorthi; Ravi,0,0,0,0
1653398197568,CSE 276A,A00,090133,Christensen; Henrik I,0,0,0,0
1653398198097,CSE 276C,A00,090134,Christensen; Henrik I,0,0,0,0
1653398198641,CSE 290,A00,090135,Bafna; Vineet,0,0,0,0
1653398198641,CSE 290,B00,090136,Ramamoorthi; Ravi,0,0,0,0
1653398198641,CSE 290,C00,090137,Li; Tzumao,10,0,10,0
1653398198641,CSE 290,D00,090138,Zhou; Yuan-Yuan,10,0,10,0
1653398198641,CSE 290,E00,090139,Christensen; Henrik I,10,0,10,0
1653398198641,CSE 290,F00,094053,Shalev; Aaron D,0,0,0,0
1653398199166,CSE 291,A00,090140,Munyaka; Imani N. S.,0,0,0,0
1653398199166,CSE 291,B00,094880,Yu; Qi,0,0,0,0
1653398199166,CSE 291,C00,090142,Pannuto; Patrick William,0,0,0,0
1653398199166,CSE 291,D00,094881,Zhang; Yiying,0,0,0,0
1653398199166,CSE 291,E00,095118,Su; Hao,0,0,0,0
1653398199708,CSE 293,001,094905,Bafna; Vineet,9999,0,9999,0
1653398199708,CSE 293,002,094906,Bellare; Mihir,9999,0,9999,0
1653398199708,CSE 293,003,094907,Berg-Kirkpatrick; Taylor D,9999,0,9999,0
1653398199708,CSE 293,004,094908,Christensen; Henrik I,9999,0,9999,0
1653398199708,CSE 293,005,094909,Cottrell; Garrison W,9999,0,9999,0
1653398199708,CSE 293,006,094910,Deutsch; Alin Bernard,9999,0,9999,0
1653398199708,CSE 293,007,094911,Esmaeilzadeh; Hadi,9999,0,9999,0
1653398199708,CSE 293,008,094912,Freund; Yoav,9999,0,9999,0
1653398199708,CSE 293,009,094913,Griswold; William G.,9999,0,9999,0
1653398199708,CSE 293,010,094914,Gymrek; Melissa Ann,9999,0,9999,0
1653398199708,CSE 293,011,094915,Heninger; Nadia A,9999,0,9999,0
1653398199708,CSE 293,012,094916,Impagliazzo; Russell,9999,0,9999,0
1653398199708,CSE 293,013,094917,Jhala; Ranjit,9999,0,9999,0
1653398199708,CSE 293,014,094918,Kahng; Andrew Byun,9999,0,9999,0
1653398199708,CSE 293,015,094919,Kane; Daniel Mertz,9999,0,9999,0
1653398199708,CSE 293,016,094920,Kriegman; David J,9999,0,9999,0
1653398199708,CSE 293,017,094921,Kumar; Arun Kumar,9999,0,9999,0
1653398199708,CSE 293,018,094922,Lerner; Sorin,9999,0,9999,0
1653398199708,CSE 293,019,094923,Lovett; Shachar,9999,0,9999,0
1653398199708,CSE 293,020,094924,McAuley; Julian John,9999,0,9999,0
1653398199708,CSE 293,021,094925,Micciancio; Daniele,9999,0,9999,0
1653398199708,CSE 293,022,094926,Orailoglu; Alex,9999,0,9999,0
1653398199708,CSE 293,023,094927,Paturi; Ramamohan,9999,0,9999,0
1653398199708,CSE 293,024,094928,Polikarpova; Nadezhda,9999,0,9999,0
1653398199708,CSE 293,025,094929,Politz; Joseph Gibbs,9999,0,9999,0
1653398199708,CSE 293,026,094930,Porter; George M,9999,0,9999,0
1653398199708,CSE 293,027,094931,Porter; Leonard Emerson,9999,0,9999,0
1653398199708,CSE 293,028,094932,Ramamoorthi; Ravi,9999,0,9999,0
1653398199708,CSE 293,029,094933,Sahoo; Debashis,9999,0,9999,0
1653398199708,CSE 293,030,094934,Saul; Lawrence,9999,0,9999,0
1653398199708,CSE 293,031,094935,Savage; Stefan,9999,0,9999,0
1653398199708,CSE 293,032,094936,Schulze; Jurgen P.,9999,0,9999,0
1653398199708,CSE 293,033,094937,Snoeren; Alex C.,9999,0,9999,0
1653398199708,CSE 293,034,094938,Shang; Jingbo,9999,0,9999,0
1653398199708,CSE 293,035,094939,Stefan; Deian,9999,0,9999,0
1653398199708,CSE 293,036,094940,Su; Hao,9999,0,9999,0
1653398199708,CSE 293,037,094941,Swanson; Steven James,9999,0,9999,0
1653398199708,CSE 293,038,094942,Tullsen; Dean Michael,9999,0,9999,0
1653398199708,CSE 293,039,094943,Voelker; Geoffrey M.,9999,0,9999,0
1653398199708,CSE 293,040,094944,Zhao; Jishen,9999,0,9999,0
1653398199708,CSE 293,041,094945,Zhou; Yuan-Yuan,9999,0,9999,0
1653398199708,CSE 293,042,094946,Gao; Sicun,9998,0,9999,1
1653398199708,CSE 293,043,094947,Weibel; Nadir,9999,0,9999,0
1653398199708,CSE 293,044,094948,Gupta; Rajesh K.,9999,0,9999,0
1653398200234,CSE 294,A00,090143,Porter; George M,9,0,10,1
1653398200760,DSE 200,A00,091799,Staff,50,0,50,0
1653398201285,DSE 203,A00,091800,Gupta; Amarnath,30,0,30,0
1653398201898,DSE 250,A00,091801,Deutsch; Alin Bernard,30,0,30,0
1653398202422,DSE 290,A00,091802,Altintas De Callaf; Ilkay,50,0,50,0
1653398203019,ECE 200,001,091003,Antipa; Nicholas A,9999,0,9999,0
1653398203019,ECE 200,002,091004,Atanasov; Nikolay A.,9999,0,9999,0
1653398203019,ECE 200,003,091005,Bharadia; Dinesh,9999,0,9999,0
1653398203019,ECE 200,004,091006,Cheng; Chung Kuan,9999,0,9999,0
1653398203019,ECE 200,005,091007,Cosman; Pamela C.,9999,0,9999,0
1653398203019,ECE 200,006,091008,Staff,9999,0,9999,0
1653398203019,ECE 200,007,091009,Dayeh; Shadi Ahmad,9999,0,9999,0
1653398203019,ECE 200,008,091010,Fainman; Yeshaiahu,9999,0,9999,0
1653398203019,ECE 200,009,091011,Ford; Joseph Earl,9999,0,9999,0
1653398203019,ECE 200,010,091012,Franceschetti; Massimo,9999,0,9999,0
1653398203019,ECE 200,011,091013,Fullerton; Eric E,9999,0,9999,0
1653398203019,ECE 200,012,091014,Galton; Ian A,9999,0,9999,0
1653398203019,ECE 200,013,091015,Gilja; Vikash,9999,0,9999,0
1653398203019,ECE 200,014,091016,Hall; Drew A.,9999,0,9999,0
1653398203019,ECE 200,015,091017,Hsueh; Tzu-Chien,9999,0,9999,0
1653398203019,ECE 200,016,091018,Javidi; Tara,9999,0,9999,0
1653398203019,ECE 200,017,091019,Kahng; Andrew Byun,9999,0,9999,0
1653398203019,ECE 200,018,091020,Kim; Young-Han,9999,0,9999,0
1653398203019,ECE 200,019,091021,Koushanfar; Farinaz,9999,0,9999,0
1653398203019,ECE 200,020,091022,Kuzum; Duygu,9999,0,9999,0
1653398203019,ECE 200,021,091023,Le; Hanh-Phuc,9999,0,9999,0
1653398203019,ECE 200,022,091024,Lin; Bill,9999,0,9999,0
1653398203019,ECE 200,023,091025,Liu; Zhaowei,9999,0,9999,0
1653398203019,ECE 200,024,091026,Lo; Yu-Hwa,9999,0,9999,0
1653398203019,ECE 200,025,091027,Lomakin; Vitaliy,9999,0,9999,0
1653398203019,ECE 200,026,091028,Mercier; Patrick Philip,9999,0,9999,0
1653398203019,ECE 200,027,091029,Meyer; Florian,9999,0,9999,0
1653398203019,ECE 200,028,091030,Milstein; Laurence B.,9999,0,9999,0
1653398203019,ECE 200,029,091031,Mir Arabbaygi; Siavash,9999,0,9999,0
1653398203019,ECE 200,030,091032,Mookherjea; Shayan,9999,0,9999,0
1653398203019,ECE 200,031,091033,Morris; Karcher William,9999,0,9999,0
1653398203019,ECE 200,032,091034,Ng; Tse Nga,9999,0,9999,0
1653398203019,ECE 200,033,091035,Nguyen; Truong Quang,9999,0,9999,0
1653398203019,ECE 200,034,091036,Nomura; Kenji,9999,0,9999,0
1653398203019,ECE 200,035,091037,Orlitsky; Alon,9999,0,9999,0
1653398203019,ECE 200,036,091038,Pal; Piya,9999,0,9999,0
1653398203019,ECE 200,037,091039,Papen; George C.,9999,0,9999,0
1653398203019,ECE 200,038,091040,Radic; Stojan,9999,0,9999,0
1653398203019,ECE 200,039,091041,Rao; Bhaskar D.,9999,0,9999,0
1653398203019,ECE 200,040,091042,Rao; Ramesh R,9999,0,9999,0
1653398203019,ECE 200,041,091043,Rebeiz; Gabriel,9999,0,9999,0
1653398203019,ECE 200,042,091044,Sanford; John R,9999,0,9999,0
1653398203019,ECE 200,043,091045,Siegel; Paul H.,9999,0,9999,0
1653398203019,ECE 200,044,091046,Sievenpiper; Daniel F.,9999,0,9999,0
1653398203019,ECE 200,045,091047,Sworder; David D.,9999,0,9999,0
1653398203019,ECE 200,046,091048,Taur; Yuan,9999,0,9999,0
1653398203019,ECE 200,047,091049,Touri; Behrouz,9999,0,9999,0
1653398203019,ECE 200,048,091050,Trivedi; Mohan M.,9999,0,9999,0
1653398203019,ECE 200,049,091051,Vardy; Alexander,9999,0,9999,0
1653398203019,ECE 200,050,091052,Vasconcelos; Nuno,9999,0,9999,0
1653398203019,ECE 200,051,091053,Wang; Xiaolong,9999,0,9999,0
1653398203019,ECE 200,052,091054,Xie; Pengtao,9999,0,9999,0
1653398203019,ECE 200,053,091055,Yip; Michael,9999,0,9999,0
1653398203019,ECE 200,054,091056,Zeger; Kenneth A.,9999,0,9999,0
1653398203019,ECE 200,055,091057,Zhang; Xinyu,9999,0,9999,0
1653398203019,ECE 200,056,091058,Turakhia; Yatish Girish,9999,0,9999,0
1653398203019,ECE 200,057,091059,Kang; Mingu,9999,0,9999,0
1653398203019,ECE 200,058,091060,Shi; Yuanyuan,9999,0,9999,0
1653398203019,ECE 200,059,091061,Wang; Edward Jay,9999,0,9999,0
1653398203019,ECE 200,060,091062,Zheng; Yang,9999,0,9999,0
1653398203550,ECE 203,A00,091065,Mercier; Patrick Philip,0,0,0,0
1653398204079,ECE 207A,A00,091605,Liu; Thomas Tao-Ming,0,0,0,0
1653398204613,ECE 212AN,A00,091068,Nomura; Kenji,0,0,0,0
1653398205138,ECE 222A,A00,091069,Rebeiz; Gabriel,0,0,0,0
1653398205661,ECE 225A,A00,091070,Orlitsky; Alon,0,0,0,0
1653398206191,ECE 230A,A00,091071,Nomura; Kenji,0,0,0,0
1653398206721,ECE 236A,A00,091072,Dayeh; Shadi Ahmad,0,0,0,0
1653398207258,ECE 238A,A00,091073,Luo; Jian,0,0,0,0
1653398207258,ECE 238A,B00,091074,Luo; Jian,0,0,0,0
1653398207786,ECE 240A,A00,091075,Radic; Stojan,0,0,0,0
1653398208326,ECE 247A,A00,091592,Shi; Lingyan,0,0,0,0
1653398208855,ECE 250,A00,091076,Touri; Behrouz,0,0,0,0
1653398209378,ECE 251C,A00,091078,Nguyen; Truong Quang,0,0,0,0
1653398209906,ECE 253,A00,091079,Cosman; Pamela C.,0,0,0,0
1653398210433,ECE 255A,A00,091080,Orlitsky; Alon,0,0,0,0
1653398210957,ECE 257A,A00,091081,Zhang; Xinyu,0,0,0,0
1653398211490,ECE 260A,A01,091084,Eldon; John,0,0,0,0
1653398212014,ECE 264C,A00,091085,Galton; Ian A,0,0,0,0
1653398212540,ECE 265C,A00,094889,Presti; Calogero Davide,0,0,0,9
1653398213068,ECE 266,A01,091087,Hall; Drew A.,0,0,0,0
1653398214115,ECE 271A,A00,091090,Vasconcelos; Nuno,0,0,0,0
1653398214639,ECE 272B,A00,091091,Sworder; David D.,0,0,0,0
1653398215168,ECE 275A,A00,091092,Meyer; Florian,0,0,0,0
1653398215693,ECE 277,A00,091093,An; Cheolhong,0,0,0,0
1653398216217,ECE 283,A00,091094,Le; Hanh-Phuc,0,0,0,0
1653398216746,ECE 284,A00,091095,Kang; Mingu,0,0,0,0
1653398216746,ECE 284,B00,091096,Wang; Edward Jay,0,0,0,0
1653398217272,ECE 285,A00,094334,Touri; Behrouz,0,0,0,0
1653398217800,ECE 289,A00,091097,Whelan; David Arthur,0,0,0,0
1653398218330,MATH 200A,A00,087414,Salehi Golsefidy; Alireza,7,0,8,1
1653398218865,MATH 202A,A00,087415,Gill; Philip E.,3,0,8,5
1653398219388,MATH 203A,A00,087416,Oprea; Dragos N.,6,0,8,2
1653398219915,MATH 204A,A00,087417,Kedlaya; Kiran S.,6,0,8,2
1653398220442,MATH 205,A00,087418,Sorensen; Claus M,6,0,8,2
1653398220967,MATH 206A,A00,087419,Izadi; Elham,7,0,8,1
1653398221492,MATH 207A,A00,087420,Mohammadi; Amir,6,0,8,2
1653398222017,MATH 208,A00,087421,Staff,9,0,10,1
1653398222543,MATH 209,A00,087422,Staff,10,0,10,0
1653398223064,MATH 218,A00,087423,Staff,10,0,10,0
1653398223590,MATH 220A,A00,087424,Novak; Jonathan I,7,0,8,1
1653398224120,MATH 231A,A00,087425,Bejenaru; Ioan,4,0,8,4
1653398224652,MATH 240A,A00,087426,Ebenfelt; Peter F,5,0,8,3
1653398225175,MATH 243,A00,087427,Staff,9,0,10,1
1653398225700,MATH 248,A00,087429,Staff,10,0,10,0
1653398226223,MATH 250A,A00,087430,Spolaor; Luca,5,0,8,3
1653398226747,MATH 257A,A00,087431,Spolaor; Luca,7,0,8,1
1653398227272,MATH 258,A00,087432,Staff,9,0,10,1
1653398227799,MATH 264A,A00,087433,Warnke; Lutz Peter,5,0,8,3
1653398228321,MATH 268,A00,087434,Staff,15,0,15,0
1653398228844,MATH 269,A00,087435,Staff,14,0,15,1
1653398229367,MATH 270A,A00,087436,Nie; Jiawang,0,0,8,8
1653398229894,MATH 272A,A00,087437,Tian; Xiaochuan,2,0,8,6
1653398230427,MATH 274,A01,087439,Cheng; Li-Tien,9,0,10,1
1653398230427,MATH 274,A02,087440,Cheng; Li-Tien,10,0,10,0
1653398230954,MATH 278A,A00,087441,Staff,8,0,10,2
1653398231477,MATH 278B,A00,087442,Staff,8,0,10,2
1653398232004,MATH 278C,A00,087443,Staff,8,0,10,2
1653398232532,MATH 280A,A00,087444,Zheng; Tianyi,0,0,8,8
1653398233056,MATH 281A,A00,087445,Bradic; Jelena,0,0,8,8
1653398233594,MATH 282A,A00,087446,Zhang; Danna,0,0,8,8
1653398234117,MATH 283,A00,087447,Tesler; Glenn,0,0,0,13
1653398234646,MATH 286,A00,087448,Kemp; Todd Aahron,6,0,8,2
1653398235170,MATH 287D,A00,087449,Bradic; Jelena,8,0,8,0
1653398235693,MATH 288,A00,087450,Staff,14,0,15,1
1653398235693,MATH 288,B00,087451,Staff,15,0,15,0
1653398235693,MATH 288,C00,087452,Staff,15,0,15,0
1653398236217,MATH 290A,A00,087453,Xu; Zhouli,7,0,8,1
1653398236751,MATH 291A,A00,087454,Xu; Zhouli,7,0,8,1
1653398237276,MATH 292,A00,087455,Staff,10,0,10,0
1653398237802,MATH 295,A00,087456,Staff,50,0,50,0
1653398238326,MATH 297,001,087457,Staff,998,0,999,1
1653398798914,COGS 200,A01,087991,Staff,48,0,50,2
1653398799436,COGS 201,A01,094504,Rangel; Lara M,17,0,25,8
1653398799961,COGS 203,A00,087992,Coulson; Seana M,19,0,20,1
1653398800489,COGS 210A,001,087993,Greene; Deanna Jacquelyn,9998,0,9999,1
1653398800489,COGS 210A,002,087994,Saygin; Ayse P,9999,0,9999,0
1653398800489,COGS 210A,003,087995,Xia; Haijun,9999,0,9999,0
1653398800489,COGS 210A,004,087996,Nitz; Douglas A.,9999,0,9999,0
1653398800489,COGS 210A,005,087997,Hollan; James D.,9999,0,9999,0
1653398800489,COGS 210A,006,087998,Deak; Gedeon O.,9998,0,9999,1
1653398800489,COGS 210A,007,087999,Rossano; Federico,9999,0,9999,0
1653398801015,COGS 211A,A00,088000,Coulson; Seana M,9997,0,9999,2
1653398801541,COGS 229,A00,088002,Staff,23,0,25,2
1653398802064,COGS 260,B00,094231,Staff,17,0,20,3
1653398802064,COGS 260,A00,088004,Nitz; Douglas A.,9998,0,9999,1
1653398802595,CSE 202,A00,090110,Paturi; Ramamohan,0,0,0,0
1653398802595,CSE 202,B00,090111,Paturi; Ramamohan,0,0,0,0
1653398803118,CSE 207B,A00,090112,Heninger; Nadia A,0,0,0,0
1653398803644,CSE 208,A00,094858,Micciancio; Daniele,0,0,0,0
1653398804172,CSE 210,A00,090113,Powell; Thomas Allan,0,0,0,0
1653398804697,CSE 219,A00,090898,Staff,0,0,0,0
1653398805221,CSE 221,A00,090114,Zhou; Yuan-Yuan,0,0,0,0
1653398805750,CSE 229A,A00,090115,Porter; George M,0,0,0,0
1653398806277,CSE 229C,A00,090116,Savage; Stefan,0,0,0,0
1653398806806,CSE 230,A00,090117,Jhala; Ranjit,0,0,0,0
1653398807333,CSE 232,A00,090118,Papakonstantinou; Yannis,0,0,0,0
1653398807857,CSE 239A,A00,090121,Kumar; Arun Kumar,0,0,0,0
1653398808382,CSE 239B,A00,090122,Jhala; Ranjit,0,0,0,0
1653398808916,CSE 240A,A00,090123,Zhao; Jishen,0,0,189,189
1653398809453,CSE 243A,A00,090124,Orailoglu; Alex,3,0,15,12
1653398809980,CSE 249B,A00,090125,Kahng; Andrew Byun,14,0,20,6
1653398810509,CSE 250A,A00,090126,Berg-Kirkpatrick; Taylor D,0,0,0,0
1653398811035,CSE 252A,A00,090127,Ochoa; Benjamin Lawrence,0,0,0,0
1653398811558,CSE 258,A01,090129,McAuley; Julian John,0,0,0,0
1653398812081,CSE 258R,A01,090131,McAuley; Julian John,0,0,0,0
1653398812606,CSE 274,A00,090132,Ramamoorthi; Ravi,0,0,0,0
1653398813133,CSE 276A,A00,090133,Christensen; Henrik I,0,0,0,0
1653398813661,CSE 276C,A00,090134,Christensen; Henrik I,0,0,0,0
1653398814192,CSE 290,A00,090135,Bafna; Vineet,0,0,0,0
1653398814192,CSE 290,B00,090136,Ramamoorthi; Ravi,0,0,0,0
1653398814192,CSE 290,C00,090137,Li; Tzumao,10,0,10,0
1653398814192,CSE 290,D00,090138,Zhou; Yuan-Yuan,10,0,10,0
1653398814192,CSE 290,E00,090139,Christensen; Henrik I,10,0,10,0
1653398814192,CSE 290,F00,094053,Shalev; Aaron D,0,0,0,0
1653398814728,CSE 291,A00,090140,Munyaka; Imani N. S.,0,0,0,0
1653398814728,CSE 291,B00,094880,Yu; Qi,0,0,0,0
1653398814728,CSE 291,C00,090142,Pannuto; Patrick William,0,0,0,0
1653398814728,CSE 291,D00,094881,Zhang; Yiying,0,0,0,0
1653398814728,CSE 291,E00,095118,Su; Hao,0,0,0,0
1653398815289,CSE 293,001,094905,Bafna; Vineet,9999,0,9999,0
1653398815289,CSE 293,002,094906,Bellare; Mihir,9999,0,9999,0
1653398815289,CSE 293,003,094907,Berg-Kirkpatrick; Taylor D,9999,0,9999,0
1653398815289,CSE 293,004,094908,Christensen; Henrik I,9999,0,9999,0
1653398815289,CSE 293,005,094909,Cottrell; Garrison W,9999,0,9999,0
1653398815289,CSE 293,006,094910,Deutsch; Alin Bernard,9999,0,9999,0
1653398815289,CSE 293,007,094911,Esmaeilzadeh; Hadi,9999,0,9999,0
1653398815289,CSE 293,008,094912,Freund; Yoav,9999,0,9999,0
1653398815289,CSE 293,009,094913,Griswold; William G.,9999,0,9999,0
1653398815289,CSE 293,010,094914,Gymrek; Melissa Ann,9999,0,9999,0
1653398815289,CSE 293,011,094915,Heninger; Nadia A,9999,0,9999,0
1653398815289,CSE 293,012,094916,Impagliazzo; Russell,9999,0,9999,0
1653398815289,CSE 293,013,094917,Jhala; Ranjit,9999,0,9999,0
1653398815289,CSE 293,014,094918,Kahng; Andrew Byun,9999,0,9999,0
1653398815289,CSE 293,015,094919,Kane; Daniel Mertz,9999,0,9999,0
1653398815289,CSE 293,016,094920,Kriegman; David J,9999,0,9999,0
1653398815289,CSE 293,017,094921,Kumar; Arun Kumar,9999,0,9999,0
1653398815289,CSE 293,018,094922,Lerner; Sorin,9999,0,9999,0
1653398815289,CSE 293,019,094923,Lovett; Shachar,9999,0,9999,0
1653398815289,CSE 293,020,094924,McAuley; Julian John,9999,0,9999,0
1653398815289,CSE 293,021,094925,Micciancio; Daniele,9999,0,9999,0
1653398815289,CSE 293,022,094926,Orailoglu; Alex,9999,0,9999,0
1653398815289,CSE 293,023,094927,Paturi; Ramamohan,9999,0,9999,0
1653398815289,CSE 293,024,094928,Polikarpova; Nadezhda,9999,0,9999,0
1653398815289,CSE 293,025,094929,Politz; Joseph Gibbs,9999,0,9999,0
1653398815289,CSE 293,026,094930,Porter; George M,9999,0,9999,0
1653398815289,CSE 293,027,094931,Porter; Leonard Emerson,9999,0,9999,0
1653398815289,CSE 293,028,094932,Ramamoorthi; Ravi,9999,0,9999,0
1653398815289,CSE 293,029,094933,Sahoo; Debashis,9999,0,9999,0
1653398815289,CSE 293,030,094934,Saul; Lawrence,9999,0,9999,0
1653398815289,CSE 293,031,094935,Savage; Stefan,9999,0,9999,0
1653398815289,CSE 293,032,094936,Schulze; Jurgen P.,9999,0,9999,0
1653398815289,CSE 293,033,094937,Snoeren; Alex C.,9999,0,9999,0
1653398815289,CSE 293,034,094938,Shang; Jingbo,9999,0,9999,0
1653398815289,CSE 293,035,094939,Stefan; Deian,9999,0,9999,0
1653398815289,CSE 293,036,094940,Su; Hao,9999,0,9999,0
1653398815289,CSE 293,037,094941,Swanson; Steven James,9999,0,9999,0
1653398815289,CSE 293,038,094942,Tullsen; Dean Michael,9999,0,9999,0
1653398815289,CSE 293,039,094943,Voelker; Geoffrey M.,9999,0,9999,0
1653398815289,CSE 293,040,094944,Zhao; Jishen,9999,0,9999,0
1653398815289,CSE 293,041,094945,Zhou; Yuan-Yuan,9999,0,9999,0
1653398815289,CSE 293,042,094946,Gao; Sicun,9998,0,9999,1
1653398815289,CSE 293,043,094947,Weibel; Nadir,9999,0,9999,0
1653398815289,CSE 293,044,094948,Gupta; Rajesh K.,9999,0,9999,0
1653398815817,CSE 294,A00,090143,Porter; George M,9,0,10,1
1653398816341,DSE 200,A00,091799,Staff,50,0,50,0
1653398816866,DSE 203,A00,091800,Gupta; Amarnath,30,0,30,0
1653398817393,DSE 250,A00,091801,Deutsch; Alin Bernard,30,0,30,0
1653398817919,DSE 290,A00,091802,Altintas De Callaf; Ilkay,50,0,50,0
1653398818513,ECE 200,001,091003,Antipa; Nicholas A,9999,0,9999,0
1653398818513,ECE 200,002,091004,Atanasov; Nikolay A.,9999,0,9999,0
1653398818513,ECE 200,003,091005,Bharadia; Dinesh,9999,0,9999,0
1653398818513,ECE 200,004,091006,Cheng; Chung Kuan,9999,0,9999,0
1653398818513,ECE 200,005,091007,Cosman; Pamela C.,9999,0,9999,0
1653398818513,ECE 200,006,091008,Staff,9999,0,9999,0
1653398818513,ECE 200,007,091009,Dayeh; Shadi Ahmad,9999,0,9999,0
1653398818513,ECE 200,008,091010,Fainman; Yeshaiahu,9999,0,9999,0
1653398818513,ECE 200,009,091011,Ford; Joseph Earl,9999,0,9999,0
1653398818513,ECE 200,010,091012,Franceschetti; Massimo,9999,0,9999,0
1653398818513,ECE 200,011,091013,Fullerton; Eric E,9999,0,9999,0
1653398818513,ECE 200,012,091014,Galton; Ian A,9999,0,9999,0
1653398818513,ECE 200,013,091015,Gilja; Vikash,9999,0,9999,0
1653398818513,ECE 200,014,091016,Hall; Drew A.,9999,0,9999,0
1653398818513,ECE 200,015,091017,Hsueh; Tzu-Chien,9999,0,9999,0
1653398818513,ECE 200,016,091018,Javidi; Tara,9999,0,9999,0
1653398818513,ECE 200,017,091019,Kahng; Andrew Byun,9999,0,9999,0
1653398818513,ECE 200,018,091020,Kim; Young-Han,9999,0,9999,0
1653398818513,ECE 200,019,091021,Koushanfar; Farinaz,9999,0,9999,0
1653398818513,ECE 200,020,091022,Kuzum; Duygu,9999,0,9999,0
1653398818513,ECE 200,021,091023,Le; Hanh-Phuc,9999,0,9999,0
1653398818513,ECE 200,022,091024,Lin; Bill,9999,0,9999,0
1653398818513,ECE 200,023,091025,Liu; Zhaowei,9999,0,9999,0
1653398818513,ECE 200,024,091026,Lo; Yu-Hwa,9999,0,9999,0
1653398818513,ECE 200,025,091027,Lomakin; Vitaliy,9999,0,9999,0
1653398818513,ECE 200,026,091028,Mercier; Patrick Philip,9999,0,9999,0
1653398818513,ECE 200,027,091029,Meyer; Florian,9999,0,9999,0
1653398818513,ECE 200,028,091030,Milstein; Laurence B.,9999,0,9999,0
1653398818513,ECE 200,029,091031,Mir Arabbaygi; Siavash,9999,0,9999,0
1653398818513,ECE 200,030,091032,Mookherjea; Shayan,9999,0,9999,0
1653398818513,ECE 200,031,091033,Morris; Karcher William,9999,0,9999,0
1653398818513,ECE 200,032,091034,Ng; Tse Nga,9999,0,9999,0
1653398818513,ECE 200,033,091035,Nguyen; Truong Quang,9999,0,9999,0
1653398818513,ECE 200,034,091036,Nomura; Kenji,9999,0,9999,0
1653398818513,ECE 200,035,091037,Orlitsky; Alon,9999,0,9999,0
1653398818513,ECE 200,036,091038,Pal; Piya,9999,0,9999,0
1653398818513,ECE 200,037,091039,Papen; George C.,9999,0,9999,0
1653398818513,ECE 200,038,091040,Radic; Stojan,9999,0,9999,0
1653398818513,ECE 200,039,091041,Rao; Bhaskar D.,9999,0,9999,0
1653398818513,ECE 200,040,091042,Rao; Ramesh R,9999,0,9999,0
1653398818513,ECE 200,041,091043,Rebeiz; Gabriel,9999,0,9999,0
1653398818513,ECE 200,042,091044,Sanford; John R,9999,0,9999,0
1653398818513,ECE 200,043,091045,Siegel; Paul H.,9999,0,9999,0
1653398818513,ECE 200,044,091046,Sievenpiper; Daniel F.,9999,0,9999,0
1653398818513,ECE 200,045,091047,Sworder; David D.,9999,0,9999,0
1653398818513,ECE 200,046,091048,Taur; Yuan,9999,0,9999,0
1653398818513,ECE 200,047,091049,Touri; Behrouz,9999,0,9999,0
1653398818513,ECE 200,048,091050,Trivedi; Mohan M.,9999,0,9999,0
1653398818513,ECE 200,049,091051,Vardy; Alexander,9999,0,9999,0
1653398818513,ECE 200,050,091052,Vasconcelos; Nuno,9999,0,9999,0
1653398818513,ECE 200,051,091053,Wang; Xiaolong,9999,0,9999,0
1653398818513,ECE 200,052,091054,Xie; Pengtao,9999,0,9999,0
1653398818513,ECE 200,053,091055,Yip; Michael,9999,0,9999,0
1653398818513,ECE 200,054,091056,Zeger; Kenneth A.,9999,0,9999,0
1653398818513,ECE 200,055,091057,Zhang; Xinyu,9999,0,9999,0
1653398818513,ECE 200,056,091058,Turakhia; Yatish Girish,9999,0,9999,0
1653398818513,ECE 200,057,091059,Kang; Mingu,9999,0,9999,0
1653398818513,ECE 200,058,091060,Shi; Yuanyuan,9999,0,9999,0
1653398818513,ECE 200,059,091061,Wang; Edward Jay,9999,0,9999,0
1653398818513,ECE 200,060,091062,Zheng; Yang,9999,0,9999,0
1653398819037,ECE 203,A00,091065,Mercier; Patrick Philip,0,0,0,0
1653398819569,ECE 207A,A00,091605,Liu; Thomas Tao-Ming,0,0,0,0
1653398820096,ECE 212AN,A00,091068,Nomura; Kenji,0,0,0,0
1653398820629,ECE 222A,A00,091069,Rebeiz; Gabriel,0,0,0,0
1653398821158,ECE 225A,A00,091070,Orlitsky; Alon,0,0,0,0
1653398821684,ECE 230A,A00,091071,Nomura; Kenji,0,0,0,0
1653398822206,ECE 236A,A00,091072,Dayeh; Shadi Ahmad,0,0,0,0
1653398822743,ECE 238A,A00,091073,Luo; Jian,0,0,0,0
1653398822743,ECE 238A,B00,091074,Luo; Jian,0,0,0,0
1653398823267,ECE 240A,A00,091075,Radic; Stojan,0,0,0,0
1653398823792,ECE 247A,A00,091592,Shi; Lingyan,0,0,0,0
1653398824323,ECE 250,A00,091076,Touri; Behrouz,0,0,0,0
1653398824852,ECE 251C,A00,091078,Nguyen; Truong Quang,0,0,0,0
1653398825383,ECE 253,A00,091079,Cosman; Pamela C.,0,0,0,0
1653398825915,ECE 255A,A00,091080,Orlitsky; Alon,0,0,0,0
1653398826446,ECE 257A,A00,091081,Zhang; Xinyu,0,0,0,0
1653398826974,ECE 260A,A01,091084,Eldon; John,0,0,0,0
1653398827499,ECE 264C,A00,091085,Galton; Ian A,0,0,0,0
1653398828025,ECE 265C,A00,094889,Presti; Calogero Davide,0,0,0,9
1653398828548,ECE 266,A01,091087,Hall; Drew A.,0,0,0,0
1653398829600,ECE 271A,A00,091090,Vasconcelos; Nuno,0,0,0,0
1653398830123,ECE 272B,A00,091091,Sworder; David D.,0,0,0,0
1653398830646,ECE 275A,A00,091092,Meyer; Florian,0,0,0,0
1653398831175,ECE 277,A00,091093,An; Cheolhong,0,0,0,0
1653398831702,ECE 283,A00,091094,Le; Hanh-Phuc,0,0,0,0
1653398832225,ECE 284,A00,091095,Kang; Mingu,0,0,0,0
1653398832225,ECE 284,B00,091096,Wang; Edward Jay,0,0,0,0
1653398832763,ECE 285,A00,094334,Touri; Behrouz,0,0,0,0
1653398833297,ECE 289,A00,091097,Whelan; David Arthur,0,0,0,0
1653398833834,MATH 200A,A00,087414,Salehi Golsefidy; Alireza,7,0,8,1
1653398834360,MATH 202A,A00,087415,Gill; Philip E.,3,0,8,5
1653398834888,MATH 203A,A00,087416,Oprea; Dragos N.,6,0,8,2
1653398835411,MATH 204A,A00,087417,Kedlaya; Kiran S.,6,0,8,2
1653398835935,MATH 205,A00,087418,Sorensen; Claus M,6,0,8,2
1653398836460,MATH 206A,A00,087419,Izadi; Elham,7,0,8,1
1653398836988,MATH 207A,A00,087420,Mohammadi; Amir,6,0,8,2
1653398837516,MATH 208,A00,087421,Staff,9,0,10,1
1653398838044,MATH 209,A00,087422,Staff,10,0,10,0
1653398838570,MATH 218,A00,087423,Staff,10,0,10,0
1653398839100,MATH 220A,A00,087424,Novak; Jonathan I,7,0,8,1
1653398839632,MATH 231A,A00,087425,Bejenaru; Ioan,4,0,8,4
1653398840167,MATH 240A,A00,087426,Ebenfelt; Peter F,5,0,8,3
1653398840692,MATH 243,A00,087427,Staff,9,0,10,1
1653398841223,MATH 248,A00,087429,Staff,10,0,10,0
1653398841749,MATH 250A,A00,087430,Spolaor; Luca,5,0,8,3
1653398842273,MATH 257A,A00,087431,Spolaor; Luca,7,0,8,1
1653398842798,MATH 258,A00,087432,Staff,9,0,10,1
1653398843417,MATH 264A,A00,087433,Warnke; Lutz Peter,5,0,8,3
1653398843946,MATH 268,A00,087434,Staff,15,0,15,0
1653398844472,MATH 269,A00,087435,Staff,14,0,15,1
1653398845003,MATH 270A,A00,087436,Nie; Jiawang,0,0,8,8
1653398845533,MATH 272A,A00,087437,Tian; Xiaochuan,2,0,8,6
1653398846066,MATH 274,A01,087439,Cheng; Li-Tien,9,0,10,1
1653398846066,MATH 274,A02,087440,Cheng; Li-Tien,10,0,10,0
1653398846595,MATH 278A,A00,087441,Staff,8,0,10,2
1653398847121,MATH 278B,A00,087442,Staff,8,0,10,2
1653398847647,MATH 278C,A00,087443,Staff,8,0,10,2
1653398848170,MATH 280A,A00,087444,Zheng; Tianyi,0,0,8,8
1653398848698,MATH 281A,A00,087445,Bradic; Jelena,0,0,8,8
1653398849226,MATH 282A,A00,087446,Zhang; Danna,0,0,8,8
1653398849748,MATH 283,A00,087447,Tesler; Glenn,0,0,0,13
1653398850274,MATH 286,A00,087448,Kemp; Todd Aahron,6,0,8,2
1653398850800,MATH 287D,A00,087449,Bradic; Jelena,8,0,8,0
1653398851325,MATH 288,A00,087450,Staff,14,0,15,1
1653398851325,MATH 288,B00,087451,Staff,15,0,15,0
1653398851325,MATH 288,C00,087452,Staff,15,0,15,0
1653398851848,MATH 290A,A00,087453,Xu; Zhouli,7,0,8,1
1653398852371,MATH 291A,A00,087454,Xu; Zhouli,7,0,8,1
1653398852896,MATH 292,A00,087455,Staff,10,0,10,0
1653398853422,MATH 295,A00,087456,Staff,50,0,50,0
1653398853949,MATH 297,001,087457,Staff,998,0,999,1
1653399414743,COGS 200,A01,087991,Staff,48,0,50,2
1653399415273,COGS 201,A01,094504,Rangel; Lara M,17,0,25,8
1653399415800,COGS 203,A00,087992,Coulson; Seana M,19,0,20,1
1653399416326,COGS 210A,001,087993,Greene; Deanna Jacquelyn,9998,0,9999,1
1653399416326,COGS 210A,002,087994,Saygin; Ayse P,9999,0,9999,0
1653399416326,COGS 210A,003,087995,Xia; Haijun,9999,0,9999,0
1653399416326,COGS 210A,004,087996,Nitz; Douglas A.,9999,0,9999,0
1653399416326,COGS 210A,005,087997,Hollan; James D.,9999,0,9999,0
1653399416326,COGS 210A,006,087998,Deak; Gedeon O.,9998,0,9999,1
1653399416326,COGS 210A,007,087999,Rossano; Federico,9999,0,9999,0
1653399416849,COGS 211A,A00,088000,Coulson; Seana M,9997,0,9999,2
1653399417381,COGS 229,A00,088002,Staff,23,0,25,2
1653399417904,COGS 260,B00,094231,Staff,17,0,20,3
1653399417904,COGS 260,A00,088004,Nitz; Douglas A.,9998,0,9999,1
1653399418429,CSE 202,A00,090110,Paturi; Ramamohan,0,0,0,0
1653399418429,CSE 202,B00,090111,Paturi; Ramamohan,0,0,0,0
1653399418953,CSE 207B,A00,090112,Heninger; Nadia A,0,0,0,0
1653399419478,CSE 208,A00,094858,Micciancio; Daniele,0,0,0,0
1653399420006,CSE 210,A00,090113,Powell; Thomas Allan,0,0,0,0
1653399420535,CSE 219,A00,090898,Staff,0,0,0,0
1653399421066,CSE 221,A00,090114,Zhou; Yuan-Yuan,0,0,0,0
1653399421593,CSE 229A,A00,090115,Porter; George M,0,0,0,0
1653399422118,CSE 229C,A00,090116,Savage; Stefan,0,0,0,0
1653399422646,CSE 230,A00,090117,Jhala; Ranjit,0,0,0,0
1653399423170,CSE 232,A00,090118,Papakonstantinou; Yannis,0,0,0,0
1653399423706,CSE 239A,A00,090121,Kumar; Arun Kumar,0,0,0,0
1653399424232,CSE 239B,A00,090122,Jhala; Ranjit,0,0,0,0
1653399424757,CSE 240A,A00,090123,Zhao; Jishen,0,0,189,189
1653399425281,CSE 243A,A00,090124,Orailoglu; Alex,3,0,15,12
1653399425818,CSE 249B,A00,090125,Kahng; Andrew Byun,14,0,20,6
1653399426344,CSE 250A,A00,090126,Berg-Kirkpatrick; Taylor D,0,0,0,0
1653399426872,CSE 252A,A00,090127,Ochoa; Benjamin Lawrence,0,0,0,0
1653399427399,CSE 258,A01,090129,McAuley; Julian John,0,0,0,0
1653399427926,CSE 258R,A01,090131,McAuley; Julian John,0,0,0,0
1653399428449,CSE 274,A00,090132,Ramamoorthi; Ravi,0,0,0,0
1653399428992,CSE 276A,A00,090133,Christensen; Henrik I,0,0,0,0
1653399429521,CSE 276C,A00,090134,Christensen; Henrik I,0,0,0,0
1653399430046,CSE 290,A00,090135,Bafna; Vineet,0,0,0,0
1653399430046,CSE 290,B00,090136,Ramamoorthi; Ravi,0,0,0,0
1653399430046,CSE 290,C00,090137,Li; Tzumao,10,0,10,0
1653399430046,CSE 290,D00,090138,Zhou; Yuan-Yuan,10,0,10,0
1653399430046,CSE 290,E00,090139,Christensen; Henrik I,10,0,10,0
1653399430046,CSE 290,F00,094053,Shalev; Aaron D,0,0,0,0
1653399430585,CSE 291,A00,090140,Munyaka; Imani N. S.,0,0,0,0
1653399430585,CSE 291,B00,094880,Yu; Qi,0,0,0,0
1653399430585,CSE 291,C00,090142,Pannuto; Patrick William,0,0,0,0
1653399430585,CSE 291,D00,094881,Zhang; Yiying,0,0,0,0
1653399430585,CSE 291,E00,095118,Su; Hao,0,0,0,0
1653399431151,CSE 293,001,094905,Bafna; Vineet,9999,0,9999,0
1653399431151,CSE 293,002,094906,Bellare; Mihir,9999,0,9999,0
1653399431151,CSE 293,003,094907,Berg-Kirkpatrick; Taylor D,9999,0,9999,0
1653399431151,CSE 293,004,094908,Christensen; Henrik I,9999,0,9999,0
1653399431151,CSE 293,005,094909,Cottrell; Garrison W,9999,0,9999,0
1653399431151,CSE 293,006,094910,Deutsch; Alin Bernard,9999,0,9999,0
1653399431151,CSE 293,007,094911,Esmaeilzadeh; Hadi,9999,0,9999,0
1653399431151,CSE 293,008,094912,Freund; Yoav,9999,0,9999,0
1653399431151,CSE 293,009,094913,Griswold; William G.,9999,0,9999,0
1653399431151,CSE 293,010,094914,Gymrek; Melissa Ann,9999,0,9999,0
1653399431151,CSE 293,011,094915,Heninger; Nadia A,9999,0,9999,0
1653399431151,CSE 293,012,094916,Impagliazzo; Russell,9999,0,9999,0
1653399431151,CSE 293,013,094917,Jhala; Ranjit,9999,0,9999,0
1653399431151,CSE 293,014,094918,Kahng; Andrew Byun,9999,0,9999,0
1653399431151,CSE 293,015,094919,Kane; Daniel Mertz,9999,0,9999,0
1653399431151,CSE 293,016,094920,Kriegman; David J,9999,0,9999,0
1653399431151,CSE 293,017,094921,Kumar; Arun Kumar,9999,0,9999,0
1653399431151,CSE 293,018,094922,Lerner; Sorin,9999,0,9999,0
1653399431151,CSE 293,019,094923,Lovett; Shachar,9999,0,9999,0
1653399431151,CSE 293,020,094924,McAuley; Julian John,9999,0,9999,0
1653399431151,CSE 293,021,094925,Micciancio; Daniele,9999,0,9999,0
1653399431151,CSE 293,022,094926,Orailoglu; Alex,9999,0,9999,0
1653399431151,CSE 293,023,094927,Paturi; Ramamohan,9999,0,9999,0
1653399431151,CSE 293,024,094928,Polikarpova; Nadezhda,9999,0,9999,0
1653399431151,CSE 293,025,094929,Politz; Joseph Gibbs,9999,0,9999,0
1653399431151,CSE 293,026,094930,Porter; George M,9999,0,9999,0
1653399431151,CSE 293,027,094931,Porter; Leonard Emerson,9999,0,9999,0
1653399431151,CSE 293,028,094932,Ramamoorthi; Ravi,9999,0,9999,0
1653399431151,CSE 293,029,094933,Sahoo; Debashis,9999,0,9999,0
1653399431151,CSE 293,030,094934,Saul; Lawrence,9999,0,9999,0
1653399431151,CSE 293,031,094935,Savage; Stefan,9999,0,9999,0
1653399431151,CSE 293,032,094936,Schulze; Jurgen P.,9999,0,9999,0
1653399431151,CSE 293,033,094937,Snoeren; Alex C.,9999,0,9999,0
1653399431151,CSE 293,034,094938,Shang; Jingbo,9999,0,9999,0
1653399431151,CSE 293,035,094939,Stefan; Deian,9999,0,9999,0
1653399431151,CSE 293,036,094940,Su; Hao,9999,0,9999,0
1653399431151,CSE 293,037,094941,Swanson; Steven James,9999,0,9999,0
1653399431151,CSE 293,038,094942,Tullsen; Dean Michael,9999,0,9999,0
1653399431151,CSE 293,039,094943,Voelker; Geoffrey M.,9999,0,9999,0
1653399431151,CSE 293,040,094944,Zhao; Jishen,9999,0,9999,0
1653399431151,CSE 293,041,094945,Zhou; Yuan-Yuan,9999,0,9999,0
1653399431151,CSE 293,042,094946,Gao; Sicun,9998,0,9999,1
1653399431151,CSE 293,043,094947,Weibel; Nadir,9999,0,9999,0
1653399431151,CSE 293,044,094948,Gupta; Rajesh K.,9999,0,9999,0
1653399431747,CSE 294,A00,090143,Porter; George M,9,0,10,1
1653399432283,DSE 200,A00,091799,Staff,50,0,50,0
1653399432806,DSE 203,A00,091800,Gupta; Amarnath,30,0,30,0
1653399433329,DSE 250,A00,091801,Deutsch; Alin Bernard,30,0,30,0
1653399433854,DSE 290,A00,091802,Altintas De Callaf; Ilkay,50,0,50,0
1653399434416,ECE 200,001,091003,Antipa; Nicholas A,9999,0,9999,0
1653399434416,ECE 200,002,091004,Atanasov; Nikolay A.,9999,0,9999,0
1653399434416,ECE 200,003,091005,Bharadia; Dinesh,9999,0,9999,0
1653399434416,ECE 200,004,091006,Cheng; Chung Kuan,9999,0,9999,0
1653399434416,ECE 200,005,091007,Cosman; Pamela C.,9999,0,9999,0
1653399434416,ECE 200,006,091008,Staff,9999,0,9999,0
1653399434416,ECE 200,007,091009,Dayeh; Shadi Ahmad,9999,0,9999,0
1653399434416,ECE 200,008,091010,Fainman; Yeshaiahu,9999,0,9999,0
1653399434416,ECE 200,009,091011,Ford; Joseph Earl,9999,0,9999,0
1653399434416,ECE 200,010,091012,Franceschetti; Massimo,9999,0,9999,0
1653399434416,ECE 200,011,091013,Fullerton; Eric E,9999,0,9999,0
1653399434416,ECE 200,012,091014,Galton; Ian A,9999,0,9999,0
1653399434416,ECE 200,013,091015,Gilja; Vikash,9999,0,9999,0
1653399434416,ECE 200,014,091016,Hall; Drew A.,9999,0,9999,0
1653399434416,ECE 200,015,091017,Hsueh; Tzu-Chien,9999,0,9999,0
1653399434416,ECE 200,016,091018,Javidi; Tara,9999,0,9999,0
1653399434416,ECE 200,017,091019,Kahng; Andrew Byun,9999,0,9999,0
1653399434416,ECE 200,018,091020,Kim; Young-Han,9999,0,9999,0
1653399434416,ECE 200,019,091021,Koushanfar; Farinaz,9999,0,9999,0
1653399434416,ECE 200,020,091022,Kuzum; Duygu,9999,0,9999,0
1653399434416,ECE 200,021,091023,Le; Hanh-Phuc,9999,0,9999,0
1653399434416,ECE 200,022,091024,Lin; Bill,9999,0,9999,0
1653399434416,ECE 200,023,091025,Liu; Zhaowei,9999,0,9999,0
1653399434416,ECE 200,024,091026,Lo; Yu-Hwa,9999,0,9999,0
1653399434416,ECE 200,025,091027,Lomakin; Vitaliy,9999,0,9999,0
1653399434416,ECE 200,026,091028,Mercier; Patrick Philip,9999,0,9999,0
1653399434416,ECE 200,027,091029,Meyer; Florian,9999,0,9999,0
1653399434416,ECE 200,028,091030,Milstein; Laurence B.,9999,0,9999,0
1653399434416,ECE 200,029,091031,Mir Arabbaygi; Siavash,9999,0,9999,0
1653399434416,ECE 200,030,091032,Mookherjea; Shayan,9999,0,9999,0
1653399434416,ECE 200,031,091033,Morris; Karcher William,9999,0,9999,0
1653399434416,ECE 200,032,091034,Ng; Tse Nga,9999,0,9999,0
1653399434416,ECE 200,033,091035,Nguyen; Truong Quang,9999,0,9999,0
1653399434416,ECE 200,034,091036,Nomura; Kenji,9999,0,9999,0
1653399434416,ECE 200,035,091037,Orlitsky; Alon,9999,0,9999,0
1653399434416,ECE 200,036,091038,Pal; Piya,9999,0,9999,0
1653399434416,ECE 200,037,091039,Papen; George C.,9999,0,9999,0
1653399434416,ECE 200,038,091040,Radic; Stojan,9999,0,9999,0
1653399434416,ECE 200,039,091041,Rao; Bhaskar D.,9999,0,9999,0
1653399434416,ECE 200,040,091042,Rao; Ramesh R,9999,0,9999,0
1653399434416,ECE 200,041,091043,Rebeiz; Gabriel,9999,0,9999,0
1653399434416,ECE 200,042,091044,Sanford; John R,9999,0,9999,0
1653399434416,ECE 200,043,091045,Siegel; Paul H.,9999,0,9999,0
1653399434416,ECE 200,044,091046,Sievenpiper; Daniel F.,9999,0,9999,0
1653399434416,ECE 200,045,091047,Sworder; David D.,9999,0,9999,0
1653399434416,ECE 200,046,091048,Taur; Yuan,9999,0,9999,0
1653399434416,ECE 200,047,091049,Touri; Behrouz,9999,0,9999,0
1653399434416,ECE 200,048,091050,Trivedi; Mohan M.,9999,0,9999,0
1653399434416,ECE 200,049,091051,Vardy; Alexander,9999,0,9999,0
1653399434416,ECE 200,050,091052,Vasconcelos; Nuno,9999,0,9999,0
1653399434416,ECE 200,051,091053,Wang; Xiaolong,9999,0,9999,0
1653399434416,ECE 200,052,091054,Xie; Pengtao,9999,0,9999,0
1653399434416,ECE 200,053,091055,Yip; Michael,9999,0,9999,0
1653399434416,ECE 200,054,091056,Zeger; Kenneth A.,9999,0,9999,0
1653399434416,ECE 200,055,091057,Zhang; Xinyu,9999,0,9999,0
1653399434416,ECE 200,056,091058,Turakhia; Yatish Girish,9999,0,9999,0
1653399434416,ECE 200,057,091059,Kang; Mingu,9999,0,9999,0
1653399434416,ECE 200,058,091060,Shi; Yuanyuan,9999,0,9999,0
1653399434416,ECE 200,059,091061,Wang; Edward Jay,9999,0,9999,0
1653399434416,ECE 200,060,091062,Zheng; Yang,9999,0,9999,0
1653399434945,ECE 203,A00,091065,Mercier; Patrick Philip,0,0,0,0
1653399435470,ECE 207A,A00,091605,Liu; Thomas Tao-Ming,0,0,0,0
1653399435999,ECE 212AN,A00,091068,Nomura; Kenji,0,0,0,0
1653399436523,ECE 222A,A00,091069,Rebeiz; Gabriel,0,0,0,0
1653399437045,ECE 225A,A00,091070,Orlitsky; Alon,0,0,0,0
1653399437569,ECE 230A,A00,091071,Nomura; Kenji,0,0,0,0
1653399438096,ECE 236A,A00,091072,Dayeh; Shadi Ahmad,0,0,0,0
1653399438620,ECE 238A,A00,091073,Luo; Jian,0,0,0,0
1653399438620,ECE 238A,B00,091074,Luo; Jian,0,0,0,0
1653399439148,ECE 240A,A00,091075,Radic; Stojan,0,0,0,0
1653399439672,ECE 247A,A00,091592,Shi; Lingyan,0,0,0,0
1653399440198,ECE 250,A00,091076,Touri; Behrouz,0,0,0,0
1653399440721,ECE 251C,A00,091078,Nguyen; Truong Quang,0,0,0,0
1653399441250,ECE 253,A00,091079,Cosman; Pamela C.,0,0,0,0
1653399441772,ECE 255A,A00,091080,Orlitsky; Alon,0,0,0,0
1653399442301,ECE 257A,A00,091081,Zhang; Xinyu,0,0,0,0
1653399442828,ECE 260A,A01,091084,Eldon; John,0,0,0,0
1653399443351,ECE 264C,A00,091085,Galton; Ian A,0,0,0,0
1653399443874,ECE 265C,A00,094889,Presti; Calogero Davide,0,0,0,9
1653399444397,ECE 266,A01,091087,Hall; Drew A.,0,0,0,0
1653399445456,ECE 271A,A00,091090,Vasconcelos; Nuno,0,0,0,0
1653399445978,ECE 272B,A00,091091,Sworder; David D.,0,0,0,0
1653399446502,ECE 275A,A00,091092,Meyer; Florian,0,0,0,0
1653399447031,ECE 277,A00,091093,An; Cheolhong,0,0,0,0
1653399447555,ECE 283,A00,091094,Le; Hanh-Phuc,0,0,0,0
1653399448085,ECE 284,A00,091095,Kang; Mingu,0,0,0,0
1653399448085,ECE 284,B00,091096,Wang; Edward Jay,0,0,0,0
1653399448609,ECE 285,A00,094334,Touri; Behrouz,0,0,0,0
1653399449136,ECE 289,A00,091097,Whelan; David Arthur,0,0,0,0
1653399449667,MATH 200A,A00,087414,Salehi Golsefidy; Alireza,7,0,8,1
1653399450190,MATH 202A,A00,087415,Gill; Philip E.,3,0,8,5
1653399450715,MATH 203A,A00,087416,Oprea; Dragos N.,6,0,8,2
1653399451243,MATH 204A,A00,087417,Kedlaya; Kiran S.,6,0,8,2
1653399451770,MATH 205,A00,087418,Sorensen; Claus M,6,0,8,2
1653399452294,MATH 206A,A00,087419,Izadi; Elham,7,0,8,1
1653399452824,MATH 207A,A00,087420,Mohammadi; Amir,6,0,8,2
1653399453349,MATH 208,A00,087421,Staff,9,0,10,1
1653399453877,MATH 209,A00,087422,Staff,10,0,10,0
1653399454402,MATH 218,A00,087423,Staff,10,0,10,0
1653399454929,MATH 220A,A00,087424,Novak; Jonathan I,7,0,8,1
1653399455452,MATH 231A,A00,087425,Bejenaru; Ioan,4,0,8,4
1653399455980,MATH 240A,A00,087426,Ebenfelt; Peter F,5,0,8,3
1653399456508,MATH 243,A00,087427,Staff,9,0,10,1
1653399457034,MATH 248,A00,087429,Staff,10,0,10,0
1653399457558,MATH 250A,A00,087430,Spolaor; Luca,5,0,8,3
1653399458082,MATH 257A,A00,087431,Spolaor; Luca,7,0,8,1
1653399458605,MATH 258,A00,087432,Staff,9,0,10,1
1653399459127,MATH 264A,A00,087433,Warnke; Lutz Peter,5,0,8,3
1653399459656,MATH 268,A00,087434,Staff,15,0,15,0
1653399460180,MATH 269,A00,087435,Staff,14,0,15,1
1653399460715,MATH 270A,A00,087436,Nie; Jiawang,0,0,8,8
1653399461242,MATH 272A,A00,087437,Tian; Xiaochuan,2,0,8,6
1653399461768,MATH 274,A01,087439,Cheng; Li-Tien,9,0,10,1
1653399461768,MATH 274,A02,087440,Cheng; Li-Tien,10,0,10,0
1653399462292,MATH 278A,A00,087441,Staff,8,0,10,2
1653399462819,MATH 278B,A00,087442,Staff,8,0,10,2
1653399463342,MATH 278C,A00,087443,Staff,8,0,10,2
1653399463870,MATH 280A,A00,087444,Zheng; Tianyi,0,0,8,8
1653399464396,MATH 281A,A00,087445,Bradic; Jelena,0,0,8,8
1653399464933,MATH 282A,A00,087446,Zhang; Danna,0,0,8,8
1653399465457,MATH 283,A00,087447,Tesler; Glenn,0,0,0,13
1653399465985,MATH 286,A00,087448,Kemp; Todd Aahron,6,0,8,2
1653399466508,MATH 287D,A00,087449,Bradic; Jelena,8,0,8,0
1653399467031,MATH 288,A00,087450,Staff,14,0,15,1
1653399467031,MATH 288,B00,087451,Staff,15,0,15,0
1653399467031,MATH 288,C00,087452,Staff,15,0,15,0
1653399467554,MATH 290A,A00,087453,Xu; Zhouli,7,0,8,1
1653399468076,MATH 291A,A00,087454,Xu; Zhouli,7,0,8,1
1653399468601,MATH 292,A00,087455,Staff,10,0,10,0
1653399469126,MATH 295,A00,087456,Staff,50,0,50,0
1653399469650,MATH 297,001,087457,Staff,998,0,999,1
1653400030426,COGS 200,A01,087991,Staff,48,0,50,2
1653400030954,COGS 201,A01,094504,Rangel; Lara M,17,0,25,8
1653400031479,COGS 203,A00,087992,Coulson; Seana M,19,0,20,1
1653400032007,COGS 210A,001,087993,Greene; Deanna Jacquelyn,9998,0,9999,1
1653400032007,COGS 210A,002,087994,Saygin; Ayse P,9999,0,9999,0
1653400032007,COGS 210A,003,087995,Xia; Haijun,9999,0,9999,0
1653400032007,COGS 210A,004,087996,Nitz; Douglas A.,9999,0,9999,0
1653400032007,COGS 210A,005,087997,Hollan; James D.,9999,0,9999,0
1653400032007,COGS 210A,006,087998,Deak; Gedeon O.,9998,0,9999,1
1653400032007,COGS 210A,007,087999,Rossano; Federico,9999,0,9999,0
1653400032530,COGS 211A,A00,088000,Coulson; Seana M,9997,0,9999,2
1653400033053,COGS 229,A00,088002,Staff,23,0,25,2
1653400033579,COGS 260,B00,094231,Staff,17,0,20,3
1653400033579,COGS 260,A00,088004,Nitz; Douglas A.,9998,0,9999,1
1653400034115,CSE 202,A00,090110,Paturi; Ramamohan,0,0,0,0
1653400034115,CSE 202,B00,090111,Paturi; Ramamohan,0,0,0,0
1653400034646,CSE 207B,A00,090112,Heninger; Nadia A,0,0,0,0
1653400035175,CSE 208,A00,094858,Micciancio; Daniele,0,0,0,0
1653400035699,CSE 210,A00,090113,Powell; Thomas Allan,0,0,0,0
1653400036227,CSE 219,A00,090898,Staff,0,0,0,0
1653400036753,CSE 221,A00,090114,Zhou; Yuan-Yuan,0,0,0,0
1653400037281,CSE 229A,A00,090115,Porter; George M,0,0,0,0
1653400037811,CSE 229C,A00,090116,Savage; Stefan,0,0,0,0
1653400038337,CSE 230,A00,090117,Jhala; Ranjit,0,0,0,0
1653400038866,CSE 232,A00,090118,Papakonstantinou; Yannis,0,0,0,0
1653400039391,CSE 239A,A00,090121,Kumar; Arun Kumar,0,0,0,0
1653400039916,CSE 239B,A00,090122,Jhala; Ranjit,0,0,0,0
1653400040444,CSE 240A,A00,090123,Zhao; Jishen,0,0,189,189
1653400040970,CSE 243A,A00,090124,Orailoglu; Alex,3,0,15,12
1653400041497,CSE 249B,A00,090125,Kahng; Andrew Byun,14,0,20,6
1653400042026,CSE 250A,A00,090126,Berg-Kirkpatrick; Taylor D,0,0,0,0
1653400042555,CSE 252A,A00,090127,Ochoa; Benjamin Lawrence,0,0,0,0
1653400043080,CSE 258,A01,090129,McAuley; Julian John,0,0,0,0
1653400043602,CSE 258R,A01,090131,McAuley; Julian John,0,0,0,0
1653400044129,CSE 274,A00,090132,Ramamoorthi; Ravi,0,0,0,0
1653400044655,CSE 276A,A00,090133,Christensen; Henrik I,0,0,0,0
1653400045180,CSE 276C,A00,090134,Christensen; Henrik I,0,0,0,0
1653400045714,CSE 290,A00,090135,Bafna; Vineet,0,0,0,0
1653400045714,CSE 290,B00,090136,Ramamoorthi; Ravi,0,0,0,0
1653400045714,CSE 290,C00,090137,Li; Tzumao,10,0,10,0
1653400045714,CSE 290,D00,090138,Zhou; Yuan-Yuan,10,0,10,0
1653400045714,CSE 290,E00,090139,Christensen; Henrik I,10,0,10,0
1653400045714,CSE 290,F00,094053,Shalev; Aaron D,0,0,0,0
1653400046243,CSE 291,A00,090140,Munyaka; Imani N. S.,0,0,0,0
1653400046243,CSE 291,B00,094880,Yu; Qi,0,0,0,0
1653400046243,CSE 291,C00,090142,Pannuto; Patrick William,0,0,0,0
1653400046243,CSE 291,D00,094881,Zhang; Yiying,0,0,0,0
1653400046243,CSE 291,E00,095118,Su; Hao,0,0,0,0
1653400046790,CSE 293,001,094905,Bafna; Vineet,9999,0,9999,0
1653400046790,CSE 293,002,094906,Bellare; Mihir,9999,0,9999,0
1653400046790,CSE 293,003,094907,Berg-Kirkpatrick; Taylor D,9999,0,9999,0
1653400046790,CSE 293,004,094908,Christensen; Henrik I,9999,0,9999,0
1653400046790,CSE 293,005,094909,Cottrell; Garrison W,9999,0,9999,0
1653400046790,CSE 293,006,094910,Deutsch; Alin Bernard,9999,0,9999,0
1653400046790,CSE 293,007,094911,Esmaeilzadeh; Hadi,9999,0,9999,0
1653400046790,CSE 293,008,094912,Freund; Yoav,9999,0,9999,0
1653400046790,CSE 293,009,094913,Griswold; William G.,9999,0,9999,0
1653400046790,CSE 293,010,094914,Gymrek; Melissa Ann,9999,0,9999,0
1653400046790,CSE 293,011,094915,Heninger; Nadia A,9999,0,9999,0
1653400046790,CSE 293,012,094916,Impagliazzo; Russell,9999,0,9999,0
1653400046790,CSE 293,013,094917,Jhala; Ranjit,9999,0,9999,0
1653400046790,CSE 293,014,094918,Kahng; Andrew Byun,9999,0,9999,0
1653400046790,CSE 293,015,094919,Kane; Daniel Mertz,9999,0,9999,0
1653400046790,CSE 293,016,094920,Kriegman; David J,9999,0,9999,0
1653400046790,CSE 293,017,094921,Kumar; Arun Kumar,9999,0,9999,0
1653400046790,CSE 293,018,094922,Lerner; Sorin,9999,0,9999,0
1653400046790,CSE 293,019,094923,Lovett; Shachar,9999,0,9999,0
1653400046790,CSE 293,020,094924,McAuley; Julian John,9999,0,9999,0
1653400046790,CSE 293,021,094925,Micciancio; Daniele,9999,0,9999,0
1653400046790,CSE 293,022,094926,Orailoglu; Alex,9999,0,9999,0
1653400046790,CSE 293,023,094927,Paturi; Ramamohan,9999,0,9999,0
1653400046790,CSE 293,024,094928,Polikarpova; Nadezhda,9999,0,9999,0
1653400046790,CSE 293,025,094929,Politz; Joseph Gibbs,9999,0,9999,0
1653400046790,CSE 293,026,094930,Porter; George M,9999,0,9999,0
1653400046790,CSE 293,027,094931,Porter; Leonard Emerson,9999,0,9999,0
1653400046790,CSE 293,028,094932,Ramamoorthi; Ravi,9999,0,9999,0
1653400046790,CSE 293,029,094933,Sahoo; Debashis,9999,0,9999,0
1653400046790,CSE 293,030,094934,Saul; Lawrence,9999,0,9999,0
1653400046790,CSE 293,031,094935,Savage; Stefan,9999,0,9999,0
1653400046790,CSE 293,032,094936,Schulze; Jurgen P.,9999,0,9999,0
1653400046790,CSE 293,033,094937,Snoeren; Alex C.,9999,0,9999,0
1653400046790,CSE 293,034,094938,Shang; Jingbo,9999,0,9999,0
1653400046790,CSE 293,035,094939,Stefan; Deian,9999,0,9999,0
1653400046790,CSE 293,036,094940,Su; Hao,9999,0,9999,0
1653400046790,CSE 293,037,094941,Swanson; Steven James,9999,0,9999,0
1653400046790,CSE 293,038,094942,Tullsen; Dean Michael,9999,0,9999,0
1653400046790,CSE 293,039,094943,Voelker; Geoffrey M.,9999,0,9999,0
1653400046790,CSE 293,040,094944,Zhao; Jishen,9999,0,9999,0
1653400046790,CSE 293,041,094945,Zhou; Yuan-Yuan,9999,0,9999,0
1653400046790,CSE 293,042,094946,Gao; Sicun,9998,0,9999,1
1653400046790,CSE 293,043,094947,Weibel; Nadir,9999,0,9999,0
1653400046790,CSE 293,044,094948,Gupta; Rajesh K.,9999,0,9999,0
1653400047317,CSE 294,A00,090143,Porter; George M,9,0,10,1
1653400047843,DSE 200,A00,091799,Staff,50,0,50,0
1653400048378,DSE 203,A00,091800,Gupta; Amarnath,30,0,30,0
1653400048904,DSE 250,A00,091801,Deutsch; Alin Bernard,30,0,30,0
1653400049432,DSE 290,A00,091802,Altintas De Callaf; Ilkay,50,0,50,0
1653400050026,ECE 200,001,091003,Antipa; Nicholas A,9999,0,9999,0
1653400050026,ECE 200,002,091004,Atanasov; Nikolay A.,9999,0,9999,0
1653400050026,ECE 200,003,091005,Bharadia; Dinesh,9999,0,9999,0
1653400050026,ECE 200,004,091006,Cheng; Chung Kuan,9999,0,9999,0
1653400050026,ECE 200,005,091007,Cosman; Pamela C.,9999,0,9999,0
1653400050026,ECE 200,006,091008,Staff,9999,0,9999,0
1653400050026,ECE 200,007,091009,Dayeh; Shadi Ahmad,9999,0,9999,0
1653400050026,ECE 200,008,091010,Fainman; Yeshaiahu,9999,0,9999,0
1653400050026,ECE 200,009,091011,Ford; Joseph Earl,9999,0,9999,0
1653400050026,ECE 200,010,091012,Franceschetti; Massimo,9999,0,9999,0
1653400050026,ECE 200,011,091013,Fullerton; Eric E,9999,0,9999,0
1653400050026,ECE 200,012,091014,Galton; Ian A,9999,0,9999,0
1653400050026,ECE 200,013,091015,Gilja; Vikash,9999,0,9999,0
1653400050026,ECE 200,014,091016,Hall; Drew A.,9999,0,9999,0
1653400050026,ECE 200,015,091017,Hsueh; Tzu-Chien,9999,0,9999,0
1653400050026,ECE 200,016,091018,Javidi; Tara,9999,0,9999,0
1653400050026,ECE 200,017,091019,Kahng; Andrew Byun,9999,0,9999,0
1653400050026,ECE 200,018,091020,Kim; Young-Han,9999,0,9999,0
1653400050026,ECE 200,019,091021,Koushanfar; Farinaz,9999,0,9999,0
1653400050026,ECE 200,020,091022,Kuzum; Duygu,9999,0,9999,0
1653400050026,ECE 200,021,091023,Le; Hanh-Phuc,9999,0,9999,0
1653400050026,ECE 200,022,091024,Lin; Bill,9999,0,9999,0
1653400050026,ECE 200,023,091025,Liu; Zhaowei,9999,0,9999,0
1653400050026,ECE 200,024,091026,Lo; Yu-Hwa,9999,0,9999,0
1653400050026,ECE 200,025,091027,Lomakin; Vitaliy,9999,0,9999,0
1653400050026,ECE 200,026,091028,Mercier; Patrick Philip,9999,0,9999,0
1653400050026,ECE 200,027,091029,Meyer; Florian,9999,0,9999,0
1653400050026,ECE 200,028,091030,Milstein; Laurence B.,9999,0,9999,0
1653400050026,ECE 200,029,091031,Mir Arabbaygi; Siavash,9999,0,9999,0
1653400050026,ECE 200,030,091032,Mookherjea; Shayan,9999,0,9999,0
1653400050026,ECE 200,031,091033,Morris; Karcher William,9999,0,9999,0
1653400050026,ECE 200,032,091034,Ng; Tse Nga,9999,0,9999,0
1653400050026,ECE 200,033,091035,Nguyen; Truong Quang,9999,0,9999,0
1653400050026,ECE 200,034,091036,Nomura; Kenji,9999,0,9999,0
1653400050026,ECE 200,035,091037,Orlitsky; Alon,9999,0,9999,0
1653400050026,ECE 200,036,091038,Pal; Piya,9999,0,9999,0
1653400050026,ECE 200,037,091039,Papen; George C.,9999,0,9999,0
1653400050026,ECE 200,038,091040,Radic; Stojan,9999,0,9999,0
1653400050026,ECE 200,039,091041,Rao; Bhaskar D.,9999,0,9999,0
1653400050026,ECE 200,040,091042,Rao; Ramesh R,9999,0,9999,0
1653400050026,ECE 200,041,091043,Rebeiz; Gabriel,9999,0,9999,0
1653400050026,ECE 200,042,091044,Sanford; John R,9999,0,9999,0
1653400050026,ECE 200,043,091045,Siegel; Paul H.,9999,0,9999,0
1653400050026,ECE 200,044,091046,Sievenpiper; Daniel F.,9999,0,9999,0
1653400050026,ECE 200,045,091047,Sworder; David D.,9999,0,9999,0
1653400050026,ECE 200,046,091048,Taur; Yuan,9999,0,9999,0
1653400050026,ECE 200,047,091049,Touri; Behrouz,9999,0,9999,0
1653400050026,ECE 200,048,091050,Trivedi; Mohan M.,9999,0,9999,0
1653400050026,ECE 200,049,091051,Vardy; Alexander,9999,0,9999,0
1653400050026,ECE 200,050,091052,Vasconcelos; Nuno,9999,0,9999,0
1653400050026,ECE 200,051,091053,Wang; Xiaolong,9999,0,9999,0
1653400050026,ECE 200,052,091054,Xie; Pengtao,9999,0,9999,0
1653400050026,ECE 200,053,091055,Yip; Michael,9999,0,9999,0
1653400050026,ECE 200,054,091056,Zeger; Kenneth A.,9999,0,9999,0
1653400050026,ECE 200,055,091057,Zhang; Xinyu,9999,0,9999,0
1653400050026,ECE 200,056,091058,Turakhia; Yatish Girish,9999,0,9999,0
1653400050026,ECE 200,057,091059,Kang; Mingu,9999,0,9999,0
1653400050026,ECE 200,058,091060,Shi; Yuanyuan,9999,0,9999,0
1653400050026,ECE 200,059,091061,Wang; Edward Jay,9999,0,9999,0
1653400050026,ECE 200,060,091062,Zheng; Yang,9999,0,9999,0
1653400050552,ECE 203,A00,091065,Mercier; Patrick Philip,0,0,0,0
1653400051077,ECE 207A,A00,091605,Liu; Thomas Tao-Ming,0,0,0,0
1653400051601,ECE 212AN,A00,091068,Nomura; Kenji,0,0,0,0
1653400052129,ECE 222A,A00,091069,Rebeiz; Gabriel,0,0,0,0
1653400052655,ECE 225A,A00,091070,Orlitsky; Alon,0,0,0,0
1653400053181,ECE 230A,A00,091071,Nomura; Kenji,0,0,0,0
1653400053709,ECE 236A,A00,091072,Dayeh; Shadi Ahmad,0,0,0,0
1653400054232,ECE 238A,A00,091073,Luo; Jian,0,0,0,0
1653400054232,ECE 238A,B00,091074,Luo; Jian,0,0,0,0
1653400054763,ECE 240A,A00,091075,Radic; Stojan,0,0,0,0
1653400055287,ECE 247A,A00,091592,Shi; Lingyan,0,0,0,0
1653400055813,ECE 250,A00,091076,Touri; Behrouz,0,0,0,0
1653400056347,ECE 251C,A00,091078,Nguyen; Truong Quang,0,0,0,0
1653400056875,ECE 253,A00,091079,Cosman; Pamela C.,0,0,0,0
1653400057398,ECE 255A,A00,091080,Orlitsky; Alon,0,0,0,0
1653400057920,ECE 257A,A00,091081,Zhang; Xinyu,0,0,0,0
1653400058451,ECE 260A,A01,091084,Eldon; John,0,0,0,0
1653400058976,ECE 264C,A00,091085,Galton; Ian A,0,0,0,0
1653400059503,ECE 265C,A00,094889,Presti; Calogero Davide,0,0,0,9
1653400060026,ECE 266,A01,091087,Hall; Drew A.,0,0,0,0
1653400061074,ECE 271A,A00,091090,Vasconcelos; Nuno,0,0,0,0
1653400061597,ECE 272B,A00,091091,Sworder; David D.,0,0,0,0
1653400062122,ECE 275A,A00,091092,Meyer; Florian,0,0,0,0
1653400062646,ECE 277,A00,091093,An; Cheolhong,0,0,0,0
1653400063171,ECE 283,A00,091094,Le; Hanh-Phuc,0,0,0,0
1653400063695,ECE 284,A00,091095,Kang; Mingu,0,0,0,0
1653400063695,ECE 284,B00,091096,Wang; Edward Jay,0,0,0,0
1653400064223,ECE 285,A00,094334,Touri; Behrouz,0,0,0,0
1653400064748,ECE 289,A00,091097,Whelan; David Arthur,0,0,0,0
1653400065281,MATH 200A,A00,087414,Salehi Golsefidy; Alireza,7,0,8,1
1653400065805,MATH 202A,A00,087415,Gill; Philip E.,3,0,8,5
1653400066332,MATH 203A,A00,087416,Oprea; Dragos N.,6,0,8,2
1653400066860,MATH 204A,A00,087417,Kedlaya; Kiran S.,6,0,8,2
1653400067386,MATH 205,A00,087418,Sorensen; Claus M,6,0,8,2
1653400067915,MATH 206A,A00,087419,Izadi; Elham,7,0,8,1
1653400068442,MATH 207A,A00,087420,Mohammadi; Amir,6,0,8,2
1653400068968,MATH 208,A00,087421,Staff,9,0,10,1
1653400069491,MATH 209,A00,087422,Staff,10,0,10,0
1653400070022,MATH 218,A00,087423,Staff,10,0,10,0
1653400070546,MATH 220A,A00,087424,Novak; Jonathan I,7,0,8,1
1653400071070,MATH 231A,A00,087425,Bejenaru; Ioan,4,0,8,4
1653400071595,MATH 240A,A00,087426,Ebenfelt; Peter F,5,0,8,3
1653400072125,MATH 243,A00,087427,Staff,9,0,10,1
1653400072649,MATH 248,A00,087429,Staff,10,0,10,0
1653400073265,MATH 250A,A00,087430,Spolaor; Luca,5,0,8,3
1653400073788,MATH 257A,A00,087431,Spolaor; Luca,7,0,8,1
1653400074311,MATH 258,A00,087432,Staff,9,0,10,1
1653400074841,MATH 264A,A00,087433,Warnke; Lutz Peter,5,0,8,3
1653400075363,MATH 268,A00,087434,Staff,15,0,15,0
1653400075886,MATH 269,A00,087435,Staff,14,0,15,1
1653400076412,MATH 270A,A00,087436,Nie; Jiawang,0,0,8,8
1653400076938,MATH 272A,A00,087437,Tian; Xiaochuan,2,0,8,6
1653400077473,MATH 274,A01,087439,Cheng; Li-Tien,9,0,10,1
1653400077473,MATH 274,A02,087440,Cheng; Li-Tien,10,0,10,0
1653400077996,MATH 278A,A00,087441,Staff,8,0,10,2
1653400078519,MATH 278B,A00,087442,Staff,8,0,10,2
1653400079052,MATH 278C,A00,087443,Staff,8,0,10,2
1653400079579,MATH 280A,A00,087444,Zheng; Tianyi,0,0,8,8
1653400080106,MATH 281A,A00,087445,Bradic; Jelena,0,0,8,8
1653400080635,MATH 282A,A00,087446,Zhang; Danna,0,0,8,8
1653400081165,MATH 283,A00,087447,Tesler; Glenn,0,0,0,13
1653400081691,MATH 286,A00,087448,Kemp; Todd Aahron,6,0,8,2
1653400082216,MATH 287D,A00,087449,Bradic; Jelena,8,0,8,0
1653400082743,MATH 288,A00,087450,Staff,14,0,15,1
1653400082743,MATH 288,B00,087451,Staff,15,0,15,0
1653400082743,MATH 288,C00,087452,Staff,15,0,15,0
1653400083271,MATH 290A,A00,087453,Xu; Zhouli,7,0,8,1
1653400083797,MATH 291A,A00,087454,Xu; Zhouli,7,0,8,1
1653400084323,MATH 292,A00,087455,Staff,10,0,10,0
1653400084848,MATH 295,A00,087456,Staff,50,0,50,0
1653400085375,MATH 297,001,087457,Staff,998,0,999,1
1653400646333,COGS 200,A01,087991,Staff,48,0,50,2
1653400646863,COGS 201,A01,094504,Rangel; Lara M,17,0,25,8
1653400647387,COGS 203,A00,087992,Coulson; Seana M,19,0,20,1
1653400647924,COGS 210A,001,087993,Greene; Deanna Jacquelyn,9998,0,9999,1
1653400647924,COGS 210A,002,087994,Saygin; Ayse P,9999,0,9999,0
1653400647924,COGS 210A,003,087995,Xia; Haijun,9999,0,9999,0
1653400647924,COGS 210A,004,087996,Nitz; Douglas A.,9999,0,9999,0
1653400647924,COGS 210A,005,087997,Hollan; James D.,9999,0,9999,0
1653400647924,COGS 210A,006,087998,Deak; Gedeon O.,9998,0,9999,1
1653400647924,COGS 210A,007,087999,Rossano; Federico,9999,0,9999,0
1653400648446,COGS 211A,A00,088000,Coulson; Seana M,9997,0,9999,2
1653400648968,COGS 229,A00,088002,Staff,23,0,25,2
1653400649495,COGS 260,B00,094231,Staff,17,0,20,3
1653400649495,COGS 260,A00,088004,Nitz; Douglas A.,9998,0,9999,1
1653400650022,CSE 202,A00,090110,Paturi; Ramamohan,0,0,0,0
1653400650022,CSE 202,B00,090111,Paturi; Ramamohan,0,0,0,0
1653400650548,CSE 207B,A00,090112,Heninger; Nadia A,0,0,0,0
1653400651073,CSE 208,A00,094858,Micciancio; Daniele,0,0,0,0
1653400651598,CSE 210,A00,090113,Powell; Thomas Allan,0,0,0,0
1653400652121,CSE 219,A00,090898,Staff,0,0,0,0
1653400652646,CSE 221,A00,090114,Zhou; Yuan-Yuan,0,0,0,0
1653400653181,CSE 229A,A00,090115,Porter; George M,0,0,0,0
1653400653709,CSE 229C,A00,090116,Savage; Stefan,0,0,0,0
1653400654233,CSE 230,A00,090117,Jhala; Ranjit,0,0,0,0
1653400654759,CSE 232,A00,090118,Papakonstantinou; Yannis,0,0,0,0
1653400655283,CSE 239A,A00,090121,Kumar; Arun Kumar,0,0,0,0
1653400655811,CSE 239B,A00,090122,Jhala; Ranjit,0,0,0,0
1653400656336,CSE 240A,A00,090123,Zhao; Jishen,0,0,189,189
1653400656861,CSE 243A,A00,090124,Orailoglu; Alex,3,0,15,12
1653400657385,CSE 249B,A00,090125,Kahng; Andrew Byun,14,0,20,6
1653400657915,CSE 250A,A00,090126,Berg-Kirkpatrick; Taylor D,0,0,0,0
1653400658441,CSE 252A,A00,090127,Ochoa; Benjamin Lawrence,0,0,0,0
1653400658969,CSE 258,A01,090129,McAuley; Julian John,0,0,0,0
1653400659498,CSE 258R,A01,090131,McAuley; Julian John,0,0,0,0
1653400660024,CSE 274,A00,090132,Ramamoorthi; Ravi,0,0,0,0
1653400660555,CSE 276A,A00,090133,Christensen; Henrik I,0,0,0,0
1653400661079,CSE 276C,A00,090134,Christensen; Henrik I,0,0,0,0
1653400661695,CSE 290,A00,090135,Bafna; Vineet,0,0,0,0
1653400661695,CSE 290,B00,090136,Ramamoorthi; Ravi,0,0,0,0
1653400661695,CSE 290,C00,090137,Li; Tzumao,10,0,10,0
1653400661695,CSE 290,D00,090138,Zhou; Yuan-Yuan,10,0,10,0
1653400661695,CSE 290,E00,090139,Christensen; Henrik I,10,0,10,0
1653400661695,CSE 290,F00,094053,Shalev; Aaron D,0,0,0,0
1653400662223,CSE 291,A00,090140,Munyaka; Imani N. S.,0,0,0,0
1653400662223,CSE 291,B00,094880,Yu; Qi,0,0,0,0
1653400662223,CSE 291,C00,090142,Pannuto; Patrick William,0,0,0,0
1653400662223,CSE 291,D00,094881,Zhang; Yiying,0,0,0,0
1653400662223,CSE 291,E00,095118,Su; Hao,0,0,0,0
1653400662763,CSE 293,001,094905,Bafna; Vineet,9999,0,9999,0
1653400662763,CSE 293,002,094906,Bellare; Mihir,9999,0,9999,0
1653400662763,CSE 293,003,094907,Berg-Kirkpatrick; Taylor D,9999,0,9999,0
1653400662763,CSE 293,004,094908,Christensen; Henrik I,9999,0,9999,0
1653400662763,CSE 293,005,094909,Cottrell; Garrison W,9999,0,9999,0
1653400662763,CSE 293,006,094910,Deutsch; Alin Bernard,9999,0,9999,0
1653400662763,CSE 293,007,094911,Esmaeilzadeh; Hadi,9999,0,9999,0
1653400662763,CSE 293,008,094912,Freund; Yoav,9999,0,9999,0
1653400662763,CSE 293,009,094913,Griswold; William G.,9999,0,9999,0
1653400662763,CSE 293,010,094914,Gymrek; Melissa Ann,9999,0,9999,0
1653400662763,CSE 293,011,094915,Heninger; Nadia A,9999,0,9999,0
1653400662763,CSE 293,012,094916,Impagliazzo; Russell,9999,0,9999,0
1653400662763,CSE 293,013,094917,Jhala; Ranjit,9999,0,9999,0
1653400662763,CSE 293,014,094918,Kahng; Andrew Byun,9999,0,9999,0
1653400662763,CSE 293,015,094919,Kane; Daniel Mertz,9999,0,9999,0
1653400662763,CSE 293,016,094920,Kriegman; David J,9999,0,9999,0
1653400662763,CSE 293,017,094921,Kumar; Arun Kumar,9999,0,9999,0
1653400662763,CSE 293,018,094922,Lerner; Sorin,9999,0,9999,0
1653400662763,CSE 293,019,094923,Lovett; Shachar,9999,0,9999,0
1653400662763,CSE 293,020,094924,McAuley; Julian John,9999,0,9999,0
1653400662763,CSE 293,021,094925,Micciancio; Daniele,9999,0,9999,0
1653400662763,CSE 293,022,094926,Orailoglu; Alex,9999,0,9999,0
1653400662763,CSE 293,023,094927,Paturi; Ramamohan,9999,0,9999,0
1653400662763,CSE 293,024,094928,Polikarpova; Nadezhda,9999,0,9999,0
1653400662763,CSE 293,025,094929,Politz; Joseph Gibbs,9999,0,9999,0
1653400662763,CSE 293,026,094930,Porter; George M,9999,0,9999,0
1653400662763,CSE 293,027,094931,Porter; Leonard Emerson,9999,0,9999,0
1653400662763,CSE 293,028,094932,Ramamoorthi; Ravi,9999,0,9999,0
1653400662763,CSE 293,029,094933,Sahoo; Debashis,9999,0,9999,0
1653400662763,CSE 293,030,094934,Saul; Lawrence,9999,0,9999,0
1653400662763,CSE 293,031,094935,Savage; Stefan,9999,0,9999,0
1653400662763,CSE 293,032,094936,Schulze; Jurgen P.,9999,0,9999,0
1653400662763,CSE 293,033,094937,Snoeren; Alex C.,9999,0,9999,0
1653400662763,CSE 293,034,094938,Shang; Jingbo,9999,0,9999,0
1653400662763,CSE 293,035,094939,Stefan; Deian,9999,0,9999,0
1653400662763,CSE 293,036,094940,Su; Hao,9999,0,9999,0
1653400662763,CSE 293,037,094941,Swanson; Steven James,9999,0,9999,0
1653400662763,CSE 293,038,094942,Tullsen; Dean Michael,9999,0,9999,0
1653400662763,CSE 293,039,094943,Voelker; Geoffrey M.,9999,0,9999,0
1653400662763,CSE 293,040,094944,Zhao; Jishen,9999,0,9999,0
1653400662763,CSE 293,041,094945,Zhou; Yuan-Yuan,9999,0,9999,0
1653400662763,CSE 293,042,094946,Gao; Sicun,9998,0,9999,1
1653400662763,CSE 293,043,094947,Weibel; Nadir,9999,0,9999,0
1653400662763,CSE 293,044,094948,Gupta; Rajesh K.,9999,0,9999,0
1653400663291,CSE 294,A00,090143,Porter; George M,9,0,10,1
1653400663814,DSE 200,A00,091799,Staff,50,0,50,0
1653400664342,DSE 203,A00,091800,Gupta; Amarnath,30,0,30,0
1653400664870,DSE 250,A00,091801,Deutsch; Alin Bernard,30,0,30,0
1653400665394,DSE 290,A00,091802,Altintas De Callaf; Ilkay,50,0,50,0
1653400665937,ECE 200,001,091003,Antipa; Nicholas A,9999,0,9999,0
1653400665937,ECE 200,002,091004,Atanasov; Nikolay A.,9999,0,9999,0
1653400665937,ECE 200,003,091005,Bharadia; Dinesh,9999,0,9999,0
1653400665937,ECE 200,004,091006,Cheng; Chung Kuan,9999,0,9999,0
1653400665937,ECE 200,005,091007,Cosman; Pamela C.,9999,0,9999,0
1653400665937,ECE 200,006,091008,Staff,9999,0,9999,0
1653400665937,ECE 200,007,091009,Dayeh; Shadi Ahmad,9999,0,9999,0
1653400665937,ECE 200,008,091010,Fainman; Yeshaiahu,9999,0,9999,0
1653400665937,ECE 200,009,091011,Ford; Joseph Earl,9999,0,9999,0
1653400665937,ECE 200,010,091012,Franceschetti; Massimo,9999,0,9999,0
1653400665937,ECE 200,011,091013,Fullerton; Eric E,9999,0,9999,0
1653400665937,ECE 200,012,091014,Galton; Ian A,9999,0,9999,0
1653400665937,ECE 200,013,091015,Gilja; Vikash,9999,0,9999,0
1653400665937,ECE 200,014,091016,Hall; Drew A.,9999,0,9999,0
1653400665937,ECE 200,015,091017,Hsueh; Tzu-Chien,9999,0,9999,0
1653400665937,ECE 200,016,091018,Javidi; Tara,9999,0,9999,0
1653400665937,ECE 200,017,091019,Kahng; Andrew Byun,9999,0,9999,0
1653400665937,ECE 200,018,091020,Kim; Young-Han,9999,0,9999,0
1653400665937,ECE 200,019,091021,Koushanfar; Farinaz,9999,0,9999,0
1653400665937,ECE 200,020,091022,Kuzum; Duygu,9999,0,9999,0
1653400665937,ECE 200,021,091023,Le; Hanh-Phuc,9999,0,9999,0
1653400665937,ECE 200,022,091024,Lin; Bill,9999,0,9999,0
1653400665937,ECE 200,023,091025,Liu; Zhaowei,9999,0,9999,0
1653400665937,ECE 200,024,091026,Lo; Yu-Hwa,9999,0,9999,0
1653400665937,ECE 200,025,091027,Lomakin; Vitaliy,9999,0,9999,0
1653400665937,ECE 200,026,091028,Mercier; Patrick Philip,9999,0,9999,0
1653400665937,ECE 200,027,091029,Meyer; Florian,9999,0,9999,0
1653400665937,ECE 200,028,091030,Milstein; Laurence B.,9999,0,9999,0
1653400665937,ECE 200,029,091031,Mir Arabbaygi; Siavash,9999,0,9999,0
1653400665937,ECE 200,030,091032,Mookherjea; Shayan,9999,0,9999,0
1653400665937,ECE 200,031,091033,Morris; Karcher William,9999,0,9999,0
1653400665937,ECE 200,032,091034,Ng; Tse Nga,9999,0,9999,0
1653400665937,ECE 200,033,091035,Nguyen; Truong Quang,9999,0,9999,0
1653400665937,ECE 200,034,091036,Nomura; Kenji,9999,0,9999,0
1653400665937,ECE 200,035,091037,Orlitsky; Alon,9999,0,9999,0
1653400665937,ECE 200,036,091038,Pal; Piya,9999,0,9999,0
1653400665937,ECE 200,037,091039,Papen; George C.,9999,0,9999,0
1653400665937,ECE 200,038,091040,Radic; Stojan,9999,0,9999,0
1653400665937,ECE 200,039,091041,Rao; Bhaskar D.,9999,0,9999,0
1653400665937,ECE 200,040,091042,Rao; Ramesh R,9999,0,9999,0
1653400665937,ECE 200,041,091043,Rebeiz; Gabriel,9999,0,9999,0
1653400665937,ECE 200,042,091044,Sanford; John R,9999,0,9999,0
1653400665937,ECE 200,043,091045,Siegel; Paul H.,9999,0,9999,0
1653400665937,ECE 200,044,091046,Sievenpiper; Daniel F.,9999,0,9999,0
1653400665937,ECE 200,045,091047,Sworder; David D.,9999,0,9999,0
1653400665937,ECE 200,046,091048,Taur; Yuan,9999,0,9999,0
1653400665937,ECE 200,047,091049,Touri; Behrouz,9999,0,9999,0
1653400665937,ECE 200,048,091050,Trivedi; Mohan M.,9999,0,9999,0
1653400665937,ECE 200,049,091051,Vardy; Alexander,9999,0,9999,0
1653400665937,ECE 200,050,091052,Vasconcelos; Nuno,9999,0,9999,0
1653400665937,ECE 200,051,091053,Wang; Xiaolong,9999,0,9999,0
1653400665937,ECE 200,052,091054,Xie; Pengtao,9999,0,9999,0
1653400665937,ECE 200,053,091055,Yip; Michael,9999,0,9999,0
1653400665937,ECE 200,054,091056,Zeger; Kenneth A.,9999,0,9999,0
1653400665937,ECE 200,055,091057,Zhang; Xinyu,9999,0,9999,0
1653400665937,ECE 200,056,091058,Turakhia; Yatish Girish,9999,0,9999,0
1653400665937,ECE 200,057,091059,Kang; Mingu,9999,0,9999,0
1653400665937,ECE 200,058,091060,Shi; Yuanyuan,9999,0,9999,0
1653400665937,ECE 200,059,091061,Wang; Edward Jay,9999,0,9999,0
1653400665937,ECE 200,060,091062,Zheng; Yang,9999,0,9999,0
1653400666461,ECE 203,A00,091065,Mercier; Patrick Philip,0,0,0,0
1653400666987,ECE 207A,A00,091605,Liu; Thomas Tao-Ming,0,0,0,0
1653400667515,ECE 212AN,A00,091068,Nomura; Kenji,0,0,0,0
1653400668038,ECE 222A,A00,091069,Rebeiz; Gabriel,0,0,0,0
1653400668563,ECE 225A,A00,091070,Orlitsky; Alon,0,0,0,0
1653400669092,ECE 230A,A00,091071,Nomura; Kenji,0,0,0,0
1653400669618,ECE 236A,A00,091072,Dayeh; Shadi Ahmad,0,0,0,0
1653400670143,ECE 238A,A00,091073,Luo; Jian,0,0,0,0
1653400670143,ECE 238A,B00,091074,Luo; Jian,0,0,0,0
1653400670673,ECE 240A,A00,091075,Radic; Stojan,0,0,0,0
1653400671202,ECE 247A,A00,091592,Shi; Lingyan,0,0,0,0
1653400671730,ECE 250,A00,091076,Touri; Behrouz,0,0,0,0
1653400672254,ECE 251C,A00,091078,Nguyen; Truong Quang,0,0,0,0
1653400672777,ECE 253,A00,091079,Cosman; Pamela C.,0,0,0,0
1653400673301,ECE 255A,A00,091080,Orlitsky; Alon,0,0,0,0
1653400673823,ECE 257A,A00,091081,Zhang; Xinyu,0,0,0,0
1653400674349,ECE 260A,A01,091084,Eldon; John,0,0,0,0
1653400674873,ECE 264C,A00,091085,Galton; Ian A,0,0,0,0
1653400675403,ECE 265C,A00,094889,Presti; Calogero Davide,0,0,0,9
1653400675933,ECE 266,A01,091087,Hall; Drew A.,0,0,0,0
1653400676998,ECE 271A,A00,091090,Vasconcelos; Nuno,0,0,0,0
1653400677521,ECE 272B,A00,091091,Sworder; David D.,0,0,0,0
1653400678049,ECE 275A,A00,091092,Meyer; Florian,0,0,0,0
1653400678574,ECE 277,A00,091093,An; Cheolhong,0,0,0,0
1653400679097,ECE 283,A00,091094,Le; Hanh-Phuc,0,0,0,0
1653400679623,ECE 284,A00,091095,Kang; Mingu,0,0,0,0
1653400679623,ECE 284,B00,091096,Wang; Edward Jay,0,0,0,0
1653400680151,ECE 285,A00,094334,Touri; Behrouz,0,0,0,0
1653400680675,ECE 289,A00,091097,Whelan; David Arthur,0,0,0,0
1653400681199,MATH 200A,A00,087414,Salehi Golsefidy; Alireza,7,0,8,1
1653400681726,MATH 202A,A00,087415,Gill; Philip E.,3,0,8,5
1653400682250,MATH 203A,A00,087416,Oprea; Dragos N.,6,0,8,2
1653400682778,MATH 204A,A00,087417,Kedlaya; Kiran S.,6,0,8,2
1653400683305,MATH 205,A00,087418,Sorensen; Claus M,6,0,8,2
1653400683839,MATH 206A,A00,087419,Izadi; Elham,7,0,8,1
1653400684364,MATH 207A,A00,087420,Mohammadi; Amir,6,0,8,2
1653400684890,MATH 208,A00,087421,Staff,9,0,10,1
1653400685412,MATH 209,A00,087422,Staff,10,0,10,0
1653400685938,MATH 218,A00,087423,Staff,10,0,10,0
1653400686464,MATH 220A,A00,087424,Novak; Jonathan I,7,0,8,1
1653400687001,MATH 231A,A00,087425,Bejenaru; Ioan,4,0,8,4
1653400687530,MATH 240A,A00,087426,Ebenfelt; Peter F,5,0,8,3
1653400688055,MATH 243,A00,087427,Staff,9,0,10,1
1653400688586,MATH 248,A00,087429,Staff,10,0,10,0
1653400689112,MATH 250A,A00,087430,Spolaor; Luca,5,0,8,3
1653400689635,MATH 257A,A00,087431,Spolaor; Luca,7,0,8,1
1653400690159,MATH 258,A00,087432,Staff,9,0,10,1
1653400690685,MATH 264A,A00,087433,Warnke; Lutz Peter,5,0,8,3
1653400691212,MATH 268,A00,087434,Staff,15,0,15,0
1653400691737,MATH 269,A00,087435,Staff,14,0,15,1
1653400692264,MATH 270A,A00,087436,Nie; Jiawang,0,0,8,8
1653400692790,MATH 272A,A00,087437,Tian; Xiaochuan,2,0,8,6
1653400693317,MATH 274,A01,087439,Cheng; Li-Tien,9,0,10,1
1653400693317,MATH 274,A02,087440,Cheng; Li-Tien,10,0,10,0
1653400693843,MATH 278A,A00,087441,Staff,8,0,10,2
1653400694366,MATH 278B,A00,087442,Staff,8,0,10,2
1653400694892,MATH 278C,A00,087443,Staff,8,0,10,2
1653400695418,MATH 280A,A00,087444,Zheng; Tianyi,0,0,8,8
1653400695946,MATH 281A,A00,087445,Bradic; Jelena,0,0,8,8
1653400696470,MATH 282A,A00,087446,Zhang; Danna,0,0,8,8
1653400697000,MATH 283,A00,087447,Tesler; Glenn,0,0,0,13
1653400697526,MATH 286,A00,087448,Kemp; Todd Aahron,6,0,8,2
1653400698050,MATH 287D,A00,087449,Bradic; Jelena,8,0,8,0
1653400698575,MATH 288,A00,087450,Staff,14,0,15,1
1653400698575,MATH 288,B00,087451,Staff,15,0,15,0
1653400698575,MATH 288,C00,087452,Staff,15,0,15,0
1653400699098,MATH 290A,A00,087453,Xu; Zhouli,7,0,8,1
1653400699625,MATH 291A,A00,087454,Xu; Zhouli,7,0,8,1
1653400700149,MATH 292,A00,087455,Staff,10,0,10,0
1653400700671,MATH 295,A00,087456,Staff,50,0,50,0
1653400701197,MATH 297,001,087457,Staff,998,0,999,1
1653401263512,COGS 200,A01,087991,Staff,48,0,50,2
1653401264041,COGS 201,A01,094504,Rangel; Lara M,17,0,25,8
1653401264564,COGS 203,A00,087992,Coulson; Seana M,19,0,20,1
1653401265108,COGS 210A,001,087993,Greene; Deanna Jacquelyn,9998,0,9999,1
1653401265108,COGS 210A,002,087994,Saygin; Ayse P,9999,0,9999,0
1653401265108,COGS 210A,003,087995,Xia; Haijun,9999,0,9999,0
1653401265108,COGS 210A,004,087996,Nitz; Douglas A.,9999,0,9999,0
1653401265108,COGS 210A,005,087997,Hollan; James D.,9999,0,9999,0
1653401265108,COGS 210A,006,087998,Deak; Gedeon O.,9998,0,9999,1
1653401265108,COGS 210A,007,087999,Rossano; Federico,9999,0,9999,0
1653401265641,COGS 211A,A00,088000,Coulson; Seana M,9997,0,9999,2
1653401266166,COGS 229,A00,088002,Staff,23,0,25,2
1653401266702,COGS 260,B00,094231,Staff,17,0,20,3
1653401266702,COGS 260,A00,088004,Nitz; Douglas A.,9998,0,9999,1
1653401267230,CSE 202,A00,090110,Paturi; Ramamohan,0,0,0,0
1653401267230,CSE 202,B00,090111,Paturi; Ramamohan,0,0,0,0
1653401267756,CSE 207B,A00,090112,Heninger; Nadia A,0,0,0,0
1653401268293,CSE 208,A00,094858,Micciancio; Daniele,0,0,0,0
1653401268815,CSE 210,A00,090113,Powell; Thomas Allan,0,0,0,0
1653401269337,CSE 219,A00,090898,Staff,0,0,0,0
1653401269861,CSE 221,A00,090114,Zhou; Yuan-Yuan,0,0,0,0
1653401270384,CSE 229A,A00,090115,Porter; George M,0,0,0,0
1653401270912,CSE 229C,A00,090116,Savage; Stefan,0,0,0,0
1653401271436,CSE 230,A00,090117,Jhala; Ranjit,0,0,0,0
1653401271963,CSE 232,A00,090118,Papakonstantinou; Yannis,0,0,0,0
1653401272508,CSE 239A,A00,090121,Kumar; Arun Kumar,0,0,0,0
1653401273033,CSE 239B,A00,090122,Jhala; Ranjit,0,0,0,0
1653401273558,CSE 240A,A00,090123,Zhao; Jishen,0,0,189,189
1653401274080,CSE 243A,A00,090124,Orailoglu; Alex,3,0,15,12
1653401274608,CSE 249B,A00,090125,Kahng; Andrew Byun,14,0,20,6
1653401275135,CSE 250A,A00,090126,Berg-Kirkpatrick; Taylor D,0,0,0,0
1653401275665,CSE 252A,A00,090127,Ochoa; Benjamin Lawrence,0,0,0,0
1653401276191,CSE 258,A01,090129,McAuley; Julian John,0,0,0,0
1653401276714,CSE 258R,A01,090131,McAuley; Julian John,0,0,0,0
1653401277236,CSE 274,A00,090132,Ramamoorthi; Ravi,0,0,0,0
1653401277759,CSE 276A,A00,090133,Christensen; Henrik I,0,0,0,0
1653401278282,CSE 276C,A00,090134,Christensen; Henrik I,0,0,0,0
1653401278807,CSE 290,A00,090135,Bafna; Vineet,0,0,0,0
1653401278807,CSE 290,B00,090136,Ramamoorthi; Ravi,0,0,0,0
1653401278807,CSE 290,C00,090137,Li; Tzumao,10,0,10,0
1653401278807,CSE 290,D00,090138,Zhou; Yuan-Yuan,10,0,10,0
1653401278807,CSE 290,E00,090139,Christensen; Henrik I,10,0,10,0
1653401278807,CSE 290,F00,094053,Shalev; Aaron D,0,0,0,0
1653401279333,CSE 291,A00,090140,Munyaka; Imani N. S.,0,0,0,0
1653401279333,CSE 291,B00,094880,Yu; Qi,0,0,0,0
1653401279333,CSE 291,C00,090142,Pannuto; Patrick William,0,0,0,0
1653401279333,CSE 291,D00,094881,Zhang; Yiying,0,0,0,0
1653401279333,CSE 291,E00,095118,Su; Hao,0,0,0,0
1653401279893,CSE 293,001,094905,Bafna; Vineet,9999,0,9999,0
1653401279893,CSE 293,002,094906,Bellare; Mihir,9999,0,9999,0
1653401279893,CSE 293,003,094907,Berg-Kirkpatrick; Taylor D,9999,0,9999,0
1653401279893,CSE 293,004,094908,Christensen; Henrik I,9999,0,9999,0
1653401279893,CSE 293,005,094909,Cottrell; Garrison W,9999,0,9999,0
1653401279893,CSE 293,006,094910,Deutsch; Alin Bernard,9999,0,9999,0
1653401279893,CSE 293,007,094911,Esmaeilzadeh; Hadi,9999,0,9999,0
1653401279893,CSE 293,008,094912,Freund; Yoav,9999,0,9999,0
1653401279893,CSE 293,009,094913,Griswold; William G.,9999,0,9999,0
1653401279893,CSE 293,010,094914,Gymrek; Melissa Ann,9999,0,9999,0
1653401279893,CSE 293,011,094915,Heninger; Nadia A,9999,0,9999,0
1653401279893,CSE 293,012,094916,Impagliazzo; Russell,9999,0,9999,0
1653401279893,CSE 293,013,094917,Jhala; Ranjit,9999,0,9999,0
1653401279893,CSE 293,014,094918,Kahng; Andrew Byun,9999,0,9999,0
1653401279893,CSE 293,015,094919,Kane; Daniel Mertz,9999,0,9999,0
1653401279893,CSE 293,016,094920,Kriegman; David J,9999,0,9999,0
1653401279893,CSE 293,017,094921,Kumar; Arun Kumar,9999,0,9999,0
1653401279893,CSE 293,018,094922,Lerner; Sorin,9999,0,9999,0
1653401279893,CSE 293,019,094923,Lovett; Shachar,9999,0,9999,0
1653401279893,CSE 293,020,094924,McAuley; Julian John,9999,0,9999,0
1653401279893,CSE 293,021,094925,Micciancio; Daniele,9999,0,9999,0
1653401279893,CSE 293,022,094926,Orailoglu; Alex,9999,0,9999,0
1653401279893,CSE 293,023,094927,Paturi; Ramamohan,9999,0,9999,0
1653401279893,CSE 293,024,094928,Polikarpova; Nadezhda,9999,0,9999,0
1653401279893,CSE 293,025,094929,Politz; Joseph Gibbs,9999,0,9999,0
1653401279893,CSE 293,026,094930,Porter; George M,9999,0,9999,0
1653401279893,CSE 293,027,094931,Porter; Leonard Emerson,9999,0,9999,0
1653401279893,CSE 293,028,094932,Ramamoorthi; Ravi,9999,0,9999,0
1653401279893,CSE 293,029,094933,Sahoo; Debashis,9999,0,9999,0
1653401279893,CSE 293,030,094934,Saul; Lawrence,9999,0,9999,0
1653401279893,CSE 293,031,094935,Savage; Stefan,9999,0,9999,0
1653401279893,CSE 293,032,094936,Schulze; Jurgen P.,9999,0,9999,0
1653401279893,CSE 293,033,094937,Snoeren; Alex C.,9999,0,9999,0
1653401279893,CSE 293,034,094938,Shang; Jingbo,9999,0,9999,0
1653401279893,CSE 293,035,094939,Stefan; Deian,9999,0,9999,0
1653401279893,CSE 293,036,094940,Su; Hao,9999,0,9999,0
1653401279893,CSE 293,037,094941,Swanson; Steven James,9999,0,9999,0
1653401279893,CSE 293,038,094942,Tullsen; Dean Michael,9999,0,9999,0
1653401279893,CSE 293,039,094943,Voelker; Geoffrey M.,9999,0,9999,0
1653401279893,CSE 293,040,094944,Zhao; Jishen,9999,0,9999,0
1653401279893,CSE 293,041,094945,Zhou; Yuan-Yuan,9999,0,9999,0
1653401279893,CSE 293,042,094946,Gao; Sicun,9998,0,9999,1
1653401279893,CSE 293,043,094947,Weibel; Nadir,9999,0,9999,0
1653401279893,CSE 293,044,094948,Gupta; Rajesh K.,9999,0,9999,0
1653401280417,CSE 294,A00,090143,Porter; George M,9,0,10,1
1653401280959,DSE 200,A00,091799,Staff,50,0,50,0
1653401281483,DSE 203,A00,091800,Gupta; Amarnath,30,0,30,0
1653401282006,DSE 250,A00,091801,Deutsch; Alin Bernard,30,0,30,0
1653401282530,DSE 290,A00,091802,Altintas De Callaf; Ilkay,50,0,50,0
1653401283075,ECE 200,001,091003,Antipa; Nicholas A,9999,0,9999,0
1653401283075,ECE 200,002,091004,Atanasov; Nikolay A.,9999,0,9999,0
1653401283075,ECE 200,003,091005,Bharadia; Dinesh,9999,0,9999,0
1653401283075,ECE 200,004,091006,Cheng; Chung Kuan,9999,0,9999,0
1653401283075,ECE 200,005,091007,Cosman; Pamela C.,9999,0,9999,0
1653401283075,ECE 200,006,091008,Staff,9999,0,9999,0
1653401283075,ECE 200,007,091009,Dayeh; Shadi Ahmad,9999,0,9999,0
1653401283075,ECE 200,008,091010,Fainman; Yeshaiahu,9999,0,9999,0
1653401283075,ECE 200,009,091011,Ford; Joseph Earl,9999,0,9999,0
1653401283075,ECE 200,010,091012,Franceschetti; Massimo,9999,0,9999,0
1653401283075,ECE 200,011,091013,Fullerton; Eric E,9999,0,9999,0
1653401283075,ECE 200,012,091014,Galton; Ian A,9999,0,9999,0
1653401283075,ECE 200,013,091015,Gilja; Vikash,9999,0,9999,0
1653401283075,ECE 200,014,091016,Hall; Drew A.,9999,0,9999,0
1653401283075,ECE 200,015,091017,Hsueh; Tzu-Chien,9999,0,9999,0
1653401283075,ECE 200,016,091018,Javidi; Tara,9999,0,9999,0
1653401283075,ECE 200,017,091019,Kahng; Andrew Byun,9999,0,9999,0
1653401283075,ECE 200,018,091020,Kim; Young-Han,9999,0,9999,0
1653401283075,ECE 200,019,091021,Koushanfar; Farinaz,9999,0,9999,0
1653401283075,ECE 200,020,091022,Kuzum; Duygu,9999,0,9999,0
1653401283075,ECE 200,021,091023,Le; Hanh-Phuc,9999,0,9999,0
1653401283075,ECE 200,022,091024,Lin; Bill,9999,0,9999,0
1653401283075,ECE 200,023,091025,Liu; Zhaowei,9999,0,9999,0
1653401283075,ECE 200,024,091026,Lo; Yu-Hwa,9999,0,9999,0
1653401283075,ECE 200,025,091027,Lomakin; Vitaliy,9999,0,9999,0
1653401283075,ECE 200,026,091028,Mercier; Patrick Philip,9999,0,9999,0
1653401283075,ECE 200,027,091029,Meyer; Florian,9999,0,9999,0
1653401283075,ECE 200,028,091030,Milstein; Laurence B.,9999,0,9999,0
1653401283075,ECE 200,029,091031,Mir Arabbaygi; Siavash,9999,0,9999,0
1653401283075,ECE 200,030,091032,Mookherjea; Shayan,9999,0,9999,0
1653401283075,ECE 200,031,091033,Morris; Karcher William,9999,0,9999,0
1653401283075,ECE 200,032,091034,Ng; Tse Nga,9999,0,9999,0
1653401283075,ECE 200,033,091035,Nguyen; Truong Quang,9999,0,9999,0
1653401283075,ECE 200,034,091036,Nomura; Kenji,9999,0,9999,0
1653401283075,ECE 200,035,091037,Orlitsky; Alon,9999,0,9999,0
1653401283075,ECE 200,036,091038,Pal; Piya,9999,0,9999,0
1653401283075,ECE 200,037,091039,Papen; George C.,9999,0,9999,0
1653401283075,ECE 200,038,091040,Radic; Stojan,9999,0,9999,0
1653401283075,ECE 200,039,091041,Rao; Bhaskar D.,9999,0,9999,0
1653401283075,ECE 200,040,091042,Rao; Ramesh R,9999,0,9999,0
1653401283075,ECE 200,041,091043,Rebeiz; Gabriel,9999,0,9999,0
1653401283075,ECE 200,042,091044,Sanford; John R,9999,0,9999,0
1653401283075,ECE 200,043,091045,Siegel; Paul H.,9999,0,9999,0
1653401283075,ECE 200,044,091046,Sievenpiper; Daniel F.,9999,0,9999,0
1653401283075,ECE 200,045,091047,Sworder; David D.,9999,0,9999,0
1653401283075,ECE 200,046,091048,Taur; Yuan,9999,0,9999,0
1653401283075,ECE 200,047,091049,Touri; Behrouz,9999,0,9999,0
1653401283075,ECE 200,048,091050,Trivedi; Mohan M.,9999,0,9999,0
1653401283075,ECE 200,049,091051,Vardy; Alexander,9999,0,9999,0
1653401283075,ECE 200,050,091052,Vasconcelos; Nuno,9999,0,9999,0
1653401283075,ECE 200,051,091053,Wang; Xiaolong,9999,0,9999,0
1653401283075,ECE 200,052,091054,Xie; Pengtao,9999,0,9999,0
1653401283075,ECE 200,053,091055,Yip; Michael,9999,0,9999,0
1653401283075,ECE 200,054,091056,Zeger; Kenneth A.,9999,0,9999,0
1653401283075,ECE 200,055,091057,Zhang; Xinyu,9999,0,9999,0
1653401283075,ECE 200,056,091058,Turakhia; Yatish Girish,9999,0,9999,0
1653401283075,ECE 200,057,091059,Kang; Mingu,9999,0,9999,0
1653401283075,ECE 200,058,091060,Shi; Yuanyuan,9999,0,9999,0
1653401283075,ECE 200,059,091061,Wang; Edward Jay,9999,0,9999,0
1653401283075,ECE 200,060,091062,Zheng; Yang,9999,0,9999,0
1653401283602,ECE 203,A00,091065,Mercier; Patrick Philip,0,0,0,0
1653401284134,ECE 207A,A00,091605,Liu; Thomas Tao-Ming,0,0,0,0
1653401284656,ECE 212AN,A00,091068,Nomura; Kenji,0,0,0,0
1653401285179,ECE 222A,A00,091069,Rebeiz; Gabriel,0,0,0,0
1653401285710,ECE 225A,A00,091070,Orlitsky; Alon,0,0,0,0
1653401286233,ECE 230A,A00,091071,Nomura; Kenji,0,0,0,0
1653401286758,ECE 236A,A00,091072,Dayeh; Shadi Ahmad,0,0,0,0
1653401287289,ECE 238A,A00,091073,Luo; Jian,0,0,0,0
1653401287289,ECE 238A,B00,091074,Luo; Jian,0,0,0,0
1653401287825,ECE 240A,A00,091075,Radic; Stojan,0,0,0,0
1653401288350,ECE 247A,A00,091592,Shi; Lingyan,0,0,0,0
1653401288874,ECE 250,A00,091076,Touri; Behrouz,0,0,0,0
1653401289402,ECE 251C,A00,091078,Nguyen; Truong Quang,0,0,0,0
1653401289932,ECE 253,A00,091079,Cosman; Pamela C.,0,0,0,0
1653401290459,ECE 255A,A00,091080,Orlitsky; Alon,0,0,0,0
1653401290985,ECE 257A,A00,091081,Zhang; Xinyu,0,0,0,0
1653401291510,ECE 260A,A01,091084,Eldon; John,0,0,0,0
1653401292034,ECE 264C,A00,091085,Galton; Ian A,0,0,0,0
1653401292566,ECE 265C,A00,094889,Presti; Calogero Davide,0,0,0,9
1653401293099,ECE 266,A01,091087,Hall; Drew A.,0,0,0,0
1653401294155,ECE 271A,A00,091090,Vasconcelos; Nuno,0,0,0,0
1653401294677,ECE 272B,A00,091091,Sworder; David D.,0,0,0,0
1653401295201,ECE 275A,A00,091092,Meyer; Florian,0,0,0,0
1653401295726,ECE 277,A00,091093,An; Cheolhong,0,0,0,0
1653401296265,ECE 283,A00,091094,Le; Hanh-Phuc,0,0,0,0
1653401296791,ECE 284,A00,091095,Kang; Mingu,0,0,0,0
1653401296791,ECE 284,B00,091096,Wang; Edward Jay,0,0,0,0
1653401297316,ECE 285,A00,094334,Touri; Behrouz,0,0,0,0
1653401297838,ECE 289,A00,091097,Whelan; David Arthur,0,0,0,0
1653401298370,MATH 200A,A00,087414,Salehi Golsefidy; Alireza,7,0,8,1
1653401298897,MATH 202A,A00,087415,Gill; Philip E.,3,0,8,5
1653401299424,MATH 203A,A00,087416,Oprea; Dragos N.,6,0,8,2
1653401299949,MATH 204A,A00,087417,Kedlaya; Kiran S.,6,0,8,2
1653401300474,MATH 205,A00,087418,Sorensen; Claus M,6,0,8,2
1653401300996,MATH 206A,A00,087419,Izadi; Elham,7,0,8,1
1653401301530,MATH 207A,A00,087420,Mohammadi; Amir,6,0,8,2
1653401302069,MATH 208,A00,087421,Staff,9,0,10,1
1653401302594,MATH 209,A00,087422,Staff,10,0,10,0
1653401303118,MATH 218,A00,087423,Staff,10,0,10,0
1653401303642,MATH 220A,A00,087424,Novak; Jonathan I,7,0,8,1
1653401304170,MATH 231A,A00,087425,Bejenaru; Ioan,4,0,8,4
1653401304766,MATH 240A,A00,087426,Ebenfelt; Peter F,5,0,8,3
1653401305291,MATH 243,A00,087427,Staff,9,0,10,1
1653401305815,MATH 248,A00,087429,Staff,10,0,10,0
1653401306338,MATH 250A,A00,087430,Spolaor; Luca,5,0,8,3
1653401306870,MATH 257A,A00,087431,Spolaor; Luca,7,0,8,1
1653401307392,MATH 258,A00,087432,Staff,9,0,10,1
1653401307920,MATH 264A,A00,087433,Warnke; Lutz Peter,5,0,8,3
1653401308443,MATH 268,A00,087434,Staff,15,0,15,0
1653401308966,MATH 269,A00,087435,Staff,14,0,15,1
1653401309493,MATH 270A,A00,087436,Nie; Jiawang,0,0,8,8
1653401310025,MATH 272A,A00,087437,Tian; Xiaochuan,2,0,8,6
1653401310558,MATH 274,A01,087439,Cheng; Li-Tien,9,0,10,1
1653401310558,MATH 274,A02,087440,Cheng; Li-Tien,10,0,10,0
1653401311085,MATH 278A,A00,087441,Staff,8,0,10,2
1653401311609,MATH 278B,A00,087442,Staff,8,0,10,2
1653401312131,MATH 278C,A00,087443,Staff,8,0,10,2
1653401312656,MATH 280A,A00,087444,Zheng; Tianyi,0,0,8,8
1653401313186,MATH 281A,A00,087445,Bradic; Jelena,0,0,8,8
1653401313716,MATH 282A,A00,087446,Zhang; Danna,0,0,8,8
1653401314238,MATH 283,A00,087447,Tesler; Glenn,0,0,0,13
1653401314770,MATH 286,A00,087448,Kemp; Todd Aahron,6,0,8,2
1653401315293,MATH 287D,A00,087449,Bradic; Jelena,8,0,8,0
1653401315819,MATH 288,A00,087450,Staff,14,0,15,1
1653401315819,MATH 288,B00,087451,Staff,15,0,15,0
1653401315819,MATH 288,C00,087452,Staff,15,0,15,0
1653401316345,MATH 290A,A00,087453,Xu; Zhouli,7,0,8,1
1653401316877,MATH 291A,A00,087454,Xu; Zhouli,7,0,8,1
1653401317399,MATH 292,A00,087455,Staff,10,0,10,0
1653401317927,MATH 295,A00,087456,Staff,50,0,50,0
1653401318450,MATH 297,001,087457,Staff,998,0,999,1
1653401879225,COGS 200,A01,087991,Staff,48,0,50,2
1653401879748,COGS 201,A01,094504,Rangel; Lara M,17,0,25,8
1653401880277,COGS 203,A00,087992,Coulson; Seana M,19,0,20,1
1653401880811,COGS 210A,001,087993,Greene; Deanna Jacquelyn,9998,0,9999,1
1653401880811,COGS 210A,002,087994,Saygin; Ayse P,9999,0,9999,0
1653401880811,COGS 210A,003,087995,Xia; Haijun,9999,0,9999,0
1653401880811,COGS 210A,004,087996,Nitz; Douglas A.,9999,0,9999,0
1653401880811,COGS 210A,005,087997,Hollan; James D.,9999,0,9999,0
1653401880811,COGS 210A,006,087998,Deak; Gedeon O.,9998,0,9999,1
1653401880811,COGS 210A,007,087999,Rossano; Federico,9999,0,9999,0
1653401881337,COGS 211A,A00,088000,Coulson; Seana M,9997,0,9999,2
1653401881862,COGS 229,A00,088002,Staff,23,0,25,2
1653401882388,COGS 260,B00,094231,Staff,17,0,20,3
1653401882388,COGS 260,A00,088004,Nitz; Douglas A.,9998,0,9999,1
1653401882914,CSE 202,A00,090110,Paturi; Ramamohan,0,0,0,0
1653401882914,CSE 202,B00,090111,Paturi; Ramamohan,0,0,0,0
1653401883440,CSE 207B,A00,090112,Heninger; Nadia A,0,0,0,0
1653401883965,CSE 208,A00,094858,Micciancio; Daniele,0,0,0,0
1653401884494,CSE 210,A00,090113,Powell; Thomas Allan,0,0,0,0
1653401885026,CSE 219,A00,090898,Staff,0,0,0,0
1653401885551,CSE 221,A00,090114,Zhou; Yuan-Yuan,0,0,0,0
1653401886081,CSE 229A,A00,090115,Porter; George M,0,0,0,0
1653401886604,CSE 229C,A00,090116,Savage; Stefan,0,0,0,0
1653401887130,CSE 230,A00,090117,Jhala; Ranjit,0,0,0,0
1653401887660,CSE 232,A00,090118,Papakonstantinou; Yannis,0,0,0,0
1653401888185,CSE 239A,A00,090121,Kumar; Arun Kumar,0,0,0,0
1653401888722,CSE 239B,A00,090122,Jhala; Ranjit,0,0,0,0
1653401889251,CSE 240A,A00,090123,Zhao; Jishen,0,0,189,189
1653401889783,CSE 243A,A00,090124,Orailoglu; Alex,3,0,15,12
1653401890306,CSE 249B,A00,090125,Kahng; Andrew Byun,14,0,20,6
1653401890832,CSE 250A,A00,090126,Berg-Kirkpatrick; Taylor D,0,0,0,0
1653401891355,CSE 252A,A00,090127,Ochoa; Benjamin Lawrence,0,0,0,0
1653401891878,CSE 258,A01,090129,McAuley; Julian John,0,0,0,0
1653401892401,CSE 258R,A01,090131,McAuley; Julian John,0,0,0,0
1653401893015,CSE 274,A00,090132,Ramamoorthi; Ravi,0,0,0,0
1653401893539,CSE 276A,A00,090133,Christensen; Henrik I,0,0,0,0
1653401894066,CSE 276C,A00,090134,Christensen; Henrik I,0,0,0,0
1653401894595,CSE 290,A00,090135,Bafna; Vineet,0,0,0,0
1653401894595,CSE 290,B00,090136,Ramamoorthi; Ravi,0,0,0,0
1653401894595,CSE 290,C00,090137,Li; Tzumao,10,0,10,0
1653401894595,CSE 290,D00,090138,Zhou; Yuan-Yuan,10,0,10,0
1653401894595,CSE 290,E00,090139,Christensen; Henrik I,10,0,10,0
1653401894595,CSE 290,F00,094053,Shalev; Aaron D,0,0,0,0
1653401895122,CSE 291,A00,090140,Munyaka; Imani N. S.,0,0,0,0
1653401895122,CSE 291,B00,094880,Yu; Qi,0,0,0,0
1653401895122,CSE 291,C00,090142,Pannuto; Patrick William,0,0,0,0
1653401895122,CSE 291,D00,094881,Zhang; Yiying,0,0,0,0
1653401895122,CSE 291,E00,095118,Su; Hao,0,0,0,0
1653401895656,CSE 293,001,094905,Bafna; Vineet,9999,0,9999,0
1653401895656,CSE 293,002,094906,Bellare; Mihir,9999,0,9999,0
1653401895656,CSE 293,003,094907,Berg-Kirkpatrick; Taylor D,9999,0,9999,0
1653401895656,CSE 293,004,094908,Christensen; Henrik I,9999,0,9999,0
1653401895656,CSE 293,005,094909,Cottrell; Garrison W,9999,0,9999,0
1653401895656,CSE 293,006,094910,Deutsch; Alin Bernard,9999,0,9999,0
1653401895656,CSE 293,007,094911,Esmaeilzadeh; Hadi,9999,0,9999,0
1653401895656,CSE 293,008,094912,Freund; Yoav,9999,0,9999,0
1653401895656,CSE 293,009,094913,Griswold; William G.,9999,0,9999,0
1653401895656,CSE 293,010,094914,Gymrek; Melissa Ann,9999,0,9999,0
1653401895656,CSE 293,011,094915,Heninger; Nadia A,9999,0,9999,0
1653401895656,CSE 293,012,094916,Impagliazzo; Russell,9999,0,9999,0
1653401895656,CSE 293,013,094917,Jhala; Ranjit,9999,0,9999,0
1653401895656,CSE 293,014,094918,Kahng; Andrew Byun,9999,0,9999,0
1653401895656,CSE 293,015,094919,Kane; Daniel Mertz,9999,0,9999,0
1653401895656,CSE 293,016,094920,Kriegman; David J,9999,0,9999,0
1653401895656,CSE 293,017,094921,Kumar; Arun Kumar,9999,0,9999,0
1653401895656,CSE 293,018,094922,Lerner; Sorin,9999,0,9999,0
1653401895656,CSE 293,019,094923,Lovett; Shachar,9999,0,9999,0
1653401895656,CSE 293,020,094924,McAuley; Julian John,9999,0,9999,0
1653401895656,CSE 293,021,094925,Micciancio; Daniele,9999,0,9999,0
1653401895656,CSE 293,022,094926,Orailoglu; Alex,9999,0,9999,0
1653401895656,CSE 293,023,094927,Paturi; Ramamohan,9999,0,9999,0
1653401895656,CSE 293,024,094928,Polikarpova; Nadezhda,9999,0,9999,0
1653401895656,CSE 293,025,094929,Politz; Joseph Gibbs,9999,0,9999,0
1653401895656,CSE 293,026,094930,Porter; George M,9999,0,9999,0
1653401895656,CSE 293,027,094931,Porter; Leonard Emerson,9999,0,9999,0
1653401895656,CSE 293,028,094932,Ramamoorthi; Ravi,9999,0,9999,0
1653401895656,CSE 293,029,094933,Sahoo; Debashis,9999,0,9999,0
1653401895656,CSE 293,030,094934,Saul; Lawrence,9999,0,9999,0
1653401895656,CSE 293,031,094935,Savage; Stefan,9999,0,9999,0
1653401895656,CSE 293,032,094936,Schulze; Jurgen P.,9999,0,9999,0
1653401895656,CSE 293,033,094937,Snoeren; Alex C.,9999,0,9999,0
1653401895656,CSE 293,034,094938,Shang; Jingbo,9999,0,9999,0
1653401895656,CSE 293,035,094939,Stefan; Deian,9999,0,9999,0
1653401895656,CSE 293,036,094940,Su; Hao,9999,0,9999,0
1653401895656,CSE 293,037,094941,Swanson; Steven James,9999,0,9999,0
1653401895656,CSE 293,038,094942,Tullsen; Dean Michael,9999,0,9999,0
1653401895656,CSE 293,039,094943,Voelker; Geoffrey M.,9999,0,9999,0
1653401895656,CSE 293,040,094944,Zhao; Jishen,9999,0,9999,0
1653401895656,CSE 293,041,094945,Zhou; Yuan-Yuan,9999,0,9999,0
1653401895656,CSE 293,042,094946,Gao; Sicun,9998,0,9999,1
1653401895656,CSE 293,043,094947,Weibel; Nadir,9999,0,9999,0
1653401895656,CSE 293,044,094948,Gupta; Rajesh K.,9999,0,9999,0
1653401896193,CSE 294,A00,090143,Porter; George M,9,0,10,1
1653401896724,DSE 200,A00,091799,Staff,50,0,50,0
1653401897245,DSE 203,A00,091800,Gupta; Amarnath,30,0,30,0
1653401897784,DSE 250,A00,091801,Deutsch; Alin Bernard,30,0,30,0
1653401898318,DSE 290,A00,091802,Altintas De Callaf; Ilkay,50,0,50,0
1653401898872,ECE 200,001,091003,Antipa; Nicholas A,9999,0,9999,0
1653401898872,ECE 200,002,091004,Atanasov; Nikolay A.,9999,0,9999,0
1653401898872,ECE 200,003,091005,Bharadia; Dinesh,9999,0,9999,0
1653401898872,ECE 200,004,091006,Cheng; Chung Kuan,9999,0,9999,0
1653401898872,ECE 200,005,091007,Cosman; Pamela C.,9999,0,9999,0
1653401898872,ECE 200,006,091008,Staff,9999,0,9999,0
1653401898872,ECE 200,007,091009,Dayeh; Shadi Ahmad,9999,0,9999,0
1653401898872,ECE 200,008,091010,Fainman; Yeshaiahu,9999,0,9999,0
1653401898872,ECE 200,009,091011,Ford; Joseph Earl,9999,0,9999,0
1653401898872,ECE 200,010,091012,Franceschetti; Massimo,9999,0,9999,0
1653401898872,ECE 200,011,091013,Fullerton; Eric E,9999,0,9999,0
1653401898872,ECE 200,012,091014,Galton; Ian A,9999,0,9999,0
1653401898872,ECE 200,013,091015,Gilja; Vikash,9999,0,9999,0
1653401898872,ECE 200,014,091016,Hall; Drew A.,9999,0,9999,0
1653401898872,ECE 200,015,091017,Hsueh; Tzu-Chien,9999,0,9999,0
1653401898872,ECE 200,016,091018,Javidi; Tara,9999,0,9999,0
1653401898872,ECE 200,017,091019,Kahng; Andrew Byun,9999,0,9999,0
1653401898872,ECE 200,018,091020,Kim; Young-Han,9999,0,9999,0
1653401898872,ECE 200,019,091021,Koushanfar; Farinaz,9999,0,9999,0
1653401898872,ECE 200,020,091022,Kuzum; Duygu,9999,0,9999,0
1653401898872,ECE 200,021,091023,Le; Hanh-Phuc,9999,0,9999,0
1653401898872,ECE 200,022,091024,Lin; Bill,9999,0,9999,0
1653401898872,ECE 200,023,091025,Liu; Zhaowei,9999,0,9999,0
1653401898872,ECE 200,024,091026,Lo; Yu-Hwa,9999,0,9999,0
1653401898872,ECE 200,025,091027,Lomakin; Vitaliy,9999,0,9999,0
1653401898872,ECE 200,026,091028,Mercier; Patrick Philip,9999,0,9999,0
1653401898872,ECE 200,027,091029,Meyer; Florian,9999,0,9999,0
1653401898872,ECE 200,028,091030,Milstein; Laurence B.,9999,0,9999,0
1653401898872,ECE 200,029,091031,Mir Arabbaygi; Siavash,9999,0,9999,0
1653401898872,ECE 200,030,091032,Mookherjea; Shayan,9999,0,9999,0
1653401898872,ECE 200,031,091033,Morris; Karcher William,9999,0,9999,0
1653401898872,ECE 200,032,091034,Ng; Tse Nga,9999,0,9999,0
1653401898872,ECE 200,033,091035,Nguyen; Truong Quang,9999,0,9999,0
1653401898872,ECE 200,034,091036,Nomura; Kenji,9999,0,9999,0
1653401898872,ECE 200,035,091037,Orlitsky; Alon,9999,0,9999,0
1653401898872,ECE 200,036,091038,Pal; Piya,9999,0,9999,0
1653401898872,ECE 200,037,091039,Papen; George C.,9999,0,9999,0
1653401898872,ECE 200,038,091040,Radic; Stojan,9999,0,9999,0
1653401898872,ECE 200,039,091041,Rao; Bhaskar D.,9999,0,9999,0
1653401898872,ECE 200,040,091042,Rao; Ramesh R,9999,0,9999,0
1653401898872,ECE 200,041,091043,Rebeiz; Gabriel,9999,0,9999,0
1653401898872,ECE 200,042,091044,Sanford; John R,9999,0,9999,0
1653401898872,ECE 200,043,091045,Siegel; Paul H.,9999,0,9999,0
1653401898872,ECE 200,044,091046,Sievenpiper; Daniel F.,9999,0,9999,0
1653401898872,ECE 200,045,091047,Sworder; David D.,9999,0,9999,0
1653401898872,ECE 200,046,091048,Taur; Yuan,9999,0,9999,0
1653401898872,ECE 200,047,091049,Touri; Behrouz,9999,0,9999,0
1653401898872,ECE 200,048,091050,Trivedi; Mohan M.,9999,0,9999,0
1653401898872,ECE 200,049,091051,Vardy; Alexander,9999,0,9999,0
1653401898872,ECE 200,050,091052,Vasconcelos; Nuno,9999,0,9999,0
1653401898872,ECE 200,051,091053,Wang; Xiaolong,9999,0,9999,0
1653401898872,ECE 200,052,091054,Xie; Pengtao,9999,0,9999,0
1653401898872,ECE 200,053,091055,Yip; Michael,9999,0,9999,0
1653401898872,ECE 200,054,091056,Zeger; Kenneth A.,9999,0,9999,0
1653401898872,ECE 200,055,091057,Zhang; Xinyu,9999,0,9999,0
1653401898872,ECE 200,056,091058,Turakhia; Yatish Girish,9999,0,9999,0
1653401898872,ECE 200,057,091059,Kang; Mingu,9999,0,9999,0
1653401898872,ECE 200,058,091060,Shi; Yuanyuan,9999,0,9999,0
1653401898872,ECE 200,059,091061,Wang; Edward Jay,9999,0,9999,0
1653401898872,ECE 200,060,091062,Zheng; Yang,9999,0,9999,0
1653401899394,ECE 203,A00,091065,Mercier; Patrick Philip,0,0,0,0
1653401899924,ECE 207A,A00,091605,Liu; Thomas Tao-Ming,0,0,0,0
1653401900446,ECE 212AN,A00,091068,Nomura; Kenji,0,0,0,0
1653401900968,ECE 222A,A00,091069,Rebeiz; Gabriel,0,0,0,0
1653401901493,ECE 225A,A00,091070,Orlitsky; Alon,0,0,0,0
1653401902025,ECE 230A,A00,091071,Nomura; Kenji,0,0,0,0
1653401902546,ECE 236A,A00,091072,Dayeh; Shadi Ahmad,0,0,0,0
1653401903075,ECE 238A,A00,091073,Luo; Jian,0,0,0,0
1653401903075,ECE 238A,B00,091074,Luo; Jian,0,0,0,0
1653401903597,ECE 240A,A00,091075,Radic; Stojan,0,0,0,0
1653401904119,ECE 247A,A00,091592,Shi; Lingyan,0,0,0,0
1653401904641,ECE 250,A00,091076,Touri; Behrouz,0,0,0,0
1653401905164,ECE 251C,A00,091078,Nguyen; Truong Quang,0,0,0,0
1653401905689,ECE 253,A00,091079,Cosman; Pamela C.,0,0,0,0
1653401906215,ECE 255A,A00,091080,Orlitsky; Alon,0,0,0,0
1653401906741,ECE 257A,A00,091081,Zhang; Xinyu,0,0,0,0
1653401907265,ECE 260A,A01,091084,Eldon; John,0,0,0,0
1653401907791,ECE 264C,A00,091085,Galton; Ian A,0,0,0,0
1653401908320,ECE 265C,A00,094889,Presti; Calogero Davide,0,0,0,9
1653401908844,ECE 266,A01,091087,Hall; Drew A.,0,0,0,0
1653401909900,ECE 271A,A00,091090,Vasconcelos; Nuno,0,0,0,0
1653401910429,ECE 272B,A00,091091,Sworder; David D.,0,0,0,0
1653401910951,ECE 275A,A00,091092,Meyer; Florian,0,0,0,0
1653401911474,ECE 277,A00,091093,An; Cheolhong,0,0,0,0
1653401911997,ECE 283,A00,091094,Le; Hanh-Phuc,0,0,0,0
1653401912528,ECE 284,A00,091095,Kang; Mingu,0,0,0,0
1653401912528,ECE 284,B00,091096,Wang; Edward Jay,0,0,0,0
1653401913054,ECE 285,A00,094334,Touri; Behrouz,0,0,0,0
1653401913581,ECE 289,A00,091097,Whelan; David Arthur,0,0,0,0
1653401914109,MATH 200A,A00,087414,Salehi Golsefidy; Alireza,7,0,8,1
1653401914635,MATH 202A,A00,087415,Gill; Philip E.,3,0,8,5
1653401915158,MATH 203A,A00,087416,Oprea; Dragos N.,6,0,8,2
1653401915684,MATH 204A,A00,087417,Kedlaya; Kiran S.,6,0,8,2
1653401916213,MATH 205,A00,087418,Sorensen; Claus M,6,0,8,2
1653401916741,MATH 206A,A00,087419,Izadi; Elham,7,0,8,1
1653401917267,MATH 207A,A00,087420,Mohammadi; Amir,6,0,8,2
1653401917794,MATH 208,A00,087421,Staff,9,0,10,1
1653401918322,MATH 209,A00,087422,Staff,10,0,10,0
1653401918851,MATH 218,A00,087423,Staff,10,0,10,0
1653401919377,MATH 220A,A00,087424,Novak; Jonathan I,7,0,8,1
1653401919900,MATH 231A,A00,087425,Bejenaru; Ioan,4,0,8,4
1653401920423,MATH 240A,A00,087426,Ebenfelt; Peter F,5,0,8,3
1653401920947,MATH 243,A00,087427,Staff,9,0,10,1
1653401921472,MATH 248,A00,087429,Staff,10,0,10,0
1653401922007,MATH 250A,A00,087430,Spolaor; Luca,5,0,8,3
1653401922530,MATH 257A,A00,087431,Spolaor; Luca,7,0,8,1
1653401923056,MATH 258,A00,087432,Staff,9,0,10,1
1653401923589,MATH 264A,A00,087433,Warnke; Lutz Peter,5,0,8,3
1653401924119,MATH 268,A00,087434,Staff,15,0,15,0
1653401924645,MATH 269,A00,087435,Staff,14,0,15,1
1653401925179,MATH 270A,A00,087436,Nie; Jiawang,0,0,8,8
1653401925704,MATH 272A,A00,087437,Tian; Xiaochuan,2,0,8,6
1653401926230,MATH 274,A01,087439,Cheng; Li-Tien,9,0,10,1
1653401926230,MATH 274,A02,087440,Cheng; Li-Tien,10,0,10,0
1653401926753,MATH 278A,A00,087441,Staff,8,0,10,2
1653401927279,MATH 278B,A00,087442,Staff,8,0,10,2
1653401927813,MATH 278C,A00,087443,Staff,8,0,10,2
1653401928336,MATH 280A,A00,087444,Zheng; Tianyi,0,0,8,8
1653401928862,MATH 281A,A00,087445,Bradic; Jelena,0,0,8,8
1653401929392,MATH 282A,A00,087446,Zhang; Danna,0,0,8,8
1653401929916,MATH 283,A00,087447,Tesler; Glenn,0,0,0,13
1653401930441,MATH 286,A00,087448,Kemp; Todd Aahron,6,0,8,2
1653401930966,MATH 287D,A00,087449,Bradic; Jelena,8,0,8,0
1653401931499,MATH 288,A00,087450,Staff,14,0,15,1
1653401931499,MATH 288,B00,087451,Staff,15,0,15,0
1653401931499,MATH 288,C00,087452,Staff,15,0,15,0
1653401932021,MATH 290A,A00,087453,Xu; Zhouli,7,0,8,1
1653401932560,MATH 291A,A00,087454,Xu; Zhouli,7,0,8,1
1653401933087,MATH 292,A00,087455,Staff,10,0,10,0
1653401933613,MATH 295,A00,087456,Staff,50,0,50,0
1653401934138,MATH 297,001,087457,Staff,998,0,999,1
1653402494963,COGS 200,A01,087991,Staff,48,0,50,2
1653402495488,COGS 201,A01,094504,Rangel; Lara M,17,0,25,8
1653402496014,COGS 203,A00,087992,Coulson; Seana M,19,0,20,1
1653402496539,COGS 210A,001,087993,Greene; Deanna Jacquelyn,9998,0,9999,1
1653402496539,COGS 210A,002,087994,Saygin; Ayse P,9999,0,9999,0
1653402496539,COGS 210A,003,087995,Xia; Haijun,9999,0,9999,0
1653402496539,COGS 210A,004,087996,Nitz; Douglas A.,9999,0,9999,0
1653402496539,COGS 210A,005,087997,Hollan; James D.,9999,0,9999,0
1653402496539,COGS 210A,006,087998,Deak; Gedeon O.,9998,0,9999,1
1653402496539,COGS 210A,007,087999,Rossano; Federico,9999,0,9999,0
1653402497070,COGS 211A,A00,088000,Coulson; Seana M,9997,0,9999,2
1653402497596,COGS 229,A00,088002,Staff,23,0,25,2
1653402498121,COGS 260,B00,094231,Staff,17,0,20,3
1653402498121,COGS 260,A00,088004,Nitz; Douglas A.,9998,0,9999,1
1653402498650,CSE 202,A00,090110,Paturi; Ramamohan,0,0,0,0
1653402498650,CSE 202,B00,090111,Paturi; Ramamohan,0,0,0,0
1653402499178,CSE 207B,A00,090112,Heninger; Nadia A,0,0,0,0
1653402499704,CSE 208,A00,094858,Micciancio; Daniele,0,0,0,0
1653402500230,CSE 210,A00,090113,Powell; Thomas Allan,0,0,0,0
1653402500752,CSE 219,A00,090898,Staff,0,0,0,0
1653402501278,CSE 221,A00,090114,Zhou; Yuan-Yuan,0,0,0,0
1653402501806,CSE 229A,A00,090115,Porter; George M,0,0,0,0
1653402502329,CSE 229C,A00,090116,Savage; Stefan,0,0,0,0
1653402502860,CSE 230,A00,090117,Jhala; Ranjit,0,0,0,0
1653402503388,CSE 232,A00,090118,Papakonstantinou; Yannis,0,0,0,0
1653402503910,CSE 239A,A00,090121,Kumar; Arun Kumar,0,0,0,0
1653402504436,CSE 239B,A00,090122,Jhala; Ranjit,0,0,0,0
1653402504962,CSE 240A,A00,090123,Zhao; Jishen,0,0,189,189
1653402505486,CSE 243A,A00,090124,Orailoglu; Alex,3,0,15,12
1653402506009,CSE 249B,A00,090125,Kahng; Andrew Byun,14,0,20,6
1653402506538,CSE 250A,A00,090126,Berg-Kirkpatrick; Taylor D,0,0,0,0
1653402507059,CSE 252A,A00,090127,Ochoa; Benjamin Lawrence,0,0,0,0
1653402507594,CSE 258,A01,090129,McAuley; Julian John,0,0,0,0
1653402508121,CSE 258R,A01,090131,McAuley; Julian John,0,0,0,0
1653402508647,CSE 274,A00,090132,Ramamoorthi; Ravi,0,0,0,0
1653402509170,CSE 276A,A00,090133,Christensen; Henrik I,0,0,0,0
1653402509705,CSE 276C,A00,090134,Christensen; Henrik I,0,0,0,0
1653402510240,CSE 290,A00,090135,Bafna; Vineet,0,0,0,0
1653402510240,CSE 290,B00,090136,Ramamoorthi; Ravi,0,0,0,0
1653402510240,CSE 290,C00,090137,Li; Tzumao,10,0,10,0
1653402510240,CSE 290,D00,090138,Zhou; Yuan-Yuan,10,0,10,0
1653402510240,CSE 290,E00,090139,Christensen; Henrik I,10,0,10,0
1653402510240,CSE 290,F00,094053,Shalev; Aaron D,0,0,0,0
1653402510771,CSE 291,A00,090140,Munyaka; Imani N. S.,0,0,0,0
1653402510771,CSE 291,B00,094880,Yu; Qi,0,0,0,0
1653402510771,CSE 291,C00,090142,Pannuto; Patrick William,0,0,0,0
1653402510771,CSE 291,D00,094881,Zhang; Yiying,0,0,0,0
1653402510771,CSE 291,E00,095118,Su; Hao,0,0,0,0
1653402511302,CSE 293,001,094905,Bafna; Vineet,9999,0,9999,0
1653402511302,CSE 293,002,094906,Bellare; Mihir,9999,0,9999,0
1653402511302,CSE 293,003,094907,Berg-Kirkpatrick; Taylor D,9999,0,9999,0
1653402511302,CSE 293,004,094908,Christensen; Henrik I,9999,0,9999,0
1653402511302,CSE 293,005,094909,Cottrell; Garrison W,9999,0,9999,0
1653402511302,CSE 293,006,094910,Deutsch; Alin Bernard,9999,0,9999,0
1653402511302,CSE 293,007,094911,Esmaeilzadeh; Hadi,9999,0,9999,0
1653402511302,CSE 293,008,094912,Freund; Yoav,9999,0,9999,0
1653402511302,CSE 293,009,094913,Griswold; William G.,9999,0,9999,0
1653402511302,CSE 293,010,094914,Gymrek; Melissa Ann,9999,0,9999,0
1653402511302,CSE 293,011,094915,Heninger; Nadia A,9999,0,9999,0
1653402511302,CSE 293,012,094916,Impagliazzo; Russell,9999,0,9999,0
1653402511302,CSE 293,013,094917,Jhala; Ranjit,9999,0,9999,0
1653402511302,CSE 293,014,094918,Kahng; Andrew Byun,9999,0,9999,0
1653402511302,CSE 293,015,094919,Kane; Daniel Mertz,9999,0,9999,0
1653402511302,CSE 293,016,094920,Kriegman; David J,9999,0,9999,0
1653402511302,CSE 293,017,094921,Kumar; Arun Kumar,9999,0,9999,0
1653402511302,CSE 293,018,094922,Lerner; Sorin,9999,0,9999,0
1653402511302,CSE 293,019,094923,Lovett; Shachar,9999,0,9999,0
1653402511302,CSE 293,020,094924,McAuley; Julian John,9999,0,9999,0
1653402511302,CSE 293,021,094925,Micciancio; Daniele,9999,0,9999,0
1653402511302,CSE 293,022,094926,Orailoglu; Alex,9999,0,9999,0
1653402511302,CSE 293,023,094927,Paturi; Ramamohan,9999,0,9999,0
1653402511302,CSE 293,024,094928,Polikarpova; Nadezhda,9999,0,9999,0
1653402511302,CSE 293,025,094929,Politz; Joseph Gibbs,9999,0,9999,0
1653402511302,CSE 293,026,094930,Porter; George M,9999,0,9999,0
1653402511302,CSE 293,027,094931,Porter; Leonard Emerson,9999,0,9999,0
1653402511302,CSE 293,028,094932,Ramamoorthi; Ravi,9999,0,9999,0
1653402511302,CSE 293,029,094933,Sahoo; Debashis,9999,0,9999,0
1653402511302,CSE 293,030,094934,Saul; Lawrence,9999,0,9999,0
1653402511302,CSE 293,031,094935,Savage; Stefan,9999,0,9999,0
1653402511302,CSE 293,032,094936,Schulze; Jurgen P.,9999,0,9999,0
1653402511302,CSE 293,033,094937,Snoeren; Alex C.,9999,0,9999,0
1653402511302,CSE 293,034,094938,Shang; Jingbo,9999,0,9999,0
1653402511302,CSE 293,035,094939,Stefan; Deian,9999,0,9999,0
1653402511302,CSE 293,036,094940,Su; Hao,9999,0,9999,0
1653402511302,CSE 293,037,094941,Swanson; Steven James,9999,0,9999,0
1653402511302,CSE 293,038,094942,Tullsen; Dean Michael,9999,0,9999,0
1653402511302,CSE 293,039,094943,Voelker; Geoffrey M.,9999,0,9999,0
1653402511302,CSE 293,040,094944,Zhao; Jishen,9999,0,9999,0
1653402511302,CSE 293,041,094945,Zhou; Yuan-Yuan,9999,0,9999,0
1653402511302,CSE 293,042,094946,Gao; Sicun,9998,0,9999,1
1653402511302,CSE 293,043,094947,Weibel; Nadir,9999,0,9999,0
1653402511302,CSE 293,044,094948,Gupta; Rajesh K.,9999,0,9999,0
1653402511825,CSE 294,A00,090143,Porter; George M,9,0,10,1
1653402512351,DSE 200,A00,091799,Staff,50,0,50,0
1653402512881,DSE 203,A00,091800,Gupta; Amarnath,30,0,30,0
1653402513411,DSE 250,A00,091801,Deutsch; Alin Bernard,30,0,30,0
1653402513937,DSE 290,A00,091802,Altintas De Callaf; Ilkay,50,0,50,0
1653402514473,ECE 200,001,091003,Antipa; Nicholas A,9999,0,9999,0
1653402514473,ECE 200,002,091004,Atanasov; Nikolay A.,9999,0,9999,0
1653402514473,ECE 200,003,091005,Bharadia; Dinesh,9999,0,9999,0
1653402514473,ECE 200,004,091006,Cheng; Chung Kuan,9999,0,9999,0
1653402514473,ECE 200,005,091007,Cosman; Pamela C.,9999,0,9999,0
1653402514473,ECE 200,006,091008,Staff,9999,0,9999,0
1653402514473,ECE 200,007,091009,Dayeh; Shadi Ahmad,9999,0,9999,0
1653402514473,ECE 200,008,091010,Fainman; Yeshaiahu,9999,0,9999,0
1653402514473,ECE 200,009,091011,Ford; Joseph Earl,9999,0,9999,0
1653402514473,ECE 200,010,091012,Franceschetti; Massimo,9999,0,9999,0
1653402514473,ECE 200,011,091013,Fullerton; Eric E,9999,0,9999,0
1653402514473,ECE 200,012,091014,Galton; Ian A,9999,0,9999,0
1653402514473,ECE 200,013,091015,Gilja; Vikash,9999,0,9999,0
1653402514473,ECE 200,014,091016,Hall; Drew A.,9999,0,9999,0
1653402514473,ECE 200,015,091017,Hsueh; Tzu-Chien,9999,0,9999,0
1653402514473,ECE 200,016,091018,Javidi; Tara,9999,0,9999,0
1653402514473,ECE 200,017,091019,Kahng; Andrew Byun,9999,0,9999,0
1653402514473,ECE 200,018,091020,Kim; Young-Han,9999,0,9999,0
1653402514473,ECE 200,019,091021,Koushanfar; Farinaz,9999,0,9999,0
1653402514473,ECE 200,020,091022,Kuzum; Duygu,9999,0,9999,0
1653402514473,ECE 200,021,091023,Le; Hanh-Phuc,9999,0,9999,0
1653402514473,ECE 200,022,091024,Lin; Bill,9999,0,9999,0
1653402514473,ECE 200,023,091025,Liu; Zhaowei,9999,0,9999,0
1653402514473,ECE 200,024,091026,Lo; Yu-Hwa,9999,0,9999,0
1653402514473,ECE 200,025,091027,Lomakin; Vitaliy,9999,0,9999,0
1653402514473,ECE 200,026,091028,Mercier; Patrick Philip,9999,0,9999,0
1653402514473,ECE 200,027,091029,Meyer; Florian,9999,0,9999,0
1653402514473,ECE 200,028,091030,Milstein; Laurence B.,9999,0,9999,0
1653402514473,ECE 200,029,091031,Mir Arabbaygi; Siavash,9999,0,9999,0
1653402514473,ECE 200,030,091032,Mookherjea; Shayan,9999,0,9999,0
1653402514473,ECE 200,031,091033,Morris; Karcher William,9999,0,9999,0
1653402514473,ECE 200,032,091034,Ng; Tse Nga,9999,0,9999,0
1653402514473,ECE 200,033,091035,Nguyen; Truong Quang,9999,0,9999,0
1653402514473,ECE 200,034,091036,Nomura; Kenji,9999,0,9999,0
1653402514473,ECE 200,035,091037,Orlitsky; Alon,9999,0,9999,0
1653402514473,ECE 200,036,091038,Pal; Piya,9999,0,9999,0
1653402514473,ECE 200,037,091039,Papen; George C.,9999,0,9999,0
1653402514473,ECE 200,038,091040,Radic; Stojan,9999,0,9999,0
1653402514473,ECE 200,039,091041,Rao; Bhaskar D.,9999,0,9999,0
1653402514473,ECE 200,040,091042,Rao; Ramesh R,9999,0,9999,0
1653402514473,ECE 200,041,091043,Rebeiz; Gabriel,9999,0,9999,0
1653402514473,ECE 200,042,091044,Sanford; John R,9999,0,9999,0
1653402514473,ECE 200,043,091045,Siegel; Paul H.,9999,0,9999,0
1653402514473,ECE 200,044,091046,Sievenpiper; Daniel F.,9999,0,9999,0
1653402514473,ECE 200,045,091047,Sworder; David D.,9999,0,9999,0
1653402514473,ECE 200,046,091048,Taur; Yuan,9999,0,9999,0
1653402514473,ECE 200,047,091049,Touri; Behrouz,9999,0,9999,0
1653402514473,ECE 200,048,091050,Trivedi; Mohan M.,9999,0,9999,0
1653402514473,ECE 200,049,091051,Vardy; Alexander,9999,0,9999,0
1653402514473,ECE 200,050,091052,Vasconcelos; Nuno,9999,0,9999,0
1653402514473,ECE 200,051,091053,Wang; Xiaolong,9999,0,9999,0
1653402514473,ECE 200,052,091054,Xie; Pengtao,9999,0,9999,0
1653402514473,ECE 200,053,091055,Yip; Michael,9999,0,9999,0
1653402514473,ECE 200,054,091056,Zeger; Kenneth A.,9999,0,9999,0
1653402514473,ECE 200,055,091057,Zhang; Xinyu,9999,0,9999,0
1653402514473,ECE 200,056,091058,Turakhia; Yatish Girish,9999,0,9999,0
1653402514473,ECE 200,057,091059,Kang; Mingu,9999,0,9999,0
1653402514473,ECE 200,058,091060,Shi; Yuanyuan,9999,0,9999,0
1653402514473,ECE 200,059,091061,Wang; Edward Jay,9999,0,9999,0
1653402514473,ECE 200,060,091062,Zheng; Yang,9999,0,9999,0
1653402514999,ECE 203,A00,091065,Mercier; Patrick Philip,0,0,0,0
1653402515528,ECE 207A,A00,091605,Liu; Thomas Tao-Ming,0,0,0,0
1653402516051,ECE 212AN,A00,091068,Nomura; Kenji,0,0,0,0
1653402516574,ECE 222A,A00,091069,Rebeiz; Gabriel,0,0,0,0
1653402517111,ECE 225A,A00,091070,Orlitsky; Alon,0,0,0,0
1653402517634,ECE 230A,A00,091071,Nomura; Kenji,0,0,0,0
1653402518155,ECE 236A,A00,091072,Dayeh; Shadi Ahmad,0,0,0,0
1653402518679,ECE 238A,A00,091073,Luo; Jian,0,0,0,0
1653402518679,ECE 238A,B00,091074,Luo; Jian,0,0,0,0
1653402519205,ECE 240A,A00,091075,Radic; Stojan,0,0,0,0
1653402519732,ECE 247A,A00,091592,Shi; Lingyan,0,0,0,0
1653402520258,ECE 250,A00,091076,Touri; Behrouz,0,0,0,0
1653402520783,ECE 251C,A00,091078,Nguyen; Truong Quang,0,0,0,0
1653402521305,ECE 253,A00,091079,Cosman; Pamela C.,0,0,0,0
1653402521828,ECE 255A,A00,091080,Orlitsky; Alon,0,0,0,0
1653402522357,ECE 257A,A00,091081,Zhang; Xinyu,0,0,0,0
1653402522885,ECE 260A,A01,091084,Eldon; John,0,0,0,0
1653402523423,ECE 264C,A00,091085,Galton; Ian A,0,0,0,0
1653402523946,ECE 265C,A00,094889,Presti; Calogero Davide,0,0,0,9
1653402524470,ECE 266,A01,091087,Hall; Drew A.,0,0,0,0
1653402525521,ECE 271A,A00,091090,Vasconcelos; Nuno,0,0,0,0
1653402526051,ECE 272B,A00,091091,Sworder; David D.,0,0,0,0
1653402526575,ECE 275A,A00,091092,Meyer; Florian,0,0,0,0
1653402527103,ECE 277,A00,091093,An; Cheolhong,0,0,0,0
1653402527631,ECE 283,A00,091094,Le; Hanh-Phuc,0,0,0,0
1653402528157,ECE 284,A00,091095,Kang; Mingu,0,0,0,0
1653402528157,ECE 284,B00,091096,Wang; Edward Jay,0,0,0,0
1653402528692,ECE 285,A00,094334,Touri; Behrouz,0,0,0,0
1653402529219,ECE 289,A00,091097,Whelan; David Arthur,0,0,0,0
1653402529746,MATH 200A,A00,087414,Salehi Golsefidy; Alireza,7,0,8,1
1653402530283,MATH 202A,A00,087415,Gill; Philip E.,3,0,8,5
1653402530811,MATH 203A,A00,087416,Oprea; Dragos N.,6,0,8,2
1653402531332,MATH 204A,A00,087417,Kedlaya; Kiran S.,6,0,8,2
1653402531859,MATH 205,A00,087418,Sorensen; Claus M,6,0,8,2
1653402532387,MATH 206A,A00,087419,Izadi; Elham,7,0,8,1
1653402532915,MATH 207A,A00,087420,Mohammadi; Amir,6,0,8,2
1653402533438,MATH 208,A00,087421,Staff,9,0,10,1
1653402533962,MATH 209,A00,087422,Staff,10,0,10,0
1653402534559,MATH 218,A00,087423,Staff,10,0,10,0
1653402535087,MATH 220A,A00,087424,Novak; Jonathan I,7,0,8,1
1653402535611,MATH 231A,A00,087425,Bejenaru; Ioan,4,0,8,4
1653402536135,MATH 240A,A00,087426,Ebenfelt; Peter F,5,0,8,3
1653402536660,MATH 243,A00,087427,Staff,9,0,10,1
1653402537186,MATH 248,A00,087429,Staff,10,0,10,0
1653402537722,MATH 250A,A00,087430,Spolaor; Luca,5,0,8,3
1653402538247,MATH 257A,A00,087431,Spolaor; Luca,7,0,8,1
1653402538770,MATH 258,A00,087432,Staff,9,0,10,1
1653402539300,MATH 264A,A00,087433,Warnke; Lutz Peter,5,0,8,3
1653402539836,MATH 268,A00,087434,Staff,15,0,15,0
1653402540358,MATH 269,A00,087435,Staff,14,0,15,1
1653402540883,MATH 270A,A00,087436,Nie; Jiawang,0,0,8,8
1653402541410,MATH 272A,A00,087437,Tian; Xiaochuan,2,0,8,6
1653402541934,MATH 274,A01,087439,Cheng; Li-Tien,9,0,10,1
1653402541934,MATH 274,A02,087440,Cheng; Li-Tien,10,0,10,0
1653402542454,MATH 278A,A00,087441,Staff,8,0,10,2
1653402542979,MATH 278B,A00,087442,Staff,8,0,10,2
1653402543504,MATH 278C,A00,087443,Staff,8,0,10,2
1653402544027,MATH 280A,A00,087444,Zheng; Tianyi,0,0,8,8
1653402544553,MATH 281A,A00,087445,Bradic; Jelena,0,0,8,8
1653402545076,MATH 282A,A00,087446,Zhang; Danna,0,0,8,8
1653402545604,MATH 283,A00,087447,Tesler; Glenn,0,0,0,13
1653402546129,MATH 286,A00,087448,Kemp; Todd Aahron,6,0,8,2
1653402546656,MATH 287D,A00,087449,Bradic; Jelena,8,0,8,0
1653402547180,MATH 288,A00,087450,Staff,14,0,15,1
1653402547180,MATH 288,B00,087451,Staff,15,0,15,0
1653402547180,MATH 288,C00,087452,Staff,15,0,15,0
1653402547709,MATH 290A,A00,087453,Xu; Zhouli,7,0,8,1
1653402548231,MATH 291A,A00,087454,Xu; Zhouli,7,0,8,1
1653402548754,MATH 292,A00,087455,Staff,10,0,10,0
1653402549276,MATH 295,A00,087456,Staff,50,0,50,0
1653402549798,MATH 297,001,087457,Staff,998,0,999,1
1653403112657,COGS 200,A01,087991,Staff,48,0,50,2
1653403113181,COGS 201,A01,094504,Rangel; Lara M,17,0,25,8
1653403113707,COGS 203,A00,087992,Coulson; Seana M,19,0,20,1
1653403114232,COGS 210A,001,087993,Greene; Deanna Jacquelyn,9998,0,9999,1
1653403114232,COGS 210A,002,087994,Saygin; Ayse P,9999,0,9999,0
1653403114232,COGS 210A,003,087995,Xia; Haijun,9999,0,9999,0
1653403114232,COGS 210A,004,087996,Nitz; Douglas A.,9999,0,9999,0
1653403114232,COGS 210A,005,087997,Hollan; James D.,9999,0,9999,0
1653403114232,COGS 210A,006,087998,Deak; Gedeon O.,9998,0,9999,1
1653403114232,COGS 210A,007,087999,Rossano; Federico,9999,0,9999,0
1653403114767,COGS 211A,A00,088000,Coulson; Seana M,9997,0,9999,2
1653403115309,COGS 229,A00,088002,Staff,23,0,25,2
1653403115835,COGS 260,B00,094231,Staff,17,0,20,3
1653403115835,COGS 260,A00,088004,Nitz; Douglas A.,9998,0,9999,1
1653403116359,CSE 202,A00,090110,Paturi; Ramamohan,0,0,0,0
1653403116359,CSE 202,B00,090111,Paturi; Ramamohan,0,0,0,0
1653403116889,CSE 207B,A00,090112,Heninger; Nadia A,0,0,0,0
1653403117411,CSE 208,A00,094858,Micciancio; Daniele,0,0,0,0
1653403117936,CSE 210,A00,090113,Powell; Thomas Allan,0,0,0,0
1653403118463,CSE 219,A00,090898,Staff,0,0,0,0
1653403119076,CSE 221,A00,090114,Zhou; Yuan-Yuan,0,0,0,0
1653403119599,CSE 229A,A00,090115,Porter; George M,0,0,0,0
1653403120122,CSE 229C,A00,090116,Savage; Stefan,0,0,0,0
1653403120644,CSE 230,A00,090117,Jhala; Ranjit,0,0,0,0
1653403121165,CSE 232,A00,090118,Papakonstantinou; Yannis,0,0,0,0
1653403121695,CSE 239A,A00,090121,Kumar; Arun Kumar,0,0,0,0
1653403122217,CSE 239B,A00,090122,Jhala; Ranjit,0,0,0,0
1653403122739,CSE 240A,A00,090123,Zhao; Jishen,0,0,189,189
1653403123265,CSE 243A,A00,090124,Orailoglu; Alex,3,0,15,12
1653403123789,CSE 249B,A00,090125,Kahng; Andrew Byun,14,0,20,6
1653403124311,CSE 250A,A00,090126,Berg-Kirkpatrick; Taylor D,0,0,0,0
1653403124915,CSE 252A,A00,090127,Ochoa; Benjamin Lawrence,0,0,0,0
1653403125440,CSE 258,A01,090129,McAuley; Julian John,0,0,0,0
1653403125961,CSE 258R,A01,090131,McAuley; Julian John,0,0,0,0
1653403126484,CSE 274,A00,090132,Ramamoorthi; Ravi,0,0,0,0
1653403127009,CSE 276A,A00,090133,Christensen; Henrik I,0,0,0,0
1653403127532,CSE 276C,A00,090134,Christensen; Henrik I,0,0,0,0
1653403128054,CSE 290,A00,090135,Bafna; Vineet,0,0,0,0
1653403128054,CSE 290,B00,090136,Ramamoorthi; Ravi,0,0,0,0
1653403128054,CSE 290,C00,090137,Li; Tzumao,10,0,10,0
1653403128054,CSE 290,D00,090138,Zhou; Yuan-Yuan,10,0,10,0
1653403128054,CSE 290,E00,090139,Christensen; Henrik I,10,0,10,0
1653403128054,CSE 290,F00,094053,Shalev; Aaron D,0,0,0,0
1653403128577,CSE 291,A00,090140,Munyaka; Imani N. S.,0,0,0,0
1653403128577,CSE 291,B00,094880,Yu; Qi,0,0,0,0
1653403128577,CSE 291,C00,090142,Pannuto; Patrick William,0,0,0,0
1653403128577,CSE 291,D00,094881,Zhang; Yiying,0,0,0,0
1653403128577,CSE 291,E00,095118,Su; Hao,0,0,0,0
1653403129103,CSE 293,001,094905,Bafna; Vineet,9999,0,9999,0
1653403129103,CSE 293,002,094906,Bellare; Mihir,9999,0,9999,0
1653403129103,CSE 293,003,094907,Berg-Kirkpatrick; Taylor D,9999,0,9999,0
1653403129103,CSE 293,004,094908,Christensen; Henrik I,9999,0,9999,0
1653403129103,CSE 293,005,094909,Cottrell; Garrison W,9999,0,9999,0
1653403129103,CSE 293,006,094910,Deutsch; Alin Bernard,9999,0,9999,0
1653403129103,CSE 293,007,094911,Esmaeilzadeh; Hadi,9999,0,9999,0
1653403129103,CSE 293,008,094912,Freund; Yoav,9999,0,9999,0
1653403129103,CSE 293,009,094913,Griswold; William G.,9999,0,9999,0
1653403129103,CSE 293,010,094914,Gymrek; Melissa Ann,9999,0,9999,0
1653403129103,CSE 293,011,094915,Heninger; Nadia A,9999,0,9999,0
1653403129103,CSE 293,012,094916,Impagliazzo; Russell,9999,0,9999,0
1653403129103,CSE 293,013,094917,Jhala; Ranjit,9999,0,9999,0
1653403129103,CSE 293,014,094918,Kahng; Andrew Byun,9999,0,9999,0
1653403129103,CSE 293,015,094919,Kane; Daniel Mertz,9999,0,9999,0
1653403129103,CSE 293,016,094920,Kriegman; David J,9999,0,9999,0
1653403129103,CSE 293,017,094921,Kumar; Arun Kumar,9999,0,9999,0
1653403129103,CSE 293,018,094922,Lerner; Sorin,9999,0,9999,0
1653403129103,CSE 293,019,094923,Lovett; Shachar,9999,0,9999,0
1653403129103,CSE 293,020,094924,McAuley; Julian John,9999,0,9999,0
1653403129103,CSE 293,021,094925,Micciancio; Daniele,9999,0,9999,0
1653403129103,CSE 293,022,094926,Orailoglu; Alex,9999,0,9999,0
1653403129103,CSE 293,023,094927,Paturi; Ramamohan,9999,0,9999,0
1653403129103,CSE 293,024,094928,Polikarpova; Nadezhda,9999,0,9999,0
1653403129103,CSE 293,025,094929,Politz; Joseph Gibbs,9999,0,9999,0
1653403129103,CSE 293,026,094930,Porter; George M,9999,0,9999,0
1653403129103,CSE 293,027,094931,Porter; Leonard Emerson,9999,0,9999,0
1653403129103,CSE 293,028,094932,Ramamoorthi; Ravi,9999,0,9999,0
1653403129103,CSE 293,029,094933,Sahoo; Debashis,9999,0,9999,0
1653403129103,CSE 293,030,094934,Saul; Lawrence,9999,0,9999,0
1653403129103,CSE 293,031,094935,Savage; Stefan,9999,0,9999,0
1653403129103,CSE 293,032,094936,Schulze; Jurgen P.,9999,0,9999,0
1653403129103,CSE 293,033,094937,Snoeren; Alex C.,9999,0,9999,0
1653403129103,CSE 293,034,094938,Shang; Jingbo,9999,0,9999,0
1653403129103,CSE 293,035,094939,Stefan; Deian,9999,0,9999,0
1653403129103,CSE 293,036,094940,Su; Hao,9999,0,9999,0
1653403129103,CSE 293,037,094941,Swanson; Steven James,9999,0,9999,0
1653403129103,CSE 293,038,094942,Tullsen; Dean Michael,9999,0,9999,0
1653403129103,CSE 293,039,094943,Voelker; Geoffrey M.,9999,0,9999,0
1653403129103,CSE 293,040,094944,Zhao; Jishen,9999,0,9999,0
1653403129103,CSE 293,041,094945,Zhou; Yuan-Yuan,9999,0,9999,0
1653403129103,CSE 293,042,094946,Gao; Sicun,9998,0,9999,1
1653403129103,CSE 293,043,094947,Weibel; Nadir,9999,0,9999,0
1653403129103,CSE 293,044,094948,Gupta; Rajesh K.,9999,0,9999,0
1653403129623,CSE 294,A00,090143,Porter; George M,9,0,10,1
1653403130146,DSE 200,A00,091799,Staff,50,0,50,0
1653403130686,DSE 203,A00,091800,Gupta; Amarnath,30,0,30,0
1653403131211,DSE 250,A00,091801,Deutsch; Alin Bernard,30,0,30,0
1653403131743,DSE 290,A00,091802,Altintas De Callaf; Ilkay,50,0,50,0
1653403132270,ECE 200,001,091003,Antipa; Nicholas A,9999,0,9999,0
1653403132270,ECE 200,002,091004,Atanasov; Nikolay A.,9999,0,9999,0
1653403132270,ECE 200,003,091005,Bharadia; Dinesh,9999,0,9999,0
1653403132270,ECE 200,004,091006,Cheng; Chung Kuan,9999,0,9999,0
1653403132270,ECE 200,005,091007,Cosman; Pamela C.,9999,0,9999,0
1653403132270,ECE 200,006,091008,Staff,9999,0,9999,0
1653403132270,ECE 200,007,091009,Dayeh; Shadi Ahmad,9999,0,9999,0
1653403132270,ECE 200,008,091010,Fainman; Yeshaiahu,9999,0,9999,0
1653403132270,ECE 200,009,091011,Ford; Joseph Earl,9999,0,9999,0
1653403132270,ECE 200,010,091012,Franceschetti; Massimo,9999,0,9999,0
1653403132270,ECE 200,011,091013,Fullerton; Eric E,9999,0,9999,0
1653403132270,ECE 200,012,091014,Galton; Ian A,9999,0,9999,0
1653403132270,ECE 200,013,091015,Gilja; Vikash,9999,0,9999,0
1653403132270,ECE 200,014,091016,Hall; Drew A.,9999,0,9999,0
1653403132270,ECE 200,015,091017,Hsueh; Tzu-Chien,9999,0,9999,0
1653403132270,ECE 200,016,091018,Javidi; Tara,9999,0,9999,0
1653403132270,ECE 200,017,091019,Kahng; Andrew Byun,9999,0,9999,0
1653403132270,ECE 200,018,091020,Kim; Young-Han,9999,0,9999,0
1653403132270,ECE 200,019,091021,Koushanfar; Farinaz,9999,0,9999,0
1653403132270,ECE 200,020,091022,Kuzum; Duygu,9999,0,9999,0
1653403132270,ECE 200,021,091023,Le; Hanh-Phuc,9999,0,9999,0
1653403132270,ECE 200,022,091024,Lin; Bill,9999,0,9999,0
1653403132270,ECE 200,023,091025,Liu; Zhaowei,9999,0,9999,0
1653403132270,ECE 200,024,091026,Lo; Yu-Hwa,9999,0,9999,0
1653403132270,ECE 200,025,091027,Lomakin; Vitaliy,9999,0,9999,0
1653403132270,ECE 200,026,091028,Mercier; Patrick Philip,9999,0,9999,0
1653403132270,ECE 200,027,091029,Meyer; Florian,9999,0,9999,0
1653403132270,ECE 200,028,091030,Milstein; Laurence B.,9999,0,9999,0
1653403132270,ECE 200,029,091031,Mir Arabbaygi; Siavash,9999,0,9999,0
1653403132270,ECE 200,030,091032,Mookherjea; Shayan,9999,0,9999,0
1653403132270,ECE 200,031,091033,Morris; Karcher William,9999,0,9999,0
1653403132270,ECE 200,032,091034,Ng; Tse Nga,9999,0,9999,0
1653403132270,ECE 200,033,091035,Nguyen; Truong Quang,9999,0,9999,0
1653403132270,ECE 200,034,091036,Nomura; Kenji,9999,0,9999,0
1653403132270,ECE 200,035,091037,Orlitsky; Alon,9999,0,9999,0
1653403132270,ECE 200,036,091038,Pal; Piya,9999,0,9999,0
1653403132270,ECE 200,037,091039,Papen; George C.,9999,0,9999,0
1653403132270,ECE 200,038,091040,Radic; Stojan,9999,0,9999,0
1653403132270,ECE 200,039,091041,Rao; Bhaskar D.,9999,0,9999,0
1653403132270,ECE 200,040,091042,Rao; Ramesh R,9999,0,9999,0
1653403132270,ECE 200,041,091043,Rebeiz; Gabriel,9999,0,9999,0
1653403132270,ECE 200,042,091044,Sanford; John R,9999,0,9999,0
1653403132270,ECE 200,043,091045,Siegel; Paul H.,9999,0,9999,0
1653403132270,ECE 200,044,091046,Sievenpiper; Daniel F.,9999,0,9999,0
1653403132270,ECE 200,045,091047,Sworder; David D.,9999,0,9999,0
1653403132270,ECE 200,046,091048,Taur; Yuan,9999,0,9999,0
1653403132270,ECE 200,047,091049,Touri; Behrouz,9999,0,9999,0
1653403132270,ECE 200,048,091050,Trivedi; Mohan M.,9999,0,9999,0
1653403132270,ECE 200,049,091051,Vardy; Alexander,9999,0,9999,0
1653403132270,ECE 200,050,091052,Vasconcelos; Nuno,9999,0,9999,0
1653403132270,ECE 200,051,091053,Wang; Xiaolong,9999,0,9999,0
1653403132270,ECE 200,052,091054,Xie; Pengtao,9999,0,9999,0
1653403132270,ECE 200,053,091055,Yip; Michael,9999,0,9999,0
1653403132270,ECE 200,054,091056,Zeger; Kenneth A.,9999,0,9999,0
1653403132270,ECE 200,055,091057,Zhang; Xinyu,9999,0,9999,0
1653403132270,ECE 200,056,091058,Turakhia; Yatish Girish,9999,0,9999,0
1653403132270,ECE 200,057,091059,Kang; Mingu,9999,0,9999,0
1653403132270,ECE 200,058,091060,Shi; Yuanyuan,9999,0,9999,0
1653403132270,ECE 200,059,091061,Wang; Edward Jay,9999,0,9999,0
1653403132270,ECE 200,060,091062,Zheng; Yang,9999,0,9999,0
1653403132792,ECE 203,A00,091065,Mercier; Patrick Philip,0,0,0,0
1653403133317,ECE 207A,A00,091605,Liu; Thomas Tao-Ming,0,0,0,0
1653403133839,ECE 212AN,A00,091068,Nomura; Kenji,0,0,0,0
1653403134366,ECE 222A,A00,091069,Rebeiz; Gabriel,0,0,0,0
1653403134900,ECE 225A,A00,091070,Orlitsky; Alon,0,0,0,0
1653403135437,ECE 230A,A00,091071,Nomura; Kenji,0,0,0,0
1653403135961,ECE 236A,A00,091072,Dayeh; Shadi Ahmad,0,0,0,0
1653403136484,ECE 238A,A00,091073,Luo; Jian,0,0,0,0
1653403136484,ECE 238A,B00,091074,Luo; Jian,0,0,0,0
1653403137014,ECE 240A,A00,091075,Radic; Stojan,0,0,0,0
1653403137536,ECE 247A,A00,091592,Shi; Lingyan,0,0,0,0
1653403138062,ECE 250,A00,091076,Touri; Behrouz,0,0,0,0
1653403138584,ECE 251C,A00,091078,Nguyen; Truong Quang,0,0,0,0
1653403139106,ECE 253,A00,091079,Cosman; Pamela C.,0,0,0,0
1653403139628,ECE 255A,A00,091080,Orlitsky; Alon,0,0,0,0
1653403140150,ECE 257A,A00,091081,Zhang; Xinyu,0,0,0,0
1653403140673,ECE 260A,A01,091084,Eldon; John,0,0,0,0
1653403141198,ECE 264C,A00,091085,Galton; Ian A,0,0,0,0
1653403141719,ECE 265C,A00,094889,Presti; Calogero Davide,0,0,0,9
1653403142252,ECE 266,A01,091087,Hall; Drew A.,0,0,0,0
1653403143301,ECE 271A,A00,091090,Vasconcelos; Nuno,0,0,0,0
1653403143834,ECE 272B,A00,091091,Sworder; David D.,0,0,0,0
1653403144360,ECE 275A,A00,091092,Meyer; Florian,0,0,0,0
1653403144883,ECE 277,A00,091093,An; Cheolhong,0,0,0,0
1653403145410,ECE 283,A00,091094,Le; Hanh-Phuc,0,0,0,0
1653403145938,ECE 284,A00,091095,Kang; Mingu,0,0,0,0
1653403145938,ECE 284,B00,091096,Wang; Edward Jay,0,0,0,0
1653403146463,ECE 285,A00,094334,Touri; Behrouz,0,0,0,0
1653403146990,ECE 289,A00,091097,Whelan; David Arthur,0,0,0,0
1653403147513,MATH 200A,A00,087414,Salehi Golsefidy; Alireza,7,0,8,1
1653403148044,MATH 202A,A00,087415,Gill; Philip E.,3,0,8,5
1653403148575,MATH 203A,A00,087416,Oprea; Dragos N.,6,0,8,2
1653403149097,MATH 204A,A00,087417,Kedlaya; Kiran S.,6,0,8,2
1653403149619,MATH 205,A00,087418,Sorensen; Claus M,6,0,8,2
1653403150142,MATH 206A,A00,087419,Izadi; Elham,7,0,8,1
1653403150662,MATH 207A,A00,087420,Mohammadi; Amir,6,0,8,2
1653403151189,MATH 208,A00,087421,Staff,9,0,10,1
1653403151713,MATH 209,A00,087422,Staff,10,0,10,0
1653403152236,MATH 218,A00,087423,Staff,10,0,10,0
1653403152763,MATH 220A,A00,087424,Novak; Jonathan I,7,0,8,1
1653403153290,MATH 231A,A00,087425,Bejenaru; Ioan,4,0,8,4
1653403153812,MATH 240A,A00,087426,Ebenfelt; Peter F,5,0,8,3
1653403154338,MATH 243,A00,087427,Staff,9,0,10,1
1653403154865,MATH 248,A00,087429,Staff,10,0,10,0
1653403155386,MATH 250A,A00,087430,Spolaor; Luca,5,0,8,3
1653403155922,MATH 257A,A00,087431,Spolaor; Luca,7,0,8,1
1653403156445,MATH 258,A00,087432,Staff,9,0,10,1
1653403156970,MATH 264A,A00,087433,Warnke; Lutz Peter,5,0,8,3
1653403157496,MATH 268,A00,087434,Staff,15,0,15,0
1653403158018,MATH 269,A00,087435,Staff,14,0,15,1
1653403158550,MATH 270A,A00,087436,Nie; Jiawang,0,0,8,8
1653403159072,MATH 272A,A00,087437,Tian; Xiaochuan,2,0,8,6
1653403159596,MATH 274,A01,087439,Cheng; Li-Tien,9,0,10,1
1653403159596,MATH 274,A02,087440,Cheng; Li-Tien,10,0,10,0
1653403160122,MATH 278A,A00,087441,Staff,8,0,10,2
1653403160644,MATH 278B,A00,087442,Staff,8,0,10,2
1653403161174,MATH 278C,A00,087443,Staff,8,0,10,2
1653403161701,MATH 280A,A00,087444,Zheng; Tianyi,0,0,8,8
1653403162226,MATH 281A,A00,087445,Bradic; Jelena,0,0,8,8
1653403162749,MATH 282A,A00,087446,Zhang; Danna,0,0,8,8
1653403163276,MATH 283,A00,087447,Tesler; Glenn,0,0,0,13
1653403163803,MATH 286,A00,087448,Kemp; Todd Aahron,6,0,8,2
1653403164325,MATH 287D,A00,087449,Bradic; Jelena,8,0,8,0
1653403164848,MATH 288,A00,087450,Staff,14,0,15,1
1653403164848,MATH 288,B00,087451,Staff,15,0,15,0
1653403164848,MATH 288,C00,087452,Staff,15,0,15,0
1653403165372,MATH 290A,A00,087453,Xu; Zhouli,7,0,8,1
1653403165899,MATH 291A,A00,087454,Xu; Zhouli,7,0,8,1
1653403166421,MATH 292,A00,087455,Staff,10,0,10,0
1653403166948,MATH 295,A00,087456,Staff,50,0,50,0
1653403167470,MATH 297,001,087457,Staff,998,0,999,1
1653403727472,COGS 200,A01,087991,Staff,48,0,50,2
1653403727999,COGS 201,A01,094504,Rangel; Lara M,17,0,25,8
1653403728530,COGS 203,A00,087992,Coulson; Seana M,19,0,20,1
1653403729056,COGS 210A,001,087993,Greene; Deanna Jacquelyn,9998,0,9999,1
1653403729056,COGS 210A,002,087994,Saygin; Ayse P,9999,0,9999,0
1653403729056,COGS 210A,003,087995,Xia; Haijun,9999,0,9999,0
1653403729056,COGS 210A,004,087996,Nitz; Douglas A.,9999,0,9999,0
1653403729056,COGS 210A,005,087997,Hollan; James D.,9999,0,9999,0
1653403729056,COGS 210A,006,087998,Deak; Gedeon O.,9998,0,9999,1
1653403729056,COGS 210A,007,087999,Rossano; Federico,9999,0,9999,0
1653403729578,COGS 211A,A00,088000,Coulson; Seana M,9997,0,9999,2
1653403730104,COGS 229,A00,088002,Staff,23,0,25,2
1653403730626,COGS 260,B00,094231,Staff,17,0,20,3
1653403730626,COGS 260,A00,088004,Nitz; Douglas A.,9998,0,9999,1
1653403731150,CSE 202,A00,090110,Paturi; Ramamohan,0,0,0,0
1653403731150,CSE 202,B00,090111,Paturi; Ramamohan,0,0,0,0
1653403731676,CSE 207B,A00,090112,Heninger; Nadia A,0,0,0,0
1653403732199,CSE 208,A00,094858,Micciancio; Daniele,0,0,0,0
1653403732723,CSE 210,A00,090113,Powell; Thomas Allan,0,0,0,0
1653403733248,CSE 219,A00,090898,Staff,0,0,0,0
1653403733774,CSE 221,A00,090114,Zhou; Yuan-Yuan,0,0,0,0
1653403734303,CSE 229A,A00,090115,Porter; George M,0,0,0,0
1653403734825,CSE 229C,A00,090116,Savage; Stefan,0,0,0,0
1653403735349,CSE 230,A00,090117,Jhala; Ranjit,0,0,0,0
1653403735873,CSE 232,A00,090118,Papakonstantinou; Yannis,0,0,0,0
1653403736396,CSE 239A,A00,090121,Kumar; Arun Kumar,0,0,0,0
1653403736919,CSE 239B,A00,090122,Jhala; Ranjit,0,0,0,0
1653403737442,CSE 240A,A00,090123,Zhao; Jishen,0,0,189,189
1653403737971,CSE 243A,A00,090124,Orailoglu; Alex,3,0,15,12
1653403738495,CSE 249B,A00,090125,Kahng; Andrew Byun,14,0,20,6
1653403739021,CSE 250A,A00,090126,Berg-Kirkpatrick; Taylor D,0,0,0,0
1653403739542,CSE 252A,A00,090127,Ochoa; Benjamin Lawrence,0,0,0,0
1653403740064,CSE 258,A01,090129,McAuley; Julian John,0,0,0,0
1653403740587,CSE 258R,A01,090131,McAuley; Julian John,0,0,0,0
1653403741109,CSE 274,A00,090132,Ramamoorthi; Ravi,0,0,0,0
1653403741634,CSE 276A,A00,090133,Christensen; Henrik I,0,0,0,0
1653403742156,CSE 276C,A00,090134,Christensen; Henrik I,0,0,0,0
1653403742683,CSE 290,A00,090135,Bafna; Vineet,0,0,0,0
1653403742683,CSE 290,B00,090136,Ramamoorthi; Ravi,0,0,0,0
1653403742683,CSE 290,C00,090137,Li; Tzumao,10,0,10,0
1653403742683,CSE 290,D00,090138,Zhou; Yuan-Yuan,10,0,10,0
1653403742683,CSE 290,E00,090139,Christensen; Henrik I,10,0,10,0
1653403742683,CSE 290,F00,094053,Shalev; Aaron D,0,0,0,0
1653403743207,CSE 291,A00,090140,Munyaka; Imani N. S.,0,0,0,0
1653403743207,CSE 291,B00,094880,Yu; Qi,0,0,0,0
1653403743207,CSE 291,C00,090142,Pannuto; Patrick William,0,0,0,0
1653403743207,CSE 291,D00,094881,Zhang; Yiying,0,0,0,0
1653403743207,CSE 291,E00,095118,Su; Hao,0,0,0,0
1653403743740,CSE 293,001,094905,Bafna; Vineet,9999,0,9999,0
1653403743740,CSE 293,002,094906,Bellare; Mihir,9999,0,9999,0
1653403743740,CSE 293,003,094907,Berg-Kirkpatrick; Taylor D,9999,0,9999,0
1653403743740,CSE 293,004,094908,Christensen; Henrik I,9999,0,9999,0
1653403743740,CSE 293,005,094909,Cottrell; Garrison W,9999,0,9999,0
1653403743740,CSE 293,006,094910,Deutsch; Alin Bernard,9999,0,9999,0
1653403743740,CSE 293,007,094911,Esmaeilzadeh; Hadi,9999,0,9999,0
1653403743740,CSE 293,008,094912,Freund; Yoav,9999,0,9999,0
1653403743740,CSE 293,009,094913,Griswold; William G.,9999,0,9999,0
1653403743740,CSE 293,010,094914,Gymrek; Melissa Ann,9999,0,9999,0
1653403743740,CSE 293,011,094915,Heninger; Nadia A,9999,0,9999,0
1653403743740,CSE 293,012,094916,Impagliazzo; Russell,9999,0,9999,0
1653403743740,CSE 293,013,094917,Jhala; Ranjit,9999,0,9999,0
1653403743740,CSE 293,014,094918,Kahng; Andrew Byun,9999,0,9999,0
1653403743740,CSE 293,015,094919,Kane; Daniel Mertz,9999,0,9999,0
1653403743740,CSE 293,016,094920,Kriegman; David J,9999,0,9999,0
1653403743740,CSE 293,017,094921,Kumar; Arun Kumar,9999,0,9999,0
1653403743740,CSE 293,018,094922,Lerner; Sorin,9999,0,9999,0
1653403743740,CSE 293,019,094923,Lovett; Shachar,9999,0,9999,0
1653403743740,CSE 293,020,094924,McAuley; Julian John,9999,0,9999,0
1653403743740,CSE 293,021,094925,Micciancio; Daniele,9999,0,9999,0
1653403743740,CSE 293,022,094926,Orailoglu; Alex,9999,0,9999,0
1653403743740,CSE 293,023,094927,Paturi; Ramamohan,9999,0,9999,0
1653403743740,CSE 293,024,094928,Polikarpova; Nadezhda,9999,0,9999,0
1653403743740,CSE 293,025,094929,Politz; Joseph Gibbs,9999,0,9999,0
1653403743740,CSE 293,026,094930,Porter; George M,9999,0,9999,0
1653403743740,CSE 293,027,094931,Porter; Leonard Emerson,9999,0,9999,0
1653403743740,CSE 293,028,094932,Ramamoorthi; Ravi,9999,0,9999,0
1653403743740,CSE 293,029,094933,Sahoo; Debashis,9999,0,9999,0
1653403743740,CSE 293,030,094934,Saul; Lawrence,9999,0,9999,0
1653403743740,CSE 293,031,094935,Savage; Stefan,9999,0,9999,0
1653403743740,CSE 293,032,094936,Schulze; Jurgen P.,9999,0,9999,0
1653403743740,CSE 293,033,094937,Snoeren; Alex C.,9999,0,9999,0
1653403743740,CSE 293,034,094938,Shang; Jingbo,9999,0,9999,0
1653403743740,CSE 293,035,094939,Stefan; Deian,9999,0,9999,0
1653403743740,CSE 293,036,094940,Su; Hao,9999,0,9999,0
1653403743740,CSE 293,037,094941,Swanson; Steven James,9999,0,9999,0
1653403743740,CSE 293,038,094942,Tullsen; Dean Michael,9999,0,9999,0
1653403743740,CSE 293,039,094943,Voelker; Geoffrey M.,9999,0,9999,0
1653403743740,CSE 293,040,094944,Zhao; Jishen,9999,0,9999,0
1653403743740,CSE 293,041,094945,Zhou; Yuan-Yuan,9999,0,9999,0
1653403743740,CSE 293,042,094946,Gao; Sicun,9998,0,9999,1
1653403743740,CSE 293,043,094947,Weibel; Nadir,9999,0,9999,0
1653403743740,CSE 293,044,094948,Gupta; Rajesh K.,9999,0,9999,0
1653403744267,CSE 294,A00,090143,Porter; George M,9,0,10,1
1653403744789,DSE 200,A00,091799,Staff,50,0,50,0
1653403745310,DSE 203,A00,091800,Gupta; Amarnath,30,0,30,0
1653403745834,DSE 250,A00,091801,Deutsch; Alin Bernard,30,0,30,0
1653403746357,DSE 290,A00,091802,Altintas De Callaf; Ilkay,50,0,50,0
1653403746883,ECE 200,001,091003,Antipa; Nicholas A,9999,0,9999,0
1653403746883,ECE 200,002,091004,Atanasov; Nikolay A.,9999,0,9999,0
1653403746883,ECE 200,003,091005,Bharadia; Dinesh,9999,0,9999,0
1653403746883,ECE 200,004,091006,Cheng; Chung Kuan,9999,0,9999,0
1653403746883,ECE 200,005,091007,Cosman; Pamela C.,9999,0,9999,0
1653403746883,ECE 200,006,091008,Staff,9999,0,9999,0
1653403746883,ECE 200,007,091009,Dayeh; Shadi Ahmad,9999,0,9999,0
1653403746883,ECE 200,008,091010,Fainman; Yeshaiahu,9999,0,9999,0
1653403746883,ECE 200,009,091011,Ford; Joseph Earl,9999,0,9999,0
1653403746883,ECE 200,010,091012,Franceschetti; Massimo,9999,0,9999,0
1653403746883,ECE 200,011,091013,Fullerton; Eric E,9999,0,9999,0
1653403746883,ECE 200,012,091014,Galton; Ian A,9999,0,9999,0
1653403746883,ECE 200,013,091015,Gilja; Vikash,9999,0,9999,0
1653403746883,ECE 200,014,091016,Hall; Drew A.,9999,0,9999,0
1653403746883,ECE 200,015,091017,Hsueh; Tzu-Chien,9999,0,9999,0
1653403746883,ECE 200,016,091018,Javidi; Tara,9999,0,9999,0
1653403746883,ECE 200,017,091019,Kahng; Andrew Byun,9999,0,9999,0
1653403746883,ECE 200,018,091020,Kim; Young-Han,9999,0,9999,0
1653403746883,ECE 200,019,091021,Koushanfar; Farinaz,9999,0,9999,0
1653403746883,ECE 200,020,091022,Kuzum; Duygu,9999,0,9999,0
1653403746883,ECE 200,021,091023,Le; Hanh-Phuc,9999,0,9999,0
1653403746883,ECE 200,022,091024,Lin; Bill,9999,0,9999,0
1653403746883,ECE 200,023,091025,Liu; Zhaowei,9999,0,9999,0
1653403746883,ECE 200,024,091026,Lo; Yu-Hwa,9999,0,9999,0
1653403746883,ECE 200,025,091027,Lomakin; Vitaliy,9999,0,9999,0
1653403746883,ECE 200,026,091028,Mercier; Patrick Philip,9999,0,9999,0
1653403746883,ECE 200,027,091029,Meyer; Florian,9999,0,9999,0
1653403746883,ECE 200,028,091030,Milstein; Laurence B.,9999,0,9999,0
1653403746883,ECE 200,029,091031,Mir Arabbaygi; Siavash,9999,0,9999,0
1653403746883,ECE 200,030,091032,Mookherjea; Shayan,9999,0,9999,0
1653403746883,ECE 200,031,091033,Morris; Karcher William,9999,0,9999,0
1653403746883,ECE 200,032,091034,Ng; Tse Nga,9999,0,9999,0
1653403746883,ECE 200,033,091035,Nguyen; Truong Quang,9999,0,9999,0
1653403746883,ECE 200,034,091036,Nomura; Kenji,9999,0,9999,0
1653403746883,ECE 200,035,091037,Orlitsky; Alon,9999,0,9999,0
1653403746883,ECE 200,036,091038,Pal; Piya,9999,0,9999,0
1653403746883,ECE 200,037,091039,Papen; George C.,9999,0,9999,0
1653403746883,ECE 200,038,091040,Radic; Stojan,9999,0,9999,0
1653403746883,ECE 200,039,091041,Rao; Bhaskar D.,9999,0,9999,0
1653403746883,ECE 200,040,091042,Rao; Ramesh R,9999,0,9999,0
1653403746883,ECE 200,041,091043,Rebeiz; Gabriel,9999,0,9999,0
1653403746883,ECE 200,042,091044,Sanford; John R,9999,0,9999,0
1653403746883,ECE 200,043,091045,Siegel; Paul H.,9999,0,9999,0
1653403746883,ECE 200,044,091046,Sievenpiper; Daniel F.,9999,0,9999,0
1653403746883,ECE 200,045,091047,Sworder; David D.,9999,0,9999,0
1653403746883,ECE 200,046,091048,Taur; Yuan,9999,0,9999,0
1653403746883,ECE 200,047,091049,Touri; Behrouz,9999,0,9999,0
1653403746883,ECE 200,048,091050,Trivedi; Mohan M.,9999,0,9999,0
1653403746883,ECE 200,049,091051,Vardy; Alexander,9999,0,9999,0
1653403746883,ECE 200,050,091052,Vasconcelos; Nuno,9999,0,9999,0
1653403746883,ECE 200,051,091053,Wang; Xiaolong,9999,0,9999,0
1653403746883,ECE 200,052,091054,Xie; Pengtao,9999,0,9999,0
1653403746883,ECE 200,053,091055,Yip; Michael,9999,0,9999,0
1653403746883,ECE 200,054,091056,Zeger; Kenneth A.,9999,0,9999,0
1653403746883,ECE 200,055,091057,Zhang; Xinyu,9999,0,9999,0
1653403746883,ECE 200,056,091058,Turakhia; Yatish Girish,9999,0,9999,0
1653403746883,ECE 200,057,091059,Kang; Mingu,9999,0,9999,0
1653403746883,ECE 200,058,091060,Shi; Yuanyuan,9999,0,9999,0
1653403746883,ECE 200,059,091061,Wang; Edward Jay,9999,0,9999,0
1653403746883,ECE 200,060,091062,Zheng; Yang,9999,0,9999,0
1653403747409,ECE 203,A00,091065,Mercier; Patrick Philip,0,0,0,0
1653403747935,ECE 207A,A00,091605,Liu; Thomas Tao-Ming,0,0,0,0
1653403748466,ECE 212AN,A00,091068,Nomura; Kenji,0,0,0,0
1653403748988,ECE 222A,A00,091069,Rebeiz; Gabriel,0,0,0,0
1653403749511,ECE 225A,A00,091070,Orlitsky; Alon,0,0,0,0
1653403750033,ECE 230A,A00,091071,Nomura; Kenji,0,0,0,0
1653403750555,ECE 236A,A00,091072,Dayeh; Shadi Ahmad,0,0,0,0
1653403751080,ECE 238A,A00,091073,Luo; Jian,0,0,0,0
1653403751080,ECE 238A,B00,091074,Luo; Jian,0,0,0,0
1653403751605,ECE 240A,A00,091075,Radic; Stojan,0,0,0,0
1653403752132,ECE 247A,A00,091592,Shi; Lingyan,0,0,0,0
1653403752658,ECE 250,A00,091076,Touri; Behrouz,0,0,0,0
1653403753180,ECE 251C,A00,091078,Nguyen; Truong Quang,0,0,0,0
1653403753706,ECE 253,A00,091079,Cosman; Pamela C.,0,0,0,0
1653403754233,ECE 255A,A00,091080,Orlitsky; Alon,0,0,0,0
1653403754755,ECE 257A,A00,091081,Zhang; Xinyu,0,0,0,0
1653403755285,ECE 260A,A01,091084,Eldon; John,0,0,0,0
1653403755812,ECE 264C,A00,091085,Galton; Ian A,0,0,0,0
1653403756334,ECE 265C,A00,094889,Presti; Calogero Davide,0,0,0,9
1653403756857,ECE 266,A01,091087,Hall; Drew A.,0,0,0,0
1653403757904,ECE 271A,A00,091090,Vasconcelos; Nuno,0,0,0,0
1653403758427,ECE 272B,A00,091091,Sworder; David D.,0,0,0,0
1653403758950,ECE 275A,A00,091092,Meyer; Florian,0,0,0,0
1653403759474,ECE 277,A00,091093,An; Cheolhong,0,0,0,0
1653403760000,ECE 283,A00,091094,Le; Hanh-Phuc,0,0,0,0
1653403760523,ECE 284,A00,091095,Kang; Mingu,0,0,0,0
1653403760523,ECE 284,B00,091096,Wang; Edward Jay,0,0,0,0
1653403761046,ECE 285,A00,094334,Touri; Behrouz,0,0,0,0
1653403761567,ECE 289,A00,091097,Whelan; David Arthur,0,0,0,0
1653403762091,MATH 200A,A00,087414,Salehi Golsefidy; Alireza,7,0,8,1
1653403762615,MATH 202A,A00,087415,Gill; Philip E.,3,0,8,5
1653403763141,MATH 203A,A00,087416,Oprea; Dragos N.,6,0,8,2
1653403763667,MATH 204A,A00,087417,Kedlaya; Kiran S.,6,0,8,2
1653403764188,MATH 205,A00,087418,Sorensen; Claus M,6,0,8,2
1653403764710,MATH 206A,A00,087419,Izadi; Elham,7,0,8,1
1653403765340,MATH 207A,A00,087420,Mohammadi; Amir,6,0,8,2
1653403765864,MATH 208,A00,087421,Staff,9,0,10,1
1653403766386,MATH 209,A00,087422,Staff,10,0,10,0
1653403766909,MATH 218,A00,087423,Staff,10,0,10,0
1653403767435,MATH 220A,A00,087424,Novak; Jonathan I,7,0,8,1
1653403767961,MATH 231A,A00,087425,Bejenaru; Ioan,4,0,8,4
1653403768490,MATH 240A,A00,087426,Ebenfelt; Peter F,5,0,8,3
1653403769014,MATH 243,A00,087427,Staff,9,0,10,1
1653403769538,MATH 248,A00,087429,Staff,10,0,10,0
1653403770062,MATH 250A,A00,087430,Spolaor; Luca,5,0,8,3
1653403770585,MATH 257A,A00,087431,Spolaor; Luca,7,0,8,1
1653403771108,MATH 258,A00,087432,Staff,9,0,10,1
1653403771638,MATH 264A,A00,087433,Warnke; Lutz Peter,5,0,8,3
1653403772161,MATH 268,A00,087434,Staff,15,0,15,0
1653403772687,MATH 269,A00,087435,Staff,14,0,15,1
1653403773214,MATH 270A,A00,087436,Nie; Jiawang,0,0,8,8
1653403773738,MATH 272A,A00,087437,Tian; Xiaochuan,2,0,8,6
1653403774261,MATH 274,A01,087439,Cheng; Li-Tien,9,0,10,1
1653403774261,MATH 274,A02,087440,Cheng; Li-Tien,10,0,10,0
1653403774787,MATH 278A,A00,087441,Staff,8,0,10,2
1653403775310,MATH 278B,A00,087442,Staff,8,0,10,2
1653403775833,MATH 278C,A00,087443,Staff,8,0,10,2
1653403776359,MATH 280A,A00,087444,Zheng; Tianyi,0,0,8,8
1653403776880,MATH 281A,A00,087445,Bradic; Jelena,0,0,8,8
1653403777404,MATH 282A,A00,087446,Zhang; Danna,0,0,8,8
1653403777929,MATH 283,A00,087447,Tesler; Glenn,0,0,0,13
1653403778454,MATH 286,A00,087448,Kemp; Todd Aahron,6,0,8,2
1653403778979,MATH 287D,A00,087449,Bradic; Jelena,8,0,8,0
1653403779502,MATH 288,A00,087450,Staff,14,0,15,1
1653403779502,MATH 288,B00,087451,Staff,15,0,15,0
1653403779502,MATH 288,C00,087452,Staff,15,0,15,0
1653403780025,MATH 290A,A00,087453,Xu; Zhouli,7,0,8,1
1653403780552,MATH 291A,A00,087454,Xu; Zhouli,7,0,8,1
1653403781085,MATH 292,A00,087455,Staff,10,0,10,0
1653403781606,MATH 295,A00,087456,Staff,50,0,50,0
1653403782133,MATH 297,001,087457,Staff,998,0,999,1
1653404341873,COGS 200,A01,087991,Staff,48,0,50,2
1653404342402,COGS 201,A01,094504,Rangel; Lara M,17,0,25,8
1653404342925,COGS 203,A00,087992,Coulson; Seana M,19,0,20,1
1653404343451,COGS 210A,001,087993,Greene; Deanna Jacquelyn,9998,0,9999,1
1653404343451,COGS 210A,002,087994,Saygin; Ayse P,9999,0,9999,0
1653404343451,COGS 210A,003,087995,Xia; Haijun,9999,0,9999,0
1653404343451,COGS 210A,004,087996,Nitz; Douglas A.,9999,0,9999,0
1653404343451,COGS 210A,005,087997,Hollan; James D.,9999,0,9999,0
1653404343451,COGS 210A,006,087998,Deak; Gedeon O.,9998,0,9999,1
1653404343451,COGS 210A,007,087999,Rossano; Federico,9999,0,9999,0
1653404343980,COGS 211A,A00,088000,Coulson; Seana M,9997,0,9999,2
1653404344505,COGS 229,A00,088002,Staff,23,0,25,2
1653404345026,COGS 260,B00,094231,Staff,17,0,20,3
1653404345026,COGS 260,A00,088004,Nitz; Douglas A.,9998,0,9999,1
1653404345549,CSE 202,A00,090110,Paturi; Ramamohan,0,0,0,0
1653404345549,CSE 202,B00,090111,Paturi; Ramamohan,0,0,0,0
1653404346075,CSE 207B,A00,090112,Heninger; Nadia A,0,0,0,0
1653404346596,CSE 208,A00,094858,Micciancio; Daniele,0,0,0,0
1653404347119,CSE 210,A00,090113,Powell; Thomas Allan,0,0,0,0
1653404347641,CSE 219,A00,090898,Staff,0,0,0,0
1653404348183,CSE 221,A00,090114,Zhou; Yuan-Yuan,0,0,0,0
1653404348708,CSE 229A,A00,090115,Porter; George M,0,0,0,0
1653404349230,CSE 229C,A00,090116,Savage; Stefan,0,0,0,0
1653404349757,CSE 230,A00,090117,Jhala; Ranjit,0,0,0,0
1653404350281,CSE 232,A00,090118,Papakonstantinou; Yannis,0,0,0,0
1653404350805,CSE 239A,A00,090121,Kumar; Arun Kumar,0,0,0,0
1653404351334,CSE 239B,A00,090122,Jhala; Ranjit,0,0,0,0
1653404351862,CSE 240A,A00,090123,Zhao; Jishen,0,0,189,189
1653404352489,CSE 243A,A00,090124,Orailoglu; Alex,3,0,15,12
1653404353011,CSE 249B,A00,090125,Kahng; Andrew Byun,14,0,20,6
1653404353535,CSE 250A,A00,090126,Berg-Kirkpatrick; Taylor D,0,0,0,0
1653404354057,CSE 252A,A00,090127,Ochoa; Benjamin Lawrence,0,0,0,0
1653404354579,CSE 258,A01,090129,McAuley; Julian John,0,0,0,0
1653404355101,CSE 258R,A01,090131,McAuley; Julian John,0,0,0,0
1653404355626,CSE 274,A00,090132,Ramamoorthi; Ravi,0,0,0,0
1653404356149,CSE 276A,A00,090133,Christensen; Henrik I,0,0,0,0
1653404356673,CSE 276C,A00,090134,Christensen; Henrik I,0,0,0,0
1653404357197,CSE 290,A00,090135,Bafna; Vineet,0,0,0,0
1653404357197,CSE 290,B00,090136,Ramamoorthi; Ravi,0,0,0,0
1653404357197,CSE 290,C00,090137,Li; Tzumao,10,0,10,0
1653404357197,CSE 290,D00,090138,Zhou; Yuan-Yuan,10,0,10,0
1653404357197,CSE 290,E00,090139,Christensen; Henrik I,10,0,10,0
1653404357197,CSE 290,F00,094053,Shalev; Aaron D,0,0,0,0
1653404357719,CSE 291,A00,090140,Munyaka; Imani N. S.,0,0,0,0
1653404357719,CSE 291,B00,094880,Yu; Qi,0,0,0,0
1653404357719,CSE 291,C00,090142,Pannuto; Patrick William,0,0,0,0
1653404357719,CSE 291,D00,094881,Zhang; Yiying,0,0,0,0
1653404357719,CSE 291,E00,095118,Su; Hao,0,0,0,0
1653404358242,CSE 293,001,094905,Bafna; Vineet,9999,0,9999,0
1653404358242,CSE 293,002,094906,Bellare; Mihir,9999,0,9999,0
1653404358242,CSE 293,003,094907,Berg-Kirkpatrick; Taylor D,9999,0,9999,0
1653404358242,CSE 293,004,094908,Christensen; Henrik I,9999,0,9999,0
1653404358242,CSE 293,005,094909,Cottrell; Garrison W,9999,0,9999,0
1653404358242,CSE 293,006,094910,Deutsch; Alin Bernard,9999,0,9999,0
1653404358242,CSE 293,007,094911,Esmaeilzadeh; Hadi,9999,0,9999,0
1653404358242,CSE 293,008,094912,Freund; Yoav,9999,0,9999,0
1653404358242,CSE 293,009,094913,Griswold; William G.,9999,0,9999,0
1653404358242,CSE 293,010,094914,Gymrek; Melissa Ann,9999,0,9999,0
1653404358242,CSE 293,011,094915,Heninger; Nadia A,9999,0,9999,0
1653404358242,CSE 293,012,094916,Impagliazzo; Russell,9999,0,9999,0
1653404358242,CSE 293,013,094917,Jhala; Ranjit,9999,0,9999,0
1653404358242,CSE 293,014,094918,Kahng; Andrew Byun,9999,0,9999,0
1653404358242,CSE 293,015,094919,Kane; Daniel Mertz,9999,0,9999,0
1653404358242,CSE 293,016,094920,Kriegman; David J,9999,0,9999,0
1653404358242,CSE 293,017,094921,Kumar; Arun Kumar,9999,0,9999,0
1653404358242,CSE 293,018,094922,Lerner; Sorin,9999,0,9999,0
1653404358242,CSE 293,019,094923,Lovett; Shachar,9999,0,9999,0
1653404358242,CSE 293,020,094924,McAuley; Julian John,9999,0,9999,0
1653404358242,CSE 293,021,094925,Micciancio; Daniele,9999,0,9999,0
1653404358242,CSE 293,022,094926,Orailoglu; Alex,9999,0,9999,0
1653404358242,CSE 293,023,094927,Paturi; Ramamohan,9999,0,9999,0
1653404358242,CSE 293,024,094928,Polikarpova; Nadezhda,9999,0,9999,0
1653404358242,CSE 293,025,094929,Politz; Joseph Gibbs,9999,0,9999,0
1653404358242,CSE 293,026,094930,Porter; George M,9999,0,9999,0
1653404358242,CSE 293,027,094931,Porter; Leonard Emerson,9999,0,9999,0
1653404358242,CSE 293,028,094932,Ramamoorthi; Ravi,9999,0,9999,0
1653404358242,CSE 293,029,094933,Sahoo; Debashis,9999,0,9999,0
1653404358242,CSE 293,030,094934,Saul; Lawrence,9999,0,9999,0
1653404358242,CSE 293,031,094935,Savage; Stefan,9999,0,9999,0
1653404358242,CSE 293,032,094936,Schulze; Jurgen P.,9999,0,9999,0
1653404358242,CSE 293,033,094937,Snoeren; Alex C.,9999,0,9999,0
1653404358242,CSE 293,034,094938,Shang; Jingbo,9999,0,9999,0
1653404358242,CSE 293,035,094939,Stefan; Deian,9999,0,9999,0
1653404358242,CSE 293,036,094940,Su; Hao,9999,0,9999,0
1653404358242,CSE 293,037,094941,Swanson; Steven James,9999,0,9999,0
1653404358242,CSE 293,038,094942,Tullsen; Dean Michael,9999,0,9999,0
1653404358242,CSE 293,039,094943,Voelker; Geoffrey M.,9999,0,9999,0
1653404358242,CSE 293,040,094944,Zhao; Jishen,9999,0,9999,0
1653404358242,CSE 293,041,094945,Zhou; Yuan-Yuan,9999,0,9999,0
1653404358242,CSE 293,042,094946,Gao; Sicun,9998,0,9999,1
1653404358242,CSE 293,043,094947,Weibel; Nadir,9999,0,9999,0
1653404358242,CSE 293,044,094948,Gupta; Rajesh K.,9999,0,9999,0
1653404358764,CSE 294,A00,090143,Porter; George M,9,0,10,1
1653404359287,DSE 200,A00,091799,Staff,50,0,50,0
1653404359814,DSE 203,A00,091800,Gupta; Amarnath,30,0,30,0
1653404360337,DSE 250,A00,091801,Deutsch; Alin Bernard,30,0,30,0
1653404360859,DSE 290,A00,091802,Altintas De Callaf; Ilkay,50,0,50,0
1653404361384,ECE 200,001,091003,Antipa; Nicholas A,9999,0,9999,0
1653404361384,ECE 200,002,091004,Atanasov; Nikolay A.,9999,0,9999,0
1653404361384,ECE 200,003,091005,Bharadia; Dinesh,9999,0,9999,0
1653404361384,ECE 200,004,091006,Cheng; Chung Kuan,9999,0,9999,0
1653404361384,ECE 200,005,091007,Cosman; Pamela C.,9999,0,9999,0
1653404361384,ECE 200,006,091008,Staff,9999,0,9999,0
1653404361384,ECE 200,007,091009,Dayeh; Shadi Ahmad,9999,0,9999,0
1653404361384,ECE 200,008,091010,Fainman; Yeshaiahu,9999,0,9999,0
1653404361384,ECE 200,009,091011,Ford; Joseph Earl,9999,0,9999,0
1653404361384,ECE 200,010,091012,Franceschetti; Massimo,9999,0,9999,0
1653404361384,ECE 200,011,091013,Fullerton; Eric E,9999,0,9999,0
1653404361384,ECE 200,012,091014,Galton; Ian A,9999,0,9999,0
1653404361384,ECE 200,013,091015,Gilja; Vikash,9999,0,9999,0
1653404361384,ECE 200,014,091016,Hall; Drew A.,9999,0,9999,0
1653404361384,ECE 200,015,091017,Hsueh; Tzu-Chien,9999,0,9999,0
1653404361384,ECE 200,016,091018,Javidi; Tara,9999,0,9999,0
1653404361384,ECE 200,017,091019,Kahng; Andrew Byun,9999,0,9999,0
1653404361384,ECE 200,018,091020,Kim; Young-Han,9999,0,9999,0
1653404361384,ECE 200,019,091021,Koushanfar; Farinaz,9999,0,9999,0
1653404361384,ECE 200,020,091022,Kuzum; Duygu,9999,0,9999,0
1653404361384,ECE 200,021,091023,Le; Hanh-Phuc,9999,0,9999,0
1653404361384,ECE 200,022,091024,Lin; Bill,9999,0,9999,0
1653404361384,ECE 200,023,091025,Liu; Zhaowei,9999,0,9999,0
1653404361384,ECE 200,024,091026,Lo; Yu-Hwa,9999,0,9999,0
1653404361384,ECE 200,025,091027,Lomakin; Vitaliy,9999,0,9999,0
1653404361384,ECE 200,026,091028,Mercier; Patrick Philip,9999,0,9999,0
1653404361384,ECE 200,027,091029,Meyer; Florian,9999,0,9999,0
1653404361384,ECE 200,028,091030,Milstein; Laurence B.,9999,0,9999,0
1653404361384,ECE 200,029,091031,Mir Arabbaygi; Siavash,9999,0,9999,0
1653404361384,ECE 200,030,091032,Mookherjea; Shayan,9999,0,9999,0
1653404361384,ECE 200,031,091033,Morris; Karcher William,9999,0,9999,0
1653404361384,ECE 200,032,091034,Ng; Tse Nga,9999,0,9999,0
1653404361384,ECE 200,033,091035,Nguyen; Truong Quang,9999,0,9999,0
1653404361384,ECE 200,034,091036,Nomura; Kenji,9999,0,9999,0
1653404361384,ECE 200,035,091037,Orlitsky; Alon,9999,0,9999,0
1653404361384,ECE 200,036,091038,Pal; Piya,9999,0,9999,0
1653404361384,ECE 200,037,091039,Papen; George C.,9999,0,9999,0
1653404361384,ECE 200,038,091040,Radic; Stojan,9999,0,9999,0
1653404361384,ECE 200,039,091041,Rao; Bhaskar D.,9999,0,9999,0
1653404361384,ECE 200,040,091042,Rao; Ramesh R,9999,0,9999,0
1653404361384,ECE 200,041,091043,Rebeiz; Gabriel,9999,0,9999,0
1653404361384,ECE 200,042,091044,Sanford; John R,9999,0,9999,0
1653404361384,ECE 200,043,091045,Siegel; Paul H.,9999,0,9999,0
1653404361384,ECE 200,044,091046,Sievenpiper; Daniel F.,9999,0,9999,0
1653404361384,ECE 200,045,091047,Sworder; David D.,9999,0,9999,0
1653404361384,ECE 200,046,091048,Taur; Yuan,9999,0,9999,0
1653404361384,ECE 200,047,091049,Touri; Behrouz,9999,0,9999,0
1653404361384,ECE 200,048,091050,Trivedi; Mohan M.,9999,0,9999,0
1653404361384,ECE 200,049,091051,Vardy; Alexander,9999,0,9999,0
1653404361384,ECE 200,050,091052,Vasconcelos; Nuno,9999,0,9999,0
1653404361384,ECE 200,051,091053,Wang; Xiaolong,9999,0,9999,0
1653404361384,ECE 200,052,091054,Xie; Pengtao,9999,0,9999,0
1653404361384,ECE 200,053,091055,Yip; Michael,9999,0,9999,0
1653404361384,ECE 200,054,091056,Zeger; Kenneth A.,9999,0,9999,0
1653404361384,ECE 200,055,091057,Zhang; Xinyu,9999,0,9999,0
1653404361384,ECE 200,056,091058,Turakhia; Yatish Girish,9999,0,9999,0
1653404361384,ECE 200,057,091059,Kang; Mingu,9999,0,9999,0
1653404361384,ECE 200,058,091060,Shi; Yuanyuan,9999,0,9999,0
1653404361384,ECE 200,059,091061,Wang; Edward Jay,9999,0,9999,0
1653404361384,ECE 200,060,091062,Zheng; Yang,9999,0,9999,0
1653404361913,ECE 203,A00,091065,Mercier; Patrick Philip,0,0,0,0
1653404362439,ECE 207A,A00,091605,Liu; Thomas Tao-Ming,0,0,0,0
1653404362964,ECE 212AN,A00,091068,Nomura; Kenji,0,0,0,0
1653404363487,ECE 222A,A00,091069,Rebeiz; Gabriel,0,0,0,0
1653404364009,ECE 225A,A00,091070,Orlitsky; Alon,0,0,0,0
1653404364533,ECE 230A,A00,091071,Nomura; Kenji,0,0,0,0
1653404365064,ECE 236A,A00,091072,Dayeh; Shadi Ahmad,0,0,0,0
1653404365590,ECE 238A,A00,091073,Luo; Jian,0,0,0,0
1653404365590,ECE 238A,B00,091074,Luo; Jian,0,0,0,0
1653404366112,ECE 240A,A00,091075,Radic; Stojan,0,0,0,0
1653404366638,ECE 247A,A00,091592,Shi; Lingyan,0,0,0,0
1653404367172,ECE 250,A00,091076,Touri; Behrouz,0,0,0,0
1653404367695,ECE 251C,A00,091078,Nguyen; Truong Quang,0,0,0,0
1653404368233,ECE 253,A00,091079,Cosman; Pamela C.,0,0,0,0
1653404368757,ECE 255A,A00,091080,Orlitsky; Alon,0,0,0,0
1653404369279,ECE 257A,A00,091081,Zhang; Xinyu,0,0,0,0
1653404369805,ECE 260A,A01,091084,Eldon; John,0,0,0,0
1653404370340,ECE 264C,A00,091085,Galton; Ian A,0,0,0,0
1653404370866,ECE 265C,A00,094889,Presti; Calogero Davide,0,0,0,9
1653404371387,ECE 266,A01,091087,Hall; Drew A.,0,0,0,0
1653404372431,ECE 271A,A00,091090,Vasconcelos; Nuno,0,0,0,0
1653404372961,ECE 272B,A00,091091,Sworder; David D.,0,0,0,0
1653404373485,ECE 275A,A00,091092,Meyer; Florian,0,0,0,0
1653404374011,ECE 277,A00,091093,An; Cheolhong,0,0,0,0
1653404374534,ECE 283,A00,091094,Le; Hanh-Phuc,0,0,0,0
1653404375060,ECE 284,A00,091095,Kang; Mingu,0,0,0,0
1653404375060,ECE 284,B00,091096,Wang; Edward Jay,0,0,0,0
1653404375582,ECE 285,A00,094334,Touri; Behrouz,0,0,0,0
1653404376104,ECE 289,A00,091097,Whelan; David Arthur,0,0,0,0
1653404376626,MATH 200A,A00,087414,Salehi Golsefidy; Alireza,7,0,8,1
1653404377149,MATH 202A,A00,087415,Gill; Philip E.,3,0,8,5
1653404377672,MATH 203A,A00,087416,Oprea; Dragos N.,6,0,8,2
1653404378195,MATH 204A,A00,087417,Kedlaya; Kiran S.,6,0,8,2
1653404378718,MATH 205,A00,087418,Sorensen; Claus M,6,0,8,2
1653404379242,MATH 206A,A00,087419,Izadi; Elham,7,0,8,1
1653404379772,MATH 207A,A00,087420,Mohammadi; Amir,6,0,8,2
1653404380295,MATH 208,A00,087421,Staff,9,0,10,1
1653404380820,MATH 209,A00,087422,Staff,10,0,10,0
1653404381357,MATH 218,A00,087423,Staff,10,0,10,0
1653404381878,MATH 220A,A00,087424,Novak; Jonathan I,7,0,8,1
1653404382409,MATH 231A,A00,087425,Bejenaru; Ioan,4,0,8,4
1653404382932,MATH 240A,A00,087426,Ebenfelt; Peter F,5,0,8,3
1653404383455,MATH 243,A00,087427,Staff,9,0,10,1
1653404383976,MATH 248,A00,087429,Staff,10,0,10,0
1653404384499,MATH 250A,A00,087430,Spolaor; Luca,5,0,8,3
1653404385027,MATH 257A,A00,087431,Spolaor; Luca,7,0,8,1
1653404385552,MATH 258,A00,087432,Staff,9,0,10,1
1653404386078,MATH 264A,A00,087433,Warnke; Lutz Peter,5,0,8,3
1653404386600,MATH 268,A00,087434,Staff,15,0,15,0
1653404387123,MATH 269,A00,087435,Staff,14,0,15,1
1653404387647,MATH 270A,A00,087436,Nie; Jiawang,0,0,8,8
1653404388169,MATH 272A,A00,087437,Tian; Xiaochuan,2,0,8,6
1653404388695,MATH 274,A01,087439,Cheng; Li-Tien,9,0,10,1
1653404388695,MATH 274,A02,087440,Cheng; Li-Tien,10,0,10,0
1653404389224,MATH 278A,A00,087441,Staff,8,0,10,2
1653404389747,MATH 278B,A00,087442,Staff,8,0,10,2
1653404390274,MATH 278C,A00,087443,Staff,8,0,10,2
1653404390806,MATH 280A,A00,087444,Zheng; Tianyi,0,0,8,8
1653404391342,MATH 281A,A00,087445,Bradic; Jelena,0,0,8,8
1653404391869,MATH 282A,A00,087446,Zhang; Danna,0,0,8,8
1653404392398,MATH 283,A00,087447,Tesler; Glenn,0,0,0,13
1653404392922,MATH 286,A00,087448,Kemp; Todd Aahron,6,0,8,2
1653404393447,MATH 287D,A00,087449,Bradic; Jelena,8,0,8,0
1653404393980,MATH 288,A00,087450,Staff,14,0,15,1
1653404393980,MATH 288,B00,087451,Staff,15,0,15,0
1653404393980,MATH 288,C00,087452,Staff,15,0,15,0
1653404394507,MATH 290A,A00,087453,Xu; Zhouli,7,0,8,1
1653404395034,MATH 291A,A00,087454,Xu; Zhouli,7,0,8,1
1653404395560,MATH 292,A00,087455,Staff,10,0,10,0
1653404396083,MATH 295,A00,087456,Staff,50,0,50,0
1653404396606,MATH 297,001,087457,Staff,998,0,999,1
1653404956291,COGS 200,A01,087991,Staff,48,0,50,2
1653404956813,COGS 201,A01,094504,Rangel; Lara M,17,0,25,8
1653404957339,COGS 203,A00,087992,Coulson; Seana M,19,0,20,1
1653404957862,COGS 210A,001,087993,Greene; Deanna Jacquelyn,9998,0,9999,1
1653404957862,COGS 210A,002,087994,Saygin; Ayse P,9999,0,9999,0
1653404957862,COGS 210A,003,087995,Xia; Haijun,9999,0,9999,0
1653404957862,COGS 210A,004,087996,Nitz; Douglas A.,9999,0,9999,0
1653404957862,COGS 210A,005,087997,Hollan; James D.,9999,0,9999,0
1653404957862,COGS 210A,006,087998,Deak; Gedeon O.,9998,0,9999,1
1653404957862,COGS 210A,007,087999,Rossano; Federico,9999,0,9999,0
1653404958388,COGS 211A,A00,088000,Coulson; Seana M,9997,0,9999,2
1653404958916,COGS 229,A00,088002,Staff,23,0,25,2
1653404959439,COGS 260,B00,094231,Staff,17,0,20,3
1653404959439,COGS 260,A00,088004,Nitz; Douglas A.,9998,0,9999,1
1653404959963,CSE 202,A00,090110,Paturi; Ramamohan,0,0,0,0
1653404959963,CSE 202,B00,090111,Paturi; Ramamohan,0,0,0,0
1653404960488,CSE 207B,A00,090112,Heninger; Nadia A,0,0,0,0
1653404961019,CSE 208,A00,094858,Micciancio; Daniele,0,0,0,0
1653404961546,CSE 210,A00,090113,Powell; Thomas Allan,0,0,0,0
1653404962076,CSE 219,A00,090898,Staff,0,0,0,0
1653404962605,CSE 221,A00,090114,Zhou; Yuan-Yuan,0,0,0,0
1653404963133,CSE 229A,A00,090115,Porter; George M,0,0,0,0
1653404963656,CSE 229C,A00,090116,Savage; Stefan,0,0,0,0
1653404964177,CSE 230,A00,090117,Jhala; Ranjit,0,0,0,0
1653404964705,CSE 232,A00,090118,Papakonstantinou; Yannis,0,0,0,0
1653404965228,CSE 239A,A00,090121,Kumar; Arun Kumar,0,0,0,0
1653404965749,CSE 239B,A00,090122,Jhala; Ranjit,0,0,0,0
1653404966270,CSE 240A,A00,090123,Zhao; Jishen,0,0,189,189
1653404966796,CSE 243A,A00,090124,Orailoglu; Alex,3,0,15,12
1653404967333,CSE 249B,A00,090125,Kahng; Andrew Byun,14,0,20,6
1653404967855,CSE 250A,A00,090126,Berg-Kirkpatrick; Taylor D,0,0,0,0
1653404968382,CSE 252A,A00,090127,Ochoa; Benjamin Lawrence,0,0,0,0
1653404968907,CSE 258,A01,090129,McAuley; Julian John,0,0,0,0
1653404969435,CSE 258R,A01,090131,McAuley; Julian John,0,0,0,0
1653404969957,CSE 274,A00,090132,Ramamoorthi; Ravi,0,0,0,0
1653404970481,CSE 276A,A00,090133,Christensen; Henrik I,0,0,0,0
1653404971002,CSE 276C,A00,090134,Christensen; Henrik I,0,0,0,0
1653404971525,CSE 290,A00,090135,Bafna; Vineet,0,0,0,0
1653404971525,CSE 290,B00,090136,Ramamoorthi; Ravi,0,0,0,0
1653404971525,CSE 290,C00,090137,Li; Tzumao,10,0,10,0
1653404971525,CSE 290,D00,090138,Zhou; Yuan-Yuan,10,0,10,0
1653404971525,CSE 290,E00,090139,Christensen; Henrik I,10,0,10,0
1653404971525,CSE 290,F00,094053,Shalev; Aaron D,0,0,0,0
1653404972055,CSE 291,A00,090140,Munyaka; Imani N. S.,0,0,0,0
1653404972055,CSE 291,B00,094880,Yu; Qi,0,0,0,0
1653404972055,CSE 291,C00,090142,Pannuto; Patrick William,0,0,0,0
1653404972055,CSE 291,D00,094881,Zhang; Yiying,0,0,0,0
1653404972055,CSE 291,E00,095118,Su; Hao,0,0,0,0
1653404972609,CSE 293,001,094905,Bafna; Vineet,9999,0,9999,0
1653404972609,CSE 293,002,094906,Bellare; Mihir,9999,0,9999,0
1653404972609,CSE 293,003,094907,Berg-Kirkpatrick; Taylor D,9999,0,9999,0
1653404972609,CSE 293,004,094908,Christensen; Henrik I,9999,0,9999,0
1653404972609,CSE 293,005,094909,Cottrell; Garrison W,9999,0,9999,0
1653404972609,CSE 293,006,094910,Deutsch; Alin Bernard,9999,0,9999,0
1653404972609,CSE 293,007,094911,Esmaeilzadeh; Hadi,9999,0,9999,0
1653404972609,CSE 293,008,094912,Freund; Yoav,9999,0,9999,0
1653404972609,CSE 293,009,094913,Griswold; William G.,9999,0,9999,0
1653404972609,CSE 293,010,094914,Gymrek; Melissa Ann,9999,0,9999,0
1653404972609,CSE 293,011,094915,Heninger; Nadia A,9999,0,9999,0
1653404972609,CSE 293,012,094916,Impagliazzo; Russell,9999,0,9999,0
1653404972609,CSE 293,013,094917,Jhala; Ranjit,9999,0,9999,0
1653404972609,CSE 293,014,094918,Kahng; Andrew Byun,9999,0,9999,0
1653404972609,CSE 293,015,094919,Kane; Daniel Mertz,9999,0,9999,0
1653404972609,CSE 293,016,094920,Kriegman; David J,9999,0,9999,0
1653404972609,CSE 293,017,094921,Kumar; Arun Kumar,9999,0,9999,0
1653404972609,CSE 293,018,094922,Lerner; Sorin,9999,0,9999,0
1653404972609,CSE 293,019,094923,Lovett; Shachar,9999,0,9999,0
1653404972609,CSE 293,020,094924,McAuley; Julian John,9999,0,9999,0
1653404972609,CSE 293,021,094925,Micciancio; Daniele,9999,0,9999,0
1653404972609,CSE 293,022,094926,Orailoglu; Alex,9999,0,9999,0
1653404972609,CSE 293,023,094927,Paturi; Ramamohan,9999,0,9999,0
1653404972609,CSE 293,024,094928,Polikarpova; Nadezhda,9999,0,9999,0
1653404972609,CSE 293,025,094929,Politz; Joseph Gibbs,9999,0,9999,0
1653404972609,CSE 293,026,094930,Porter; George M,9999,0,9999,0
1653404972609,CSE 293,027,094931,Porter; Leonard Emerson,9999,0,9999,0
1653404972609,CSE 293,028,094932,Ramamoorthi; Ravi,9999,0,9999,0
1653404972609,CSE 293,029,094933,Sahoo; Debashis,9999,0,9999,0
1653404972609,CSE 293,030,094934,Saul; Lawrence,9999,0,9999,0
1653404972609,CSE 293,031,094935,Savage; Stefan,9999,0,9999,0
1653404972609,CSE 293,032,094936,Schulze; Jurgen P.,9999,0,9999,0
1653404972609,CSE 293,033,094937,Snoeren; Alex C.,9999,0,9999,0
1653404972609,CSE 293,034,094938,Shang; Jingbo,9999,0,9999,0
1653404972609,CSE 293,035,094939,Stefan; Deian,9999,0,9999,0
1653404972609,CSE 293,036,094940,Su; Hao,9999,0,9999,0
1653404972609,CSE 293,037,094941,Swanson; Steven James,9999,0,9999,0
1653404972609,CSE 293,038,094942,Tullsen; Dean Michael,9999,0,9999,0
1653404972609,CSE 293,039,094943,Voelker; Geoffrey M.,9999,0,9999,0
1653404972609,CSE 293,040,094944,Zhao; Jishen,9999,0,9999,0
1653404972609,CSE 293,041,094945,Zhou; Yuan-Yuan,9999,0,9999,0
1653404972609,CSE 293,042,094946,Gao; Sicun,9998,0,9999,1
1653404972609,CSE 293,043,094947,Weibel; Nadir,9999,0,9999,0
1653404972609,CSE 293,044,094948,Gupta; Rajesh K.,9999,0,9999,0
1653404973131,CSE 294,A00,090143,Porter; George M,9,0,10,1
1653404973659,DSE 200,A00,091799,Staff,50,0,50,0
1653404974186,DSE 203,A00,091800,Gupta; Amarnath,30,0,30,0
1653404974707,DSE 250,A00,091801,Deutsch; Alin Bernard,30,0,30,0
1653404975231,DSE 290,A00,091802,Altintas De Callaf; Ilkay,50,0,50,0
1653404975778,ECE 200,001,091003,Antipa; Nicholas A,9999,0,9999,0
1653404975778,ECE 200,002,091004,Atanasov; Nikolay A.,9999,0,9999,0
1653404975778,ECE 200,003,091005,Bharadia; Dinesh,9999,0,9999,0
1653404975778,ECE 200,004,091006,Cheng; Chung Kuan,9999,0,9999,0
1653404975778,ECE 200,005,091007,Cosman; Pamela C.,9999,0,9999,0
1653404975778,ECE 200,006,091008,Staff,9999,0,9999,0
1653404975778,ECE 200,007,091009,Dayeh; Shadi Ahmad,9999,0,9999,0
1653404975778,ECE 200,008,091010,Fainman; Yeshaiahu,9999,0,9999,0
1653404975778,ECE 200,009,091011,Ford; Joseph Earl,9999,0,9999,0
1653404975778,ECE 200,010,091012,Franceschetti; Massimo,9999,0,9999,0
1653404975778,ECE 200,011,091013,Fullerton; Eric E,9999,0,9999,0
1653404975778,ECE 200,012,091014,Galton; Ian A,9999,0,9999,0
1653404975778,ECE 200,013,091015,Gilja; Vikash,9999,0,9999,0
1653404975778,ECE 200,014,091016,Hall; Drew A.,9999,0,9999,0
1653404975778,ECE 200,015,091017,Hsueh; Tzu-Chien,9999,0,9999,0
1653404975778,ECE 200,016,091018,Javidi; Tara,9999,0,9999,0
1653404975778,ECE 200,017,091019,Kahng; Andrew Byun,9999,0,9999,0
1653404975778,ECE 200,018,091020,Kim; Young-Han,9999,0,9999,0
1653404975778,ECE 200,019,091021,Koushanfar; Farinaz,9999,0,9999,0
1653404975778,ECE 200,020,091022,Kuzum; Duygu,9999,0,9999,0
1653404975778,ECE 200,021,091023,Le; Hanh-Phuc,9999,0,9999,0
1653404975778,ECE 200,022,091024,Lin; Bill,9999,0,9999,0
1653404975778,ECE 200,023,091025,Liu; Zhaowei,9999,0,9999,0
1653404975778,ECE 200,024,091026,Lo; Yu-Hwa,9999,0,9999,0
1653404975778,ECE 200,025,091027,Lomakin; Vitaliy,9999,0,9999,0
1653404975778,ECE 200,026,091028,Mercier; Patrick Philip,9999,0,9999,0
1653404975778,ECE 200,027,091029,Meyer; Florian,9999,0,9999,0
1653404975778,ECE 200,028,091030,Milstein; Laurence B.,9999,0,9999,0
1653404975778,ECE 200,029,091031,Mir Arabbaygi; Siavash,9999,0,9999,0
1653404975778,ECE 200,030,091032,Mookherjea; Shayan,9999,0,9999,0
1653404975778,ECE 200,031,091033,Morris; Karcher William,9999,0,9999,0
1653404975778,ECE 200,032,091034,Ng; Tse Nga,9999,0,9999,0
1653404975778,ECE 200,033,091035,Nguyen; Truong Quang,9999,0,9999,0
1653404975778,ECE 200,034,091036,Nomura; Kenji,9999,0,9999,0
1653404975778,ECE 200,035,091037,Orlitsky; Alon,9999,0,9999,0
1653404975778,ECE 200,036,091038,Pal; Piya,9999,0,9999,0
1653404975778,ECE 200,037,091039,Papen; George C.,9999,0,9999,0
1653404975778,ECE 200,038,091040,Radic; Stojan,9999,0,9999,0
1653404975778,ECE 200,039,091041,Rao; Bhaskar D.,9999,0,9999,0
1653404975778,ECE 200,040,091042,Rao; Ramesh R,9999,0,9999,0
1653404975778,ECE 200,041,091043,Rebeiz; Gabriel,9999,0,9999,0
1653404975778,ECE 200,042,091044,Sanford; John R,9999,0,9999,0
1653404975778,ECE 200,043,091045,Siegel; Paul H.,9999,0,9999,0
1653404975778,ECE 200,044,091046,Sievenpiper; Daniel F.,9999,0,9999,0
1653404975778,ECE 200,045,091047,Sworder; David D.,9999,0,9999,0
1653404975778,ECE 200,046,091048,Taur; Yuan,9999,0,9999,0
1653404975778,ECE 200,047,091049,Touri; Behrouz,9999,0,9999,0
1653404975778,ECE 200,048,091050,Trivedi; Mohan M.,9999,0,9999,0
1653404975778,ECE 200,049,091051,Vardy; Alexander,9999,0,9999,0
1653404975778,ECE 200,050,091052,Vasconcelos; Nuno,9999,0,9999,0
1653404975778,ECE 200,051,091053,Wang; Xiaolong,9999,0,9999,0
1653404975778,ECE 200,052,091054,Xie; Pengtao,9999,0,9999,0
1653404975778,ECE 200,053,091055,Yip; Michael,9999,0,9999,0
1653404975778,ECE 200,054,091056,Zeger; Kenneth A.,9999,0,9999,0
1653404975778,ECE 200,055,091057,Zhang; Xinyu,9999,0,9999,0
1653404975778,ECE 200,056,091058,Turakhia; Yatish Girish,9999,0,9999,0
1653404975778,ECE 200,057,091059,Kang; Mingu,9999,0,9999,0
1653404975778,ECE 200,058,091060,Shi; Yuanyuan,9999,0,9999,0
1653404975778,ECE 200,059,091061,Wang; Edward Jay,9999,0,9999,0
1653404975778,ECE 200,060,091062,Zheng; Yang,9999,0,9999,0
1653404976300,ECE 203,A00,091065,Mercier; Patrick Philip,0,0,0,0
1653404976838,ECE 207A,A00,091605,Liu; Thomas Tao-Ming,0,0,0,0
1653404977365,ECE 212AN,A00,091068,Nomura; Kenji,0,0,0,0
1653404977887,ECE 222A,A00,091069,Rebeiz; Gabriel,0,0,0,0
1653404978409,ECE 225A,A00,091070,Orlitsky; Alon,0,0,0,0
1653404978934,ECE 230A,A00,091071,Nomura; Kenji,0,0,0,0
1653404979457,ECE 236A,A00,091072,Dayeh; Shadi Ahmad,0,0,0,0
1653404979981,ECE 238A,A00,091073,Luo; Jian,0,0,0,0
1653404979981,ECE 238A,B00,091074,Luo; Jian,0,0,0,0
1653404980505,ECE 240A,A00,091075,Radic; Stojan,0,0,0,0
1653404981027,ECE 247A,A00,091592,Shi; Lingyan,0,0,0,0
1653404981556,ECE 250,A00,091076,Touri; Behrouz,0,0,0,0
1653404982082,ECE 251C,A00,091078,Nguyen; Truong Quang,0,0,0,0
1653404982604,ECE 253,A00,091079,Cosman; Pamela C.,0,0,0,0
1653404983129,ECE 255A,A00,091080,Orlitsky; Alon,0,0,0,0
1653404983650,ECE 257A,A00,091081,Zhang; Xinyu,0,0,0,0
1653404984179,ECE 260A,A01,091084,Eldon; John,0,0,0,0
1653404984783,ECE 264C,A00,091085,Galton; Ian A,0,0,0,0
1653404985309,ECE 265C,A00,094889,Presti; Calogero Davide,0,0,0,9
1653404985835,ECE 266,A01,091087,Hall; Drew A.,0,0,0,0
1653404986882,ECE 271A,A00,091090,Vasconcelos; Nuno,0,0,0,0
1653404987411,ECE 272B,A00,091091,Sworder; David D.,0,0,0,0
1653404988002,ECE 275A,A00,091092,Meyer; Florian,0,0,0,0
1653404988533,ECE 277,A00,091093,An; Cheolhong,0,0,0,0
1653404989060,ECE 283,A00,091094,Le; Hanh-Phuc,0,0,0,0
1653404989594,ECE 284,A00,091095,Kang; Mingu,0,0,0,0
1653404989594,ECE 284,B00,091096,Wang; Edward Jay,0,0,0,0
1653404990120,ECE 285,A00,094334,Touri; Behrouz,0,0,0,0
1653404990644,ECE 289,A00,091097,Whelan; David Arthur,0,0,0,0
1653404991169,MATH 200A,A00,087414,Salehi Golsefidy; Alireza,7,0,8,1
1653404991698,MATH 202A,A00,087415,Gill; Philip E.,3,0,8,5
1653404992223,MATH 203A,A00,087416,Oprea; Dragos N.,6,0,8,2
1653404992830,MATH 204A,A00,087417,Kedlaya; Kiran S.,6,0,8,2
1653404993360,MATH 205,A00,087418,Sorensen; Claus M,6,0,8,2
1653404993885,MATH 206A,A00,087419,Izadi; Elham,7,0,8,1
1653404994414,MATH 207A,A00,087420,Mohammadi; Amir,6,0,8,2
1653404994946,MATH 208,A00,087421,Staff,9,0,10,1
1653404995470,MATH 209,A00,087422,Staff,10,0,10,0
1653404995991,MATH 218,A00,087423,Staff,10,0,10,0
1653404996515,MATH 220A,A00,087424,Novak; Jonathan I,7,0,8,1
1653404997039,MATH 231A,A00,087425,Bejenaru; Ioan,4,0,8,4
1653404997562,MATH 240A,A00,087426,Ebenfelt; Peter F,5,0,8,3
1653404998091,MATH 243,A00,087427,Staff,9,0,10,1
1653404998614,MATH 248,A00,087429,Staff,10,0,10,0
1653404999144,MATH 250A,A00,087430,Spolaor; Luca,5,0,8,3
1653404999670,MATH 257A,A00,087431,Spolaor; Luca,7,0,8,1
1653405000198,MATH 258,A00,087432,Staff,9,0,10,1
1653405000726,MATH 264A,A00,087433,Warnke; Lutz Peter,5,0,8,3
1653405001249,MATH 268,A00,087434,Staff,15,0,15,0
1653405001775,MATH 269,A00,087435,Staff,14,0,15,1
1653405002324,MATH 270A,A00,087436,Nie; Jiawang,0,0,8,8
1653405002848,MATH 272A,A00,087437,Tian; Xiaochuan,2,0,8,6
1653405003372,MATH 274,A01,087439,Cheng; Li-Tien,9,0,10,1
1653405003372,MATH 274,A02,087440,Cheng; Li-Tien,10,0,10,0
1653405003897,MATH 278A,A00,087441,Staff,8,0,10,2
1653405004426,MATH 278B,A00,087442,Staff,8,0,10,2
1653405004963,MATH 278C,A00,087443,Staff,8,0,10,2
1653405005485,MATH 280A,A00,087444,Zheng; Tianyi,0,0,8,8
1653405006013,MATH 281A,A00,087445,Bradic; Jelena,0,0,8,8
1653405006539,MATH 282A,A00,087446,Zhang; Danna,0,0,8,8
1653405007076,MATH 283,A00,087447,Tesler; Glenn,0,0,0,13
1653405007598,MATH 286,A00,087448,Kemp; Todd Aahron,6,0,8,2
1653405008121,MATH 287D,A00,087449,Bradic; Jelena,8,0,8,0
1653405008646,MATH 288,A00,087450,Staff,14,0,15,1
1653405008646,MATH 288,B00,087451,Staff,15,0,15,0
1653405008646,MATH 288,C00,087452,Staff,15,0,15,0
1653405009172,MATH 290A,A00,087453,Xu; Zhouli,7,0,8,1
1653405009702,MATH 291A,A00,087454,Xu; Zhouli,7,0,8,1
1653405010230,MATH 292,A00,087455,Staff,10,0,10,0
1653405010752,MATH 295,A00,087456,Staff,50,0,50,0
1653405011274,MATH 297,001,087457,Staff,998,0,999,1
1653405570788,COGS 200,A01,087991,Staff,48,0,50,2
1653405571310,COGS 201,A01,094504,Rangel; Lara M,17,0,25,8
1653405571836,COGS 203,A00,087992,Coulson; Seana M,19,0,20,1
1653405572361,COGS 210A,001,087993,Greene; Deanna Jacquelyn,9998,0,9999,1
1653405572361,COGS 210A,002,087994,Saygin; Ayse P,9999,0,9999,0
1653405572361,COGS 210A,003,087995,Xia; Haijun,9999,0,9999,0
1653405572361,COGS 210A,004,087996,Nitz; Douglas A.,9999,0,9999,0
1653405572361,COGS 210A,005,087997,Hollan; James D.,9999,0,9999,0
1653405572361,COGS 210A,006,087998,Deak; Gedeon O.,9998,0,9999,1
1653405572361,COGS 210A,007,087999,Rossano; Federico,9999,0,9999,0
1653405572886,COGS 211A,A00,088000,Coulson; Seana M,9997,0,9999,2
1653405573409,COGS 229,A00,088002,Staff,23,0,25,2
1653405573932,COGS 260,B00,094231,Staff,17,0,20,3
1653405573932,COGS 260,A00,088004,Nitz; Douglas A.,9998,0,9999,1
1653405574475,CSE 202,A00,090110,Paturi; Ramamohan,0,0,0,0
1653405574475,CSE 202,B00,090111,Paturi; Ramamohan,0,0,0,0
1653405574999,CSE 207B,A00,090112,Heninger; Nadia A,0,0,0,0
1653405575531,CSE 208,A00,094858,Micciancio; Daniele,0,0,0,0
1653405576056,CSE 210,A00,090113,Powell; Thomas Allan,0,0,0,0
1653405576584,CSE 219,A00,090898,Staff,0,0,0,0
1653405577107,CSE 221,A00,090114,Zhou; Yuan-Yuan,0,0,0,0
1653405577634,CSE 229A,A00,090115,Porter; George M,0,0,0,0
1653405578164,CSE 229C,A00,090116,Savage; Stefan,0,0,0,0
1653405578687,CSE 230,A00,090117,Jhala; Ranjit,0,0,0,0
1653405579213,CSE 232,A00,090118,Papakonstantinou; Yannis,0,0,0,0
1653405579829,CSE 239A,A00,090121,Kumar; Arun Kumar,0,0,0,0
1653405580352,CSE 239B,A00,090122,Jhala; Ranjit,0,0,0,0
1653405580875,CSE 240A,A00,090123,Zhao; Jishen,0,0,189,189
1653405581399,CSE 243A,A00,090124,Orailoglu; Alex,3,0,15,12
1653405581922,CSE 249B,A00,090125,Kahng; Andrew Byun,14,0,20,6
1653405582444,CSE 250A,A00,090126,Berg-Kirkpatrick; Taylor D,0,0,0,0
1653405582987,CSE 252A,A00,090127,Ochoa; Benjamin Lawrence,0,0,0,0
1653405583511,CSE 258,A01,090129,McAuley; Julian John,0,0,0,0
1653405584034,CSE 258R,A01,090131,McAuley; Julian John,0,0,0,0
1653405584557,CSE 274,A00,090132,Ramamoorthi; Ravi,0,0,0,0
1653405585078,CSE 276A,A00,090133,Christensen; Henrik I,0,0,0,0
1653405585608,CSE 276C,A00,090134,Christensen; Henrik I,0,0,0,0
1653405586133,CSE 290,A00,090135,Bafna; Vineet,0,0,0,0
1653405586133,CSE 290,B00,090136,Ramamoorthi; Ravi,0,0,0,0
1653405586133,CSE 290,C00,090137,Li; Tzumao,10,0,10,0
1653405586133,CSE 290,D00,090138,Zhou; Yuan-Yuan,10,0,10,0
1653405586133,CSE 290,E00,090139,Christensen; Henrik I,10,0,10,0
1653405586133,CSE 290,F00,094053,Shalev; Aaron D,0,0,0,0
1653405586664,CSE 291,A00,090140,Munyaka; Imani N. S.,0,0,0,0
1653405586664,CSE 291,B00,094880,Yu; Qi,0,0,0,0
1653405586664,CSE 291,C00,090142,Pannuto; Patrick William,0,0,0,0
1653405586664,CSE 291,D00,094881,Zhang; Yiying,0,0,0,0
1653405586664,CSE 291,E00,095118,Su; Hao,0,0,0,0
1653405587196,CSE 293,001,094905,Bafna; Vineet,9999,0,9999,0
1653405587196,CSE 293,002,094906,Bellare; Mihir,9999,0,9999,0
1653405587196,CSE 293,003,094907,Berg-Kirkpatrick; Taylor D,9999,0,9999,0
1653405587196,CSE 293,004,094908,Christensen; Henrik I,9999,0,9999,0
1653405587196,CSE 293,005,094909,Cottrell; Garrison W,9999,0,9999,0
1653405587196,CSE 293,006,094910,Deutsch; Alin Bernard,9999,0,9999,0
1653405587196,CSE 293,007,094911,Esmaeilzadeh; Hadi,9999,0,9999,0
1653405587196,CSE 293,008,094912,Freund; Yoav,9999,0,9999,0
1653405587196,CSE 293,009,094913,Griswold; William G.,9999,0,9999,0
1653405587196,CSE 293,010,094914,Gymrek; Melissa Ann,9999,0,9999,0
1653405587196,CSE 293,011,094915,Heninger; Nadia A,9999,0,9999,0
1653405587196,CSE 293,012,094916,Impagliazzo; Russell,9999,0,9999,0
1653405587196,CSE 293,013,094917,Jhala; Ranjit,9999,0,9999,0
1653405587196,CSE 293,014,094918,Kahng; Andrew Byun,9999,0,9999,0
1653405587196,CSE 293,015,094919,Kane; Daniel Mertz,9999,0,9999,0
1653405587196,CSE 293,016,094920,Kriegman; David J,9999,0,9999,0
1653405587196,CSE 293,017,094921,Kumar; Arun Kumar,9999,0,9999,0
1653405587196,CSE 293,018,094922,Lerner; Sorin,9999,0,9999,0
1653405587196,CSE 293,019,094923,Lovett; Shachar,9999,0,9999,0
1653405587196,CSE 293,020,094924,McAuley; Julian John,9999,0,9999,0
1653405587196,CSE 293,021,094925,Micciancio; Daniele,9999,0,9999,0
1653405587196,CSE 293,022,094926,Orailoglu; Alex,9999,0,9999,0
1653405587196,CSE 293,023,094927,Paturi; Ramamohan,9999,0,9999,0
1653405587196,CSE 293,024,094928,Polikarpova; Nadezhda,9999,0,9999,0
1653405587196,CSE 293,025,094929,Politz; Joseph Gibbs,9999,0,9999,0
1653405587196,CSE 293,026,094930,Porter; George M,9999,0,9999,0
1653405587196,CSE 293,027,094931,Porter; Leonard Emerson,9999,0,9999,0
1653405587196,CSE 293,028,094932,Ramamoorthi; Ravi,9999,0,9999,0
1653405587196,CSE 293,029,094933,Sahoo; Debashis,9999,0,9999,0
1653405587196,CSE 293,030,094934,Saul; Lawrence,9999,0,9999,0
1653405587196,CSE 293,031,094935,Savage; Stefan,9999,0,9999,0
1653405587196,CSE 293,032,094936,Schulze; Jurgen P.,9999,0,9999,0
1653405587196,CSE 293,033,094937,Snoeren; Alex C.,9999,0,9999,0
1653405587196,CSE 293,034,094938,Shang; Jingbo,9999,0,9999,0
1653405587196,CSE 293,035,094939,Stefan; Deian,9999,0,9999,0
1653405587196,CSE 293,036,094940,Su; Hao,9999,0,9999,0
1653405587196,CSE 293,037,094941,Swanson; Steven James,9999,0,9999,0
1653405587196,CSE 293,038,094942,Tullsen; Dean Michael,9999,0,9999,0
1653405587196,CSE 293,039,094943,Voelker; Geoffrey M.,9999,0,9999,0
1653405587196,CSE 293,040,094944,Zhao; Jishen,9999,0,9999,0
1653405587196,CSE 293,041,094945,Zhou; Yuan-Yuan,9999,0,9999,0
1653405587196,CSE 293,042,094946,Gao; Sicun,9998,0,9999,1
1653405587196,CSE 293,043,094947,Weibel; Nadir,9999,0,9999,0
1653405587196,CSE 293,044,094948,Gupta; Rajesh K.,9999,0,9999,0
1653405587719,CSE 294,A00,090143,Porter; George M,9,0,10,1
1653405588247,DSE 200,A00,091799,Staff,50,0,50,0
1653405588774,DSE 203,A00,091800,Gupta; Amarnath,30,0,30,0
1653405589296,DSE 250,A00,091801,Deutsch; Alin Bernard,30,0,30,0
1653405589820,DSE 290,A00,091802,Altintas De Callaf; Ilkay,50,0,50,0
1653405590369,ECE 200,001,091003,Antipa; Nicholas A,9999,0,9999,0
1653405590369,ECE 200,002,091004,Atanasov; Nikolay A.,9999,0,9999,0
1653405590369,ECE 200,003,091005,Bharadia; Dinesh,9999,0,9999,0
1653405590369,ECE 200,004,091006,Cheng; Chung Kuan,9999,0,9999,0
1653405590369,ECE 200,005,091007,Cosman; Pamela C.,9999,0,9999,0
1653405590369,ECE 200,006,091008,Staff,9999,0,9999,0
1653405590369,ECE 200,007,091009,Dayeh; Shadi Ahmad,9999,0,9999,0
1653405590369,ECE 200,008,091010,Fainman; Yeshaiahu,9999,0,9999,0
1653405590369,ECE 200,009,091011,Ford; Joseph Earl,9999,0,9999,0
1653405590369,ECE 200,010,091012,Franceschetti; Massimo,9999,0,9999,0
1653405590369,ECE 200,011,091013,Fullerton; Eric E,9999,0,9999,0
1653405590369,ECE 200,012,091014,Galton; Ian A,9999,0,9999,0
1653405590369,ECE 200,013,091015,Gilja; Vikash,9999,0,9999,0
1653405590369,ECE 200,014,091016,Hall; Drew A.,9999,0,9999,0
1653405590369,ECE 200,015,091017,Hsueh; Tzu-Chien,9999,0,9999,0
1653405590369,ECE 200,016,091018,Javidi; Tara,9999,0,9999,0
1653405590369,ECE 200,017,091019,Kahng; Andrew Byun,9999,0,9999,0
1653405590369,ECE 200,018,091020,Kim; Young-Han,9999,0,9999,0
1653405590369,ECE 200,019,091021,Koushanfar; Farinaz,9999,0,9999,0
1653405590369,ECE 200,020,091022,Kuzum; Duygu,9999,0,9999,0
1653405590369,ECE 200,021,091023,Le; Hanh-Phuc,9999,0,9999,0
1653405590369,ECE 200,022,091024,Lin; Bill,9999,0,9999,0
1653405590369,ECE 200,023,091025,Liu; Zhaowei,9999,0,9999,0
1653405590369,ECE 200,024,091026,Lo; Yu-Hwa,9999,0,9999,0
1653405590369,ECE 200,025,091027,Lomakin; Vitaliy,9999,0,9999,0
1653405590369,ECE 200,026,091028,Mercier; Patrick Philip,9999,0,9999,0
1653405590369,ECE 200,027,091029,Meyer; Florian,9999,0,9999,0
1653405590369,ECE 200,028,091030,Milstein; Laurence B.,9999,0,9999,0
1653405590369,ECE 200,029,091031,Mir Arabbaygi; Siavash,9999,0,9999,0
1653405590369,ECE 200,030,091032,Mookherjea; Shayan,9999,0,9999,0
1653405590369,ECE 200,031,091033,Morris; Karcher William,9999,0,9999,0
1653405590369,ECE 200,032,091034,Ng; Tse Nga,9999,0,9999,0
1653405590369,ECE 200,033,091035,Nguyen; Truong Quang,9999,0,9999,0
1653405590369,ECE 200,034,091036,Nomura; Kenji,9999,0,9999,0
1653405590369,ECE 200,035,091037,Orlitsky; Alon,9999,0,9999,0
1653405590369,ECE 200,036,091038,Pal; Piya,9999,0,9999,0
1653405590369,ECE 200,037,091039,Papen; George C.,9999,0,9999,0
1653405590369,ECE 200,038,091040,Radic; Stojan,9999,0,9999,0
1653405590369,ECE 200,039,091041,Rao; Bhaskar D.,9999,0,9999,0
1653405590369,ECE 200,040,091042,Rao; Ramesh R,9999,0,9999,0
1653405590369,ECE 200,041,091043,Rebeiz; Gabriel,9999,0,9999,0
1653405590369,ECE 200,042,091044,Sanford; John R,9999,0,9999,0
1653405590369,ECE 200,043,091045,Siegel; Paul H.,9999,0,9999,0
1653405590369,ECE 200,044,091046,Sievenpiper; Daniel F.,9999,0,9999,0
1653405590369,ECE 200,045,091047,Sworder; David D.,9999,0,9999,0
1653405590369,ECE 200,046,091048,Taur; Yuan,9999,0,9999,0
1653405590369,ECE 200,047,091049,Touri; Behrouz,9999,0,9999,0
1653405590369,ECE 200,048,091050,Trivedi; Mohan M.,9999,0,9999,0
1653405590369,ECE 200,049,091051,Vardy; Alexander,9999,0,9999,0
1653405590369,ECE 200,050,091052,Vasconcelos; Nuno,9999,0,9999,0
1653405590369,ECE 200,051,091053,Wang; Xiaolong,9999,0,9999,0
1653405590369,ECE 200,052,091054,Xie; Pengtao,9999,0,9999,0
1653405590369,ECE 200,053,091055,Yip; Michael,9999,0,9999,0
1653405590369,ECE 200,054,091056,Zeger; Kenneth A.,9999,0,9999,0
1653405590369,ECE 200,055,091057,Zhang; Xinyu,9999,0,9999,0
1653405590369,ECE 200,056,091058,Turakhia; Yatish Girish,9999,0,9999,0
1653405590369,ECE 200,057,091059,Kang; Mingu,9999,0,9999,0
1653405590369,ECE 200,058,091060,Shi; Yuanyuan,9999,0,9999,0
1653405590369,ECE 200,059,091061,Wang; Edward Jay,9999,0,9999,0
1653405590369,ECE 200,060,091062,Zheng; Yang,9999,0,9999,0
1653405590898,ECE 203,A00,091065,Mercier; Patrick Philip,0,0,0,0
1653405591422,ECE 207A,A00,091605,Liu; Thomas Tao-Ming,0,0,0,0
1653405591952,ECE 212AN,A00,091068,Nomura; Kenji,0,0,0,0
1653405592473,ECE 222A,A00,091069,Rebeiz; Gabriel,0,0,0,0
1653405592996,ECE 225A,A00,091070,Orlitsky; Alon,0,0,0,0
1653405593517,ECE 230A,A00,091071,Nomura; Kenji,0,0,0,0
1653405594051,ECE 236A,A00,091072,Dayeh; Shadi Ahmad,0,0,0,0
1653405594589,ECE 238A,A00,091073,Luo; Jian,0,0,0,0
1653405594589,ECE 238A,B00,091074,Luo; Jian,0,0,0,0
1653405595114,ECE 240A,A00,091075,Radic; Stojan,0,0,0,0
1653405595641,ECE 247A,A00,091592,Shi; Lingyan,0,0,0,0
1653405596163,ECE 250,A00,091076,Touri; Behrouz,0,0,0,0
1653405596689,ECE 251C,A00,091078,Nguyen; Truong Quang,0,0,0,0
1653405597213,ECE 253,A00,091079,Cosman; Pamela C.,0,0,0,0
1653405597738,ECE 255A,A00,091080,Orlitsky; Alon,0,0,0,0
1653405598262,ECE 257A,A00,091081,Zhang; Xinyu,0,0,0,0
1653405598785,ECE 260A,A01,091084,Eldon; John,0,0,0,0
1653405599308,ECE 264C,A00,091085,Galton; Ian A,0,0,0,0
1653405599830,ECE 265C,A00,094889,Presti; Calogero Davide,0,0,0,9
1653405600353,ECE 266,A01,091087,Hall; Drew A.,0,0,0,0
1653405601538,ECE 271A,A00,091090,Vasconcelos; Nuno,0,0,0,0
1653405602069,ECE 272B,A00,091091,Sworder; David D.,0,0,0,0
1653405602603,ECE 275A,A00,091092,Meyer; Florian,0,0,0,0
1653405603126,ECE 277,A00,091093,An; Cheolhong,0,0,0,0
1653405603649,ECE 283,A00,091094,Le; Hanh-Phuc,0,0,0,0
1653405604176,ECE 284,A00,091095,Kang; Mingu,0,0,0,0
1653405604176,ECE 284,B00,091096,Wang; Edward Jay,0,0,0,0
1653405604699,ECE 285,A00,094334,Touri; Behrouz,0,0,0,0
1653405605223,ECE 289,A00,091097,Whelan; David Arthur,0,0,0,0
1653405605748,MATH 200A,A00,087414,Salehi Golsefidy; Alireza,7,0,8,1
1653405606270,MATH 202A,A00,087415,Gill; Philip E.,3,0,8,5
1653405606799,MATH 203A,A00,087416,Oprea; Dragos N.,6,0,8,2
1653405607326,MATH 204A,A00,087417,Kedlaya; Kiran S.,6,0,8,2
1653405607853,MATH 205,A00,087418,Sorensen; Claus M,6,0,8,2
1653405608378,MATH 206A,A00,087419,Izadi; Elham,7,0,8,1
1653405608906,MATH 207A,A00,087420,Mohammadi; Amir,6,0,8,2
1653405609428,MATH 208,A00,087421,Staff,9,0,10,1
1653405609951,MATH 209,A00,087422,Staff,10,0,10,0
1653405610473,MATH 218,A00,087423,Staff,10,0,10,0
1653405611009,MATH 220A,A00,087424,Novak; Jonathan I,7,0,8,1
1653405611544,MATH 231A,A00,087425,Bejenaru; Ioan,4,0,8,4
1653405612071,MATH 240A,A00,087426,Ebenfelt; Peter F,5,0,8,3
1653405612601,MATH 243,A00,087427,Staff,9,0,10,1
1653405613122,MATH 248,A00,087429,Staff,10,0,10,0
1653405613647,MATH 250A,A00,087430,Spolaor; Luca,5,0,8,3
1653405614168,MATH 257A,A00,087431,Spolaor; Luca,7,0,8,1
1653405614696,MATH 258,A00,087432,Staff,9,0,10,1
1653405615230,MATH 264A,A00,087433,Warnke; Lutz Peter,5,0,8,3
1653405615754,MATH 268,A00,087434,Staff,15,0,15,0
1653405616276,MATH 269,A00,087435,Staff,14,0,15,1
1653405616801,MATH 270A,A00,087436,Nie; Jiawang,0,0,8,8
1653405617334,MATH 272A,A00,087437,Tian; Xiaochuan,2,0,8,6
1653405617858,MATH 274,A01,087439,Cheng; Li-Tien,9,0,10,1
1653405617858,MATH 274,A02,087440,Cheng; Li-Tien,10,0,10,0
1653405618380,MATH 278A,A00,087441,Staff,8,0,10,2
1653405618904,MATH 278B,A00,087442,Staff,8,0,10,2
1653405619426,MATH 278C,A00,087443,Staff,8,0,10,2
1653405619952,MATH 280A,A00,087444,Zheng; Tianyi,0,0,8,8
1653405620475,MATH 281A,A00,087445,Bradic; Jelena,0,0,8,8
1653405620996,MATH 282A,A00,087446,Zhang; Danna,0,0,8,8
1653405621520,MATH 283,A00,087447,Tesler; Glenn,0,0,0,13
1653405622041,MATH 286,A00,087448,Kemp; Todd Aahron,6,0,8,2
1653405622564,MATH 287D,A00,087449,Bradic; Jelena,8,0,8,0
1653405623087,MATH 288,A00,087450,Staff,14,0,15,1
1653405623087,MATH 288,B00,087451,Staff,15,0,15,0
1653405623087,MATH 288,C00,087452,Staff,15,0,15,0
1653405623611,MATH 290A,A00,087453,Xu; Zhouli,7,0,8,1
1653405624140,MATH 291A,A00,087454,Xu; Zhouli,7,0,8,1
1653405624668,MATH 292,A00,087455,Staff,10,0,10,0
1653405625190,MATH 295,A00,087456,Staff,50,0,50,0
1653405625711,MATH 297,001,087457,Staff,998,0,999,1
1653406185816,COGS 200,A01,087991,Staff,48,0,50,2
1653406186337,COGS 201,A01,094504,Rangel; Lara M,17,0,25,8
1653406186862,COGS 203,A00,087992,Coulson; Seana M,19,0,20,1
1653406187390,COGS 210A,001,087993,Greene; Deanna Jacquelyn,9998,0,9999,1
1653406187390,COGS 210A,002,087994,Saygin; Ayse P,9999,0,9999,0
1653406187390,COGS 210A,003,087995,Xia; Haijun,9999,0,9999,0
1653406187390,COGS 210A,004,087996,Nitz; Douglas A.,9999,0,9999,0
1653406187390,COGS 210A,005,087997,Hollan; James D.,9999,0,9999,0
1653406187390,COGS 210A,006,087998,Deak; Gedeon O.,9998,0,9999,1
1653406187390,COGS 210A,007,087999,Rossano; Federico,9999,0,9999,0
1653406187916,COGS 211A,A00,088000,Coulson; Seana M,9997,0,9999,2
1653406188445,COGS 229,A00,088002,Staff,23,0,25,2
1653406188972,COGS 260,B00,094231,Staff,17,0,20,3
1653406188972,COGS 260,A00,088004,Nitz; Douglas A.,9998,0,9999,1
1653406189494,CSE 202,A00,090110,Paturi; Ramamohan,0,0,0,0
1653406189494,CSE 202,B00,090111,Paturi; Ramamohan,0,0,0,0
1653406190017,CSE 207B,A00,090112,Heninger; Nadia A,0,0,0,0
1653406190540,CSE 208,A00,094858,Micciancio; Daniele,0,0,0,0
1653406191061,CSE 210,A00,090113,Powell; Thomas Allan,0,0,0,0
1653406191587,CSE 219,A00,090898,Staff,0,0,0,0
1653406192112,CSE 221,A00,090114,Zhou; Yuan-Yuan,0,0,0,0
1653406192636,CSE 229A,A00,090115,Porter; George M,0,0,0,0
1653406193161,CSE 229C,A00,090116,Savage; Stefan,0,0,0,0
1653406193689,CSE 230,A00,090117,Jhala; Ranjit,0,0,0,0
1653406194212,CSE 232,A00,090118,Papakonstantinou; Yannis,0,0,0,0
1653406194735,CSE 239A,A00,090121,Kumar; Arun Kumar,0,0,0,0
1653406195257,CSE 239B,A00,090122,Jhala; Ranjit,0,0,0,0
1653406195780,CSE 240A,A00,090123,Zhao; Jishen,0,0,189,189
1653406196306,CSE 243A,A00,090124,Orailoglu; Alex,3,0,15,12
1653406196830,CSE 249B,A00,090125,Kahng; Andrew Byun,14,0,20,6
1653406197356,CSE 250A,A00,090126,Berg-Kirkpatrick; Taylor D,0,0,0,0
1653406197889,CSE 252A,A00,090127,Ochoa; Benjamin Lawrence,0,0,0,0
1653406198412,CSE 258,A01,090129,McAuley; Julian John,0,0,0,0
1653406198937,CSE 258R,A01,090131,McAuley; Julian John,0,0,0,0
1653406199460,CSE 274,A00,090132,Ramamoorthi; Ravi,0,0,0,0
1653406199986,CSE 276A,A00,090133,Christensen; Henrik I,0,0,0,0
1653406200643,CSE 276C,A00,090134,Christensen; Henrik I,0,0,0,0
1653406201173,CSE 290,A00,090135,Bafna; Vineet,0,0,0,0
1653406201173,CSE 290,B00,090136,Ramamoorthi; Ravi,0,0,0,0
1653406201173,CSE 290,C00,090137,Li; Tzumao,10,0,10,0
1653406201173,CSE 290,D00,090138,Zhou; Yuan-Yuan,10,0,10,0
1653406201173,CSE 290,E00,090139,Christensen; Henrik I,10,0,10,0
1653406201173,CSE 290,F00,094053,Shalev; Aaron D,0,0,0,0
1653406201702,CSE 291,A00,090140,Munyaka; Imani N. S.,0,0,0,0
1653406201702,CSE 291,B00,094880,Yu; Qi,0,0,0,0
1653406201702,CSE 291,C00,090142,Pannuto; Patrick William,0,0,0,0
1653406201702,CSE 291,D00,094881,Zhang; Yiying,0,0,0,0
1653406201702,CSE 291,E00,095118,Su; Hao,0,0,0,0
1653406202242,CSE 293,001,094905,Bafna; Vineet,9999,0,9999,0
1653406202242,CSE 293,002,094906,Bellare; Mihir,9999,0,9999,0
1653406202242,CSE 293,003,094907,Berg-Kirkpatrick; Taylor D,9999,0,9999,0
1653406202242,CSE 293,004,094908,Christensen; Henrik I,9999,0,9999,0
1653406202242,CSE 293,005,094909,Cottrell; Garrison W,9999,0,9999,0
1653406202242,CSE 293,006,094910,Deutsch; Alin Bernard,9999,0,9999,0
1653406202242,CSE 293,007,094911,Esmaeilzadeh; Hadi,9999,0,9999,0
1653406202242,CSE 293,008,094912,Freund; Yoav,9999,0,9999,0
1653406202242,CSE 293,009,094913,Griswold; William G.,9999,0,9999,0
1653406202242,CSE 293,010,094914,Gymrek; Melissa Ann,9999,0,9999,0
1653406202242,CSE 293,011,094915,Heninger; Nadia A,9999,0,9999,0
1653406202242,CSE 293,012,094916,Impagliazzo; Russell,9999,0,9999,0
1653406202242,CSE 293,013,094917,Jhala; Ranjit,9999,0,9999,0
1653406202242,CSE 293,014,094918,Kahng; Andrew Byun,9999,0,9999,0
1653406202242,CSE 293,015,094919,Kane; Daniel Mertz,9999,0,9999,0
1653406202242,CSE 293,016,094920,Kriegman; David J,9999,0,9999,0
1653406202242,CSE 293,017,094921,Kumar; Arun Kumar,9999,0,9999,0
1653406202242,CSE 293,018,094922,Lerner; Sorin,9999,0,9999,0
1653406202242,CSE 293,019,094923,Lovett; Shachar,9999,0,9999,0
1653406202242,CSE 293,020,094924,McAuley; Julian John,9999,0,9999,0
1653406202242,CSE 293,021,094925,Micciancio; Daniele,9999,0,9999,0
1653406202242,CSE 293,022,094926,Orailoglu; Alex,9999,0,9999,0
1653406202242,CSE 293,023,094927,Paturi; Ramamohan,9999,0,9999,0
1653406202242,CSE 293,024,094928,Polikarpova; Nadezhda,9999,0,9999,0
1653406202242,CSE 293,025,094929,Politz; Joseph Gibbs,9999,0,9999,0
1653406202242,CSE 293,026,094930,Porter; George M,9999,0,9999,0
1653406202242,CSE 293,027,094931,Porter; Leonard Emerson,9999,0,9999,0
1653406202242,CSE 293,028,094932,Ramamoorthi; Ravi,9999,0,9999,0
1653406202242,CSE 293,029,094933,Sahoo; Debashis,9999,0,9999,0
1653406202242,CSE 293,030,094934,Saul; Lawrence,9999,0,9999,0
1653406202242,CSE 293,031,094935,Savage; Stefan,9999,0,9999,0
1653406202242,CSE 293,032,094936,Schulze; Jurgen P.,9999,0,9999,0
1653406202242,CSE 293,033,094937,Snoeren; Alex C.,9999,0,9999,0
1653406202242,CSE 293,034,094938,Shang; Jingbo,9999,0,9999,0
1653406202242,CSE 293,035,094939,Stefan; Deian,9999,0,9999,0
1653406202242,CSE 293,036,094940,Su; Hao,9999,0,9999,0
1653406202242,CSE 293,037,094941,Swanson; Steven James,9999,0,9999,0
1653406202242,CSE 293,038,094942,Tullsen; Dean Michael,9999,0,9999,0
1653406202242,CSE 293,039,094943,Voelker; Geoffrey M.,9999,0,9999,0
1653406202242,CSE 293,040,094944,Zhao; Jishen,9999,0,9999,0
1653406202242,CSE 293,041,094945,Zhou; Yuan-Yuan,9999,0,9999,0
1653406202242,CSE 293,042,094946,Gao; Sicun,9998,0,9999,1
1653406202242,CSE 293,043,094947,Weibel; Nadir,9999,0,9999,0
1653406202242,CSE 293,044,094948,Gupta; Rajesh K.,9999,0,9999,0
1653406202767,CSE 294,A00,090143,Porter; George M,9,0,10,1
1653406203292,DSE 200,A00,091799,Staff,50,0,50,0
1653406203815,DSE 203,A00,091800,Gupta; Amarnath,30,0,30,0
1653406204338,DSE 250,A00,091801,Deutsch; Alin Bernard,30,0,30,0
1653406204872,DSE 290,A00,091802,Altintas De Callaf; Ilkay,50,0,50,0
1653406205412,ECE 200,001,091003,Antipa; Nicholas A,9999,0,9999,0
1653406205412,ECE 200,002,091004,Atanasov; Nikolay A.,9999,0,9999,0
1653406205412,ECE 200,003,091005,Bharadia; Dinesh,9999,0,9999,0
1653406205412,ECE 200,004,091006,Cheng; Chung Kuan,9999,0,9999,0
1653406205412,ECE 200,005,091007,Cosman; Pamela C.,9999,0,9999,0
1653406205412,ECE 200,006,091008,Staff,9999,0,9999,0
1653406205412,ECE 200,007,091009,Dayeh; Shadi Ahmad,9999,0,9999,0
1653406205412,ECE 200,008,091010,Fainman; Yeshaiahu,9999,0,9999,0
1653406205412,ECE 200,009,091011,Ford; Joseph Earl,9999,0,9999,0
1653406205412,ECE 200,010,091012,Franceschetti; Massimo,9999,0,9999,0
1653406205412,ECE 200,011,091013,Fullerton; Eric E,9999,0,9999,0
1653406205412,ECE 200,012,091014,Galton; Ian A,9999,0,9999,0
1653406205412,ECE 200,013,091015,Gilja; Vikash,9999,0,9999,0
1653406205412,ECE 200,014,091016,Hall; Drew A.,9999,0,9999,0
1653406205412,ECE 200,015,091017,Hsueh; Tzu-Chien,9999,0,9999,0
1653406205412,ECE 200,016,091018,Javidi; Tara,9999,0,9999,0
1653406205412,ECE 200,017,091019,Kahng; Andrew Byun,9999,0,9999,0
1653406205412,ECE 200,018,091020,Kim; Young-Han,9999,0,9999,0
1653406205412,ECE 200,019,091021,Koushanfar; Farinaz,9999,0,9999,0
1653406205412,ECE 200,020,091022,Kuzum; Duygu,9999,0,9999,0
1653406205412,ECE 200,021,091023,Le; Hanh-Phuc,9999,0,9999,0
1653406205412,ECE 200,022,091024,Lin; Bill,9999,0,9999,0
1653406205412,ECE 200,023,091025,Liu; Zhaowei,9999,0,9999,0
1653406205412,ECE 200,024,091026,Lo; Yu-Hwa,9999,0,9999,0
1653406205412,ECE 200,025,091027,Lomakin; Vitaliy,9999,0,9999,0
1653406205412,ECE 200,026,091028,Mercier; Patrick Philip,9999,0,9999,0
1653406205412,ECE 200,027,091029,Meyer; Florian,9999,0,9999,0
1653406205412,ECE 200,028,091030,Milstein; Laurence B.,9999,0,9999,0
1653406205412,ECE 200,029,091031,Mir Arabbaygi; Siavash,9999,0,9999,0
1653406205412,ECE 200,030,091032,Mookherjea; Shayan,9999,0,9999,0
1653406205412,ECE 200,031,091033,Morris; Karcher William,9999,0,9999,0
1653406205412,ECE 200,032,091034,Ng; Tse Nga,9999,0,9999,0
1653406205412,ECE 200,033,091035,Nguyen; Truong Quang,9999,0,9999,0
1653406205412,ECE 200,034,091036,Nomura; Kenji,9999,0,9999,0
1653406205412,ECE 200,035,091037,Orlitsky; Alon,9999,0,9999,0
1653406205412,ECE 200,036,091038,Pal; Piya,9999,0,9999,0
1653406205412,ECE 200,037,091039,Papen; George C.,9999,0,9999,0
1653406205412,ECE 200,038,091040,Radic; Stojan,9999,0,9999,0
1653406205412,ECE 200,039,091041,Rao; Bhaskar D.,9999,0,9999,0
1653406205412,ECE 200,040,091042,Rao; Ramesh R,9999,0,9999,0
1653406205412,ECE 200,041,091043,Rebeiz; Gabriel,9999,0,9999,0
1653406205412,ECE 200,042,091044,Sanford; John R,9999,0,9999,0
1653406205412,ECE 200,043,091045,Siegel; Paul H.,9999,0,9999,0
1653406205412,ECE 200,044,091046,Sievenpiper; Daniel F.,9999,0,9999,0
1653406205412,ECE 200,045,091047,Sworder; David D.,9999,0,9999,0
1653406205412,ECE 200,046,091048,Taur; Yuan,9999,0,9999,0
1653406205412,ECE 200,047,091049,Touri; Behrouz,9999,0,9999,0
1653406205412,ECE 200,048,091050,Trivedi; Mohan M.,9999,0,9999,0
1653406205412,ECE 200,049,091051,Vardy; Alexander,9999,0,9999,0
1653406205412,ECE 200,050,091052,Vasconcelos; Nuno,9999,0,9999,0
1653406205412,ECE 200,051,091053,Wang; Xiaolong,9999,0,9999,0
1653406205412,ECE 200,052,091054,Xie; Pengtao,9999,0,9999,0
1653406205412,ECE 200,053,091055,Yip; Michael,9999,0,9999,0
1653406205412,ECE 200,054,091056,Zeger; Kenneth A.,9999,0,9999,0
1653406205412,ECE 200,055,091057,Zhang; Xinyu,9999,0,9999,0
1653406205412,ECE 200,056,091058,Turakhia; Yatish Girish,9999,0,9999,0
1653406205412,ECE 200,057,091059,Kang; Mingu,9999,0,9999,0
1653406205412,ECE 200,058,091060,Shi; Yuanyuan,9999,0,9999,0
1653406205412,ECE 200,059,091061,Wang; Edward Jay,9999,0,9999,0
1653406205412,ECE 200,060,091062,Zheng; Yang,9999,0,9999,0
1653406205934,ECE 203,A00,091065,Mercier; Patrick Philip,0,0,0,0
1653406206464,ECE 207A,A00,091605,Liu; Thomas Tao-Ming,0,0,0,0
1653406206994,ECE 212AN,A00,091068,Nomura; Kenji,0,0,0,0
1653406207515,ECE 222A,A00,091069,Rebeiz; Gabriel,0,0,0,0
1653406208041,ECE 225A,A00,091070,Orlitsky; Alon,0,0,0,0
1653406208567,ECE 230A,A00,091071,Nomura; Kenji,0,0,0,0
1653406209095,ECE 236A,A00,091072,Dayeh; Shadi Ahmad,0,0,0,0
1653406209618,ECE 238A,A00,091073,Luo; Jian,0,0,0,0
1653406209618,ECE 238A,B00,091074,Luo; Jian,0,0,0,0
1653406210159,ECE 240A,A00,091075,Radic; Stojan,0,0,0,0
1653406210694,ECE 247A,A00,091592,Shi; Lingyan,0,0,0,0
1653406211226,ECE 250,A00,091076,Touri; Behrouz,0,0,0,0
1653406211776,ECE 251C,A00,091078,Nguyen; Truong Quang,0,0,0,0
1653406212333,ECE 253,A00,091079,Cosman; Pamela C.,0,0,0,0
1653406212862,ECE 255A,A00,091080,Orlitsky; Alon,0,0,0,0
1653406213385,ECE 257A,A00,091081,Zhang; Xinyu,0,0,0,0
1653406213908,ECE 260A,A01,091084,Eldon; John,0,0,0,0
1653406214433,ECE 264C,A00,091085,Galton; Ian A,0,0,0,0
1653406214956,ECE 265C,A00,094889,Presti; Calogero Davide,0,0,0,9
1653406215484,ECE 266,A01,091087,Hall; Drew A.,0,0,0,0
1653406216530,ECE 271A,A00,091090,Vasconcelos; Nuno,0,0,0,0
1653406217056,ECE 272B,A00,091091,Sworder; David D.,0,0,0,0
1653406217580,ECE 275A,A00,091092,Meyer; Florian,0,0,0,0
1653406218101,ECE 277,A00,091093,An; Cheolhong,0,0,0,0
1653406218625,ECE 283,A00,091094,Le; Hanh-Phuc,0,0,0,0
1653406219152,ECE 284,A00,091095,Kang; Mingu,0,0,0,0
1653406219152,ECE 284,B00,091096,Wang; Edward Jay,0,0,0,0
1653406219675,ECE 285,A00,094334,Touri; Behrouz,0,0,0,0
1653406220198,ECE 289,A00,091097,Whelan; David Arthur,0,0,0,0
1653406220805,MATH 200A,A00,087414,Salehi Golsefidy; Alireza,7,0,8,1
1653406221327,MATH 202A,A00,087415,Gill; Philip E.,3,0,8,5
1653406221861,MATH 203A,A00,087416,Oprea; Dragos N.,6,0,8,2
1653406222383,MATH 204A,A00,087417,Kedlaya; Kiran S.,6,0,8,2
1653406222906,MATH 205,A00,087418,Sorensen; Claus M,6,0,8,2
1653406223429,MATH 206A,A00,087419,Izadi; Elham,7,0,8,1
1653406223972,MATH 207A,A00,087420,Mohammadi; Amir,6,0,8,2
1653406224493,MATH 208,A00,087421,Staff,9,0,10,1
1653406225019,MATH 209,A00,087422,Staff,10,0,10,0
1653406225552,MATH 218,A00,087423,Staff,10,0,10,0
1653406226076,MATH 220A,A00,087424,Novak; Jonathan I,7,0,8,1
1653406226603,MATH 231A,A00,087425,Bejenaru; Ioan,4,0,8,4
1653406227131,MATH 240A,A00,087426,Ebenfelt; Peter F,5,0,8,3
1653406227656,MATH 243,A00,087427,Staff,9,0,10,1
1653406228181,MATH 248,A00,087429,Staff,10,0,10,0
1653406228715,MATH 250A,A00,087430,Spolaor; Luca,5,0,8,3
1653406229243,MATH 257A,A00,087431,Spolaor; Luca,7,0,8,1
1653406229766,MATH 258,A00,087432,Staff,9,0,10,1
1653406230291,MATH 264A,A00,087433,Warnke; Lutz Peter,5,0,8,3
1653406230812,MATH 268,A00,087434,Staff,15,0,15,0
1653406231334,MATH 269,A00,087435,Staff,14,0,15,1
1653406231856,MATH 270A,A00,087436,Nie; Jiawang,0,0,8,8
1653406232383,MATH 272A,A00,087437,Tian; Xiaochuan,2,0,8,6
1653406232912,MATH 274,A01,087439,Cheng; Li-Tien,9,0,10,1
1653406232912,MATH 274,A02,087440,Cheng; Li-Tien,10,0,10,0
1653406233436,MATH 278A,A00,087441,Staff,8,0,10,2
1653406233961,MATH 278B,A00,087442,Staff,8,0,10,2
1653406234485,MATH 278C,A00,087443,Staff,8,0,10,2
1653406235012,MATH 280A,A00,087444,Zheng; Tianyi,0,0,8,8
1653406235549,MATH 281A,A00,087445,Bradic; Jelena,0,0,8,8
1653406236074,MATH 282A,A00,087446,Zhang; Danna,0,0,8,8
1653406236596,MATH 283,A00,087447,Tesler; Glenn,0,0,0,13
1653406237118,MATH 286,A00,087448,Kemp; Todd Aahron,6,0,8,2
1653406237643,MATH 287D,A00,087449,Bradic; Jelena,8,0,8,0
1653406238165,MATH 288,A00,087450,Staff,14,0,15,1
1653406238165,MATH 288,B00,087451,Staff,15,0,15,0
1653406238165,MATH 288,C00,087452,Staff,15,0,15,0
1653406238689,MATH 290A,A00,087453,Xu; Zhouli,7,0,8,1
1653406239215,MATH 291A,A00,087454,Xu; Zhouli,7,0,8,1
1653406239739,MATH 292,A00,087455,Staff,10,0,10,0
1653406240261,MATH 295,A00,087456,Staff,50,0,50,0
1653406240784,MATH 297,001,087457,Staff,998,0,999,1
1653406801669,COGS 200,A01,087991,Staff,48,0,50,2
1653406802203,COGS 201,A01,094504,Rangel; Lara M,17,0,25,8
1653406802730,COGS 203,A00,087992,Coulson; Seana M,19,0,20,1
1653406803266,COGS 210A,001,087993,Greene; Deanna Jacquelyn,9998,0,9999,1
1653406803266,COGS 210A,002,087994,Saygin; Ayse P,9999,0,9999,0
1653406803266,COGS 210A,003,087995,Xia; Haijun,9999,0,9999,0
1653406803266,COGS 210A,004,087996,Nitz; Douglas A.,9999,0,9999,0
1653406803266,COGS 210A,005,087997,Hollan; James D.,9999,0,9999,0
1653406803266,COGS 210A,006,087998,Deak; Gedeon O.,9998,0,9999,1
1653406803266,COGS 210A,007,087999,Rossano; Federico,9999,0,9999,0
1653406803796,COGS 211A,A00,088000,Coulson; Seana M,9997,0,9999,2
1653406804322,COGS 229,A00,088002,Staff,23,0,25,2
1653406804855,COGS 260,B00,094231,Staff,17,0,20,3
1653406804855,COGS 260,A00,088004,Nitz; Douglas A.,9998,0,9999,1
1653406805379,CSE 202,A00,090110,Paturi; Ramamohan,0,0,0,0
1653406805379,CSE 202,B00,090111,Paturi; Ramamohan,0,0,0,0
1653406805913,CSE 207B,A00,090112,Heninger; Nadia A,0,0,0,0
1653406806448,CSE 208,A00,094858,Micciancio; Daniele,0,0,0,0
1653406806971,CSE 210,A00,090113,Powell; Thomas Allan,0,0,0,0
1653406807492,CSE 219,A00,090898,Staff,0,0,0,0
1653406808029,CSE 221,A00,090114,Zhou; Yuan-Yuan,0,0,0,0
1653406808556,CSE 229A,A00,090115,Porter; George M,0,0,0,0
1653406809154,CSE 229C,A00,090116,Savage; Stefan,0,0,0,0
1653406809676,CSE 230,A00,090117,Jhala; Ranjit,0,0,0,0
1653406810198,CSE 232,A00,090118,Papakonstantinou; Yannis,0,0,0,0
1653406810782,CSE 239A,A00,090121,Kumar; Arun Kumar,0,0,0,0
1653406811307,CSE 239B,A00,090122,Jhala; Ranjit,0,0,0,0
1653406811838,CSE 240A,A00,090123,Zhao; Jishen,0,0,189,189
1653406812363,CSE 243A,A00,090124,Orailoglu; Alex,3,0,15,12
1653406812894,CSE 249B,A00,090125,Kahng; Andrew Byun,14,0,20,6
1653406813418,CSE 250A,A00,090126,Berg-Kirkpatrick; Taylor D,0,0,0,0
1653406813946,CSE 252A,A00,090127,Ochoa; Benjamin Lawrence,0,0,0,0
1653406814485,CSE 258,A01,090129,McAuley; Julian John,0,0,0,0
1653406815007,CSE 258R,A01,090131,McAuley; Julian John,0,0,0,0
1653406815541,CSE 274,A00,090132,Ramamoorthi; Ravi,0,0,0,0
1653406816063,CSE 276A,A00,090133,Christensen; Henrik I,0,0,0,0
1653406816590,CSE 276C,A00,090134,Christensen; Henrik I,0,0,0,0
1653406817115,CSE 290,A00,090135,Bafna; Vineet,0,0,0,0
1653406817115,CSE 290,B00,090136,Ramamoorthi; Ravi,0,0,0,0
1653406817115,CSE 290,C00,090137,Li; Tzumao,10,0,10,0
1653406817115,CSE 290,D00,090138,Zhou; Yuan-Yuan,10,0,10,0
1653406817115,CSE 290,E00,090139,Christensen; Henrik I,10,0,10,0
1653406817115,CSE 290,F00,094053,Shalev; Aaron D,0,0,0,0
1653406817638,CSE 291,A00,090140,Munyaka; Imani N. S.,0,0,0,0
1653406817638,CSE 291,B00,094880,Yu; Qi,0,0,0,0
1653406817638,CSE 291,C00,090142,Pannuto; Patrick William,0,0,0,0
1653406817638,CSE 291,D00,094881,Zhang; Yiying,0,0,0,0
1653406817638,CSE 291,E00,095118,Su; Hao,0,0,0,0
1653406818163,CSE 293,001,094905,Bafna; Vineet,9999,0,9999,0
1653406818163,CSE 293,002,094906,Bellare; Mihir,9999,0,9999,0
1653406818163,CSE 293,003,094907,Berg-Kirkpatrick; Taylor D,9999,0,9999,0
1653406818163,CSE 293,004,094908,Christensen; Henrik I,9999,0,9999,0
1653406818163,CSE 293,005,094909,Cottrell; Garrison W,9999,0,9999,0
1653406818163,CSE 293,006,094910,Deutsch; Alin Bernard,9999,0,9999,0
1653406818163,CSE 293,007,094911,Esmaeilzadeh; Hadi,9999,0,9999,0
1653406818163,CSE 293,008,094912,Freund; Yoav,9999,0,9999,0
1653406818163,CSE 293,009,094913,Griswold; William G.,9999,0,9999,0
1653406818163,CSE 293,010,094914,Gymrek; Melissa Ann,9999,0,9999,0
1653406818163,CSE 293,011,094915,Heninger; Nadia A,9999,0,9999,0
1653406818163,CSE 293,012,094916,Impagliazzo; Russell,9999,0,9999,0
1653406818163,CSE 293,013,094917,Jhala; Ranjit,9999,0,9999,0
1653406818163,CSE 293,014,094918,Kahng; Andrew Byun,9999,0,9999,0
1653406818163,CSE 293,015,094919,Kane; Daniel Mertz,9999,0,9999,0
1653406818163,CSE 293,016,094920,Kriegman; David J,9999,0,9999,0
1653406818163,CSE 293,017,094921,Kumar; Arun Kumar,9999,0,9999,0
1653406818163,CSE 293,018,094922,Lerner; Sorin,9999,0,9999,0
1653406818163,CSE 293,019,094923,Lovett; Shachar,9999,0,9999,0
1653406818163,CSE 293,020,094924,McAuley; Julian John,9999,0,9999,0
1653406818163,CSE 293,021,094925,Micciancio; Daniele,9999,0,9999,0
1653406818163,CSE 293,022,094926,Orailoglu; Alex,9999,0,9999,0
1653406818163,CSE 293,023,094927,Paturi; Ramamohan,9999,0,9999,0
1653406818163,CSE 293,024,094928,Polikarpova; Nadezhda,9999,0,9999,0
1653406818163,CSE 293,025,094929,Politz; Joseph Gibbs,9999,0,9999,0
1653406818163,CSE 293,026,094930,Porter; George M,9999,0,9999,0
1653406818163,CSE 293,027,094931,Porter; Leonard Emerson,9999,0,9999,0
1653406818163,CSE 293,028,094932,Ramamoorthi; Ravi,9999,0,9999,0
1653406818163,CSE 293,029,094933,Sahoo; Debashis,9999,0,9999,0
1653406818163,CSE 293,030,094934,Saul; Lawrence,9999,0,9999,0
1653406818163,CSE 293,031,094935,Savage; Stefan,9999,0,9999,0
1653406818163,CSE 293,032,094936,Schulze; Jurgen P.,9999,0,9999,0
1653406818163,CSE 293,033,094937,Snoeren; Alex C.,9999,0,9999,0
1653406818163,CSE 293,034,094938,Shang; Jingbo,9999,0,9999,0
1653406818163,CSE 293,035,094939,Stefan; Deian,9999,0,9999,0
1653406818163,CSE 293,036,094940,Su; Hao,9999,0,9999,0
1653406818163,CSE 293,037,094941,Swanson; Steven James,9999,0,9999,0
1653406818163,CSE 293,038,094942,Tullsen; Dean Michael,9999,0,9999,0
1653406818163,CSE 293,039,094943,Voelker; Geoffrey M.,9999,0,9999,0
1653406818163,CSE 293,040,094944,Zhao; Jishen,9999,0,9999,0
1653406818163,CSE 293,041,094945,Zhou; Yuan-Yuan,9999,0,9999,0
1653406818163,CSE 293,042,094946,Gao; Sicun,9998,0,9999,1
1653406818163,CSE 293,043,094947,Weibel; Nadir,9999,0,9999,0
1653406818163,CSE 293,044,094948,Gupta; Rajesh K.,9999,0,9999,0
1653406818693,CSE 294,A00,090143,Porter; George M,9,0,10,1
1653406819220,DSE 200,A00,091799,Staff,50,0,50,0
1653406819743,DSE 203,A00,091800,Gupta; Amarnath,30,0,30,0
1653406820280,DSE 250,A00,091801,Deutsch; Alin Bernard,30,0,30,0
1653406820803,DSE 290,A00,091802,Altintas De Callaf; Ilkay,50,0,50,0
1653406821332,ECE 200,001,091003,Antipa; Nicholas A,9999,0,9999,0
1653406821332,ECE 200,002,091004,Atanasov; Nikolay A.,9999,0,9999,0
1653406821332,ECE 200,003,091005,Bharadia; Dinesh,9999,0,9999,0
1653406821332,ECE 200,004,091006,Cheng; Chung Kuan,9999,0,9999,0
1653406821332,ECE 200,005,091007,Cosman; Pamela C.,9999,0,9999,0
1653406821332,ECE 200,006,091008,Staff,9999,0,9999,0
1653406821332,ECE 200,007,091009,Dayeh; Shadi Ahmad,9999,0,9999,0
1653406821332,ECE 200,008,091010,Fainman; Yeshaiahu,9999,0,9999,0
1653406821332,ECE 200,009,091011,Ford; Joseph Earl,9999,0,9999,0
1653406821332,ECE 200,010,091012,Franceschetti; Massimo,9999,0,9999,0
1653406821332,ECE 200,011,091013,Fullerton; Eric E,9999,0,9999,0
1653406821332,ECE 200,012,091014,Galton; Ian A,9999,0,9999,0
1653406821332,ECE 200,013,091015,Gilja; Vikash,9999,0,9999,0
1653406821332,ECE 200,014,091016,Hall; Drew A.,9999,0,9999,0
1653406821332,ECE 200,015,091017,Hsueh; Tzu-Chien,9999,0,9999,0
1653406821332,ECE 200,016,091018,Javidi; Tara,9999,0,9999,0
1653406821332,ECE 200,017,091019,Kahng; Andrew Byun,9999,0,9999,0
1653406821332,ECE 200,018,091020,Kim; Young-Han,9999,0,9999,0
1653406821332,ECE 200,019,091021,Koushanfar; Farinaz,9999,0,9999,0
1653406821332,ECE 200,020,091022,Kuzum; Duygu,9999,0,9999,0
1653406821332,ECE 200,021,091023,Le; Hanh-Phuc,9999,0,9999,0
1653406821332,ECE 200,022,091024,Lin; Bill,9999,0,9999,0
1653406821332,ECE 200,023,091025,Liu; Zhaowei,9999,0,9999,0
1653406821332,ECE 200,024,091026,Lo; Yu-Hwa,9999,0,9999,0
1653406821332,ECE 200,025,091027,Lomakin; Vitaliy,9999,0,9999,0
1653406821332,ECE 200,026,091028,Mercier; Patrick Philip,9999,0,9999,0
1653406821332,ECE 200,027,091029,Meyer; Florian,9999,0,9999,0
1653406821332,ECE 200,028,091030,Milstein; Laurence B.,9999,0,9999,0
1653406821332,ECE 200,029,091031,Mir Arabbaygi; Siavash,9999,0,9999,0
1653406821332,ECE 200,030,091032,Mookherjea; Shayan,9999,0,9999,0
1653406821332,ECE 200,031,091033,Morris; Karcher William,9999,0,9999,0
1653406821332,ECE 200,032,091034,Ng; Tse Nga,9999,0,9999,0
1653406821332,ECE 200,033,091035,Nguyen; Truong Quang,9999,0,9999,0
1653406821332,ECE 200,034,091036,Nomura; Kenji,9999,0,9999,0
1653406821332,ECE 200,035,091037,Orlitsky; Alon,9999,0,9999,0
1653406821332,ECE 200,036,091038,Pal; Piya,9999,0,9999,0
1653406821332,ECE 200,037,091039,Papen; George C.,9999,0,9999,0
1653406821332,ECE 200,038,091040,Radic; Stojan,9999,0,9999,0
1653406821332,ECE 200,039,091041,Rao; Bhaskar D.,9999,0,9999,0
1653406821332,ECE 200,040,091042,Rao; Ramesh R,9999,0,9999,0
1653406821332,ECE 200,041,091043,Rebeiz; Gabriel,9999,0,9999,0
1653406821332,ECE 200,042,091044,Sanford; John R,9999,0,9999,0
1653406821332,ECE 200,043,091045,Siegel; Paul H.,9999,0,9999,0
1653406821332,ECE 200,044,091046,Sievenpiper; Daniel F.,9999,0,9999,0
1653406821332,ECE 200,045,091047,Sworder; David D.,9999,0,9999,0
1653406821332,ECE 200,046,091048,Taur; Yuan,9999,0,9999,0
1653406821332,ECE 200,047,091049,Touri; Behrouz,9999,0,9999,0
1653406821332,ECE 200,048,091050,Trivedi; Mohan M.,9999,0,9999,0
1653406821332,ECE 200,049,091051,Vardy; Alexander,9999,0,9999,0
1653406821332,ECE 200,050,091052,Vasconcelos; Nuno,9999,0,9999,0
1653406821332,ECE 200,051,091053,Wang; Xiaolong,9999,0,9999,0
1653406821332,ECE 200,052,091054,Xie; Pengtao,9999,0,9999,0
1653406821332,ECE 200,053,091055,Yip; Michael,9999,0,9999,0
1653406821332,ECE 200,054,091056,Zeger; Kenneth A.,9999,0,9999,0
1653406821332,ECE 200,055,091057,Zhang; Xinyu,9999,0,9999,0
1653406821332,ECE 200,056,091058,Turakhia; Yatish Girish,9999,0,9999,0
1653406821332,ECE 200,057,091059,Kang; Mingu,9999,0,9999,0
1653406821332,ECE 200,058,091060,Shi; Yuanyuan,9999,0,9999,0
1653406821332,ECE 200,059,091061,Wang; Edward Jay,9999,0,9999,0
1653406821332,ECE 200,060,091062,Zheng; Yang,9999,0,9999,0
1653406821855,ECE 203,A00,091065,Mercier; Patrick Philip,0,0,0,0
1653406822380,ECE 207A,A00,091605,Liu; Thomas Tao-Ming,0,0,0,0
1653406822908,ECE 212AN,A00,091068,Nomura; Kenji,0,0,0,0
1653406823438,ECE 222A,A00,091069,Rebeiz; Gabriel,0,0,0,0
1653406823970,ECE 225A,A00,091070,Orlitsky; Alon,0,0,0,0
1653406824495,ECE 230A,A00,091071,Nomura; Kenji,0,0,0,0
1653406825017,ECE 236A,A00,091072,Dayeh; Shadi Ahmad,0,0,0,0
1653406825539,ECE 238A,A00,091073,Luo; Jian,0,0,0,0
1653406825539,ECE 238A,B00,091074,Luo; Jian,0,0,0,0
1653406826060,ECE 240A,A00,091075,Radic; Stojan,0,0,0,0
1653406826584,ECE 247A,A00,091592,Shi; Lingyan,0,0,0,0
1653406827106,ECE 250,A00,091076,Touri; Behrouz,0,0,0,0
1653406827631,ECE 251C,A00,091078,Nguyen; Truong Quang,0,0,0,0
1653406828157,ECE 253,A00,091079,Cosman; Pamela C.,0,0,0,0
1653406828680,ECE 255A,A00,091080,Orlitsky; Alon,0,0,0,0
1653406829203,ECE 257A,A00,091081,Zhang; Xinyu,0,0,0,0
1653406829729,ECE 260A,A01,091084,Eldon; John,0,0,0,0
1653406830259,ECE 264C,A00,091085,Galton; Ian A,0,0,0,0
1653406830785,ECE 265C,A00,094889,Presti; Calogero Davide,0,0,0,9
1653406831307,ECE 266,A01,091087,Hall; Drew A.,0,0,0,0
1653406832355,ECE 271A,A00,091090,Vasconcelos; Nuno,0,0,0,0
1653406832883,ECE 272B,A00,091091,Sworder; David D.,0,0,0,0
1653406833420,ECE 275A,A00,091092,Meyer; Florian,0,0,0,0
1653406833947,ECE 277,A00,091093,An; Cheolhong,0,0,0,0
1653406834472,ECE 283,A00,091094,Le; Hanh-Phuc,0,0,0,0
1653406834994,ECE 284,A00,091095,Kang; Mingu,0,0,0,0
1653406834994,ECE 284,B00,091096,Wang; Edward Jay,0,0,0,0
1653406835519,ECE 285,A00,094334,Touri; Behrouz,0,0,0,0
1653406836044,ECE 289,A00,091097,Whelan; David Arthur,0,0,0,0
1653406836572,MATH 200A,A00,087414,Salehi Golsefidy; Alireza,7,0,8,1
1653406837093,MATH 202A,A00,087415,Gill; Philip E.,3,0,8,5
1653406837617,MATH 203A,A00,087416,Oprea; Dragos N.,6,0,8,2
1653406838142,MATH 204A,A00,087417,Kedlaya; Kiran S.,6,0,8,2
1653406838665,MATH 205,A00,087418,Sorensen; Claus M,6,0,8,2
1653406839189,MATH 206A,A00,087419,Izadi; Elham,7,0,8,1
1653406839711,MATH 207A,A00,087420,Mohammadi; Amir,6,0,8,2
1653406840232,MATH 208,A00,087421,Staff,9,0,10,1
1653406840754,MATH 209,A00,087422,Staff,10,0,10,0
1653406841285,MATH 218,A00,087423,Staff,10,0,10,0
1653406841808,MATH 220A,A00,087424,Novak; Jonathan I,7,0,8,1
1653406842335,MATH 231A,A00,087425,Bejenaru; Ioan,4,0,8,4
1653406842858,MATH 240A,A00,087426,Ebenfelt; Peter F,5,0,8,3
1653406843389,MATH 243,A00,087427,Staff,9,0,10,1
1653406843920,MATH 248,A00,087429,Staff,10,0,10,0
1653406844448,MATH 250A,A00,087430,Spolaor; Luca,5,0,8,3
1653406844970,MATH 257A,A00,087431,Spolaor; Luca,7,0,8,1
1653406845500,MATH 258,A00,087432,Staff,9,0,10,1
1653406846041,MATH 264A,A00,087433,Warnke; Lutz Peter,5,0,8,3
1653406846568,MATH 268,A00,087434,Staff,15,0,15,0
1653406847090,MATH 269,A00,087435,Staff,14,0,15,1
1653406847616,MATH 270A,A00,087436,Nie; Jiawang,0,0,8,8
1653406848155,MATH 272A,A00,087437,Tian; Xiaochuan,2,0,8,6
1653406848684,MATH 274,A01,087439,Cheng; Li-Tien,9,0,10,1
1653406848684,MATH 274,A02,087440,Cheng; Li-Tien,10,0,10,0
1653406849206,MATH 278A,A00,087441,Staff,8,0,10,2
1653406849734,MATH 278B,A00,087442,Staff,8,0,10,2
1653406850256,MATH 278C,A00,087443,Staff,8,0,10,2
1653406850778,MATH 280A,A00,087444,Zheng; Tianyi,0,0,8,8
1653406851417,MATH 281A,A00,087445,Bradic; Jelena,0,0,8,8
1653406851940,MATH 282A,A00,087446,Zhang; Danna,0,0,8,8
1653406852467,MATH 283,A00,087447,Tesler; Glenn,0,0,0,13
1653406853001,MATH 286,A00,087448,Kemp; Todd Aahron,6,0,8,2
1653406853527,MATH 287D,A00,087449,Bradic; Jelena,8,0,8,0
1653406854049,MATH 288,A00,087450,Staff,14,0,15,1
1653406854049,MATH 288,B00,087451,Staff,15,0,15,0
1653406854049,MATH 288,C00,087452,Staff,15,0,15,0
1653406854574,MATH 290A,A00,087453,Xu; Zhouli,7,0,8,1
1653406855097,MATH 291A,A00,087454,Xu; Zhouli,7,0,8,1
1653406855619,MATH 292,A00,087455,Staff,10,0,10,0
1653406856140,MATH 295,A00,087456,Staff,50,0,50,0
1653406856674,MATH 297,001,087457,Staff,998,0,999,1
1653407417330,COGS 200,A01,087991,Staff,48,0,50,2
1653407417853,COGS 201,A01,094504,Rangel; Lara M,17,0,25,8
1653407418403,COGS 203,A00,087992,Coulson; Seana M,19,0,20,1
1653407418925,COGS 210A,001,087993,Greene; Deanna Jacquelyn,9998,0,9999,1
1653407418925,COGS 210A,002,087994,Saygin; Ayse P,9999,0,9999,0
1653407418925,COGS 210A,003,087995,Xia; Haijun,9999,0,9999,0
1653407418925,COGS 210A,004,087996,Nitz; Douglas A.,9999,0,9999,0
1653407418925,COGS 210A,005,087997,Hollan; James D.,9999,0,9999,0
1653407418925,COGS 210A,006,087998,Deak; Gedeon O.,9998,0,9999,1
1653407418925,COGS 210A,007,087999,Rossano; Federico,9999,0,9999,0
1653407419453,COGS 211A,A00,088000,Coulson; Seana M,9997,0,9999,2
1653407419974,COGS 229,A00,088002,Staff,23,0,25,2
1653407420499,COGS 260,B00,094231,Staff,17,0,20,3
1653407420499,COGS 260,A00,088004,Nitz; Douglas A.,9998,0,9999,1
1653407421023,CSE 202,A00,090110,Paturi; Ramamohan,0,0,0,0
1653407421023,CSE 202,B00,090111,Paturi; Ramamohan,0,0,0,0
1653407421544,CSE 207B,A00,090112,Heninger; Nadia A,0,0,0,0
1653407422073,CSE 208,A00,094858,Micciancio; Daniele,0,0,0,0
1653407422599,CSE 210,A00,090113,Powell; Thomas Allan,0,0,0,0
1653407423121,CSE 219,A00,090898,Staff,0,0,0,0
1653407423659,CSE 221,A00,090114,Zhou; Yuan-Yuan,0,0,0,0
1653407424193,CSE 229A,A00,090115,Porter; George M,0,0,0,0
1653407424717,CSE 229C,A00,090116,Savage; Stefan,0,0,0,0
1653407425239,CSE 230,A00,090117,Jhala; Ranjit,0,0,0,0
1653407425767,CSE 232,A00,090118,Papakonstantinou; Yannis,0,0,0,0
1653407426289,CSE 239A,A00,090121,Kumar; Arun Kumar,0,0,0,0
1653407426820,CSE 239B,A00,090122,Jhala; Ranjit,0,0,0,0
1653407427358,CSE 240A,A00,090123,Zhao; Jishen,0,0,189,189
1653407427883,CSE 243A,A00,090124,Orailoglu; Alex,3,0,15,12
1653407428415,CSE 249B,A00,090125,Kahng; Andrew Byun,14,0,20,6
1653407428948,CSE 250A,A00,090126,Berg-Kirkpatrick; Taylor D,0,0,0,0
1653407429470,CSE 252A,A00,090127,Ochoa; Benjamin Lawrence,0,0,0,0
1653407429994,CSE 258,A01,090129,McAuley; Julian John,0,0,0,0
1653407430532,CSE 258R,A01,090131,McAuley; Julian John,0,0,0,0
1653407431077,CSE 274,A00,090132,Ramamoorthi; Ravi,0,0,0,0
1653407431611,CSE 276A,A00,090133,Christensen; Henrik I,0,0,0,0
1653407432137,CSE 276C,A00,090134,Christensen; Henrik I,0,0,0,0
1653407432660,CSE 290,A00,090135,Bafna; Vineet,0,0,0,0
1653407432660,CSE 290,B00,090136,Ramamoorthi; Ravi,0,0,0,0
1653407432660,CSE 290,C00,090137,Li; Tzumao,10,0,10,0
1653407432660,CSE 290,D00,090138,Zhou; Yuan-Yuan,10,0,10,0
1653407432660,CSE 290,E00,090139,Christensen; Henrik I,10,0,10,0
1653407432660,CSE 290,F00,094053,Shalev; Aaron D,0,0,0,0
1653407433188,CSE 291,A00,090140,Munyaka; Imani N. S.,0,0,0,0
1653407433188,CSE 291,B00,094880,Yu; Qi,0,0,0,0
1653407433188,CSE 291,C00,090142,Pannuto; Patrick William,0,0,0,0
1653407433188,CSE 291,D00,094881,Zhang; Yiying,0,0,0,0
1653407433188,CSE 291,E00,095118,Su; Hao,0,0,0,0
1653407433713,CSE 293,001,094905,Bafna; Vineet,9999,0,9999,0
1653407433713,CSE 293,002,094906,Bellare; Mihir,9999,0,9999,0
1653407433713,CSE 293,003,094907,Berg-Kirkpatrick; Taylor D,9999,0,9999,0
1653407433713,CSE 293,004,094908,Christensen; Henrik I,9999,0,9999,0
1653407433713,CSE 293,005,094909,Cottrell; Garrison W,9999,0,9999,0
1653407433713,CSE 293,006,094910,Deutsch; Alin Bernard,9999,0,9999,0
1653407433713,CSE 293,007,094911,Esmaeilzadeh; Hadi,9999,0,9999,0
1653407433713,CSE 293,008,094912,Freund; Yoav,9999,0,9999,0
1653407433713,CSE 293,009,094913,Griswold; William G.,9999,0,9999,0
1653407433713,CSE 293,010,094914,Gymrek; Melissa Ann,9999,0,9999,0
1653407433713,CSE 293,011,094915,Heninger; Nadia A,9999,0,9999,0
1653407433713,CSE 293,012,094916,Impagliazzo; Russell,9999,0,9999,0
1653407433713,CSE 293,013,094917,Jhala; Ranjit,9999,0,9999,0
1653407433713,CSE 293,014,094918,Kahng; Andrew Byun,9999,0,9999,0
1653407433713,CSE 293,015,094919,Kane; Daniel Mertz,9999,0,9999,0
1653407433713,CSE 293,016,094920,Kriegman; David J,9999,0,9999,0
1653407433713,CSE 293,017,094921,Kumar; Arun Kumar,9999,0,9999,0
1653407433713,CSE 293,018,094922,Lerner; Sorin,9999,0,9999,0
1653407433713,CSE 293,019,094923,Lovett; Shachar,9999,0,9999,0
1653407433713,CSE 293,020,094924,McAuley; Julian John,9999,0,9999,0
1653407433713,CSE 293,021,094925,Micciancio; Daniele,9999,0,9999,0
1653407433713,CSE 293,022,094926,Orailoglu; Alex,9999,0,9999,0
1653407433713,CSE 293,023,094927,Paturi; Ramamohan,9999,0,9999,0
1653407433713,CSE 293,024,094928,Polikarpova; Nadezhda,9999,0,9999,0
1653407433713,CSE 293,025,094929,Politz; Joseph Gibbs,9999,0,9999,0
1653407433713,CSE 293,026,094930,Porter; George M,9999,0,9999,0
1653407433713,CSE 293,027,094931,Porter; Leonard Emerson,9999,0,9999,0
1653407433713,CSE 293,028,094932,Ramamoorthi; Ravi,9999,0,9999,0
1653407433713,CSE 293,029,094933,Sahoo; Debashis,9999,0,9999,0
1653407433713,CSE 293,030,094934,Saul; Lawrence,9999,0,9999,0
1653407433713,CSE 293,031,094935,Savage; Stefan,9999,0,9999,0
1653407433713,CSE 293,032,094936,Schulze; Jurgen P.,9999,0,9999,0
1653407433713,CSE 293,033,094937,Snoeren; Alex C.,9999,0,9999,0
1653407433713,CSE 293,034,094938,Shang; Jingbo,9999,0,9999,0
1653407433713,CSE 293,035,094939,Stefan; Deian,9999,0,9999,0
1653407433713,CSE 293,036,094940,Su; Hao,9999,0,9999,0
1653407433713,CSE 293,037,094941,Swanson; Steven James,9999,0,9999,0
1653407433713,CSE 293,038,094942,Tullsen; Dean Michael,9999,0,9999,0
1653407433713,CSE 293,039,094943,Voelker; Geoffrey M.,9999,0,9999,0
1653407433713,CSE 293,040,094944,Zhao; Jishen,9999,0,9999,0
1653407433713,CSE 293,041,094945,Zhou; Yuan-Yuan,9999,0,9999,0
1653407433713,CSE 293,042,094946,Gao; Sicun,9998,0,9999,1
1653407433713,CSE 293,043,094947,Weibel; Nadir,9999,0,9999,0
1653407433713,CSE 293,044,094948,Gupta; Rajesh K.,9999,0,9999,0
1653407434239,CSE 294,A00,090143,Porter; George M,9,0,10,1
1653407434764,DSE 200,A00,091799,Staff,50,0,50,0
1653407435292,DSE 203,A00,091800,Gupta; Amarnath,30,0,30,0
1653407435814,DSE 250,A00,091801,Deutsch; Alin Bernard,30,0,30,0
1653407436338,DSE 290,A00,091802,Altintas De Callaf; Ilkay,50,0,50,0
1653407436868,ECE 200,001,091003,Antipa; Nicholas A,9999,0,9999,0
1653407436868,ECE 200,002,091004,Atanasov; Nikolay A.,9999,0,9999,0
1653407436868,ECE 200,003,091005,Bharadia; Dinesh,9999,0,9999,0
1653407436868,ECE 200,004,091006,Cheng; Chung Kuan,9999,0,9999,0
1653407436868,ECE 200,005,091007,Cosman; Pamela C.,9999,0,9999,0
1653407436868,ECE 200,006,091008,Staff,9999,0,9999,0
1653407436868,ECE 200,007,091009,Dayeh; Shadi Ahmad,9999,0,9999,0
1653407436868,ECE 200,008,091010,Fainman; Yeshaiahu,9999,0,9999,0
1653407436868,ECE 200,009,091011,Ford; Joseph Earl,9999,0,9999,0
1653407436868,ECE 200,010,091012,Franceschetti; Massimo,9999,0,9999,0
1653407436868,ECE 200,011,091013,Fullerton; Eric E,9999,0,9999,0
1653407436868,ECE 200,012,091014,Galton; Ian A,9999,0,9999,0
1653407436868,ECE 200,013,091015,Gilja; Vikash,9999,0,9999,0
1653407436868,ECE 200,014,091016,Hall; Drew A.,9999,0,9999,0
1653407436868,ECE 200,015,091017,Hsueh; Tzu-Chien,9999,0,9999,0
1653407436868,ECE 200,016,091018,Javidi; Tara,9999,0,9999,0
1653407436868,ECE 200,017,091019,Kahng; Andrew Byun,9999,0,9999,0
1653407436868,ECE 200,018,091020,Kim; Young-Han,9999,0,9999,0
1653407436868,ECE 200,019,091021,Koushanfar; Farinaz,9999,0,9999,0
1653407436868,ECE 200,020,091022,Kuzum; Duygu,9999,0,9999,0
1653407436868,ECE 200,021,091023,Le; Hanh-Phuc,9999,0,9999,0
1653407436868,ECE 200,022,091024,Lin; Bill,9999,0,9999,0
1653407436868,ECE 200,023,091025,Liu; Zhaowei,9999,0,9999,0
1653407436868,ECE 200,024,091026,Lo; Yu-Hwa,9999,0,9999,0
1653407436868,ECE 200,025,091027,Lomakin; Vitaliy,9999,0,9999,0
1653407436868,ECE 200,026,091028,Mercier; Patrick Philip,9999,0,9999,0
1653407436868,ECE 200,027,091029,Meyer; Florian,9999,0,9999,0
1653407436868,ECE 200,028,091030,Milstein; Laurence B.,9999,0,9999,0
1653407436868,ECE 200,029,091031,Mir Arabbaygi; Siavash,9999,0,9999,0
1653407436868,ECE 200,030,091032,Mookherjea; Shayan,9999,0,9999,0
1653407436868,ECE 200,031,091033,Morris; Karcher William,9999,0,9999,0
1653407436868,ECE 200,032,091034,Ng; Tse Nga,9999,0,9999,0
1653407436868,ECE 200,033,091035,Nguyen; Truong Quang,9999,0,9999,0
1653407436868,ECE 200,034,091036,Nomura; Kenji,9999,0,9999,0
1653407436868,ECE 200,035,091037,Orlitsky; Alon,9999,0,9999,0
1653407436868,ECE 200,036,091038,Pal; Piya,9999,0,9999,0
1653407436868,ECE 200,037,091039,Papen; George C.,9999,0,9999,0
1653407436868,ECE 200,038,091040,Radic; Stojan,9999,0,9999,0
1653407436868,ECE 200,039,091041,Rao; Bhaskar D.,9999,0,9999,0
1653407436868,ECE 200,040,091042,Rao; Ramesh R,9999,0,9999,0
1653407436868,ECE 200,041,091043,Rebeiz; Gabriel,9999,0,9999,0
1653407436868,ECE 200,042,091044,Sanford; John R,9999,0,9999,0
1653407436868,ECE 200,043,091045,Siegel; Paul H.,9999,0,9999,0
1653407436868,ECE 200,044,091046,Sievenpiper; Daniel F.,9999,0,9999,0
1653407436868,ECE 200,045,091047,Sworder; David D.,9999,0,9999,0
1653407436868,ECE 200,046,091048,Taur; Yuan,9999,0,9999,0
1653407436868,ECE 200,047,091049,Touri; Behrouz,9999,0,9999,0
1653407436868,ECE 200,048,091050,Trivedi; Mohan M.,9999,0,9999,0
1653407436868,ECE 200,049,091051,Vardy; Alexander,9999,0,9999,0
1653407436868,ECE 200,050,091052,Vasconcelos; Nuno,9999,0,9999,0
1653407436868,ECE 200,051,091053,Wang; Xiaolong,9999,0,9999,0
1653407436868,ECE 200,052,091054,Xie; Pengtao,9999,0,9999,0
1653407436868,ECE 200,053,091055,Yip; Michael,9999,0,9999,0
1653407436868,ECE 200,054,091056,Zeger; Kenneth A.,9999,0,9999,0
1653407436868,ECE 200,055,091057,Zhang; Xinyu,9999,0,9999,0
1653407436868,ECE 200,056,091058,Turakhia; Yatish Girish,9999,0,9999,0
1653407436868,ECE 200,057,091059,Kang; Mingu,9999,0,9999,0
1653407436868,ECE 200,058,091060,Shi; Yuanyuan,9999,0,9999,0
1653407436868,ECE 200,059,091061,Wang; Edward Jay,9999,0,9999,0
1653407436868,ECE 200,060,091062,Zheng; Yang,9999,0,9999,0
1653407437392,ECE 203,A00,091065,Mercier; Patrick Philip,0,0,0,0
1653407437914,ECE 207A,A00,091605,Liu; Thomas Tao-Ming,0,0,0,0
1653407438438,ECE 212AN,A00,091068,Nomura; Kenji,0,0,0,0
1653407438961,ECE 222A,A00,091069,Rebeiz; Gabriel,0,0,0,0
1653407439486,ECE 225A,A00,091070,Orlitsky; Alon,0,0,0,0
1653407440012,ECE 230A,A00,091071,Nomura; Kenji,0,0,0,0
1653407440538,ECE 236A,A00,091072,Dayeh; Shadi Ahmad,0,0,0,0
1653407441066,ECE 238A,A00,091073,Luo; Jian,0,0,0,0
1653407441066,ECE 238A,B00,091074,Luo; Jian,0,0,0,0
1653407441587,ECE 240A,A00,091075,Radic; Stojan,0,0,0,0
1653407442110,ECE 247A,A00,091592,Shi; Lingyan,0,0,0,0
1653407442633,ECE 250,A00,091076,Touri; Behrouz,0,0,0,0
1653407443156,ECE 251C,A00,091078,Nguyen; Truong Quang,0,0,0,0
1653407443687,ECE 253,A00,091079,Cosman; Pamela C.,0,0,0,0
1653407444209,ECE 255A,A00,091080,Orlitsky; Alon,0,0,0,0
1653407444737,ECE 257A,A00,091081,Zhang; Xinyu,0,0,0,0
1653407445262,ECE 260A,A01,091084,Eldon; John,0,0,0,0
1653407445784,ECE 264C,A00,091085,Galton; Ian A,0,0,0,0
1653407446311,ECE 265C,A00,094889,Presti; Calogero Davide,0,0,0,9
1653407446842,ECE 266,A01,091087,Hall; Drew A.,0,0,0,0
1653407447891,ECE 271A,A00,091090,Vasconcelos; Nuno,0,0,0,0
1653407448419,ECE 272B,A00,091091,Sworder; David D.,0,0,0,0
1653407448944,ECE 275A,A00,091092,Meyer; Florian,0,0,0,0
1653407449469,ECE 277,A00,091093,An; Cheolhong,0,0,0,0
1653407450007,ECE 283,A00,091094,Le; Hanh-Phuc,0,0,0,0
1653407450618,ECE 284,A00,091095,Kang; Mingu,0,0,0,0
1653407450618,ECE 284,B00,091096,Wang; Edward Jay,0,0,0,0
1653407451141,ECE 285,A00,094334,Touri; Behrouz,0,0,0,0
1653407451691,ECE 289,A00,091097,Whelan; David Arthur,0,0,0,0
1653407452226,MATH 200A,A00,087414,Salehi Golsefidy; Alireza,7,0,8,1
1653407452753,MATH 202A,A00,087415,Gill; Philip E.,3,0,8,5
1653407453283,MATH 203A,A00,087416,Oprea; Dragos N.,6,0,8,2
1653407453806,MATH 204A,A00,087417,Kedlaya; Kiran S.,6,0,8,2
1653407454334,MATH 205,A00,087418,Sorensen; Claus M,6,0,8,2
1653407454857,MATH 206A,A00,087419,Izadi; Elham,7,0,8,1
1653407455382,MATH 207A,A00,087420,Mohammadi; Amir,6,0,8,2
1653407455906,MATH 208,A00,087421,Staff,9,0,10,1
1653407456434,MATH 209,A00,087422,Staff,10,0,10,0
1653407456961,MATH 218,A00,087423,Staff,10,0,10,0
1653407457483,MATH 220A,A00,087424,Novak; Jonathan I,7,0,8,1
1653407458006,MATH 231A,A00,087425,Bejenaru; Ioan,4,0,8,4
1653407458536,MATH 240A,A00,087426,Ebenfelt; Peter F,5,0,8,3
1653407459068,MATH 243,A00,087427,Staff,9,0,10,1
1653407459594,MATH 248,A00,087429,Staff,10,0,10,0
1653407460116,MATH 250A,A00,087430,Spolaor; Luca,5,0,8,3
1653407460638,MATH 257A,A00,087431,Spolaor; Luca,7,0,8,1
1653407461162,MATH 258,A00,087432,Staff,9,0,10,1
1653407461684,MATH 264A,A00,087433,Warnke; Lutz Peter,5,0,8,3
1653407462213,MATH 268,A00,087434,Staff,15,0,15,0
1653407462737,MATH 269,A00,087435,Staff,14,0,15,1
1653407463259,MATH 270A,A00,087436,Nie; Jiawang,0,0,8,8
1653407463785,MATH 272A,A00,087437,Tian; Xiaochuan,2,0,8,6
1653407464309,MATH 274,A01,087439,Cheng; Li-Tien,9,0,10,1
1653407464309,MATH 274,A02,087440,Cheng; Li-Tien,10,0,10,0
1653407464831,MATH 278A,A00,087441,Staff,8,0,10,2
1653407465355,MATH 278B,A00,087442,Staff,8,0,10,2
1653407465877,MATH 278C,A00,087443,Staff,8,0,10,2
1653407466399,MATH 280A,A00,087444,Zheng; Tianyi,0,0,8,8
1653407466926,MATH 281A,A00,087445,Bradic; Jelena,0,0,8,8
1653407467451,MATH 282A,A00,087446,Zhang; Danna,0,0,8,8
1653407467975,MATH 283,A00,087447,Tesler; Glenn,0,0,0,14
1653407468508,MATH 286,A00,087448,Kemp; Todd Aahron,6,0,8,2
1653407469032,MATH 287D,A00,087449,Bradic; Jelena,8,0,8,0
1653407469563,MATH 288,A00,087450,Staff,14,0,15,1
1653407469563,MATH 288,B00,087451,Staff,15,0,15,0
1653407469563,MATH 288,C00,087452,Staff,15,0,15,0
1653407470085,MATH 290A,A00,087453,Xu; Zhouli,7,0,8,1
1653407470609,MATH 291A,A00,087454,Xu; Zhouli,7,0,8,1
1653407471133,MATH 292,A00,087455,Staff,10,0,10,0
1653407471661,MATH 295,A00,087456,Staff,50,0,50,0
1653407472182,MATH 297,001,087457,Staff,998,0,999,1
1653408043824,COGS 200,A01,087991,Staff,48,0,50,2
1653408044355,COGS 201,A01,094504,Rangel; Lara M,17,0,25,8
1653408044880,COGS 203,A00,087992,Coulson; Seana M,19,0,20,1
1653408045403,COGS 210A,001,087993,Greene; Deanna Jacquelyn,9998,0,9999,1
1653408045403,COGS 210A,002,087994,Saygin; Ayse P,9999,0,9999,0
1653408045403,COGS 210A,003,087995,Xia; Haijun,9999,0,9999,0
1653408045403,COGS 210A,004,087996,Nitz; Douglas A.,9999,0,9999,0
1653408045403,COGS 210A,005,087997,Hollan; James D.,9999,0,9999,0
1653408045403,COGS 210A,006,087998,Deak; Gedeon O.,9998,0,9999,1
1653408045403,COGS 210A,007,087999,Rossano; Federico,9999,0,9999,0
1653408045928,COGS 211A,A00,088000,Coulson; Seana M,9997,0,9999,2
1653408046510,COGS 229,A00,088002,Staff,23,0,25,2
1653408047032,COGS 260,B00,094231,Staff,17,0,20,3
1653408047032,COGS 260,A00,088004,Nitz; Douglas A.,9998,0,9999,1
1653408047594,CSE 202,A00,090110,Paturi; Ramamohan,0,0,0,0
1653408047594,CSE 202,B00,090111,Paturi; Ramamohan,0,0,0,0
1653408048117,CSE 207B,A00,090112,Heninger; Nadia A,0,0,0,0
1653408048651,CSE 208,A00,094858,Micciancio; Daniele,0,0,0,0
1653408049182,CSE 210,A00,090113,Powell; Thomas Allan,0,0,0,0
1653408049804,CSE 219,A00,090898,Staff,0,0,0,0
1653408050331,CSE 221,A00,090114,Zhou; Yuan-Yuan,0,0,0,0
1653408050859,CSE 229A,A00,090115,Porter; George M,0,0,0,0
1653408051382,CSE 229C,A00,090116,Savage; Stefan,0,0,0,0
1653408051904,CSE 230,A00,090117,Jhala; Ranjit,0,0,0,0
1653408052431,CSE 232,A00,090118,Papakonstantinou; Yannis,0,0,0,0
1653408052965,CSE 239A,A00,090121,Kumar; Arun Kumar,0,0,0,0
1653408053495,CSE 239B,A00,090122,Jhala; Ranjit,0,0,0,0
1653408054018,CSE 240A,A00,090123,Zhao; Jishen,0,0,189,189
1653408054541,CSE 243A,A00,090124,Orailoglu; Alex,3,0,15,12
1653408055066,CSE 249B,A00,090125,Kahng; Andrew Byun,14,0,20,6
1653408055599,CSE 250A,A00,090126,Berg-Kirkpatrick; Taylor D,0,0,0,0
1653408056124,CSE 252A,A00,090127,Ochoa; Benjamin Lawrence,0,0,0,0
1653408056648,CSE 258,A01,090129,McAuley; Julian John,0,0,0,0
1653408057170,CSE 258R,A01,090131,McAuley; Julian John,0,0,0,0
1653408057700,CSE 274,A00,090132,Ramamoorthi; Ravi,0,0,0,0
1653408058227,CSE 276A,A00,090133,Christensen; Henrik I,0,0,0,0
1653408058751,CSE 276C,A00,090134,Christensen; Henrik I,0,0,0,0
1653408059275,CSE 290,A00,090135,Bafna; Vineet,0,0,0,0
1653408059275,CSE 290,B00,090136,Ramamoorthi; Ravi,0,0,0,0
1653408059275,CSE 290,C00,090137,Li; Tzumao,10,0,10,0
1653408059275,CSE 290,D00,090138,Zhou; Yuan-Yuan,10,0,10,0
1653408059275,CSE 290,E00,090139,Christensen; Henrik I,10,0,10,0
1653408059275,CSE 290,F00,094053,Shalev; Aaron D,0,0,0,0
1653408059803,CSE 291,A00,090140,Munyaka; Imani N. S.,0,0,0,0
1653408059803,CSE 291,B00,094880,Yu; Qi,0,0,0,0
1653408059803,CSE 291,C00,090142,Pannuto; Patrick William,0,0,0,0
1653408059803,CSE 291,D00,094881,Zhang; Yiying,0,0,0,0
1653408059803,CSE 291,E00,095118,Su; Hao,0,0,0,0
1653408060327,CSE 293,001,094905,Bafna; Vineet,9999,0,9999,0
1653408060327,CSE 293,002,094906,Bellare; Mihir,9999,0,9999,0
1653408060327,CSE 293,003,094907,Berg-Kirkpatrick; Taylor D,9999,0,9999,0
1653408060327,CSE 293,004,094908,Christensen; Henrik I,9999,0,9999,0
1653408060327,CSE 293,005,094909,Cottrell; Garrison W,9999,0,9999,0
1653408060327,CSE 293,006,094910,Deutsch; Alin Bernard,9999,0,9999,0
1653408060327,CSE 293,007,094911,Esmaeilzadeh; Hadi,9999,0,9999,0
1653408060327,CSE 293,008,094912,Freund; Yoav,9999,0,9999,0
1653408060327,CSE 293,009,094913,Griswold; William G.,9999,0,9999,0
1653408060327,CSE 293,010,094914,Gymrek; Melissa Ann,9999,0,9999,0
1653408060327,CSE 293,011,094915,Heninger; Nadia A,9999,0,9999,0
1653408060327,CSE 293,012,094916,Impagliazzo; Russell,9999,0,9999,0
1653408060327,CSE 293,013,094917,Jhala; Ranjit,9999,0,9999,0
1653408060327,CSE 293,014,094918,Kahng; Andrew Byun,9999,0,9999,0
1653408060327,CSE 293,015,094919,Kane; Daniel Mertz,9999,0,9999,0
1653408060327,CSE 293,016,094920,Kriegman; David J,9999,0,9999,0
1653408060327,CSE 293,017,094921,Kumar; Arun Kumar,9999,0,9999,0
1653408060327,CSE 293,018,094922,Lerner; Sorin,9999,0,9999,0
1653408060327,CSE 293,019,094923,Lovett; Shachar,9999,0,9999,0
1653408060327,CSE 293,020,094924,McAuley; Julian John,9999,0,9999,0
1653408060327,CSE 293,021,094925,Micciancio; Daniele,9999,0,9999,0
1653408060327,CSE 293,022,094926,Orailoglu; Alex,9999,0,9999,0
1653408060327,CSE 293,023,094927,Paturi; Ramamohan,9999,0,9999,0
1653408060327,CSE 293,024,094928,Polikarpova; Nadezhda,9999,0,9999,0
1653408060327,CSE 293,025,094929,Politz; Joseph Gibbs,9999,0,9999,0
1653408060327,CSE 293,026,094930,Porter; George M,9999,0,9999,0
1653408060327,CSE 293,027,094931,Porter; Leonard Emerson,9999,0,9999,0
1653408060327,CSE 293,028,094932,Ramamoorthi; Ravi,9999,0,9999,0
1653408060327,CSE 293,029,094933,Sahoo; Debashis,9999,0,9999,0
1653408060327,CSE 293,030,094934,Saul; Lawrence,9999,0,9999,0
1653408060327,CSE 293,031,094935,Savage; Stefan,9999,0,9999,0
1653408060327,CSE 293,032,094936,Schulze; Jurgen P.,9999,0,9999,0
1653408060327,CSE 293,033,094937,Snoeren; Alex C.,9999,0,9999,0
1653408060327,CSE 293,034,094938,Shang; Jingbo,9999,0,9999,0
1653408060327,CSE 293,035,094939,Stefan; Deian,9999,0,9999,0
1653408060327,CSE 293,036,094940,Su; Hao,9999,0,9999,0
1653408060327,CSE 293,037,094941,Swanson; Steven James,9999,0,9999,0
1653408060327,CSE 293,038,094942,Tullsen; Dean Michael,9999,0,9999,0
1653408060327,CSE 293,039,094943,Voelker; Geoffrey M.,9999,0,9999,0
1653408060327,CSE 293,040,094944,Zhao; Jishen,9999,0,9999,0
1653408060327,CSE 293,041,094945,Zhou; Yuan-Yuan,9999,0,9999,0
1653408060327,CSE 293,042,094946,Gao; Sicun,9998,0,9999,1
1653408060327,CSE 293,043,094947,Weibel; Nadir,9999,0,9999,0
1653408060327,CSE 293,044,094948,Gupta; Rajesh K.,9999,0,9999,0
1653408060851,CSE 294,A00,090143,Porter; George M,9,0,10,1
1653408061396,DSE 200,A00,091799,Staff,50,0,50,0
1653408061916,DSE 203,A00,091800,Gupta; Amarnath,30,0,30,0
1653408062441,DSE 250,A00,091801,Deutsch; Alin Bernard,30,0,30,0
1653408062997,DSE 290,A00,091802,Altintas De Callaf; Ilkay,50,0,50,0
1653408063539,ECE 200,001,091003,Antipa; Nicholas A,9999,0,9999,0
1653408063539,ECE 200,002,091004,Atanasov; Nikolay A.,9999,0,9999,0
1653408063539,ECE 200,003,091005,Bharadia; Dinesh,9999,0,9999,0
1653408063539,ECE 200,004,091006,Cheng; Chung Kuan,9999,0,9999,0
1653408063539,ECE 200,005,091007,Cosman; Pamela C.,9999,0,9999,0
1653408063539,ECE 200,006,091008,Staff,9999,0,9999,0
1653408063539,ECE 200,007,091009,Dayeh; Shadi Ahmad,9999,0,9999,0
1653408063539,ECE 200,008,091010,Fainman; Yeshaiahu,9999,0,9999,0
1653408063539,ECE 200,009,091011,Ford; Joseph Earl,9999,0,9999,0
1653408063539,ECE 200,010,091012,Franceschetti; Massimo,9999,0,9999,0
1653408063539,ECE 200,011,091013,Fullerton; Eric E,9999,0,9999,0
1653408063539,ECE 200,012,091014,Galton; Ian A,9999,0,9999,0
1653408063539,ECE 200,013,091015,Gilja; Vikash,9999,0,9999,0
1653408063539,ECE 200,014,091016,Hall; Drew A.,9999,0,9999,0
1653408063539,ECE 200,015,091017,Hsueh; Tzu-Chien,9999,0,9999,0
1653408063539,ECE 200,016,091018,Javidi; Tara,9999,0,9999,0
1653408063539,ECE 200,017,091019,Kahng; Andrew Byun,9999,0,9999,0
1653408063539,ECE 200,018,091020,Kim; Young-Han,9999,0,9999,0
1653408063539,ECE 200,019,091021,Koushanfar; Farinaz,9999,0,9999,0
1653408063539,ECE 200,020,091022,Kuzum; Duygu,9999,0,9999,0
1653408063539,ECE 200,021,091023,Le; Hanh-Phuc,9999,0,9999,0
1653408063539,ECE 200,022,091024,Lin; Bill,9999,0,9999,0
1653408063539,ECE 200,023,091025,Liu; Zhaowei,9999,0,9999,0
1653408063539,ECE 200,024,091026,Lo; Yu-Hwa,9999,0,9999,0
1653408063539,ECE 200,025,091027,Lomakin; Vitaliy,9999,0,9999,0
1653408063539,ECE 200,026,091028,Mercier; Patrick Philip,9999,0,9999,0
1653408063539,ECE 200,027,091029,Meyer; Florian,9999,0,9999,0
1653408063539,ECE 200,028,091030,Milstein; Laurence B.,9999,0,9999,0
1653408063539,ECE 200,029,091031,Mir Arabbaygi; Siavash,9999,0,9999,0
1653408063539,ECE 200,030,091032,Mookherjea; Shayan,9999,0,9999,0
1653408063539,ECE 200,031,091033,Morris; Karcher William,9999,0,9999,0
1653408063539,ECE 200,032,091034,Ng; Tse Nga,9999,0,9999,0
1653408063539,ECE 200,033,091035,Nguyen; Truong Quang,9999,0,9999,0
1653408063539,ECE 200,034,091036,Nomura; Kenji,9999,0,9999,0
1653408063539,ECE 200,035,091037,Orlitsky; Alon,9999,0,9999,0
1653408063539,ECE 200,036,091038,Pal; Piya,9999,0,9999,0
1653408063539,ECE 200,037,091039,Papen; George C.,9999,0,9999,0
1653408063539,ECE 200,038,091040,Radic; Stojan,9999,0,9999,0
1653408063539,ECE 200,039,091041,Rao; Bhaskar D.,9999,0,9999,0
1653408063539,ECE 200,040,091042,Rao; Ramesh R,9999,0,9999,0
1653408063539,ECE 200,041,091043,Rebeiz; Gabriel,9999,0,9999,0
1653408063539,ECE 200,042,091044,Sanford; John R,9999,0,9999,0
1653408063539,ECE 200,043,091045,Siegel; Paul H.,9999,0,9999,0
1653408063539,ECE 200,044,091046,Sievenpiper; Daniel F.,9999,0,9999,0
1653408063539,ECE 200,045,091047,Sworder; David D.,9999,0,9999,0
1653408063539,ECE 200,046,091048,Taur; Yuan,9999,0,9999,0
1653408063539,ECE 200,047,091049,Touri; Behrouz,9999,0,9999,0
1653408063539,ECE 200,048,091050,Trivedi; Mohan M.,9999,0,9999,0
1653408063539,ECE 200,049,091051,Vardy; Alexander,9999,0,9999,0
1653408063539,ECE 200,050,091052,Vasconcelos; Nuno,9999,0,9999,0
1653408063539,ECE 200,051,091053,Wang; Xiaolong,9999,0,9999,0
1653408063539,ECE 200,052,091054,Xie; Pengtao,9999,0,9999,0
1653408063539,ECE 200,053,091055,Yip; Michael,9999,0,9999,0
1653408063539,ECE 200,054,091056,Zeger; Kenneth A.,9999,0,9999,0
1653408063539,ECE 200,055,091057,Zhang; Xinyu,9999,0,9999,0
1653408063539,ECE 200,056,091058,Turakhia; Yatish Girish,9999,0,9999,0
1653408063539,ECE 200,057,091059,Kang; Mingu,9999,0,9999,0
1653408063539,ECE 200,058,091060,Shi; Yuanyuan,9999,0,9999,0
1653408063539,ECE 200,059,091061,Wang; Edward Jay,9999,0,9999,0
1653408063539,ECE 200,060,091062,Zheng; Yang,9999,0,9999,0
1653408064064,ECE 203,A00,091065,Mercier; Patrick Philip,0,0,0,0
1653408064590,ECE 207A,A00,091605,Liu; Thomas Tao-Ming,0,0,0,0
1653408065115,ECE 212AN,A00,091068,Nomura; Kenji,0,0,0,0
1653408065649,ECE 222A,A00,091069,Rebeiz; Gabriel,0,0,0,0
1653408066172,ECE 225A,A00,091070,Orlitsky; Alon,0,0,0,0
1653408066698,ECE 230A,A00,091071,Nomura; Kenji,0,0,0,0
1653408067234,ECE 236A,A00,091072,Dayeh; Shadi Ahmad,0,0,0,0
1653408067763,ECE 238A,A00,091073,Luo; Jian,0,0,0,0
1653408067763,ECE 238A,B00,091074,Luo; Jian,0,0,0,0
1653408068286,ECE 240A,A00,091075,Radic; Stojan,0,0,0,0
1653408068810,ECE 247A,A00,091592,Shi; Lingyan,0,0,0,0
1653408069332,ECE 250,A00,091076,Touri; Behrouz,0,0,0,0
1653408069856,ECE 251C,A00,091078,Nguyen; Truong Quang,0,0,0,0
1653408070419,ECE 253,A00,091079,Cosman; Pamela C.,0,0,0,0
1653408070945,ECE 255A,A00,091080,Orlitsky; Alon,0,0,0,0
1653408071469,ECE 257A,A00,091081,Zhang; Xinyu,0,0,0,0
1653408071994,ECE 260A,A01,091084,Eldon; John,0,0,0,0
1653408072521,ECE 264C,A00,091085,Galton; Ian A,0,0,0,0
1653408073045,ECE 265C,A00,094889,Presti; Calogero Davide,0,0,0,9
1653408073570,ECE 266,A01,091087,Hall; Drew A.,0,0,0,0
1653408074684,ECE 271A,A00,091090,Vasconcelos; Nuno,0,0,0,0
1653408075208,ECE 272B,A00,091091,Sworder; David D.,0,0,0,0
1653408075741,ECE 275A,A00,091092,Meyer; Florian,0,0,0,0
1653408076450,ECE 277,A00,091093,An; Cheolhong,0,0,0,0
1653408076978,ECE 283,A00,091094,Le; Hanh-Phuc,0,0,0,0
1653408077520,ECE 284,A00,091095,Kang; Mingu,0,0,0,0
1653408077520,ECE 284,B00,091096,Wang; Edward Jay,0,0,0,0
1653408078051,ECE 285,A00,094334,Touri; Behrouz,0,0,0,0
1653408078574,ECE 289,A00,091097,Whelan; David Arthur,0,0,0,0
1653408079102,MATH 200A,A00,087414,Salehi Golsefidy; Alireza,7,0,8,1
1653408079633,MATH 202A,A00,087415,Gill; Philip E.,3,0,8,5
1653408080159,MATH 203A,A00,087416,Oprea; Dragos N.,6,0,8,2
1653408080700,MATH 204A,A00,087417,Kedlaya; Kiran S.,6,0,8,2
1653408081227,MATH 205,A00,087418,Sorensen; Claus M,6,0,8,2
1653408081749,MATH 206A,A00,087419,Izadi; Elham,7,0,8,1
1653408082275,MATH 207A,A00,087420,Mohammadi; Amir,6,0,8,2
1653408082797,MATH 208,A00,087421,Staff,9,0,10,1
1653408083319,MATH 209,A00,087422,Staff,10,0,10,0
1653408083851,MATH 218,A00,087423,Staff,10,0,10,0
1653408084374,MATH 220A,A00,087424,Novak; Jonathan I,7,0,8,1
1653408084902,MATH 231A,A00,087425,Bejenaru; Ioan,4,0,8,4
1653408085428,MATH 240A,A00,087426,Ebenfelt; Peter F,5,0,8,3
1653408085953,MATH 243,A00,087427,Staff,9,0,10,1
1653408086495,MATH 248,A00,087429,Staff,10,0,10,0
1653408087022,MATH 250A,A00,087430,Spolaor; Luca,5,0,8,3
1653408087550,MATH 257A,A00,087431,Spolaor; Luca,7,0,8,1
1653408088072,MATH 258,A00,087432,Staff,9,0,10,1
1653408088595,MATH 264A,A00,087433,Warnke; Lutz Peter,5,0,8,3
1653408089118,MATH 268,A00,087434,Staff,15,0,15,0
1653408089655,MATH 269,A00,087435,Staff,14,0,15,1
1653408090192,MATH 270A,A00,087436,Nie; Jiawang,0,0,8,8
1653408090714,MATH 272A,A00,087437,Tian; Xiaochuan,2,0,8,6
1653408091238,MATH 274,A01,087439,Cheng; Li-Tien,9,0,10,1
1653408091238,MATH 274,A02,087440,Cheng; Li-Tien,10,0,10,0
1653408091761,MATH 278A,A00,087441,Staff,8,0,10,2
1653408092286,MATH 278B,A00,087442,Staff,8,0,10,2
1653408092808,MATH 278C,A00,087443,Staff,8,0,10,2
1653408093340,MATH 280A,A00,087444,Zheng; Tianyi,0,0,8,8
1653408093875,MATH 281A,A00,087445,Bradic; Jelena,0,0,8,8
1653408094400,MATH 282A,A00,087446,Zhang; Danna,0,0,8,8
1653408094932,MATH 283,A00,087447,Tesler; Glenn,0,0,0,14
1653408095458,MATH 286,A00,087448,Kemp; Todd Aahron,6,0,8,2
1653408095992,MATH 287D,A00,087449,Bradic; Jelena,8,0,8,0
1653408096521,MATH 288,A00,087450,Staff,14,0,15,1
1653408096521,MATH 288,B00,087451,Staff,15,0,15,0
1653408096521,MATH 288,C00,087452,Staff,15,0,15,0
1653408097053,MATH 290A,A00,087453,Xu; Zhouli,7,0,8,1
1653408097576,MATH 291A,A00,087454,Xu; Zhouli,7,0,8,1
1653408098117,MATH 292,A00,087455,Staff,10,0,10,0
1653408098639,MATH 295,A00,087456,Staff,50,0,50,0
1653408099161,MATH 297,001,087457,Staff,998,0,999,1
1653408660399,COGS 200,A01,087991,Staff,48,0,50,2
1653408660929,COGS 201,A01,094504,Rangel; Lara M,17,0,25,8
1653408661454,COGS 203,A00,087992,Coulson; Seana M,19,0,20,1
1653408661984,COGS 210A,001,087993,Greene; Deanna Jacquelyn,9998,0,9999,1
1653408661984,COGS 210A,002,087994,Saygin; Ayse P,9999,0,9999,0
1653408661984,COGS 210A,003,087995,Xia; Haijun,9999,0,9999,0
1653408661984,COGS 210A,004,087996,Nitz; Douglas A.,9999,0,9999,0
1653408661984,COGS 210A,005,087997,Hollan; James D.,9999,0,9999,0
1653408661984,COGS 210A,006,087998,Deak; Gedeon O.,9998,0,9999,1
1653408661984,COGS 210A,007,087999,Rossano; Federico,9999,0,9999,0
1653408662513,COGS 211A,A00,088000,Coulson; Seana M,9997,0,9999,2
1653408663044,COGS 229,A00,088002,Staff,23,0,25,2
1653408663571,COGS 260,B00,094231,Staff,17,0,20,3
1653408663571,COGS 260,A00,088004,Nitz; Douglas A.,9998,0,9999,1
1653408664097,CSE 202,A00,090110,Paturi; Ramamohan,0,0,0,0
1653408664097,CSE 202,B00,090111,Paturi; Ramamohan,0,0,0,0
1653408664620,CSE 207B,A00,090112,Heninger; Nadia A,0,0,0,0
1653408665142,CSE 208,A00,094858,Micciancio; Daniele,0,0,0,0
1653408665667,CSE 210,A00,090113,Powell; Thomas Allan,0,0,0,0
1653408666201,CSE 219,A00,090898,Staff,0,0,0,0
1653408666731,CSE 221,A00,090114,Zhou; Yuan-Yuan,0,0,0,0
1653408667257,CSE 229A,A00,090115,Porter; George M,0,0,0,0
1653408667793,CSE 229C,A00,090116,Savage; Stefan,0,0,0,0
1653408668321,CSE 230,A00,090117,Jhala; Ranjit,0,0,0,0
1653408668855,CSE 232,A00,090118,Papakonstantinou; Yannis,0,0,0,0
1653408669379,CSE 239A,A00,090121,Kumar; Arun Kumar,0,0,0,0
1653408669904,CSE 239B,A00,090122,Jhala; Ranjit,0,0,0,0
1653408670430,CSE 240A,A00,090123,Zhao; Jishen,0,0,189,189
1653408670962,CSE 243A,A00,090124,Orailoglu; Alex,3,0,15,12
1653408671484,CSE 249B,A00,090125,Kahng; Andrew Byun,14,0,20,6
1653408672021,CSE 250A,A00,090126,Berg-Kirkpatrick; Taylor D,0,0,0,0
1653408672545,CSE 252A,A00,090127,Ochoa; Benjamin Lawrence,0,0,0,0
1653408673070,CSE 258,A01,090129,McAuley; Julian John,0,0,0,0
1653408673605,CSE 258R,A01,090131,McAuley; Julian John,0,0,0,0
1653408674142,CSE 274,A00,090132,Ramamoorthi; Ravi,0,0,0,0
1653408674664,CSE 276A,A00,090133,Christensen; Henrik I,0,0,0,0
1653408675185,CSE 276C,A00,090134,Christensen; Henrik I,0,0,0,0
1653408675716,CSE 290,A00,090135,Bafna; Vineet,0,0,0,0
1653408675716,CSE 290,B00,090136,Ramamoorthi; Ravi,0,0,0,0
1653408675716,CSE 290,C00,090137,Li; Tzumao,10,0,10,0
1653408675716,CSE 290,D00,090138,Zhou; Yuan-Yuan,10,0,10,0
1653408675716,CSE 290,E00,090139,Christensen; Henrik I,10,0,10,0
1653408675716,CSE 290,F00,094053,Shalev; Aaron D,0,0,0,0
1653408676243,CSE 291,A00,090140,Munyaka; Imani N. S.,0,0,0,0
1653408676243,CSE 291,B00,094880,Yu; Qi,0,0,0,0
1653408676243,CSE 291,C00,090142,Pannuto; Patrick William,0,0,0,0
1653408676243,CSE 291,D00,094881,Zhang; Yiying,0,0,0,0
1653408676243,CSE 291,E00,095118,Su; Hao,0,0,0,0
1653408676776,CSE 293,001,094905,Bafna; Vineet,9999,0,9999,0
1653408676776,CSE 293,002,094906,Bellare; Mihir,9999,0,9999,0
1653408676776,CSE 293,003,094907,Berg-Kirkpatrick; Taylor D,9999,0,9999,0
1653408676776,CSE 293,004,094908,Christensen; Henrik I,9999,0,9999,0
1653408676776,CSE 293,005,094909,Cottrell; Garrison W,9999,0,9999,0
1653408676776,CSE 293,006,094910,Deutsch; Alin Bernard,9999,0,9999,0
1653408676776,CSE 293,007,094911,Esmaeilzadeh; Hadi,9999,0,9999,0
1653408676776,CSE 293,008,094912,Freund; Yoav,9999,0,9999,0
1653408676776,CSE 293,009,094913,Griswold; William G.,9999,0,9999,0
1653408676776,CSE 293,010,094914,Gymrek; Melissa Ann,9999,0,9999,0
1653408676776,CSE 293,011,094915,Heninger; Nadia A,9999,0,9999,0
1653408676776,CSE 293,012,094916,Impagliazzo; Russell,9999,0,9999,0
1653408676776,CSE 293,013,094917,Jhala; Ranjit,9999,0,9999,0
1653408676776,CSE 293,014,094918,Kahng; Andrew Byun,9999,0,9999,0
1653408676776,CSE 293,015,094919,Kane; Daniel Mertz,9999,0,9999,0
1653408676776,CSE 293,016,094920,Kriegman; David J,9999,0,9999,0
1653408676776,CSE 293,017,094921,Kumar; Arun Kumar,9999,0,9999,0
1653408676776,CSE 293,018,094922,Lerner; Sorin,9999,0,9999,0
1653408676776,CSE 293,019,094923,Lovett; Shachar,9999,0,9999,0
1653408676776,CSE 293,020,094924,McAuley; Julian John,9999,0,9999,0
1653408676776,CSE 293,021,094925,Micciancio; Daniele,9999,0,9999,0
1653408676776,CSE 293,022,094926,Orailoglu; Alex,9999,0,9999,0
1653408676776,CSE 293,023,094927,Paturi; Ramamohan,9999,0,9999,0
1653408676776,CSE 293,024,094928,Polikarpova; Nadezhda,9999,0,9999,0
1653408676776,CSE 293,025,094929,Politz; Joseph Gibbs,9999,0,9999,0
1653408676776,CSE 293,026,094930,Porter; George M,9999,0,9999,0
1653408676776,CSE 293,027,094931,Porter; Leonard Emerson,9999,0,9999,0
1653408676776,CSE 293,028,094932,Ramamoorthi; Ravi,9999,0,9999,0
1653408676776,CSE 293,029,094933,Sahoo; Debashis,9999,0,9999,0
1653408676776,CSE 293,030,094934,Saul; Lawrence,9999,0,9999,0
1653408676776,CSE 293,031,094935,Savage; Stefan,9999,0,9999,0
1653408676776,CSE 293,032,094936,Schulze; Jurgen P.,9999,0,9999,0
1653408676776,CSE 293,033,094937,Snoeren; Alex C.,9999,0,9999,0
1653408676776,CSE 293,034,094938,Shang; Jingbo,9999,0,9999,0
1653408676776,CSE 293,035,094939,Stefan; Deian,9999,0,9999,0
1653408676776,CSE 293,036,094940,Su; Hao,9999,0,9999,0
1653408676776,CSE 293,037,094941,Swanson; Steven James,9999,0,9999,0
1653408676776,CSE 293,038,094942,Tullsen; Dean Michael,9999,0,9999,0
1653408676776,CSE 293,039,094943,Voelker; Geoffrey M.,9999,0,9999,0
1653408676776,CSE 293,040,094944,Zhao; Jishen,9999,0,9999,0
1653408676776,CSE 293,041,094945,Zhou; Yuan-Yuan,9999,0,9999,0
1653408676776,CSE 293,042,094946,Gao; Sicun,9998,0,9999,1
1653408676776,CSE 293,043,094947,Weibel; Nadir,9999,0,9999,0
1653408676776,CSE 293,044,094948,Gupta; Rajesh K.,9999,0,9999,0
1653408677308,CSE 294,A00,090143,Porter; George M,9,0,10,1
1653408677840,DSE 200,A00,091799,Staff,50,0,50,0
1653408678377,DSE 203,A00,091800,Gupta; Amarnath,30,0,30,0
1653408678913,DSE 250,A00,091801,Deutsch; Alin Bernard,30,0,30,0
1653408679443,DSE 290,A00,091802,Altintas De Callaf; Ilkay,50,0,50,0
1653408679969,ECE 200,001,091003,Antipa; Nicholas A,9999,0,9999,0
1653408679969,ECE 200,002,091004,Atanasov; Nikolay A.,9999,0,9999,0
1653408679969,ECE 200,003,091005,Bharadia; Dinesh,9999,0,9999,0
1653408679969,ECE 200,004,091006,Cheng; Chung Kuan,9999,0,9999,0
1653408679969,ECE 200,005,091007,Cosman; Pamela C.,9999,0,9999,0
1653408679969,ECE 200,006,091008,Staff,9999,0,9999,0
1653408679969,ECE 200,007,091009,Dayeh; Shadi Ahmad,9999,0,9999,0
1653408679969,ECE 200,008,091010,Fainman; Yeshaiahu,9999,0,9999,0
1653408679969,ECE 200,009,091011,Ford; Joseph Earl,9999,0,9999,0
1653408679969,ECE 200,010,091012,Franceschetti; Massimo,9999,0,9999,0
1653408679969,ECE 200,011,091013,Fullerton; Eric E,9999,0,9999,0
1653408679969,ECE 200,012,091014,Galton; Ian A,9999,0,9999,0
1653408679969,ECE 200,013,091015,Gilja; Vikash,9999,0,9999,0
1653408679969,ECE 200,014,091016,Hall; Drew A.,9999,0,9999,0
1653408679969,ECE 200,015,091017,Hsueh; Tzu-Chien,9999,0,9999,0
1653408679969,ECE 200,016,091018,Javidi; Tara,9999,0,9999,0
1653408679969,ECE 200,017,091019,Kahng; Andrew Byun,9999,0,9999,0
1653408679969,ECE 200,018,091020,Kim; Young-Han,9999,0,9999,0
1653408679969,ECE 200,019,091021,Koushanfar; Farinaz,9999,0,9999,0
1653408679969,ECE 200,020,091022,Kuzum; Duygu,9999,0,9999,0
1653408679969,ECE 200,021,091023,Le; Hanh-Phuc,9999,0,9999,0
1653408679969,ECE 200,022,091024,Lin; Bill,9999,0,9999,0
1653408679969,ECE 200,023,091025,Liu; Zhaowei,9999,0,9999,0
1653408679969,ECE 200,024,091026,Lo; Yu-Hwa,9999,0,9999,0
1653408679969,ECE 200,025,091027,Lomakin; Vitaliy,9999,0,9999,0
1653408679969,ECE 200,026,091028,Mercier; Patrick Philip,9999,0,9999,0
1653408679969,ECE 200,027,091029,Meyer; Florian,9999,0,9999,0
1653408679969,ECE 200,028,091030,Milstein; Laurence B.,9999,0,9999,0
1653408679969,ECE 200,029,091031,Mir Arabbaygi; Siavash,9999,0,9999,0
1653408679969,ECE 200,030,091032,Mookherjea; Shayan,9999,0,9999,0
1653408679969,ECE 200,031,091033,Morris; Karcher William,9999,0,9999,0
1653408679969,ECE 200,032,091034,Ng; Tse Nga,9999,0,9999,0
1653408679969,ECE 200,033,091035,Nguyen; Truong Quang,9999,0,9999,0
1653408679969,ECE 200,034,091036,Nomura; Kenji,9999,0,9999,0
1653408679969,ECE 200,035,091037,Orlitsky; Alon,9999,0,9999,0
1653408679969,ECE 200,036,091038,Pal; Piya,9999,0,9999,0
1653408679969,ECE 200,037,091039,Papen; George C.,9999,0,9999,0
1653408679969,ECE 200,038,091040,Radic; Stojan,9999,0,9999,0
1653408679969,ECE 200,039,091041,Rao; Bhaskar D.,9999,0,9999,0
1653408679969,ECE 200,040,091042,Rao; Ramesh R,9999,0,9999,0
1653408679969,ECE 200,041,091043,Rebeiz; Gabriel,9999,0,9999,0
1653408679969,ECE 200,042,091044,Sanford; John R,9999,0,9999,0
1653408679969,ECE 200,043,091045,Siegel; Paul H.,9999,0,9999,0
1653408679969,ECE 200,044,091046,Sievenpiper; Daniel F.,9999,0,9999,0
1653408679969,ECE 200,045,091047,Sworder; David D.,9999,0,9999,0
1653408679969,ECE 200,046,091048,Taur; Yuan,9999,0,9999,0
1653408679969,ECE 200,047,091049,Touri; Behrouz,9999,0,9999,0
1653408679969,ECE 200,048,091050,Trivedi; Mohan M.,9999,0,9999,0
1653408679969,ECE 200,049,091051,Vardy; Alexander,9999,0,9999,0
1653408679969,ECE 200,050,091052,Vasconcelos; Nuno,9999,0,9999,0
1653408679969,ECE 200,051,091053,Wang; Xiaolong,9999,0,9999,0
1653408679969,ECE 200,052,091054,Xie; Pengtao,9999,0,9999,0
1653408679969,ECE 200,053,091055,Yip; Michael,9999,0,9999,0
1653408679969,ECE 200,054,091056,Zeger; Kenneth A.,9999,0,9999,0
1653408679969,ECE 200,055,091057,Zhang; Xinyu,9999,0,9999,0
1653408679969,ECE 200,056,091058,Turakhia; Yatish Girish,9999,0,9999,0
1653408679969,ECE 200,057,091059,Kang; Mingu,9999,0,9999,0
1653408679969,ECE 200,058,091060,Shi; Yuanyuan,9999,0,9999,0
1653408679969,ECE 200,059,091061,Wang; Edward Jay,9999,0,9999,0
1653408679969,ECE 200,060,091062,Zheng; Yang,9999,0,9999,0
1653408680495,ECE 203,A00,091065,Mercier; Patrick Philip,0,0,0,0
1653408681017,ECE 207A,A00,091605,Liu; Thomas Tao-Ming,0,0,0,0
1653408681539,ECE 212AN,A00,091068,Nomura; Kenji,0,0,0,0
1653408682063,ECE 222A,A00,091069,Rebeiz; Gabriel,0,0,0,0
1653408682593,ECE 225A,A00,091070,Orlitsky; Alon,0,0,0,0
1653408683116,ECE 230A,A00,091071,Nomura; Kenji,0,0,0,0
1653408683645,ECE 236A,A00,091072,Dayeh; Shadi Ahmad,0,0,0,0
1653408684166,ECE 238A,A00,091073,Luo; Jian,0,0,0,0
1653408684166,ECE 238A,B00,091074,Luo; Jian,0,0,0,0
1653408684690,ECE 240A,A00,091075,Radic; Stojan,0,0,0,0
1653408685215,ECE 247A,A00,091592,Shi; Lingyan,0,0,0,0
1653408685738,ECE 250,A00,091076,Touri; Behrouz,0,0,0,0
1653408686265,ECE 251C,A00,091078,Nguyen; Truong Quang,0,0,0,0
1653408686788,ECE 253,A00,091079,Cosman; Pamela C.,0,0,0,0
1653408687313,ECE 255A,A00,091080,Orlitsky; Alon,0,0,0,0
1653408687841,ECE 257A,A00,091081,Zhang; Xinyu,0,0,0,0
1653408688367,ECE 260A,A01,091084,Eldon; John,0,0,0,0
1653408688902,ECE 264C,A00,091085,Galton; Ian A,0,0,0,0
1653408689434,ECE 265C,A00,094889,Presti; Calogero Davide,0,0,0,9
1653408689966,ECE 266,A01,091087,Hall; Drew A.,0,0,0,0
1653408691017,ECE 271A,A00,091090,Vasconcelos; Nuno,0,0,0,0
1653408691539,ECE 272B,A00,091091,Sworder; David D.,0,0,0,0
1653408692140,ECE 275A,A00,091092,Meyer; Florian,0,0,0,0
1653408692669,ECE 277,A00,091093,An; Cheolhong,0,0,0,0
1653408693192,ECE 283,A00,091094,Le; Hanh-Phuc,0,0,0,0
1653408693713,ECE 284,A00,091095,Kang; Mingu,0,0,0,0
1653408693713,ECE 284,B00,091096,Wang; Edward Jay,0,0,0,0
1653408694235,ECE 285,A00,094334,Touri; Behrouz,0,0,0,0
1653408694759,ECE 289,A00,091097,Whelan; David Arthur,0,0,0,0
1653408695281,MATH 200A,A00,087414,Salehi Golsefidy; Alireza,7,0,8,1
1653408695825,MATH 202A,A00,087415,Gill; Philip E.,3,0,8,5
1653408696347,MATH 203A,A00,087416,Oprea; Dragos N.,6,0,8,2
1653408696877,MATH 204A,A00,087417,Kedlaya; Kiran S.,6,0,8,2
1653408697398,MATH 205,A00,087418,Sorensen; Claus M,6,0,8,2
1653408697921,MATH 206A,A00,087419,Izadi; Elham,7,0,8,1
1653408698448,MATH 207A,A00,087420,Mohammadi; Amir,6,0,8,2
1653408698971,MATH 208,A00,087421,Staff,9,0,10,1
1653408699493,MATH 209,A00,087422,Staff,10,0,10,0
1653408700019,MATH 218,A00,087423,Staff,10,0,10,0
1653408700541,MATH 220A,A00,087424,Novak; Jonathan I,7,0,8,1
1653408701079,MATH 231A,A00,087425,Bejenaru; Ioan,4,0,8,4
1653408701604,MATH 240A,A00,087426,Ebenfelt; Peter F,5,0,8,3
1653408702126,MATH 243,A00,087427,Staff,9,0,10,1
1653408702649,MATH 248,A00,087429,Staff,10,0,10,0
1653408703173,MATH 250A,A00,087430,Spolaor; Luca,5,0,8,3
1653408703698,MATH 257A,A00,087431,Spolaor; Luca,7,0,8,1
1653408704219,MATH 258,A00,087432,Staff,9,0,10,1
1653408704755,MATH 264A,A00,087433,Warnke; Lutz Peter,5,0,8,3
1653408705282,MATH 268,A00,087434,Staff,15,0,15,0
1653408705812,MATH 269,A00,087435,Staff,14,0,15,1
1653408706338,MATH 270A,A00,087436,Nie; Jiawang,0,0,8,8
1653408706874,MATH 272A,A00,087437,Tian; Xiaochuan,2,0,8,6
1653408707399,MATH 274,A01,087439,Cheng; Li-Tien,9,0,10,1
1653408707399,MATH 274,A02,087440,Cheng; Li-Tien,10,0,10,0
1653408707934,MATH 278A,A00,087441,Staff,8,0,10,2
1653408708472,MATH 278B,A00,087442,Staff,8,0,10,2
1653408709009,MATH 278C,A00,087443,Staff,8,0,10,2
1653408709547,MATH 280A,A00,087444,Zheng; Tianyi,0,0,8,8
1653408710070,MATH 281A,A00,087445,Bradic; Jelena,0,0,8,8
1653408710591,MATH 282A,A00,087446,Zhang; Danna,0,0,8,8
1653408711130,MATH 283,A00,087447,Tesler; Glenn,0,0,0,14
1653408711661,MATH 286,A00,087448,Kemp; Todd Aahron,6,0,8,2
1653408712182,MATH 287D,A00,087449,Bradic; Jelena,8,0,8,0
1653408712706,MATH 288,A00,087450,Staff,14,0,15,1
1653408712706,MATH 288,B00,087451,Staff,15,0,15,0
1653408712706,MATH 288,C00,087452,Staff,15,0,15,0
1653408713237,MATH 290A,A00,087453,Xu; Zhouli,7,0,8,1
1653408713760,MATH 291A,A00,087454,Xu; Zhouli,7,0,8,1
1653408714284,MATH 292,A00,087455,Staff,10,0,10,0
1653408714807,MATH 295,A00,087456,Staff,50,0,50,0
1653408715331,MATH 297,001,087457,Staff,998,0,999,1
1653409278372,COGS 200,A01,087991,Staff,48,0,50,2
1653409278905,COGS 201,A01,094504,Rangel; Lara M,17,0,25,8
1653409279430,COGS 203,A00,087992,Coulson; Seana M,19,0,20,1
1653409279955,COGS 210A,001,087993,Greene; Deanna Jacquelyn,9998,0,9999,1
1653409279955,COGS 210A,002,087994,Saygin; Ayse P,9999,0,9999,0
1653409279955,COGS 210A,003,087995,Xia; Haijun,9999,0,9999,0
1653409279955,COGS 210A,004,087996,Nitz; Douglas A.,9999,0,9999,0
1653409279955,COGS 210A,005,087997,Hollan; James D.,9999,0,9999,0
1653409279955,COGS 210A,006,087998,Deak; Gedeon O.,9998,0,9999,1
1653409279955,COGS 210A,007,087999,Rossano; Federico,9999,0,9999,0
1653409280485,COGS 211A,A00,088000,Coulson; Seana M,9997,0,9999,2
1653409281016,COGS 229,A00,088002,Staff,23,0,25,2
1653409281553,COGS 260,B00,094231,Staff,17,0,20,3
1653409281553,COGS 260,A00,088004,Nitz; Douglas A.,9998,0,9999,1
1653409282091,CSE 202,A00,090110,Paturi; Ramamohan,0,0,0,0
1653409282091,CSE 202,B00,090111,Paturi; Ramamohan,0,0,0,0
1653409282708,CSE 207B,A00,090112,Heninger; Nadia A,0,0,0,0
1653409283232,CSE 208,A00,094858,Micciancio; Daniele,0,0,0,0
1653409283756,CSE 210,A00,090113,Powell; Thomas Allan,0,0,0,0
1653409284287,CSE 219,A00,090898,Staff,0,0,0,0
1653409284816,CSE 221,A00,090114,Zhou; Yuan-Yuan,0,0,0,0
1653409285338,CSE 229A,A00,090115,Porter; George M,0,0,0,0
1653409285865,CSE 229C,A00,090116,Savage; Stefan,0,0,0,0
1653409286387,CSE 230,A00,090117,Jhala; Ranjit,0,0,0,0
1653409286912,CSE 232,A00,090118,Papakonstantinou; Yannis,0,0,0,0
1653409287433,CSE 239A,A00,090121,Kumar; Arun Kumar,0,0,0,0
1653409287965,CSE 239B,A00,090122,Jhala; Ranjit,0,0,0,0
1653409288492,CSE 240A,A00,090123,Zhao; Jishen,0,0,189,189
1653409289014,CSE 243A,A00,090124,Orailoglu; Alex,3,0,15,12
1653409289542,CSE 249B,A00,090125,Kahng; Andrew Byun,14,0,20,6
1653409290063,CSE 250A,A00,090126,Berg-Kirkpatrick; Taylor D,0,0,0,0
1653409290587,CSE 252A,A00,090127,Ochoa; Benjamin Lawrence,0,0,0,0
1653409291109,CSE 258,A01,090129,McAuley; Julian John,0,0,0,0
1653409291635,CSE 258R,A01,090131,McAuley; Julian John,0,0,0,0
1653409292164,CSE 274,A00,090132,Ramamoorthi; Ravi,0,0,0,0
1653409292689,CSE 276A,A00,090133,Christensen; Henrik I,0,0,0,0
1653409293211,CSE 276C,A00,090134,Christensen; Henrik I,0,0,0,0
1653409293739,CSE 290,A00,090135,Bafna; Vineet,0,0,0,0
1653409293739,CSE 290,B00,090136,Ramamoorthi; Ravi,0,0,0,0
1653409293739,CSE 290,C00,090137,Li; Tzumao,10,0,10,0
1653409293739,CSE 290,D00,090138,Zhou; Yuan-Yuan,10,0,10,0
1653409293739,CSE 290,E00,090139,Christensen; Henrik I,10,0,10,0
1653409293739,CSE 290,F00,094053,Shalev; Aaron D,0,0,0,0
1653409294270,CSE 291,A00,090140,Munyaka; Imani N. S.,0,0,0,0
1653409294270,CSE 291,B00,094880,Yu; Qi,0,0,0,0
1653409294270,CSE 291,C00,090142,Pannuto; Patrick William,0,0,0,0
1653409294270,CSE 291,D00,094881,Zhang; Yiying,0,0,0,0
1653409294270,CSE 291,E00,095118,Su; Hao,0,0,0,0
1653409294805,CSE 293,001,094905,Bafna; Vineet,9999,0,9999,0
1653409294805,CSE 293,002,094906,Bellare; Mihir,9999,0,9999,0
1653409294805,CSE 293,003,094907,Berg-Kirkpatrick; Taylor D,9999,0,9999,0
1653409294805,CSE 293,004,094908,Christensen; Henrik I,9999,0,9999,0
1653409294805,CSE 293,005,094909,Cottrell; Garrison W,9999,0,9999,0
1653409294805,CSE 293,006,094910,Deutsch; Alin Bernard,9999,0,9999,0
1653409294805,CSE 293,007,094911,Esmaeilzadeh; Hadi,9999,0,9999,0
1653409294805,CSE 293,008,094912,Freund; Yoav,9999,0,9999,0
1653409294805,CSE 293,009,094913,Griswold; William G.,9999,0,9999,0
1653409294805,CSE 293,010,094914,Gymrek; Melissa Ann,9999,0,9999,0
1653409294805,CSE 293,011,094915,Heninger; Nadia A,9999,0,9999,0
1653409294805,CSE 293,012,094916,Impagliazzo; Russell,9999,0,9999,0
1653409294805,CSE 293,013,094917,Jhala; Ranjit,9999,0,9999,0
1653409294805,CSE 293,014,094918,Kahng; Andrew Byun,9999,0,9999,0
1653409294805,CSE 293,015,094919,Kane; Daniel Mertz,9999,0,9999,0
1653409294805,CSE 293,016,094920,Kriegman; David J,9999,0,9999,0
1653409294805,CSE 293,017,094921,Kumar; Arun Kumar,9999,0,9999,0
1653409294805,CSE 293,018,094922,Lerner; Sorin,9999,0,9999,0
1653409294805,CSE 293,019,094923,Lovett; Shachar,9999,0,9999,0
1653409294805,CSE 293,020,094924,McAuley; Julian John,9999,0,9999,0
1653409294805,CSE 293,021,094925,Micciancio; Daniele,9999,0,9999,0
1653409294805,CSE 293,022,094926,Orailoglu; Alex,9999,0,9999,0
1653409294805,CSE 293,023,094927,Paturi; Ramamohan,9999,0,9999,0
1653409294805,CSE 293,024,094928,Polikarpova; Nadezhda,9999,0,9999,0
1653409294805,CSE 293,025,094929,Politz; Joseph Gibbs,9999,0,9999,0
1653409294805,CSE 293,026,094930,Porter; George M,9999,0,9999,0
1653409294805,CSE 293,027,094931,Porter; Leonard Emerson,9999,0,9999,0
1653409294805,CSE 293,028,094932,Ramamoorthi; Ravi,9999,0,9999,0
1653409294805,CSE 293,029,094933,Sahoo; Debashis,9999,0,9999,0
1653409294805,CSE 293,030,094934,Saul; Lawrence,9999,0,9999,0
1653409294805,CSE 293,031,094935,Savage; Stefan,9999,0,9999,0
1653409294805,CSE 293,032,094936,Schulze; Jurgen P.,9999,0,9999,0
1653409294805,CSE 293,033,094937,Snoeren; Alex C.,9999,0,9999,0
1653409294805,CSE 293,034,094938,Shang; Jingbo,9999,0,9999,0
1653409294805,CSE 293,035,094939,Stefan; Deian,9999,0,9999,0
1653409294805,CSE 293,036,094940,Su; Hao,9999,0,9999,0
1653409294805,CSE 293,037,094941,Swanson; Steven James,9999,0,9999,0
1653409294805,CSE 293,038,094942,Tullsen; Dean Michael,9999,0,9999,0
1653409294805,CSE 293,039,094943,Voelker; Geoffrey M.,9999,0,9999,0
1653409294805,CSE 293,040,094944,Zhao; Jishen,9999,0,9999,0
1653409294805,CSE 293,041,094945,Zhou; Yuan-Yuan,9999,0,9999,0
1653409294805,CSE 293,042,094946,Gao; Sicun,9998,0,9999,1
1653409294805,CSE 293,043,094947,Weibel; Nadir,9999,0,9999,0
1653409294805,CSE 293,044,094948,Gupta; Rajesh K.,9999,0,9999,0
1653409295328,CSE 294,A00,090143,Porter; George M,9,0,10,1
1653409295852,DSE 200,A00,091799,Staff,50,0,50,0
1653409296377,DSE 203,A00,091800,Gupta; Amarnath,30,0,30,0
1653409296900,DSE 250,A00,091801,Deutsch; Alin Bernard,30,0,30,0
1653409297438,DSE 290,A00,091802,Altintas De Callaf; Ilkay,50,0,50,0
1653409297988,ECE 200,001,091003,Antipa; Nicholas A,9999,0,9999,0
1653409297988,ECE 200,002,091004,Atanasov; Nikolay A.,9999,0,9999,0
1653409297988,ECE 200,003,091005,Bharadia; Dinesh,9999,0,9999,0
1653409297988,ECE 200,004,091006,Cheng; Chung Kuan,9999,0,9999,0
1653409297988,ECE 200,005,091007,Cosman; Pamela C.,9999,0,9999,0
1653409297988,ECE 200,006,091008,Staff,9999,0,9999,0
1653409297988,ECE 200,007,091009,Dayeh; Shadi Ahmad,9999,0,9999,0
1653409297988,ECE 200,008,091010,Fainman; Yeshaiahu,9999,0,9999,0
1653409297988,ECE 200,009,091011,Ford; Joseph Earl,9999,0,9999,0
1653409297988,ECE 200,010,091012,Franceschetti; Massimo,9999,0,9999,0
1653409297988,ECE 200,011,091013,Fullerton; Eric E,9999,0,9999,0
1653409297988,ECE 200,012,091014,Galton; Ian A,9999,0,9999,0
1653409297988,ECE 200,013,091015,Gilja; Vikash,9999,0,9999,0
1653409297988,ECE 200,014,091016,Hall; Drew A.,9999,0,9999,0
1653409297988,ECE 200,015,091017,Hsueh; Tzu-Chien,9999,0,9999,0
1653409297988,ECE 200,016,091018,Javidi; Tara,9999,0,9999,0
1653409297988,ECE 200,017,091019,Kahng; Andrew Byun,9999,0,9999,0
1653409297988,ECE 200,018,091020,Kim; Young-Han,9999,0,9999,0
1653409297988,ECE 200,019,091021,Koushanfar; Farinaz,9999,0,9999,0
1653409297988,ECE 200,020,091022,Kuzum; Duygu,9999,0,9999,0
1653409297988,ECE 200,021,091023,Le; Hanh-Phuc,9999,0,9999,0
1653409297988,ECE 200,022,091024,Lin; Bill,9999,0,9999,0
1653409297988,ECE 200,023,091025,Liu; Zhaowei,9999,0,9999,0
1653409297988,ECE 200,024,091026,Lo; Yu-Hwa,9999,0,9999,0
1653409297988,ECE 200,025,091027,Lomakin; Vitaliy,9999,0,9999,0
1653409297988,ECE 200,026,091028,Mercier; Patrick Philip,9999,0,9999,0
1653409297988,ECE 200,027,091029,Meyer; Florian,9999,0,9999,0
1653409297988,ECE 200,028,091030,Milstein; Laurence B.,9999,0,9999,0
1653409297988,ECE 200,029,091031,Mir Arabbaygi; Siavash,9999,0,9999,0
1653409297988,ECE 200,030,091032,Mookherjea; Shayan,9999,0,9999,0
1653409297988,ECE 200,031,091033,Morris; Karcher William,9999,0,9999,0
1653409297988,ECE 200,032,091034,Ng; Tse Nga,9999,0,9999,0
1653409297988,ECE 200,033,091035,Nguyen; Truong Quang,9999,0,9999,0
1653409297988,ECE 200,034,091036,Nomura; Kenji,9999,0,9999,0
1653409297988,ECE 200,035,091037,Orlitsky; Alon,9999,0,9999,0
1653409297988,ECE 200,036,091038,Pal; Piya,9999,0,9999,0
1653409297988,ECE 200,037,091039,Papen; George C.,9999,0,9999,0
1653409297988,ECE 200,038,091040,Radic; Stojan,9999,0,9999,0
1653409297988,ECE 200,039,091041,Rao; Bhaskar D.,9999,0,9999,0
1653409297988,ECE 200,040,091042,Rao; Ramesh R,9999,0,9999,0
1653409297988,ECE 200,041,091043,Rebeiz; Gabriel,9999,0,9999,0
1653409297988,ECE 200,042,091044,Sanford; John R,9999,0,9999,0
1653409297988,ECE 200,043,091045,Siegel; Paul H.,9999,0,9999,0
1653409297988,ECE 200,044,091046,Sievenpiper; Daniel F.,9999,0,9999,0
1653409297988,ECE 200,045,091047,Sworder; David D.,9999,0,9999,0
1653409297988,ECE 200,046,091048,Taur; Yuan,9999,0,9999,0
1653409297988,ECE 200,047,091049,Touri; Behrouz,9999,0,9999,0
1653409297988,ECE 200,048,091050,Trivedi; Mohan M.,9999,0,9999,0
1653409297988,ECE 200,049,091051,Vardy; Alexander,9999,0,9999,0
1653409297988,ECE 200,050,091052,Vasconcelos; Nuno,9999,0,9999,0
1653409297988,ECE 200,051,091053,Wang; Xiaolong,9999,0,9999,0
1653409297988,ECE 200,052,091054,Xie; Pengtao,9999,0,9999,0
1653409297988,ECE 200,053,091055,Yip; Michael,9999,0,9999,0
1653409297988,ECE 200,054,091056,Zeger; Kenneth A.,9999,0,9999,0
1653409297988,ECE 200,055,091057,Zhang; Xinyu,9999,0,9999,0
1653409297988,ECE 200,056,091058,Turakhia; Yatish Girish,9999,0,9999,0
1653409297988,ECE 200,057,091059,Kang; Mingu,9999,0,9999,0
1653409297988,ECE 200,058,091060,Shi; Yuanyuan,9999,0,9999,0
1653409297988,ECE 200,059,091061,Wang; Edward Jay,9999,0,9999,0
1653409297988,ECE 200,060,091062,Zheng; Yang,9999,0,9999,0
1653409298512,ECE 203,A00,091065,Mercier; Patrick Philip,0,0,0,0
1653409299035,ECE 207A,A00,091605,Liu; Thomas Tao-Ming,0,0,0,0
1653409299600,ECE 212AN,A00,091068,Nomura; Kenji,0,0,0,0
1653409300129,ECE 222A,A00,091069,Rebeiz; Gabriel,0,0,0,0
1653409300654,ECE 225A,A00,091070,Orlitsky; Alon,0,0,0,0
1653409301180,ECE 230A,A00,091071,Nomura; Kenji,0,0,0,0
1653409301704,ECE 236A,A00,091072,Dayeh; Shadi Ahmad,0,0,0,0
1653409302227,ECE 238A,A00,091073,Luo; Jian,0,0,0,0
1653409302227,ECE 238A,B00,091074,Luo; Jian,0,0,0,0
1653409302754,ECE 240A,A00,091075,Radic; Stojan,0,0,0,0
1653409303285,ECE 247A,A00,091592,Shi; Lingyan,0,0,0,0
1653409303808,ECE 250,A00,091076,Touri; Behrouz,0,0,0,0
1653409304333,ECE 251C,A00,091078,Nguyen; Truong Quang,0,0,0,0
1653409304857,ECE 253,A00,091079,Cosman; Pamela C.,0,0,0,0
1653409305380,ECE 255A,A00,091080,Orlitsky; Alon,0,0,0,0
1653409305908,ECE 257A,A00,091081,Zhang; Xinyu,0,0,0,0
1653409306439,ECE 260A,A01,091084,Eldon; John,0,0,0,0
1653409306971,ECE 264C,A00,091085,Galton; Ian A,0,0,0,0
1653409307495,ECE 265C,A00,094889,Presti; Calogero Davide,0,0,0,9
1653409308022,ECE 266,A01,091087,Hall; Drew A.,0,0,0,0
1653409309106,ECE 271A,A00,091090,Vasconcelos; Nuno,0,0,0,0
1653409309632,ECE 272B,A00,091091,Sworder; David D.,0,0,0,0
1653409310158,ECE 275A,A00,091092,Meyer; Florian,0,0,0,0
1653409310681,ECE 277,A00,091093,An; Cheolhong,0,0,0,0
1653409311204,ECE 283,A00,091094,Le; Hanh-Phuc,0,0,0,0
1653409311738,ECE 284,A00,091095,Kang; Mingu,0,0,0,0
1653409311738,ECE 284,B00,091096,Wang; Edward Jay,0,0,0,0
1653409312269,ECE 285,A00,094334,Touri; Behrouz,0,0,0,0
1653409312791,ECE 289,A00,091097,Whelan; David Arthur,0,0,0,0
1653409313332,MATH 200A,A00,087414,Salehi Golsefidy; Alireza,7,0,8,1
1653409313860,MATH 202A,A00,087415,Gill; Philip E.,3,0,8,5
1653409314382,MATH 203A,A00,087416,Oprea; Dragos N.,6,0,8,2
1653409314908,MATH 204A,A00,087417,Kedlaya; Kiran S.,6,0,8,2
1653409315432,MATH 205,A00,087418,Sorensen; Claus M,6,0,8,2
1653409315964,MATH 206A,A00,087419,Izadi; Elham,7,0,8,1
1653409316495,MATH 207A,A00,087420,Mohammadi; Amir,6,0,8,2
1653409317021,MATH 208,A00,087421,Staff,9,0,10,1
1653409317544,MATH 209,A00,087422,Staff,10,0,10,0
1653409318065,MATH 218,A00,087423,Staff,10,0,10,0
1653409318593,MATH 220A,A00,087424,Novak; Jonathan I,7,0,8,1
1653409319115,MATH 231A,A00,087425,Bejenaru; Ioan,4,0,8,4
1653409319639,MATH 240A,A00,087426,Ebenfelt; Peter F,5,0,8,3
1653409320163,MATH 243,A00,087427,Staff,9,0,10,1
1653409320685,MATH 248,A00,087429,Staff,10,0,10,0
1653409321213,MATH 250A,A00,087430,Spolaor; Luca,5,0,8,3
1653409321738,MATH 257A,A00,087431,Spolaor; Luca,7,0,8,1
1653409322269,MATH 258,A00,087432,Staff,9,0,10,1
1653409322794,MATH 264A,A00,087433,Warnke; Lutz Peter,5,0,8,3
1653409323316,MATH 268,A00,087434,Staff,15,0,15,0
1653409323841,MATH 269,A00,087435,Staff,14,0,15,1
1653409324364,MATH 270A,A00,087436,Nie; Jiawang,0,0,8,8
1653409324887,MATH 272A,A00,087437,Tian; Xiaochuan,2,0,8,6
1653409325411,MATH 274,A01,087439,Cheng; Li-Tien,9,0,10,1
1653409325411,MATH 274,A02,087440,Cheng; Li-Tien,10,0,10,0
1653409325934,MATH 278A,A00,087441,Staff,8,0,10,2
1653409326478,MATH 278B,A00,087442,Staff,8,0,10,2
1653409327006,MATH 278C,A00,087443,Staff,8,0,10,2
1653409327547,MATH 280A,A00,087444,Zheng; Tianyi,0,0,8,8
1653409328073,MATH 281A,A00,087445,Bradic; Jelena,0,0,8,8
1653409328598,MATH 282A,A00,087446,Zhang; Danna,0,0,8,8
1653409329123,MATH 283,A00,087447,Tesler; Glenn,0,0,0,14
1653409329647,MATH 286,A00,087448,Kemp; Todd Aahron,6,0,8,2
1653409330170,MATH 287D,A00,087449,Bradic; Jelena,8,0,8,0
1653409330693,MATH 288,A00,087450,Staff,14,0,15,1
1653409330693,MATH 288,B00,087451,Staff,15,0,15,0
1653409330693,MATH 288,C00,087452,Staff,15,0,15,0
1653409331223,MATH 290A,A00,087453,Xu; Zhouli,7,0,8,1
1653409331747,MATH 291A,A00,087454,Xu; Zhouli,7,0,8,1
1653409332273,MATH 292,A00,087455,Staff,10,0,10,0
1653409332800,MATH 295,A00,087456,Staff,50,0,50,0
1653409333335,MATH 297,001,087457,Staff,998,0,999,1
1653409895497,COGS 200,A01,087991,Staff,48,0,50,2
1653409896021,COGS 201,A01,094504,Rangel; Lara M,17,0,25,8
1653409896555,COGS 203,A00,087992,Coulson; Seana M,19,0,20,1
1653409897093,COGS 210A,001,087993,Greene; Deanna Jacquelyn,9998,0,9999,1
1653409897093,COGS 210A,002,087994,Saygin; Ayse P,9999,0,9999,0
1653409897093,COGS 210A,003,087995,Xia; Haijun,9999,0,9999,0
1653409897093,COGS 210A,004,087996,Nitz; Douglas A.,9999,0,9999,0
1653409897093,COGS 210A,005,087997,Hollan; James D.,9999,0,9999,0
1653409897093,COGS 210A,006,087998,Deak; Gedeon O.,9998,0,9999,1
1653409897093,COGS 210A,007,087999,Rossano; Federico,9999,0,9999,0
1653409897617,COGS 211A,A00,088000,Coulson; Seana M,9997,0,9999,2
1653409898142,COGS 229,A00,088002,Staff,23,0,25,2
1653409898681,COGS 260,B00,094231,Staff,17,0,20,3
1653409898681,COGS 260,A00,088004,Nitz; Douglas A.,9998,0,9999,1
1653409899212,CSE 202,A00,090110,Paturi; Ramamohan,0,0,0,0
1653409899212,CSE 202,B00,090111,Paturi; Ramamohan,0,0,0,0
1653409899745,CSE 207B,A00,090112,Heninger; Nadia A,0,0,0,0
1653409900282,CSE 208,A00,094858,Micciancio; Daniele,0,0,0,0
1653409900827,CSE 210,A00,090113,Powell; Thomas Allan,0,0,0,0
1653409901352,CSE 219,A00,090898,Staff,0,0,0,0
1653409901879,CSE 221,A00,090114,Zhou; Yuan-Yuan,0,0,0,0
1653409902400,CSE 229A,A00,090115,Porter; George M,0,0,0,0
1653409902934,CSE 229C,A00,090116,Savage; Stefan,0,0,0,0
1653409903455,CSE 230,A00,090117,Jhala; Ranjit,0,0,0,0
1653409903982,CSE 232,A00,090118,Papakonstantinou; Yannis,0,0,0,0
1653409904514,CSE 239A,A00,090121,Kumar; Arun Kumar,0,0,0,0
1653409905036,CSE 239B,A00,090122,Jhala; Ranjit,0,0,0,0
1653409905569,CSE 240A,A00,090123,Zhao; Jishen,0,0,189,189
1653409906090,CSE 243A,A00,090124,Orailoglu; Alex,3,0,15,12
1653409906611,CSE 249B,A00,090125,Kahng; Andrew Byun,14,0,20,6
1653409907138,CSE 250A,A00,090126,Berg-Kirkpatrick; Taylor D,0,0,0,0
1653409907664,CSE 252A,A00,090127,Ochoa; Benjamin Lawrence,0,0,0,0
1653409908202,CSE 258,A01,090129,McAuley; Julian John,0,0,0,0
1653409908732,CSE 258R,A01,090131,McAuley; Julian John,0,0,0,0
1653409909259,CSE 274,A00,090132,Ramamoorthi; Ravi,0,0,0,0
1653409909782,CSE 276A,A00,090133,Christensen; Henrik I,0,0,0,0
1653409910318,CSE 276C,A00,090134,Christensen; Henrik I,0,0,0,0
1653409910850,CSE 290,A00,090135,Bafna; Vineet,0,0,0,0
1653409910850,CSE 290,B00,090136,Ramamoorthi; Ravi,0,0,0,0
1653409910850,CSE 290,C00,090137,Li; Tzumao,10,0,10,0
1653409910850,CSE 290,D00,090138,Zhou; Yuan-Yuan,10,0,10,0
1653409910850,CSE 290,E00,090139,Christensen; Henrik I,10,0,10,0
1653409910850,CSE 290,F00,094053,Shalev; Aaron D,0,0,0,0
1653409911374,CSE 291,A00,090140,Munyaka; Imani N. S.,0,0,0,0
1653409911374,CSE 291,B00,094880,Yu; Qi,0,0,0,0
1653409911374,CSE 291,C00,090142,Pannuto; Patrick William,0,0,0,0
1653409911374,CSE 291,D00,094881,Zhang; Yiying,0,0,0,0
1653409911374,CSE 291,E00,095118,Su; Hao,0,0,0,0
1653409911910,CSE 293,001,094905,Bafna; Vineet,9999,0,9999,0
1653409911910,CSE 293,002,094906,Bellare; Mihir,9999,0,9999,0
1653409911910,CSE 293,003,094907,Berg-Kirkpatrick; Taylor D,9999,0,9999,0
1653409911910,CSE 293,004,094908,Christensen; Henrik I,9999,0,9999,0
1653409911910,CSE 293,005,094909,Cottrell; Garrison W,9999,0,9999,0
1653409911910,CSE 293,006,094910,Deutsch; Alin Bernard,9999,0,9999,0
1653409911910,CSE 293,007,094911,Esmaeilzadeh; Hadi,9999,0,9999,0
1653409911910,CSE 293,008,094912,Freund; Yoav,9999,0,9999,0
1653409911910,CSE 293,009,094913,Griswold; William G.,9999,0,9999,0
1653409911910,CSE 293,010,094914,Gymrek; Melissa Ann,9999,0,9999,0
1653409911910,CSE 293,011,094915,Heninger; Nadia A,9999,0,9999,0
1653409911910,CSE 293,012,094916,Impagliazzo; Russell,9999,0,9999,0
1653409911910,CSE 293,013,094917,Jhala; Ranjit,9999,0,9999,0
1653409911910,CSE 293,014,094918,Kahng; Andrew Byun,9999,0,9999,0
1653409911910,CSE 293,015,094919,Kane; Daniel Mertz,9999,0,9999,0
1653409911910,CSE 293,016,094920,Kriegman; David J,9999,0,9999,0
1653409911910,CSE 293,017,094921,Kumar; Arun Kumar,9999,0,9999,0
1653409911910,CSE 293,018,094922,Lerner; Sorin,9999,0,9999,0
1653409911910,CSE 293,019,094923,Lovett; Shachar,9999,0,9999,0
1653409911910,CSE 293,020,094924,McAuley; Julian John,9999,0,9999,0
1653409911910,CSE 293,021,094925,Micciancio; Daniele,9999,0,9999,0
1653409911910,CSE 293,022,094926,Orailoglu; Alex,9999,0,9999,0
1653409911910,CSE 293,023,094927,Paturi; Ramamohan,9999,0,9999,0
1653409911910,CSE 293,024,094928,Polikarpova; Nadezhda,9999,0,9999,0
1653409911910,CSE 293,025,094929,Politz; Joseph Gibbs,9999,0,9999,0
1653409911910,CSE 293,026,094930,Porter; George M,9999,0,9999,0
1653409911910,CSE 293,027,094931,Porter; Leonard Emerson,9999,0,9999,0
1653409911910,CSE 293,028,094932,Ramamoorthi; Ravi,9999,0,9999,0
1653409911910,CSE 293,029,094933,Sahoo; Debashis,9999,0,9999,0
1653409911910,CSE 293,030,094934,Saul; Lawrence,9999,0,9999,0
1653409911910,CSE 293,031,094935,Savage; Stefan,9999,0,9999,0
1653409911910,CSE 293,032,094936,Schulze; Jurgen P.,9999,0,9999,0
1653409911910,CSE 293,033,094937,Snoeren; Alex C.,9999,0,9999,0
1653409911910,CSE 293,034,094938,Shang; Jingbo,9999,0,9999,0
1653409911910,CSE 293,035,094939,Stefan; Deian,9999,0,9999,0
1653409911910,CSE 293,036,094940,Su; Hao,9999,0,9999,0
1653409911910,CSE 293,037,094941,Swanson; Steven James,9999,0,9999,0
1653409911910,CSE 293,038,094942,Tullsen; Dean Michael,9999,0,9999,0
1653409911910,CSE 293,039,094943,Voelker; Geoffrey M.,9999,0,9999,0
1653409911910,CSE 293,040,094944,Zhao; Jishen,9999,0,9999,0
1653409911910,CSE 293,041,094945,Zhou; Yuan-Yuan,9999,0,9999,0
1653409911910,CSE 293,042,094946,Gao; Sicun,9998,0,9999,1
1653409911910,CSE 293,043,094947,Weibel; Nadir,9999,0,9999,0
1653409911910,CSE 293,044,094948,Gupta; Rajesh K.,9999,0,9999,0
1653409912431,CSE 294,A00,090143,Porter; George M,9,0,10,1
1653409912965,DSE 200,A00,091799,Staff,50,0,50,0
1653409913499,DSE 203,A00,091800,Gupta; Amarnath,30,0,30,0
1653409914027,DSE 250,A00,091801,Deutsch; Alin Bernard,30,0,30,0
1653409914550,DSE 290,A00,091802,Altintas De Callaf; Ilkay,50,0,50,0
1653409915107,ECE 200,001,091003,Antipa; Nicholas A,9999,0,9999,0
1653409915107,ECE 200,002,091004,Atanasov; Nikolay A.,9999,0,9999,0
1653409915107,ECE 200,003,091005,Bharadia; Dinesh,9999,0,9999,0
1653409915107,ECE 200,004,091006,Cheng; Chung Kuan,9999,0,9999,0
1653409915107,ECE 200,005,091007,Cosman; Pamela C.,9999,0,9999,0
1653409915107,ECE 200,006,091008,Staff,9999,0,9999,0
1653409915107,ECE 200,007,091009,Dayeh; Shadi Ahmad,9999,0,9999,0
1653409915107,ECE 200,008,091010,Fainman; Yeshaiahu,9999,0,9999,0
1653409915107,ECE 200,009,091011,Ford; Joseph Earl,9999,0,9999,0
1653409915107,ECE 200,010,091012,Franceschetti; Massimo,9999,0,9999,0
1653409915107,ECE 200,011,091013,Fullerton; Eric E,9999,0,9999,0
1653409915107,ECE 200,012,091014,Galton; Ian A,9999,0,9999,0
1653409915107,ECE 200,013,091015,Gilja; Vikash,9999,0,9999,0
1653409915107,ECE 200,014,091016,Hall; Drew A.,9999,0,9999,0
1653409915107,ECE 200,015,091017,Hsueh; Tzu-Chien,9999,0,9999,0
1653409915107,ECE 200,016,091018,Javidi; Tara,9999,0,9999,0
1653409915107,ECE 200,017,091019,Kahng; Andrew Byun,9999,0,9999,0
1653409915107,ECE 200,018,091020,Kim; Young-Han,9999,0,9999,0
1653409915107,ECE 200,019,091021,Koushanfar; Farinaz,9999,0,9999,0
1653409915107,ECE 200,020,091022,Kuzum; Duygu,9999,0,9999,0
1653409915107,ECE 200,021,091023,Le; Hanh-Phuc,9999,0,9999,0
1653409915107,ECE 200,022,091024,Lin; Bill,9999,0,9999,0
1653409915107,ECE 200,023,091025,Liu; Zhaowei,9999,0,9999,0
1653409915107,ECE 200,024,091026,Lo; Yu-Hwa,9999,0,9999,0
1653409915107,ECE 200,025,091027,Lomakin; Vitaliy,9999,0,9999,0
1653409915107,ECE 200,026,091028,Mercier; Patrick Philip,9999,0,9999,0
1653409915107,ECE 200,027,091029,Meyer; Florian,9999,0,9999,0
1653409915107,ECE 200,028,091030,Milstein; Laurence B.,9999,0,9999,0
1653409915107,ECE 200,029,091031,Mir Arabbaygi; Siavash,9999,0,9999,0
1653409915107,ECE 200,030,091032,Mookherjea; Shayan,9999,0,9999,0
1653409915107,ECE 200,031,091033,Morris; Karcher William,9999,0,9999,0
1653409915107,ECE 200,032,091034,Ng; Tse Nga,9999,0,9999,0
1653409915107,ECE 200,033,091035,Nguyen; Truong Quang,9999,0,9999,0
1653409915107,ECE 200,034,091036,Nomura; Kenji,9999,0,9999,0
1653409915107,ECE 200,035,091037,Orlitsky; Alon,9999,0,9999,0
1653409915107,ECE 200,036,091038,Pal; Piya,9999,0,9999,0
1653409915107,ECE 200,037,091039,Papen; George C.,9999,0,9999,0
1653409915107,ECE 200,038,091040,Radic; Stojan,9999,0,9999,0
1653409915107,ECE 200,039,091041,Rao; Bhaskar D.,9999,0,9999,0
1653409915107,ECE 200,040,091042,Rao; Ramesh R,9999,0,9999,0
1653409915107,ECE 200,041,091043,Rebeiz; Gabriel,9999,0,9999,0
1653409915107,ECE 200,042,091044,Sanford; John R,9999,0,9999,0
1653409915107,ECE 200,043,091045,Siegel; Paul H.,9999,0,9999,0
1653409915107,ECE 200,044,091046,Sievenpiper; Daniel F.,9999,0,9999,0
1653409915107,ECE 200,045,091047,Sworder; David D.,9999,0,9999,0
1653409915107,ECE 200,046,091048,Taur; Yuan,9999,0,9999,0
1653409915107,ECE 200,047,091049,Touri; Behrouz,9999,0,9999,0
1653409915107,ECE 200,048,091050,Trivedi; Mohan M.,9999,0,9999,0
1653409915107,ECE 200,049,091051,Vardy; Alexander,9999,0,9999,0
1653409915107,ECE 200,050,091052,Vasconcelos; Nuno,9999,0,9999,0
1653409915107,ECE 200,051,091053,Wang; Xiaolong,9999,0,9999,0
1653409915107,ECE 200,052,091054,Xie; Pengtao,9999,0,9999,0
1653409915107,ECE 200,053,091055,Yip; Michael,9999,0,9999,0
1653409915107,ECE 200,054,091056,Zeger; Kenneth A.,9999,0,9999,0
1653409915107,ECE 200,055,091057,Zhang; Xinyu,9999,0,9999,0
1653409915107,ECE 200,056,091058,Turakhia; Yatish Girish,9999,0,9999,0
1653409915107,ECE 200,057,091059,Kang; Mingu,9999,0,9999,0
1653409915107,ECE 200,058,091060,Shi; Yuanyuan,9999,0,9999,0
1653409915107,ECE 200,059,091061,Wang; Edward Jay,9999,0,9999,0
1653409915107,ECE 200,060,091062,Zheng; Yang,9999,0,9999,0
1653409915642,ECE 203,A00,091065,Mercier; Patrick Philip,0,0,0,0
1653409916169,ECE 207A,A00,091605,Liu; Thomas Tao-Ming,0,0,0,0
1653409916698,ECE 212AN,A00,091068,Nomura; Kenji,0,0,0,0
1653409917226,ECE 222A,A00,091069,Rebeiz; Gabriel,0,0,0,0
1653409917750,ECE 225A,A00,091070,Orlitsky; Alon,0,0,0,0
1653409918292,ECE 230A,A00,091071,Nomura; Kenji,0,0,0,0
1653409918829,ECE 236A,A00,091072,Dayeh; Shadi Ahmad,0,0,0,0
1653409919443,ECE 238A,A00,091073,Luo; Jian,0,0,0,0
1653409919443,ECE 238A,B00,091074,Luo; Jian,0,0,0,0
1653409919976,ECE 240A,A00,091075,Radic; Stojan,0,0,0,0
1653409920499,ECE 247A,A00,091592,Shi; Lingyan,0,0,0,0
1653409921021,ECE 250,A00,091076,Touri; Behrouz,0,0,0,0
1653409921552,ECE 251C,A00,091078,Nguyen; Truong Quang,0,0,0,0
1653409922075,ECE 253,A00,091079,Cosman; Pamela C.,0,0,0,0
1653409922600,ECE 255A,A00,091080,Orlitsky; Alon,0,0,0,0
1653409923125,ECE 257A,A00,091081,Zhang; Xinyu,0,0,0,0
1653409923658,ECE 260A,A01,091084,Eldon; John,0,0,0,0
1653409924180,ECE 264C,A00,091085,Galton; Ian A,0,0,0,0
1653409924714,ECE 265C,A00,094889,Presti; Calogero Davide,0,0,0,9
1653409925244,ECE 266,A01,091087,Hall; Drew A.,0,0,0,0
1653409926367,ECE 271A,A00,091090,Vasconcelos; Nuno,0,0,0,0
1653409926897,ECE 272B,A00,091091,Sworder; David D.,0,0,0,0
1653409927422,ECE 275A,A00,091092,Meyer; Florian,0,0,0,0
1653409927946,ECE 277,A00,091093,An; Cheolhong,0,0,0,0
1653409928472,ECE 283,A00,091094,Le; Hanh-Phuc,0,0,0,0
1653409928994,ECE 284,A00,091095,Kang; Mingu,0,0,0,0
1653409928994,ECE 284,B00,091096,Wang; Edward Jay,0,0,0,0
1653409929525,ECE 285,A00,094334,Touri; Behrouz,0,0,0,0
1653409930052,ECE 289,A00,091097,Whelan; David Arthur,0,0,0,0
1653409930575,MATH 200A,A00,087414,Salehi Golsefidy; Alireza,7,0,8,1
1653409931101,MATH 202A,A00,087415,Gill; Philip E.,3,0,8,5
1653409931637,MATH 203A,A00,087416,Oprea; Dragos N.,6,0,8,2
1653409932177,MATH 204A,A00,087417,Kedlaya; Kiran S.,6,0,8,2
1653409932699,MATH 205,A00,087418,Sorensen; Claus M,6,0,8,2
1653409933221,MATH 206A,A00,087419,Izadi; Elham,7,0,8,1
1653409933756,MATH 207A,A00,087420,Mohammadi; Amir,6,0,8,2
1653409934278,MATH 208,A00,087421,Staff,9,0,10,1
1653409934802,MATH 209,A00,087422,Staff,10,0,10,0
1653409935325,MATH 218,A00,087423,Staff,10,0,10,0
1653409935852,MATH 220A,A00,087424,Novak; Jonathan I,7,0,8,1
1653409936377,MATH 231A,A00,087425,Bejenaru; Ioan,4,0,8,4
1653409936898,MATH 240A,A00,087426,Ebenfelt; Peter F,5,0,8,3
1653409937426,MATH 243,A00,087427,Staff,9,0,10,1
1653409937956,MATH 248,A00,087429,Staff,10,0,10,0
1653409938478,MATH 250A,A00,087430,Spolaor; Luca,5,0,8,3
1653409939004,MATH 257A,A00,087431,Spolaor; Luca,7,0,8,1
1653409939531,MATH 258,A00,087432,Staff,9,0,10,1
1653409940052,MATH 264A,A00,087433,Warnke; Lutz Peter,5,0,8,3
1653409940579,MATH 268,A00,087434,Staff,15,0,15,0
1653409941120,MATH 269,A00,087435,Staff,14,0,15,1
1653409941650,MATH 270A,A00,087436,Nie; Jiawang,0,0,8,8
1653409942176,MATH 272A,A00,087437,Tian; Xiaochuan,2,0,8,6
1653409942704,MATH 274,A01,087439,Cheng; Li-Tien,9,0,10,1
1653409942704,MATH 274,A02,087440,Cheng; Li-Tien,10,0,10,0
1653409943233,MATH 278A,A00,087441,Staff,8,0,10,2
1653409943754,MATH 278B,A00,087442,Staff,8,0,10,2
1653409944275,MATH 278C,A00,087443,Staff,8,0,10,2
1653409944801,MATH 280A,A00,087444,Zheng; Tianyi,0,0,8,8
1653409945327,MATH 281A,A00,087445,Bradic; Jelena,0,0,8,8
1653409945852,MATH 282A,A00,087446,Zhang; Danna,0,0,8,8
1653409946386,MATH 283,A00,087447,Tesler; Glenn,0,0,0,14
1653409946911,MATH 286,A00,087448,Kemp; Todd Aahron,6,0,8,2
1653409947432,MATH 287D,A00,087449,Bradic; Jelena,8,0,8,0
1653409947955,MATH 288,A00,087450,Staff,14,0,15,1
1653409947955,MATH 288,B00,087451,Staff,15,0,15,0
1653409947955,MATH 288,C00,087452,Staff,15,0,15,0
1653409948485,MATH 290A,A00,087453,Xu; Zhouli,7,0,8,1
1653409949016,MATH 291A,A00,087454,Xu; Zhouli,7,0,8,1
1653409949540,MATH 292,A00,087455,Staff,10,0,10,0
1653409950067,MATH 295,A00,087456,Staff,50,0,50,0
1653409950611,MATH 297,001,087457,Staff,998,0,999,1
1653410512192,COGS 200,A01,087991,Staff,48,0,50,2
1653410512716,COGS 201,A01,094504,Rangel; Lara M,17,0,25,8
1653410513238,COGS 203,A00,087992,Coulson; Seana M,19,0,20,1
1653410513766,COGS 210A,001,087993,Greene; Deanna Jacquelyn,9998,0,9999,1
1653410513766,COGS 210A,002,087994,Saygin; Ayse P,9999,0,9999,0
1653410513766,COGS 210A,003,087995,Xia; Haijun,9999,0,9999,0
1653410513766,COGS 210A,004,087996,Nitz; Douglas A.,9999,0,9999,0
1653410513766,COGS 210A,005,087997,Hollan; James D.,9999,0,9999,0
1653410513766,COGS 210A,006,087998,Deak; Gedeon O.,9998,0,9999,1
1653410513766,COGS 210A,007,087999,Rossano; Federico,9999,0,9999,0
1653410514297,COGS 211A,A00,088000,Coulson; Seana M,9997,0,9999,2
1653410514898,COGS 229,A00,088002,Staff,23,0,25,2
1653410515421,COGS 260,B00,094231,Staff,17,0,20,3
1653410515421,COGS 260,A00,088004,Nitz; Douglas A.,9998,0,9999,1
1653410515943,CSE 202,A00,090110,Paturi; Ramamohan,0,0,0,0
1653410515943,CSE 202,B00,090111,Paturi; Ramamohan,0,0,0,0
1653410516470,CSE 207B,A00,090112,Heninger; Nadia A,0,0,0,0
1653410516997,CSE 208,A00,094858,Micciancio; Daniele,0,0,0,0
1653410517534,CSE 210,A00,090113,Powell; Thomas Allan,0,0,0,0
1653410518057,CSE 219,A00,090898,Staff,0,0,0,0
1653410518579,CSE 221,A00,090114,Zhou; Yuan-Yuan,0,0,0,0
1653410519109,CSE 229A,A00,090115,Porter; George M,0,0,0,0
1653410519633,CSE 229C,A00,090116,Savage; Stefan,0,0,0,0
1653410520155,CSE 230,A00,090117,Jhala; Ranjit,0,0,0,0
1653410520678,CSE 232,A00,090118,Papakonstantinou; Yannis,0,0,0,0
1653410521204,CSE 239A,A00,090121,Kumar; Arun Kumar,0,0,0,0
1653410521728,CSE 239B,A00,090122,Jhala; Ranjit,0,0,0,0
1653410522255,CSE 240A,A00,090123,Zhao; Jishen,0,0,189,189
1653410522780,CSE 243A,A00,090124,Orailoglu; Alex,3,0,15,12
1653410523301,CSE 249B,A00,090125,Kahng; Andrew Byun,13,0,20,7
1653410523824,CSE 250A,A00,090126,Berg-Kirkpatrick; Taylor D,0,0,0,0
1653410524350,CSE 252A,A00,090127,Ochoa; Benjamin Lawrence,0,0,0,0
1653410524880,CSE 258,A01,090129,McAuley; Julian John,0,0,0,0
1653410525407,CSE 258R,A01,090131,McAuley; Julian John,0,0,0,0
1653410525929,CSE 274,A00,090132,Ramamoorthi; Ravi,0,0,0,0
1653410526451,CSE 276A,A00,090133,Christensen; Henrik I,0,0,0,0
1653410526992,CSE 276C,A00,090134,Christensen; Henrik I,0,0,0,0
1653410527515,CSE 290,A00,090135,Bafna; Vineet,0,0,0,0
1653410527515,CSE 290,B00,090136,Ramamoorthi; Ravi,0,0,0,0
1653410527515,CSE 290,C00,090137,Li; Tzumao,10,0,10,0
1653410527515,CSE 290,D00,090138,Zhou; Yuan-Yuan,10,0,10,0
1653410527515,CSE 290,E00,090139,Christensen; Henrik I,10,0,10,0
1653410527515,CSE 290,F00,094053,Shalev; Aaron D,0,0,0,0
1653410528042,CSE 291,A00,090140,Munyaka; Imani N. S.,0,0,0,0
1653410528042,CSE 291,B00,094880,Yu; Qi,0,0,0,0
1653410528042,CSE 291,C00,090142,Pannuto; Patrick William,0,0,0,0
1653410528042,CSE 291,D00,094881,Zhang; Yiying,0,0,0,0
1653410528042,CSE 291,E00,095118,Su; Hao,0,0,0,0
1653410528568,CSE 293,001,094905,Bafna; Vineet,9999,0,9999,0
1653410528568,CSE 293,002,094906,Bellare; Mihir,9999,0,9999,0
1653410528568,CSE 293,003,094907,Berg-Kirkpatrick; Taylor D,9999,0,9999,0
1653410528568,CSE 293,004,094908,Christensen; Henrik I,9999,0,9999,0
1653410528568,CSE 293,005,094909,Cottrell; Garrison W,9999,0,9999,0
1653410528568,CSE 293,006,094910,Deutsch; Alin Bernard,9999,0,9999,0
1653410528568,CSE 293,007,094911,Esmaeilzadeh; Hadi,9999,0,9999,0
1653410528568,CSE 293,008,094912,Freund; Yoav,9999,0,9999,0
1653410528568,CSE 293,009,094913,Griswold; William G.,9999,0,9999,0
1653410528568,CSE 293,010,094914,Gymrek; Melissa Ann,9999,0,9999,0
1653410528568,CSE 293,011,094915,Heninger; Nadia A,9999,0,9999,0
1653410528568,CSE 293,012,094916,Impagliazzo; Russell,9999,0,9999,0
1653410528568,CSE 293,013,094917,Jhala; Ranjit,9999,0,9999,0
1653410528568,CSE 293,014,094918,Kahng; Andrew Byun,9999,0,9999,0
1653410528568,CSE 293,015,094919,Kane; Daniel Mertz,9999,0,9999,0
1653410528568,CSE 293,016,094920,Kriegman; David J,9999,0,9999,0
1653410528568,CSE 293,017,094921,Kumar; Arun Kumar,9999,0,9999,0
1653410528568,CSE 293,018,094922,Lerner; Sorin,9999,0,9999,0
1653410528568,CSE 293,019,094923,Lovett; Shachar,9999,0,9999,0
1653410528568,CSE 293,020,094924,McAuley; Julian John,9999,0,9999,0
1653410528568,CSE 293,021,094925,Micciancio; Daniele,9999,0,9999,0
1653410528568,CSE 293,022,094926,Orailoglu; Alex,9999,0,9999,0
1653410528568,CSE 293,023,094927,Paturi; Ramamohan,9999,0,9999,0
1653410528568,CSE 293,024,094928,Polikarpova; Nadezhda,9999,0,9999,0
1653410528568,CSE 293,025,094929,Politz; Joseph Gibbs,9999,0,9999,0
1653410528568,CSE 293,026,094930,Porter; George M,9999,0,9999,0
1653410528568,CSE 293,027,094931,Porter; Leonard Emerson,9999,0,9999,0
1653410528568,CSE 293,028,094932,Ramamoorthi; Ravi,9999,0,9999,0
1653410528568,CSE 293,029,094933,Sahoo; Debashis,9999,0,9999,0
1653410528568,CSE 293,030,094934,Saul; Lawrence,9999,0,9999,0
1653410528568,CSE 293,031,094935,Savage; Stefan,9999,0,9999,0
1653410528568,CSE 293,032,094936,Schulze; Jurgen P.,9999,0,9999,0
1653410528568,CSE 293,033,094937,Snoeren; Alex C.,9999,0,9999,0
1653410528568,CSE 293,034,094938,Shang; Jingbo,9999,0,9999,0
1653410528568,CSE 293,035,094939,Stefan; Deian,9999,0,9999,0
1653410528568,CSE 293,036,094940,Su; Hao,9999,0,9999,0
1653410528568,CSE 293,037,094941,Swanson; Steven James,9999,0,9999,0
1653410528568,CSE 293,038,094942,Tullsen; Dean Michael,9999,0,9999,0
1653410528568,CSE 293,039,094943,Voelker; Geoffrey M.,9999,0,9999,0
1653410528568,CSE 293,040,094944,Zhao; Jishen,9999,0,9999,0
1653410528568,CSE 293,041,094945,Zhou; Yuan-Yuan,9999,0,9999,0
1653410528568,CSE 293,042,094946,Gao; Sicun,9998,0,9999,1
1653410528568,CSE 293,043,094947,Weibel; Nadir,9999,0,9999,0
1653410528568,CSE 293,044,094948,Gupta; Rajesh K.,9999,0,9999,0
1653410529093,CSE 294,A00,090143,Porter; George M,9,0,10,1
1653410529616,DSE 200,A00,091799,Staff,50,0,50,0
1653410530150,DSE 203,A00,091800,Gupta; Amarnath,30,0,30,0
1653410530672,DSE 250,A00,091801,Deutsch; Alin Bernard,30,0,30,0
1653410531198,DSE 290,A00,091802,Altintas De Callaf; Ilkay,50,0,50,0
1653410531742,ECE 200,001,091003,Antipa; Nicholas A,9999,0,9999,0
1653410531742,ECE 200,002,091004,Atanasov; Nikolay A.,9999,0,9999,0
1653410531742,ECE 200,003,091005,Bharadia; Dinesh,9999,0,9999,0
1653410531742,ECE 200,004,091006,Cheng; Chung Kuan,9999,0,9999,0
1653410531742,ECE 200,005,091007,Cosman; Pamela C.,9999,0,9999,0
1653410531742,ECE 200,006,091008,Staff,9999,0,9999,0
1653410531742,ECE 200,007,091009,Dayeh; Shadi Ahmad,9999,0,9999,0
1653410531742,ECE 200,008,091010,Fainman; Yeshaiahu,9999,0,9999,0
1653410531742,ECE 200,009,091011,Ford; Joseph Earl,9999,0,9999,0
1653410531742,ECE 200,010,091012,Franceschetti; Massimo,9999,0,9999,0
1653410531742,ECE 200,011,091013,Fullerton; Eric E,9999,0,9999,0
1653410531742,ECE 200,012,091014,Galton; Ian A,9999,0,9999,0
1653410531742,ECE 200,013,091015,Gilja; Vikash,9999,0,9999,0
1653410531742,ECE 200,014,091016,Hall; Drew A.,9999,0,9999,0
1653410531742,ECE 200,015,091017,Hsueh; Tzu-Chien,9999,0,9999,0
1653410531742,ECE 200,016,091018,Javidi; Tara,9999,0,9999,0
1653410531742,ECE 200,017,091019,Kahng; Andrew Byun,9999,0,9999,0
1653410531742,ECE 200,018,091020,Kim; Young-Han,9999,0,9999,0
1653410531742,ECE 200,019,091021,Koushanfar; Farinaz,9999,0,9999,0
1653410531742,ECE 200,020,091022,Kuzum; Duygu,9999,0,9999,0
1653410531742,ECE 200,021,091023,Le; Hanh-Phuc,9999,0,9999,0
1653410531742,ECE 200,022,091024,Lin; Bill,9999,0,9999,0
1653410531742,ECE 200,023,091025,Liu; Zhaowei,9999,0,9999,0
1653410531742,ECE 200,024,091026,Lo; Yu-Hwa,9999,0,9999,0
1653410531742,ECE 200,025,091027,Lomakin; Vitaliy,9999,0,9999,0
1653410531742,ECE 200,026,091028,Mercier; Patrick Philip,9999,0,9999,0
1653410531742,ECE 200,027,091029,Meyer; Florian,9999,0,9999,0
1653410531742,ECE 200,028,091030,Milstein; Laurence B.,9999,0,9999,0
1653410531742,ECE 200,029,091031,Mir Arabbaygi; Siavash,9999,0,9999,0
1653410531742,ECE 200,030,091032,Mookherjea; Shayan,9999,0,9999,0
1653410531742,ECE 200,031,091033,Morris; Karcher William,9999,0,9999,0
1653410531742,ECE 200,032,091034,Ng; Tse Nga,9999,0,9999,0
1653410531742,ECE 200,033,091035,Nguyen; Truong Quang,9999,0,9999,0
1653410531742,ECE 200,034,091036,Nomura; Kenji,9999,0,9999,0
1653410531742,ECE 200,035,091037,Orlitsky; Alon,9999,0,9999,0
1653410531742,ECE 200,036,091038,Pal; Piya,9999,0,9999,0
1653410531742,ECE 200,037,091039,Papen; George C.,9999,0,9999,0
1653410531742,ECE 200,038,091040,Radic; Stojan,9999,0,9999,0
1653410531742,ECE 200,039,091041,Rao; Bhaskar D.,9999,0,9999,0
1653410531742,ECE 200,040,091042,Rao; Ramesh R,9999,0,9999,0
1653410531742,ECE 200,041,091043,Rebeiz; Gabriel,9999,0,9999,0
1653410531742,ECE 200,042,091044,Sanford; John R,9999,0,9999,0
1653410531742,ECE 200,043,091045,Siegel; Paul H.,9999,0,9999,0
1653410531742,ECE 200,044,091046,Sievenpiper; Daniel F.,9999,0,9999,0
1653410531742,ECE 200,045,091047,Sworder; David D.,9999,0,9999,0
1653410531742,ECE 200,046,091048,Taur; Yuan,9999,0,9999,0
1653410531742,ECE 200,047,091049,Touri; Behrouz,9999,0,9999,0
1653410531742,ECE 200,048,091050,Trivedi; Mohan M.,9999,0,9999,0
1653410531742,ECE 200,049,091051,Vardy; Alexander,9999,0,9999,0
1653410531742,ECE 200,050,091052,Vasconcelos; Nuno,9999,0,9999,0
1653410531742,ECE 200,051,091053,Wang; Xiaolong,9999,0,9999,0
1653410531742,ECE 200,052,091054,Xie; Pengtao,9999,0,9999,0
1653410531742,ECE 200,053,091055,Yip; Michael,9999,0,9999,0
1653410531742,ECE 200,054,091056,Zeger; Kenneth A.,9999,0,9999,0
1653410531742,ECE 200,055,091057,Zhang; Xinyu,9999,0,9999,0
1653410531742,ECE 200,056,091058,Turakhia; Yatish Girish,9999,0,9999,0
1653410531742,ECE 200,057,091059,Kang; Mingu,9999,0,9999,0
1653410531742,ECE 200,058,091060,Shi; Yuanyuan,9999,0,9999,0
1653410531742,ECE 200,059,091061,Wang; Edward Jay,9999,0,9999,0
1653410531742,ECE 200,060,091062,Zheng; Yang,9999,0,9999,0
1653410532265,ECE 203,A00,091065,Mercier; Patrick Philip,0,0,0,0
1653410532787,ECE 207A,A00,091605,Liu; Thomas Tao-Ming,0,0,0,0
1653410533311,ECE 212AN,A00,091068,Nomura; Kenji,0,0,0,0
1653410533841,ECE 222A,A00,091069,Rebeiz; Gabriel,0,0,0,0
1653410534366,ECE 225A,A00,091070,Orlitsky; Alon,0,0,0,0
1653410534899,ECE 230A,A00,091071,Nomura; Kenji,0,0,0,0
1653410535440,ECE 236A,A00,091072,Dayeh; Shadi Ahmad,0,0,0,0
1653410535965,ECE 238A,A00,091073,Luo; Jian,0,0,0,0
1653410535965,ECE 238A,B00,091074,Luo; Jian,0,0,0,0
1653410536493,ECE 240A,A00,091075,Radic; Stojan,0,0,0,0
1653410537015,ECE 247A,A00,091592,Shi; Lingyan,0,0,0,0
1653410537551,ECE 250,A00,091076,Touri; Behrouz,0,0,0,0
1653410538075,ECE 251C,A00,091078,Nguyen; Truong Quang,0,0,0,0
1653410538611,ECE 253,A00,091079,Cosman; Pamela C.,0,0,0,0
1653410539143,ECE 255A,A00,091080,Orlitsky; Alon,0,0,0,0
1653410539670,ECE 257A,A00,091081,Zhang; Xinyu,0,0,0,0
1653410540196,ECE 260A,A01,091084,Eldon; John,0,0,0,0
1653410540718,ECE 264C,A00,091085,Galton; Ian A,0,0,0,0
1653410541248,ECE 265C,A00,094889,Presti; Calogero Davide,0,0,0,9
1653410541770,ECE 266,A01,091087,Hall; Drew A.,0,0,0,0
1653410542819,ECE 271A,A00,091090,Vasconcelos; Nuno,0,0,0,0
1653410543341,ECE 272B,A00,091091,Sworder; David D.,0,0,0,0
1653410543870,ECE 275A,A00,091092,Meyer; Florian,0,0,0,0
1653410544393,ECE 277,A00,091093,An; Cheolhong,0,0,0,0
1653410544914,ECE 283,A00,091094,Le; Hanh-Phuc,0,0,0,0
1653410545445,ECE 284,A00,091095,Kang; Mingu,0,0,0,0
1653410545445,ECE 284,B00,091096,Wang; Edward Jay,0,0,0,0
1653410545973,ECE 285,A00,094334,Touri; Behrouz,0,0,0,0
1653410546495,ECE 289,A00,091097,Whelan; David Arthur,0,0,0,0
1653410547028,MATH 200A,A00,087414,Salehi Golsefidy; Alireza,7,0,8,1
1653410547562,MATH 202A,A00,087415,Gill; Philip E.,3,0,8,5
1653410548086,MATH 203A,A00,087416,Oprea; Dragos N.,6,0,8,2
1653410548613,MATH 204A,A00,087417,Kedlaya; Kiran S.,6,0,8,2
1653410549136,MATH 205,A00,087418,Sorensen; Claus M,6,0,8,2
1653410549660,MATH 206A,A00,087419,Izadi; Elham,7,0,8,1
1653410550182,MATH 207A,A00,087420,Mohammadi; Amir,6,0,8,2
1653410550705,MATH 208,A00,087421,Staff,9,0,10,1
1653410551227,MATH 209,A00,087422,Staff,10,0,10,0
1653410551767,MATH 218,A00,087423,Staff,10,0,10,0
1653410552289,MATH 220A,A00,087424,Novak; Jonathan I,7,0,8,1
1653410552816,MATH 231A,A00,087425,Bejenaru; Ioan,4,0,8,4
1653410553340,MATH 240A,A00,087426,Ebenfelt; Peter F,5,0,8,3
1653410553871,MATH 243,A00,087427,Staff,9,0,10,1
1653410554398,MATH 248,A00,087429,Staff,10,0,10,0
1653410554919,MATH 250A,A00,087430,Spolaor; Luca,5,0,8,3
1653410555445,MATH 257A,A00,087431,Spolaor; Luca,7,0,8,1
1653410555968,MATH 258,A00,087432,Staff,9,0,10,1
1653410556489,MATH 264A,A00,087433,Warnke; Lutz Peter,5,0,8,3
1653410557016,MATH 268,A00,087434,Staff,15,0,15,0
1653410557538,MATH 269,A00,087435,Staff,14,0,15,1
1653410558063,MATH 270A,A00,087436,Nie; Jiawang,0,0,8,8
1653410558596,MATH 272A,A00,087437,Tian; Xiaochuan,2,0,8,6
1653410559136,MATH 274,A01,087439,Cheng; Li-Tien,9,0,10,1
1653410559136,MATH 274,A02,087440,Cheng; Li-Tien,10,0,10,0
1653410559659,MATH 278A,A00,087441,Staff,8,0,10,2
1653410560181,MATH 278B,A00,087442,Staff,8,0,10,2
1653410560704,MATH 278C,A00,087443,Staff,8,0,10,2
1653410561228,MATH 280A,A00,087444,Zheng; Tianyi,0,0,8,8
1653410561758,MATH 281A,A00,087445,Bradic; Jelena,0,0,8,8
1653410562282,MATH 282A,A00,087446,Zhang; Danna,0,0,8,8
1653410562805,MATH 283,A00,087447,Tesler; Glenn,0,0,0,14
1653410563328,MATH 286,A00,087448,Kemp; Todd Aahron,6,0,8,2
1653410563858,MATH 287D,A00,087449,Bradic; Jelena,8,0,8,0
1653410564384,MATH 288,A00,087450,Staff,14,0,15,1
1653410564384,MATH 288,B00,087451,Staff,15,0,15,0
1653410564384,MATH 288,C00,087452,Staff,15,0,15,0
1653410564921,MATH 290A,A00,087453,Xu; Zhouli,7,0,8,1
1653410565450,MATH 291A,A00,087454,Xu; Zhouli,7,0,8,1
1653410565971,MATH 292,A00,087455,Staff,10,0,10,0
1653410566493,MATH 295,A00,087456,Staff,50,0,50,0
1653410567036,MATH 297,001,087457,Staff,998,0,999,1
1653411129760,COGS 200,A01,087991,Staff,48,0,50,2
1653411130282,COGS 201,A01,094504,Rangel; Lara M,17,0,25,8
1653411130805,COGS 203,A00,087992,Coulson; Seana M,19,0,20,1
1653411131335,COGS 210A,001,087993,Greene; Deanna Jacquelyn,9998,0,9999,1
1653411131335,COGS 210A,002,087994,Saygin; Ayse P,9999,0,9999,0
1653411131335,COGS 210A,003,087995,Xia; Haijun,9999,0,9999,0
1653411131335,COGS 210A,004,087996,Nitz; Douglas A.,9999,0,9999,0
1653411131335,COGS 210A,005,087997,Hollan; James D.,9999,0,9999,0
1653411131335,COGS 210A,006,087998,Deak; Gedeon O.,9998,0,9999,1
1653411131335,COGS 210A,007,087999,Rossano; Federico,9999,0,9999,0
1653411131861,COGS 211A,A00,088000,Coulson; Seana M,9997,0,9999,2
1653411132474,COGS 229,A00,088002,Staff,23,0,25,2
1653411132996,COGS 260,B00,094231,Staff,17,0,20,3
1653411132996,COGS 260,A00,088004,Nitz; Douglas A.,9998,0,9999,1
1653411133524,CSE 202,A00,090110,Paturi; Ramamohan,0,0,0,0
1653411133524,CSE 202,B00,090111,Paturi; Ramamohan,0,0,0,0
1653411134049,CSE 207B,A00,090112,Heninger; Nadia A,0,0,0,0
1653411134586,CSE 208,A00,094858,Micciancio; Daniele,0,0,0,0
1653411135111,CSE 210,A00,090113,Powell; Thomas Allan,0,0,0,0
1653411135632,CSE 219,A00,090898,Staff,0,0,0,0
1653411136155,CSE 221,A00,090114,Zhou; Yuan-Yuan,0,0,0,0
1653411136679,CSE 229A,A00,090115,Porter; George M,0,0,0,0
1653411137211,CSE 229C,A00,090116,Savage; Stefan,0,0,0,0
1653411137734,CSE 230,A00,090117,Jhala; Ranjit,0,0,0,0
1653411138257,CSE 232,A00,090118,Papakonstantinou; Yannis,0,0,0,0
1653411138782,CSE 239A,A00,090121,Kumar; Arun Kumar,0,0,0,0
1653411139307,CSE 239B,A00,090122,Jhala; Ranjit,0,0,0,0
1653411139829,CSE 240A,A00,090123,Zhao; Jishen,0,0,189,189
1653411140359,CSE 243A,A00,090124,Orailoglu; Alex,3,0,15,12
1653411140889,CSE 249B,A00,090125,Kahng; Andrew Byun,13,0,20,7
1653411141429,CSE 250A,A00,090126,Berg-Kirkpatrick; Taylor D,0,0,0,0
1653411141957,CSE 252A,A00,090127,Ochoa; Benjamin Lawrence,0,0,0,0
1653411142484,CSE 258,A01,090129,McAuley; Julian John,0,0,0,0
1653411143014,CSE 258R,A01,090131,McAuley; Julian John,0,0,0,0
1653411143539,CSE 274,A00,090132,Ramamoorthi; Ravi,0,0,0,0
1653411144072,CSE 276A,A00,090133,Christensen; Henrik I,0,0,0,0
1653411144598,CSE 276C,A00,090134,Christensen; Henrik I,0,0,0,0
1653411145134,CSE 290,A00,090135,Bafna; Vineet,0,0,0,0
1653411145134,CSE 290,B00,090136,Ramamoorthi; Ravi,0,0,0,0
1653411145134,CSE 290,C00,090137,Li; Tzumao,10,0,10,0
1653411145134,CSE 290,D00,090138,Zhou; Yuan-Yuan,10,0,10,0
1653411145134,CSE 290,E00,090139,Christensen; Henrik I,10,0,10,0
1653411145134,CSE 290,F00,094053,Shalev; Aaron D,0,0,0,0
1653411145660,CSE 291,A00,090140,Munyaka; Imani N. S.,0,0,0,0
1653411145660,CSE 291,B00,094880,Yu; Qi,0,0,0,0
1653411145660,CSE 291,C00,090142,Pannuto; Patrick William,0,0,0,0
1653411145660,CSE 291,D00,094881,Zhang; Yiying,0,0,0,0
1653411145660,CSE 291,E00,095118,Su; Hao,0,0,0,0
1653411146193,CSE 293,001,094905,Bafna; Vineet,9999,0,9999,0
1653411146193,CSE 293,002,094906,Bellare; Mihir,9999,0,9999,0
1653411146193,CSE 293,003,094907,Berg-Kirkpatrick; Taylor D,9999,0,9999,0
1653411146193,CSE 293,004,094908,Christensen; Henrik I,9999,0,9999,0
1653411146193,CSE 293,005,094909,Cottrell; Garrison W,9999,0,9999,0
1653411146193,CSE 293,006,094910,Deutsch; Alin Bernard,9999,0,9999,0
1653411146193,CSE 293,007,094911,Esmaeilzadeh; Hadi,9999,0,9999,0
1653411146193,CSE 293,008,094912,Freund; Yoav,9999,0,9999,0
1653411146193,CSE 293,009,094913,Griswold; William G.,9999,0,9999,0
1653411146193,CSE 293,010,094914,Gymrek; Melissa Ann,9999,0,9999,0
1653411146193,CSE 293,011,094915,Heninger; Nadia A,9999,0,9999,0
1653411146193,CSE 293,012,094916,Impagliazzo; Russell,9999,0,9999,0
1653411146193,CSE 293,013,094917,Jhala; Ranjit,9999,0,9999,0
1653411146193,CSE 293,014,094918,Kahng; Andrew Byun,9999,0,9999,0
1653411146193,CSE 293,015,094919,Kane; Daniel Mertz,9999,0,9999,0
1653411146193,CSE 293,016,094920,Kriegman; David J,9999,0,9999,0
1653411146193,CSE 293,017,094921,Kumar; Arun Kumar,9999,0,9999,0
1653411146193,CSE 293,018,094922,Lerner; Sorin,9999,0,9999,0
1653411146193,CSE 293,019,094923,Lovett; Shachar,9999,0,9999,0
1653411146193,CSE 293,020,094924,McAuley; Julian John,9999,0,9999,0
1653411146193,CSE 293,021,094925,Micciancio; Daniele,9999,0,9999,0
1653411146193,CSE 293,022,094926,Orailoglu; Alex,9999,0,9999,0
1653411146193,CSE 293,023,094927,Paturi; Ramamohan,9999,0,9999,0
1653411146193,CSE 293,024,094928,Polikarpova; Nadezhda,9999,0,9999,0
1653411146193,CSE 293,025,094929,Politz; Joseph Gibbs,9999,0,9999,0
1653411146193,CSE 293,026,094930,Porter; George M,9999,0,9999,0
1653411146193,CSE 293,027,094931,Porter; Leonard Emerson,9999,0,9999,0
1653411146193,CSE 293,028,094932,Ramamoorthi; Ravi,9999,0,9999,0
1653411146193,CSE 293,029,094933,Sahoo; Debashis,9999,0,9999,0
1653411146193,CSE 293,030,094934,Saul; Lawrence,9999,0,9999,0
1653411146193,CSE 293,031,094935,Savage; Stefan,9999,0,9999,0
1653411146193,CSE 293,032,094936,Schulze; Jurgen P.,9999,0,9999,0
1653411146193,CSE 293,033,094937,Snoeren; Alex C.,9999,0,9999,0
1653411146193,CSE 293,034,094938,Shang; Jingbo,9999,0,9999,0
1653411146193,CSE 293,035,094939,Stefan; Deian,9999,0,9999,0
1653411146193,CSE 293,036,094940,Su; Hao,9999,0,9999,0
1653411146193,CSE 293,037,094941,Swanson; Steven James,9999,0,9999,0
1653411146193,CSE 293,038,094942,Tullsen; Dean Michael,9999,0,9999,0
1653411146193,CSE 293,039,094943,Voelker; Geoffrey M.,9999,0,9999,0
1653411146193,CSE 293,040,094944,Zhao; Jishen,9999,0,9999,0
1653411146193,CSE 293,041,094945,Zhou; Yuan-Yuan,9999,0,9999,0
1653411146193,CSE 293,042,094946,Gao; Sicun,9998,0,9999,1
1653411146193,CSE 293,043,094947,Weibel; Nadir,9999,0,9999,0
1653411146193,CSE 293,044,094948,Gupta; Rajesh K.,9999,0,9999,0
1653411146720,CSE 294,A00,090143,Porter; George M,9,0,10,1
1653411147264,DSE 200,A00,091799,Staff,50,0,50,0
1653411147786,DSE 203,A00,091800,Gupta; Amarnath,30,0,30,0
1653411148309,DSE 250,A00,091801,Deutsch; Alin Bernard,30,0,30,0
1653411148853,DSE 290,A00,091802,Altintas De Callaf; Ilkay,50,0,50,0
1653411149398,ECE 200,001,091003,Antipa; Nicholas A,9999,0,9999,0
1653411149398,ECE 200,002,091004,Atanasov; Nikolay A.,9999,0,9999,0
1653411149398,ECE 200,003,091005,Bharadia; Dinesh,9999,0,9999,0
1653411149398,ECE 200,004,091006,Cheng; Chung Kuan,9999,0,9999,0
1653411149398,ECE 200,005,091007,Cosman; Pamela C.,9999,0,9999,0
1653411149398,ECE 200,006,091008,Staff,9999,0,9999,0
1653411149398,ECE 200,007,091009,Dayeh; Shadi Ahmad,9999,0,9999,0
1653411149398,ECE 200,008,091010,Fainman; Yeshaiahu,9999,0,9999,0
1653411149398,ECE 200,009,091011,Ford; Joseph Earl,9999,0,9999,0
1653411149398,ECE 200,010,091012,Franceschetti; Massimo,9999,0,9999,0
1653411149398,ECE 200,011,091013,Fullerton; Eric E,9999,0,9999,0
1653411149398,ECE 200,012,091014,Galton; Ian A,9999,0,9999,0
1653411149398,ECE 200,013,091015,Gilja; Vikash,9999,0,9999,0
1653411149398,ECE 200,014,091016,Hall; Drew A.,9999,0,9999,0
1653411149398,ECE 200,015,091017,Hsueh; Tzu-Chien,9999,0,9999,0
1653411149398,ECE 200,016,091018,Javidi; Tara,9999,0,9999,0
1653411149398,ECE 200,017,091019,Kahng; Andrew Byun,9999,0,9999,0
1653411149398,ECE 200,018,091020,Kim; Young-Han,9999,0,9999,0
1653411149398,ECE 200,019,091021,Koushanfar; Farinaz,9999,0,9999,0
1653411149398,ECE 200,020,091022,Kuzum; Duygu,9999,0,9999,0
1653411149398,ECE 200,021,091023,Le; Hanh-Phuc,9999,0,9999,0
1653411149398,ECE 200,022,091024,Lin; Bill,9999,0,9999,0
1653411149398,ECE 200,023,091025,Liu; Zhaowei,9999,0,9999,0
1653411149398,ECE 200,024,091026,Lo; Yu-Hwa,9999,0,9999,0
1653411149398,ECE 200,025,091027,Lomakin; Vitaliy,9999,0,9999,0
1653411149398,ECE 200,026,091028,Mercier; Patrick Philip,9999,0,9999,0
1653411149398,ECE 200,027,091029,Meyer; Florian,9999,0,9999,0
1653411149398,ECE 200,028,091030,Milstein; Laurence B.,9999,0,9999,0
1653411149398,ECE 200,029,091031,Mir Arabbaygi; Siavash,9999,0,9999,0
1653411149398,ECE 200,030,091032,Mookherjea; Shayan,9999,0,9999,0
1653411149398,ECE 200,031,091033,Morris; Karcher William,9999,0,9999,0
1653411149398,ECE 200,032,091034,Ng; Tse Nga,9999,0,9999,0
1653411149398,ECE 200,033,091035,Nguyen; Truong Quang,9999,0,9999,0
1653411149398,ECE 200,034,091036,Nomura; Kenji,9999,0,9999,0
1653411149398,ECE 200,035,091037,Orlitsky; Alon,9999,0,9999,0
1653411149398,ECE 200,036,091038,Pal; Piya,9999,0,9999,0
1653411149398,ECE 200,037,091039,Papen; George C.,9999,0,9999,0
1653411149398,ECE 200,038,091040,Radic; Stojan,9999,0,9999,0
1653411149398,ECE 200,039,091041,Rao; Bhaskar D.,9999,0,9999,0
1653411149398,ECE 200,040,091042,Rao; Ramesh R,9999,0,9999,0
1653411149398,ECE 200,041,091043,Rebeiz; Gabriel,9999,0,9999,0
1653411149398,ECE 200,042,091044,Sanford; John R,9999,0,9999,0
1653411149398,ECE 200,043,091045,Siegel; Paul H.,9999,0,9999,0
1653411149398,ECE 200,044,091046,Sievenpiper; Daniel F.,9999,0,9999,0
1653411149398,ECE 200,045,091047,Sworder; David D.,9999,0,9999,0
1653411149398,ECE 200,046,091048,Taur; Yuan,9999,0,9999,0
1653411149398,ECE 200,047,091049,Touri; Behrouz,9999,0,9999,0
1653411149398,ECE 200,048,091050,Trivedi; Mohan M.,9999,0,9999,0
1653411149398,ECE 200,049,091051,Vardy; Alexander,9999,0,9999,0
1653411149398,ECE 200,050,091052,Vasconcelos; Nuno,9999,0,9999,0
1653411149398,ECE 200,051,091053,Wang; Xiaolong,9999,0,9999,0
1653411149398,ECE 200,052,091054,Xie; Pengtao,9999,0,9999,0
1653411149398,ECE 200,053,091055,Yip; Michael,9999,0,9999,0
1653411149398,ECE 200,054,091056,Zeger; Kenneth A.,9999,0,9999,0
1653411149398,ECE 200,055,091057,Zhang; Xinyu,9999,0,9999,0
1653411149398,ECE 200,056,091058,Turakhia; Yatish Girish,9999,0,9999,0
1653411149398,ECE 200,057,091059,Kang; Mingu,9999,0,9999,0
1653411149398,ECE 200,058,091060,Shi; Yuanyuan,9999,0,9999,0
1653411149398,ECE 200,059,091061,Wang; Edward Jay,9999,0,9999,0
1653411149398,ECE 200,060,091062,Zheng; Yang,9999,0,9999,0
1653411149930,ECE 203,A00,091065,Mercier; Patrick Philip,0,0,0,0
1653411150456,ECE 207A,A00,091605,Liu; Thomas Tao-Ming,0,0,0,0
1653411150982,ECE 212AN,A00,091068,Nomura; Kenji,0,0,0,0
1653411151526,ECE 222A,A00,091069,Rebeiz; Gabriel,0,0,0,0
1653411152052,ECE 225A,A00,091070,Orlitsky; Alon,0,0,0,0
1653411152610,ECE 230A,A00,091071,Nomura; Kenji,0,0,0,0
1653411153133,ECE 236A,A00,091072,Dayeh; Shadi Ahmad,0,0,0,0
1653411153656,ECE 238A,A00,091073,Luo; Jian,0,0,0,0
1653411153656,ECE 238A,B00,091074,Luo; Jian,0,0,0,0
1653411154178,ECE 240A,A00,091075,Radic; Stojan,0,0,0,0
1653411154705,ECE 247A,A00,091592,Shi; Lingyan,0,0,0,0
1653411155235,ECE 250,A00,091076,Touri; Behrouz,0,0,0,0
1653411155761,ECE 251C,A00,091078,Nguyen; Truong Quang,0,0,0,0
1653411156294,ECE 253,A00,091079,Cosman; Pamela C.,0,0,0,0
1653411156815,ECE 255A,A00,091080,Orlitsky; Alon,0,0,0,0
1653411157344,ECE 257A,A00,091081,Zhang; Xinyu,0,0,0,0
1653411157873,ECE 260A,A01,091084,Eldon; John,0,0,0,0
1653411158471,ECE 264C,A00,091085,Galton; Ian A,0,0,0,0
1653411158998,ECE 265C,A00,094889,Presti; Calogero Davide,0,0,0,9
1653411159527,ECE 266,A01,091087,Hall; Drew A.,0,0,0,0
1653411160605,ECE 271A,A00,091090,Vasconcelos; Nuno,0,0,0,0
1653411161126,ECE 272B,A00,091091,Sworder; David D.,0,0,0,0
1653411161650,ECE 275A,A00,091092,Meyer; Florian,0,0,0,0
1653411162172,ECE 277,A00,091093,An; Cheolhong,0,0,0,0
1653411162699,ECE 283,A00,091094,Le; Hanh-Phuc,0,0,0,0
1653411163228,ECE 284,A00,091095,Kang; Mingu,0,0,0,0
1653411163228,ECE 284,B00,091096,Wang; Edward Jay,0,0,0,0
1653411163750,ECE 285,A00,094334,Touri; Behrouz,0,0,0,0
1653411164273,ECE 289,A00,091097,Whelan; David Arthur,0,0,0,0
1653411164819,MATH 200A,A00,087414,Salehi Golsefidy; Alireza,7,0,8,1
1653411165344,MATH 202A,A00,087415,Gill; Philip E.,3,0,8,5
1653411165874,MATH 203A,A00,087416,Oprea; Dragos N.,6,0,8,2
1653411166404,MATH 204A,A00,087417,Kedlaya; Kiran S.,6,0,8,2
1653411166944,MATH 205,A00,087418,Sorensen; Claus M,6,0,8,2
1653411167472,MATH 206A,A00,087419,Izadi; Elham,7,0,8,1
1653411167995,MATH 207A,A00,087420,Mohammadi; Amir,6,0,8,2
1653411168537,MATH 208,A00,087421,Staff,9,0,10,1
1653411169064,MATH 209,A00,087422,Staff,10,0,10,0
1653411169596,MATH 218,A00,087423,Staff,10,0,10,0
1653411170121,MATH 220A,A00,087424,Novak; Jonathan I,7,0,8,1
1653411170643,MATH 231A,A00,087425,Bejenaru; Ioan,4,0,8,4
1653411171173,MATH 240A,A00,087426,Ebenfelt; Peter F,5,0,8,3
1653411171694,MATH 243,A00,087427,Staff,9,0,10,1
1653411172221,MATH 248,A00,087429,Staff,10,0,10,0
1653411172748,MATH 250A,A00,087430,Spolaor; Luca,5,0,8,3
1653411173277,MATH 257A,A00,087431,Spolaor; Luca,7,0,8,1
1653411173807,MATH 258,A00,087432,Staff,9,0,10,1
1653411174343,MATH 264A,A00,087433,Warnke; Lutz Peter,5,0,8,3
1653411174867,MATH 268,A00,087434,Staff,15,0,15,0
1653411175397,MATH 269,A00,087435,Staff,14,0,15,1
1653411175918,MATH 270A,A00,087436,Nie; Jiawang,0,0,8,8
1653411176443,MATH 272A,A00,087437,Tian; Xiaochuan,2,0,8,6
1653411176974,MATH 274,A01,087439,Cheng; Li-Tien,9,0,10,1
1653411176974,MATH 274,A02,087440,Cheng; Li-Tien,10,0,10,0
1653411177499,MATH 278A,A00,087441,Staff,8,0,10,2
1653411178025,MATH 278B,A00,087442,Staff,8,0,10,2
1653411178550,MATH 278C,A00,087443,Staff,8,0,10,2
1653411179084,MATH 280A,A00,087444,Zheng; Tianyi,0,0,8,8
1653411179614,MATH 281A,A00,087445,Bradic; Jelena,0,0,8,8
1653411180149,MATH 282A,A00,087446,Zhang; Danna,0,0,8,8
1653411180681,MATH 283,A00,087447,Tesler; Glenn,0,0,0,14
1653411181223,MATH 286,A00,087448,Kemp; Todd Aahron,6,0,8,2
1653411181746,MATH 287D,A00,087449,Bradic; Jelena,8,0,8,0
1653411182269,MATH 288,A00,087450,Staff,14,0,15,1
1653411182269,MATH 288,B00,087451,Staff,15,0,15,0
1653411182269,MATH 288,C00,087452,Staff,15,0,15,0
1653411182795,MATH 290A,A00,087453,Xu; Zhouli,7,0,8,1
1653411183321,MATH 291A,A00,087454,Xu; Zhouli,7,0,8,1
1653411183845,MATH 292,A00,087455,Staff,10,0,10,0
1653411184379,MATH 295,A00,087456,Staff,50,0,50,0
1653411184912,MATH 297,001,087457,Staff,998,0,999,1
1653411748140,COGS 200,A01,087991,Staff,48,0,50,2
1653411748665,COGS 201,A01,094504,Rangel; Lara M,17,0,25,8
1653411749292,COGS 203,A00,087992,Coulson; Seana M,19,0,20,1
1653411749815,COGS 210A,001,087993,Greene; Deanna Jacquelyn,9998,0,9999,1
1653411749815,COGS 210A,002,087994,Saygin; Ayse P,9999,0,9999,0
1653411749815,COGS 210A,003,087995,Xia; Haijun,9999,0,9999,0
1653411749815,COGS 210A,004,087996,Nitz; Douglas A.,9999,0,9999,0
1653411749815,COGS 210A,005,087997,Hollan; James D.,9999,0,9999,0
1653411749815,COGS 210A,006,087998,Deak; Gedeon O.,9998,0,9999,1
1653411749815,COGS 210A,007,087999,Rossano; Federico,9999,0,9999,0
1653411750337,COGS 211A,A00,088000,Coulson; Seana M,9997,0,9999,2
1653411750871,COGS 229,A00,088002,Staff,23,0,25,2
1653411751410,COGS 260,B00,094231,Staff,17,0,20,3
1653411751410,COGS 260,A00,088004,Nitz; Douglas A.,9998,0,9999,1
1653411751939,CSE 202,A00,090110,Paturi; Ramamohan,0,0,0,0
1653411751939,CSE 202,B00,090111,Paturi; Ramamohan,0,0,0,0
1653411752461,CSE 207B,A00,090112,Heninger; Nadia A,0,0,0,0
1653411752995,CSE 208,A00,094858,Micciancio; Daniele,0,0,0,0
1653411753517,CSE 210,A00,090113,Powell; Thomas Allan,0,0,0,0
1653411754039,CSE 219,A00,090898,Staff,0,0,0,0
1653411754563,CSE 221,A00,090114,Zhou; Yuan-Yuan,0,0,0,0
1653411755090,CSE 229A,A00,090115,Porter; George M,0,0,0,0
1653411755616,CSE 229C,A00,090116,Savage; Stefan,0,0,0,0
1653411756139,CSE 230,A00,090117,Jhala; Ranjit,0,0,0,0
1653411756670,CSE 232,A00,090118,Papakonstantinou; Yannis,0,0,0,0
1653411757225,CSE 239A,A00,090121,Kumar; Arun Kumar,0,0,0,0
1653411757751,CSE 239B,A00,090122,Jhala; Ranjit,0,0,0,0
1653411758287,CSE 240A,A00,090123,Zhao; Jishen,0,0,189,189
1653411758808,CSE 243A,A00,090124,Orailoglu; Alex,3,0,15,12
1653411759335,CSE 249B,A00,090125,Kahng; Andrew Byun,13,0,20,7
1653411759858,CSE 250A,A00,090126,Berg-Kirkpatrick; Taylor D,0,0,0,0
1653411760392,CSE 252A,A00,090127,Ochoa; Benjamin Lawrence,0,0,0,0
1653411760932,CSE 258,A01,090129,McAuley; Julian John,0,0,0,0
1653411761458,CSE 258R,A01,090131,McAuley; Julian John,0,0,0,0
1653411761995,CSE 274,A00,090132,Ramamoorthi; Ravi,0,0,0,0
1653411762524,CSE 276A,A00,090133,Christensen; Henrik I,0,0,0,0
1653411763065,CSE 276C,A00,090134,Christensen; Henrik I,0,0,0,0
1653411763595,CSE 290,A00,090135,Bafna; Vineet,0,0,0,0
1653411763595,CSE 290,B00,090136,Ramamoorthi; Ravi,0,0,0,0
1653411763595,CSE 290,C00,090137,Li; Tzumao,10,0,10,0
1653411763595,CSE 290,D00,090138,Zhou; Yuan-Yuan,10,0,10,0
1653411763595,CSE 290,E00,090139,Christensen; Henrik I,10,0,10,0
1653411763595,CSE 290,F00,094053,Shalev; Aaron D,0,0,0,0
1653411764120,CSE 291,A00,090140,Munyaka; Imani N. S.,0,0,0,0
1653411764120,CSE 291,B00,094880,Yu; Qi,0,0,0,0
1653411764120,CSE 291,C00,090142,Pannuto; Patrick William,0,0,0,0
1653411764120,CSE 291,D00,094881,Zhang; Yiying,0,0,0,0
1653411764120,CSE 291,E00,095118,Su; Hao,0,0,0,0
1653411764653,CSE 293,001,094905,Bafna; Vineet,9999,0,9999,0
1653411764653,CSE 293,002,094906,Bellare; Mihir,9999,0,9999,0
1653411764653,CSE 293,003,094907,Berg-Kirkpatrick; Taylor D,9999,0,9999,0
1653411764653,CSE 293,004,094908,Christensen; Henrik I,9999,0,9999,0
1653411764653,CSE 293,005,094909,Cottrell; Garrison W,9999,0,9999,0
1653411764653,CSE 293,006,094910,Deutsch; Alin Bernard,9999,0,9999,0
1653411764653,CSE 293,007,094911,Esmaeilzadeh; Hadi,9999,0,9999,0
1653411764653,CSE 293,008,094912,Freund; Yoav,9999,0,9999,0
1653411764653,CSE 293,009,094913,Griswold; William G.,9999,0,9999,0
1653411764653,CSE 293,010,094914,Gymrek; Melissa Ann,9999,0,9999,0
1653411764653,CSE 293,011,094915,Heninger; Nadia A,9999,0,9999,0
1653411764653,CSE 293,012,094916,Impagliazzo; Russell,9999,0,9999,0
1653411764653,CSE 293,013,094917,Jhala; Ranjit,9999,0,9999,0
1653411764653,CSE 293,014,094918,Kahng; Andrew Byun,9999,0,9999,0
1653411764653,CSE 293,015,094919,Kane; Daniel Mertz,9999,0,9999,0
1653411764653,CSE 293,016,094920,Kriegman; David J,9999,0,9999,0
1653411764653,CSE 293,017,094921,Kumar; Arun Kumar,9999,0,9999,0
1653411764653,CSE 293,018,094922,Lerner; Sorin,9999,0,9999,0
1653411764653,CSE 293,019,094923,Lovett; Shachar,9999,0,9999,0
1653411764653,CSE 293,020,094924,McAuley; Julian John,9999,0,9999,0
1653411764653,CSE 293,021,094925,Micciancio; Daniele,9999,0,9999,0
1653411764653,CSE 293,022,094926,Orailoglu; Alex,9999,0,9999,0
1653411764653,CSE 293,023,094927,Paturi; Ramamohan,9999,0,9999,0
1653411764653,CSE 293,024,094928,Polikarpova; Nadezhda,9999,0,9999,0
1653411764653,CSE 293,025,094929,Politz; Joseph Gibbs,9999,0,9999,0
1653411764653,CSE 293,026,094930,Porter; George M,9999,0,9999,0
1653411764653,CSE 293,027,094931,Porter; Leonard Emerson,9999,0,9999,0
1653411764653,CSE 293,028,094932,Ramamoorthi; Ravi,9999,0,9999,0
1653411764653,CSE 293,029,094933,Sahoo; Debashis,9999,0,9999,0
1653411764653,CSE 293,030,094934,Saul; Lawrence,9999,0,9999,0
1653411764653,CSE 293,031,094935,Savage; Stefan,9999,0,9999,0
1653411764653,CSE 293,032,094936,Schulze; Jurgen P.,9999,0,9999,0
1653411764653,CSE 293,033,094937,Snoeren; Alex C.,9999,0,9999,0
1653411764653,CSE 293,034,094938,Shang; Jingbo,9999,0,9999,0
1653411764653,CSE 293,035,094939,Stefan; Deian,9999,0,9999,0
1653411764653,CSE 293,036,094940,Su; Hao,9999,0,9999,0
1653411764653,CSE 293,037,094941,Swanson; Steven James,9999,0,9999,0
1653411764653,CSE 293,038,094942,Tullsen; Dean Michael,9999,0,9999,0
1653411764653,CSE 293,039,094943,Voelker; Geoffrey M.,9999,0,9999,0
1653411764653,CSE 293,040,094944,Zhao; Jishen,9999,0,9999,0
1653411764653,CSE 293,041,094945,Zhou; Yuan-Yuan,9999,0,9999,0
1653411764653,CSE 293,042,094946,Gao; Sicun,9998,0,9999,1
1653411764653,CSE 293,043,094947,Weibel; Nadir,9999,0,9999,0
1653411764653,CSE 293,044,094948,Gupta; Rajesh K.,9999,0,9999,0
1653411765181,CSE 294,A00,090143,Porter; George M,9,0,10,1
1653411765709,DSE 200,A00,091799,Staff,50,0,50,0
1653411766249,DSE 203,A00,091800,Gupta; Amarnath,30,0,30,0
1653411766773,DSE 250,A00,091801,Deutsch; Alin Bernard,30,0,30,0
1653411767297,DSE 290,A00,091802,Altintas De Callaf; Ilkay,50,0,50,0
1653411767830,ECE 200,001,091003,Antipa; Nicholas A,9999,0,9999,0
1653411767830,ECE 200,002,091004,Atanasov; Nikolay A.,9999,0,9999,0
1653411767830,ECE 200,003,091005,Bharadia; Dinesh,9999,0,9999,0
1653411767830,ECE 200,004,091006,Cheng; Chung Kuan,9999,0,9999,0
1653411767830,ECE 200,005,091007,Cosman; Pamela C.,9999,0,9999,0
1653411767830,ECE 200,006,091008,Staff,9999,0,9999,0
1653411767830,ECE 200,007,091009,Dayeh; Shadi Ahmad,9999,0,9999,0
1653411767830,ECE 200,008,091010,Fainman; Yeshaiahu,9999,0,9999,0
1653411767830,ECE 200,009,091011,Ford; Joseph Earl,9999,0,9999,0
1653411767830,ECE 200,010,091012,Franceschetti; Massimo,9999,0,9999,0
1653411767830,ECE 200,011,091013,Fullerton; Eric E,9999,0,9999,0
1653411767830,ECE 200,012,091014,Galton; Ian A,9999,0,9999,0
1653411767830,ECE 200,013,091015,Gilja; Vikash,9999,0,9999,0
1653411767830,ECE 200,014,091016,Hall; Drew A.,9999,0,9999,0
1653411767830,ECE 200,015,091017,Hsueh; Tzu-Chien,9999,0,9999,0
1653411767830,ECE 200,016,091018,Javidi; Tara,9999,0,9999,0
1653411767830,ECE 200,017,091019,Kahng; Andrew Byun,9999,0,9999,0
1653411767830,ECE 200,018,091020,Kim; Young-Han,9999,0,9999,0
1653411767830,ECE 200,019,091021,Koushanfar; Farinaz,9999,0,9999,0
1653411767830,ECE 200,020,091022,Kuzum; Duygu,9999,0,9999,0
1653411767830,ECE 200,021,091023,Le; Hanh-Phuc,9999,0,9999,0
1653411767830,ECE 200,022,091024,Lin; Bill,9999,0,9999,0
1653411767830,ECE 200,023,091025,Liu; Zhaowei,9999,0,9999,0
1653411767830,ECE 200,024,091026,Lo; Yu-Hwa,9999,0,9999,0
1653411767830,ECE 200,025,091027,Lomakin; Vitaliy,9999,0,9999,0
1653411767830,ECE 200,026,091028,Mercier; Patrick Philip,9999,0,9999,0
1653411767830,ECE 200,027,091029,Meyer; Florian,9999,0,9999,0
1653411767830,ECE 200,028,091030,Milstein; Laurence B.,9999,0,9999,0
1653411767830,ECE 200,029,091031,Mir Arabbaygi; Siavash,9999,0,9999,0
1653411767830,ECE 200,030,091032,Mookherjea; Shayan,9999,0,9999,0
1653411767830,ECE 200,031,091033,Morris; Karcher William,9999,0,9999,0
1653411767830,ECE 200,032,091034,Ng; Tse Nga,9999,0,9999,0
1653411767830,ECE 200,033,091035,Nguyen; Truong Quang,9999,0,9999,0
1653411767830,ECE 200,034,091036,Nomura; Kenji,9999,0,9999,0
1653411767830,ECE 200,035,091037,Orlitsky; Alon,9999,0,9999,0
1653411767830,ECE 200,036,091038,Pal; Piya,9999,0,9999,0
1653411767830,ECE 200,037,091039,Papen; George C.,9999,0,9999,0
1653411767830,ECE 200,038,091040,Radic; Stojan,9999,0,9999,0
1653411767830,ECE 200,039,091041,Rao; Bhaskar D.,9999,0,9999,0
1653411767830,ECE 200,040,091042,Rao; Ramesh R,9999,0,9999,0
1653411767830,ECE 200,041,091043,Rebeiz; Gabriel,9999,0,9999,0
1653411767830,ECE 200,042,091044,Sanford; John R,9999,0,9999,0
1653411767830,ECE 200,043,091045,Siegel; Paul H.,9999,0,9999,0
1653411767830,ECE 200,044,091046,Sievenpiper; Daniel F.,9999,0,9999,0
1653411767830,ECE 200,045,091047,Sworder; David D.,9999,0,9999,0
1653411767830,ECE 200,046,091048,Taur; Yuan,9999,0,9999,0
1653411767830,ECE 200,047,091049,Touri; Behrouz,9999,0,9999,0
1653411767830,ECE 200,048,091050,Trivedi; Mohan M.,9999,0,9999,0
1653411767830,ECE 200,049,091051,Vardy; Alexander,9999,0,9999,0
1653411767830,ECE 200,050,091052,Vasconcelos; Nuno,9999,0,9999,0
1653411767830,ECE 200,051,091053,Wang; Xiaolong,9999,0,9999,0
1653411767830,ECE 200,052,091054,Xie; Pengtao,9999,0,9999,0
1653411767830,ECE 200,053,091055,Yip; Michael,9999,0,9999,0
1653411767830,ECE 200,054,091056,Zeger; Kenneth A.,9999,0,9999,0
1653411767830,ECE 200,055,091057,Zhang; Xinyu,9999,0,9999,0
1653411767830,ECE 200,056,091058,Turakhia; Yatish Girish,9999,0,9999,0
1653411767830,ECE 200,057,091059,Kang; Mingu,9999,0,9999,0
1653411767830,ECE 200,058,091060,Shi; Yuanyuan,9999,0,9999,0
1653411767830,ECE 200,059,091061,Wang; Edward Jay,9999,0,9999,0
1653411767830,ECE 200,060,091062,Zheng; Yang,9999,0,9999,0
1653411768353,ECE 203,A00,091065,Mercier; Patrick Philip,0,0,0,0
1653411768879,ECE 207A,A00,091605,Liu; Thomas Tao-Ming,0,0,0,0
1653411769410,ECE 212AN,A00,091068,Nomura; Kenji,0,0,0,0
1653411769943,ECE 222A,A00,091069,Rebeiz; Gabriel,0,0,0,0
1653411770467,ECE 225A,A00,091070,Orlitsky; Alon,0,0,0,0
1653411770989,ECE 230A,A00,091071,Nomura; Kenji,0,0,0,0
1653411771518,ECE 236A,A00,091072,Dayeh; Shadi Ahmad,0,0,0,0
1653411772059,ECE 238A,A00,091073,Luo; Jian,0,0,0,0
1653411772059,ECE 238A,B00,091074,Luo; Jian,0,0,0,0
1653411772583,ECE 240A,A00,091075,Radic; Stojan,0,0,0,0
1653411773116,ECE 247A,A00,091592,Shi; Lingyan,0,0,0,0
1653411773645,ECE 250,A00,091076,Touri; Behrouz,0,0,0,0
1653411774170,ECE 251C,A00,091078,Nguyen; Truong Quang,0,0,0,0
1653411774706,ECE 253,A00,091079,Cosman; Pamela C.,0,0,0,0
1653411775228,ECE 255A,A00,091080,Orlitsky; Alon,0,0,0,0
1653411775752,ECE 257A,A00,091081,Zhang; Xinyu,0,0,0,0
1653411776280,ECE 260A,A01,091084,Eldon; John,0,0,0,0
1653411776818,ECE 264C,A00,091085,Galton; Ian A,0,0,0,0
1653411777361,ECE 265C,A00,094889,Presti; Calogero Davide,0,0,0,9
1653411777883,ECE 266,A01,091087,Hall; Drew A.,0,0,0,0
1653411778929,ECE 271A,A00,091090,Vasconcelos; Nuno,0,0,0,0
1653411779451,ECE 272B,A00,091091,Sworder; David D.,0,0,0,0
1653411779981,ECE 275A,A00,091092,Meyer; Florian,0,0,0,0
1653411780505,ECE 277,A00,091093,An; Cheolhong,0,0,0,0
1653411781033,ECE 283,A00,091094,Le; Hanh-Phuc,0,0,0,0
1653411781558,ECE 284,A00,091095,Kang; Mingu,0,0,0,0
1653411781558,ECE 284,B00,091096,Wang; Edward Jay,0,0,0,0
1653411782084,ECE 285,A00,094334,Touri; Behrouz,0,0,0,0
1653411782608,ECE 289,A00,091097,Whelan; David Arthur,0,0,0,0
1653411783136,MATH 200A,A00,087414,Salehi Golsefidy; Alireza,7,0,8,1
1653411783666,MATH 202A,A00,087415,Gill; Philip E.,3,0,8,5
1653411784193,MATH 203A,A00,087416,Oprea; Dragos N.,6,0,8,2
1653411784715,MATH 204A,A00,087417,Kedlaya; Kiran S.,6,0,8,2
1653411785241,MATH 205,A00,087418,Sorensen; Claus M,6,0,8,2
1653411785769,MATH 206A,A00,087419,Izadi; Elham,7,0,8,1
1653411786292,MATH 207A,A00,087420,Mohammadi; Amir,6,0,8,2
1653411786817,MATH 208,A00,087421,Staff,9,0,10,1
1653411787339,MATH 209,A00,087422,Staff,10,0,10,0
1653411787864,MATH 218,A00,087423,Staff,10,0,10,0
1653411788393,MATH 220A,A00,087424,Novak; Jonathan I,7,0,8,1
1653411788919,MATH 231A,A00,087425,Bejenaru; Ioan,4,0,8,4
1653411789443,MATH 240A,A00,087426,Ebenfelt; Peter F,5,0,8,3
1653411789971,MATH 243,A00,087427,Staff,9,0,10,1
1653411790501,MATH 248,A00,087429,Staff,10,0,10,0
1653411791025,MATH 250A,A00,087430,Spolaor; Luca,5,0,8,3
1653411791548,MATH 257A,A00,087431,Spolaor; Luca,7,0,8,1
1653411792072,MATH 258,A00,087432,Staff,9,0,10,1
1653411792602,MATH 264A,A00,087433,Warnke; Lutz Peter,5,0,8,3
1653411793124,MATH 268,A00,087434,Staff,15,0,15,0
1653411793646,MATH 269,A00,087435,Staff,14,0,15,1
1653411794174,MATH 270A,A00,087436,Nie; Jiawang,0,0,8,8
1653411794703,MATH 272A,A00,087437,Tian; Xiaochuan,2,0,8,6
1653411795230,MATH 274,A01,087439,Cheng; Li-Tien,9,0,10,1
1653411795230,MATH 274,A02,087440,Cheng; Li-Tien,10,0,10,0
1653411795766,MATH 278A,A00,087441,Staff,8,0,10,2
1653411796293,MATH 278B,A00,087442,Staff,8,0,10,2
1653411796841,MATH 278C,A00,087443,Staff,8,0,10,2
1653411797371,MATH 280A,A00,087444,Zheng; Tianyi,0,0,8,8
1653411797894,MATH 281A,A00,087445,Bradic; Jelena,0,0,8,8
1653411798423,MATH 282A,A00,087446,Zhang; Danna,0,0,8,8
1653411798950,MATH 283,A00,087447,Tesler; Glenn,0,0,0,14
1653411799490,MATH 286,A00,087448,Kemp; Todd Aahron,6,0,8,2
1653411800016,MATH 287D,A00,087449,Bradic; Jelena,8,0,8,0
1653411800538,MATH 288,A00,087450,Staff,14,0,15,1
1653411800538,MATH 288,B00,087451,Staff,15,0,15,0
1653411800538,MATH 288,C00,087452,Staff,15,0,15,0
1653411801063,MATH 290A,A00,087453,Xu; Zhouli,7,0,8,1
1653411801605,MATH 291A,A00,087454,Xu; Zhouli,7,0,8,1
1653411802126,MATH 292,A00,087455,Staff,10,0,10,0
1653411802734,MATH 295,A00,087456,Staff,50,0,50,0
1653411803257,MATH 297,001,087457,Staff,998,0,999,1
1653412376625,COGS 200,A01,087991,Staff,48,0,50,2
1653412377148,COGS 201,A01,094504,Rangel; Lara M,17,0,25,8
1653412377670,COGS 203,A00,087992,Coulson; Seana M,19,0,20,1
1653412378193,COGS 210A,001,087993,Greene; Deanna Jacquelyn,9998,0,9999,1
1653412378193,COGS 210A,002,087994,Saygin; Ayse P,9999,0,9999,0
1653412378193,COGS 210A,003,087995,Xia; Haijun,9999,0,9999,0
1653412378193,COGS 210A,004,087996,Nitz; Douglas A.,9999,0,9999,0
1653412378193,COGS 210A,005,087997,Hollan; James D.,9999,0,9999,0
1653412378193,COGS 210A,006,087998,Deak; Gedeon O.,9998,0,9999,1
1653412378193,COGS 210A,007,087999,Rossano; Federico,9999,0,9999,0
1653412378717,COGS 211A,A00,088000,Coulson; Seana M,9997,0,9999,2
1653412379239,COGS 229,A00,088002,Staff,23,0,25,2
1653412379772,COGS 260,B00,094231,Staff,17,0,20,3
1653412379772,COGS 260,A00,088004,Nitz; Douglas A.,9998,0,9999,1
1653412380303,CSE 202,A00,090110,Paturi; Ramamohan,0,0,0,0
1653412380303,CSE 202,B00,090111,Paturi; Ramamohan,0,0,0,0
1653412380827,CSE 207B,A00,090112,Heninger; Nadia A,0,0,0,0
1653412381351,CSE 208,A00,094858,Micciancio; Daniele,0,0,0,0
1653412381877,CSE 210,A00,090113,Powell; Thomas Allan,0,0,0,0
1653412382416,CSE 219,A00,090898,Staff,0,0,0,0
1653412382948,CSE 221,A00,090114,Zhou; Yuan-Yuan,0,0,0,0
1653412383472,CSE 229A,A00,090115,Porter; George M,0,0,0,0
1653412384005,CSE 229C,A00,090116,Savage; Stefan,0,0,0,0
1653412384540,CSE 230,A00,090117,Jhala; Ranjit,0,0,0,0
1653412385064,CSE 232,A00,090118,Papakonstantinou; Yannis,0,0,0,0
1653412385586,CSE 239A,A00,090121,Kumar; Arun Kumar,0,0,0,0
1653412386108,CSE 239B,A00,090122,Jhala; Ranjit,0,0,0,0
1653412386639,CSE 240A,A00,090123,Zhao; Jishen,0,0,189,189
1653412387171,CSE 243A,A00,090124,Orailoglu; Alex,3,0,15,12
1653412387712,CSE 249B,A00,090125,Kahng; Andrew Byun,13,0,20,7
1653412388240,CSE 250A,A00,090126,Berg-Kirkpatrick; Taylor D,0,0,0,0
1653412388766,CSE 252A,A00,090127,Ochoa; Benjamin Lawrence,0,0,0,0
1653412389287,CSE 258,A01,090129,McAuley; Julian John,0,0,0,0
1653412389808,CSE 258R,A01,090131,McAuley; Julian John,0,0,0,0
1653412390330,CSE 274,A00,090132,Ramamoorthi; Ravi,0,0,0,0
1653412390853,CSE 276A,A00,090133,Christensen; Henrik I,0,0,0,0
1653412391380,CSE 276C,A00,090134,Christensen; Henrik I,0,0,0,0
1653412391903,CSE 290,A00,090135,Bafna; Vineet,0,0,0,0
1653412391903,CSE 290,B00,090136,Ramamoorthi; Ravi,0,0,0,0
1653412391903,CSE 290,C00,090137,Li; Tzumao,10,0,10,0
1653412391903,CSE 290,D00,090138,Zhou; Yuan-Yuan,10,0,10,0
1653412391903,CSE 290,E00,090139,Christensen; Henrik I,10,0,10,0
1653412391903,CSE 290,F00,094053,Shalev; Aaron D,0,0,0,0
1653412392426,CSE 291,A00,090140,Munyaka; Imani N. S.,0,0,0,0
1653412392426,CSE 291,B00,094880,Yu; Qi,0,0,0,0
1653412392426,CSE 291,C00,090142,Pannuto; Patrick William,0,0,0,0
1653412392426,CSE 291,D00,094881,Zhang; Yiying,0,0,0,0
1653412392426,CSE 291,E00,095118,Su; Hao,0,0,0,0
1653412392959,CSE 293,001,094905,Bafna; Vineet,9999,0,9999,0
1653412392959,CSE 293,002,094906,Bellare; Mihir,9999,0,9999,0
1653412392959,CSE 293,003,094907,Berg-Kirkpatrick; Taylor D,9999,0,9999,0
1653412392959,CSE 293,004,094908,Christensen; Henrik I,9999,0,9999,0
1653412392959,CSE 293,005,094909,Cottrell; Garrison W,9999,0,9999,0
1653412392959,CSE 293,006,094910,Deutsch; Alin Bernard,9999,0,9999,0
1653412392959,CSE 293,007,094911,Esmaeilzadeh; Hadi,9999,0,9999,0
1653412392959,CSE 293,008,094912,Freund; Yoav,9999,0,9999,0
1653412392959,CSE 293,009,094913,Griswold; William G.,9999,0,9999,0
1653412392959,CSE 293,010,094914,Gymrek; Melissa Ann,9999,0,9999,0
1653412392959,CSE 293,011,094915,Heninger; Nadia A,9999,0,9999,0
1653412392959,CSE 293,012,094916,Impagliazzo; Russell,9999,0,9999,0
1653412392959,CSE 293,013,094917,Jhala; Ranjit,9999,0,9999,0
1653412392959,CSE 293,014,094918,Kahng; Andrew Byun,9999,0,9999,0
1653412392959,CSE 293,015,094919,Kane; Daniel Mertz,9999,0,9999,0
1653412392959,CSE 293,016,094920,Kriegman; David J,9999,0,9999,0
1653412392959,CSE 293,017,094921,Kumar; Arun Kumar,9999,0,9999,0
1653412392959,CSE 293,018,094922,Lerner; Sorin,9999,0,9999,0
1653412392959,CSE 293,019,094923,Lovett; Shachar,9999,0,9999,0
1653412392959,CSE 293,020,094924,McAuley; Julian John,9999,0,9999,0
1653412392959,CSE 293,021,094925,Micciancio; Daniele,9999,0,9999,0
1653412392959,CSE 293,022,094926,Orailoglu; Alex,9999,0,9999,0
1653412392959,CSE 293,023,094927,Paturi; Ramamohan,9999,0,9999,0
1653412392959,CSE 293,024,094928,Polikarpova; Nadezhda,9999,0,9999,0
1653412392959,CSE 293,025,094929,Politz; Joseph Gibbs,9999,0,9999,0
1653412392959,CSE 293,026,094930,Porter; George M,9999,0,9999,0
1653412392959,CSE 293,027,094931,Porter; Leonard Emerson,9999,0,9999,0
1653412392959,CSE 293,028,094932,Ramamoorthi; Ravi,9999,0,9999,0
1653412392959,CSE 293,029,094933,Sahoo; Debashis,9999,0,9999,0
1653412392959,CSE 293,030,094934,Saul; Lawrence,9999,0,9999,0
1653412392959,CSE 293,031,094935,Savage; Stefan,9999,0,9999,0
1653412392959,CSE 293,032,094936,Schulze; Jurgen P.,9999,0,9999,0
1653412392959,CSE 293,033,094937,Snoeren; Alex C.,9999,0,9999,0
1653412392959,CSE 293,034,094938,Shang; Jingbo,9999,0,9999,0
1653412392959,CSE 293,035,094939,Stefan; Deian,9999,0,9999,0
1653412392959,CSE 293,036,094940,Su; Hao,9999,0,9999,0
1653412392959,CSE 293,037,094941,Swanson; Steven James,9999,0,9999,0
1653412392959,CSE 293,038,094942,Tullsen; Dean Michael,9999,0,9999,0
1653412392959,CSE 293,039,094943,Voelker; Geoffrey M.,9999,0,9999,0
1653412392959,CSE 293,040,094944,Zhao; Jishen,9999,0,9999,0
1653412392959,CSE 293,041,094945,Zhou; Yuan-Yuan,9999,0,9999,0
1653412392959,CSE 293,042,094946,Gao; Sicun,9998,0,9999,1
1653412392959,CSE 293,043,094947,Weibel; Nadir,9999,0,9999,0
1653412392959,CSE 293,044,094948,Gupta; Rajesh K.,9999,0,9999,0
1653412393485,CSE 294,A00,090143,Porter; George M,9,0,10,1
1653412394008,DSE 200,A00,091799,Staff,50,0,50,0
1653412394540,DSE 203,A00,091800,Gupta; Amarnath,30,0,30,0
1653412395063,DSE 250,A00,091801,Deutsch; Alin Bernard,30,0,30,0
1653412395584,DSE 290,A00,091802,Altintas De Callaf; Ilkay,50,0,50,0
1653412396113,ECE 200,001,091003,Antipa; Nicholas A,9999,0,9999,0
1653412396113,ECE 200,002,091004,Atanasov; Nikolay A.,9999,0,9999,0
1653412396113,ECE 200,003,091005,Bharadia; Dinesh,9999,0,9999,0
1653412396113,ECE 200,004,091006,Cheng; Chung Kuan,9999,0,9999,0
1653412396113,ECE 200,005,091007,Cosman; Pamela C.,9999,0,9999,0
1653412396113,ECE 200,006,091008,Staff,9999,0,9999,0
1653412396113,ECE 200,007,091009,Dayeh; Shadi Ahmad,9999,0,9999,0
1653412396113,ECE 200,008,091010,Fainman; Yeshaiahu,9999,0,9999,0
1653412396113,ECE 200,009,091011,Ford; Joseph Earl,9999,0,9999,0
1653412396113,ECE 200,010,091012,Franceschetti; Massimo,9999,0,9999,0
1653412396113,ECE 200,011,091013,Fullerton; Eric E,9999,0,9999,0
1653412396113,ECE 200,012,091014,Galton; Ian A,9999,0,9999,0
1653412396113,ECE 200,013,091015,Gilja; Vikash,9999,0,9999,0
1653412396113,ECE 200,014,091016,Hall; Drew A.,9999,0,9999,0
1653412396113,ECE 200,015,091017,Hsueh; Tzu-Chien,9999,0,9999,0
1653412396113,ECE 200,016,091018,Javidi; Tara,9999,0,9999,0
1653412396113,ECE 200,017,091019,Kahng; Andrew Byun,9999,0,9999,0
1653412396113,ECE 200,018,091020,Kim; Young-Han,9999,0,9999,0
1653412396113,ECE 200,019,091021,Koushanfar; Farinaz,9999,0,9999,0
1653412396113,ECE 200,020,091022,Kuzum; Duygu,9999,0,9999,0
1653412396113,ECE 200,021,091023,Le; Hanh-Phuc,9999,0,9999,0
1653412396113,ECE 200,022,091024,Lin; Bill,9999,0,9999,0
1653412396113,ECE 200,023,091025,Liu; Zhaowei,9999,0,9999,0
1653412396113,ECE 200,024,091026,Lo; Yu-Hwa,9999,0,9999,0
1653412396113,ECE 200,025,091027,Lomakin; Vitaliy,9999,0,9999,0
1653412396113,ECE 200,026,091028,Mercier; Patrick Philip,9999,0,9999,0
1653412396113,ECE 200,027,091029,Meyer; Florian,9999,0,9999,0
1653412396113,ECE 200,028,091030,Milstein; Laurence B.,9999,0,9999,0
1653412396113,ECE 200,029,091031,Mir Arabbaygi; Siavash,9999,0,9999,0
1653412396113,ECE 200,030,091032,Mookherjea; Shayan,9999,0,9999,0
1653412396113,ECE 200,031,091033,Morris; Karcher William,9999,0,9999,0
1653412396113,ECE 200,032,091034,Ng; Tse Nga,9999,0,9999,0
1653412396113,ECE 200,033,091035,Nguyen; Truong Quang,9999,0,9999,0
1653412396113,ECE 200,034,091036,Nomura; Kenji,9999,0,9999,0
1653412396113,ECE 200,035,091037,Orlitsky; Alon,9999,0,9999,0
1653412396113,ECE 200,036,091038,Pal; Piya,9999,0,9999,0
1653412396113,ECE 200,037,091039,Papen; George C.,9999,0,9999,0
1653412396113,ECE 200,038,091040,Radic; Stojan,9999,0,9999,0
1653412396113,ECE 200,039,091041,Rao; Bhaskar D.,9999,0,9999,0
1653412396113,ECE 200,040,091042,Rao; Ramesh R,9999,0,9999,0
1653412396113,ECE 200,041,091043,Rebeiz; Gabriel,9999,0,9999,0
1653412396113,ECE 200,042,091044,Sanford; John R,9999,0,9999,0
1653412396113,ECE 200,043,091045,Siegel; Paul H.,9999,0,9999,0
1653412396113,ECE 200,044,091046,Sievenpiper; Daniel F.,9999,0,9999,0
1653412396113,ECE 200,045,091047,Sworder; David D.,9999,0,9999,0
1653412396113,ECE 200,046,091048,Taur; Yuan,9999,0,9999,0
1653412396113,ECE 200,047,091049,Touri; Behrouz,9999,0,9999,0
1653412396113,ECE 200,048,091050,Trivedi; Mohan M.,9999,0,9999,0
1653412396113,ECE 200,049,091051,Vardy; Alexander,9999,0,9999,0
1653412396113,ECE 200,050,091052,Vasconcelos; Nuno,9999,0,9999,0
1653412396113,ECE 200,051,091053,Wang; Xiaolong,9999,0,9999,0
1653412396113,ECE 200,052,091054,Xie; Pengtao,9999,0,9999,0
1653412396113,ECE 200,053,091055,Yip; Michael,9999,0,9999,0
1653412396113,ECE 200,054,091056,Zeger; Kenneth A.,9999,0,9999,0
1653412396113,ECE 200,055,091057,Zhang; Xinyu,9999,0,9999,0
1653412396113,ECE 200,056,091058,Turakhia; Yatish Girish,9999,0,9999,0
1653412396113,ECE 200,057,091059,Kang; Mingu,9999,0,9999,0
1653412396113,ECE 200,058,091060,Shi; Yuanyuan,9999,0,9999,0
1653412396113,ECE 200,059,091061,Wang; Edward Jay,9999,0,9999,0
1653412396113,ECE 200,060,091062,Zheng; Yang,9999,0,9999,0
1653412396637,ECE 203,A00,091065,Mercier; Patrick Philip,0,0,0,0
1653412397164,ECE 207A,A00,091605,Liu; Thomas Tao-Ming,0,0,0,0
1653412397700,ECE 212AN,A00,091068,Nomura; Kenji,0,0,0,0
1653412398225,ECE 222A,A00,091069,Rebeiz; Gabriel,0,0,0,0
1653412398748,ECE 225A,A00,091070,Orlitsky; Alon,0,0,0,0
1653412399269,ECE 230A,A00,091071,Nomura; Kenji,0,0,0,0
1653412399795,ECE 236A,A00,091072,Dayeh; Shadi Ahmad,0,0,0,0
1653412400319,ECE 238A,A00,091073,Luo; Jian,0,0,0,0
1653412400319,ECE 238A,B00,091074,Luo; Jian,0,0,0,0
1653412400840,ECE 240A,A00,091075,Radic; Stojan,0,0,0,0
1653412401369,ECE 247A,A00,091592,Shi; Lingyan,0,0,0,0
1653412401902,ECE 250,A00,091076,Touri; Behrouz,0,0,0,0
1653412402428,ECE 251C,A00,091078,Nguyen; Truong Quang,0,0,0,0
1653412402954,ECE 253,A00,091079,Cosman; Pamela C.,0,0,0,0
1653412403557,ECE 255A,A00,091080,Orlitsky; Alon,0,0,0,0
1653412404079,ECE 257A,A00,091081,Zhang; Xinyu,0,0,0,0
1653412404602,ECE 260A,A01,091084,Eldon; John,0,0,0,0
1653412405134,ECE 264C,A00,091085,Galton; Ian A,0,0,0,0
1653412405658,ECE 265C,A00,094889,Presti; Calogero Davide,0,0,0,9
1653412406183,ECE 266,A01,091087,Hall; Drew A.,0,0,0,0
1653412407236,ECE 271A,A00,091090,Vasconcelos; Nuno,0,0,0,0
1653412407763,ECE 272B,A00,091091,Sworder; David D.,0,0,0,0
1653412408285,ECE 275A,A00,091092,Meyer; Florian,0,0,0,0
1653412408816,ECE 277,A00,091093,An; Cheolhong,0,0,0,0
1653412409345,ECE 283,A00,091094,Le; Hanh-Phuc,0,0,0,0
1653412409870,ECE 284,A00,091095,Kang; Mingu,0,0,0,0
1653412409870,ECE 284,B00,091096,Wang; Edward Jay,0,0,0,0
1653412410394,ECE 285,A00,094334,Touri; Behrouz,0,0,0,0
1653412410920,ECE 289,A00,091097,Whelan; David Arthur,0,0,0,0
1653412411445,MATH 200A,A00,087414,Salehi Golsefidy; Alireza,7,0,8,1
1653412411977,MATH 202A,A00,087415,Gill; Philip E.,3,0,8,5
1653412412505,MATH 203A,A00,087416,Oprea; Dragos N.,6,0,8,2
1653412413029,MATH 204A,A00,087417,Kedlaya; Kiran S.,6,0,8,2
1653412413552,MATH 205,A00,087418,Sorensen; Claus M,6,0,8,2
1653412414081,MATH 206A,A00,087419,Izadi; Elham,7,0,8,1
1653412414603,MATH 207A,A00,087420,Mohammadi; Amir,6,0,8,2
1653412415128,MATH 208,A00,087421,Staff,9,0,10,1
1653412415650,MATH 209,A00,087422,Staff,10,0,10,0
1653412416172,MATH 218,A00,087423,Staff,10,0,10,0
1653412416698,MATH 220A,A00,087424,Novak; Jonathan I,7,0,8,1
1653412417223,MATH 231A,A00,087425,Bejenaru; Ioan,4,0,8,4
1653412417746,MATH 240A,A00,087426,Ebenfelt; Peter F,5,0,8,3
1653412418285,MATH 243,A00,087427,Staff,9,0,10,1
1653412418814,MATH 248,A00,087429,Staff,10,0,10,0
1653412419335,MATH 250A,A00,087430,Spolaor; Luca,5,0,8,3
1653412419860,MATH 257A,A00,087431,Spolaor; Luca,7,0,8,1
1653412420390,MATH 258,A00,087432,Staff,9,0,10,1
1653412420915,MATH 264A,A00,087433,Warnke; Lutz Peter,5,0,8,3
1653412421441,MATH 268,A00,087434,Staff,15,0,15,0
1653412421965,MATH 269,A00,087435,Staff,14,0,15,1
1653412422492,MATH 270A,A00,087436,Nie; Jiawang,0,0,8,8
1653412423022,MATH 272A,A00,087437,Tian; Xiaochuan,2,0,8,6
1653412423545,MATH 274,A01,087439,Cheng; Li-Tien,9,0,10,1
1653412423545,MATH 274,A02,087440,Cheng; Li-Tien,10,0,10,0
1653412424067,MATH 278A,A00,087441,Staff,8,0,10,2
1653412424589,MATH 278B,A00,087442,Staff,8,0,10,2
1653412425112,MATH 278C,A00,087443,Staff,8,0,10,2
1653412425647,MATH 280A,A00,087444,Zheng; Tianyi,0,0,8,8
1653412426171,MATH 281A,A00,087445,Bradic; Jelena,0,0,8,8
1653412426702,MATH 282A,A00,087446,Zhang; Danna,0,0,8,8
1653412427228,MATH 283,A00,087447,Tesler; Glenn,0,0,0,14
1653412427762,MATH 286,A00,087448,Kemp; Todd Aahron,6,0,8,2
1653412428284,MATH 287D,A00,087449,Bradic; Jelena,8,0,8,0
1653412428807,MATH 288,A00,087450,Staff,14,0,15,1
1653412428807,MATH 288,B00,087451,Staff,15,0,15,0
1653412428807,MATH 288,C00,087452,Staff,15,0,15,0
1653412429329,MATH 290A,A00,087453,Xu; Zhouli,7,0,8,1
1653412429861,MATH 291A,A00,087454,Xu; Zhouli,7,0,8,1
1653412430384,MATH 292,A00,087455,Staff,10,0,10,0
1653412430919,MATH 295,A00,087456,Staff,50,0,50,0
1653412431450,MATH 297,001,087457,Staff,998,0,999,1
1653412993874,COGS 200,A01,087991,Staff,48,0,50,2
1653412994401,COGS 201,A01,094504,Rangel; Lara M,17,0,25,8
1653412994934,COGS 203,A00,087992,Coulson; Seana M,19,0,20,1
1653412995459,COGS 210A,001,087993,Greene; Deanna Jacquelyn,9998,0,9999,1
1653412995459,COGS 210A,002,087994,Saygin; Ayse P,9999,0,9999,0
1653412995459,COGS 210A,003,087995,Xia; Haijun,9999,0,9999,0
1653412995459,COGS 210A,004,087996,Nitz; Douglas A.,9999,0,9999,0
1653412995459,COGS 210A,005,087997,Hollan; James D.,9999,0,9999,0
1653412995459,COGS 210A,006,087998,Deak; Gedeon O.,9998,0,9999,1
1653412995459,COGS 210A,007,087999,Rossano; Federico,9999,0,9999,0
1653412995995,COGS 211A,A00,088000,Coulson; Seana M,9997,0,9999,2
1653412996519,COGS 229,A00,088002,Staff,23,0,25,2
1653412997041,COGS 260,B00,094231,Staff,17,0,20,3
1653412997041,COGS 260,A00,088004,Nitz; Douglas A.,9998,0,9999,1
1653412997582,CSE 202,A00,090110,Paturi; Ramamohan,0,0,0,0
1653412997582,CSE 202,B00,090111,Paturi; Ramamohan,0,0,0,0
1653412998121,CSE 207B,A00,090112,Heninger; Nadia A,0,0,0,0
1653412998648,CSE 208,A00,094858,Micciancio; Daniele,0,0,0,0
1653412999174,CSE 210,A00,090113,Powell; Thomas Allan,0,0,0,0
1653412999697,CSE 219,A00,090898,Staff,0,0,0,0
1653413000223,CSE 221,A00,090114,Zhou; Yuan-Yuan,0,0,0,0
1653413000748,CSE 229A,A00,090115,Porter; George M,0,0,0,0
1653413001270,CSE 229C,A00,090116,Savage; Stefan,0,0,0,0
1653413001800,CSE 230,A00,090117,Jhala; Ranjit,0,0,0,0
1653413002322,CSE 232,A00,090118,Papakonstantinou; Yannis,0,0,0,0
1653413002852,CSE 239A,A00,090121,Kumar; Arun Kumar,0,0,0,0
1653413003387,CSE 239B,A00,090122,Jhala; Ranjit,0,0,0,0
1653413003910,CSE 240A,A00,090123,Zhao; Jishen,0,0,189,189
1653413004440,CSE 243A,A00,090124,Orailoglu; Alex,3,0,15,12
1653413004966,CSE 249B,A00,090125,Kahng; Andrew Byun,13,0,20,7
1653413005487,CSE 250A,A00,090126,Berg-Kirkpatrick; Taylor D,0,0,0,0
1653413006022,CSE 252A,A00,090127,Ochoa; Benjamin Lawrence,0,0,0,0
1653413006545,CSE 258,A01,090129,McAuley; Julian John,0,0,0,0
1653413007067,CSE 258R,A01,090131,McAuley; Julian John,0,0,0,0
1653413007593,CSE 274,A00,090132,Ramamoorthi; Ravi,0,0,0,0
1653413008121,CSE 276A,A00,090133,Christensen; Henrik I,0,0,0,0
1653413008652,CSE 276C,A00,090134,Christensen; Henrik I,0,0,0,0
1653413009179,CSE 290,A00,090135,Bafna; Vineet,0,0,0,0
1653413009179,CSE 290,B00,090136,Ramamoorthi; Ravi,0,0,0,0
1653413009179,CSE 290,C00,090137,Li; Tzumao,10,0,10,0
1653413009179,CSE 290,D00,090138,Zhou; Yuan-Yuan,10,0,10,0
1653413009179,CSE 290,E00,090139,Christensen; Henrik I,10,0,10,0
1653413009179,CSE 290,F00,094053,Shalev; Aaron D,0,0,0,0
1653413009706,CSE 291,A00,090140,Munyaka; Imani N. S.,0,0,0,0
1653413009706,CSE 291,B00,094880,Yu; Qi,0,0,0,0
1653413009706,CSE 291,C00,090142,Pannuto; Patrick William,0,0,0,0
1653413009706,CSE 291,D00,094881,Zhang; Yiying,0,0,0,0
1653413009706,CSE 291,E00,095118,Su; Hao,0,0,0,0
1653413010240,CSE 293,001,094905,Bafna; Vineet,9999,0,9999,0
1653413010240,CSE 293,002,094906,Bellare; Mihir,9999,0,9999,0
1653413010240,CSE 293,003,094907,Berg-Kirkpatrick; Taylor D,9999,0,9999,0
1653413010240,CSE 293,004,094908,Christensen; Henrik I,9999,0,9999,0
1653413010240,CSE 293,005,094909,Cottrell; Garrison W,9999,0,9999,0
1653413010240,CSE 293,006,094910,Deutsch; Alin Bernard,9999,0,9999,0
1653413010240,CSE 293,007,094911,Esmaeilzadeh; Hadi,9999,0,9999,0
1653413010240,CSE 293,008,094912,Freund; Yoav,9999,0,9999,0
1653413010240,CSE 293,009,094913,Griswold; William G.,9999,0,9999,0
1653413010240,CSE 293,010,094914,Gymrek; Melissa Ann,9999,0,9999,0
1653413010240,CSE 293,011,094915,Heninger; Nadia A,9999,0,9999,0
1653413010240,CSE 293,012,094916,Impagliazzo; Russell,9999,0,9999,0
1653413010240,CSE 293,013,094917,Jhala; Ranjit,9999,0,9999,0
1653413010240,CSE 293,014,094918,Kahng; Andrew Byun,9999,0,9999,0
1653413010240,CSE 293,015,094919,Kane; Daniel Mertz,9999,0,9999,0
1653413010240,CSE 293,016,094920,Kriegman; David J,9999,0,9999,0
1653413010240,CSE 293,017,094921,Kumar; Arun Kumar,9999,0,9999,0
1653413010240,CSE 293,018,094922,Lerner; Sorin,9999,0,9999,0
1653413010240,CSE 293,019,094923,Lovett; Shachar,9999,0,9999,0
1653413010240,CSE 293,020,094924,McAuley; Julian John,9999,0,9999,0
1653413010240,CSE 293,021,094925,Micciancio; Daniele,9999,0,9999,0
1653413010240,CSE 293,022,094926,Orailoglu; Alex,9999,0,9999,0
1653413010240,CSE 293,023,094927,Paturi; Ramamohan,9999,0,9999,0
1653413010240,CSE 293,024,094928,Polikarpova; Nadezhda,9999,0,9999,0
1653413010240,CSE 293,025,094929,Politz; Joseph Gibbs,9999,0,9999,0
1653413010240,CSE 293,026,094930,Porter; George M,9999,0,9999,0
1653413010240,CSE 293,027,094931,Porter; Leonard Emerson,9999,0,9999,0
1653413010240,CSE 293,028,094932,Ramamoorthi; Ravi,9999,0,9999,0
1653413010240,CSE 293,029,094933,Sahoo; Debashis,9999,0,9999,0
1653413010240,CSE 293,030,094934,Saul; Lawrence,9999,0,9999,0
1653413010240,CSE 293,031,094935,Savage; Stefan,9999,0,9999,0
1653413010240,CSE 293,032,094936,Schulze; Jurgen P.,9999,0,9999,0
1653413010240,CSE 293,033,094937,Snoeren; Alex C.,9999,0,9999,0
1653413010240,CSE 293,034,094938,Shang; Jingbo,9999,0,9999,0
1653413010240,CSE 293,035,094939,Stefan; Deian,9999,0,9999,0
1653413010240,CSE 293,036,094940,Su; Hao,9999,0,9999,0
1653413010240,CSE 293,037,094941,Swanson; Steven James,9999,0,9999,0
1653413010240,CSE 293,038,094942,Tullsen; Dean Michael,9999,0,9999,0
1653413010240,CSE 293,039,094943,Voelker; Geoffrey M.,9999,0,9999,0
1653413010240,CSE 293,040,094944,Zhao; Jishen,9999,0,9999,0
1653413010240,CSE 293,041,094945,Zhou; Yuan-Yuan,9999,0,9999,0
1653413010240,CSE 293,042,094946,Gao; Sicun,9998,0,9999,1
1653413010240,CSE 293,043,094947,Weibel; Nadir,9999,0,9999,0
1653413010240,CSE 293,044,094948,Gupta; Rajesh K.,9999,0,9999,0
1653413010765,CSE 294,A00,090143,Porter; George M,9,0,10,1
1653413011288,DSE 200,A00,091799,Staff,50,0,50,0
1653413011814,DSE 203,A00,091800,Gupta; Amarnath,30,0,30,0
1653413012348,DSE 250,A00,091801,Deutsch; Alin Bernard,30,0,30,0
1653413012871,DSE 290,A00,091802,Altintas De Callaf; Ilkay,50,0,50,0
1653413013409,ECE 200,001,091003,Antipa; Nicholas A,9999,0,9999,0
1653413013409,ECE 200,002,091004,Atanasov; Nikolay A.,9999,0,9999,0
1653413013409,ECE 200,003,091005,Bharadia; Dinesh,9999,0,9999,0
1653413013409,ECE 200,004,091006,Cheng; Chung Kuan,9999,0,9999,0
1653413013409,ECE 200,005,091007,Cosman; Pamela C.,9999,0,9999,0
1653413013409,ECE 200,006,091008,Staff,9999,0,9999,0
1653413013409,ECE 200,007,091009,Dayeh; Shadi Ahmad,9999,0,9999,0
1653413013409,ECE 200,008,091010,Fainman; Yeshaiahu,9999,0,9999,0
1653413013409,ECE 200,009,091011,Ford; Joseph Earl,9999,0,9999,0
1653413013409,ECE 200,010,091012,Franceschetti; Massimo,9999,0,9999,0
1653413013409,ECE 200,011,091013,Fullerton; Eric E,9999,0,9999,0
1653413013409,ECE 200,012,091014,Galton; Ian A,9999,0,9999,0
1653413013409,ECE 200,013,091015,Gilja; Vikash,9999,0,9999,0
1653413013409,ECE 200,014,091016,Hall; Drew A.,9999,0,9999,0
1653413013409,ECE 200,015,091017,Hsueh; Tzu-Chien,9999,0,9999,0
1653413013409,ECE 200,016,091018,Javidi; Tara,9999,0,9999,0
1653413013409,ECE 200,017,091019,Kahng; Andrew Byun,9999,0,9999,0
1653413013409,ECE 200,018,091020,Kim; Young-Han,9999,0,9999,0
1653413013409,ECE 200,019,091021,Koushanfar; Farinaz,9999,0,9999,0
1653413013409,ECE 200,020,091022,Kuzum; Duygu,9999,0,9999,0
1653413013409,ECE 200,021,091023,Le; Hanh-Phuc,9999,0,9999,0
1653413013409,ECE 200,022,091024,Lin; Bill,9999,0,9999,0
1653413013409,ECE 200,023,091025,Liu; Zhaowei,9999,0,9999,0
1653413013409,ECE 200,024,091026,Lo; Yu-Hwa,9999,0,9999,0
1653413013409,ECE 200,025,091027,Lomakin; Vitaliy,9999,0,9999,0
1653413013409,ECE 200,026,091028,Mercier; Patrick Philip,9999,0,9999,0
1653413013409,ECE 200,027,091029,Meyer; Florian,9999,0,9999,0
1653413013409,ECE 200,028,091030,Milstein; Laurence B.,9999,0,9999,0
1653413013409,ECE 200,029,091031,Mir Arabbaygi; Siavash,9999,0,9999,0
1653413013409,ECE 200,030,091032,Mookherjea; Shayan,9999,0,9999,0
1653413013409,ECE 200,031,091033,Morris; Karcher William,9999,0,9999,0
1653413013409,ECE 200,032,091034,Ng; Tse Nga,9999,0,9999,0
1653413013409,ECE 200,033,091035,Nguyen; Truong Quang,9999,0,9999,0
1653413013409,ECE 200,034,091036,Nomura; Kenji,9999,0,9999,0
1653413013409,ECE 200,035,091037,Orlitsky; Alon,9999,0,9999,0
1653413013409,ECE 200,036,091038,Pal; Piya,9999,0,9999,0
1653413013409,ECE 200,037,091039,Papen; George C.,9999,0,9999,0
1653413013409,ECE 200,038,091040,Radic; Stojan,9999,0,9999,0
1653413013409,ECE 200,039,091041,Rao; Bhaskar D.,9999,0,9999,0
1653413013409,ECE 200,040,091042,Rao; Ramesh R,9999,0,9999,0
1653413013409,ECE 200,041,091043,Rebeiz; Gabriel,9999,0,9999,0
1653413013409,ECE 200,042,091044,Sanford; John R,9999,0,9999,0
1653413013409,ECE 200,043,091045,Siegel; Paul H.,9999,0,9999,0
1653413013409,ECE 200,044,091046,Sievenpiper; Daniel F.,9999,0,9999,0
1653413013409,ECE 200,045,091047,Sworder; David D.,9999,0,9999,0
1653413013409,ECE 200,046,091048,Taur; Yuan,9999,0,9999,0
1653413013409,ECE 200,047,091049,Touri; Behrouz,9999,0,9999,0
1653413013409,ECE 200,048,091050,Trivedi; Mohan M.,9999,0,9999,0
1653413013409,ECE 200,049,091051,Vardy; Alexander,9999,0,9999,0
1653413013409,ECE 200,050,091052,Vasconcelos; Nuno,9999,0,9999,0
1653413013409,ECE 200,051,091053,Wang; Xiaolong,9999,0,9999,0
1653413013409,ECE 200,052,091054,Xie; Pengtao,9999,0,9999,0
1653413013409,ECE 200,053,091055,Yip; Michael,9999,0,9999,0
1653413013409,ECE 200,054,091056,Zeger; Kenneth A.,9999,0,9999,0
1653413013409,ECE 200,055,091057,Zhang; Xinyu,9999,0,9999,0
1653413013409,ECE 200,056,091058,Turakhia; Yatish Girish,9999,0,9999,0
1653413013409,ECE 200,057,091059,Kang; Mingu,9999,0,9999,0
1653413013409,ECE 200,058,091060,Shi; Yuanyuan,9999,0,9999,0
1653413013409,ECE 200,059,091061,Wang; Edward Jay,9999,0,9999,0
1653413013409,ECE 200,060,091062,Zheng; Yang,9999,0,9999,0
1653413013933,ECE 203,A00,091065,Mercier; Patrick Philip,0,0,0,0
1653413014455,ECE 207A,A00,091605,Liu; Thomas Tao-Ming,0,0,0,0
1653413014990,ECE 212AN,A00,091068,Nomura; Kenji,0,0,0,0
1653413015515,ECE 222A,A00,091069,Rebeiz; Gabriel,0,0,0,0
1653413016037,ECE 225A,A00,091070,Orlitsky; Alon,0,0,0,0
1653413016569,ECE 230A,A00,091071,Nomura; Kenji,0,0,0,0
1653413017112,ECE 236A,A00,091072,Dayeh; Shadi Ahmad,0,0,0,0
1653413017635,ECE 238A,A00,091073,Luo; Jian,0,0,0,0
1653413017635,ECE 238A,B00,091074,Luo; Jian,0,0,0,0
1653413018165,ECE 240A,A00,091075,Radic; Stojan,0,0,0,0
1653413018688,ECE 247A,A00,091592,Shi; Lingyan,0,0,0,0
1653413019210,ECE 250,A00,091076,Touri; Behrouz,0,0,0,0
1653413019733,ECE 251C,A00,091078,Nguyen; Truong Quang,0,0,0,0
1653413020265,ECE 253,A00,091079,Cosman; Pamela C.,0,0,0,0
1653413020799,ECE 255A,A00,091080,Orlitsky; Alon,0,0,0,0
1653413021324,ECE 257A,A00,091081,Zhang; Xinyu,0,0,0,0
1653413021848,ECE 260A,A01,091084,Eldon; John,0,0,0,0
1653413022382,ECE 264C,A00,091085,Galton; Ian A,0,0,0,0
1653413022919,ECE 265C,A00,094889,Presti; Calogero Davide,0,0,0,9
1653413023460,ECE 266,A01,091087,Hall; Drew A.,0,0,0,0
1653413024519,ECE 271A,A00,091090,Vasconcelos; Nuno,0,0,0,0
1653413025040,ECE 272B,A00,091091,Sworder; David D.,0,0,0,0
1653413025572,ECE 275A,A00,091092,Meyer; Florian,0,0,0,0
1653413026107,ECE 277,A00,091093,An; Cheolhong,0,0,0,0
1653413026640,ECE 283,A00,091094,Le; Hanh-Phuc,0,0,0,0
1653413027162,ECE 284,A00,091095,Kang; Mingu,0,0,0,0
1653413027162,ECE 284,B00,091096,Wang; Edward Jay,0,0,0,0
1653413027703,ECE 285,A00,094334,Touri; Behrouz,0,0,0,0
1653413028224,ECE 289,A00,091097,Whelan; David Arthur,0,0,0,0
1653413028747,MATH 200A,A00,087414,Salehi Golsefidy; Alireza,7,0,8,1
1653413029269,MATH 202A,A00,087415,Gill; Philip E.,3,0,8,5
1653413029795,MATH 203A,A00,087416,Oprea; Dragos N.,6,0,8,2
1653413030321,MATH 204A,A00,087417,Kedlaya; Kiran S.,6,0,8,2
1653413030851,MATH 205,A00,087418,Sorensen; Claus M,6,0,8,2
1653413031374,MATH 206A,A00,087419,Izadi; Elham,7,0,8,1
1653413031907,MATH 207A,A00,087420,Mohammadi; Amir,6,0,8,2
1653413032436,MATH 208,A00,087421,Staff,9,0,10,1
1653413032959,MATH 209,A00,087422,Staff,10,0,10,0
1653413033486,MATH 218,A00,087423,Staff,10,0,10,0
1653413034027,MATH 220A,A00,087424,Novak; Jonathan I,7,0,8,1
1653413034554,MATH 231A,A00,087425,Bejenaru; Ioan,4,0,8,4
1653413035084,MATH 240A,A00,087426,Ebenfelt; Peter F,5,0,8,3
1653413035607,MATH 243,A00,087427,Staff,9,0,10,1
1653413036141,MATH 248,A00,087429,Staff,10,0,10,0
1653413036680,MATH 250A,A00,087430,Spolaor; Luca,5,0,8,3
1653413037208,MATH 257A,A00,087431,Spolaor; Luca,7,0,8,1
1653413037730,MATH 258,A00,087432,Staff,9,0,10,1
1653413038251,MATH 264A,A00,087433,Warnke; Lutz Peter,5,0,8,3
1653413038776,MATH 268,A00,087434,Staff,15,0,15,0
1653413039301,MATH 269,A00,087435,Staff,14,0,15,1
1653413039825,MATH 270A,A00,087436,Nie; Jiawang,0,0,8,8
1653413040366,MATH 272A,A00,087437,Tian; Xiaochuan,2,0,8,6
1653413040900,MATH 274,A01,087439,Cheng; Li-Tien,9,0,10,1
1653413040900,MATH 274,A02,087440,Cheng; Li-Tien,10,0,10,0
1653413041424,MATH 278A,A00,087441,Staff,8,0,10,2
1653413041952,MATH 278B,A00,087442,Staff,8,0,10,2
1653413042482,MATH 278C,A00,087443,Staff,8,0,10,2
1653413043010,MATH 280A,A00,087444,Zheng; Tianyi,0,0,8,8
1653413043531,MATH 281A,A00,087445,Bradic; Jelena,0,0,8,8
1653413044064,MATH 282A,A00,087446,Zhang; Danna,0,0,8,8
1653413044587,MATH 283,A00,087447,Tesler; Glenn,0,0,0,14
1653413045129,MATH 286,A00,087448,Kemp; Todd Aahron,6,0,8,2
1653413045652,MATH 287D,A00,087449,Bradic; Jelena,8,0,8,0
1653413046190,MATH 288,A00,087450,Staff,14,0,15,1
1653413046190,MATH 288,B00,087451,Staff,15,0,15,0
1653413046190,MATH 288,C00,087452,Staff,15,0,15,0
1653413046843,MATH 290A,A00,087453,Xu; Zhouli,7,0,8,1
1653413047367,MATH 291A,A00,087454,Xu; Zhouli,7,0,8,1
1653413047900,MATH 292,A00,087455,Staff,10,0,10,0
1653413048423,MATH 295,A00,087456,Staff,50,0,50,0
1653413048945,MATH 297,001,087457,Staff,998,0,999,1
1653413612429,COGS 200,A01,087991,Staff,48,0,50,2
1653413612951,COGS 201,A01,094504,Rangel; Lara M,17,0,25,8
1653413613473,COGS 203,A00,087992,Coulson; Seana M,19,0,20,1
1653413613996,COGS 210A,001,087993,Greene; Deanna Jacquelyn,9998,0,9999,1
1653413613996,COGS 210A,002,087994,Saygin; Ayse P,9999,0,9999,0
1653413613996,COGS 210A,003,087995,Xia; Haijun,9999,0,9999,0
1653413613996,COGS 210A,004,087996,Nitz; Douglas A.,9999,0,9999,0
1653413613996,COGS 210A,005,087997,Hollan; James D.,9999,0,9999,0
1653413613996,COGS 210A,006,087998,Deak; Gedeon O.,9998,0,9999,1
1653413613996,COGS 210A,007,087999,Rossano; Federico,9999,0,9999,0
1653413614527,COGS 211A,A00,088000,Coulson; Seana M,9997,0,9999,2
1653413615068,COGS 229,A00,088002,Staff,23,0,25,2
1653413615589,COGS 260,B00,094231,Staff,17,0,20,3
1653413615589,COGS 260,A00,088004,Nitz; Douglas A.,9998,0,9999,1
1653413616116,CSE 202,A00,090110,Paturi; Ramamohan,0,0,0,0
1653413616116,CSE 202,B00,090111,Paturi; Ramamohan,0,0,0,0
1653413616640,CSE 207B,A00,090112,Heninger; Nadia A,0,0,0,0
1653413617162,CSE 208,A00,094858,Micciancio; Daniele,0,0,0,0
1653413617684,CSE 210,A00,090113,Powell; Thomas Allan,0,0,0,0
1653413618205,CSE 219,A00,090898,Staff,0,0,0,0
1653413618728,CSE 221,A00,090114,Zhou; Yuan-Yuan,0,0,0,0
1653413619270,CSE 229A,A00,090115,Porter; George M,0,0,0,0
1653413619798,CSE 229C,A00,090116,Savage; Stefan,0,0,0,0
1653413620325,CSE 230,A00,090117,Jhala; Ranjit,0,0,0,0
1653413620851,CSE 232,A00,090118,Papakonstantinou; Yannis,0,0,0,0
1653413621373,CSE 239A,A00,090121,Kumar; Arun Kumar,0,0,0,0
1653413621896,CSE 239B,A00,090122,Jhala; Ranjit,0,0,0,0
1653413622430,CSE 240A,A00,090123,Zhao; Jishen,0,0,189,189
1653413622955,CSE 243A,A00,090124,Orailoglu; Alex,3,0,15,12
1653413623477,CSE 249B,A00,090125,Kahng; Andrew Byun,13,0,20,7
1653413624012,CSE 250A,A00,090126,Berg-Kirkpatrick; Taylor D,0,0,0,0
1653413624538,CSE 252A,A00,090127,Ochoa; Benjamin Lawrence,0,0,0,0
1653413625062,CSE 258,A01,090129,McAuley; Julian John,0,0,0,0
1653413625591,CSE 258R,A01,090131,McAuley; Julian John,0,0,0,0
1653413626113,CSE 274,A00,090132,Ramamoorthi; Ravi,0,0,0,0
1653413626634,CSE 276A,A00,090133,Christensen; Henrik I,0,0,0,0
1653413627158,CSE 276C,A00,090134,Christensen; Henrik I,0,0,0,0
1653413627682,CSE 290,A00,090135,Bafna; Vineet,0,0,0,0
1653413627682,CSE 290,B00,090136,Ramamoorthi; Ravi,0,0,0,0
1653413627682,CSE 290,C00,090137,Li; Tzumao,10,0,10,0
1653413627682,CSE 290,D00,090138,Zhou; Yuan-Yuan,10,0,10,0
1653413627682,CSE 290,E00,090139,Christensen; Henrik I,10,0,10,0
1653413627682,CSE 290,F00,094053,Shalev; Aaron D,0,0,0,0
1653413628208,CSE 291,A00,090140,Munyaka; Imani N. S.,0,0,0,0
1653413628208,CSE 291,B00,094880,Yu; Qi,0,0,0,0
1653413628208,CSE 291,C00,090142,Pannuto; Patrick William,0,0,0,0
1653413628208,CSE 291,D00,094881,Zhang; Yiying,0,0,0,0
1653413628208,CSE 291,E00,095118,Su; Hao,0,0,0,0
1653413628777,CSE 293,001,094905,Bafna; Vineet,9999,0,9999,0
1653413628777,CSE 293,002,094906,Bellare; Mihir,9999,0,9999,0
1653413628777,CSE 293,003,094907,Berg-Kirkpatrick; Taylor D,9999,0,9999,0
1653413628777,CSE 293,004,094908,Christensen; Henrik I,9999,0,9999,0
1653413628777,CSE 293,005,094909,Cottrell; Garrison W,9999,0,9999,0
1653413628777,CSE 293,006,094910,Deutsch; Alin Bernard,9999,0,9999,0
1653413628777,CSE 293,007,094911,Esmaeilzadeh; Hadi,9999,0,9999,0
1653413628777,CSE 293,008,094912,Freund; Yoav,9999,0,9999,0
1653413628777,CSE 293,009,094913,Griswold; William G.,9999,0,9999,0
1653413628777,CSE 293,010,094914,Gymrek; Melissa Ann,9999,0,9999,0
1653413628777,CSE 293,011,094915,Heninger; Nadia A,9999,0,9999,0
1653413628777,CSE 293,012,094916,Impagliazzo; Russell,9999,0,9999,0
1653413628777,CSE 293,013,094917,Jhala; Ranjit,9999,0,9999,0
1653413628777,CSE 293,014,094918,Kahng; Andrew Byun,9999,0,9999,0
1653413628777,CSE 293,015,094919,Kane; Daniel Mertz,9999,0,9999,0
1653413628777,CSE 293,016,094920,Kriegman; David J,9999,0,9999,0
1653413628777,CSE 293,017,094921,Kumar; Arun Kumar,9999,0,9999,0
1653413628777,CSE 293,018,094922,Lerner; Sorin,9999,0,9999,0
1653413628777,CSE 293,019,094923,Lovett; Shachar,9999,0,9999,0
1653413628777,CSE 293,020,094924,McAuley; Julian John,9999,0,9999,0
1653413628777,CSE 293,021,094925,Micciancio; Daniele,9999,0,9999,0
1653413628777,CSE 293,022,094926,Orailoglu; Alex,9999,0,9999,0
1653413628777,CSE 293,023,094927,Paturi; Ramamohan,9999,0,9999,0
1653413628777,CSE 293,024,094928,Polikarpova; Nadezhda,9999,0,9999,0
1653413628777,CSE 293,025,094929,Politz; Joseph Gibbs,9999,0,9999,0
1653413628777,CSE 293,026,094930,Porter; George M,9999,0,9999,0
1653413628777,CSE 293,027,094931,Porter; Leonard Emerson,9999,0,9999,0
1653413628777,CSE 293,028,094932,Ramamoorthi; Ravi,9999,0,9999,0
1653413628777,CSE 293,029,094933,Sahoo; Debashis,9999,0,9999,0
1653413628777,CSE 293,030,094934,Saul; Lawrence,9999,0,9999,0
1653413628777,CSE 293,031,094935,Savage; Stefan,9999,0,9999,0
1653413628777,CSE 293,032,094936,Schulze; Jurgen P.,9999,0,9999,0
1653413628777,CSE 293,033,094937,Snoeren; Alex C.,9999,0,9999,0
1653413628777,CSE 293,034,094938,Shang; Jingbo,9999,0,9999,0
1653413628777,CSE 293,035,094939,Stefan; Deian,9999,0,9999,0
1653413628777,CSE 293,036,094940,Su; Hao,9999,0,9999,0
1653413628777,CSE 293,037,094941,Swanson; Steven James,9999,0,9999,0
1653413628777,CSE 293,038,094942,Tullsen; Dean Michael,9999,0,9999,0
1653413628777,CSE 293,039,094943,Voelker; Geoffrey M.,9999,0,9999,0
1653413628777,CSE 293,040,094944,Zhao; Jishen,9999,0,9999,0
1653413628777,CSE 293,041,094945,Zhou; Yuan-Yuan,9999,0,9999,0
1653413628777,CSE 293,042,094946,Gao; Sicun,9998,0,9999,1
1653413628777,CSE 293,043,094947,Weibel; Nadir,9999,0,9999,0
1653413628777,CSE 293,044,094948,Gupta; Rajesh K.,9999,0,9999,0
1653413629301,CSE 294,A00,090143,Porter; George M,9,0,10,1
1653413629835,DSE 200,A00,091799,Staff,50,0,50,0
1653413630361,DSE 203,A00,091800,Gupta; Amarnath,30,0,30,0
1653413630885,DSE 250,A00,091801,Deutsch; Alin Bernard,30,0,30,0
1653413631409,DSE 290,A00,091802,Altintas De Callaf; Ilkay,50,0,50,0
1653413631978,ECE 200,001,091003,Antipa; Nicholas A,9999,0,9999,0
1653413631978,ECE 200,002,091004,Atanasov; Nikolay A.,9999,0,9999,0
1653413631978,ECE 200,003,091005,Bharadia; Dinesh,9999,0,9999,0
1653413631978,ECE 200,004,091006,Cheng; Chung Kuan,9999,0,9999,0
1653413631978,ECE 200,005,091007,Cosman; Pamela C.,9999,0,9999,0
1653413631978,ECE 200,006,091008,Staff,9999,0,9999,0
1653413631978,ECE 200,007,091009,Dayeh; Shadi Ahmad,9999,0,9999,0
1653413631978,ECE 200,008,091010,Fainman; Yeshaiahu,9999,0,9999,0
1653413631978,ECE 200,009,091011,Ford; Joseph Earl,9999,0,9999,0
1653413631978,ECE 200,010,091012,Franceschetti; Massimo,9999,0,9999,0
1653413631978,ECE 200,011,091013,Fullerton; Eric E,9999,0,9999,0
1653413631978,ECE 200,012,091014,Galton; Ian A,9999,0,9999,0
1653413631978,ECE 200,013,091015,Gilja; Vikash,9999,0,9999,0
1653413631978,ECE 200,014,091016,Hall; Drew A.,9999,0,9999,0
1653413631978,ECE 200,015,091017,Hsueh; Tzu-Chien,9999,0,9999,0
1653413631978,ECE 200,016,091018,Javidi; Tara,9999,0,9999,0
1653413631978,ECE 200,017,091019,Kahng; Andrew Byun,9999,0,9999,0
1653413631978,ECE 200,018,091020,Kim; Young-Han,9999,0,9999,0
1653413631978,ECE 200,019,091021,Koushanfar; Farinaz,9999,0,9999,0
1653413631978,ECE 200,020,091022,Kuzum; Duygu,9999,0,9999,0
1653413631978,ECE 200,021,091023,Le; Hanh-Phuc,9999,0,9999,0
1653413631978,ECE 200,022,091024,Lin; Bill,9999,0,9999,0
1653413631978,ECE 200,023,091025,Liu; Zhaowei,9999,0,9999,0
1653413631978,ECE 200,024,091026,Lo; Yu-Hwa,9999,0,9999,0
1653413631978,ECE 200,025,091027,Lomakin; Vitaliy,9999,0,9999,0
1653413631978,ECE 200,026,091028,Mercier; Patrick Philip,9999,0,9999,0
1653413631978,ECE 200,027,091029,Meyer; Florian,9999,0,9999,0
1653413631978,ECE 200,028,091030,Milstein; Laurence B.,9999,0,9999,0
1653413631978,ECE 200,029,091031,Mir Arabbaygi; Siavash,9999,0,9999,0
1653413631978,ECE 200,030,091032,Mookherjea; Shayan,9999,0,9999,0
1653413631978,ECE 200,031,091033,Morris; Karcher William,9999,0,9999,0
1653413631978,ECE 200,032,091034,Ng; Tse Nga,9999,0,9999,0
1653413631978,ECE 200,033,091035,Nguyen; Truong Quang,9999,0,9999,0
1653413631978,ECE 200,034,091036,Nomura; Kenji,9999,0,9999,0
1653413631978,ECE 200,035,091037,Orlitsky; Alon,9999,0,9999,0
1653413631978,ECE 200,036,091038,Pal; Piya,9999,0,9999,0
1653413631978,ECE 200,037,091039,Papen; George C.,9999,0,9999,0
1653413631978,ECE 200,038,091040,Radic; Stojan,9999,0,9999,0
1653413631978,ECE 200,039,091041,Rao; Bhaskar D.,9999,0,9999,0
1653413631978,ECE 200,040,091042,Rao; Ramesh R,9999,0,9999,0
1653413631978,ECE 200,041,091043,Rebeiz; Gabriel,9999,0,9999,0
1653413631978,ECE 200,042,091044,Sanford; John R,9999,0,9999,0
1653413631978,ECE 200,043,091045,Siegel; Paul H.,9999,0,9999,0
1653413631978,ECE 200,044,091046,Sievenpiper; Daniel F.,9999,0,9999,0
1653413631978,ECE 200,045,091047,Sworder; David D.,9999,0,9999,0
1653413631978,ECE 200,046,091048,Taur; Yuan,9999,0,9999,0
1653413631978,ECE 200,047,091049,Touri; Behrouz,9999,0,9999,0
1653413631978,ECE 200,048,091050,Trivedi; Mohan M.,9999,0,9999,0
1653413631978,ECE 200,049,091051,Vardy; Alexander,9999,0,9999,0
1653413631978,ECE 200,050,091052,Vasconcelos; Nuno,9999,0,9999,0
1653413631978,ECE 200,051,091053,Wang; Xiaolong,9999,0,9999,0
1653413631978,ECE 200,052,091054,Xie; Pengtao,9999,0,9999,0
1653413631978,ECE 200,053,091055,Yip; Michael,9999,0,9999,0
1653413631978,ECE 200,054,091056,Zeger; Kenneth A.,9999,0,9999,0
1653413631978,ECE 200,055,091057,Zhang; Xinyu,9999,0,9999,0
1653413631978,ECE 200,056,091058,Turakhia; Yatish Girish,9999,0,9999,0
1653413631978,ECE 200,057,091059,Kang; Mingu,9999,0,9999,0
1653413631978,ECE 200,058,091060,Shi; Yuanyuan,9999,0,9999,0
1653413631978,ECE 200,059,091061,Wang; Edward Jay,9999,0,9999,0
1653413631978,ECE 200,060,091062,Zheng; Yang,9999,0,9999,0
1653413632512,ECE 203,A00,091065,Mercier; Patrick Philip,0,0,0,0
1653413633037,ECE 207A,A00,091605,Liu; Thomas Tao-Ming,0,0,0,0
1653413633561,ECE 212AN,A00,091068,Nomura; Kenji,0,0,0,0
1653413634081,ECE 222A,A00,091069,Rebeiz; Gabriel,0,0,0,0
1653413634606,ECE 225A,A00,091070,Orlitsky; Alon,0,0,0,0
1653413635130,ECE 230A,A00,091071,Nomura; Kenji,0,0,0,0
1653413635661,ECE 236A,A00,091072,Dayeh; Shadi Ahmad,0,0,0,0
1653413636184,ECE 238A,A00,091073,Luo; Jian,0,0,0,0
1653413636184,ECE 238A,B00,091074,Luo; Jian,0,0,0,0
1653413636715,ECE 240A,A00,091075,Radic; Stojan,0,0,0,0
1653413637249,ECE 247A,A00,091592,Shi; Lingyan,0,0,0,0
1653413637870,ECE 250,A00,091076,Touri; Behrouz,0,0,0,0
1653413638392,ECE 251C,A00,091078,Nguyen; Truong Quang,0,0,0,0
1653413638931,ECE 253,A00,091079,Cosman; Pamela C.,0,0,0,0
1653413639453,ECE 255A,A00,091080,Orlitsky; Alon,0,0,0,0
1653413639974,ECE 257A,A00,091081,Zhang; Xinyu,0,0,0,0
1653413640501,ECE 260A,A01,091084,Eldon; John,0,0,0,0
1653413641031,ECE 264C,A00,091085,Galton; Ian A,0,0,0,0
1653413641554,ECE 265C,A00,094889,Presti; Calogero Davide,0,0,0,9
1653413642095,ECE 266,A01,091087,Hall; Drew A.,0,0,0,0
1653413643148,ECE 271A,A00,091090,Vasconcelos; Nuno,0,0,0,0
1653413643672,ECE 272B,A00,091091,Sworder; David D.,0,0,0,0
1653413644198,ECE 275A,A00,091092,Meyer; Florian,0,0,0,0
1653413644734,ECE 277,A00,091093,An; Cheolhong,0,0,0,0
1653413645269,ECE 283,A00,091094,Le; Hanh-Phuc,0,0,0,0
1653413645800,ECE 284,A00,091095,Kang; Mingu,0,0,0,0
1653413645800,ECE 284,B00,091096,Wang; Edward Jay,0,0,0,0
1653413646325,ECE 285,A00,094334,Touri; Behrouz,0,0,0,0
1653413646861,ECE 289,A00,091097,Whelan; David Arthur,0,0,0,0
1653413647401,MATH 200A,A00,087414,Salehi Golsefidy; Alireza,7,0,8,1
1653413647933,MATH 202A,A00,087415,Gill; Philip E.,3,0,8,5
1653413648485,MATH 203A,A00,087416,Oprea; Dragos N.,6,0,8,2
1653413649011,MATH 204A,A00,087417,Kedlaya; Kiran S.,6,0,8,2
1653413649537,MATH 205,A00,087418,Sorensen; Claus M,6,0,8,2
1653413650059,MATH 206A,A00,087419,Izadi; Elham,7,0,8,1
1653413650581,MATH 207A,A00,087420,Mohammadi; Amir,6,0,8,2
1653413651106,MATH 208,A00,087421,Staff,9,0,10,1
1653413651628,MATH 209,A00,087422,Staff,10,0,10,0
1653413652162,MATH 218,A00,087423,Staff,10,0,10,0
1653413652692,MATH 220A,A00,087424,Novak; Jonathan I,7,0,8,1
1653413653221,MATH 231A,A00,087425,Bejenaru; Ioan,4,0,8,4
1653413653748,MATH 240A,A00,087426,Ebenfelt; Peter F,5,0,8,3
1653413654271,MATH 243,A00,087427,Staff,9,0,10,1
1653413654796,MATH 248,A00,087429,Staff,10,0,10,0
1653413655317,MATH 250A,A00,087430,Spolaor; Luca,5,0,8,3
1653413655846,MATH 257A,A00,087431,Spolaor; Luca,7,0,8,1
1653413656371,MATH 258,A00,087432,Staff,9,0,10,1
1653413656894,MATH 264A,A00,087433,Warnke; Lutz Peter,5,0,8,3
1653413657423,MATH 268,A00,087434,Staff,15,0,15,0
1653413657949,MATH 269,A00,087435,Staff,14,0,15,1
1653413658471,MATH 270A,A00,087436,Nie; Jiawang,0,0,8,8
1653413658999,MATH 272A,A00,087437,Tian; Xiaochuan,2,0,8,6
1653413659535,MATH 274,A01,087439,Cheng; Li-Tien,9,0,10,1
1653413659535,MATH 274,A02,087440,Cheng; Li-Tien,10,0,10,0
1653413660067,MATH 278A,A00,087441,Staff,8,0,10,2
1653413660590,MATH 278B,A00,087442,Staff,8,0,10,2
1653413661120,MATH 278C,A00,087443,Staff,8,0,10,2
1653413661650,MATH 280A,A00,087444,Zheng; Tianyi,0,0,8,8
1653413662177,MATH 281A,A00,087445,Bradic; Jelena,0,0,8,8
1653413662718,MATH 282A,A00,087446,Zhang; Danna,0,0,8,8
1653413663243,MATH 283,A00,087447,Tesler; Glenn,0,0,0,14
1653413663773,MATH 286,A00,087448,Kemp; Todd Aahron,6,0,8,2
1653413664309,MATH 287D,A00,087449,Bradic; Jelena,8,0,8,0
1653413664841,MATH 288,A00,087450,Staff,14,0,15,1
1653413664841,MATH 288,B00,087451,Staff,15,0,15,0
1653413664841,MATH 288,C00,087452,Staff,15,0,15,0
1653413665364,MATH 290A,A00,087453,Xu; Zhouli,7,0,8,1
1653413665887,MATH 291A,A00,087454,Xu; Zhouli,7,0,8,1
1653413666409,MATH 292,A00,087455,Staff,10,0,10,0
1653413666933,MATH 295,A00,087456,Staff,50,0,50,0
1653413667457,MATH 297,001,087457,Staff,998,0,999,1
1653414230330,COGS 200,A01,087991,Staff,48,0,50,2
1653414230858,COGS 201,A01,094504,Rangel; Lara M,17,0,25,8
1653414231394,COGS 203,A00,087992,Coulson; Seana M,19,0,20,1
1653414231927,COGS 210A,001,087993,Greene; Deanna Jacquelyn,9998,0,9999,1
1653414231927,COGS 210A,002,087994,Saygin; Ayse P,9999,0,9999,0
1653414231927,COGS 210A,003,087995,Xia; Haijun,9999,0,9999,0
1653414231927,COGS 210A,004,087996,Nitz; Douglas A.,9999,0,9999,0
1653414231927,COGS 210A,005,087997,Hollan; James D.,9999,0,9999,0
1653414231927,COGS 210A,006,087998,Deak; Gedeon O.,9998,0,9999,1
1653414231927,COGS 210A,007,087999,Rossano; Federico,9999,0,9999,0
1653414232455,COGS 211A,A00,088000,Coulson; Seana M,9997,0,9999,2
1653414232977,COGS 229,A00,088002,Staff,23,0,25,2
1653414233498,COGS 260,B00,094231,Staff,17,0,20,3
1653414233498,COGS 260,A00,088004,Nitz; Douglas A.,9998,0,9999,1
1653414234031,CSE 202,A00,090110,Paturi; Ramamohan,0,0,0,0
1653414234031,CSE 202,B00,090111,Paturi; Ramamohan,0,0,0,0
1653414234581,CSE 207B,A00,090112,Heninger; Nadia A,0,0,0,0
1653414235108,CSE 208,A00,094858,Micciancio; Daniele,0,0,0,0
1653414235651,CSE 210,A00,090113,Powell; Thomas Allan,0,0,0,0
1653414236175,CSE 219,A00,090898,Staff,0,0,0,0
1653414236708,CSE 221,A00,090114,Zhou; Yuan-Yuan,0,0,0,0
1653414237244,CSE 229A,A00,090115,Porter; George M,0,0,0,0
1653414237769,CSE 229C,A00,090116,Savage; Stefan,0,0,0,0
1653414238300,CSE 230,A00,090117,Jhala; Ranjit,0,0,0,0
1653414238832,CSE 232,A00,090118,Papakonstantinou; Yannis,0,0,0,0
1653414239355,CSE 239A,A00,090121,Kumar; Arun Kumar,0,0,0,0
1653414239881,CSE 239B,A00,090122,Jhala; Ranjit,0,0,0,0
1653414240406,CSE 240A,A00,090123,Zhao; Jishen,0,0,189,189
1653414240931,CSE 243A,A00,090124,Orailoglu; Alex,3,0,15,12
1653414241460,CSE 249B,A00,090125,Kahng; Andrew Byun,13,0,20,7
1653414241985,CSE 250A,A00,090126,Berg-Kirkpatrick; Taylor D,0,0,0,0
1653414242522,CSE 252A,A00,090127,Ochoa; Benjamin Lawrence,0,0,0,0
1653414243057,CSE 258,A01,090129,McAuley; Julian John,0,0,0,0
1653414243582,CSE 258R,A01,090131,McAuley; Julian John,0,0,0,0
1653414244107,CSE 274,A00,090132,Ramamoorthi; Ravi,0,0,0,0
1653414244639,CSE 276A,A00,090133,Christensen; Henrik I,0,0,0,0
1653414245173,CSE 276C,A00,090134,Christensen; Henrik I,0,0,0,0
1653414245695,CSE 290,A00,090135,Bafna; Vineet,0,0,0,0
1653414245695,CSE 290,B00,090136,Ramamoorthi; Ravi,0,0,0,0
1653414245695,CSE 290,C00,090137,Li; Tzumao,10,0,10,0
1653414245695,CSE 290,D00,090138,Zhou; Yuan-Yuan,10,0,10,0
1653414245695,CSE 290,E00,090139,Christensen; Henrik I,10,0,10,0
1653414245695,CSE 290,F00,094053,Shalev; Aaron D,0,0,0,0
1653414246224,CSE 291,A00,090140,Munyaka; Imani N. S.,0,0,0,0
1653414246224,CSE 291,B00,094880,Yu; Qi,0,0,0,0
1653414246224,CSE 291,C00,090142,Pannuto; Patrick William,0,0,0,0
1653414246224,CSE 291,D00,094881,Zhang; Yiying,0,0,0,0
1653414246224,CSE 291,E00,095118,Su; Hao,0,0,0,0
1653414246769,CSE 293,001,094905,Bafna; Vineet,9999,0,9999,0
1653414246769,CSE 293,002,094906,Bellare; Mihir,9999,0,9999,0
1653414246769,CSE 293,003,094907,Berg-Kirkpatrick; Taylor D,9999,0,9999,0
1653414246769,CSE 293,004,094908,Christensen; Henrik I,9999,0,9999,0
1653414246769,CSE 293,005,094909,Cottrell; Garrison W,9999,0,9999,0
1653414246769,CSE 293,006,094910,Deutsch; Alin Bernard,9999,0,9999,0
1653414246769,CSE 293,007,094911,Esmaeilzadeh; Hadi,9999,0,9999,0
1653414246769,CSE 293,008,094912,Freund; Yoav,9999,0,9999,0
1653414246769,CSE 293,009,094913,Griswold; William G.,9999,0,9999,0
1653414246769,CSE 293,010,094914,Gymrek; Melissa Ann,9999,0,9999,0
1653414246769,CSE 293,011,094915,Heninger; Nadia A,9999,0,9999,0
1653414246769,CSE 293,012,094916,Impagliazzo; Russell,9999,0,9999,0
1653414246769,CSE 293,013,094917,Jhala; Ranjit,9999,0,9999,0
1653414246769,CSE 293,014,094918,Kahng; Andrew Byun,9999,0,9999,0
1653414246769,CSE 293,015,094919,Kane; Daniel Mertz,9999,0,9999,0
1653414246769,CSE 293,016,094920,Kriegman; David J,9999,0,9999,0
1653414246769,CSE 293,017,094921,Kumar; Arun Kumar,9999,0,9999,0
1653414246769,CSE 293,018,094922,Lerner; Sorin,9999,0,9999,0
1653414246769,CSE 293,019,094923,Lovett; Shachar,9999,0,9999,0
1653414246769,CSE 293,020,094924,McAuley; Julian John,9999,0,9999,0
1653414246769,CSE 293,021,094925,Micciancio; Daniele,9999,0,9999,0
1653414246769,CSE 293,022,094926,Orailoglu; Alex,9999,0,9999,0
1653414246769,CSE 293,023,094927,Paturi; Ramamohan,9999,0,9999,0
1653414246769,CSE 293,024,094928,Polikarpova; Nadezhda,9999,0,9999,0
1653414246769,CSE 293,025,094929,Politz; Joseph Gibbs,9999,0,9999,0
1653414246769,CSE 293,026,094930,Porter; George M,9999,0,9999,0
1653414246769,CSE 293,027,094931,Porter; Leonard Emerson,9999,0,9999,0
1653414246769,CSE 293,028,094932,Ramamoorthi; Ravi,9999,0,9999,0
1653414246769,CSE 293,029,094933,Sahoo; Debashis,9999,0,9999,0
1653414246769,CSE 293,030,094934,Saul; Lawrence,9999,0,9999,0
1653414246769,CSE 293,031,094935,Savage; Stefan,9999,0,9999,0
1653414246769,CSE 293,032,094936,Schulze; Jurgen P.,9999,0,9999,0
1653414246769,CSE 293,033,094937,Snoeren; Alex C.,9999,0,9999,0
1653414246769,CSE 293,034,094938,Shang; Jingbo,9999,0,9999,0
1653414246769,CSE 293,035,094939,Stefan; Deian,9999,0,9999,0
1653414246769,CSE 293,036,094940,Su; Hao,9999,0,9999,0
1653414246769,CSE 293,037,094941,Swanson; Steven James,9999,0,9999,0
1653414246769,CSE 293,038,094942,Tullsen; Dean Michael,9999,0,9999,0
1653414246769,CSE 293,039,094943,Voelker; Geoffrey M.,9999,0,9999,0
1653414246769,CSE 293,040,094944,Zhao; Jishen,9999,0,9999,0
1653414246769,CSE 293,041,094945,Zhou; Yuan-Yuan,9999,0,9999,0
1653414246769,CSE 293,042,094946,Gao; Sicun,9998,0,9999,1
1653414246769,CSE 293,043,094947,Weibel; Nadir,9999,0,9999,0
1653414246769,CSE 293,044,094948,Gupta; Rajesh K.,9999,0,9999,0
1653414247301,CSE 294,A00,090143,Porter; George M,9,0,10,1
1653414247838,DSE 200,A00,091799,Staff,50,0,50,0
1653414248366,DSE 203,A00,091800,Gupta; Amarnath,30,0,30,0
1653414248893,DSE 250,A00,091801,Deutsch; Alin Bernard,30,0,30,0
1653414249421,DSE 290,A00,091802,Altintas De Callaf; Ilkay,50,0,50,0
1653414249965,ECE 200,001,091003,Antipa; Nicholas A,9999,0,9999,0
1653414249965,ECE 200,002,091004,Atanasov; Nikolay A.,9999,0,9999,0
1653414249965,ECE 200,003,091005,Bharadia; Dinesh,9999,0,9999,0
1653414249965,ECE 200,004,091006,Cheng; Chung Kuan,9999,0,9999,0
1653414249965,ECE 200,005,091007,Cosman; Pamela C.,9999,0,9999,0
1653414249965,ECE 200,006,091008,Staff,9999,0,9999,0
1653414249965,ECE 200,007,091009,Dayeh; Shadi Ahmad,9999,0,9999,0
1653414249965,ECE 200,008,091010,Fainman; Yeshaiahu,9999,0,9999,0
1653414249965,ECE 200,009,091011,Ford; Joseph Earl,9999,0,9999,0
1653414249965,ECE 200,010,091012,Franceschetti; Massimo,9999,0,9999,0
1653414249965,ECE 200,011,091013,Fullerton; Eric E,9999,0,9999,0
1653414249965,ECE 200,012,091014,Galton; Ian A,9999,0,9999,0
1653414249965,ECE 200,013,091015,Gilja; Vikash,9999,0,9999,0
1653414249965,ECE 200,014,091016,Hall; Drew A.,9999,0,9999,0
1653414249965,ECE 200,015,091017,Hsueh; Tzu-Chien,9999,0,9999,0
1653414249965,ECE 200,016,091018,Javidi; Tara,9999,0,9999,0
1653414249965,ECE 200,017,091019,Kahng; Andrew Byun,9999,0,9999,0
1653414249965,ECE 200,018,091020,Kim; Young-Han,9999,0,9999,0
1653414249965,ECE 200,019,091021,Koushanfar; Farinaz,9999,0,9999,0
1653414249965,ECE 200,020,091022,Kuzum; Duygu,9999,0,9999,0
1653414249965,ECE 200,021,091023,Le; Hanh-Phuc,9999,0,9999,0
1653414249965,ECE 200,022,091024,Lin; Bill,9999,0,9999,0
1653414249965,ECE 200,023,091025,Liu; Zhaowei,9999,0,9999,0
1653414249965,ECE 200,024,091026,Lo; Yu-Hwa,9999,0,9999,0
1653414249965,ECE 200,025,091027,Lomakin; Vitaliy,9999,0,9999,0
1653414249965,ECE 200,026,091028,Mercier; Patrick Philip,9999,0,9999,0
1653414249965,ECE 200,027,091029,Meyer; Florian,9999,0,9999,0
1653414249965,ECE 200,028,091030,Milstein; Laurence B.,9999,0,9999,0
1653414249965,ECE 200,029,091031,Mir Arabbaygi; Siavash,9999,0,9999,0
1653414249965,ECE 200,030,091032,Mookherjea; Shayan,9999,0,9999,0
1653414249965,ECE 200,031,091033,Morris; Karcher William,9999,0,9999,0
1653414249965,ECE 200,032,091034,Ng; Tse Nga,9999,0,9999,0
1653414249965,ECE 200,033,091035,Nguyen; Truong Quang,9999,0,9999,0
1653414249965,ECE 200,034,091036,Nomura; Kenji,9999,0,9999,0
1653414249965,ECE 200,035,091037,Orlitsky; Alon,9999,0,9999,0
1653414249965,ECE 200,036,091038,Pal; Piya,9999,0,9999,0
1653414249965,ECE 200,037,091039,Papen; George C.,9999,0,9999,0
1653414249965,ECE 200,038,091040,Radic; Stojan,9999,0,9999,0
1653414249965,ECE 200,039,091041,Rao; Bhaskar D.,9999,0,9999,0
1653414249965,ECE 200,040,091042,Rao; Ramesh R,9999,0,9999,0
1653414249965,ECE 200,041,091043,Rebeiz; Gabriel,9999,0,9999,0
1653414249965,ECE 200,042,091044,Sanford; John R,9999,0,9999,0
1653414249965,ECE 200,043,091045,Siegel; Paul H.,9999,0,9999,0
1653414249965,ECE 200,044,091046,Sievenpiper; Daniel F.,9999,0,9999,0
1653414249965,ECE 200,045,091047,Sworder; David D.,9999,0,9999,0
1653414249965,ECE 200,046,091048,Taur; Yuan,9999,0,9999,0
1653414249965,ECE 200,047,091049,Touri; Behrouz,9999,0,9999,0
1653414249965,ECE 200,048,091050,Trivedi; Mohan M.,9999,0,9999,0
1653414249965,ECE 200,049,091051,Vardy; Alexander,9999,0,9999,0
1653414249965,ECE 200,050,091052,Vasconcelos; Nuno,9999,0,9999,0
1653414249965,ECE 200,051,091053,Wang; Xiaolong,9999,0,9999,0
1653414249965,ECE 200,052,091054,Xie; Pengtao,9999,0,9999,0
1653414249965,ECE 200,053,091055,Yip; Michael,9999,0,9999,0
1653414249965,ECE 200,054,091056,Zeger; Kenneth A.,9999,0,9999,0
1653414249965,ECE 200,055,091057,Zhang; Xinyu,9999,0,9999,0
1653414249965,ECE 200,056,091058,Turakhia; Yatish Girish,9999,0,9999,0
1653414249965,ECE 200,057,091059,Kang; Mingu,9999,0,9999,0
1653414249965,ECE 200,058,091060,Shi; Yuanyuan,9999,0,9999,0
1653414249965,ECE 200,059,091061,Wang; Edward Jay,9999,0,9999,0
1653414249965,ECE 200,060,091062,Zheng; Yang,9999,0,9999,0
1653414250489,ECE 203,A00,091065,Mercier; Patrick Philip,0,0,0,0
1653414251011,ECE 207A,A00,091605,Liu; Thomas Tao-Ming,0,0,0,0
1653414251536,ECE 212AN,A00,091068,Nomura; Kenji,0,0,0,0
1653414252061,ECE 222A,A00,091069,Rebeiz; Gabriel,0,0,0,0
1653414252586,ECE 225A,A00,091070,Orlitsky; Alon,0,0,0,0
1653414253110,ECE 230A,A00,091071,Nomura; Kenji,0,0,0,0
1653414253637,ECE 236A,A00,091072,Dayeh; Shadi Ahmad,0,0,0,0
1653414254169,ECE 238A,A00,091073,Luo; Jian,0,0,0,0
1653414254169,ECE 238A,B00,091074,Luo; Jian,0,0,0,0
1653414254697,ECE 240A,A00,091075,Radic; Stojan,0,0,0,0
1653414255234,ECE 247A,A00,091592,Shi; Lingyan,0,0,0,0
1653414255761,ECE 250,A00,091076,Touri; Behrouz,0,0,0,0
1653414256295,ECE 251C,A00,091078,Nguyen; Truong Quang,0,0,0,0
1653414256821,ECE 253,A00,091079,Cosman; Pamela C.,0,0,0,0
1653414257345,ECE 255A,A00,091080,Orlitsky; Alon,0,0,0,0
1653414257872,ECE 257A,A00,091081,Zhang; Xinyu,0,0,0,0
1653414258400,ECE 260A,A01,091084,Eldon; John,0,0,0,0
1653414258926,ECE 264C,A00,091085,Galton; Ian A,0,0,0,0
1653414259452,ECE 265C,A00,094889,Presti; Calogero Davide,0,0,0,9
1653414259989,ECE 266,A01,091087,Hall; Drew A.,0,0,0,0
1653414261035,ECE 271A,A00,091090,Vasconcelos; Nuno,0,0,0,0
1653414261567,ECE 272B,A00,091091,Sworder; David D.,0,0,0,0
1653414262091,ECE 275A,A00,091092,Meyer; Florian,0,0,0,0
1653414262625,ECE 277,A00,091093,An; Cheolhong,0,0,0,0
1653414263146,ECE 283,A00,091094,Le; Hanh-Phuc,0,0,0,0
1653414263670,ECE 284,A00,091095,Kang; Mingu,0,0,0,0
1653414263670,ECE 284,B00,091096,Wang; Edward Jay,0,0,0,0
1653414264207,ECE 285,A00,094334,Touri; Behrouz,0,0,0,0
1653414264733,ECE 289,A00,091097,Whelan; David Arthur,0,0,0,0
1653414265270,MATH 200A,A00,087414,Salehi Golsefidy; Alireza,7,0,8,1
1653414265793,MATH 202A,A00,087415,Gill; Philip E.,3,0,8,5
1653414266315,MATH 203A,A00,087416,Oprea; Dragos N.,6,0,8,2
1653414266836,MATH 204A,A00,087417,Kedlaya; Kiran S.,6,0,8,2
1653414267360,MATH 205,A00,087418,Sorensen; Claus M,6,0,8,2
1653414267885,MATH 206A,A00,087419,Izadi; Elham,7,0,8,1
1653414268407,MATH 207A,A00,087420,Mohammadi; Amir,6,0,8,2
1653414268936,MATH 208,A00,087421,Staff,9,0,10,1
1653414269466,MATH 209,A00,087422,Staff,10,0,10,0
1653414270011,MATH 218,A00,087423,Staff,10,0,10,0
1653414270541,MATH 220A,A00,087424,Novak; Jonathan I,7,0,8,1
1653414271077,MATH 231A,A00,087425,Bejenaru; Ioan,4,0,8,4
1653414271598,MATH 240A,A00,087426,Ebenfelt; Peter F,5,0,8,3
1653414272119,MATH 243,A00,087427,Staff,9,0,10,1
1653414272642,MATH 248,A00,087429,Staff,10,0,10,0
1653414273167,MATH 250A,A00,087430,Spolaor; Luca,5,0,8,3
1653414273692,MATH 257A,A00,087431,Spolaor; Luca,7,0,8,1
1653414274214,MATH 258,A00,087432,Staff,9,0,10,1
1653414274743,MATH 264A,A00,087433,Warnke; Lutz Peter,5,0,8,3
1653414275267,MATH 268,A00,087434,Staff,15,0,15,0
1653414275790,MATH 269,A00,087435,Staff,14,0,15,1
1653414276320,MATH 270A,A00,087436,Nie; Jiawang,0,0,8,8
1653414276843,MATH 272A,A00,087437,Tian; Xiaochuan,2,0,8,6
1653414277365,MATH 274,A01,087439,Cheng; Li-Tien,9,0,10,1
1653414277365,MATH 274,A02,087440,Cheng; Li-Tien,10,0,10,0
1653414277891,MATH 278A,A00,087441,Staff,8,0,10,2
1653414278416,MATH 278B,A00,087442,Staff,8,0,10,2
1653414278949,MATH 278C,A00,087443,Staff,8,0,10,2
1653414279472,MATH 280A,A00,087444,Zheng; Tianyi,0,0,8,8
1653414280014,MATH 281A,A00,087445,Bradic; Jelena,0,0,8,8
1653414280546,MATH 282A,A00,087446,Zhang; Danna,0,0,8,8
1653414281069,MATH 283,A00,087447,Tesler; Glenn,0,0,0,14
1653414281704,MATH 286,A00,087448,Kemp; Todd Aahron,6,0,8,2
1653414282226,MATH 287D,A00,087449,Bradic; Jelena,8,0,8,0
1653414282751,MATH 288,A00,087450,Staff,14,0,15,1
1653414282751,MATH 288,B00,087451,Staff,15,0,15,0
1653414282751,MATH 288,C00,087452,Staff,15,0,15,0
1653414283277,MATH 290A,A00,087453,Xu; Zhouli,7,0,8,1
1653414283800,MATH 291A,A00,087454,Xu; Zhouli,7,0,8,1
1653414284321,MATH 292,A00,087455,Staff,10,0,10,0
1653414284847,MATH 295,A00,087456,Staff,50,0,50,0
1653414285395,MATH 297,001,087457,Staff,998,0,999,1
1653414858006,COGS 200,A01,087991,Staff,48,0,50,2
1653414858538,COGS 201,A01,094504,Rangel; Lara M,17,0,25,8
1653414859063,COGS 203,A00,087992,Coulson; Seana M,19,0,20,1
1653414859588,COGS 210A,001,087993,Greene; Deanna Jacquelyn,9998,0,9999,1
1653414859588,COGS 210A,002,087994,Saygin; Ayse P,9999,0,9999,0
1653414859588,COGS 210A,003,087995,Xia; Haijun,9999,0,9999,0
1653414859588,COGS 210A,004,087996,Nitz; Douglas A.,9999,0,9999,0
1653414859588,COGS 210A,005,087997,Hollan; James D.,9999,0,9999,0
1653414859588,COGS 210A,006,087998,Deak; Gedeon O.,9998,0,9999,1
1653414859588,COGS 210A,007,087999,Rossano; Federico,9999,0,9999,0
1653414860118,COGS 211A,A00,088000,Coulson; Seana M,9997,0,9999,2
1653414860640,COGS 229,A00,088002,Staff,23,0,25,2
1653414861164,COGS 260,B00,094231,Staff,17,0,20,3
1653414861164,COGS 260,A00,088004,Nitz; Douglas A.,9998,0,9999,1
1653414861705,CSE 202,A00,090110,Paturi; Ramamohan,0,0,0,0
1653414861705,CSE 202,B00,090111,Paturi; Ramamohan,0,0,0,0
1653414862228,CSE 207B,A00,090112,Heninger; Nadia A,0,0,0,0
1653414862752,CSE 208,A00,094858,Micciancio; Daniele,0,0,0,0
1653414863276,CSE 210,A00,090113,Powell; Thomas Allan,0,0,0,0
1653414863801,CSE 219,A00,090898,Staff,0,0,0,0
1653414864325,CSE 221,A00,090114,Zhou; Yuan-Yuan,0,0,0,0
1653414864856,CSE 229A,A00,090115,Porter; George M,0,0,0,0
1653414865383,CSE 229C,A00,090116,Savage; Stefan,0,0,0,0
1653414865908,CSE 230,A00,090117,Jhala; Ranjit,0,0,0,0
1653414866441,CSE 232,A00,090118,Papakonstantinou; Yannis,0,0,0,0
1653414866963,CSE 239A,A00,090121,Kumar; Arun Kumar,0,0,0,0
1653414867491,CSE 239B,A00,090122,Jhala; Ranjit,0,0,0,0
1653414868014,CSE 240A,A00,090123,Zhao; Jishen,0,0,189,189
1653414868539,CSE 243A,A00,090124,Orailoglu; Alex,3,0,15,12
1653414869065,CSE 249B,A00,090125,Kahng; Andrew Byun,13,0,20,7
1653414869590,CSE 250A,A00,090126,Berg-Kirkpatrick; Taylor D,0,0,0,0
1653414870113,CSE 252A,A00,090127,Ochoa; Benjamin Lawrence,0,0,0,0
1653414870649,CSE 258,A01,090129,McAuley; Julian John,0,0,0,0
1653414871171,CSE 258R,A01,090131,McAuley; Julian John,0,0,0,0
1653414871696,CSE 274,A00,090132,Ramamoorthi; Ravi,0,0,0,0
1653414872218,CSE 276A,A00,090133,Christensen; Henrik I,0,0,0,0
1653414872757,CSE 276C,A00,090134,Christensen; Henrik I,0,0,0,0
1653414873289,CSE 290,A00,090135,Bafna; Vineet,0,0,0,0
1653414873289,CSE 290,B00,090136,Ramamoorthi; Ravi,0,0,0,0
1653414873289,CSE 290,C00,090137,Li; Tzumao,10,0,10,0
1653414873289,CSE 290,D00,090138,Zhou; Yuan-Yuan,10,0,10,0
1653414873289,CSE 290,E00,090139,Christensen; Henrik I,10,0,10,0
1653414873289,CSE 290,F00,094053,Shalev; Aaron D,0,0,0,0
1653414873813,CSE 291,A00,090140,Munyaka; Imani N. S.,0,0,0,0
1653414873813,CSE 291,B00,094880,Yu; Qi,0,0,0,0
1653414873813,CSE 291,C00,090142,Pannuto; Patrick William,0,0,0,0
1653414873813,CSE 291,D00,094881,Zhang; Yiying,0,0,0,0
1653414873813,CSE 291,E00,095118,Su; Hao,0,0,0,0
1653414874362,CSE 293,001,094905,Bafna; Vineet,9999,0,9999,0
1653414874362,CSE 293,002,094906,Bellare; Mihir,9999,0,9999,0
1653414874362,CSE 293,003,094907,Berg-Kirkpatrick; Taylor D,9999,0,9999,0
1653414874362,CSE 293,004,094908,Christensen; Henrik I,9999,0,9999,0
1653414874362,CSE 293,005,094909,Cottrell; Garrison W,9999,0,9999,0
1653414874362,CSE 293,006,094910,Deutsch; Alin Bernard,9999,0,9999,0
1653414874362,CSE 293,007,094911,Esmaeilzadeh; Hadi,9999,0,9999,0
1653414874362,CSE 293,008,094912,Freund; Yoav,9999,0,9999,0
1653414874362,CSE 293,009,094913,Griswold; William G.,9999,0,9999,0
1653414874362,CSE 293,010,094914,Gymrek; Melissa Ann,9999,0,9999,0
1653414874362,CSE 293,011,094915,Heninger; Nadia A,9999,0,9999,0
1653414874362,CSE 293,012,094916,Impagliazzo; Russell,9999,0,9999,0
1653414874362,CSE 293,013,094917,Jhala; Ranjit,9999,0,9999,0
1653414874362,CSE 293,014,094918,Kahng; Andrew Byun,9999,0,9999,0
1653414874362,CSE 293,015,094919,Kane; Daniel Mertz,9999,0,9999,0
1653414874362,CSE 293,016,094920,Kriegman; David J,9999,0,9999,0
1653414874362,CSE 293,017,094921,Kumar; Arun Kumar,9999,0,9999,0
1653414874362,CSE 293,018,094922,Lerner; Sorin,9999,0,9999,0
1653414874362,CSE 293,019,094923,Lovett; Shachar,9999,0,9999,0
1653414874362,CSE 293,020,094924,McAuley; Julian John,9999,0,9999,0
1653414874362,CSE 293,021,094925,Micciancio; Daniele,9999,0,9999,0
1653414874362,CSE 293,022,094926,Orailoglu; Alex,9999,0,9999,0
1653414874362,CSE 293,023,094927,Paturi; Ramamohan,9999,0,9999,0
1653414874362,CSE 293,024,094928,Polikarpova; Nadezhda,9999,0,9999,0
1653414874362,CSE 293,025,094929,Politz; Joseph Gibbs,9999,0,9999,0
1653414874362,CSE 293,026,094930,Porter; George M,9999,0,9999,0
1653414874362,CSE 293,027,094931,Porter; Leonard Emerson,9999,0,9999,0
1653414874362,CSE 293,028,094932,Ramamoorthi; Ravi,9999,0,9999,0
1653414874362,CSE 293,029,094933,Sahoo; Debashis,9999,0,9999,0
1653414874362,CSE 293,030,094934,Saul; Lawrence,9999,0,9999,0
1653414874362,CSE 293,031,094935,Savage; Stefan,9999,0,9999,0
1653414874362,CSE 293,032,094936,Schulze; Jurgen P.,9999,0,9999,0
1653414874362,CSE 293,033,094937,Snoeren; Alex C.,9999,0,9999,0
1653414874362,CSE 293,034,094938,Shang; Jingbo,9999,0,9999,0
1653414874362,CSE 293,035,094939,Stefan; Deian,9999,0,9999,0
1653414874362,CSE 293,036,094940,Su; Hao,9999,0,9999,0
1653414874362,CSE 293,037,094941,Swanson; Steven James,9999,0,9999,0
1653414874362,CSE 293,038,094942,Tullsen; Dean Michael,9999,0,9999,0
1653414874362,CSE 293,039,094943,Voelker; Geoffrey M.,9999,0,9999,0
1653414874362,CSE 293,040,094944,Zhao; Jishen,9999,0,9999,0
1653414874362,CSE 293,041,094945,Zhou; Yuan-Yuan,9999,0,9999,0
1653414874362,CSE 293,042,094946,Gao; Sicun,9998,0,9999,1
1653414874362,CSE 293,043,094947,Weibel; Nadir,9999,0,9999,0
1653414874362,CSE 293,044,094948,Gupta; Rajesh K.,9999,0,9999,0
1653414874887,CSE 294,A00,090143,Porter; George M,9,0,10,1
1653414875418,DSE 200,A00,091799,Staff,50,0,50,0
1653414875954,DSE 203,A00,091800,Gupta; Amarnath,30,0,30,0
1653414876489,DSE 250,A00,091801,Deutsch; Alin Bernard,30,0,30,0
1653414877027,DSE 290,A00,091802,Altintas De Callaf; Ilkay,50,0,50,0
1653414877572,ECE 200,001,091003,Antipa; Nicholas A,9999,0,9999,0
1653414877572,ECE 200,002,091004,Atanasov; Nikolay A.,9999,0,9999,0
1653414877572,ECE 200,003,091005,Bharadia; Dinesh,9999,0,9999,0
1653414877572,ECE 200,004,091006,Cheng; Chung Kuan,9999,0,9999,0
1653414877572,ECE 200,005,091007,Cosman; Pamela C.,9999,0,9999,0
1653414877572,ECE 200,006,091008,Staff,9999,0,9999,0
1653414877572,ECE 200,007,091009,Dayeh; Shadi Ahmad,9999,0,9999,0
1653414877572,ECE 200,008,091010,Fainman; Yeshaiahu,9999,0,9999,0
1653414877572,ECE 200,009,091011,Ford; Joseph Earl,9999,0,9999,0
1653414877572,ECE 200,010,091012,Franceschetti; Massimo,9999,0,9999,0
1653414877572,ECE 200,011,091013,Fullerton; Eric E,9999,0,9999,0
1653414877572,ECE 200,012,091014,Galton; Ian A,9999,0,9999,0
1653414877572,ECE 200,013,091015,Gilja; Vikash,9999,0,9999,0
1653414877572,ECE 200,014,091016,Hall; Drew A.,9999,0,9999,0
1653414877572,ECE 200,015,091017,Hsueh; Tzu-Chien,9999,0,9999,0
1653414877572,ECE 200,016,091018,Javidi; Tara,9999,0,9999,0
1653414877572,ECE 200,017,091019,Kahng; Andrew Byun,9999,0,9999,0
1653414877572,ECE 200,018,091020,Kim; Young-Han,9999,0,9999,0
1653414877572,ECE 200,019,091021,Koushanfar; Farinaz,9999,0,9999,0
1653414877572,ECE 200,020,091022,Kuzum; Duygu,9999,0,9999,0
1653414877572,ECE 200,021,091023,Le; Hanh-Phuc,9999,0,9999,0
1653414877572,ECE 200,022,091024,Lin; Bill,9999,0,9999,0
1653414877572,ECE 200,023,091025,Liu; Zhaowei,9999,0,9999,0
1653414877572,ECE 200,024,091026,Lo; Yu-Hwa,9999,0,9999,0
1653414877572,ECE 200,025,091027,Lomakin; Vitaliy,9999,0,9999,0
1653414877572,ECE 200,026,091028,Mercier; Patrick Philip,9999,0,9999,0
1653414877572,ECE 200,027,091029,Meyer; Florian,9999,0,9999,0
1653414877572,ECE 200,028,091030,Milstein; Laurence B.,9999,0,9999,0
1653414877572,ECE 200,029,091031,Mir Arabbaygi; Siavash,9999,0,9999,0
1653414877572,ECE 200,030,091032,Mookherjea; Shayan,9999,0,9999,0
1653414877572,ECE 200,031,091033,Morris; Karcher William,9999,0,9999,0
1653414877572,ECE 200,032,091034,Ng; Tse Nga,9999,0,9999,0
1653414877572,ECE 200,033,091035,Nguyen; Truong Quang,9999,0,9999,0
1653414877572,ECE 200,034,091036,Nomura; Kenji,9999,0,9999,0
1653414877572,ECE 200,035,091037,Orlitsky; Alon,9999,0,9999,0
1653414877572,ECE 200,036,091038,Pal; Piya,9999,0,9999,0
1653414877572,ECE 200,037,091039,Papen; George C.,9999,0,9999,0
1653414877572,ECE 200,038,091040,Radic; Stojan,9999,0,9999,0
1653414877572,ECE 200,039,091041,Rao; Bhaskar D.,9999,0,9999,0
1653414877572,ECE 200,040,091042,Rao; Ramesh R,9999,0,9999,0
1653414877572,ECE 200,041,091043,Rebeiz; Gabriel,9999,0,9999,0
1653414877572,ECE 200,042,091044,Sanford; John R,9999,0,9999,0
1653414877572,ECE 200,043,091045,Siegel; Paul H.,9999,0,9999,0
1653414877572,ECE 200,044,091046,Sievenpiper; Daniel F.,9999,0,9999,0
1653414877572,ECE 200,045,091047,Sworder; David D.,9999,0,9999,0
1653414877572,ECE 200,046,091048,Taur; Yuan,9999,0,9999,0
1653414877572,ECE 200,047,091049,Touri; Behrouz,9999,0,9999,0
1653414877572,ECE 200,048,091050,Trivedi; Mohan M.,9999,0,9999,0
1653414877572,ECE 200,049,091051,Vardy; Alexander,9999,0,9999,0
1653414877572,ECE 200,050,091052,Vasconcelos; Nuno,9999,0,9999,0
1653414877572,ECE 200,051,091053,Wang; Xiaolong,9999,0,9999,0
1653414877572,ECE 200,052,091054,Xie; Pengtao,9999,0,9999,0
1653414877572,ECE 200,053,091055,Yip; Michael,9999,0,9999,0
1653414877572,ECE 200,054,091056,Zeger; Kenneth A.,9999,0,9999,0
1653414877572,ECE 200,055,091057,Zhang; Xinyu,9999,0,9999,0
1653414877572,ECE 200,056,091058,Turakhia; Yatish Girish,9999,0,9999,0
1653414877572,ECE 200,057,091059,Kang; Mingu,9999,0,9999,0
1653414877572,ECE 200,058,091060,Shi; Yuanyuan,9999,0,9999,0
1653414877572,ECE 200,059,091061,Wang; Edward Jay,9999,0,9999,0
1653414877572,ECE 200,060,091062,Zheng; Yang,9999,0,9999,0
1653414878099,ECE 203,A00,091065,Mercier; Patrick Philip,0,0,0,0
1653414878623,ECE 207A,A00,091605,Liu; Thomas Tao-Ming,0,0,0,0
1653414879151,ECE 212AN,A00,091068,Nomura; Kenji,0,0,0,0
1653414879684,ECE 222A,A00,091069,Rebeiz; Gabriel,0,0,0,0
1653414880213,ECE 225A,A00,091070,Orlitsky; Alon,0,0,0,0
1653414880745,ECE 230A,A00,091071,Nomura; Kenji,0,0,0,0
1653414881271,ECE 236A,A00,091072,Dayeh; Shadi Ahmad,0,0,0,0
1653414881870,ECE 238A,A00,091073,Luo; Jian,0,0,0,0
1653414881870,ECE 238A,B00,091074,Luo; Jian,0,0,0,0
1653414882394,ECE 240A,A00,091075,Radic; Stojan,0,0,0,0
1653414882921,ECE 247A,A00,091592,Shi; Lingyan,0,0,0,0
1653414883444,ECE 250,A00,091076,Touri; Behrouz,0,0,0,0
1653414883967,ECE 251C,A00,091078,Nguyen; Truong Quang,0,0,0,0
1653414884499,ECE 253,A00,091079,Cosman; Pamela C.,0,0,0,0
1653414885029,ECE 255A,A00,091080,Orlitsky; Alon,0,0,0,0
1653414885553,ECE 257A,A00,091081,Zhang; Xinyu,0,0,0,0
1653414886079,ECE 260A,A01,091084,Eldon; John,0,0,0,0
1653414886606,ECE 264C,A00,091085,Galton; Ian A,0,0,0,0
1653414887128,ECE 265C,A00,094889,Presti; Calogero Davide,0,0,0,9
1653414887655,ECE 266,A01,091087,Hall; Drew A.,0,0,0,0
1653414888712,ECE 271A,A00,091090,Vasconcelos; Nuno,0,0,0,0
1653414889242,ECE 272B,A00,091091,Sworder; David D.,0,0,0,0
1653414889765,ECE 275A,A00,091092,Meyer; Florian,0,0,0,0
1653414890297,ECE 277,A00,091093,An; Cheolhong,0,0,0,0
1653414890825,ECE 283,A00,091094,Le; Hanh-Phuc,0,0,0,0
1653414891361,ECE 284,A00,091095,Kang; Mingu,0,0,0,0
1653414891361,ECE 284,B00,091096,Wang; Edward Jay,0,0,0,0
1653414891886,ECE 285,A00,094334,Touri; Behrouz,0,0,0,0
1653414892418,ECE 289,A00,091097,Whelan; David Arthur,0,0,0,0
1653414892943,MATH 200A,A00,087414,Salehi Golsefidy; Alireza,7,0,8,1
1653414893478,MATH 202A,A00,087415,Gill; Philip E.,3,0,8,5
1653414894005,MATH 203A,A00,087416,Oprea; Dragos N.,6,0,8,2
1653414894530,MATH 204A,A00,087417,Kedlaya; Kiran S.,6,0,8,2
1653414895052,MATH 205,A00,087418,Sorensen; Claus M,6,0,8,2
1653414895574,MATH 206A,A00,087419,Izadi; Elham,7,0,8,1
1653414896100,MATH 207A,A00,087420,Mohammadi; Amir,6,0,8,2
1653414896624,MATH 208,A00,087421,Staff,9,0,10,1
1653414897148,MATH 209,A00,087422,Staff,10,0,10,0
1653414897669,MATH 218,A00,087423,Staff,10,0,10,0
1653414898192,MATH 220A,A00,087424,Novak; Jonathan I,7,0,8,1
1653414898727,MATH 231A,A00,087425,Bejenaru; Ioan,4,0,8,4
1653414899251,MATH 240A,A00,087426,Ebenfelt; Peter F,5,0,8,3
1653414899773,MATH 243,A00,087427,Staff,9,0,10,1
1653414900298,MATH 248,A00,087429,Staff,10,0,10,0
1653414900821,MATH 250A,A00,087430,Spolaor; Luca,5,0,8,3
1653414901427,MATH 257A,A00,087431,Spolaor; Luca,7,0,8,1
1653414901963,MATH 258,A00,087432,Staff,9,0,10,1
1653414902490,MATH 264A,A00,087433,Warnke; Lutz Peter,5,0,8,3
1653414903017,MATH 268,A00,087434,Staff,15,0,15,0
1653414903549,MATH 269,A00,087435,Staff,14,0,15,1
1653414904071,MATH 270A,A00,087436,Nie; Jiawang,0,0,8,8
1653414904605,MATH 272A,A00,087437,Tian; Xiaochuan,2,0,8,6
1653414905135,MATH 274,A01,087439,Cheng; Li-Tien,9,0,10,1
1653414905135,MATH 274,A02,087440,Cheng; Li-Tien,10,0,10,0
1653414905671,MATH 278A,A00,087441,Staff,8,0,10,2
1653414906194,MATH 278B,A00,087442,Staff,8,0,10,2
1653414906725,MATH 278C,A00,087443,Staff,8,0,10,2
1653414907246,MATH 280A,A00,087444,Zheng; Tianyi,0,0,8,8
1653414907772,MATH 281A,A00,087445,Bradic; Jelena,0,0,8,8
1653414908300,MATH 282A,A00,087446,Zhang; Danna,0,0,8,8
1653414908838,MATH 283,A00,087447,Tesler; Glenn,0,0,0,14
1653414909368,MATH 286,A00,087448,Kemp; Todd Aahron,6,0,8,2
1653414909896,MATH 287D,A00,087449,Bradic; Jelena,8,0,8,0
1653414910418,MATH 288,A00,087450,Staff,14,0,15,1
1653414910418,MATH 288,B00,087451,Staff,15,0,15,0
1653414910418,MATH 288,C00,087452,Staff,15,0,15,0
1653414910950,MATH 290A,A00,087453,Xu; Zhouli,7,0,8,1
1653414911472,MATH 291A,A00,087454,Xu; Zhouli,7,0,8,1
1653414911996,MATH 292,A00,087455,Staff,10,0,10,0
1653414912528,MATH 295,A00,087456,Staff,50,0,50,0
1653414913050,MATH 297,001,087457,Staff,998,0,999,1
1653415478949,COGS 200,A01,087991,Staff,48,0,50,2
1653415479476,COGS 201,A01,094504,Rangel; Lara M,17,0,25,8
1653415480017,COGS 203,A00,087992,Coulson; Seana M,19,0,20,1
1653415480541,COGS 210A,001,087993,Greene; Deanna Jacquelyn,9998,0,9999,1
1653415480541,COGS 210A,002,087994,Saygin; Ayse P,9999,0,9999,0
1653415480541,COGS 210A,003,087995,Xia; Haijun,9999,0,9999,0
1653415480541,COGS 210A,004,087996,Nitz; Douglas A.,9999,0,9999,0
1653415480541,COGS 210A,005,087997,Hollan; James D.,9999,0,9999,0
1653415480541,COGS 210A,006,087998,Deak; Gedeon O.,9998,0,9999,1
1653415480541,COGS 210A,007,087999,Rossano; Federico,9999,0,9999,0
1653415481085,COGS 211A,A00,088000,Coulson; Seana M,9997,0,9999,2
1653415481612,COGS 229,A00,088002,Staff,23,0,25,2
1653415482134,COGS 260,B00,094231,Staff,17,0,20,3
1653415482134,COGS 260,A00,088004,Nitz; Douglas A.,9998,0,9999,1
1653415482664,CSE 202,A00,090110,Paturi; Ramamohan,0,0,0,0
1653415482664,CSE 202,B00,090111,Paturi; Ramamohan,0,0,0,0
1653415483203,CSE 207B,A00,090112,Heninger; Nadia A,0,0,0,0
1653415483724,CSE 208,A00,094858,Micciancio; Daniele,0,0,0,0
1653415484260,CSE 210,A00,090113,Powell; Thomas Allan,0,0,0,0
1653415484799,CSE 219,A00,090898,Staff,0,0,0,0
1653415485334,CSE 221,A00,090114,Zhou; Yuan-Yuan,0,0,0,0
1653415485865,CSE 229A,A00,090115,Porter; George M,0,0,0,0
1653415486388,CSE 229C,A00,090116,Savage; Stefan,0,0,0,0
1653415486915,CSE 230,A00,090117,Jhala; Ranjit,0,0,0,0
1653415487451,CSE 232,A00,090118,Papakonstantinou; Yannis,0,0,0,0
1653415487975,CSE 239A,A00,090121,Kumar; Arun Kumar,0,0,0,0
1653415488509,CSE 239B,A00,090122,Jhala; Ranjit,0,0,0,0
1653415489043,CSE 240A,A00,090123,Zhao; Jishen,0,0,189,189
1653415489571,CSE 243A,A00,090124,Orailoglu; Alex,3,0,15,12
1653415490104,CSE 249B,A00,090125,Kahng; Andrew Byun,13,0,20,7
1653415490626,CSE 250A,A00,090126,Berg-Kirkpatrick; Taylor D,0,0,0,0
1653415491149,CSE 252A,A00,090127,Ochoa; Benjamin Lawrence,0,0,0,0
1653415491680,CSE 258,A01,090129,McAuley; Julian John,0,0,0,0
1653415492208,CSE 258R,A01,090131,McAuley; Julian John,0,0,0,0
1653415492743,CSE 274,A00,090132,Ramamoorthi; Ravi,0,0,0,0
1653415493273,CSE 276A,A00,090133,Christensen; Henrik I,0,0,0,0
1653415493796,CSE 276C,A00,090134,Christensen; Henrik I,0,0,0,0
1653415494325,CSE 290,A00,090135,Bafna; Vineet,0,0,0,0
1653415494325,CSE 290,B00,090136,Ramamoorthi; Ravi,0,0,0,0
1653415494325,CSE 290,C00,090137,Li; Tzumao,10,0,10,0
1653415494325,CSE 290,D00,090138,Zhou; Yuan-Yuan,10,0,10,0
1653415494325,CSE 290,E00,090139,Christensen; Henrik I,10,0,10,0
1653415494325,CSE 290,F00,094053,Shalev; Aaron D,0,0,0,0
1653415494877,CSE 291,A00,090140,Munyaka; Imani N. S.,0,0,0,0
1653415494877,CSE 291,B00,094880,Yu; Qi,0,0,0,0
1653415494877,CSE 291,C00,090142,Pannuto; Patrick William,0,0,0,0
1653415494877,CSE 291,D00,094881,Zhang; Yiying,0,0,0,0
1653415494877,CSE 291,E00,095118,Su; Hao,0,0,0,0
1653415495408,CSE 293,001,094905,Bafna; Vineet,9999,0,9999,0
1653415495408,CSE 293,002,094906,Bellare; Mihir,9999,0,9999,0
1653415495408,CSE 293,003,094907,Berg-Kirkpatrick; Taylor D,9999,0,9999,0
1653415495408,CSE 293,004,094908,Christensen; Henrik I,9999,0,9999,0
1653415495408,CSE 293,005,094909,Cottrell; Garrison W,9999,0,9999,0
1653415495408,CSE 293,006,094910,Deutsch; Alin Bernard,9999,0,9999,0
1653415495408,CSE 293,007,094911,Esmaeilzadeh; Hadi,9999,0,9999,0
1653415495408,CSE 293,008,094912,Freund; Yoav,9999,0,9999,0
1653415495408,CSE 293,009,094913,Griswold; William G.,9999,0,9999,0
1653415495408,CSE 293,010,094914,Gymrek; Melissa Ann,9999,0,9999,0
1653415495408,CSE 293,011,094915,Heninger; Nadia A,9999,0,9999,0
1653415495408,CSE 293,012,094916,Impagliazzo; Russell,9999,0,9999,0
1653415495408,CSE 293,013,094917,Jhala; Ranjit,9999,0,9999,0
1653415495408,CSE 293,014,094918,Kahng; Andrew Byun,9999,0,9999,0
1653415495408,CSE 293,015,094919,Kane; Daniel Mertz,9999,0,9999,0
1653415495408,CSE 293,016,094920,Kriegman; David J,9999,0,9999,0
1653415495408,CSE 293,017,094921,Kumar; Arun Kumar,9999,0,9999,0
1653415495408,CSE 293,018,094922,Lerner; Sorin,9999,0,9999,0
1653415495408,CSE 293,019,094923,Lovett; Shachar,9999,0,9999,0
1653415495408,CSE 293,020,094924,McAuley; Julian John,9999,0,9999,0
1653415495408,CSE 293,021,094925,Micciancio; Daniele,9999,0,9999,0
1653415495408,CSE 293,022,094926,Orailoglu; Alex,9999,0,9999,0
1653415495408,CSE 293,023,094927,Paturi; Ramamohan,9999,0,9999,0
1653415495408,CSE 293,024,094928,Polikarpova; Nadezhda,9999,0,9999,0
1653415495408,CSE 293,025,094929,Politz; Joseph Gibbs,9999,0,9999,0
1653415495408,CSE 293,026,094930,Porter; George M,9999,0,9999,0
1653415495408,CSE 293,027,094931,Porter; Leonard Emerson,9999,0,9999,0
1653415495408,CSE 293,028,094932,Ramamoorthi; Ravi,9999,0,9999,0
1653415495408,CSE 293,029,094933,Sahoo; Debashis,9999,0,9999,0
1653415495408,CSE 293,030,094934,Saul; Lawrence,9999,0,9999,0
1653415495408,CSE 293,031,094935,Savage; Stefan,9999,0,9999,0
1653415495408,CSE 293,032,094936,Schulze; Jurgen P.,9999,0,9999,0
1653415495408,CSE 293,033,094937,Snoeren; Alex C.,9999,0,9999,0
1653415495408,CSE 293,034,094938,Shang; Jingbo,9999,0,9999,0
1653415495408,CSE 293,035,094939,Stefan; Deian,9999,0,9999,0
1653415495408,CSE 293,036,094940,Su; Hao,9999,0,9999,0
1653415495408,CSE 293,037,094941,Swanson; Steven James,9999,0,9999,0
1653415495408,CSE 293,038,094942,Tullsen; Dean Michael,9999,0,9999,0
1653415495408,CSE 293,039,094943,Voelker; Geoffrey M.,9999,0,9999,0
1653415495408,CSE 293,040,094944,Zhao; Jishen,9999,0,9999,0
1653415495408,CSE 293,041,094945,Zhou; Yuan-Yuan,9999,0,9999,0
1653415495408,CSE 293,042,094946,Gao; Sicun,9998,0,9999,1
1653415495408,CSE 293,043,094947,Weibel; Nadir,9999,0,9999,0
1653415495408,CSE 293,044,094948,Gupta; Rajesh K.,9999,0,9999,0
1653415495937,CSE 294,A00,090143,Porter; George M,9,0,10,1
1653415496472,DSE 200,A00,091799,Staff,50,0,50,0
1653415497004,DSE 203,A00,091800,Gupta; Amarnath,30,0,30,0
1653415497526,DSE 250,A00,091801,Deutsch; Alin Bernard,30,0,30,0
1653415498052,DSE 290,A00,091802,Altintas De Callaf; Ilkay,50,0,50,0
1653415498634,ECE 200,001,091003,Antipa; Nicholas A,9999,0,9999,0
1653415498634,ECE 200,002,091004,Atanasov; Nikolay A.,9999,0,9999,0
1653415498634,ECE 200,003,091005,Bharadia; Dinesh,9999,0,9999,0
1653415498634,ECE 200,004,091006,Cheng; Chung Kuan,9999,0,9999,0
1653415498634,ECE 200,005,091007,Cosman; Pamela C.,9999,0,9999,0
1653415498634,ECE 200,006,091008,Staff,9999,0,9999,0
1653415498634,ECE 200,007,091009,Dayeh; Shadi Ahmad,9999,0,9999,0
1653415498634,ECE 200,008,091010,Fainman; Yeshaiahu,9999,0,9999,0
1653415498634,ECE 200,009,091011,Ford; Joseph Earl,9999,0,9999,0
1653415498634,ECE 200,010,091012,Franceschetti; Massimo,9999,0,9999,0
1653415498634,ECE 200,011,091013,Fullerton; Eric E,9999,0,9999,0
1653415498634,ECE 200,012,091014,Galton; Ian A,9999,0,9999,0
1653415498634,ECE 200,013,091015,Gilja; Vikash,9999,0,9999,0
1653415498634,ECE 200,014,091016,Hall; Drew A.,9999,0,9999,0
1653415498634,ECE 200,015,091017,Hsueh; Tzu-Chien,9999,0,9999,0
1653415498634,ECE 200,016,091018,Javidi; Tara,9999,0,9999,0
1653415498634,ECE 200,017,091019,Kahng; Andrew Byun,9999,0,9999,0
1653415498634,ECE 200,018,091020,Kim; Young-Han,9999,0,9999,0
1653415498634,ECE 200,019,091021,Koushanfar; Farinaz,9999,0,9999,0
1653415498634,ECE 200,020,091022,Kuzum; Duygu,9999,0,9999,0
1653415498634,ECE 200,021,091023,Le; Hanh-Phuc,9999,0,9999,0
1653415498634,ECE 200,022,091024,Lin; Bill,9999,0,9999,0
1653415498634,ECE 200,023,091025,Liu; Zhaowei,9999,0,9999,0
1653415498634,ECE 200,024,091026,Lo; Yu-Hwa,9999,0,9999,0
1653415498634,ECE 200,025,091027,Lomakin; Vitaliy,9999,0,9999,0
1653415498634,ECE 200,026,091028,Mercier; Patrick Philip,9999,0,9999,0
1653415498634,ECE 200,027,091029,Meyer; Florian,9999,0,9999,0
1653415498634,ECE 200,028,091030,Milstein; Laurence B.,9999,0,9999,0
1653415498634,ECE 200,029,091031,Mir Arabbaygi; Siavash,9999,0,9999,0
1653415498634,ECE 200,030,091032,Mookherjea; Shayan,9999,0,9999,0
1653415498634,ECE 200,031,091033,Morris; Karcher William,9999,0,9999,0
1653415498634,ECE 200,032,091034,Ng; Tse Nga,9999,0,9999,0
1653415498634,ECE 200,033,091035,Nguyen; Truong Quang,9999,0,9999,0
1653415498634,ECE 200,034,091036,Nomura; Kenji,9999,0,9999,0
1653415498634,ECE 200,035,091037,Orlitsky; Alon,9999,0,9999,0
1653415498634,ECE 200,036,091038,Pal; Piya,9999,0,9999,0
1653415498634,ECE 200,037,091039,Papen; George C.,9999,0,9999,0
1653415498634,ECE 200,038,091040,Radic; Stojan,9999,0,9999,0
1653415498634,ECE 200,039,091041,Rao; Bhaskar D.,9999,0,9999,0
1653415498634,ECE 200,040,091042,Rao; Ramesh R,9999,0,9999,0
1653415498634,ECE 200,041,091043,Rebeiz; Gabriel,9999,0,9999,0
1653415498634,ECE 200,042,091044,Sanford; John R,9999,0,9999,0
1653415498634,ECE 200,043,091045,Siegel; Paul H.,9999,0,9999,0
1653415498634,ECE 200,044,091046,Sievenpiper; Daniel F.,9999,0,9999,0
1653415498634,ECE 200,045,091047,Sworder; David D.,9999,0,9999,0
1653415498634,ECE 200,046,091048,Taur; Yuan,9999,0,9999,0
1653415498634,ECE 200,047,091049,Touri; Behrouz,9999,0,9999,0
1653415498634,ECE 200,048,091050,Trivedi; Mohan M.,9999,0,9999,0
1653415498634,ECE 200,049,091051,Vardy; Alexander,9999,0,9999,0
1653415498634,ECE 200,050,091052,Vasconcelos; Nuno,9999,0,9999,0
1653415498634,ECE 200,051,091053,Wang; Xiaolong,9999,0,9999,0
1653415498634,ECE 200,052,091054,Xie; Pengtao,9999,0,9999,0
1653415498634,ECE 200,053,091055,Yip; Michael,9999,0,9999,0
1653415498634,ECE 200,054,091056,Zeger; Kenneth A.,9999,0,9999,0
1653415498634,ECE 200,055,091057,Zhang; Xinyu,9999,0,9999,0
1653415498634,ECE 200,056,091058,Turakhia; Yatish Girish,9999,0,9999,0
1653415498634,ECE 200,057,091059,Kang; Mingu,9999,0,9999,0
1653415498634,ECE 200,058,091060,Shi; Yuanyuan,9999,0,9999,0
1653415498634,ECE 200,059,091061,Wang; Edward Jay,9999,0,9999,0
1653415498634,ECE 200,060,091062,Zheng; Yang,9999,0,9999,0
1653415499171,ECE 203,A00,091065,Mercier; Patrick Philip,0,0,0,0
1653415499698,ECE 207A,A00,091605,Liu; Thomas Tao-Ming,0,0,0,0
1653415500223,ECE 212AN,A00,091068,Nomura; Kenji,0,0,0,0
1653415500747,ECE 222A,A00,091069,Rebeiz; Gabriel,0,0,0,0
1653415501270,ECE 225A,A00,091070,Orlitsky; Alon,0,0,0,0
1653415501793,ECE 230A,A00,091071,Nomura; Kenji,0,0,0,0
1653415502317,ECE 236A,A00,091072,Dayeh; Shadi Ahmad,0,0,0,0
1653415502857,ECE 238A,A00,091073,Luo; Jian,0,0,0,0
1653415502857,ECE 238A,B00,091074,Luo; Jian,0,0,0,0
1653415503393,ECE 240A,A00,091075,Radic; Stojan,0,0,0,0
1653415503919,ECE 247A,A00,091592,Shi; Lingyan,0,0,0,0
1653415504467,ECE 250,A00,091076,Touri; Behrouz,0,0,0,0
1653415504995,ECE 251C,A00,091078,Nguyen; Truong Quang,0,0,0,0
1653415505517,ECE 253,A00,091079,Cosman; Pamela C.,0,0,0,0
1653415506058,ECE 255A,A00,091080,Orlitsky; Alon,0,0,0,0
1653415506589,ECE 257A,A00,091081,Zhang; Xinyu,0,0,0,0
1653415507119,ECE 260A,A01,091084,Eldon; John,0,0,0,0
1653415507643,ECE 264C,A00,091085,Galton; Ian A,0,0,0,0
1653415508182,ECE 265C,A00,094889,Presti; Calogero Davide,0,0,0,9
1653415508714,ECE 266,A01,091087,Hall; Drew A.,0,0,0,0
1653415509760,ECE 271A,A00,091090,Vasconcelos; Nuno,0,0,0,0
1653415510281,ECE 272B,A00,091091,Sworder; David D.,0,0,0,0
1653415510816,ECE 275A,A00,091092,Meyer; Florian,0,0,0,0
1653415511355,ECE 277,A00,091093,An; Cheolhong,0,0,0,0
1653415511883,ECE 283,A00,091094,Le; Hanh-Phuc,0,0,0,0
1653415512422,ECE 284,A00,091095,Kang; Mingu,0,0,0,0
1653415512422,ECE 284,B00,091096,Wang; Edward Jay,0,0,0,0
1653415512955,ECE 285,A00,094334,Touri; Behrouz,0,0,0,0
1653415513482,ECE 289,A00,091097,Whelan; David Arthur,0,0,0,0
1653415514007,MATH 200A,A00,087414,Salehi Golsefidy; Alireza,7,0,8,1
1653415514544,MATH 202A,A00,087415,Gill; Philip E.,3,0,8,5
1653415515072,MATH 203A,A00,087416,Oprea; Dragos N.,6,0,8,2
1653415515601,MATH 204A,A00,087417,Kedlaya; Kiran S.,6,0,8,2
1653415516124,MATH 205,A00,087418,Sorensen; Claus M,6,0,8,2
1653415516646,MATH 206A,A00,087419,Izadi; Elham,7,0,8,1
1653415517172,MATH 207A,A00,087420,Mohammadi; Amir,6,0,8,2
1653415517695,MATH 208,A00,087421,Staff,9,0,10,1
1653415518232,MATH 209,A00,087422,Staff,10,0,10,0
1653415518766,MATH 218,A00,087423,Staff,10,0,10,0
1653415519289,MATH 220A,A00,087424,Novak; Jonathan I,7,0,8,1
1653415519817,MATH 231A,A00,087425,Bejenaru; Ioan,4,0,8,4
1653415520341,MATH 240A,A00,087426,Ebenfelt; Peter F,5,0,8,3
1653415520888,MATH 243,A00,087427,Staff,9,0,10,1
1653415521437,MATH 248,A00,087429,Staff,10,0,10,0
1653415521959,MATH 250A,A00,087430,Spolaor; Luca,5,0,8,3
1653415522510,MATH 257A,A00,087431,Spolaor; Luca,7,0,8,1
1653415523045,MATH 258,A00,087432,Staff,9,0,10,1
1653415523580,MATH 264A,A00,087433,Warnke; Lutz Peter,5,0,8,3
1653415524110,MATH 268,A00,087434,Staff,15,0,15,0
1653415524646,MATH 269,A00,087435,Staff,14,0,15,1
1653415525185,MATH 270A,A00,087436,Nie; Jiawang,0,0,8,8
1653415525712,MATH 272A,A00,087437,Tian; Xiaochuan,2,0,8,6
1653415526238,MATH 274,A01,087439,Cheng; Li-Tien,9,0,10,1
1653415526238,MATH 274,A02,087440,Cheng; Li-Tien,10,0,10,0
1653415526763,MATH 278A,A00,087441,Staff,8,0,10,2
1653415527286,MATH 278B,A00,087442,Staff,8,0,10,2
1653415527813,MATH 278C,A00,087443,Staff,8,0,10,2
1653415528345,MATH 280A,A00,087444,Zheng; Tianyi,0,0,8,8
1653415528996,MATH 281A,A00,087445,Bradic; Jelena,0,0,8,8
1653415529518,MATH 282A,A00,087446,Zhang; Danna,0,0,8,8
1653415530045,MATH 283,A00,087447,Tesler; Glenn,0,0,0,14
1653415530567,MATH 286,A00,087448,Kemp; Todd Aahron,6,0,8,2
1653415531095,MATH 287D,A00,087449,Bradic; Jelena,8,0,8,0
1653415531618,MATH 288,A00,087450,Staff,14,0,15,1
1653415531618,MATH 288,B00,087451,Staff,15,0,15,0
1653415531618,MATH 288,C00,087452,Staff,15,0,15,0
1653415532155,MATH 290A,A00,087453,Xu; Zhouli,7,0,8,1
1653415532678,MATH 291A,A00,087454,Xu; Zhouli,7,0,8,1
1653415533218,MATH 292,A00,087455,Staff,10,0,10,0
1653415533743,MATH 295,A00,087456,Staff,50,0,50,0
1653415534281,MATH 297,001,087457,Staff,998,0,999,1
1653416098841,COGS 200,A01,087991,Staff,48,0,50,2
1653416099382,COGS 201,A01,094504,Rangel; Lara M,17,0,25,8
1653416099916,COGS 203,A00,087992,Coulson; Seana M,19,0,20,1
1653416100439,COGS 210A,001,087993,Greene; Deanna Jacquelyn,9998,0,9999,1
1653416100439,COGS 210A,002,087994,Saygin; Ayse P,9999,0,9999,0
1653416100439,COGS 210A,003,087995,Xia; Haijun,9999,0,9999,0
1653416100439,COGS 210A,004,087996,Nitz; Douglas A.,9999,0,9999,0
1653416100439,COGS 210A,005,087997,Hollan; James D.,9999,0,9999,0
1653416100439,COGS 210A,006,087998,Deak; Gedeon O.,9998,0,9999,1
1653416100439,COGS 210A,007,087999,Rossano; Federico,9999,0,9999,0
1653416100965,COGS 211A,A00,088000,Coulson; Seana M,9997,0,9999,2
1653416101490,COGS 229,A00,088002,Staff,23,0,25,2
1653416102024,COGS 260,B00,094231,Staff,17,0,20,3
1653416102024,COGS 260,A00,088004,Nitz; Douglas A.,9998,0,9999,1
1653416102560,CSE 202,A00,090110,Paturi; Ramamohan,0,0,0,0
1653416102560,CSE 202,B00,090111,Paturi; Ramamohan,0,0,0,0
1653416103086,CSE 207B,A00,090112,Heninger; Nadia A,0,0,0,0
1653416103609,CSE 208,A00,094858,Micciancio; Daniele,0,0,0,0
1653416104131,CSE 210,A00,090113,Powell; Thomas Allan,0,0,0,0
1653416104664,CSE 219,A00,090898,Staff,0,0,0,0
1653416105190,CSE 221,A00,090114,Zhou; Yuan-Yuan,0,0,0,0
1653416105725,CSE 229A,A00,090115,Porter; George M,0,0,0,0
1653416106257,CSE 229C,A00,090116,Savage; Stefan,0,0,0,0
1653416106778,CSE 230,A00,090117,Jhala; Ranjit,0,0,0,0
1653416107308,CSE 232,A00,090118,Papakonstantinou; Yannis,0,0,0,0
1653416107828,CSE 239A,A00,090121,Kumar; Arun Kumar,0,0,0,0
1653416108354,CSE 239B,A00,090122,Jhala; Ranjit,0,0,0,0
1653416108877,CSE 240A,A00,090123,Zhao; Jishen,0,0,189,189
1653416109400,CSE 243A,A00,090124,Orailoglu; Alex,3,0,15,12
1653416109925,CSE 249B,A00,090125,Kahng; Andrew Byun,13,0,20,7
1653416110449,CSE 250A,A00,090126,Berg-Kirkpatrick; Taylor D,0,0,0,0
1653416110982,CSE 252A,A00,090127,Ochoa; Benjamin Lawrence,0,0,0,0
1653416111509,CSE 258,A01,090129,McAuley; Julian John,0,0,0,0
1653416112036,CSE 258R,A01,090131,McAuley; Julian John,0,0,0,0
1653416112564,CSE 274,A00,090132,Ramamoorthi; Ravi,0,0,0,0
1653416113088,CSE 276A,A00,090133,Christensen; Henrik I,0,0,0,0
1653416113616,CSE 276C,A00,090134,Christensen; Henrik I,0,0,0,0
1653416114143,CSE 290,A00,090135,Bafna; Vineet,0,0,0,0
1653416114143,CSE 290,B00,090136,Ramamoorthi; Ravi,0,0,0,0
1653416114143,CSE 290,C00,090137,Li; Tzumao,10,0,10,0
1653416114143,CSE 290,D00,090138,Zhou; Yuan-Yuan,10,0,10,0
1653416114143,CSE 290,E00,090139,Christensen; Henrik I,10,0,10,0
1653416114143,CSE 290,F00,094053,Shalev; Aaron D,0,0,0,0
1653416114673,CSE 291,A00,090140,Munyaka; Imani N. S.,0,0,0,0
1653416114673,CSE 291,B00,094880,Yu; Qi,0,0,0,0
1653416114673,CSE 291,C00,090142,Pannuto; Patrick William,0,0,0,0
1653416114673,CSE 291,D00,094881,Zhang; Yiying,0,0,0,0
1653416114673,CSE 291,E00,095118,Su; Hao,0,0,0,0
1653416115204,CSE 293,001,094905,Bafna; Vineet,9999,0,9999,0
1653416115204,CSE 293,002,094906,Bellare; Mihir,9999,0,9999,0
1653416115204,CSE 293,003,094907,Berg-Kirkpatrick; Taylor D,9999,0,9999,0
1653416115204,CSE 293,004,094908,Christensen; Henrik I,9999,0,9999,0
1653416115204,CSE 293,005,094909,Cottrell; Garrison W,9999,0,9999,0
1653416115204,CSE 293,006,094910,Deutsch; Alin Bernard,9999,0,9999,0
1653416115204,CSE 293,007,094911,Esmaeilzadeh; Hadi,9999,0,9999,0
1653416115204,CSE 293,008,094912,Freund; Yoav,9999,0,9999,0
1653416115204,CSE 293,009,094913,Griswold; William G.,9999,0,9999,0
1653416115204,CSE 293,010,094914,Gymrek; Melissa Ann,9999,0,9999,0
1653416115204,CSE 293,011,094915,Heninger; Nadia A,9999,0,9999,0
1653416115204,CSE 293,012,094916,Impagliazzo; Russell,9999,0,9999,0
1653416115204,CSE 293,013,094917,Jhala; Ranjit,9999,0,9999,0
1653416115204,CSE 293,014,094918,Kahng; Andrew Byun,9999,0,9999,0
1653416115204,CSE 293,015,094919,Kane; Daniel Mertz,9999,0,9999,0
1653416115204,CSE 293,016,094920,Kriegman; David J,9999,0,9999,0
1653416115204,CSE 293,017,094921,Kumar; Arun Kumar,9999,0,9999,0
1653416115204,CSE 293,018,094922,Lerner; Sorin,9999,0,9999,0
1653416115204,CSE 293,019,094923,Lovett; Shachar,9999,0,9999,0
1653416115204,CSE 293,020,094924,McAuley; Julian John,9999,0,9999,0
1653416115204,CSE 293,021,094925,Micciancio; Daniele,9999,0,9999,0
1653416115204,CSE 293,022,094926,Orailoglu; Alex,9999,0,9999,0
1653416115204,CSE 293,023,094927,Paturi; Ramamohan,9999,0,9999,0
1653416115204,CSE 293,024,094928,Polikarpova; Nadezhda,9999,0,9999,0
1653416115204,CSE 293,025,094929,Politz; Joseph Gibbs,9999,0,9999,0
1653416115204,CSE 293,026,094930,Porter; George M,9999,0,9999,0
1653416115204,CSE 293,027,094931,Porter; Leonard Emerson,9999,0,9999,0
1653416115204,CSE 293,028,094932,Ramamoorthi; Ravi,9999,0,9999,0
1653416115204,CSE 293,029,094933,Sahoo; Debashis,9999,0,9999,0
1653416115204,CSE 293,030,094934,Saul; Lawrence,9999,0,9999,0
1653416115204,CSE 293,031,094935,Savage; Stefan,9999,0,9999,0
1653416115204,CSE 293,032,094936,Schulze; Jurgen P.,9999,0,9999,0
1653416115204,CSE 293,033,094937,Snoeren; Alex C.,9999,0,9999,0
1653416115204,CSE 293,034,094938,Shang; Jingbo,9999,0,9999,0
1653416115204,CSE 293,035,094939,Stefan; Deian,9999,0,9999,0
1653416115204,CSE 293,036,094940,Su; Hao,9999,0,9999,0
1653416115204,CSE 293,037,094941,Swanson; Steven James,9999,0,9999,0
1653416115204,CSE 293,038,094942,Tullsen; Dean Michael,9999,0,9999,0
1653416115204,CSE 293,039,094943,Voelker; Geoffrey M.,9999,0,9999,0
1653416115204,CSE 293,040,094944,Zhao; Jishen,9999,0,9999,0
1653416115204,CSE 293,041,094945,Zhou; Yuan-Yuan,9999,0,9999,0
1653416115204,CSE 293,042,094946,Gao; Sicun,9998,0,9999,1
1653416115204,CSE 293,043,094947,Weibel; Nadir,9999,0,9999,0
1653416115204,CSE 293,044,094948,Gupta; Rajesh K.,9999,0,9999,0
1653416115732,CSE 294,A00,090143,Porter; George M,9,0,10,1
1653416116262,DSE 200,A00,091799,Staff,50,0,50,0
1653416116785,DSE 203,A00,091800,Gupta; Amarnath,30,0,30,0
1653416117321,DSE 250,A00,091801,Deutsch; Alin Bernard,30,0,30,0
1653416117848,DSE 290,A00,091802,Altintas De Callaf; Ilkay,50,0,50,0
1653416118393,ECE 200,001,091003,Antipa; Nicholas A,9999,0,9999,0
1653416118393,ECE 200,002,091004,Atanasov; Nikolay A.,9999,0,9999,0
1653416118393,ECE 200,003,091005,Bharadia; Dinesh,9999,0,9999,0
1653416118393,ECE 200,004,091006,Cheng; Chung Kuan,9999,0,9999,0
1653416118393,ECE 200,005,091007,Cosman; Pamela C.,9999,0,9999,0
1653416118393,ECE 200,006,091008,Staff,9999,0,9999,0
1653416118393,ECE 200,007,091009,Dayeh; Shadi Ahmad,9999,0,9999,0
1653416118393,ECE 200,008,091010,Fainman; Yeshaiahu,9999,0,9999,0
1653416118393,ECE 200,009,091011,Ford; Joseph Earl,9999,0,9999,0
1653416118393,ECE 200,010,091012,Franceschetti; Massimo,9999,0,9999,0
1653416118393,ECE 200,011,091013,Fullerton; Eric E,9999,0,9999,0
1653416118393,ECE 200,012,091014,Galton; Ian A,9999,0,9999,0
1653416118393,ECE 200,013,091015,Gilja; Vikash,9999,0,9999,0
1653416118393,ECE 200,014,091016,Hall; Drew A.,9999,0,9999,0
1653416118393,ECE 200,015,091017,Hsueh; Tzu-Chien,9999,0,9999,0
1653416118393,ECE 200,016,091018,Javidi; Tara,9999,0,9999,0
1653416118393,ECE 200,017,091019,Kahng; Andrew Byun,9999,0,9999,0
1653416118393,ECE 200,018,091020,Kim; Young-Han,9999,0,9999,0
1653416118393,ECE 200,019,091021,Koushanfar; Farinaz,9999,0,9999,0
1653416118393,ECE 200,020,091022,Kuzum; Duygu,9999,0,9999,0
1653416118393,ECE 200,021,091023,Le; Hanh-Phuc,9999,0,9999,0
1653416118393,ECE 200,022,091024,Lin; Bill,9999,0,9999,0
1653416118393,ECE 200,023,091025,Liu; Zhaowei,9999,0,9999,0
1653416118393,ECE 200,024,091026,Lo; Yu-Hwa,9999,0,9999,0
1653416118393,ECE 200,025,091027,Lomakin; Vitaliy,9999,0,9999,0
1653416118393,ECE 200,026,091028,Mercier; Patrick Philip,9999,0,9999,0
1653416118393,ECE 200,027,091029,Meyer; Florian,9999,0,9999,0
1653416118393,ECE 200,028,091030,Milstein; Laurence B.,9999,0,9999,0
1653416118393,ECE 200,029,091031,Mir Arabbaygi; Siavash,9999,0,9999,0
1653416118393,ECE 200,030,091032,Mookherjea; Shayan,9999,0,9999,0
1653416118393,ECE 200,031,091033,Morris; Karcher William,9999,0,9999,0
1653416118393,ECE 200,032,091034,Ng; Tse Nga,9999,0,9999,0
1653416118393,ECE 200,033,091035,Nguyen; Truong Quang,9999,0,9999,0
1653416118393,ECE 200,034,091036,Nomura; Kenji,9999,0,9999,0
1653416118393,ECE 200,035,091037,Orlitsky; Alon,9999,0,9999,0
1653416118393,ECE 200,036,091038,Pal; Piya,9999,0,9999,0
1653416118393,ECE 200,037,091039,Papen; George C.,9999,0,9999,0
1653416118393,ECE 200,038,091040,Radic; Stojan,9999,0,9999,0
1653416118393,ECE 200,039,091041,Rao; Bhaskar D.,9999,0,9999,0
1653416118393,ECE 200,040,091042,Rao; Ramesh R,9999,0,9999,0
1653416118393,ECE 200,041,091043,Rebeiz; Gabriel,9999,0,9999,0
1653416118393,ECE 200,042,091044,Sanford; John R,9999,0,9999,0
1653416118393,ECE 200,043,091045,Siegel; Paul H.,9999,0,9999,0
1653416118393,ECE 200,044,091046,Sievenpiper; Daniel F.,9999,0,9999,0
1653416118393,ECE 200,045,091047,Sworder; David D.,9999,0,9999,0
1653416118393,ECE 200,046,091048,Taur; Yuan,9999,0,9999,0
1653416118393,ECE 200,047,091049,Touri; Behrouz,9999,0,9999,0
1653416118393,ECE 200,048,091050,Trivedi; Mohan M.,9999,0,9999,0
1653416118393,ECE 200,049,091051,Vardy; Alexander,9999,0,9999,0
1653416118393,ECE 200,050,091052,Vasconcelos; Nuno,9999,0,9999,0
1653416118393,ECE 200,051,091053,Wang; Xiaolong,9999,0,9999,0
1653416118393,ECE 200,052,091054,Xie; Pengtao,9999,0,9999,0
1653416118393,ECE 200,053,091055,Yip; Michael,9999,0,9999,0
1653416118393,ECE 200,054,091056,Zeger; Kenneth A.,9999,0,9999,0
1653416118393,ECE 200,055,091057,Zhang; Xinyu,9999,0,9999,0
1653416118393,ECE 200,056,091058,Turakhia; Yatish Girish,9999,0,9999,0
1653416118393,ECE 200,057,091059,Kang; Mingu,9999,0,9999,0
1653416118393,ECE 200,058,091060,Shi; Yuanyuan,9999,0,9999,0
1653416118393,ECE 200,059,091061,Wang; Edward Jay,9999,0,9999,0
1653416118393,ECE 200,060,091062,Zheng; Yang,9999,0,9999,0
1653416118919,ECE 203,A00,091065,Mercier; Patrick Philip,0,0,0,0
1653416119443,ECE 207A,A00,091605,Liu; Thomas Tao-Ming,0,0,0,0
1653416119979,ECE 212AN,A00,091068,Nomura; Kenji,0,0,0,0
1653416120513,ECE 222A,A00,091069,Rebeiz; Gabriel,0,0,0,0
1653416121108,ECE 225A,A00,091070,Orlitsky; Alon,0,0,0,0
1653416121631,ECE 230A,A00,091071,Nomura; Kenji,0,0,0,0
1653416122155,ECE 236A,A00,091072,Dayeh; Shadi Ahmad,0,0,0,0
1653416122681,ECE 238A,A00,091073,Luo; Jian,0,0,0,0
1653416122681,ECE 238A,B00,091074,Luo; Jian,0,0,0,0
1653416123203,ECE 240A,A00,091075,Radic; Stojan,0,0,0,0
1653416123729,ECE 247A,A00,091592,Shi; Lingyan,0,0,0,0
1653416124265,ECE 250,A00,091076,Touri; Behrouz,0,0,0,0
1653416124792,ECE 251C,A00,091078,Nguyen; Truong Quang,0,0,0,0
1653416125314,ECE 253,A00,091079,Cosman; Pamela C.,0,0,0,0
1653416125841,ECE 255A,A00,091080,Orlitsky; Alon,0,0,0,0
1653416126362,ECE 257A,A00,091081,Zhang; Xinyu,0,0,0,0
1653416126885,ECE 260A,A01,091084,Eldon; John,0,0,0,0
1653416127425,ECE 264C,A00,091085,Galton; Ian A,0,0,0,0
1653416127978,ECE 265C,A00,094889,Presti; Calogero Davide,0,0,0,9
1653416128512,ECE 266,A01,091087,Hall; Drew A.,0,0,0,0
1653416129560,ECE 271A,A00,091090,Vasconcelos; Nuno,0,0,0,0
1653416130087,ECE 272B,A00,091091,Sworder; David D.,0,0,0,0
1653416130621,ECE 275A,A00,091092,Meyer; Florian,0,0,0,0
1653416131149,ECE 277,A00,091093,An; Cheolhong,0,0,0,0
1653416131674,ECE 283,A00,091094,Le; Hanh-Phuc,0,0,0,0
1653416132199,ECE 284,A00,091095,Kang; Mingu,0,0,0,0
1653416132199,ECE 284,B00,091096,Wang; Edward Jay,0,0,0,0
1653416132733,ECE 285,A00,094334,Touri; Behrouz,0,0,0,0
1653416133267,ECE 289,A00,091097,Whelan; David Arthur,0,0,0,0
1653416133793,MATH 200A,A00,087414,Salehi Golsefidy; Alireza,7,0,8,1
1653416134315,MATH 202A,A00,087415,Gill; Philip E.,3,0,8,5
1653416134840,MATH 203A,A00,087416,Oprea; Dragos N.,6,0,8,2
1653416135368,MATH 204A,A00,087417,Kedlaya; Kiran S.,6,0,8,2
1653416135892,MATH 205,A00,087418,Sorensen; Claus M,6,0,8,2
1653416136425,MATH 206A,A00,087419,Izadi; Elham,7,0,8,1
1653416136962,MATH 207A,A00,087420,Mohammadi; Amir,6,0,8,2
1653416137486,MATH 208,A00,087421,Staff,9,0,10,1
1653416138008,MATH 209,A00,087422,Staff,10,0,10,0
1653416138530,MATH 218,A00,087423,Staff,10,0,10,0
1653416139054,MATH 220A,A00,087424,Novak; Jonathan I,7,0,8,1
1653416139578,MATH 231A,A00,087425,Bejenaru; Ioan,4,0,8,4
1653416140123,MATH 240A,A00,087426,Ebenfelt; Peter F,5,0,8,3
1653416140653,MATH 243,A00,087427,Staff,9,0,10,1
1653416141177,MATH 248,A00,087429,Staff,10,0,10,0
1653416141698,MATH 250A,A00,087430,Spolaor; Luca,5,0,8,3
1653416142229,MATH 257A,A00,087431,Spolaor; Luca,7,0,8,1
1653416142750,MATH 258,A00,087432,Staff,9,0,10,1
1653416143275,MATH 264A,A00,087433,Warnke; Lutz Peter,5,0,8,3
1653416143808,MATH 268,A00,087434,Staff,15,0,15,0
1653416144343,MATH 269,A00,087435,Staff,14,0,15,1
1653416144865,MATH 270A,A00,087436,Nie; Jiawang,0,0,8,8
1653416145390,MATH 272A,A00,087437,Tian; Xiaochuan,2,0,8,6
1653416145914,MATH 274,A01,087439,Cheng; Li-Tien,9,0,10,1
1653416145914,MATH 274,A02,087440,Cheng; Li-Tien,10,0,10,0
1653416146438,MATH 278A,A00,087441,Staff,8,0,10,2
1653416146961,MATH 278B,A00,087442,Staff,8,0,10,2
1653416147486,MATH 278C,A00,087443,Staff,8,0,10,2
1653416148012,MATH 280A,A00,087444,Zheng; Tianyi,0,0,8,8
1653416148538,MATH 281A,A00,087445,Bradic; Jelena,0,0,8,8
1653416149060,MATH 282A,A00,087446,Zhang; Danna,0,0,8,8
1653416149584,MATH 283,A00,087447,Tesler; Glenn,0,0,0,14
1653416150108,MATH 286,A00,087448,Kemp; Todd Aahron,6,0,8,2
1653416150633,MATH 287D,A00,087449,Bradic; Jelena,8,0,8,0
1653416151164,MATH 288,A00,087450,Staff,14,0,15,1
1653416151164,MATH 288,B00,087451,Staff,15,0,15,0
1653416151164,MATH 288,C00,087452,Staff,15,0,15,0
1653416151703,MATH 290A,A00,087453,Xu; Zhouli,7,0,8,1
1653416152225,MATH 291A,A00,087454,Xu; Zhouli,7,0,8,1
1653416152753,MATH 292,A00,087455,Staff,10,0,10,0
1653416153276,MATH 295,A00,087456,Staff,50,0,50,0
1653416153799,MATH 297,001,087457,Staff,998,0,999,1
1653416717465,COGS 200,A01,087991,Staff,48,0,50,2
1653416717990,COGS 201,A01,094504,Rangel; Lara M,17,0,25,8
1653416718519,COGS 203,A00,087992,Coulson; Seana M,19,0,20,1
1653416719044,COGS 210A,001,087993,Greene; Deanna Jacquelyn,9998,0,9999,1
1653416719044,COGS 210A,002,087994,Saygin; Ayse P,9999,0,9999,0
1653416719044,COGS 210A,003,087995,Xia; Haijun,9999,0,9999,0
1653416719044,COGS 210A,004,087996,Nitz; Douglas A.,9999,0,9999,0
1653416719044,COGS 210A,005,087997,Hollan; James D.,9999,0,9999,0
1653416719044,COGS 210A,006,087998,Deak; Gedeon O.,9998,0,9999,1
1653416719044,COGS 210A,007,087999,Rossano; Federico,9999,0,9999,0
1653416719580,COGS 211A,A00,088000,Coulson; Seana M,9997,0,9999,2
1653416720110,COGS 229,A00,088002,Staff,23,0,25,2
1653416720636,COGS 260,B00,094231,Staff,17,0,20,3
1653416720636,COGS 260,A00,088004,Nitz; Douglas A.,9998,0,9999,1
1653416721165,CSE 202,A00,090110,Paturi; Ramamohan,0,0,0,0
1653416721165,CSE 202,B00,090111,Paturi; Ramamohan,0,0,0,0
1653416721689,CSE 207B,A00,090112,Heninger; Nadia A,0,0,0,0
1653416722213,CSE 208,A00,094858,Micciancio; Daniele,0,0,0,0
1653416722750,CSE 210,A00,090113,Powell; Thomas Allan,0,0,0,0
1653416730322,CSE 219,A00,090898,Staff,0,0,0,0
1653416734236,CSE 221,A00,090114,Zhou; Yuan-Yuan,0,0,0,0
1653416735946,CSE 229A,A00,090115,Porter; George M,0,0,0,0
1653416736481,CSE 229C,A00,090116,Savage; Stefan,0,0,0,0
1653416737004,CSE 230,A00,090117,Jhala; Ranjit,0,0,0,0
1653416737527,CSE 232,A00,090118,Papakonstantinou; Yannis,0,0,0,0
1653416738058,CSE 239A,A00,090121,Kumar; Arun Kumar,0,0,0,0
1653416738580,CSE 239B,A00,090122,Jhala; Ranjit,0,0,0,0
1653416739102,CSE 240A,A00,090123,Zhao; Jishen,0,0,189,189
1653416739631,CSE 243A,A00,090124,Orailoglu; Alex,3,0,15,12
1653416740154,CSE 249B,A00,090125,Kahng; Andrew Byun,13,0,20,7
1653416740683,CSE 250A,A00,090126,Berg-Kirkpatrick; Taylor D,0,0,0,0
1653416741206,CSE 252A,A00,090127,Ochoa; Benjamin Lawrence,0,0,0,0
1653416741727,CSE 258,A01,090129,McAuley; Julian John,0,0,0,0
1653416742252,CSE 258R,A01,090131,McAuley; Julian John,0,0,0,0
1653416742778,CSE 274,A00,090132,Ramamoorthi; Ravi,0,0,0,0
1653416743304,CSE 276A,A00,090133,Christensen; Henrik I,0,0,0,0
1653416743826,CSE 276C,A00,090134,Christensen; Henrik I,0,0,0,0
1653416744353,CSE 290,A00,090135,Bafna; Vineet,0,0,0,0
1653416744353,CSE 290,B00,090136,Ramamoorthi; Ravi,0,0,0,0
1653416744353,CSE 290,C00,090137,Li; Tzumao,10,0,10,0
1653416744353,CSE 290,D00,090138,Zhou; Yuan-Yuan,10,0,10,0
1653416744353,CSE 290,E00,090139,Christensen; Henrik I,10,0,10,0
1653416744353,CSE 290,F00,094053,Shalev; Aaron D,0,0,0,0
1653416744878,CSE 291,A00,090140,Munyaka; Imani N. S.,0,0,0,0
1653416744878,CSE 291,B00,094880,Yu; Qi,0,0,0,0
1653416744878,CSE 291,C00,090142,Pannuto; Patrick William,0,0,0,0
1653416744878,CSE 291,D00,094881,Zhang; Yiying,0,0,0,0
1653416744878,CSE 291,E00,095118,Su; Hao,0,0,0,0
1653416745405,CSE 293,001,094905,Bafna; Vineet,9999,0,9999,0
1653416745405,CSE 293,002,094906,Bellare; Mihir,9999,0,9999,0
1653416745405,CSE 293,003,094907,Berg-Kirkpatrick; Taylor D,9999,0,9999,0
1653416745405,CSE 293,004,094908,Christensen; Henrik I,9999,0,9999,0
1653416745405,CSE 293,005,094909,Cottrell; Garrison W,9999,0,9999,0
1653416745405,CSE 293,006,094910,Deutsch; Alin Bernard,9999,0,9999,0
1653416745405,CSE 293,007,094911,Esmaeilzadeh; Hadi,9999,0,9999,0
1653416745405,CSE 293,008,094912,Freund; Yoav,9999,0,9999,0
1653416745405,CSE 293,009,094913,Griswold; William G.,9999,0,9999,0
1653416745405,CSE 293,010,094914,Gymrek; Melissa Ann,9999,0,9999,0
1653416745405,CSE 293,011,094915,Heninger; Nadia A,9999,0,9999,0
1653416745405,CSE 293,012,094916,Impagliazzo; Russell,9999,0,9999,0
1653416745405,CSE 293,013,094917,Jhala; Ranjit,9999,0,9999,0
1653416745405,CSE 293,014,094918,Kahng; Andrew Byun,9999,0,9999,0
1653416745405,CSE 293,015,094919,Kane; Daniel Mertz,9999,0,9999,0
1653416745405,CSE 293,016,094920,Kriegman; David J,9999,0,9999,0
1653416745405,CSE 293,017,094921,Kumar; Arun Kumar,9999,0,9999,0
1653416745405,CSE 293,018,094922,Lerner; Sorin,9999,0,9999,0
1653416745405,CSE 293,019,094923,Lovett; Shachar,9999,0,9999,0
1653416745405,CSE 293,020,094924,McAuley; Julian John,9999,0,9999,0
1653416745405,CSE 293,021,094925,Micciancio; Daniele,9999,0,9999,0
1653416745405,CSE 293,022,094926,Orailoglu; Alex,9999,0,9999,0
1653416745405,CSE 293,023,094927,Paturi; Ramamohan,9999,0,9999,0
1653416745405,CSE 293,024,094928,Polikarpova; Nadezhda,9999,0,9999,0
1653416745405,CSE 293,025,094929,Politz; Joseph Gibbs,9999,0,9999,0
1653416745405,CSE 293,026,094930,Porter; George M,9999,0,9999,0
1653416745405,CSE 293,027,094931,Porter; Leonard Emerson,9999,0,9999,0
1653416745405,CSE 293,028,094932,Ramamoorthi; Ravi,9999,0,9999,0
1653416745405,CSE 293,029,094933,Sahoo; Debashis,9999,0,9999,0
1653416745405,CSE 293,030,094934,Saul; Lawrence,9999,0,9999,0
1653416745405,CSE 293,031,094935,Savage; Stefan,9999,0,9999,0
1653416745405,CSE 293,032,094936,Schulze; Jurgen P.,9999,0,9999,0
1653416745405,CSE 293,033,094937,Snoeren; Alex C.,9999,0,9999,0
1653416745405,CSE 293,034,094938,Shang; Jingbo,9999,0,9999,0
1653416745405,CSE 293,035,094939,Stefan; Deian,9999,0,9999,0
1653416745405,CSE 293,036,094940,Su; Hao,9999,0,9999,0
1653416745405,CSE 293,037,094941,Swanson; Steven James,9999,0,9999,0
1653416745405,CSE 293,038,094942,Tullsen; Dean Michael,9999,0,9999,0
1653416745405,CSE 293,039,094943,Voelker; Geoffrey M.,9999,0,9999,0
1653416745405,CSE 293,040,094944,Zhao; Jishen,9999,0,9999,0
1653416745405,CSE 293,041,094945,Zhou; Yuan-Yuan,9999,0,9999,0
1653416745405,CSE 293,042,094946,Gao; Sicun,9998,0,9999,1
1653416745405,CSE 293,043,094947,Weibel; Nadir,9999,0,9999,0
1653416745405,CSE 293,044,094948,Gupta; Rajesh K.,9999,0,9999,0
1653416745929,CSE 294,A00,090143,Porter; George M,9,0,10,1
1653416746455,DSE 200,A00,091799,Staff,50,0,50,0
1653416746990,DSE 203,A00,091800,Gupta; Amarnath,30,0,30,0
1653416747514,DSE 250,A00,091801,Deutsch; Alin Bernard,30,0,30,0
1653416748045,DSE 290,A00,091802,Altintas De Callaf; Ilkay,50,0,50,0
1653416748576,ECE 200,001,091003,Antipa; Nicholas A,9999,0,9999,0
1653416748576,ECE 200,002,091004,Atanasov; Nikolay A.,9999,0,9999,0
1653416748576,ECE 200,003,091005,Bharadia; Dinesh,9999,0,9999,0
1653416748576,ECE 200,004,091006,Cheng; Chung Kuan,9999,0,9999,0
1653416748576,ECE 200,005,091007,Cosman; Pamela C.,9999,0,9999,0
1653416748576,ECE 200,006,091008,Staff,9999,0,9999,0
1653416748576,ECE 200,007,091009,Dayeh; Shadi Ahmad,9999,0,9999,0
1653416748576,ECE 200,008,091010,Fainman; Yeshaiahu,9999,0,9999,0
1653416748576,ECE 200,009,091011,Ford; Joseph Earl,9999,0,9999,0
1653416748576,ECE 200,010,091012,Franceschetti; Massimo,9999,0,9999,0
1653416748576,ECE 200,011,091013,Fullerton; Eric E,9999,0,9999,0
1653416748576,ECE 200,012,091014,Galton; Ian A,9999,0,9999,0
1653416748576,ECE 200,013,091015,Gilja; Vikash,9999,0,9999,0
1653416748576,ECE 200,014,091016,Hall; Drew A.,9999,0,9999,0
1653416748576,ECE 200,015,091017,Hsueh; Tzu-Chien,9999,0,9999,0
1653416748576,ECE 200,016,091018,Javidi; Tara,9999,0,9999,0
1653416748576,ECE 200,017,091019,Kahng; Andrew Byun,9999,0,9999,0
1653416748576,ECE 200,018,091020,Kim; Young-Han,9999,0,9999,0
1653416748576,ECE 200,019,091021,Koushanfar; Farinaz,9999,0,9999,0
1653416748576,ECE 200,020,091022,Kuzum; Duygu,9999,0,9999,0
1653416748576,ECE 200,021,091023,Le; Hanh-Phuc,9999,0,9999,0
1653416748576,ECE 200,022,091024,Lin; Bill,9999,0,9999,0
1653416748576,ECE 200,023,091025,Liu; Zhaowei,9999,0,9999,0
1653416748576,ECE 200,024,091026,Lo; Yu-Hwa,9999,0,9999,0
1653416748576,ECE 200,025,091027,Lomakin; Vitaliy,9999,0,9999,0
1653416748576,ECE 200,026,091028,Mercier; Patrick Philip,9999,0,9999,0
1653416748576,ECE 200,027,091029,Meyer; Florian,9999,0,9999,0
1653416748576,ECE 200,028,091030,Milstein; Laurence B.,9999,0,9999,0
1653416748576,ECE 200,029,091031,Mir Arabbaygi; Siavash,9999,0,9999,0
1653416748576,ECE 200,030,091032,Mookherjea; Shayan,9999,0,9999,0
1653416748576,ECE 200,031,091033,Morris; Karcher William,9999,0,9999,0
1653416748576,ECE 200,032,091034,Ng; Tse Nga,9999,0,9999,0
1653416748576,ECE 200,033,091035,Nguyen; Truong Quang,9999,0,9999,0
1653416748576,ECE 200,034,091036,Nomura; Kenji,9999,0,9999,0
1653416748576,ECE 200,035,091037,Orlitsky; Alon,9999,0,9999,0
1653416748576,ECE 200,036,091038,Pal; Piya,9999,0,9999,0
1653416748576,ECE 200,037,091039,Papen; George C.,9999,0,9999,0
1653416748576,ECE 200,038,091040,Radic; Stojan,9999,0,9999,0
1653416748576,ECE 200,039,091041,Rao; Bhaskar D.,9999,0,9999,0
1653416748576,ECE 200,040,091042,Rao; Ramesh R,9999,0,9999,0
1653416748576,ECE 200,041,091043,Rebeiz; Gabriel,9999,0,9999,0
1653416748576,ECE 200,042,091044,Sanford; John R,9999,0,9999,0
1653416748576,ECE 200,043,091045,Siegel; Paul H.,9999,0,9999,0
1653416748576,ECE 200,044,091046,Sievenpiper; Daniel F.,9999,0,9999,0
1653416748576,ECE 200,045,091047,Sworder; David D.,9999,0,9999,0
1653416748576,ECE 200,046,091048,Taur; Yuan,9999,0,9999,0
1653416748576,ECE 200,047,091049,Touri; Behrouz,9999,0,9999,0
1653416748576,ECE 200,048,091050,Trivedi; Mohan M.,9999,0,9999,0
1653416748576,ECE 200,049,091051,Vardy; Alexander,9999,0,9999,0
1653416748576,ECE 200,050,091052,Vasconcelos; Nuno,9999,0,9999,0
1653416748576,ECE 200,051,091053,Wang; Xiaolong,9999,0,9999,0
1653416748576,ECE 200,052,091054,Xie; Pengtao,9999,0,9999,0
1653416748576,ECE 200,053,091055,Yip; Michael,9999,0,9999,0
1653416748576,ECE 200,054,091056,Zeger; Kenneth A.,9999,0,9999,0
1653416748576,ECE 200,055,091057,Zhang; Xinyu,9999,0,9999,0
1653416748576,ECE 200,056,091058,Turakhia; Yatish Girish,9999,0,9999,0
1653416748576,ECE 200,057,091059,Kang; Mingu,9999,0,9999,0
1653416748576,ECE 200,058,091060,Shi; Yuanyuan,9999,0,9999,0
1653416748576,ECE 200,059,091061,Wang; Edward Jay,9999,0,9999,0
1653416748576,ECE 200,060,091062,Zheng; Yang,9999,0,9999,0
1653416749101,ECE 203,A00,091065,Mercier; Patrick Philip,0,0,0,0
1653416749627,ECE 207A,A00,091605,Liu; Thomas Tao-Ming,0,0,0,0
1653416750153,ECE 212AN,A00,091068,Nomura; Kenji,0,0,0,0
1653416750677,ECE 222A,A00,091069,Rebeiz; Gabriel,0,0,0,0
1653416751201,ECE 225A,A00,091070,Orlitsky; Alon,0,0,0,0
1653416751727,ECE 230A,A00,091071,Nomura; Kenji,0,0,0,0
1653416752251,ECE 236A,A00,091072,Dayeh; Shadi Ahmad,0,0,0,0
1653416752778,ECE 238A,A00,091073,Luo; Jian,0,0,0,0
1653416752778,ECE 238A,B00,091074,Luo; Jian,0,0,0,0
1653416753302,ECE 240A,A00,091075,Radic; Stojan,0,0,0,0
1653416753828,ECE 247A,A00,091592,Shi; Lingyan,0,0,0,0
1653416754357,ECE 250,A00,091076,Touri; Behrouz,0,0,0,0
1653416754884,ECE 251C,A00,091078,Nguyen; Truong Quang,0,0,0,0
1653416755414,ECE 253,A00,091079,Cosman; Pamela C.,0,0,0,0
1653416755948,ECE 255A,A00,091080,Orlitsky; Alon,0,0,0,0
1653416756472,ECE 257A,A00,091081,Zhang; Xinyu,0,0,0,0
1653416756995,ECE 260A,A01,091084,Eldon; John,0,0,0,0
1653416757526,ECE 264C,A00,091085,Galton; Ian A,0,0,0,0
1653416758055,ECE 265C,A00,094889,Presti; Calogero Davide,0,0,0,9
1653416758578,ECE 266,A01,091087,Hall; Drew A.,0,0,0,0
1653416759628,ECE 271A,A00,091090,Vasconcelos; Nuno,0,0,0,0
1653416760154,ECE 272B,A00,091091,Sworder; David D.,0,0,0,0
1653416760688,ECE 275A,A00,091092,Meyer; Florian,0,0,0,0
1653416761210,ECE 277,A00,091093,An; Cheolhong,0,0,0,0
1653416761739,ECE 283,A00,091094,Le; Hanh-Phuc,0,0,0,0
1653416762267,ECE 284,A00,091095,Kang; Mingu,0,0,0,0
1653416762267,ECE 284,B00,091096,Wang; Edward Jay,0,0,0,0
1653416762789,ECE 285,A00,094334,Touri; Behrouz,0,0,0,0
1653416763321,ECE 289,A00,091097,Whelan; David Arthur,0,0,0,0
1653416763850,MATH 200A,A00,087414,Salehi Golsefidy; Alireza,7,0,8,1
1653416764371,MATH 202A,A00,087415,Gill; Philip E.,3,0,8,5
1653416764899,MATH 203A,A00,087416,Oprea; Dragos N.,6,0,8,2
1653416765422,MATH 204A,A00,087417,Kedlaya; Kiran S.,6,0,8,2
1653416765989,MATH 205,A00,087418,Sorensen; Claus M,6,0,8,2
1653416766510,MATH 206A,A00,087419,Izadi; Elham,7,0,8,1
1653416767035,MATH 207A,A00,087420,Mohammadi; Amir,6,0,8,2
1653416767564,MATH 208,A00,087421,Staff,9,0,10,1
1653416768092,MATH 209,A00,087422,Staff,10,0,10,0
1653416768616,MATH 218,A00,087423,Staff,10,0,10,0
1653416769163,MATH 220A,A00,087424,Novak; Jonathan I,7,0,8,1
1653416769685,MATH 231A,A00,087425,Bejenaru; Ioan,4,0,8,4
1653416770208,MATH 240A,A00,087426,Ebenfelt; Peter F,5,0,8,3
1653416770731,MATH 243,A00,087427,Staff,9,0,10,1
1653416771257,MATH 248,A00,087429,Staff,10,0,10,0
1653416771787,MATH 250A,A00,087430,Spolaor; Luca,5,0,8,3
1653416772309,MATH 257A,A00,087431,Spolaor; Luca,7,0,8,1
1653416772832,MATH 258,A00,087432,Staff,9,0,10,1
1653416773366,MATH 264A,A00,087433,Warnke; Lutz Peter,5,0,8,3
1653416773890,MATH 268,A00,087434,Staff,15,0,15,0
1653416774412,MATH 269,A00,087435,Staff,14,0,15,1
1653416774939,MATH 270A,A00,087436,Nie; Jiawang,0,0,8,8
1653416775463,MATH 272A,A00,087437,Tian; Xiaochuan,2,0,8,6
1653416775986,MATH 274,A01,087439,Cheng; Li-Tien,9,0,10,1
1653416775986,MATH 274,A02,087440,Cheng; Li-Tien,10,0,10,0
1653416776511,MATH 278A,A00,087441,Staff,8,0,10,2
1653416777144,MATH 278B,A00,087442,Staff,8,0,10,2
1653416777671,MATH 278C,A00,087443,Staff,8,0,10,2
1653416778211,MATH 280A,A00,087444,Zheng; Tianyi,0,0,8,8
1653416778737,MATH 281A,A00,087445,Bradic; Jelena,0,0,8,8
1653416779270,MATH 282A,A00,087446,Zhang; Danna,0,0,8,8
1653416779792,MATH 283,A00,087447,Tesler; Glenn,0,0,0,14
1653416780315,MATH 286,A00,087448,Kemp; Todd Aahron,6,0,8,2
1653416780852,MATH 287D,A00,087449,Bradic; Jelena,8,0,8,0
1653416781374,MATH 288,A00,087450,Staff,14,0,15,1
1653416781374,MATH 288,B00,087451,Staff,15,0,15,0
1653416781374,MATH 288,C00,087452,Staff,15,0,15,0
1653416781918,MATH 290A,A00,087453,Xu; Zhouli,7,0,8,1
1653416782441,MATH 291A,A00,087454,Xu; Zhouli,7,0,8,1
1653416782966,MATH 292,A00,087455,Staff,10,0,10,0
1653416783498,MATH 295,A00,087456,Staff,50,0,50,0
1653416784032,MATH 297,001,087457,Staff,998,0,999,1
1653417346927,COGS 200,A01,087991,Staff,48,0,50,2
1653417347457,COGS 201,A01,094504,Rangel; Lara M,17,0,25,8
1653417347978,COGS 203,A00,087992,Coulson; Seana M,19,0,20,1
1653417348510,COGS 210A,001,087993,Greene; Deanna Jacquelyn,9998,0,9999,1
1653417348510,COGS 210A,002,087994,Saygin; Ayse P,9999,0,9999,0
1653417348510,COGS 210A,003,087995,Xia; Haijun,9999,0,9999,0
1653417348510,COGS 210A,004,087996,Nitz; Douglas A.,9999,0,9999,0
1653417348510,COGS 210A,005,087997,Hollan; James D.,9999,0,9999,0
1653417348510,COGS 210A,006,087998,Deak; Gedeon O.,9998,0,9999,1
1653417348510,COGS 210A,007,087999,Rossano; Federico,9999,0,9999,0
1653417349031,COGS 211A,A00,088000,Coulson; Seana M,9997,0,9999,2
1653417349559,COGS 229,A00,088002,Staff,23,0,25,2
1653417350087,COGS 260,B00,094231,Staff,17,0,20,3
1653417350087,COGS 260,A00,088004,Nitz; Douglas A.,9998,0,9999,1
1653417350622,CSE 202,A00,090110,Paturi; Ramamohan,0,0,0,0
1653417350622,CSE 202,B00,090111,Paturi; Ramamohan,0,0,0,0
1653417351147,CSE 207B,A00,090112,Heninger; Nadia A,0,0,0,0
1653417351680,CSE 208,A00,094858,Micciancio; Daniele,0,0,0,0
1653417352203,CSE 210,A00,090113,Powell; Thomas Allan,0,0,0,0
1653417352724,CSE 219,A00,090898,Staff,0,0,0,0
1653417353247,CSE 221,A00,090114,Zhou; Yuan-Yuan,0,0,0,0
1653417353773,CSE 229A,A00,090115,Porter; George M,0,0,0,0
1653417354312,CSE 229C,A00,090116,Savage; Stefan,0,0,0,0
1653417354846,CSE 230,A00,090117,Jhala; Ranjit,0,0,0,0
1653417355376,CSE 232,A00,090118,Papakonstantinou; Yannis,0,0,0,0
1653417355902,CSE 239A,A00,090121,Kumar; Arun Kumar,0,0,0,0
1653417356426,CSE 239B,A00,090122,Jhala; Ranjit,0,0,0,0
1653417356956,CSE 240A,A00,090123,Zhao; Jishen,0,0,189,189
1653417357499,CSE 243A,A00,090124,Orailoglu; Alex,3,0,15,12
1653417358021,CSE 249B,A00,090125,Kahng; Andrew Byun,13,0,20,7
1653417358546,CSE 250A,A00,090126,Berg-Kirkpatrick; Taylor D,0,0,0,0
1653417359068,CSE 252A,A00,090127,Ochoa; Benjamin Lawrence,0,0,0,0
1653417359595,CSE 258,A01,090129,McAuley; Julian John,0,0,0,0
1653417360210,CSE 258R,A01,090131,McAuley; Julian John,0,0,0,0
1653417360735,CSE 274,A00,090132,Ramamoorthi; Ravi,0,0,0,0
1653417361264,CSE 276A,A00,090133,Christensen; Henrik I,0,0,0,0
1653417361805,CSE 276C,A00,090134,Christensen; Henrik I,0,0,0,0
1653417362331,CSE 290,A00,090135,Bafna; Vineet,0,0,0,0
1653417362331,CSE 290,B00,090136,Ramamoorthi; Ravi,0,0,0,0
1653417362331,CSE 290,C00,090137,Li; Tzumao,10,0,10,0
1653417362331,CSE 290,D00,090138,Zhou; Yuan-Yuan,10,0,10,0
1653417362331,CSE 290,E00,090139,Christensen; Henrik I,10,0,10,0
1653417362331,CSE 290,F00,094053,Shalev; Aaron D,0,0,0,0
1653417362860,CSE 291,A00,090140,Munyaka; Imani N. S.,0,0,0,0
1653417362860,CSE 291,B00,094880,Yu; Qi,0,0,0,0
1653417362860,CSE 291,C00,090142,Pannuto; Patrick William,0,0,0,0
1653417362860,CSE 291,D00,094881,Zhang; Yiying,0,0,0,0
1653417362860,CSE 291,E00,095118,Su; Hao,0,0,0,0
1653417363402,CSE 293,001,094905,Bafna; Vineet,9999,0,9999,0
1653417363402,CSE 293,002,094906,Bellare; Mihir,9999,0,9999,0
1653417363402,CSE 293,003,094907,Berg-Kirkpatrick; Taylor D,9999,0,9999,0
1653417363402,CSE 293,004,094908,Christensen; Henrik I,9999,0,9999,0
1653417363402,CSE 293,005,094909,Cottrell; Garrison W,9999,0,9999,0
1653417363402,CSE 293,006,094910,Deutsch; Alin Bernard,9999,0,9999,0
1653417363402,CSE 293,007,094911,Esmaeilzadeh; Hadi,9999,0,9999,0
1653417363402,CSE 293,008,094912,Freund; Yoav,9999,0,9999,0
1653417363402,CSE 293,009,094913,Griswold; William G.,9999,0,9999,0
1653417363402,CSE 293,010,094914,Gymrek; Melissa Ann,9999,0,9999,0
1653417363402,CSE 293,011,094915,Heninger; Nadia A,9999,0,9999,0
1653417363402,CSE 293,012,094916,Impagliazzo; Russell,9999,0,9999,0
1653417363402,CSE 293,013,094917,Jhala; Ranjit,9999,0,9999,0
1653417363402,CSE 293,014,094918,Kahng; Andrew Byun,9999,0,9999,0
1653417363402,CSE 293,015,094919,Kane; Daniel Mertz,9999,0,9999,0
1653417363402,CSE 293,016,094920,Kriegman; David J,9999,0,9999,0
1653417363402,CSE 293,017,094921,Kumar; Arun Kumar,9999,0,9999,0
1653417363402,CSE 293,018,094922,Lerner; Sorin,9999,0,9999,0
1653417363402,CSE 293,019,094923,Lovett; Shachar,9999,0,9999,0
1653417363402,CSE 293,020,094924,McAuley; Julian John,9999,0,9999,0
1653417363402,CSE 293,021,094925,Micciancio; Daniele,9999,0,9999,0
1653417363402,CSE 293,022,094926,Orailoglu; Alex,9999,0,9999,0
1653417363402,CSE 293,023,094927,Paturi; Ramamohan,9999,0,9999,0
1653417363402,CSE 293,024,094928,Polikarpova; Nadezhda,9999,0,9999,0
1653417363402,CSE 293,025,094929,Politz; Joseph Gibbs,9999,0,9999,0
1653417363402,CSE 293,026,094930,Porter; George M,9999,0,9999,0
1653417363402,CSE 293,027,094931,Porter; Leonard Emerson,9999,0,9999,0
1653417363402,CSE 293,028,094932,Ramamoorthi; Ravi,9999,0,9999,0
1653417363402,CSE 293,029,094933,Sahoo; Debashis,9999,0,9999,0
1653417363402,CSE 293,030,094934,Saul; Lawrence,9999,0,9999,0
1653417363402,CSE 293,031,094935,Savage; Stefan,9999,0,9999,0
1653417363402,CSE 293,032,094936,Schulze; Jurgen P.,9999,0,9999,0
1653417363402,CSE 293,033,094937,Snoeren; Alex C.,9999,0,9999,0
1653417363402,CSE 293,034,094938,Shang; Jingbo,9999,0,9999,0
1653417363402,CSE 293,035,094939,Stefan; Deian,9999,0,9999,0
1653417363402,CSE 293,036,094940,Su; Hao,9999,0,9999,0
1653417363402,CSE 293,037,094941,Swanson; Steven James,9999,0,9999,0
1653417363402,CSE 293,038,094942,Tullsen; Dean Michael,9999,0,9999,0
1653417363402,CSE 293,039,094943,Voelker; Geoffrey M.,9999,0,9999,0
1653417363402,CSE 293,040,094944,Zhao; Jishen,9999,0,9999,0
1653417363402,CSE 293,041,094945,Zhou; Yuan-Yuan,9999,0,9999,0
1653417363402,CSE 293,042,094946,Gao; Sicun,9998,0,9999,1
1653417363402,CSE 293,043,094947,Weibel; Nadir,9999,0,9999,0
1653417363402,CSE 293,044,094948,Gupta; Rajesh K.,9999,0,9999,0
1653417363938,CSE 294,A00,090143,Porter; George M,9,0,10,1
1653417364461,DSE 200,A00,091799,Staff,50,0,50,0
1653417364995,DSE 203,A00,091800,Gupta; Amarnath,30,0,30,0
1653417365522,DSE 250,A00,091801,Deutsch; Alin Bernard,30,0,30,0
1653417366046,DSE 290,A00,091802,Altintas De Callaf; Ilkay,50,0,50,0
1653417366577,ECE 200,001,091003,Antipa; Nicholas A,9999,0,9999,0
1653417366577,ECE 200,002,091004,Atanasov; Nikolay A.,9999,0,9999,0
1653417366577,ECE 200,003,091005,Bharadia; Dinesh,9999,0,9999,0
1653417366577,ECE 200,004,091006,Cheng; Chung Kuan,9999,0,9999,0
1653417366577,ECE 200,005,091007,Cosman; Pamela C.,9999,0,9999,0
1653417366577,ECE 200,006,091008,Staff,9999,0,9999,0
1653417366577,ECE 200,007,091009,Dayeh; Shadi Ahmad,9999,0,9999,0
1653417366577,ECE 200,008,091010,Fainman; Yeshaiahu,9999,0,9999,0
1653417366577,ECE 200,009,091011,Ford; Joseph Earl,9999,0,9999,0
1653417366577,ECE 200,010,091012,Franceschetti; Massimo,9999,0,9999,0
1653417366577,ECE 200,011,091013,Fullerton; Eric E,9999,0,9999,0
1653417366577,ECE 200,012,091014,Galton; Ian A,9999,0,9999,0
1653417366577,ECE 200,013,091015,Gilja; Vikash,9999,0,9999,0
1653417366577,ECE 200,014,091016,Hall; Drew A.,9999,0,9999,0
1653417366577,ECE 200,015,091017,Hsueh; Tzu-Chien,9999,0,9999,0
1653417366577,ECE 200,016,091018,Javidi; Tara,9999,0,9999,0
1653417366577,ECE 200,017,091019,Kahng; Andrew Byun,9999,0,9999,0
1653417366577,ECE 200,018,091020,Kim; Young-Han,9999,0,9999,0
1653417366577,ECE 200,019,091021,Koushanfar; Farinaz,9999,0,9999,0
1653417366577,ECE 200,020,091022,Kuzum; Duygu,9999,0,9999,0
1653417366577,ECE 200,021,091023,Le; Hanh-Phuc,9999,0,9999,0
1653417366577,ECE 200,022,091024,Lin; Bill,9999,0,9999,0
1653417366577,ECE 200,023,091025,Liu; Zhaowei,9999,0,9999,0
1653417366577,ECE 200,024,091026,Lo; Yu-Hwa,9999,0,9999,0
1653417366577,ECE 200,025,091027,Lomakin; Vitaliy,9999,0,9999,0
1653417366577,ECE 200,026,091028,Mercier; Patrick Philip,9999,0,9999,0
1653417366577,ECE 200,027,091029,Meyer; Florian,9999,0,9999,0
1653417366577,ECE 200,028,091030,Milstein; Laurence B.,9999,0,9999,0
1653417366577,ECE 200,029,091031,Mir Arabbaygi; Siavash,9999,0,9999,0
1653417366577,ECE 200,030,091032,Mookherjea; Shayan,9999,0,9999,0
1653417366577,ECE 200,031,091033,Morris; Karcher William,9999,0,9999,0
1653417366577,ECE 200,032,091034,Ng; Tse Nga,9999,0,9999,0
1653417366577,ECE 200,033,091035,Nguyen; Truong Quang,9999,0,9999,0
1653417366577,ECE 200,034,091036,Nomura; Kenji,9999,0,9999,0
1653417366577,ECE 200,035,091037,Orlitsky; Alon,9999,0,9999,0
1653417366577,ECE 200,036,091038,Pal; Piya,9999,0,9999,0
1653417366577,ECE 200,037,091039,Papen; George C.,9999,0,9999,0
1653417366577,ECE 200,038,091040,Radic; Stojan,9999,0,9999,0
1653417366577,ECE 200,039,091041,Rao; Bhaskar D.,9999,0,9999,0
1653417366577,ECE 200,040,091042,Rao; Ramesh R,9999,0,9999,0
1653417366577,ECE 200,041,091043,Rebeiz; Gabriel,9999,0,9999,0
1653417366577,ECE 200,042,091044,Sanford; John R,9999,0,9999,0
1653417366577,ECE 200,043,091045,Siegel; Paul H.,9999,0,9999,0
1653417366577,ECE 200,044,091046,Sievenpiper; Daniel F.,9999,0,9999,0
1653417366577,ECE 200,045,091047,Sworder; David D.,9999,0,9999,0
1653417366577,ECE 200,046,091048,Taur; Yuan,9999,0,9999,0
1653417366577,ECE 200,047,091049,Touri; Behrouz,9999,0,9999,0
1653417366577,ECE 200,048,091050,Trivedi; Mohan M.,9999,0,9999,0
1653417366577,ECE 200,049,091051,Vardy; Alexander,9999,0,9999,0
1653417366577,ECE 200,050,091052,Vasconcelos; Nuno,9999,0,9999,0
1653417366577,ECE 200,051,091053,Wang; Xiaolong,9999,0,9999,0
1653417366577,ECE 200,052,091054,Xie; Pengtao,9999,0,9999,0
1653417366577,ECE 200,053,091055,Yip; Michael,9999,0,9999,0
1653417366577,ECE 200,054,091056,Zeger; Kenneth A.,9999,0,9999,0
1653417366577,ECE 200,055,091057,Zhang; Xinyu,9999,0,9999,0
1653417366577,ECE 200,056,091058,Turakhia; Yatish Girish,9999,0,9999,0
1653417366577,ECE 200,057,091059,Kang; Mingu,9999,0,9999,0
1653417366577,ECE 200,058,091060,Shi; Yuanyuan,9999,0,9999,0
1653417366577,ECE 200,059,091061,Wang; Edward Jay,9999,0,9999,0
1653417366577,ECE 200,060,091062,Zheng; Yang,9999,0,9999,0
1653417367099,ECE 203,A00,091065,Mercier; Patrick Philip,0,0,0,0
1653417367716,ECE 207A,A00,091605,Liu; Thomas Tao-Ming,0,0,0,0
1653417368238,ECE 212AN,A00,091068,Nomura; Kenji,0,0,0,0
1653417368770,ECE 222A,A00,091069,Rebeiz; Gabriel,0,0,0,0
1653417369293,ECE 225A,A00,091070,Orlitsky; Alon,0,0,0,0
1653417369823,ECE 230A,A00,091071,Nomura; Kenji,0,0,0,0
1653417370345,ECE 236A,A00,091072,Dayeh; Shadi Ahmad,0,0,0,0
1653417370869,ECE 238A,A00,091073,Luo; Jian,0,0,0,0
1653417370869,ECE 238A,B00,091074,Luo; Jian,0,0,0,0
1653417371391,ECE 240A,A00,091075,Radic; Stojan,0,0,0,0
1653417371922,ECE 247A,A00,091592,Shi; Lingyan,0,0,0,0
1653417372446,ECE 250,A00,091076,Touri; Behrouz,0,0,0,0
1653417372972,ECE 251C,A00,091078,Nguyen; Truong Quang,0,0,0,0
1653417373501,ECE 253,A00,091079,Cosman; Pamela C.,0,0,0,0
1653417374033,ECE 255A,A00,091080,Orlitsky; Alon,0,0,0,0
1653417374560,ECE 257A,A00,091081,Zhang; Xinyu,0,0,0,0
1653417375086,ECE 260A,A01,091084,Eldon; John,0,0,0,0
1653417375614,ECE 264C,A00,091085,Galton; Ian A,0,0,0,0
1653417376138,ECE 265C,A00,094889,Presti; Calogero Davide,0,0,0,9
1653417376665,ECE 266,A01,091087,Hall; Drew A.,0,0,0,0
1653417377717,ECE 271A,A00,091090,Vasconcelos; Nuno,0,0,0,0
1653417378240,ECE 272B,A00,091091,Sworder; David D.,0,0,0,0
1653417378766,ECE 275A,A00,091092,Meyer; Florian,0,0,0,0
1653417379288,ECE 277,A00,091093,An; Cheolhong,0,0,0,0
1653417379813,ECE 283,A00,091094,Le; Hanh-Phuc,0,0,0,0
1653417380345,ECE 284,A00,091095,Kang; Mingu,0,0,0,0
1653417380345,ECE 284,B00,091096,Wang; Edward Jay,0,0,0,0
1653417380876,ECE 285,A00,094334,Touri; Behrouz,0,0,0,0
1653417381412,ECE 289,A00,091097,Whelan; David Arthur,0,0,0,0
1653417381935,MATH 200A,A00,087414,Salehi Golsefidy; Alireza,7,0,8,1
1653417382466,MATH 202A,A00,087415,Gill; Philip E.,3,0,8,5
1653417382989,MATH 203A,A00,087416,Oprea; Dragos N.,6,0,8,2
1653417383511,MATH 204A,A00,087417,Kedlaya; Kiran S.,6,0,8,2
1653417384039,MATH 205,A00,087418,Sorensen; Claus M,6,0,8,2
1653417384570,MATH 206A,A00,087419,Izadi; Elham,7,0,8,1
1653417385102,MATH 207A,A00,087420,Mohammadi; Amir,6,0,8,2
1653417385628,MATH 208,A00,087421,Staff,9,0,10,1
1653417386151,MATH 209,A00,087422,Staff,10,0,10,0
1653417386675,MATH 218,A00,087423,Staff,10,0,10,0
1653417387202,MATH 220A,A00,087424,Novak; Jonathan I,7,0,8,1
1653417387725,MATH 231A,A00,087425,Bejenaru; Ioan,4,0,8,4
1653417388261,MATH 240A,A00,087426,Ebenfelt; Peter F,5,0,8,3
1653417388786,MATH 243,A00,087427,Staff,9,0,10,1
1653417389313,MATH 248,A00,087429,Staff,10,0,10,0
1653417389837,MATH 250A,A00,087430,Spolaor; Luca,5,0,8,3
1653417390369,MATH 257A,A00,087431,Spolaor; Luca,7,0,8,1
1653417390898,MATH 258,A00,087432,Staff,9,0,10,1
1653417391425,MATH 264A,A00,087433,Warnke; Lutz Peter,5,0,8,3
1653417391952,MATH 268,A00,087434,Staff,15,0,15,0
1653417392476,MATH 269,A00,087435,Staff,14,0,15,1
1653417393012,MATH 270A,A00,087436,Nie; Jiawang,0,0,8,8
1653417393536,MATH 272A,A00,087437,Tian; Xiaochuan,2,0,8,6
1653417394060,MATH 274,A01,087439,Cheng; Li-Tien,9,0,10,1
1653417394060,MATH 274,A02,087440,Cheng; Li-Tien,10,0,10,0
1653417394582,MATH 278A,A00,087441,Staff,8,0,10,2
1653417395108,MATH 278B,A00,087442,Staff,8,0,10,2
1653417395630,MATH 278C,A00,087443,Staff,8,0,10,2
1653417396155,MATH 280A,A00,087444,Zheng; Tianyi,0,0,8,8
1653417396680,MATH 281A,A00,087445,Bradic; Jelena,0,0,8,8
1653417397204,MATH 282A,A00,087446,Zhang; Danna,0,0,8,8
1653417397730,MATH 283,A00,087447,Tesler; Glenn,0,0,0,14
1653417398252,MATH 286,A00,087448,Kemp; Todd Aahron,6,0,8,2
1653417398776,MATH 287D,A00,087449,Bradic; Jelena,8,0,8,0
1653417399306,MATH 288,A00,087450,Staff,14,0,15,1
1653417399306,MATH 288,B00,087451,Staff,15,0,15,0
1653417399306,MATH 288,C00,087452,Staff,15,0,15,0
1653417399828,MATH 290A,A00,087453,Xu; Zhouli,7,0,8,1
1653417400353,MATH 291A,A00,087454,Xu; Zhouli,7,0,8,1
1653417400877,MATH 292,A00,087455,Staff,10,0,10,0
1653417401400,MATH 295,A00,087456,Staff,50,0,50,0
1653417401928,MATH 297,001,087457,Staff,998,0,999,1
1653417965576,COGS 200,A01,087991,Staff,48,0,50,2
1653417966100,COGS 201,A01,094504,Rangel; Lara M,17,0,25,8
1653417966622,COGS 203,A00,087992,Coulson; Seana M,19,0,20,1
1653417967155,COGS 210A,001,087993,Greene; Deanna Jacquelyn,9998,0,9999,1
1653417967155,COGS 210A,002,087994,Saygin; Ayse P,9999,0,9999,0
1653417967155,COGS 210A,003,087995,Xia; Haijun,9999,0,9999,0
1653417967155,COGS 210A,004,087996,Nitz; Douglas A.,9999,0,9999,0
1653417967155,COGS 210A,005,087997,Hollan; James D.,9999,0,9999,0
1653417967155,COGS 210A,006,087998,Deak; Gedeon O.,9998,0,9999,1
1653417967155,COGS 210A,007,087999,Rossano; Federico,9999,0,9999,0
1653417967685,COGS 211A,A00,088000,Coulson; Seana M,9997,0,9999,2
1653417968211,COGS 229,A00,088002,Staff,23,0,25,2
1653417968742,COGS 260,B00,094231,Staff,17,0,20,3
1653417968742,COGS 260,A00,088004,Nitz; Douglas A.,9998,0,9999,1
1653417969291,CSE 202,A00,090110,Paturi; Ramamohan,0,0,0,0
1653417969291,CSE 202,B00,090111,Paturi; Ramamohan,0,0,0,0
1653417969818,CSE 207B,A00,090112,Heninger; Nadia A,0,0,0,0
1653417970347,CSE 208,A00,094858,Micciancio; Daniele,0,0,0,0
1653417970873,CSE 210,A00,090113,Powell; Thomas Allan,0,0,0,0
1653417971408,CSE 219,A00,090898,Staff,0,0,0,0
1653417971947,CSE 221,A00,090114,Zhou; Yuan-Yuan,0,0,0,0
1653417972473,CSE 229A,A00,090115,Porter; George M,0,0,0,0
1653417972996,CSE 229C,A00,090116,Savage; Stefan,0,0,0,0
1653417973519,CSE 230,A00,090117,Jhala; Ranjit,0,0,0,0
1653417974050,CSE 232,A00,090118,Papakonstantinou; Yannis,0,0,0,0
1653417974575,CSE 239A,A00,090121,Kumar; Arun Kumar,0,0,0,0
1653417975102,CSE 239B,A00,090122,Jhala; Ranjit,0,0,0,0
1653417975623,CSE 240A,A00,090123,Zhao; Jishen,0,0,189,189
1653417976159,CSE 243A,A00,090124,Orailoglu; Alex,3,0,15,12
1653417976691,CSE 249B,A00,090125,Kahng; Andrew Byun,13,0,20,7
1653417977219,CSE 250A,A00,090126,Berg-Kirkpatrick; Taylor D,0,0,0,0
1653417977750,CSE 252A,A00,090127,Ochoa; Benjamin Lawrence,0,0,0,0
1653417978274,CSE 258,A01,090129,McAuley; Julian John,0,0,0,0
1653417978804,CSE 258R,A01,090131,McAuley; Julian John,0,0,0,0
1653417979338,CSE 274,A00,090132,Ramamoorthi; Ravi,0,0,0,0
1653417979865,CSE 276A,A00,090133,Christensen; Henrik I,0,0,0,0
1653417980392,CSE 276C,A00,090134,Christensen; Henrik I,0,0,0,0
1653417980968,CSE 290,A00,090135,Bafna; Vineet,0,0,0,0
1653417980968,CSE 290,B00,090136,Ramamoorthi; Ravi,0,0,0,0
1653417980968,CSE 290,C00,090137,Li; Tzumao,10,0,10,0
1653417980968,CSE 290,D00,090138,Zhou; Yuan-Yuan,10,0,10,0
1653417980968,CSE 290,E00,090139,Christensen; Henrik I,10,0,10,0
1653417980968,CSE 290,F00,094053,Shalev; Aaron D,0,0,0,0
1653417981497,CSE 291,A00,090140,Munyaka; Imani N. S.,0,0,0,0
1653417981497,CSE 291,B00,094880,Yu; Qi,0,0,0,0
1653417981497,CSE 291,C00,090142,Pannuto; Patrick William,0,0,0,0
1653417981497,CSE 291,D00,094881,Zhang; Yiying,0,0,0,0
1653417981497,CSE 291,E00,095118,Su; Hao,0,0,0,0
1653417982030,CSE 293,001,094905,Bafna; Vineet,9999,0,9999,0
1653417982030,CSE 293,002,094906,Bellare; Mihir,9999,0,9999,0
1653417982030,CSE 293,003,094907,Berg-Kirkpatrick; Taylor D,9999,0,9999,0
1653417982030,CSE 293,004,094908,Christensen; Henrik I,9999,0,9999,0
1653417982030,CSE 293,005,094909,Cottrell; Garrison W,9999,0,9999,0
1653417982030,CSE 293,006,094910,Deutsch; Alin Bernard,9999,0,9999,0
1653417982030,CSE 293,007,094911,Esmaeilzadeh; Hadi,9999,0,9999,0
1653417982030,CSE 293,008,094912,Freund; Yoav,9999,0,9999,0
1653417982030,CSE 293,009,094913,Griswold; William G.,9999,0,9999,0
1653417982030,CSE 293,010,094914,Gymrek; Melissa Ann,9999,0,9999,0
1653417982030,CSE 293,011,094915,Heninger; Nadia A,9999,0,9999,0
1653417982030,CSE 293,012,094916,Impagliazzo; Russell,9999,0,9999,0
1653417982030,CSE 293,013,094917,Jhala; Ranjit,9999,0,9999,0
1653417982030,CSE 293,014,094918,Kahng; Andrew Byun,9999,0,9999,0
1653417982030,CSE 293,015,094919,Kane; Daniel Mertz,9999,0,9999,0
1653417982030,CSE 293,016,094920,Kriegman; David J,9999,0,9999,0
1653417982030,CSE 293,017,094921,Kumar; Arun Kumar,9999,0,9999,0
1653417982030,CSE 293,018,094922,Lerner; Sorin,9999,0,9999,0
1653417982030,CSE 293,019,094923,Lovett; Shachar,9999,0,9999,0
1653417982030,CSE 293,020,094924,McAuley; Julian John,9999,0,9999,0
1653417982030,CSE 293,021,094925,Micciancio; Daniele,9999,0,9999,0
1653417982030,CSE 293,022,094926,Orailoglu; Alex,9999,0,9999,0
1653417982030,CSE 293,023,094927,Paturi; Ramamohan,9999,0,9999,0
1653417982030,CSE 293,024,094928,Polikarpova; Nadezhda,9999,0,9999,0
1653417982030,CSE 293,025,094929,Politz; Joseph Gibbs,9999,0,9999,0
1653417982030,CSE 293,026,094930,Porter; George M,9999,0,9999,0
1653417982030,CSE 293,027,094931,Porter; Leonard Emerson,9999,0,9999,0
1653417982030,CSE 293,028,094932,Ramamoorthi; Ravi,9999,0,9999,0
1653417982030,CSE 293,029,094933,Sahoo; Debashis,9999,0,9999,0
1653417982030,CSE 293,030,094934,Saul; Lawrence,9999,0,9999,0
1653417982030,CSE 293,031,094935,Savage; Stefan,9999,0,9999,0
1653417982030,CSE 293,032,094936,Schulze; Jurgen P.,9999,0,9999,0
1653417982030,CSE 293,033,094937,Snoeren; Alex C.,9999,0,9999,0
1653417982030,CSE 293,034,094938,Shang; Jingbo,9999,0,9999,0
1653417982030,CSE 293,035,094939,Stefan; Deian,9999,0,9999,0
1653417982030,CSE 293,036,094940,Su; Hao,9999,0,9999,0
1653417982030,CSE 293,037,094941,Swanson; Steven James,9999,0,9999,0
1653417982030,CSE 293,038,094942,Tullsen; Dean Michael,9999,0,9999,0
1653417982030,CSE 293,039,094943,Voelker; Geoffrey M.,9999,0,9999,0
1653417982030,CSE 293,040,094944,Zhao; Jishen,9999,0,9999,0
1653417982030,CSE 293,041,094945,Zhou; Yuan-Yuan,9999,0,9999,0
1653417982030,CSE 293,042,094946,Gao; Sicun,9998,0,9999,1
1653417982030,CSE 293,043,094947,Weibel; Nadir,9999,0,9999,0
1653417982030,CSE 293,044,094948,Gupta; Rajesh K.,9999,0,9999,0
1653417982551,CSE 294,A00,090143,Porter; George M,9,0,10,1
1653417983077,DSE 200,A00,091799,Staff,50,0,50,0
1653417983601,DSE 203,A00,091800,Gupta; Amarnath,30,0,30,0
1653417984124,DSE 250,A00,091801,Deutsch; Alin Bernard,30,0,30,0
1653417984653,DSE 290,A00,091802,Altintas De Callaf; Ilkay,50,0,50,0
1653417985221,ECE 200,001,091003,Antipa; Nicholas A,9999,0,9999,0
1653417985221,ECE 200,002,091004,Atanasov; Nikolay A.,9999,0,9999,0
1653417985221,ECE 200,003,091005,Bharadia; Dinesh,9999,0,9999,0
1653417985221,ECE 200,004,091006,Cheng; Chung Kuan,9999,0,9999,0
1653417985221,ECE 200,005,091007,Cosman; Pamela C.,9999,0,9999,0
1653417985221,ECE 200,006,091008,Staff,9999,0,9999,0
1653417985221,ECE 200,007,091009,Dayeh; Shadi Ahmad,9999,0,9999,0
1653417985221,ECE 200,008,091010,Fainman; Yeshaiahu,9999,0,9999,0
1653417985221,ECE 200,009,091011,Ford; Joseph Earl,9999,0,9999,0
1653417985221,ECE 200,010,091012,Franceschetti; Massimo,9999,0,9999,0
1653417985221,ECE 200,011,091013,Fullerton; Eric E,9999,0,9999,0
1653417985221,ECE 200,012,091014,Galton; Ian A,9999,0,9999,0
1653417985221,ECE 200,013,091015,Gilja; Vikash,9999,0,9999,0
1653417985221,ECE 200,014,091016,Hall; Drew A.,9999,0,9999,0
1653417985221,ECE 200,015,091017,Hsueh; Tzu-Chien,9999,0,9999,0
1653417985221,ECE 200,016,091018,Javidi; Tara,9999,0,9999,0
1653417985221,ECE 200,017,091019,Kahng; Andrew Byun,9999,0,9999,0
1653417985221,ECE 200,018,091020,Kim; Young-Han,9999,0,9999,0
1653417985221,ECE 200,019,091021,Koushanfar; Farinaz,9999,0,9999,0
1653417985221,ECE 200,020,091022,Kuzum; Duygu,9999,0,9999,0
1653417985221,ECE 200,021,091023,Le; Hanh-Phuc,9999,0,9999,0
1653417985221,ECE 200,022,091024,Lin; Bill,9999,0,9999,0
1653417985221,ECE 200,023,091025,Liu; Zhaowei,9999,0,9999,0
1653417985221,ECE 200,024,091026,Lo; Yu-Hwa,9999,0,9999,0
1653417985221,ECE 200,025,091027,Lomakin; Vitaliy,9999,0,9999,0
1653417985221,ECE 200,026,091028,Mercier; Patrick Philip,9999,0,9999,0
1653417985221,ECE 200,027,091029,Meyer; Florian,9999,0,9999,0
1653417985221,ECE 200,028,091030,Milstein; Laurence B.,9999,0,9999,0
1653417985221,ECE 200,029,091031,Mir Arabbaygi; Siavash,9999,0,9999,0
1653417985221,ECE 200,030,091032,Mookherjea; Shayan,9999,0,9999,0
1653417985221,ECE 200,031,091033,Morris; Karcher William,9999,0,9999,0
1653417985221,ECE 200,032,091034,Ng; Tse Nga,9999,0,9999,0
1653417985221,ECE 200,033,091035,Nguyen; Truong Quang,9999,0,9999,0
1653417985221,ECE 200,034,091036,Nomura; Kenji,9999,0,9999,0
1653417985221,ECE 200,035,091037,Orlitsky; Alon,9999,0,9999,0
1653417985221,ECE 200,036,091038,Pal; Piya,9999,0,9999,0
1653417985221,ECE 200,037,091039,Papen; George C.,9999,0,9999,0
1653417985221,ECE 200,038,091040,Radic; Stojan,9999,0,9999,0
1653417985221,ECE 200,039,091041,Rao; Bhaskar D.,9999,0,9999,0
1653417985221,ECE 200,040,091042,Rao; Ramesh R,9999,0,9999,0
1653417985221,ECE 200,041,091043,Rebeiz; Gabriel,9999,0,9999,0
1653417985221,ECE 200,042,091044,Sanford; John R,9999,0,9999,0
1653417985221,ECE 200,043,091045,Siegel; Paul H.,9999,0,9999,0
1653417985221,ECE 200,044,091046,Sievenpiper; Daniel F.,9999,0,9999,0
1653417985221,ECE 200,045,091047,Sworder; David D.,9999,0,9999,0
1653417985221,ECE 200,046,091048,Taur; Yuan,9999,0,9999,0
1653417985221,ECE 200,047,091049,Touri; Behrouz,9999,0,9999,0
1653417985221,ECE 200,048,091050,Trivedi; Mohan M.,9999,0,9999,0
1653417985221,ECE 200,049,091051,Vardy; Alexander,9999,0,9999,0
1653417985221,ECE 200,050,091052,Vasconcelos; Nuno,9999,0,9999,0
1653417985221,ECE 200,051,091053,Wang; Xiaolong,9999,0,9999,0
1653417985221,ECE 200,052,091054,Xie; Pengtao,9999,0,9999,0
1653417985221,ECE 200,053,091055,Yip; Michael,9999,0,9999,0
1653417985221,ECE 200,054,091056,Zeger; Kenneth A.,9999,0,9999,0
1653417985221,ECE 200,055,091057,Zhang; Xinyu,9999,0,9999,0
1653417985221,ECE 200,056,091058,Turakhia; Yatish Girish,9999,0,9999,0
1653417985221,ECE 200,057,091059,Kang; Mingu,9999,0,9999,0
1653417985221,ECE 200,058,091060,Shi; Yuanyuan,9999,0,9999,0
1653417985221,ECE 200,059,091061,Wang; Edward Jay,9999,0,9999,0
1653417985221,ECE 200,060,091062,Zheng; Yang,9999,0,9999,0
1653417985753,ECE 203,A00,091065,Mercier; Patrick Philip,0,0,0,0
1653417986287,ECE 207A,A00,091605,Liu; Thomas Tao-Ming,0,0,0,0
1653417986814,ECE 212AN,A00,091068,Nomura; Kenji,0,0,0,0
1653417987343,ECE 222A,A00,091069,Rebeiz; Gabriel,0,0,0,0
1653417987889,ECE 225A,A00,091070,Orlitsky; Alon,0,0,0,0
1653417988427,ECE 230A,A00,091071,Nomura; Kenji,0,0,0,0
1653417988952,ECE 236A,A00,091072,Dayeh; Shadi Ahmad,0,0,0,0
1653417989483,ECE 238A,A00,091073,Luo; Jian,0,0,0,0
1653417989483,ECE 238A,B00,091074,Luo; Jian,0,0,0,0
1653417990008,ECE 240A,A00,091075,Radic; Stojan,0,0,0,0
1653417990532,ECE 247A,A00,091592,Shi; Lingyan,0,0,0,0
1653417991055,ECE 250,A00,091076,Touri; Behrouz,0,0,0,0
1653417991577,ECE 251C,A00,091078,Nguyen; Truong Quang,0,0,0,0
1653417992103,ECE 253,A00,091079,Cosman; Pamela C.,0,0,0,0
1653417992632,ECE 255A,A00,091080,Orlitsky; Alon,0,0,0,0
1653417993164,ECE 257A,A00,091081,Zhang; Xinyu,0,0,0,0
1653417993688,ECE 260A,A01,091084,Eldon; John,0,0,0,0
1653417994210,ECE 264C,A00,091085,Galton; Ian A,0,0,0,0
1653417994739,ECE 265C,A00,094889,Presti; Calogero Davide,0,0,0,9
1653417995269,ECE 266,A01,091087,Hall; Drew A.,0,0,0,0
1653417996326,ECE 271A,A00,091090,Vasconcelos; Nuno,0,0,0,0
1653417996858,ECE 272B,A00,091091,Sworder; David D.,0,0,0,0
1653417997385,ECE 275A,A00,091092,Meyer; Florian,0,0,0,0
1653417997917,ECE 277,A00,091093,An; Cheolhong,0,0,0,0
1653417998440,ECE 283,A00,091094,Le; Hanh-Phuc,0,0,0,0
1653417998975,ECE 284,A00,091095,Kang; Mingu,0,0,0,0
1653417998975,ECE 284,B00,091096,Wang; Edward Jay,0,0,0,0
1653417999499,ECE 285,A00,094334,Touri; Behrouz,0,0,0,0
1653418000035,ECE 289,A00,091097,Whelan; David Arthur,0,0,0,0
1653418000560,MATH 200A,A00,087414,Salehi Golsefidy; Alireza,7,0,8,1
1653418001090,MATH 202A,A00,087415,Gill; Philip E.,3,0,8,5
1653418001612,MATH 203A,A00,087416,Oprea; Dragos N.,6,0,8,2
1653418002138,MATH 204A,A00,087417,Kedlaya; Kiran S.,6,0,8,2
1653418002667,MATH 205,A00,087418,Sorensen; Claus M,6,0,8,2
1653418003195,MATH 206A,A00,087419,Izadi; Elham,7,0,8,1
1653418003726,MATH 207A,A00,087420,Mohammadi; Amir,6,0,8,2
1653418004267,MATH 208,A00,087421,Staff,9,0,10,1
1653418004794,MATH 209,A00,087422,Staff,10,0,10,0
1653418005327,MATH 218,A00,087423,Staff,10,0,10,0
1653418005866,MATH 220A,A00,087424,Novak; Jonathan I,7,0,8,1
1653418006388,MATH 231A,A00,087425,Bejenaru; Ioan,4,0,8,4
1653418006910,MATH 240A,A00,087426,Ebenfelt; Peter F,5,0,8,3
1653418007452,MATH 243,A00,087427,Staff,9,0,10,1
1653418007978,MATH 248,A00,087429,Staff,10,0,10,0
1653418008512,MATH 250A,A00,087430,Spolaor; Luca,5,0,8,3
1653418009042,MATH 257A,A00,087431,Spolaor; Luca,7,0,8,1
1653418009564,MATH 258,A00,087432,Staff,9,0,10,1
1653418010087,MATH 264A,A00,087433,Warnke; Lutz Peter,5,0,8,3
1653418010612,MATH 268,A00,087434,Staff,15,0,15,0
1653418011137,MATH 269,A00,087435,Staff,14,0,15,1
1653418011663,MATH 270A,A00,087436,Nie; Jiawang,0,0,8,8
1653418012285,MATH 272A,A00,087437,Tian; Xiaochuan,2,0,8,6
1653418012813,MATH 274,A01,087439,Cheng; Li-Tien,9,0,10,1
1653418012813,MATH 274,A02,087440,Cheng; Li-Tien,10,0,10,0
1653418013341,MATH 278A,A00,087441,Staff,8,0,10,2
1653418013863,MATH 278B,A00,087442,Staff,8,0,10,2
1653418014387,MATH 278C,A00,087443,Staff,8,0,10,2
1653418014918,MATH 280A,A00,087444,Zheng; Tianyi,0,0,8,8
1653418015449,MATH 281A,A00,087445,Bradic; Jelena,0,0,8,8
1653418015974,MATH 282A,A00,087446,Zhang; Danna,0,0,8,8
1653418016501,MATH 283,A00,087447,Tesler; Glenn,0,0,0,14
1653418017024,MATH 286,A00,087448,Kemp; Todd Aahron,6,0,8,2
1653418017550,MATH 287D,A00,087449,Bradic; Jelena,8,0,8,0
1653418018081,MATH 288,A00,087450,Staff,14,0,15,1
1653418018081,MATH 288,B00,087451,Staff,15,0,15,0
1653418018081,MATH 288,C00,087452,Staff,15,0,15,0
1653418018603,MATH 290A,A00,087453,Xu; Zhouli,7,0,8,1
1653418019137,MATH 291A,A00,087454,Xu; Zhouli,7,0,8,1
1653418019661,MATH 292,A00,087455,Staff,10,0,10,0
1653418020196,MATH 295,A00,087456,Staff,50,0,50,0
1653418020733,MATH 297,001,087457,Staff,998,0,999,1
1653418585000,COGS 200,A01,087991,Staff,48,0,50,2
1653418585530,COGS 201,A01,094504,Rangel; Lara M,17,0,25,8
1653418586052,COGS 203,A00,087992,Coulson; Seana M,19,0,20,1
1653418586581,COGS 210A,001,087993,Greene; Deanna Jacquelyn,9998,0,9999,1
1653418586581,COGS 210A,002,087994,Saygin; Ayse P,9999,0,9999,0
1653418586581,COGS 210A,003,087995,Xia; Haijun,9999,0,9999,0
1653418586581,COGS 210A,004,087996,Nitz; Douglas A.,9999,0,9999,0
1653418586581,COGS 210A,005,087997,Hollan; James D.,9999,0,9999,0
1653418586581,COGS 210A,006,087998,Deak; Gedeon O.,9998,0,9999,1
1653418586581,COGS 210A,007,087999,Rossano; Federico,9999,0,9999,0
1653418587113,COGS 211A,A00,088000,Coulson; Seana M,9997,0,9999,2
1653418587669,COGS 229,A00,088002,Staff,23,0,25,2
1653418588198,COGS 260,B00,094231,Staff,17,0,20,3
1653418588198,COGS 260,A00,088004,Nitz; Douglas A.,9998,0,9999,1
1653418588730,CSE 202,A00,090110,Paturi; Ramamohan,0,0,0,0
1653418588730,CSE 202,B00,090111,Paturi; Ramamohan,0,0,0,0
1653418589263,CSE 207B,A00,090112,Heninger; Nadia A,0,0,0,0
1653418589787,CSE 208,A00,094858,Micciancio; Daniele,0,0,0,0
1653418590321,CSE 210,A00,090113,Powell; Thomas Allan,0,0,0,0
1653418590847,CSE 219,A00,090898,Staff,0,0,0,0
1653418591372,CSE 221,A00,090114,Zhou; Yuan-Yuan,0,0,0,0
1653418591902,CSE 229A,A00,090115,Porter; George M,0,0,0,0
1653418592432,CSE 229C,A00,090116,Savage; Stefan,0,0,0,0
1653418592958,CSE 230,A00,090117,Jhala; Ranjit,0,0,0,0
1653418593481,CSE 232,A00,090118,Papakonstantinou; Yannis,0,0,0,0
1653418594007,CSE 239A,A00,090121,Kumar; Arun Kumar,0,0,0,0
1653418594530,CSE 239B,A00,090122,Jhala; Ranjit,0,0,0,0
1653418595055,CSE 240A,A00,090123,Zhao; Jishen,0,0,189,189
1653418595581,CSE 243A,A00,090124,Orailoglu; Alex,3,0,15,12
1653418596105,CSE 249B,A00,090125,Kahng; Andrew Byun,13,0,20,7
1653418596647,CSE 250A,A00,090126,Berg-Kirkpatrick; Taylor D,0,0,0,0
1653418597184,CSE 252A,A00,090127,Ochoa; Benjamin Lawrence,0,0,0,0
1653418597723,CSE 258,A01,090129,McAuley; Julian John,0,0,0,0
1653418598246,CSE 258R,A01,090131,McAuley; Julian John,0,0,0,0
1653418598770,CSE 274,A00,090132,Ramamoorthi; Ravi,0,0,0,0
1653418599297,CSE 276A,A00,090133,Christensen; Henrik I,0,0,0,0
1653418599822,CSE 276C,A00,090134,Christensen; Henrik I,0,0,0,0
1653418600354,CSE 290,A00,090135,Bafna; Vineet,0,0,0,0
1653418600354,CSE 290,B00,090136,Ramamoorthi; Ravi,0,0,0,0
1653418600354,CSE 290,C00,090137,Li; Tzumao,10,0,10,0
1653418600354,CSE 290,D00,090138,Zhou; Yuan-Yuan,10,0,10,0
1653418600354,CSE 290,E00,090139,Christensen; Henrik I,10,0,10,0
1653418600354,CSE 290,F00,094053,Shalev; Aaron D,0,0,0,0
1653418600889,CSE 291,A00,090140,Munyaka; Imani N. S.,0,0,0,0
1653418600889,CSE 291,B00,094880,Yu; Qi,0,0,0,0
1653418600889,CSE 291,C00,090142,Pannuto; Patrick William,0,0,0,0
1653418600889,CSE 291,D00,094881,Zhang; Yiying,0,0,0,0
1653418600889,CSE 291,E00,095118,Su; Hao,0,0,0,0
1653418601448,CSE 293,001,094905,Bafna; Vineet,9999,0,9999,0
1653418601448,CSE 293,002,094906,Bellare; Mihir,9999,0,9999,0
1653418601448,CSE 293,003,094907,Berg-Kirkpatrick; Taylor D,9999,0,9999,0
1653418601448,CSE 293,004,094908,Christensen; Henrik I,9999,0,9999,0
1653418601448,CSE 293,005,094909,Cottrell; Garrison W,9999,0,9999,0
1653418601448,CSE 293,006,094910,Deutsch; Alin Bernard,9999,0,9999,0
1653418601448,CSE 293,007,094911,Esmaeilzadeh; Hadi,9999,0,9999,0
1653418601448,CSE 293,008,094912,Freund; Yoav,9999,0,9999,0
1653418601448,CSE 293,009,094913,Griswold; William G.,9999,0,9999,0
1653418601448,CSE 293,010,094914,Gymrek; Melissa Ann,9999,0,9999,0
1653418601448,CSE 293,011,094915,Heninger; Nadia A,9999,0,9999,0
1653418601448,CSE 293,012,094916,Impagliazzo; Russell,9999,0,9999,0
1653418601448,CSE 293,013,094917,Jhala; Ranjit,9999,0,9999,0
1653418601448,CSE 293,014,094918,Kahng; Andrew Byun,9999,0,9999,0
1653418601448,CSE 293,015,094919,Kane; Daniel Mertz,9999,0,9999,0
1653418601448,CSE 293,016,094920,Kriegman; David J,9999,0,9999,0
1653418601448,CSE 293,017,094921,Kumar; Arun Kumar,9999,0,9999,0
1653418601448,CSE 293,018,094922,Lerner; Sorin,9999,0,9999,0
1653418601448,CSE 293,019,094923,Lovett; Shachar,9999,0,9999,0
1653418601448,CSE 293,020,094924,McAuley; Julian John,9999,0,9999,0
1653418601448,CSE 293,021,094925,Micciancio; Daniele,9999,0,9999,0
1653418601448,CSE 293,022,094926,Orailoglu; Alex,9999,0,9999,0
1653418601448,CSE 293,023,094927,Paturi; Ramamohan,9999,0,9999,0
1653418601448,CSE 293,024,094928,Polikarpova; Nadezhda,9999,0,9999,0
1653418601448,CSE 293,025,094929,Politz; Joseph Gibbs,9999,0,9999,0
1653418601448,CSE 293,026,094930,Porter; George M,9999,0,9999,0
1653418601448,CSE 293,027,094931,Porter; Leonard Emerson,9999,0,9999,0
1653418601448,CSE 293,028,094932,Ramamoorthi; Ravi,9999,0,9999,0
1653418601448,CSE 293,029,094933,Sahoo; Debashis,9999,0,9999,0
1653418601448,CSE 293,030,094934,Saul; Lawrence,9999,0,9999,0
1653418601448,CSE 293,031,094935,Savage; Stefan,9999,0,9999,0
1653418601448,CSE 293,032,094936,Schulze; Jurgen P.,9999,0,9999,0
1653418601448,CSE 293,033,094937,Snoeren; Alex C.,9999,0,9999,0
1653418601448,CSE 293,034,094938,Shang; Jingbo,9999,0,9999,0
1653418601448,CSE 293,035,094939,Stefan; Deian,9999,0,9999,0
1653418601448,CSE 293,036,094940,Su; Hao,9999,0,9999,0
1653418601448,CSE 293,037,094941,Swanson; Steven James,9999,0,9999,0
1653418601448,CSE 293,038,094942,Tullsen; Dean Michael,9999,0,9999,0
1653418601448,CSE 293,039,094943,Voelker; Geoffrey M.,9999,0,9999,0
1653418601448,CSE 293,040,094944,Zhao; Jishen,9999,0,9999,0
1653418601448,CSE 293,041,094945,Zhou; Yuan-Yuan,9999,0,9999,0
1653418601448,CSE 293,042,094946,Gao; Sicun,9998,0,9999,1
1653418601448,CSE 293,043,094947,Weibel; Nadir,9999,0,9999,0
1653418601448,CSE 293,044,094948,Gupta; Rajesh K.,9999,0,9999,0
1653418601974,CSE 294,A00,090143,Porter; George M,9,0,10,1
1653418602499,DSE 200,A00,091799,Staff,50,0,50,0
1653418603036,DSE 203,A00,091800,Gupta; Amarnath,30,0,30,0
1653418603562,DSE 250,A00,091801,Deutsch; Alin Bernard,30,0,30,0
1653418604160,DSE 290,A00,091802,Altintas De Callaf; Ilkay,50,0,50,0
1653418604707,ECE 200,001,091003,Antipa; Nicholas A,9999,0,9999,0
1653418604707,ECE 200,002,091004,Atanasov; Nikolay A.,9999,0,9999,0
1653418604707,ECE 200,003,091005,Bharadia; Dinesh,9999,0,9999,0
1653418604707,ECE 200,004,091006,Cheng; Chung Kuan,9999,0,9999,0
1653418604707,ECE 200,005,091007,Cosman; Pamela C.,9999,0,9999,0
1653418604707,ECE 200,006,091008,Staff,9999,0,9999,0
1653418604707,ECE 200,007,091009,Dayeh; Shadi Ahmad,9999,0,9999,0
1653418604707,ECE 200,008,091010,Fainman; Yeshaiahu,9999,0,9999,0
1653418604707,ECE 200,009,091011,Ford; Joseph Earl,9999,0,9999,0
1653418604707,ECE 200,010,091012,Franceschetti; Massimo,9999,0,9999,0
1653418604707,ECE 200,011,091013,Fullerton; Eric E,9999,0,9999,0
1653418604707,ECE 200,012,091014,Galton; Ian A,9999,0,9999,0
1653418604707,ECE 200,013,091015,Gilja; Vikash,9999,0,9999,0
1653418604707,ECE 200,014,091016,Hall; Drew A.,9999,0,9999,0
1653418604707,ECE 200,015,091017,Hsueh; Tzu-Chien,9999,0,9999,0
1653418604707,ECE 200,016,091018,Javidi; Tara,9999,0,9999,0
1653418604707,ECE 200,017,091019,Kahng; Andrew Byun,9999,0,9999,0
1653418604707,ECE 200,018,091020,Kim; Young-Han,9999,0,9999,0
1653418604707,ECE 200,019,091021,Koushanfar; Farinaz,9999,0,9999,0
1653418604707,ECE 200,020,091022,Kuzum; Duygu,9999,0,9999,0
1653418604707,ECE 200,021,091023,Le; Hanh-Phuc,9999,0,9999,0
1653418604707,ECE 200,022,091024,Lin; Bill,9999,0,9999,0
1653418604707,ECE 200,023,091025,Liu; Zhaowei,9999,0,9999,0
1653418604707,ECE 200,024,091026,Lo; Yu-Hwa,9999,0,9999,0
1653418604707,ECE 200,025,091027,Lomakin; Vitaliy,9999,0,9999,0
1653418604707,ECE 200,026,091028,Mercier; Patrick Philip,9999,0,9999,0
1653418604707,ECE 200,027,091029,Meyer; Florian,9999,0,9999,0
1653418604707,ECE 200,028,091030,Milstein; Laurence B.,9999,0,9999,0
1653418604707,ECE 200,029,091031,Mir Arabbaygi; Siavash,9999,0,9999,0
1653418604707,ECE 200,030,091032,Mookherjea; Shayan,9999,0,9999,0
1653418604707,ECE 200,031,091033,Morris; Karcher William,9999,0,9999,0
1653418604707,ECE 200,032,091034,Ng; Tse Nga,9999,0,9999,0
1653418604707,ECE 200,033,091035,Nguyen; Truong Quang,9999,0,9999,0
1653418604707,ECE 200,034,091036,Nomura; Kenji,9999,0,9999,0
1653418604707,ECE 200,035,091037,Orlitsky; Alon,9999,0,9999,0
1653418604707,ECE 200,036,091038,Pal; Piya,9999,0,9999,0
1653418604707,ECE 200,037,091039,Papen; George C.,9999,0,9999,0
1653418604707,ECE 200,038,091040,Radic; Stojan,9999,0,9999,0
1653418604707,ECE 200,039,091041,Rao; Bhaskar D.,9999,0,9999,0
1653418604707,ECE 200,040,091042,Rao; Ramesh R,9999,0,9999,0
1653418604707,ECE 200,041,091043,Rebeiz; Gabriel,9999,0,9999,0
1653418604707,ECE 200,042,091044,Sanford; John R,9999,0,9999,0
1653418604707,ECE 200,043,091045,Siegel; Paul H.,9999,0,9999,0
1653418604707,ECE 200,044,091046,Sievenpiper; Daniel F.,9999,0,9999,0
1653418604707,ECE 200,045,091047,Sworder; David D.,9999,0,9999,0
1653418604707,ECE 200,046,091048,Taur; Yuan,9999,0,9999,0
1653418604707,ECE 200,047,091049,Touri; Behrouz,9999,0,9999,0
1653418604707,ECE 200,048,091050,Trivedi; Mohan M.,9999,0,9999,0
1653418604707,ECE 200,049,091051,Vardy; Alexander,9999,0,9999,0
1653418604707,ECE 200,050,091052,Vasconcelos; Nuno,9999,0,9999,0
1653418604707,ECE 200,051,091053,Wang; Xiaolong,9999,0,9999,0
1653418604707,ECE 200,052,091054,Xie; Pengtao,9999,0,9999,0
1653418604707,ECE 200,053,091055,Yip; Michael,9999,0,9999,0
1653418604707,ECE 200,054,091056,Zeger; Kenneth A.,9999,0,9999,0
1653418604707,ECE 200,055,091057,Zhang; Xinyu,9999,0,9999,0
1653418604707,ECE 200,056,091058,Turakhia; Yatish Girish,9999,0,9999,0
1653418604707,ECE 200,057,091059,Kang; Mingu,9999,0,9999,0
1653418604707,ECE 200,058,091060,Shi; Yuanyuan,9999,0,9999,0
1653418604707,ECE 200,059,091061,Wang; Edward Jay,9999,0,9999,0
1653418604707,ECE 200,060,091062,Zheng; Yang,9999,0,9999,0
1653418605230,ECE 203,A00,091065,Mercier; Patrick Philip,0,0,0,0
1653418605753,ECE 207A,A00,091605,Liu; Thomas Tao-Ming,0,0,0,0
1653418606280,ECE 212AN,A00,091068,Nomura; Kenji,0,0,0,0
1653418606802,ECE 222A,A00,091069,Rebeiz; Gabriel,0,0,0,0
1653418607325,ECE 225A,A00,091070,Orlitsky; Alon,0,0,0,0
1653418607846,ECE 230A,A00,091071,Nomura; Kenji,0,0,0,0
1653418608368,ECE 236A,A00,091072,Dayeh; Shadi Ahmad,0,0,0,0
1653418608892,ECE 238A,A00,091073,Luo; Jian,0,0,0,0
1653418608892,ECE 238A,B00,091074,Luo; Jian,0,0,0,0
1653418609416,ECE 240A,A00,091075,Radic; Stojan,0,0,0,0
1653418609939,ECE 247A,A00,091592,Shi; Lingyan,0,0,0,0
1653418610464,ECE 250,A00,091076,Touri; Behrouz,0,0,0,0
1653418610989,ECE 251C,A00,091078,Nguyen; Truong Quang,0,0,0,0
1653418611584,ECE 253,A00,091079,Cosman; Pamela C.,0,0,0,0
1653418612107,ECE 255A,A00,091080,Orlitsky; Alon,0,0,0,0
1653418612629,ECE 257A,A00,091081,Zhang; Xinyu,0,0,0,0
1653418613163,ECE 260A,A01,091084,Eldon; John,0,0,0,0
1653418613703,ECE 264C,A00,091085,Galton; Ian A,0,0,0,0
1653418614236,ECE 265C,A00,094889,Presti; Calogero Davide,0,0,0,9
1653418614761,ECE 266,A01,091087,Hall; Drew A.,0,0,0,0
1653418615806,ECE 271A,A00,091090,Vasconcelos; Nuno,0,0,0,0
1653418616328,ECE 272B,A00,091091,Sworder; David D.,0,0,0,0
1653418616850,ECE 275A,A00,091092,Meyer; Florian,0,0,0,0
1653418617376,ECE 277,A00,091093,An; Cheolhong,0,0,0,0
1653418617901,ECE 283,A00,091094,Le; Hanh-Phuc,0,0,0,0
1653418618437,ECE 284,A00,091095,Kang; Mingu,0,0,0,0
1653418618437,ECE 284,B00,091096,Wang; Edward Jay,0,0,0,0
1653418618970,ECE 285,A00,094334,Touri; Behrouz,0,0,0,0
1653418619506,ECE 289,A00,091097,Whelan; David Arthur,0,0,0,0
1653418620029,MATH 200A,A00,087414,Salehi Golsefidy; Alireza,7,0,8,1
1653418620561,MATH 202A,A00,087415,Gill; Philip E.,3,0,8,5
1653418621087,MATH 203A,A00,087416,Oprea; Dragos N.,6,0,8,2
1653418621611,MATH 204A,A00,087417,Kedlaya; Kiran S.,6,0,8,2
1653418622141,MATH 205,A00,087418,Sorensen; Claus M,6,0,8,2
1653418622666,MATH 206A,A00,087419,Izadi; Elham,7,0,8,1
1653418623191,MATH 207A,A00,087420,Mohammadi; Amir,6,0,8,2
1653418623718,MATH 208,A00,087421,Staff,9,0,10,1
1653418624241,MATH 209,A00,087422,Staff,10,0,10,0
1653418624798,MATH 218,A00,087423,Staff,10,0,10,0
1653418625328,MATH 220A,A00,087424,Novak; Jonathan I,7,0,8,1
1653418625851,MATH 231A,A00,087425,Bejenaru; Ioan,4,0,8,4
1653418626376,MATH 240A,A00,087426,Ebenfelt; Peter F,5,0,8,3
1653418626898,MATH 243,A00,087427,Staff,9,0,10,1
1653418627425,MATH 248,A00,087429,Staff,10,0,10,0
1653418627947,MATH 250A,A00,087430,Spolaor; Luca,5,0,8,3
1653418628476,MATH 257A,A00,087431,Spolaor; Luca,7,0,8,1
1653418628999,MATH 258,A00,087432,Staff,9,0,10,1
1653418629531,MATH 264A,A00,087433,Warnke; Lutz Peter,5,0,8,3
1653418630054,MATH 268,A00,087434,Staff,15,0,15,0
1653418630580,MATH 269,A00,087435,Staff,14,0,15,1
1653418631109,MATH 270A,A00,087436,Nie; Jiawang,0,0,8,8
1653418631634,MATH 272A,A00,087437,Tian; Xiaochuan,2,0,8,6
1653418632163,MATH 274,A01,087439,Cheng; Li-Tien,9,0,10,1
1653418632163,MATH 274,A02,087440,Cheng; Li-Tien,10,0,10,0
1653418632686,MATH 278A,A00,087441,Staff,8,0,10,2
1653418633208,MATH 278B,A00,087442,Staff,8,0,10,2
1653418633731,MATH 278C,A00,087443,Staff,8,0,10,2
1653418634256,MATH 280A,A00,087444,Zheng; Tianyi,0,0,8,8
1653418634783,MATH 281A,A00,087445,Bradic; Jelena,0,0,8,8
1653418635308,MATH 282A,A00,087446,Zhang; Danna,0,0,8,8
1653418635834,MATH 283,A00,087447,Tesler; Glenn,0,0,0,14
1653418636374,MATH 286,A00,087448,Kemp; Todd Aahron,6,0,8,2
1653418636903,MATH 287D,A00,087449,Bradic; Jelena,8,0,8,0
1653418637441,MATH 288,A00,087450,Staff,14,0,15,1
1653418637441,MATH 288,B00,087451,Staff,15,0,15,0
1653418637441,MATH 288,C00,087452,Staff,15,0,15,0
1653418637964,MATH 290A,A00,087453,Xu; Zhouli,7,0,8,1
1653418638487,MATH 291A,A00,087454,Xu; Zhouli,7,0,8,1
1653418639011,MATH 292,A00,087455,Staff,10,0,10,0
1653418639532,MATH 295,A00,087456,Staff,50,0,50,0
1653418640057,MATH 297,001,087457,Staff,998,0,999,1
1653419202945,COGS 200,A01,087991,Staff,48,0,50,2
1653419203468,COGS 201,A01,094504,Rangel; Lara M,17,0,25,8
1653419203990,COGS 203,A00,087992,Coulson; Seana M,19,0,20,1
1653419204514,COGS 210A,001,087993,Greene; Deanna Jacquelyn,9998,0,9999,1
1653419204514,COGS 210A,002,087994,Saygin; Ayse P,9999,0,9999,0
1653419204514,COGS 210A,003,087995,Xia; Haijun,9999,0,9999,0
1653419204514,COGS 210A,004,087996,Nitz; Douglas A.,9999,0,9999,0
1653419204514,COGS 210A,005,087997,Hollan; James D.,9999,0,9999,0
1653419204514,COGS 210A,006,087998,Deak; Gedeon O.,9998,0,9999,1
1653419204514,COGS 210A,007,087999,Rossano; Federico,9999,0,9999,0
1653419205050,COGS 211A,A00,088000,Coulson; Seana M,9997,0,9999,2
1653419205577,COGS 229,A00,088002,Staff,23,0,25,2
1653419206106,COGS 260,B00,094231,Staff,17,0,20,3
1653419206106,COGS 260,A00,088004,Nitz; Douglas A.,9998,0,9999,1
1653419206645,CSE 202,A00,090110,Paturi; Ramamohan,0,0,0,0
1653419206645,CSE 202,B00,090111,Paturi; Ramamohan,0,0,0,0
1653419207180,CSE 207B,A00,090112,Heninger; Nadia A,0,0,0,0
1653419207707,CSE 208,A00,094858,Micciancio; Daniele,0,0,0,0
1653419208228,CSE 210,A00,090113,Powell; Thomas Allan,0,0,0,0
1653419208753,CSE 219,A00,090898,Staff,0,0,0,0
1653419209283,CSE 221,A00,090114,Zhou; Yuan-Yuan,0,0,0,0
1653419209806,CSE 229A,A00,090115,Porter; George M,0,0,0,0
1653419210348,CSE 229C,A00,090116,Savage; Stefan,0,0,0,0
1653419210879,CSE 230,A00,090117,Jhala; Ranjit,0,0,0,0
1653419211411,CSE 232,A00,090118,Papakonstantinou; Yannis,0,0,0,0
1653419211932,CSE 239A,A00,090121,Kumar; Arun Kumar,0,0,0,0
1653419212458,CSE 239B,A00,090122,Jhala; Ranjit,0,0,0,0
1653419212983,CSE 240A,A00,090123,Zhao; Jishen,0,0,189,189
1653419213516,CSE 243A,A00,090124,Orailoglu; Alex,3,0,15,12
1653419214042,CSE 249B,A00,090125,Kahng; Andrew Byun,13,0,20,7
1653419214569,CSE 250A,A00,090126,Berg-Kirkpatrick; Taylor D,0,0,0,0
1653419215099,CSE 252A,A00,090127,Ochoa; Benjamin Lawrence,0,0,0,0
1653419215625,CSE 258,A01,090129,McAuley; Julian John,0,0,0,0
1653419216151,CSE 258R,A01,090131,McAuley; Julian John,0,0,0,0
1653419216690,CSE 274,A00,090132,Ramamoorthi; Ravi,0,0,0,0
1653419217228,CSE 276A,A00,090133,Christensen; Henrik I,0,0,0,0
1653419217759,CSE 276C,A00,090134,Christensen; Henrik I,0,0,0,0
1653419218287,CSE 290,A00,090135,Bafna; Vineet,0,0,0,0
1653419218287,CSE 290,B00,090136,Ramamoorthi; Ravi,0,0,0,0
1653419218287,CSE 290,C00,090137,Li; Tzumao,10,0,10,0
1653419218287,CSE 290,D00,090138,Zhou; Yuan-Yuan,10,0,10,0
1653419218287,CSE 290,E00,090139,Christensen; Henrik I,10,0,10,0
1653419218287,CSE 290,F00,094053,Shalev; Aaron D,0,0,0,0
1653419218818,CSE 291,A00,090140,Munyaka; Imani N. S.,0,0,0,0
1653419218818,CSE 291,B00,094880,Yu; Qi,0,0,0,0
1653419218818,CSE 291,C00,090142,Pannuto; Patrick William,0,0,0,0
1653419218818,CSE 291,D00,094881,Zhang; Yiying,0,0,0,0
1653419218818,CSE 291,E00,095118,Su; Hao,0,0,0,0
1653419219344,CSE 293,001,094905,Bafna; Vineet,9999,0,9999,0
1653419219344,CSE 293,002,094906,Bellare; Mihir,9999,0,9999,0
1653419219344,CSE 293,003,094907,Berg-Kirkpatrick; Taylor D,9999,0,9999,0
1653419219344,CSE 293,004,094908,Christensen; Henrik I,9999,0,9999,0
1653419219344,CSE 293,005,094909,Cottrell; Garrison W,9999,0,9999,0
1653419219344,CSE 293,006,094910,Deutsch; Alin Bernard,9999,0,9999,0
1653419219344,CSE 293,007,094911,Esmaeilzadeh; Hadi,9999,0,9999,0
1653419219344,CSE 293,008,094912,Freund; Yoav,9999,0,9999,0
1653419219344,CSE 293,009,094913,Griswold; William G.,9999,0,9999,0
1653419219344,CSE 293,010,094914,Gymrek; Melissa Ann,9999,0,9999,0
1653419219344,CSE 293,011,094915,Heninger; Nadia A,9999,0,9999,0
1653419219344,CSE 293,012,094916,Impagliazzo; Russell,9999,0,9999,0
1653419219344,CSE 293,013,094917,Jhala; Ranjit,9999,0,9999,0
1653419219344,CSE 293,014,094918,Kahng; Andrew Byun,9999,0,9999,0
1653419219344,CSE 293,015,094919,Kane; Daniel Mertz,9999,0,9999,0
1653419219344,CSE 293,016,094920,Kriegman; David J,9999,0,9999,0
1653419219344,CSE 293,017,094921,Kumar; Arun Kumar,9999,0,9999,0
1653419219344,CSE 293,018,094922,Lerner; Sorin,9999,0,9999,0
1653419219344,CSE 293,019,094923,Lovett; Shachar,9999,0,9999,0
1653419219344,CSE 293,020,094924,McAuley; Julian John,9999,0,9999,0
1653419219344,CSE 293,021,094925,Micciancio; Daniele,9999,0,9999,0
1653419219344,CSE 293,022,094926,Orailoglu; Alex,9999,0,9999,0
1653419219344,CSE 293,023,094927,Paturi; Ramamohan,9999,0,9999,0
1653419219344,CSE 293,024,094928,Polikarpova; Nadezhda,9999,0,9999,0
1653419219344,CSE 293,025,094929,Politz; Joseph Gibbs,9999,0,9999,0
1653419219344,CSE 293,026,094930,Porter; George M,9999,0,9999,0
1653419219344,CSE 293,027,094931,Porter; Leonard Emerson,9999,0,9999,0
1653419219344,CSE 293,028,094932,Ramamoorthi; Ravi,9999,0,9999,0
1653419219344,CSE 293,029,094933,Sahoo; Debashis,9999,0,9999,0
1653419219344,CSE 293,030,094934,Saul; Lawrence,9999,0,9999,0
1653419219344,CSE 293,031,094935,Savage; Stefan,9999,0,9999,0
1653419219344,CSE 293,032,094936,Schulze; Jurgen P.,9999,0,9999,0
1653419219344,CSE 293,033,094937,Snoeren; Alex C.,9999,0,9999,0
1653419219344,CSE 293,034,094938,Shang; Jingbo,9999,0,9999,0
1653419219344,CSE 293,035,094939,Stefan; Deian,9999,0,9999,0
1653419219344,CSE 293,036,094940,Su; Hao,9999,0,9999,0
1653419219344,CSE 293,037,094941,Swanson; Steven James,9999,0,9999,0
1653419219344,CSE 293,038,094942,Tullsen; Dean Michael,9999,0,9999,0
1653419219344,CSE 293,039,094943,Voelker; Geoffrey M.,9999,0,9999,0
1653419219344,CSE 293,040,094944,Zhao; Jishen,9999,0,9999,0
1653419219344,CSE 293,041,094945,Zhou; Yuan-Yuan,9999,0,9999,0
1653419219344,CSE 293,042,094946,Gao; Sicun,9998,0,9999,1
1653419219344,CSE 293,043,094947,Weibel; Nadir,9999,0,9999,0
1653419219344,CSE 293,044,094948,Gupta; Rajesh K.,9999,0,9999,0
1653419219869,CSE 294,A00,090143,Porter; George M,9,0,10,1
1653419220393,DSE 200,A00,091799,Staff,50,0,50,0
1653419220915,DSE 203,A00,091800,Gupta; Amarnath,30,0,30,0
1653419221446,DSE 250,A00,091801,Deutsch; Alin Bernard,30,0,30,0
1653419221982,DSE 290,A00,091802,Altintas De Callaf; Ilkay,50,0,50,0
1653419222536,ECE 200,001,091003,Antipa; Nicholas A,9999,0,9999,0
1653419222536,ECE 200,002,091004,Atanasov; Nikolay A.,9999,0,9999,0
1653419222536,ECE 200,003,091005,Bharadia; Dinesh,9999,0,9999,0
1653419222536,ECE 200,004,091006,Cheng; Chung Kuan,9999,0,9999,0
1653419222536,ECE 200,005,091007,Cosman; Pamela C.,9999,0,9999,0
1653419222536,ECE 200,006,091008,Staff,9999,0,9999,0
1653419222536,ECE 200,007,091009,Dayeh; Shadi Ahmad,9999,0,9999,0
1653419222536,ECE 200,008,091010,Fainman; Yeshaiahu,9999,0,9999,0
1653419222536,ECE 200,009,091011,Ford; Joseph Earl,9999,0,9999,0
1653419222536,ECE 200,010,091012,Franceschetti; Massimo,9999,0,9999,0
1653419222536,ECE 200,011,091013,Fullerton; Eric E,9999,0,9999,0
1653419222536,ECE 200,012,091014,Galton; Ian A,9999,0,9999,0
1653419222536,ECE 200,013,091015,Gilja; Vikash,9999,0,9999,0
1653419222536,ECE 200,014,091016,Hall; Drew A.,9999,0,9999,0
1653419222536,ECE 200,015,091017,Hsueh; Tzu-Chien,9999,0,9999,0
1653419222536,ECE 200,016,091018,Javidi; Tara,9999,0,9999,0
1653419222536,ECE 200,017,091019,Kahng; Andrew Byun,9999,0,9999,0
1653419222536,ECE 200,018,091020,Kim; Young-Han,9999,0,9999,0
1653419222536,ECE 200,019,091021,Koushanfar; Farinaz,9999,0,9999,0
1653419222536,ECE 200,020,091022,Kuzum; Duygu,9999,0,9999,0
1653419222536,ECE 200,021,091023,Le; Hanh-Phuc,9999,0,9999,0
1653419222536,ECE 200,022,091024,Lin; Bill,9999,0,9999,0
1653419222536,ECE 200,023,091025,Liu; Zhaowei,9999,0,9999,0
1653419222536,ECE 200,024,091026,Lo; Yu-Hwa,9999,0,9999,0
1653419222536,ECE 200,025,091027,Lomakin; Vitaliy,9999,0,9999,0
1653419222536,ECE 200,026,091028,Mercier; Patrick Philip,9999,0,9999,0
1653419222536,ECE 200,027,091029,Meyer; Florian,9999,0,9999,0
1653419222536,ECE 200,028,091030,Milstein; Laurence B.,9999,0,9999,0
1653419222536,ECE 200,029,091031,Mir Arabbaygi; Siavash,9999,0,9999,0
1653419222536,ECE 200,030,091032,Mookherjea; Shayan,9999,0,9999,0
1653419222536,ECE 200,031,091033,Morris; Karcher William,9999,0,9999,0
1653419222536,ECE 200,032,091034,Ng; Tse Nga,9999,0,9999,0
1653419222536,ECE 200,033,091035,Nguyen; Truong Quang,9999,0,9999,0
1653419222536,ECE 200,034,091036,Nomura; Kenji,9999,0,9999,0
1653419222536,ECE 200,035,091037,Orlitsky; Alon,9999,0,9999,0
1653419222536,ECE 200,036,091038,Pal; Piya,9999,0,9999,0
1653419222536,ECE 200,037,091039,Papen; George C.,9999,0,9999,0
1653419222536,ECE 200,038,091040,Radic; Stojan,9999,0,9999,0
1653419222536,ECE 200,039,091041,Rao; Bhaskar D.,9999,0,9999,0
1653419222536,ECE 200,040,091042,Rao; Ramesh R,9999,0,9999,0
1653419222536,ECE 200,041,091043,Rebeiz; Gabriel,9999,0,9999,0
1653419222536,ECE 200,042,091044,Sanford; John R,9999,0,9999,0
1653419222536,ECE 200,043,091045,Siegel; Paul H.,9999,0,9999,0
1653419222536,ECE 200,044,091046,Sievenpiper; Daniel F.,9999,0,9999,0
1653419222536,ECE 200,045,091047,Sworder; David D.,9999,0,9999,0
1653419222536,ECE 200,046,091048,Taur; Yuan,9999,0,9999,0
1653419222536,ECE 200,047,091049,Touri; Behrouz,9999,0,9999,0
1653419222536,ECE 200,048,091050,Trivedi; Mohan M.,9999,0,9999,0
1653419222536,ECE 200,049,091051,Vardy; Alexander,9999,0,9999,0
1653419222536,ECE 200,050,091052,Vasconcelos; Nuno,9999,0,9999,0
1653419222536,ECE 200,051,091053,Wang; Xiaolong,9999,0,9999,0
1653419222536,ECE 200,052,091054,Xie; Pengtao,9999,0,9999,0
1653419222536,ECE 200,053,091055,Yip; Michael,9999,0,9999,0
1653419222536,ECE 200,054,091056,Zeger; Kenneth A.,9999,0,9999,0
1653419222536,ECE 200,055,091057,Zhang; Xinyu,9999,0,9999,0
1653419222536,ECE 200,056,091058,Turakhia; Yatish Girish,9999,0,9999,0
1653419222536,ECE 200,057,091059,Kang; Mingu,9999,0,9999,0
1653419222536,ECE 200,058,091060,Shi; Yuanyuan,9999,0,9999,0
1653419222536,ECE 200,059,091061,Wang; Edward Jay,9999,0,9999,0
1653419222536,ECE 200,060,091062,Zheng; Yang,9999,0,9999,0
1653419223064,ECE 203,A00,091065,Mercier; Patrick Philip,0,0,0,0
1653419223591,ECE 207A,A00,091605,Liu; Thomas Tao-Ming,0,0,0,0
1653419224116,ECE 212AN,A00,091068,Nomura; Kenji,0,0,0,0
1653419224642,ECE 222A,A00,091069,Rebeiz; Gabriel,0,0,0,0
1653419225175,ECE 225A,A00,091070,Orlitsky; Alon,0,0,0,0
1653419225699,ECE 230A,A00,091071,Nomura; Kenji,0,0,0,0
1653419226220,ECE 236A,A00,091072,Dayeh; Shadi Ahmad,0,0,0,0
1653419226744,ECE 238A,A00,091073,Luo; Jian,0,0,0,0
1653419226744,ECE 238A,B00,091074,Luo; Jian,0,0,0,0
1653419227267,ECE 240A,A00,091075,Radic; Stojan,0,0,0,0
1653419227790,ECE 247A,A00,091592,Shi; Lingyan,0,0,0,0
1653419228314,ECE 250,A00,091076,Touri; Behrouz,0,0,0,0
1653419228836,ECE 251C,A00,091078,Nguyen; Truong Quang,0,0,0,0
1653419229366,ECE 253,A00,091079,Cosman; Pamela C.,0,0,0,0
1653419229897,ECE 255A,A00,091080,Orlitsky; Alon,0,0,0,0
1653419230422,ECE 257A,A00,091081,Zhang; Xinyu,0,0,0,0
1653419230951,ECE 260A,A01,091084,Eldon; John,0,0,0,0
1653419231474,ECE 264C,A00,091085,Galton; Ian A,0,0,0,0
1653419231999,ECE 265C,A00,094889,Presti; Calogero Davide,0,0,0,9
1653419232523,ECE 266,A01,091087,Hall; Drew A.,0,0,0,0
1653419233575,ECE 271A,A00,091090,Vasconcelos; Nuno,0,0,0,0
1653419234101,ECE 272B,A00,091091,Sworder; David D.,0,0,0,0
1653419234625,ECE 275A,A00,091092,Meyer; Florian,0,0,0,0
1653419235147,ECE 277,A00,091093,An; Cheolhong,0,0,0,0
1653419235685,ECE 283,A00,091094,Le; Hanh-Phuc,0,0,0,0
1653419236219,ECE 284,A00,091095,Kang; Mingu,0,0,0,0
1653419236219,ECE 284,B00,091096,Wang; Edward Jay,0,0,0,0
1653419236747,ECE 285,A00,094334,Touri; Behrouz,0,0,0,0
1653419237273,ECE 289,A00,091097,Whelan; David Arthur,0,0,0,0
1653419237799,MATH 200A,A00,087414,Salehi Golsefidy; Alireza,7,0,8,1
1653419238330,MATH 202A,A00,087415,Gill; Philip E.,3,0,8,5
1653419238858,MATH 203A,A00,087416,Oprea; Dragos N.,6,0,8,2
1653419239386,MATH 204A,A00,087417,Kedlaya; Kiran S.,6,0,8,2
1653419239911,MATH 205,A00,087418,Sorensen; Claus M,6,0,8,2
1653419240433,MATH 206A,A00,087419,Izadi; Elham,7,0,8,1
1653419240960,MATH 207A,A00,087420,Mohammadi; Amir,6,0,8,2
1653419241485,MATH 208,A00,087421,Staff,9,0,10,1
1653419242009,MATH 209,A00,087422,Staff,10,0,10,0
1653419242535,MATH 218,A00,087423,Staff,10,0,10,0
1653419243058,MATH 220A,A00,087424,Novak; Jonathan I,7,0,8,1
1653419243583,MATH 231A,A00,087425,Bejenaru; Ioan,4,0,8,4
1653419244105,MATH 240A,A00,087426,Ebenfelt; Peter F,5,0,8,3
1653419244643,MATH 243,A00,087427,Staff,9,0,10,1
1653419245169,MATH 248,A00,087429,Staff,10,0,10,0
1653419245695,MATH 250A,A00,087430,Spolaor; Luca,5,0,8,3
1653419246243,MATH 257A,A00,087431,Spolaor; Luca,7,0,8,1
1653419246766,MATH 258,A00,087432,Staff,9,0,10,1
1653419247294,MATH 264A,A00,087433,Warnke; Lutz Peter,5,0,8,3
1653419247894,MATH 268,A00,087434,Staff,15,0,15,0
1653419248419,MATH 269,A00,087435,Staff,14,0,15,1
1653419248941,MATH 270A,A00,087436,Nie; Jiawang,0,0,8,8
1653419249463,MATH 272A,A00,087437,Tian; Xiaochuan,2,0,8,6
1653419249989,MATH 274,A01,087439,Cheng; Li-Tien,9,0,10,1
1653419249989,MATH 274,A02,087440,Cheng; Li-Tien,10,0,10,0
1653419250515,MATH 278A,A00,087441,Staff,8,0,10,2
1653419251037,MATH 278B,A00,087442,Staff,8,0,10,2
1653419251560,MATH 278C,A00,087443,Staff,8,0,10,2
1653419252085,MATH 280A,A00,087444,Zheng; Tianyi,0,0,8,8
1653419252607,MATH 281A,A00,087445,Bradic; Jelena,0,0,8,8
1653419253128,MATH 282A,A00,087446,Zhang; Danna,0,0,8,8
1653419253654,MATH 283,A00,087447,Tesler; Glenn,0,0,0,14
1653419254182,MATH 286,A00,087448,Kemp; Todd Aahron,6,0,8,2
1653419254706,MATH 287D,A00,087449,Bradic; Jelena,8,0,8,0
1653419255233,MATH 288,A00,087450,Staff,14,0,15,1
1653419255233,MATH 288,B00,087451,Staff,15,0,15,0
1653419255233,MATH 288,C00,087452,Staff,15,0,15,0
1653419255755,MATH 290A,A00,087453,Xu; Zhouli,7,0,8,1
1653419256290,MATH 291A,A00,087454,Xu; Zhouli,7,0,8,1
1653419256817,MATH 292,A00,087455,Staff,10,0,10,0
1653419257345,MATH 295,A00,087456,Staff,50,0,50,0
1653419257873,MATH 297,001,087457,Staff,998,0,999,1
1653419831678,COGS 200,A01,087991,Staff,48,0,50,2
1653419832214,COGS 201,A01,094504,Rangel; Lara M,17,0,25,8
1653419832739,COGS 203,A00,087992,Coulson; Seana M,19,0,20,1
1653419833262,COGS 210A,001,087993,Greene; Deanna Jacquelyn,9998,0,9999,1
1653419833262,COGS 210A,002,087994,Saygin; Ayse P,9999,0,9999,0
1653419833262,COGS 210A,003,087995,Xia; Haijun,9999,0,9999,0
1653419833262,COGS 210A,004,087996,Nitz; Douglas A.,9999,0,9999,0
1653419833262,COGS 210A,005,087997,Hollan; James D.,9999,0,9999,0
1653419833262,COGS 210A,006,087998,Deak; Gedeon O.,9998,0,9999,1
1653419833262,COGS 210A,007,087999,Rossano; Federico,9999,0,9999,0
1653419833805,COGS 211A,A00,088000,Coulson; Seana M,9997,0,9999,2
1653419834343,COGS 229,A00,088002,Staff,23,0,25,2
1653419834865,COGS 260,B00,094231,Staff,17,0,20,3
1653419834865,COGS 260,A00,088004,Nitz; Douglas A.,9998,0,9999,1
1653419835388,CSE 202,A00,090110,Paturi; Ramamohan,0,0,0,0
1653419835388,CSE 202,B00,090111,Paturi; Ramamohan,0,0,0,0
1653419835919,CSE 207B,A00,090112,Heninger; Nadia A,0,0,0,0
1653419836444,CSE 208,A00,094858,Micciancio; Daniele,0,0,0,0
1653419836970,CSE 210,A00,090113,Powell; Thomas Allan,0,0,0,0
1653419837494,CSE 219,A00,090898,Staff,0,0,0,0
1653419838030,CSE 221,A00,090114,Zhou; Yuan-Yuan,0,0,0,0
1653419838563,CSE 229A,A00,090115,Porter; George M,0,0,0,0
1653419839090,CSE 229C,A00,090116,Savage; Stefan,0,0,0,0
1653419839629,CSE 230,A00,090117,Jhala; Ranjit,0,0,0,0
1653419840155,CSE 232,A00,090118,Papakonstantinou; Yannis,0,0,0,0
1653419840676,CSE 239A,A00,090121,Kumar; Arun Kumar,0,0,0,0
1653419841207,CSE 239B,A00,090122,Jhala; Ranjit,0,0,0,0
1653419841745,CSE 240A,A00,090123,Zhao; Jishen,0,0,189,189
1653419842277,CSE 243A,A00,090124,Orailoglu; Alex,3,0,15,12
1653419842802,CSE 249B,A00,090125,Kahng; Andrew Byun,13,0,20,7
1653419843324,CSE 250A,A00,090126,Berg-Kirkpatrick; Taylor D,0,0,0,0
1653419843850,CSE 252A,A00,090127,Ochoa; Benjamin Lawrence,0,0,0,0
1653419844370,CSE 258,A01,090129,McAuley; Julian John,0,0,0,0
1653419844910,CSE 258R,A01,090131,McAuley; Julian John,0,0,0,0
1653419845434,CSE 274,A00,090132,Ramamoorthi; Ravi,0,0,0,0
1653419845964,CSE 276A,A00,090133,Christensen; Henrik I,0,0,0,0
1653419846486,CSE 276C,A00,090134,Christensen; Henrik I,0,0,0,0
1653419847011,CSE 290,A00,090135,Bafna; Vineet,0,0,0,0
1653419847011,CSE 290,B00,090136,Ramamoorthi; Ravi,0,0,0,0
1653419847011,CSE 290,C00,090137,Li; Tzumao,10,0,10,0
1653419847011,CSE 290,D00,090138,Zhou; Yuan-Yuan,10,0,10,0
1653419847011,CSE 290,E00,090139,Christensen; Henrik I,10,0,10,0
1653419847011,CSE 290,F00,094053,Shalev; Aaron D,0,0,0,0
1653419847534,CSE 291,A00,090140,Munyaka; Imani N. S.,0,0,0,0
1653419847534,CSE 291,B00,094880,Yu; Qi,0,0,0,0
1653419847534,CSE 291,C00,090142,Pannuto; Patrick William,0,0,0,0
1653419847534,CSE 291,D00,094881,Zhang; Yiying,0,0,0,0
1653419847534,CSE 291,E00,095118,Su; Hao,0,0,0,0
1653419848083,CSE 293,001,094905,Bafna; Vineet,9999,0,9999,0
1653419848083,CSE 293,002,094906,Bellare; Mihir,9999,0,9999,0
1653419848083,CSE 293,003,094907,Berg-Kirkpatrick; Taylor D,9999,0,9999,0
1653419848083,CSE 293,004,094908,Christensen; Henrik I,9999,0,9999,0
1653419848083,CSE 293,005,094909,Cottrell; Garrison W,9999,0,9999,0
1653419848083,CSE 293,006,094910,Deutsch; Alin Bernard,9999,0,9999,0
1653419848083,CSE 293,007,094911,Esmaeilzadeh; Hadi,9999,0,9999,0
1653419848083,CSE 293,008,094912,Freund; Yoav,9999,0,9999,0
1653419848083,CSE 293,009,094913,Griswold; William G.,9999,0,9999,0
1653419848083,CSE 293,010,094914,Gymrek; Melissa Ann,9999,0,9999,0
1653419848083,CSE 293,011,094915,Heninger; Nadia A,9999,0,9999,0
1653419848083,CSE 293,012,094916,Impagliazzo; Russell,9999,0,9999,0
1653419848083,CSE 293,013,094917,Jhala; Ranjit,9999,0,9999,0
1653419848083,CSE 293,014,094918,Kahng; Andrew Byun,9999,0,9999,0
1653419848083,CSE 293,015,094919,Kane; Daniel Mertz,9999,0,9999,0
1653419848083,CSE 293,016,094920,Kriegman; David J,9999,0,9999,0
1653419848083,CSE 293,017,094921,Kumar; Arun Kumar,9999,0,9999,0
1653419848083,CSE 293,018,094922,Lerner; Sorin,9999,0,9999,0
1653419848083,CSE 293,019,094923,Lovett; Shachar,9999,0,9999,0
1653419848083,CSE 293,020,094924,McAuley; Julian John,9999,0,9999,0
1653419848083,CSE 293,021,094925,Micciancio; Daniele,9999,0,9999,0
1653419848083,CSE 293,022,094926,Orailoglu; Alex,9999,0,9999,0
1653419848083,CSE 293,023,094927,Paturi; Ramamohan,9999,0,9999,0
1653419848083,CSE 293,024,094928,Polikarpova; Nadezhda,9999,0,9999,0
1653419848083,CSE 293,025,094929,Politz; Joseph Gibbs,9999,0,9999,0
1653419848083,CSE 293,026,094930,Porter; George M,9999,0,9999,0
1653419848083,CSE 293,027,094931,Porter; Leonard Emerson,9999,0,9999,0
1653419848083,CSE 293,028,094932,Ramamoorthi; Ravi,9999,0,9999,0
1653419848083,CSE 293,029,094933,Sahoo; Debashis,9999,0,9999,0
1653419848083,CSE 293,030,094934,Saul; Lawrence,9999,0,9999,0
1653419848083,CSE 293,031,094935,Savage; Stefan,9999,0,9999,0
1653419848083,CSE 293,032,094936,Schulze; Jurgen P.,9999,0,9999,0
1653419848083,CSE 293,033,094937,Snoeren; Alex C.,9999,0,9999,0
1653419848083,CSE 293,034,094938,Shang; Jingbo,9999,0,9999,0
1653419848083,CSE 293,035,094939,Stefan; Deian,9999,0,9999,0
1653419848083,CSE 293,036,094940,Su; Hao,9999,0,9999,0
1653419848083,CSE 293,037,094941,Swanson; Steven James,9999,0,9999,0
1653419848083,CSE 293,038,094942,Tullsen; Dean Michael,9999,0,9999,0
1653419848083,CSE 293,039,094943,Voelker; Geoffrey M.,9999,0,9999,0
1653419848083,CSE 293,040,094944,Zhao; Jishen,9999,0,9999,0
1653419848083,CSE 293,041,094945,Zhou; Yuan-Yuan,9999,0,9999,0
1653419848083,CSE 293,042,094946,Gao; Sicun,9998,0,9999,1
1653419848083,CSE 293,043,094947,Weibel; Nadir,9999,0,9999,0
1653419848083,CSE 293,044,094948,Gupta; Rajesh K.,9999,0,9999,0
1653419848608,CSE 294,A00,090143,Porter; George M,9,0,10,1
1653419849223,DSE 200,A00,091799,Staff,50,0,50,0
1653419849747,DSE 203,A00,091800,Gupta; Amarnath,30,0,30,0
1653419850271,DSE 250,A00,091801,Deutsch; Alin Bernard,30,0,30,0
1653419850794,DSE 290,A00,091802,Altintas De Callaf; Ilkay,50,0,50,0
1653419851347,ECE 200,001,091003,Antipa; Nicholas A,9999,0,9999,0
1653419851347,ECE 200,002,091004,Atanasov; Nikolay A.,9999,0,9999,0
1653419851347,ECE 200,003,091005,Bharadia; Dinesh,9999,0,9999,0
1653419851347,ECE 200,004,091006,Cheng; Chung Kuan,9999,0,9999,0
1653419851347,ECE 200,005,091007,Cosman; Pamela C.,9999,0,9999,0
1653419851347,ECE 200,006,091008,Staff,9999,0,9999,0
1653419851347,ECE 200,007,091009,Dayeh; Shadi Ahmad,9999,0,9999,0
1653419851347,ECE 200,008,091010,Fainman; Yeshaiahu,9999,0,9999,0
1653419851347,ECE 200,009,091011,Ford; Joseph Earl,9999,0,9999,0
1653419851347,ECE 200,010,091012,Franceschetti; Massimo,9999,0,9999,0
1653419851347,ECE 200,011,091013,Fullerton; Eric E,9999,0,9999,0
1653419851347,ECE 200,012,091014,Galton; Ian A,9999,0,9999,0
1653419851347,ECE 200,013,091015,Gilja; Vikash,9999,0,9999,0
1653419851347,ECE 200,014,091016,Hall; Drew A.,9999,0,9999,0
1653419851347,ECE 200,015,091017,Hsueh; Tzu-Chien,9999,0,9999,0
1653419851347,ECE 200,016,091018,Javidi; Tara,9999,0,9999,0
1653419851347,ECE 200,017,091019,Kahng; Andrew Byun,9999,0,9999,0
1653419851347,ECE 200,018,091020,Kim; Young-Han,9999,0,9999,0
1653419851347,ECE 200,019,091021,Koushanfar; Farinaz,9999,0,9999,0
1653419851347,ECE 200,020,091022,Kuzum; Duygu,9999,0,9999,0
1653419851347,ECE 200,021,091023,Le; Hanh-Phuc,9999,0,9999,0
1653419851347,ECE 200,022,091024,Lin; Bill,9999,0,9999,0
1653419851347,ECE 200,023,091025,Liu; Zhaowei,9999,0,9999,0
1653419851347,ECE 200,024,091026,Lo; Yu-Hwa,9999,0,9999,0
1653419851347,ECE 200,025,091027,Lomakin; Vitaliy,9999,0,9999,0
1653419851347,ECE 200,026,091028,Mercier; Patrick Philip,9999,0,9999,0
1653419851347,ECE 200,027,091029,Meyer; Florian,9999,0,9999,0
1653419851347,ECE 200,028,091030,Milstein; Laurence B.,9999,0,9999,0
1653419851347,ECE 200,029,091031,Mir Arabbaygi; Siavash,9999,0,9999,0
1653419851347,ECE 200,030,091032,Mookherjea; Shayan,9999,0,9999,0
1653419851347,ECE 200,031,091033,Morris; Karcher William,9999,0,9999,0
1653419851347,ECE 200,032,091034,Ng; Tse Nga,9999,0,9999,0
1653419851347,ECE 200,033,091035,Nguyen; Truong Quang,9999,0,9999,0
1653419851347,ECE 200,034,091036,Nomura; Kenji,9999,0,9999,0
1653419851347,ECE 200,035,091037,Orlitsky; Alon,9999,0,9999,0
1653419851347,ECE 200,036,091038,Pal; Piya,9999,0,9999,0
1653419851347,ECE 200,037,091039,Papen; George C.,9999,0,9999,0
1653419851347,ECE 200,038,091040,Radic; Stojan,9999,0,9999,0
1653419851347,ECE 200,039,091041,Rao; Bhaskar D.,9999,0,9999,0
1653419851347,ECE 200,040,091042,Rao; Ramesh R,9999,0,9999,0
1653419851347,ECE 200,041,091043,Rebeiz; Gabriel,9999,0,9999,0
1653419851347,ECE 200,042,091044,Sanford; John R,9999,0,9999,0
1653419851347,ECE 200,043,091045,Siegel; Paul H.,9999,0,9999,0
1653419851347,ECE 200,044,091046,Sievenpiper; Daniel F.,9999,0,9999,0
1653419851347,ECE 200,045,091047,Sworder; David D.,9999,0,9999,0
1653419851347,ECE 200,046,091048,Taur; Yuan,9999,0,9999,0
1653419851347,ECE 200,047,091049,Touri; Behrouz,9999,0,9999,0
1653419851347,ECE 200,048,091050,Trivedi; Mohan M.,9999,0,9999,0
1653419851347,ECE 200,049,091051,Vardy; Alexander,9999,0,9999,0
1653419851347,ECE 200,050,091052,Vasconcelos; Nuno,9999,0,9999,0
1653419851347,ECE 200,051,091053,Wang; Xiaolong,9999,0,9999,0
1653419851347,ECE 200,052,091054,Xie; Pengtao,9999,0,9999,0
1653419851347,ECE 200,053,091055,Yip; Michael,9999,0,9999,0
1653419851347,ECE 200,054,091056,Zeger; Kenneth A.,9999,0,9999,0
1653419851347,ECE 200,055,091057,Zhang; Xinyu,9999,0,9999,0
1653419851347,ECE 200,056,091058,Turakhia; Yatish Girish,9999,0,9999,0
1653419851347,ECE 200,057,091059,Kang; Mingu,9999,0,9999,0
1653419851347,ECE 200,058,091060,Shi; Yuanyuan,9999,0,9999,0
1653419851347,ECE 200,059,091061,Wang; Edward Jay,9999,0,9999,0
1653419851347,ECE 200,060,091062,Zheng; Yang,9999,0,9999,0
1653419851870,ECE 203,A00,091065,Mercier; Patrick Philip,0,0,0,0
1653419852392,ECE 207A,A00,091605,Liu; Thomas Tao-Ming,0,0,0,0
1653419852915,ECE 212AN,A00,091068,Nomura; Kenji,0,0,0,0
1653419853440,ECE 222A,A00,091069,Rebeiz; Gabriel,0,0,0,0
1653419853962,ECE 225A,A00,091070,Orlitsky; Alon,0,0,0,0
1653419854484,ECE 230A,A00,091071,Nomura; Kenji,0,0,0,0
1653419855009,ECE 236A,A00,091072,Dayeh; Shadi Ahmad,0,0,0,0
1653419855535,ECE 238A,A00,091073,Luo; Jian,0,0,0,0
1653419855535,ECE 238A,B00,091074,Luo; Jian,0,0,0,0
1653419856071,ECE 240A,A00,091075,Radic; Stojan,0,0,0,0
1653419856601,ECE 247A,A00,091592,Shi; Lingyan,0,0,0,0
1653419857139,ECE 250,A00,091076,Touri; Behrouz,0,0,0,0
1653419857667,ECE 251C,A00,091078,Nguyen; Truong Quang,0,0,0,0
1653419858190,ECE 253,A00,091079,Cosman; Pamela C.,0,0,0,0
1653419858712,ECE 255A,A00,091080,Orlitsky; Alon,0,0,0,0
1653419859236,ECE 257A,A00,091081,Zhang; Xinyu,0,0,0,0
1653419859759,ECE 260A,A01,091084,Eldon; John,0,0,0,0
1653419860295,ECE 264C,A00,091085,Galton; Ian A,0,0,0,0
1653419860825,ECE 265C,A00,094889,Presti; Calogero Davide,0,0,0,9
1653419861348,ECE 266,A01,091087,Hall; Drew A.,0,0,0,0
1653419862394,ECE 271A,A00,091090,Vasconcelos; Nuno,0,0,0,0
1653419862917,ECE 272B,A00,091091,Sworder; David D.,0,0,0,0
1653419863441,ECE 275A,A00,091092,Meyer; Florian,0,0,0,0
1653419863965,ECE 277,A00,091093,An; Cheolhong,0,0,0,0
1653419864489,ECE 283,A00,091094,Le; Hanh-Phuc,0,0,0,0
1653419865017,ECE 284,A00,091095,Kang; Mingu,0,0,0,0
1653419865017,ECE 284,B00,091096,Wang; Edward Jay,0,0,0,0
1653419865543,ECE 285,A00,094334,Touri; Behrouz,0,0,0,0
1653419866065,ECE 289,A00,091097,Whelan; David Arthur,0,0,0,0
1653419866587,MATH 200A,A00,087414,Salehi Golsefidy; Alireza,7,0,8,1
1653419867119,MATH 202A,A00,087415,Gill; Philip E.,3,0,8,5
1653419867664,MATH 203A,A00,087416,Oprea; Dragos N.,6,0,8,2
1653419868203,MATH 204A,A00,087417,Kedlaya; Kiran S.,6,0,8,2
1653419868726,MATH 205,A00,087418,Sorensen; Claus M,6,0,8,2
1653419869252,MATH 206A,A00,087419,Izadi; Elham,7,0,8,1
1653419869777,MATH 207A,A00,087420,Mohammadi; Amir,6,0,8,2
1653419870313,MATH 208,A00,087421,Staff,9,0,10,1
1653419870842,MATH 209,A00,087422,Staff,10,0,10,0
1653419871369,MATH 218,A00,087423,Staff,10,0,10,0
1653419871896,MATH 220A,A00,087424,Novak; Jonathan I,7,0,8,1
1653419872427,MATH 231A,A00,087425,Bejenaru; Ioan,4,0,8,4
1653419872959,MATH 240A,A00,087426,Ebenfelt; Peter F,5,0,8,3
1653419873482,MATH 243,A00,087427,Staff,9,0,10,1
1653419874006,MATH 248,A00,087429,Staff,10,0,10,0
1653419874528,MATH 250A,A00,087430,Spolaor; Luca,5,0,8,3
1653419875050,MATH 257A,A00,087431,Spolaor; Luca,7,0,8,1
1653419875582,MATH 258,A00,087432,Staff,9,0,10,1
1653419876114,MATH 264A,A00,087433,Warnke; Lutz Peter,5,0,8,3
1653419876639,MATH 268,A00,087434,Staff,15,0,15,0
1653419877162,MATH 269,A00,087435,Staff,14,0,15,1
1653419877698,MATH 270A,A00,087436,Nie; Jiawang,0,0,8,8
1653419878226,MATH 272A,A00,087437,Tian; Xiaochuan,2,0,8,6
1653419878749,MATH 274,A01,087439,Cheng; Li-Tien,9,0,10,1
1653419878749,MATH 274,A02,087440,Cheng; Li-Tien,10,0,10,0
1653419879278,MATH 278A,A00,087441,Staff,8,0,10,2
1653419879812,MATH 278B,A00,087442,Staff,8,0,10,2
1653419880337,MATH 278C,A00,087443,Staff,8,0,10,2
1653419880862,MATH 280A,A00,087444,Zheng; Tianyi,0,0,8,8
1653419881400,MATH 281A,A00,087445,Bradic; Jelena,0,0,8,8
1653419881936,MATH 282A,A00,087446,Zhang; Danna,0,0,8,8
1653419882459,MATH 283,A00,087447,Tesler; Glenn,0,0,0,14
1653419882996,MATH 286,A00,087448,Kemp; Todd Aahron,6,0,8,2
1653419883528,MATH 287D,A00,087449,Bradic; Jelena,8,0,8,0
1653419884049,MATH 288,A00,087450,Staff,14,0,15,1
1653419884049,MATH 288,B00,087451,Staff,15,0,15,0
1653419884049,MATH 288,C00,087452,Staff,15,0,15,0
1653419884593,MATH 290A,A00,087453,Xu; Zhouli,7,0,8,1
1653419885118,MATH 291A,A00,087454,Xu; Zhouli,7,0,8,1
1653419885640,MATH 292,A00,087455,Staff,10,0,10,0
1653419886166,MATH 295,A00,087456,Staff,50,0,50,0
1653419886691,MATH 297,001,087457,Staff,998,0,999,1
1653420448934,COGS 200,A01,087991,Staff,48,0,50,2
1653420449475,COGS 201,A01,094504,Rangel; Lara M,17,0,25,8
1653420450002,COGS 203,A00,087992,Coulson; Seana M,19,0,20,1
1653420450528,COGS 210A,001,087993,Greene; Deanna Jacquelyn,9998,0,9999,1
1653420450528,COGS 210A,002,087994,Saygin; Ayse P,9999,0,9999,0
1653420450528,COGS 210A,003,087995,Xia; Haijun,9999,0,9999,0
1653420450528,COGS 210A,004,087996,Nitz; Douglas A.,9999,0,9999,0
1653420450528,COGS 210A,005,087997,Hollan; James D.,9999,0,9999,0
1653420450528,COGS 210A,006,087998,Deak; Gedeon O.,9998,0,9999,1
1653420450528,COGS 210A,007,087999,Rossano; Federico,9999,0,9999,0
1653420451067,COGS 211A,A00,088000,Coulson; Seana M,9997,0,9999,2
1653420451600,COGS 229,A00,088002,Staff,23,0,25,2
1653420452129,COGS 260,B00,094231,Staff,17,0,20,3
1653420452129,COGS 260,A00,088004,Nitz; Douglas A.,9998,0,9999,1
1653420452652,CSE 202,A00,090110,Paturi; Ramamohan,0,0,0,0
1653420452652,CSE 202,B00,090111,Paturi; Ramamohan,0,0,0,0
1653420453172,CSE 207B,A00,090112,Heninger; Nadia A,0,0,0,0
1653420453694,CSE 208,A00,094858,Micciancio; Daniele,0,0,0,0
1653420454215,CSE 210,A00,090113,Powell; Thomas Allan,0,0,0,0
1653420454740,CSE 219,A00,090898,Staff,0,0,0,0
1653420455274,CSE 221,A00,090114,Zhou; Yuan-Yuan,0,0,0,0
1653420455805,CSE 229A,A00,090115,Porter; George M,0,0,0,0
1653420456338,CSE 229C,A00,090116,Savage; Stefan,0,0,0,0
1653420456873,CSE 230,A00,090117,Jhala; Ranjit,0,0,0,0
1653420457402,CSE 232,A00,090118,Papakonstantinou; Yannis,0,0,0,0
1653420457939,CSE 239A,A00,090121,Kumar; Arun Kumar,0,0,0,0
1653420458470,CSE 239B,A00,090122,Jhala; Ranjit,0,0,0,0
1653420458992,CSE 240A,A00,090123,Zhao; Jishen,0,0,189,189
1653420459517,CSE 243A,A00,090124,Orailoglu; Alex,3,0,15,12
1653420460042,CSE 249B,A00,090125,Kahng; Andrew Byun,13,0,20,7
1653420460570,CSE 250A,A00,090126,Berg-Kirkpatrick; Taylor D,0,0,0,0
1653420461096,CSE 252A,A00,090127,Ochoa; Benjamin Lawrence,0,0,0,0
1653420461631,CSE 258,A01,090129,McAuley; Julian John,0,0,0,0
1653420462153,CSE 258R,A01,090131,McAuley; Julian John,0,0,0,0
1653420462679,CSE 274,A00,090132,Ramamoorthi; Ravi,0,0,0,0
1653420463205,CSE 276A,A00,090133,Christensen; Henrik I,0,0,0,0
1653420463730,CSE 276C,A00,090134,Christensen; Henrik I,0,0,0,0
1653420464253,CSE 290,A00,090135,Bafna; Vineet,0,0,0,0
1653420464253,CSE 290,B00,090136,Ramamoorthi; Ravi,0,0,0,0
1653420464253,CSE 290,C00,090137,Li; Tzumao,10,0,10,0
1653420464253,CSE 290,D00,090138,Zhou; Yuan-Yuan,10,0,10,0
1653420464253,CSE 290,E00,090139,Christensen; Henrik I,10,0,10,0
1653420464253,CSE 290,F00,094053,Shalev; Aaron D,0,0,0,0
1653420464779,CSE 291,A00,090140,Munyaka; Imani N. S.,0,0,0,0
1653420464779,CSE 291,B00,094880,Yu; Qi,0,0,0,0
1653420464779,CSE 291,C00,090142,Pannuto; Patrick William,0,0,0,0
1653420464779,CSE 291,D00,094881,Zhang; Yiying,0,0,0,0
1653420464779,CSE 291,E00,095118,Su; Hao,0,0,0,0
1653420465313,CSE 293,001,094905,Bafna; Vineet,9999,0,9999,0
1653420465313,CSE 293,002,094906,Bellare; Mihir,9999,0,9999,0
1653420465313,CSE 293,003,094907,Berg-Kirkpatrick; Taylor D,9999,0,9999,0
1653420465313,CSE 293,004,094908,Christensen; Henrik I,9999,0,9999,0
1653420465313,CSE 293,005,094909,Cottrell; Garrison W,9999,0,9999,0
1653420465313,CSE 293,006,094910,Deutsch; Alin Bernard,9999,0,9999,0
1653420465313,CSE 293,007,094911,Esmaeilzadeh; Hadi,9999,0,9999,0
1653420465313,CSE 293,008,094912,Freund; Yoav,9999,0,9999,0
1653420465313,CSE 293,009,094913,Griswold; William G.,9999,0,9999,0
1653420465313,CSE 293,010,094914,Gymrek; Melissa Ann,9999,0,9999,0
1653420465313,CSE 293,011,094915,Heninger; Nadia A,9999,0,9999,0
1653420465313,CSE 293,012,094916,Impagliazzo; Russell,9999,0,9999,0
1653420465313,CSE 293,013,094917,Jhala; Ranjit,9999,0,9999,0
1653420465313,CSE 293,014,094918,Kahng; Andrew Byun,9999,0,9999,0
1653420465313,CSE 293,015,094919,Kane; Daniel Mertz,9999,0,9999,0
1653420465313,CSE 293,016,094920,Kriegman; David J,9999,0,9999,0
1653420465313,CSE 293,017,094921,Kumar; Arun Kumar,9999,0,9999,0
1653420465313,CSE 293,018,094922,Lerner; Sorin,9999,0,9999,0
1653420465313,CSE 293,019,094923,Lovett; Shachar,9999,0,9999,0
1653420465313,CSE 293,020,094924,McAuley; Julian John,9999,0,9999,0
1653420465313,CSE 293,021,094925,Micciancio; Daniele,9999,0,9999,0
1653420465313,CSE 293,022,094926,Orailoglu; Alex,9999,0,9999,0
1653420465313,CSE 293,023,094927,Paturi; Ramamohan,9999,0,9999,0
1653420465313,CSE 293,024,094928,Polikarpova; Nadezhda,9999,0,9999,0
1653420465313,CSE 293,025,094929,Politz; Joseph Gibbs,9999,0,9999,0
1653420465313,CSE 293,026,094930,Porter; George M,9999,0,9999,0
1653420465313,CSE 293,027,094931,Porter; Leonard Emerson,9999,0,9999,0
1653420465313,CSE 293,028,094932,Ramamoorthi; Ravi,9999,0,9999,0
1653420465313,CSE 293,029,094933,Sahoo; Debashis,9999,0,9999,0
1653420465313,CSE 293,030,094934,Saul; Lawrence,9999,0,9999,0
1653420465313,CSE 293,031,094935,Savage; Stefan,9999,0,9999,0
1653420465313,CSE 293,032,094936,Schulze; Jurgen P.,9999,0,9999,0
1653420465313,CSE 293,033,094937,Snoeren; Alex C.,9999,0,9999,0
1653420465313,CSE 293,034,094938,Shang; Jingbo,9999,0,9999,0
1653420465313,CSE 293,035,094939,Stefan; Deian,9999,0,9999,0
1653420465313,CSE 293,036,094940,Su; Hao,9999,0,9999,0
1653420465313,CSE 293,037,094941,Swanson; Steven James,9999,0,9999,0
1653420465313,CSE 293,038,094942,Tullsen; Dean Michael,9999,0,9999,0
1653420465313,CSE 293,039,094943,Voelker; Geoffrey M.,9999,0,9999,0
1653420465313,CSE 293,040,094944,Zhao; Jishen,9999,0,9999,0
1653420465313,CSE 293,041,094945,Zhou; Yuan-Yuan,9999,0,9999,0
1653420465313,CSE 293,042,094946,Gao; Sicun,9998,0,9999,1
1653420465313,CSE 293,043,094947,Weibel; Nadir,9999,0,9999,0
1653420465313,CSE 293,044,094948,Gupta; Rajesh K.,9999,0,9999,0
1653420465838,CSE 294,A00,090143,Porter; George M,9,0,10,1
1653420466361,DSE 200,A00,091799,Staff,50,0,50,0
1653420466886,DSE 203,A00,091800,Gupta; Amarnath,30,0,30,0
1653420467419,DSE 250,A00,091801,Deutsch; Alin Bernard,30,0,30,0
1653420467943,DSE 290,A00,091802,Altintas De Callaf; Ilkay,50,0,50,0
1653420468473,ECE 200,001,091003,Antipa; Nicholas A,9999,0,9999,0
1653420468473,ECE 200,002,091004,Atanasov; Nikolay A.,9999,0,9999,0
1653420468473,ECE 200,003,091005,Bharadia; Dinesh,9999,0,9999,0
1653420468473,ECE 200,004,091006,Cheng; Chung Kuan,9999,0,9999,0
1653420468473,ECE 200,005,091007,Cosman; Pamela C.,9999,0,9999,0
1653420468473,ECE 200,006,091008,Staff,9999,0,9999,0
1653420468473,ECE 200,007,091009,Dayeh; Shadi Ahmad,9999,0,9999,0
1653420468473,ECE 200,008,091010,Fainman; Yeshaiahu,9999,0,9999,0
1653420468473,ECE 200,009,091011,Ford; Joseph Earl,9999,0,9999,0
1653420468473,ECE 200,010,091012,Franceschetti; Massimo,9999,0,9999,0
1653420468473,ECE 200,011,091013,Fullerton; Eric E,9999,0,9999,0
1653420468473,ECE 200,012,091014,Galton; Ian A,9999,0,9999,0
1653420468473,ECE 200,013,091015,Gilja; Vikash,9999,0,9999,0
1653420468473,ECE 200,014,091016,Hall; Drew A.,9999,0,9999,0
1653420468473,ECE 200,015,091017,Hsueh; Tzu-Chien,9999,0,9999,0
1653420468473,ECE 200,016,091018,Javidi; Tara,9999,0,9999,0
1653420468473,ECE 200,017,091019,Kahng; Andrew Byun,9999,0,9999,0
1653420468473,ECE 200,018,091020,Kim; Young-Han,9999,0,9999,0
1653420468473,ECE 200,019,091021,Koushanfar; Farinaz,9999,0,9999,0
1653420468473,ECE 200,020,091022,Kuzum; Duygu,9999,0,9999,0
1653420468473,ECE 200,021,091023,Le; Hanh-Phuc,9999,0,9999,0
1653420468473,ECE 200,022,091024,Lin; Bill,9999,0,9999,0
1653420468473,ECE 200,023,091025,Liu; Zhaowei,9999,0,9999,0
1653420468473,ECE 200,024,091026,Lo; Yu-Hwa,9999,0,9999,0
1653420468473,ECE 200,025,091027,Lomakin; Vitaliy,9999,0,9999,0
1653420468473,ECE 200,026,091028,Mercier; Patrick Philip,9999,0,9999,0
1653420468473,ECE 200,027,091029,Meyer; Florian,9999,0,9999,0
1653420468473,ECE 200,028,091030,Milstein; Laurence B.,9999,0,9999,0
1653420468473,ECE 200,029,091031,Mir Arabbaygi; Siavash,9999,0,9999,0
1653420468473,ECE 200,030,091032,Mookherjea; Shayan,9999,0,9999,0
1653420468473,ECE 200,031,091033,Morris; Karcher William,9999,0,9999,0
1653420468473,ECE 200,032,091034,Ng; Tse Nga,9999,0,9999,0
1653420468473,ECE 200,033,091035,Nguyen; Truong Quang,9999,0,9999,0
1653420468473,ECE 200,034,091036,Nomura; Kenji,9999,0,9999,0
1653420468473,ECE 200,035,091037,Orlitsky; Alon,9999,0,9999,0
1653420468473,ECE 200,036,091038,Pal; Piya,9999,0,9999,0
1653420468473,ECE 200,037,091039,Papen; George C.,9999,0,9999,0
1653420468473,ECE 200,038,091040,Radic; Stojan,9999,0,9999,0
1653420468473,ECE 200,039,091041,Rao; Bhaskar D.,9999,0,9999,0
1653420468473,ECE 200,040,091042,Rao; Ramesh R,9999,0,9999,0
1653420468473,ECE 200,041,091043,Rebeiz; Gabriel,9999,0,9999,0
1653420468473,ECE 200,042,091044,Sanford; John R,9999,0,9999,0
1653420468473,ECE 200,043,091045,Siegel; Paul H.,9999,0,9999,0
1653420468473,ECE 200,044,091046,Sievenpiper; Daniel F.,9999,0,9999,0
1653420468473,ECE 200,045,091047,Sworder; David D.,9999,0,9999,0
1653420468473,ECE 200,046,091048,Taur; Yuan,9999,0,9999,0
1653420468473,ECE 200,047,091049,Touri; Behrouz,9999,0,9999,0
1653420468473,ECE 200,048,091050,Trivedi; Mohan M.,9999,0,9999,0
1653420468473,ECE 200,049,091051,Vardy; Alexander,9999,0,9999,0
1653420468473,ECE 200,050,091052,Vasconcelos; Nuno,9999,0,9999,0
1653420468473,ECE 200,051,091053,Wang; Xiaolong,9999,0,9999,0
1653420468473,ECE 200,052,091054,Xie; Pengtao,9999,0,9999,0
1653420468473,ECE 200,053,091055,Yip; Michael,9999,0,9999,0
1653420468473,ECE 200,054,091056,Zeger; Kenneth A.,9999,0,9999,0
1653420468473,ECE 200,055,091057,Zhang; Xinyu,9999,0,9999,0
1653420468473,ECE 200,056,091058,Turakhia; Yatish Girish,9999,0,9999,0
1653420468473,ECE 200,057,091059,Kang; Mingu,9999,0,9999,0
1653420468473,ECE 200,058,091060,Shi; Yuanyuan,9999,0,9999,0
1653420468473,ECE 200,059,091061,Wang; Edward Jay,9999,0,9999,0
1653420468473,ECE 200,060,091062,Zheng; Yang,9999,0,9999,0
1653420469003,ECE 203,A00,091065,Mercier; Patrick Philip,0,0,0,0
1653420469530,ECE 207A,A00,091605,Liu; Thomas Tao-Ming,0,0,0,0
1653420470053,ECE 212AN,A00,091068,Nomura; Kenji,0,0,0,0
1653420470580,ECE 222A,A00,091069,Rebeiz; Gabriel,0,0,0,0
1653420471102,ECE 225A,A00,091070,Orlitsky; Alon,0,0,0,0
1653420471636,ECE 230A,A00,091071,Nomura; Kenji,0,0,0,0
1653420472160,ECE 236A,A00,091072,Dayeh; Shadi Ahmad,0,0,0,0
1653420472687,ECE 238A,A00,091073,Luo; Jian,0,0,0,0
1653420472687,ECE 238A,B00,091074,Luo; Jian,0,0,0,0
1653420473220,ECE 240A,A00,091075,Radic; Stojan,0,0,0,0
1653420473744,ECE 247A,A00,091592,Shi; Lingyan,0,0,0,0
1653420474286,ECE 250,A00,091076,Touri; Behrouz,0,0,0,0
1653420474815,ECE 251C,A00,091078,Nguyen; Truong Quang,0,0,0,0
1653420475343,ECE 253,A00,091079,Cosman; Pamela C.,0,0,0,0
1653420475867,ECE 255A,A00,091080,Orlitsky; Alon,0,0,0,0
1653420476390,ECE 257A,A00,091081,Zhang; Xinyu,0,0,0,0
1653420476915,ECE 260A,A01,091084,Eldon; John,0,0,0,0
1653420477440,ECE 264C,A00,091085,Galton; Ian A,0,0,0,0
1653420477962,ECE 265C,A00,094889,Presti; Calogero Davide,0,0,0,9
1653420478488,ECE 266,A01,091087,Hall; Drew A.,0,0,0,0
1653420479536,ECE 271A,A00,091090,Vasconcelos; Nuno,0,0,0,0
1653420480064,ECE 272B,A00,091091,Sworder; David D.,0,0,0,0
1653420480590,ECE 275A,A00,091092,Meyer; Florian,0,0,0,0
1653420481115,ECE 277,A00,091093,An; Cheolhong,0,0,0,0
1653420481648,ECE 283,A00,091094,Le; Hanh-Phuc,0,0,0,0
1653420482188,ECE 284,A00,091095,Kang; Mingu,0,0,0,0
1653420482188,ECE 284,B00,091096,Wang; Edward Jay,0,0,0,0
1653420482720,ECE 285,A00,094334,Touri; Behrouz,0,0,0,0
1653420483258,ECE 289,A00,091097,Whelan; David Arthur,0,0,0,0
1653420483784,MATH 200A,A00,087414,Salehi Golsefidy; Alireza,7,0,8,1
1653420484315,MATH 202A,A00,087415,Gill; Philip E.,3,0,8,5
1653420484847,MATH 203A,A00,087416,Oprea; Dragos N.,6,0,8,2
1653420485383,MATH 204A,A00,087417,Kedlaya; Kiran S.,6,0,8,2
1653420485914,MATH 205,A00,087418,Sorensen; Claus M,6,0,8,2
1653420486440,MATH 206A,A00,087419,Izadi; Elham,7,0,8,1
1653420486962,MATH 207A,A00,087420,Mohammadi; Amir,6,0,8,2
1653420487484,MATH 208,A00,087421,Staff,9,0,10,1
1653420488006,MATH 209,A00,087422,Staff,10,0,10,0
1653420488531,MATH 218,A00,087423,Staff,10,0,10,0
1653420489057,MATH 220A,A00,087424,Novak; Jonathan I,7,0,8,1
1653420489580,MATH 231A,A00,087425,Bejenaru; Ioan,4,0,8,4
1653420490106,MATH 240A,A00,087426,Ebenfelt; Peter F,5,0,8,3
1653420490629,MATH 243,A00,087427,Staff,9,0,10,1
1653420491153,MATH 248,A00,087429,Staff,10,0,10,0
1653420491681,MATH 250A,A00,087430,Spolaor; Luca,5,0,8,3
1653420492284,MATH 257A,A00,087431,Spolaor; Luca,7,0,8,1
1653420492808,MATH 258,A00,087432,Staff,9,0,10,1
1653420493330,MATH 264A,A00,087433,Warnke; Lutz Peter,5,0,8,3
1653420493852,MATH 268,A00,087434,Staff,15,0,15,0
1653420494381,MATH 269,A00,087435,Staff,14,0,15,1
1653420494914,MATH 270A,A00,087436,Nie; Jiawang,0,0,8,8
1653420495437,MATH 272A,A00,087437,Tian; Xiaochuan,2,0,8,6
1653420495967,MATH 274,A01,087439,Cheng; Li-Tien,9,0,10,1
1653420495967,MATH 274,A02,087440,Cheng; Li-Tien,10,0,10,0
1653420496494,MATH 278A,A00,087441,Staff,8,0,10,2
1653420497020,MATH 278B,A00,087442,Staff,8,0,10,2
1653420497543,MATH 278C,A00,087443,Staff,8,0,10,2
1653420498079,MATH 280A,A00,087444,Zheng; Tianyi,0,0,8,8
1653420498655,MATH 281A,A00,087445,Bradic; Jelena,0,0,8,8
1653420499177,MATH 282A,A00,087446,Zhang; Danna,0,0,8,8
1653420499699,MATH 283,A00,087447,Tesler; Glenn,0,0,0,14
1653420500230,MATH 286,A00,087448,Kemp; Todd Aahron,6,0,8,2
1653420500751,MATH 287D,A00,087449,Bradic; Jelena,8,0,8,0
1653420501281,MATH 288,A00,087450,Staff,14,0,15,1
1653420501281,MATH 288,B00,087451,Staff,15,0,15,0
1653420501281,MATH 288,C00,087452,Staff,15,0,15,0
1653420501806,MATH 290A,A00,087453,Xu; Zhouli,7,0,8,1
1653420502330,MATH 291A,A00,087454,Xu; Zhouli,7,0,8,1
1653420502854,MATH 292,A00,087455,Staff,10,0,10,0
1653420503377,MATH 295,A00,087456,Staff,50,0,50,0
1653420503902,MATH 297,001,087457,Staff,998,0,999,1
1653421067235,COGS 200,A01,087991,Staff,48,0,50,2
1653421067768,COGS 201,A01,094504,Rangel; Lara M,17,0,25,8
1653421068304,COGS 203,A00,087992,Coulson; Seana M,19,0,20,1
1653421068829,COGS 210A,001,087993,Greene; Deanna Jacquelyn,9998,0,9999,1
1653421068829,COGS 210A,002,087994,Saygin; Ayse P,9999,0,9999,0
1653421068829,COGS 210A,003,087995,Xia; Haijun,9999,0,9999,0
1653421068829,COGS 210A,004,087996,Nitz; Douglas A.,9999,0,9999,0
1653421068829,COGS 210A,005,087997,Hollan; James D.,9999,0,9999,0
1653421068829,COGS 210A,006,087998,Deak; Gedeon O.,9998,0,9999,1
1653421068829,COGS 210A,007,087999,Rossano; Federico,9999,0,9999,0
1653421069350,COGS 211A,A00,088000,Coulson; Seana M,9997,0,9999,2
1653421069872,COGS 229,A00,088002,Staff,23,0,25,2
1653421070396,COGS 260,B00,094231,Staff,17,0,20,3
1653421070396,COGS 260,A00,088004,Nitz; Douglas A.,9998,0,9999,1
1653421070924,CSE 202,A00,090110,Paturi; Ramamohan,0,0,0,0
1653421070924,CSE 202,B00,090111,Paturi; Ramamohan,0,0,0,0
1653421071447,CSE 207B,A00,090112,Heninger; Nadia A,0,0,0,0
1653421071979,CSE 208,A00,094858,Micciancio; Daniele,0,0,0,0
1653421072509,CSE 210,A00,090113,Powell; Thomas Allan,0,0,0,0
1653421073035,CSE 219,A00,090898,Staff,0,0,0,0
1653421073563,CSE 221,A00,090114,Zhou; Yuan-Yuan,0,0,0,0
1653421074092,CSE 229A,A00,090115,Porter; George M,0,0,0,0
1653421074621,CSE 229C,A00,090116,Savage; Stefan,0,0,0,0
1653421075144,CSE 230,A00,090117,Jhala; Ranjit,0,0,0,0
1653421075680,CSE 232,A00,090118,Papakonstantinou; Yannis,0,0,0,0
1653421076210,CSE 239A,A00,090121,Kumar; Arun Kumar,0,0,0,0
1653421076734,CSE 239B,A00,090122,Jhala; Ranjit,0,0,0,0
1653421077257,CSE 240A,A00,090123,Zhao; Jishen,0,0,189,189
1653421077779,CSE 243A,A00,090124,Orailoglu; Alex,3,0,15,12
1653421078302,CSE 249B,A00,090125,Kahng; Andrew Byun,13,0,20,7
1653421078824,CSE 250A,A00,090126,Berg-Kirkpatrick; Taylor D,0,0,0,0
1653421079346,CSE 252A,A00,090127,Ochoa; Benjamin Lawrence,0,0,0,0
1653421079869,CSE 258,A01,090129,McAuley; Julian John,0,0,0,0
1653421080392,CSE 258R,A01,090131,McAuley; Julian John,0,0,0,0
1653421080915,CSE 274,A00,090132,Ramamoorthi; Ravi,0,0,0,0
1653421081445,CSE 276A,A00,090133,Christensen; Henrik I,0,0,0,0
1653421081974,CSE 276C,A00,090134,Christensen; Henrik I,0,0,0,0
1653421082504,CSE 290,A00,090135,Bafna; Vineet,0,0,0,0
1653421082504,CSE 290,B00,090136,Ramamoorthi; Ravi,0,0,0,0
1653421082504,CSE 290,C00,090137,Li; Tzumao,10,0,10,0
1653421082504,CSE 290,D00,090138,Zhou; Yuan-Yuan,10,0,10,0
1653421082504,CSE 290,E00,090139,Christensen; Henrik I,10,0,10,0
1653421082504,CSE 290,F00,094053,Shalev; Aaron D,0,0,0,0
1653421083098,CSE 291,A00,090140,Munyaka; Imani N. S.,0,0,0,0
1653421083098,CSE 291,B00,094880,Yu; Qi,0,0,0,0
1653421083098,CSE 291,C00,090142,Pannuto; Patrick William,0,0,0,0
1653421083098,CSE 291,D00,094881,Zhang; Yiying,0,0,0,0
1653421083098,CSE 291,E00,095118,Su; Hao,0,0,0,0
1653421083637,CSE 293,001,094905,Bafna; Vineet,9999,0,9999,0
1653421083637,CSE 293,002,094906,Bellare; Mihir,9999,0,9999,0
1653421083637,CSE 293,003,094907,Berg-Kirkpatrick; Taylor D,9999,0,9999,0
1653421083637,CSE 293,004,094908,Christensen; Henrik I,9999,0,9999,0
1653421083637,CSE 293,005,094909,Cottrell; Garrison W,9999,0,9999,0
1653421083637,CSE 293,006,094910,Deutsch; Alin Bernard,9999,0,9999,0
1653421083637,CSE 293,007,094911,Esmaeilzadeh; Hadi,9999,0,9999,0
1653421083637,CSE 293,008,094912,Freund; Yoav,9999,0,9999,0
1653421083637,CSE 293,009,094913,Griswold; William G.,9999,0,9999,0
1653421083637,CSE 293,010,094914,Gymrek; Melissa Ann,9999,0,9999,0
1653421083637,CSE 293,011,094915,Heninger; Nadia A,9999,0,9999,0
1653421083637,CSE 293,012,094916,Impagliazzo; Russell,9999,0,9999,0
1653421083637,CSE 293,013,094917,Jhala; Ranjit,9999,0,9999,0
1653421083637,CSE 293,014,094918,Kahng; Andrew Byun,9999,0,9999,0
1653421083637,CSE 293,015,094919,Kane; Daniel Mertz,9999,0,9999,0
1653421083637,CSE 293,016,094920,Kriegman; David J,9999,0,9999,0
1653421083637,CSE 293,017,094921,Kumar; Arun Kumar,9999,0,9999,0
1653421083637,CSE 293,018,094922,Lerner; Sorin,9999,0,9999,0
1653421083637,CSE 293,019,094923,Lovett; Shachar,9999,0,9999,0
1653421083637,CSE 293,020,094924,McAuley; Julian John,9999,0,9999,0
1653421083637,CSE 293,021,094925,Micciancio; Daniele,9999,0,9999,0
1653421083637,CSE 293,022,094926,Orailoglu; Alex,9999,0,9999,0
1653421083637,CSE 293,023,094927,Paturi; Ramamohan,9999,0,9999,0
1653421083637,CSE 293,024,094928,Polikarpova; Nadezhda,9999,0,9999,0
1653421083637,CSE 293,025,094929,Politz; Joseph Gibbs,9999,0,9999,0
1653421083637,CSE 293,026,094930,Porter; George M,9999,0,9999,0
1653421083637,CSE 293,027,094931,Porter; Leonard Emerson,9999,0,9999,0
1653421083637,CSE 293,028,094932,Ramamoorthi; Ravi,9999,0,9999,0
1653421083637,CSE 293,029,094933,Sahoo; Debashis,9999,0,9999,0
1653421083637,CSE 293,030,094934,Saul; Lawrence,9999,0,9999,0
1653421083637,CSE 293,031,094935,Savage; Stefan,9999,0,9999,0
1653421083637,CSE 293,032,094936,Schulze; Jurgen P.,9999,0,9999,0
1653421083637,CSE 293,033,094937,Snoeren; Alex C.,9999,0,9999,0
1653421083637,CSE 293,034,094938,Shang; Jingbo,9999,0,9999,0
1653421083637,CSE 293,035,094939,Stefan; Deian,9999,0,9999,0
1653421083637,CSE 293,036,094940,Su; Hao,9999,0,9999,0
1653421083637,CSE 293,037,094941,Swanson; Steven James,9999,0,9999,0
1653421083637,CSE 293,038,094942,Tullsen; Dean Michael,9999,0,9999,0
1653421083637,CSE 293,039,094943,Voelker; Geoffrey M.,9999,0,9999,0
1653421083637,CSE 293,040,094944,Zhao; Jishen,9999,0,9999,0
1653421083637,CSE 293,041,094945,Zhou; Yuan-Yuan,9999,0,9999,0
1653421083637,CSE 293,042,094946,Gao; Sicun,9998,0,9999,1
1653421083637,CSE 293,043,094947,Weibel; Nadir,9999,0,9999,0
1653421083637,CSE 293,044,094948,Gupta; Rajesh K.,9999,0,9999,0
1653421084162,CSE 294,A00,090143,Porter; George M,9,0,10,1
1653421084685,DSE 200,A00,091799,Staff,50,0,50,0
1653421085324,DSE 203,A00,091800,Gupta; Amarnath,30,0,30,0
1653421085852,DSE 250,A00,091801,Deutsch; Alin Bernard,30,0,30,0
1653421086376,DSE 290,A00,091802,Altintas De Callaf; Ilkay,50,0,50,0
1653421086913,ECE 200,001,091003,Antipa; Nicholas A,9999,0,9999,0
1653421086913,ECE 200,002,091004,Atanasov; Nikolay A.,9999,0,9999,0
1653421086913,ECE 200,003,091005,Bharadia; Dinesh,9999,0,9999,0
1653421086913,ECE 200,004,091006,Cheng; Chung Kuan,9999,0,9999,0
1653421086913,ECE 200,005,091007,Cosman; Pamela C.,9999,0,9999,0
1653421086913,ECE 200,006,091008,Staff,9999,0,9999,0
1653421086913,ECE 200,007,091009,Dayeh; Shadi Ahmad,9999,0,9999,0
1653421086913,ECE 200,008,091010,Fainman; Yeshaiahu,9999,0,9999,0
1653421086913,ECE 200,009,091011,Ford; Joseph Earl,9999,0,9999,0
1653421086913,ECE 200,010,091012,Franceschetti; Massimo,9999,0,9999,0
1653421086913,ECE 200,011,091013,Fullerton; Eric E,9999,0,9999,0
1653421086913,ECE 200,012,091014,Galton; Ian A,9999,0,9999,0
1653421086913,ECE 200,013,091015,Gilja; Vikash,9999,0,9999,0
1653421086913,ECE 200,014,091016,Hall; Drew A.,9999,0,9999,0
1653421086913,ECE 200,015,091017,Hsueh; Tzu-Chien,9999,0,9999,0
1653421086913,ECE 200,016,091018,Javidi; Tara,9999,0,9999,0
1653421086913,ECE 200,017,091019,Kahng; Andrew Byun,9999,0,9999,0
1653421086913,ECE 200,018,091020,Kim; Young-Han,9999,0,9999,0
1653421086913,ECE 200,019,091021,Koushanfar; Farinaz,9999,0,9999,0
1653421086913,ECE 200,020,091022,Kuzum; Duygu,9999,0,9999,0
1653421086913,ECE 200,021,091023,Le; Hanh-Phuc,9999,0,9999,0
1653421086913,ECE 200,022,091024,Lin; Bill,9999,0,9999,0
1653421086913,ECE 200,023,091025,Liu; Zhaowei,9999,0,9999,0
1653421086913,ECE 200,024,091026,Lo; Yu-Hwa,9999,0,9999,0
1653421086913,ECE 200,025,091027,Lomakin; Vitaliy,9999,0,9999,0
1653421086913,ECE 200,026,091028,Mercier; Patrick Philip,9999,0,9999,0
1653421086913,ECE 200,027,091029,Meyer; Florian,9999,0,9999,0
1653421086913,ECE 200,028,091030,Milstein; Laurence B.,9999,0,9999,0
1653421086913,ECE 200,029,091031,Mir Arabbaygi; Siavash,9999,0,9999,0
1653421086913,ECE 200,030,091032,Mookherjea; Shayan,9999,0,9999,0
1653421086913,ECE 200,031,091033,Morris; Karcher William,9999,0,9999,0
1653421086913,ECE 200,032,091034,Ng; Tse Nga,9999,0,9999,0
1653421086913,ECE 200,033,091035,Nguyen; Truong Quang,9999,0,9999,0
1653421086913,ECE 200,034,091036,Nomura; Kenji,9999,0,9999,0
1653421086913,ECE 200,035,091037,Orlitsky; Alon,9999,0,9999,0
1653421086913,ECE 200,036,091038,Pal; Piya,9999,0,9999,0
1653421086913,ECE 200,037,091039,Papen; George C.,9999,0,9999,0
1653421086913,ECE 200,038,091040,Radic; Stojan,9999,0,9999,0
1653421086913,ECE 200,039,091041,Rao; Bhaskar D.,9999,0,9999,0
1653421086913,ECE 200,040,091042,Rao; Ramesh R,9999,0,9999,0
1653421086913,ECE 200,041,091043,Rebeiz; Gabriel,9999,0,9999,0
1653421086913,ECE 200,042,091044,Sanford; John R,9999,0,9999,0
1653421086913,ECE 200,043,091045,Siegel; Paul H.,9999,0,9999,0
1653421086913,ECE 200,044,091046,Sievenpiper; Daniel F.,9999,0,9999,0
1653421086913,ECE 200,045,091047,Sworder; David D.,9999,0,9999,0
1653421086913,ECE 200,046,091048,Taur; Yuan,9999,0,9999,0
1653421086913,ECE 200,047,091049,Touri; Behrouz,9999,0,9999,0
1653421086913,ECE 200,048,091050,Trivedi; Mohan M.,9999,0,9999,0
1653421086913,ECE 200,049,091051,Vardy; Alexander,9999,0,9999,0
1653421086913,ECE 200,050,091052,Vasconcelos; Nuno,9999,0,9999,0
1653421086913,ECE 200,051,091053,Wang; Xiaolong,9999,0,9999,0
1653421086913,ECE 200,052,091054,Xie; Pengtao,9999,0,9999,0
1653421086913,ECE 200,053,091055,Yip; Michael,9999,0,9999,0
1653421086913,ECE 200,054,091056,Zeger; Kenneth A.,9999,0,9999,0
1653421086913,ECE 200,055,091057,Zhang; Xinyu,9999,0,9999,0
1653421086913,ECE 200,056,091058,Turakhia; Yatish Girish,9999,0,9999,0
1653421086913,ECE 200,057,091059,Kang; Mingu,9999,0,9999,0
1653421086913,ECE 200,058,091060,Shi; Yuanyuan,9999,0,9999,0
1653421086913,ECE 200,059,091061,Wang; Edward Jay,9999,0,9999,0
1653421086913,ECE 200,060,091062,Zheng; Yang,9999,0,9999,0
1653421087436,ECE 203,A00,091065,Mercier; Patrick Philip,0,0,0,0
1653421087972,ECE 207A,A00,091605,Liu; Thomas Tao-Ming,0,0,0,0
1653421088492,ECE 212AN,A00,091068,Nomura; Kenji,0,0,0,0
1653421089018,ECE 222A,A00,091069,Rebeiz; Gabriel,0,0,0,0
1653421089542,ECE 225A,A00,091070,Orlitsky; Alon,0,0,0,0
1653421090069,ECE 230A,A00,091071,Nomura; Kenji,0,0,0,0
1653421090601,ECE 236A,A00,091072,Dayeh; Shadi Ahmad,0,0,0,0
1653421091133,ECE 238A,A00,091073,Luo; Jian,0,0,0,0
1653421091133,ECE 238A,B00,091074,Luo; Jian,0,0,0,0
1653421091658,ECE 240A,A00,091075,Radic; Stojan,0,0,0,0
1653421092181,ECE 247A,A00,091592,Shi; Lingyan,0,0,0,0
1653421092715,ECE 250,A00,091076,Touri; Behrouz,0,0,0,0
1653421093248,ECE 251C,A00,091078,Nguyen; Truong Quang,0,0,0,0
1653421093777,ECE 253,A00,091079,Cosman; Pamela C.,0,0,0,0
1653421094308,ECE 255A,A00,091080,Orlitsky; Alon,0,0,0,0
1653421094832,ECE 257A,A00,091081,Zhang; Xinyu,0,0,0,0
1653421095354,ECE 260A,A01,091084,Eldon; John,0,0,0,0
1653421095882,ECE 264C,A00,091085,Galton; Ian A,0,0,0,0
1653421096410,ECE 265C,A00,094889,Presti; Calogero Davide,0,0,0,9
1653421096934,ECE 266,A01,091087,Hall; Drew A.,0,0,0,0
1653421097984,ECE 271A,A00,091090,Vasconcelos; Nuno,0,0,0,0
1653421098510,ECE 272B,A00,091091,Sworder; David D.,0,0,0,0
1653421099048,ECE 275A,A00,091092,Meyer; Florian,0,0,0,0
1653421099569,ECE 277,A00,091093,An; Cheolhong,0,0,0,0
1653421100105,ECE 283,A00,091094,Le; Hanh-Phuc,0,0,0,0
1653421100636,ECE 284,A00,091095,Kang; Mingu,0,0,0,0
1653421100636,ECE 284,B00,091096,Wang; Edward Jay,0,0,0,0
1653421101163,ECE 285,A00,094334,Touri; Behrouz,0,0,0,0
1653421101693,ECE 289,A00,091097,Whelan; David Arthur,0,0,0,0
1653421102226,MATH 200A,A00,087414,Salehi Golsefidy; Alireza,7,0,8,1
1653421102753,MATH 202A,A00,087415,Gill; Philip E.,3,0,8,5
1653421103282,MATH 203A,A00,087416,Oprea; Dragos N.,6,0,8,2
1653421103821,MATH 204A,A00,087417,Kedlaya; Kiran S.,6,0,8,2
1653421104346,MATH 205,A00,087418,Sorensen; Claus M,6,0,8,2
1653421104871,MATH 206A,A00,087419,Izadi; Elham,7,0,8,1
1653421105404,MATH 207A,A00,087420,Mohammadi; Amir,6,0,8,2
1653421105929,MATH 208,A00,087421,Staff,9,0,10,1
1653421106454,MATH 209,A00,087422,Staff,10,0,10,0
1653421106979,MATH 218,A00,087423,Staff,10,0,10,0
1653421107502,MATH 220A,A00,087424,Novak; Jonathan I,7,0,8,1
1653421108029,MATH 231A,A00,087425,Bejenaru; Ioan,4,0,8,4
1653421108555,MATH 240A,A00,087426,Ebenfelt; Peter F,5,0,8,3
1653421109078,MATH 243,A00,087427,Staff,9,0,10,1
1653421109604,MATH 248,A00,087429,Staff,10,0,10,0
1653421110134,MATH 250A,A00,087430,Spolaor; Luca,5,0,8,3
1653421110666,MATH 257A,A00,087431,Spolaor; Luca,7,0,8,1
1653421111195,MATH 258,A00,087432,Staff,9,0,10,1
1653421111745,MATH 264A,A00,087433,Warnke; Lutz Peter,5,0,8,3
1653421112269,MATH 268,A00,087434,Staff,15,0,15,0
1653421112806,MATH 269,A00,087435,Staff,14,0,15,1
1653421113334,MATH 270A,A00,087436,Nie; Jiawang,0,0,8,8
1653421113857,MATH 272A,A00,087437,Tian; Xiaochuan,2,0,8,6
1653421114381,MATH 274,A01,087439,Cheng; Li-Tien,9,0,10,1
1653421114381,MATH 274,A02,087440,Cheng; Li-Tien,10,0,10,0
1653421114909,MATH 278A,A00,087441,Staff,8,0,10,2
1653421115435,MATH 278B,A00,087442,Staff,8,0,10,2
1653421115958,MATH 278C,A00,087443,Staff,8,0,10,2
1653421116479,MATH 280A,A00,087444,Zheng; Tianyi,0,0,8,8
1653421117003,MATH 281A,A00,087445,Bradic; Jelena,0,0,8,8
1653421117527,MATH 282A,A00,087446,Zhang; Danna,0,0,8,8
1653421118052,MATH 283,A00,087447,Tesler; Glenn,0,0,0,14
1653421118588,MATH 286,A00,087448,Kemp; Todd Aahron,6,0,8,2
1653421119113,MATH 287D,A00,087449,Bradic; Jelena,8,0,8,0
1653421119641,MATH 288,A00,087450,Staff,14,0,15,1
1653421119641,MATH 288,B00,087451,Staff,15,0,15,0
1653421119641,MATH 288,C00,087452,Staff,15,0,15,0
1653421120181,MATH 290A,A00,087453,Xu; Zhouli,7,0,8,1
1653421120720,MATH 291A,A00,087454,Xu; Zhouli,7,0,8,1
1653421121250,MATH 292,A00,087455,Staff,10,0,10,0
1653421121781,MATH 295,A00,087456,Staff,50,0,50,0
1653421122303,MATH 297,001,087457,Staff,998,0,999,1
1653421695160,COGS 200,A01,087991,Staff,48,0,50,2
1653421695692,COGS 201,A01,094504,Rangel; Lara M,17,0,25,8
1653421696225,COGS 203,A00,087992,Coulson; Seana M,19,0,20,1
1653421696753,COGS 210A,001,087993,Greene; Deanna Jacquelyn,9998,0,9999,1
1653421696753,COGS 210A,002,087994,Saygin; Ayse P,9999,0,9999,0
1653421696753,COGS 210A,003,087995,Xia; Haijun,9999,0,9999,0
1653421696753,COGS 210A,004,087996,Nitz; Douglas A.,9999,0,9999,0
1653421696753,COGS 210A,005,087997,Hollan; James D.,9999,0,9999,0
1653421696753,COGS 210A,006,087998,Deak; Gedeon O.,9998,0,9999,1
1653421696753,COGS 210A,007,087999,Rossano; Federico,9999,0,9999,0
1653421697274,COGS 211A,A00,088000,Coulson; Seana M,9997,0,9999,2
1653421697814,COGS 229,A00,088002,Staff,23,0,25,2
1653421698343,COGS 260,B00,094231,Staff,17,0,20,3
1653421698343,COGS 260,A00,088004,Nitz; Douglas A.,9998,0,9999,1
1653421698865,CSE 202,A00,090110,Paturi; Ramamohan,0,0,0,0
1653421698865,CSE 202,B00,090111,Paturi; Ramamohan,0,0,0,0
1653421699388,CSE 207B,A00,090112,Heninger; Nadia A,0,0,0,0
1653421699910,CSE 208,A00,094858,Micciancio; Daniele,0,0,0,0
1653421700437,CSE 210,A00,090113,Powell; Thomas Allan,0,0,0,0
1653421700967,CSE 219,A00,090898,Staff,0,0,0,0
1653421701497,CSE 221,A00,090114,Zhou; Yuan-Yuan,0,0,0,0
1653421702018,CSE 229A,A00,090115,Porter; George M,0,0,0,0
1653421702544,CSE 229C,A00,090116,Savage; Stefan,0,0,0,0
1653421703068,CSE 230,A00,090117,Jhala; Ranjit,0,0,0,0
1653421703594,CSE 232,A00,090118,Papakonstantinou; Yannis,0,0,0,0
1653421704115,CSE 239A,A00,090121,Kumar; Arun Kumar,0,0,0,0
1653421704638,CSE 239B,A00,090122,Jhala; Ranjit,0,0,0,0
1653421705177,CSE 240A,A00,090123,Zhao; Jishen,0,0,189,189
1653421705700,CSE 243A,A00,090124,Orailoglu; Alex,3,0,15,12
1653421706228,CSE 249B,A00,090125,Kahng; Andrew Byun,13,0,20,7
1653421706755,CSE 250A,A00,090126,Berg-Kirkpatrick; Taylor D,0,0,0,0
1653421707285,CSE 252A,A00,090127,Ochoa; Benjamin Lawrence,0,0,0,0
1653421707814,CSE 258,A01,090129,McAuley; Julian John,0,0,0,0
1653421708348,CSE 258R,A01,090131,McAuley; Julian John,0,0,0,0
1653421708872,CSE 274,A00,090132,Ramamoorthi; Ravi,0,0,0,0
1653421709401,CSE 276A,A00,090133,Christensen; Henrik I,0,0,0,0
1653421709926,CSE 276C,A00,090134,Christensen; Henrik I,0,0,0,0
1653421710449,CSE 290,A00,090135,Bafna; Vineet,0,0,0,0
1653421710449,CSE 290,B00,090136,Ramamoorthi; Ravi,0,0,0,0
1653421710449,CSE 290,C00,090137,Li; Tzumao,10,0,10,0
1653421710449,CSE 290,D00,090138,Zhou; Yuan-Yuan,10,0,10,0
1653421710449,CSE 290,E00,090139,Christensen; Henrik I,10,0,10,0
1653421710449,CSE 290,F00,094053,Shalev; Aaron D,0,0,0,0
1653421710976,CSE 291,A00,090140,Munyaka; Imani N. S.,0,0,0,0
1653421710976,CSE 291,B00,094880,Yu; Qi,0,0,0,0
1653421710976,CSE 291,C00,090142,Pannuto; Patrick William,0,0,0,0
1653421710976,CSE 291,D00,094881,Zhang; Yiying,0,0,0,0
1653421710976,CSE 291,E00,095118,Su; Hao,0,0,0,0
1653421711526,CSE 293,001,094905,Bafna; Vineet,9999,0,9999,0
1653421711526,CSE 293,002,094906,Bellare; Mihir,9999,0,9999,0
1653421711526,CSE 293,003,094907,Berg-Kirkpatrick; Taylor D,9999,0,9999,0
1653421711526,CSE 293,004,094908,Christensen; Henrik I,9999,0,9999,0
1653421711526,CSE 293,005,094909,Cottrell; Garrison W,9999,0,9999,0
1653421711526,CSE 293,006,094910,Deutsch; Alin Bernard,9999,0,9999,0
1653421711526,CSE 293,007,094911,Esmaeilzadeh; Hadi,9999,0,9999,0
1653421711526,CSE 293,008,094912,Freund; Yoav,9999,0,9999,0
1653421711526,CSE 293,009,094913,Griswold; William G.,9999,0,9999,0
1653421711526,CSE 293,010,094914,Gymrek; Melissa Ann,9999,0,9999,0
1653421711526,CSE 293,011,094915,Heninger; Nadia A,9999,0,9999,0
1653421711526,CSE 293,012,094916,Impagliazzo; Russell,9999,0,9999,0
1653421711526,CSE 293,013,094917,Jhala; Ranjit,9999,0,9999,0
1653421711526,CSE 293,014,094918,Kahng; Andrew Byun,9999,0,9999,0
1653421711526,CSE 293,015,094919,Kane; Daniel Mertz,9999,0,9999,0
1653421711526,CSE 293,016,094920,Kriegman; David J,9999,0,9999,0
1653421711526,CSE 293,017,094921,Kumar; Arun Kumar,9999,0,9999,0
1653421711526,CSE 293,018,094922,Lerner; Sorin,9999,0,9999,0
1653421711526,CSE 293,019,094923,Lovett; Shachar,9999,0,9999,0
1653421711526,CSE 293,020,094924,McAuley; Julian John,9999,0,9999,0
1653421711526,CSE 293,021,094925,Micciancio; Daniele,9999,0,9999,0
1653421711526,CSE 293,022,094926,Orailoglu; Alex,9999,0,9999,0
1653421711526,CSE 293,023,094927,Paturi; Ramamohan,9999,0,9999,0
1653421711526,CSE 293,024,094928,Polikarpova; Nadezhda,9999,0,9999,0
1653421711526,CSE 293,025,094929,Politz; Joseph Gibbs,9999,0,9999,0
1653421711526,CSE 293,026,094930,Porter; George M,9999,0,9999,0
1653421711526,CSE 293,027,094931,Porter; Leonard Emerson,9999,0,9999,0
1653421711526,CSE 293,028,094932,Ramamoorthi; Ravi,9999,0,9999,0
1653421711526,CSE 293,029,094933,Sahoo; Debashis,9999,0,9999,0
1653421711526,CSE 293,030,094934,Saul; Lawrence,9999,0,9999,0
1653421711526,CSE 293,031,094935,Savage; Stefan,9999,0,9999,0
1653421711526,CSE 293,032,094936,Schulze; Jurgen P.,9999,0,9999,0
1653421711526,CSE 293,033,094937,Snoeren; Alex C.,9999,0,9999,0
1653421711526,CSE 293,034,094938,Shang; Jingbo,9999,0,9999,0
1653421711526,CSE 293,035,094939,Stefan; Deian,9999,0,9999,0
1653421711526,CSE 293,036,094940,Su; Hao,9999,0,9999,0
1653421711526,CSE 293,037,094941,Swanson; Steven James,9999,0,9999,0
1653421711526,CSE 293,038,094942,Tullsen; Dean Michael,9999,0,9999,0
1653421711526,CSE 293,039,094943,Voelker; Geoffrey M.,9999,0,9999,0
1653421711526,CSE 293,040,094944,Zhao; Jishen,9999,0,9999,0
1653421711526,CSE 293,041,094945,Zhou; Yuan-Yuan,9999,0,9999,0
1653421711526,CSE 293,042,094946,Gao; Sicun,9998,0,9999,1
1653421711526,CSE 293,043,094947,Weibel; Nadir,9999,0,9999,0
1653421711526,CSE 293,044,094948,Gupta; Rajesh K.,9999,0,9999,0
1653421712051,CSE 294,A00,090143,Porter; George M,9,0,10,1
1653421712573,DSE 200,A00,091799,Staff,50,0,50,0
1653421713095,DSE 203,A00,091800,Gupta; Amarnath,30,0,30,0
1653421713618,DSE 250,A00,091801,Deutsch; Alin Bernard,30,0,30,0
1653421714142,DSE 290,A00,091802,Altintas De Callaf; Ilkay,50,0,50,0
1653421714674,ECE 200,001,091003,Antipa; Nicholas A,9999,0,9999,0
1653421714674,ECE 200,002,091004,Atanasov; Nikolay A.,9999,0,9999,0
1653421714674,ECE 200,003,091005,Bharadia; Dinesh,9999,0,9999,0
1653421714674,ECE 200,004,091006,Cheng; Chung Kuan,9999,0,9999,0
1653421714674,ECE 200,005,091007,Cosman; Pamela C.,9999,0,9999,0
1653421714674,ECE 200,006,091008,Staff,9999,0,9999,0
1653421714674,ECE 200,007,091009,Dayeh; Shadi Ahmad,9999,0,9999,0
1653421714674,ECE 200,008,091010,Fainman; Yeshaiahu,9999,0,9999,0
1653421714674,ECE 200,009,091011,Ford; Joseph Earl,9999,0,9999,0
1653421714674,ECE 200,010,091012,Franceschetti; Massimo,9999,0,9999,0
1653421714674,ECE 200,011,091013,Fullerton; Eric E,9999,0,9999,0
1653421714674,ECE 200,012,091014,Galton; Ian A,9999,0,9999,0
1653421714674,ECE 200,013,091015,Gilja; Vikash,9999,0,9999,0
1653421714674,ECE 200,014,091016,Hall; Drew A.,9999,0,9999,0
1653421714674,ECE 200,015,091017,Hsueh; Tzu-Chien,9999,0,9999,0
1653421714674,ECE 200,016,091018,Javidi; Tara,9999,0,9999,0
1653421714674,ECE 200,017,091019,Kahng; Andrew Byun,9999,0,9999,0
1653421714674,ECE 200,018,091020,Kim; Young-Han,9999,0,9999,0
1653421714674,ECE 200,019,091021,Koushanfar; Farinaz,9999,0,9999,0
1653421714674,ECE 200,020,091022,Kuzum; Duygu,9999,0,9999,0
1653421714674,ECE 200,021,091023,Le; Hanh-Phuc,9999,0,9999,0
1653421714674,ECE 200,022,091024,Lin; Bill,9999,0,9999,0
1653421714674,ECE 200,023,091025,Liu; Zhaowei,9999,0,9999,0
1653421714674,ECE 200,024,091026,Lo; Yu-Hwa,9999,0,9999,0
1653421714674,ECE 200,025,091027,Lomakin; Vitaliy,9999,0,9999,0
1653421714674,ECE 200,026,091028,Mercier; Patrick Philip,9999,0,9999,0
1653421714674,ECE 200,027,091029,Meyer; Florian,9999,0,9999,0
1653421714674,ECE 200,028,091030,Milstein; Laurence B.,9999,0,9999,0
1653421714674,ECE 200,029,091031,Mir Arabbaygi; Siavash,9999,0,9999,0
1653421714674,ECE 200,030,091032,Mookherjea; Shayan,9999,0,9999,0
1653421714674,ECE 200,031,091033,Morris; Karcher William,9999,0,9999,0
1653421714674,ECE 200,032,091034,Ng; Tse Nga,9999,0,9999,0
1653421714674,ECE 200,033,091035,Nguyen; Truong Quang,9999,0,9999,0
1653421714674,ECE 200,034,091036,Nomura; Kenji,9999,0,9999,0
1653421714674,ECE 200,035,091037,Orlitsky; Alon,9999,0,9999,0
1653421714674,ECE 200,036,091038,Pal; Piya,9999,0,9999,0
1653421714674,ECE 200,037,091039,Papen; George C.,9999,0,9999,0
1653421714674,ECE 200,038,091040,Radic; Stojan,9999,0,9999,0
1653421714674,ECE 200,039,091041,Rao; Bhaskar D.,9999,0,9999,0
1653421714674,ECE 200,040,091042,Rao; Ramesh R,9999,0,9999,0
1653421714674,ECE 200,041,091043,Rebeiz; Gabriel,9999,0,9999,0
1653421714674,ECE 200,042,091044,Sanford; John R,9999,0,9999,0
1653421714674,ECE 200,043,091045,Siegel; Paul H.,9999,0,9999,0
1653421714674,ECE 200,044,091046,Sievenpiper; Daniel F.,9999,0,9999,0
1653421714674,ECE 200,045,091047,Sworder; David D.,9999,0,9999,0
1653421714674,ECE 200,046,091048,Taur; Yuan,9999,0,9999,0
1653421714674,ECE 200,047,091049,Touri; Behrouz,9999,0,9999,0
1653421714674,ECE 200,048,091050,Trivedi; Mohan M.,9999,0,9999,0
1653421714674,ECE 200,049,091051,Vardy; Alexander,9999,0,9999,0
1653421714674,ECE 200,050,091052,Vasconcelos; Nuno,9999,0,9999,0
1653421714674,ECE 200,051,091053,Wang; Xiaolong,9999,0,9999,0
1653421714674,ECE 200,052,091054,Xie; Pengtao,9999,0,9999,0
1653421714674,ECE 200,053,091055,Yip; Michael,9999,0,9999,0
1653421714674,ECE 200,054,091056,Zeger; Kenneth A.,9999,0,9999,0
1653421714674,ECE 200,055,091057,Zhang; Xinyu,9999,0,9999,0
1653421714674,ECE 200,056,091058,Turakhia; Yatish Girish,9999,0,9999,0
1653421714674,ECE 200,057,091059,Kang; Mingu,9999,0,9999,0
1653421714674,ECE 200,058,091060,Shi; Yuanyuan,9999,0,9999,0
1653421714674,ECE 200,059,091061,Wang; Edward Jay,9999,0,9999,0
1653421714674,ECE 200,060,091062,Zheng; Yang,9999,0,9999,0
1653421715209,ECE 203,A00,091065,Mercier; Patrick Philip,0,0,0,0
1653421715739,ECE 207A,A00,091605,Liu; Thomas Tao-Ming,0,0,0,0
1653421716264,ECE 212AN,A00,091068,Nomura; Kenji,0,0,0,0
1653421716786,ECE 222A,A00,091069,Rebeiz; Gabriel,0,0,0,0
1653421717314,ECE 225A,A00,091070,Orlitsky; Alon,0,0,0,0
1653421717837,ECE 230A,A00,091071,Nomura; Kenji,0,0,0,0
1653421718372,ECE 236A,A00,091072,Dayeh; Shadi Ahmad,0,0,0,0
1653421718903,ECE 238A,A00,091073,Luo; Jian,0,0,0,0
1653421718903,ECE 238A,B00,091074,Luo; Jian,0,0,0,0
1653421719429,ECE 240A,A00,091075,Radic; Stojan,0,0,0,0
1653421719954,ECE 247A,A00,091592,Shi; Lingyan,0,0,0,0
1653421720476,ECE 250,A00,091076,Touri; Behrouz,0,0,0,0
1653421720997,ECE 251C,A00,091078,Nguyen; Truong Quang,0,0,0,0
1653421721518,ECE 253,A00,091079,Cosman; Pamela C.,0,0,0,0
1653421722049,ECE 255A,A00,091080,Orlitsky; Alon,0,0,0,0
1653421722570,ECE 257A,A00,091081,Zhang; Xinyu,0,0,0,0
1653421723096,ECE 260A,A01,091084,Eldon; John,0,0,0,0
1653421723622,ECE 264C,A00,091085,Galton; Ian A,0,0,0,0
1653421724147,ECE 265C,A00,094889,Presti; Calogero Davide,0,0,0,9
1653421724670,ECE 266,A01,091087,Hall; Drew A.,0,0,0,0
1653421725732,ECE 271A,A00,091090,Vasconcelos; Nuno,0,0,0,0
1653421726259,ECE 272B,A00,091091,Sworder; David D.,0,0,0,0
1653421726784,ECE 275A,A00,091092,Meyer; Florian,0,0,0,0
1653421727311,ECE 277,A00,091093,An; Cheolhong,0,0,0,0
1653421727842,ECE 283,A00,091094,Le; Hanh-Phuc,0,0,0,0
1653421728371,ECE 284,A00,091095,Kang; Mingu,0,0,0,0
1653421728371,ECE 284,B00,091096,Wang; Edward Jay,0,0,0,0
1653421728893,ECE 285,A00,094334,Touri; Behrouz,0,0,0,0
1653421729431,ECE 289,A00,091097,Whelan; David Arthur,0,0,0,0
1653421729958,MATH 200A,A00,087414,Salehi Golsefidy; Alireza,7,0,8,1
1653421730480,MATH 202A,A00,087415,Gill; Philip E.,3,0,8,5
1653421731013,MATH 203A,A00,087416,Oprea; Dragos N.,6,0,8,2
1653421731535,MATH 204A,A00,087417,Kedlaya; Kiran S.,6,0,8,2
1653421732074,MATH 205,A00,087418,Sorensen; Claus M,6,0,8,2
1653421732599,MATH 206A,A00,087419,Izadi; Elham,7,0,8,1
1653421733121,MATH 207A,A00,087420,Mohammadi; Amir,6,0,8,2
1653421733650,MATH 208,A00,087421,Staff,9,0,10,1
1653421734174,MATH 209,A00,087422,Staff,10,0,10,0
1653421734704,MATH 218,A00,087423,Staff,10,0,10,0
1653421735238,MATH 220A,A00,087424,Novak; Jonathan I,7,0,8,1
1653421735772,MATH 231A,A00,087425,Bejenaru; Ioan,4,0,8,4
1653421736307,MATH 240A,A00,087426,Ebenfelt; Peter F,5,0,8,3
1653421736939,MATH 243,A00,087427,Staff,9,0,10,1
1653421737465,MATH 248,A00,087429,Staff,10,0,10,0
1653421737992,MATH 250A,A00,087430,Spolaor; Luca,5,0,8,3
1653421738517,MATH 257A,A00,087431,Spolaor; Luca,7,0,8,1
1653421739043,MATH 258,A00,087432,Staff,9,0,10,1
1653421739569,MATH 264A,A00,087433,Warnke; Lutz Peter,5,0,8,3
1653421740090,MATH 268,A00,087434,Staff,15,0,15,0
1653421740620,MATH 269,A00,087435,Staff,14,0,15,1
1653421741151,MATH 270A,A00,087436,Nie; Jiawang,0,0,8,8
1653421741688,MATH 272A,A00,087437,Tian; Xiaochuan,2,0,8,6
1653421742210,MATH 274,A01,087439,Cheng; Li-Tien,9,0,10,1
1653421742210,MATH 274,A02,087440,Cheng; Li-Tien,10,0,10,0
1653421742745,MATH 278A,A00,087441,Staff,8,0,10,2
1653421743275,MATH 278B,A00,087442,Staff,8,0,10,2
1653421743798,MATH 278C,A00,087443,Staff,8,0,10,2
1653421744325,MATH 280A,A00,087444,Zheng; Tianyi,0,0,8,8
1653421744848,MATH 281A,A00,087445,Bradic; Jelena,0,0,8,8
1653421745379,MATH 282A,A00,087446,Zhang; Danna,0,0,8,8
1653421745918,MATH 283,A00,087447,Tesler; Glenn,0,0,0,14
1653421746443,MATH 286,A00,087448,Kemp; Todd Aahron,6,0,8,2
1653421746970,MATH 287D,A00,087449,Bradic; Jelena,8,0,8,0
1653421747494,MATH 288,A00,087450,Staff,14,0,15,1
1653421747494,MATH 288,B00,087451,Staff,15,0,15,0
1653421747494,MATH 288,C00,087452,Staff,15,0,15,0
1653421748017,MATH 290A,A00,087453,Xu; Zhouli,7,0,8,1
1653421748539,MATH 291A,A00,087454,Xu; Zhouli,7,0,8,1
1653421749060,MATH 292,A00,087455,Staff,10,0,10,0
1653421749586,MATH 295,A00,087456,Staff,50,0,50,0
1653421750110,MATH 297,001,087457,Staff,998,0,999,1
1653422311841,COGS 200,A01,087991,Staff,48,0,50,2
1653422312372,COGS 201,A01,094504,Rangel; Lara M,17,0,25,8
1653422312893,COGS 203,A00,087992,Coulson; Seana M,19,0,20,1
1653422313424,COGS 210A,001,087993,Greene; Deanna Jacquelyn,9998,0,9999,1
1653422313424,COGS 210A,002,087994,Saygin; Ayse P,9999,0,9999,0
1653422313424,COGS 210A,003,087995,Xia; Haijun,9999,0,9999,0
1653422313424,COGS 210A,004,087996,Nitz; Douglas A.,9999,0,9999,0
1653422313424,COGS 210A,005,087997,Hollan; James D.,9999,0,9999,0
1653422313424,COGS 210A,006,087998,Deak; Gedeon O.,9998,0,9999,1
1653422313424,COGS 210A,007,087999,Rossano; Federico,9999,0,9999,0
1653422313948,COGS 211A,A00,088000,Coulson; Seana M,9997,0,9999,2
1653422314474,COGS 229,A00,088002,Staff,23,0,25,2
1653422315006,COGS 260,B00,094231,Staff,17,0,20,3
1653422315006,COGS 260,A00,088004,Nitz; Douglas A.,9998,0,9999,1
1653422315530,CSE 202,A00,090110,Paturi; Ramamohan,0,0,0,0
1653422315530,CSE 202,B00,090111,Paturi; Ramamohan,0,0,0,0
1653422316051,CSE 207B,A00,090112,Heninger; Nadia A,0,0,0,0
1653422316578,CSE 208,A00,094858,Micciancio; Daniele,0,0,0,0
1653422317117,CSE 210,A00,090113,Powell; Thomas Allan,0,0,0,0
1653422317639,CSE 219,A00,090898,Staff,0,0,0,0
1653422318162,CSE 221,A00,090114,Zhou; Yuan-Yuan,0,0,0,0
1653422318683,CSE 229A,A00,090115,Porter; George M,0,0,0,0
1653422319213,CSE 229C,A00,090116,Savage; Stefan,0,0,0,0
1653422319740,CSE 230,A00,090117,Jhala; Ranjit,0,0,0,0
1653422320267,CSE 232,A00,090118,Papakonstantinou; Yannis,0,0,0,0
1653422320788,CSE 239A,A00,090121,Kumar; Arun Kumar,0,0,0,0
1653422321310,CSE 239B,A00,090122,Jhala; Ranjit,0,0,0,0
1653422321837,CSE 240A,A00,090123,Zhao; Jishen,0,0,189,189
1653422322358,CSE 243A,A00,090124,Orailoglu; Alex,3,0,15,12
1653422322880,CSE 249B,A00,090125,Kahng; Andrew Byun,13,0,20,7
1653422323407,CSE 250A,A00,090126,Berg-Kirkpatrick; Taylor D,0,0,0,0
1653422323934,CSE 252A,A00,090127,Ochoa; Benjamin Lawrence,0,0,0,0
1653422324459,CSE 258,A01,090129,McAuley; Julian John,0,0,0,0
1653422324982,CSE 258R,A01,090131,McAuley; Julian John,0,0,0,0
1653422325506,CSE 274,A00,090132,Ramamoorthi; Ravi,0,0,0,0
1653422326123,CSE 276A,A00,090133,Christensen; Henrik I,0,0,0,0
1653422326658,CSE 276C,A00,090134,Christensen; Henrik I,0,0,0,0
1653422327200,CSE 290,A00,090135,Bafna; Vineet,0,0,0,0
1653422327200,CSE 290,B00,090136,Ramamoorthi; Ravi,0,0,0,0
1653422327200,CSE 290,C00,090137,Li; Tzumao,10,0,10,0
1653422327200,CSE 290,D00,090138,Zhou; Yuan-Yuan,10,0,10,0
1653422327200,CSE 290,E00,090139,Christensen; Henrik I,10,0,10,0
1653422327200,CSE 290,F00,094053,Shalev; Aaron D,0,0,0,0
1653422327737,CSE 291,A00,090140,Munyaka; Imani N. S.,0,0,0,0
1653422327737,CSE 291,B00,094880,Yu; Qi,0,0,0,0
1653422327737,CSE 291,C00,090142,Pannuto; Patrick William,0,0,0,0
1653422327737,CSE 291,D00,094881,Zhang; Yiying,0,0,0,0
1653422327737,CSE 291,E00,095118,Su; Hao,0,0,0,0
1653422328292,CSE 293,001,094905,Bafna; Vineet,9999,0,9999,0
1653422328292,CSE 293,002,094906,Bellare; Mihir,9999,0,9999,0
1653422328292,CSE 293,003,094907,Berg-Kirkpatrick; Taylor D,9999,0,9999,0
1653422328292,CSE 293,004,094908,Christensen; Henrik I,9999,0,9999,0
1653422328292,CSE 293,005,094909,Cottrell; Garrison W,9999,0,9999,0
1653422328292,CSE 293,006,094910,Deutsch; Alin Bernard,9999,0,9999,0
1653422328292,CSE 293,007,094911,Esmaeilzadeh; Hadi,9999,0,9999,0
1653422328292,CSE 293,008,094912,Freund; Yoav,9999,0,9999,0
1653422328292,CSE 293,009,094913,Griswold; William G.,9999,0,9999,0
1653422328292,CSE 293,010,094914,Gymrek; Melissa Ann,9999,0,9999,0
1653422328292,CSE 293,011,094915,Heninger; Nadia A,9999,0,9999,0
1653422328292,CSE 293,012,094916,Impagliazzo; Russell,9999,0,9999,0
1653422328292,CSE 293,013,094917,Jhala; Ranjit,9999,0,9999,0
1653422328292,CSE 293,014,094918,Kahng; Andrew Byun,9999,0,9999,0
1653422328292,CSE 293,015,094919,Kane; Daniel Mertz,9999,0,9999,0
1653422328292,CSE 293,016,094920,Kriegman; David J,9999,0,9999,0
1653422328292,CSE 293,017,094921,Kumar; Arun Kumar,9999,0,9999,0
1653422328292,CSE 293,018,094922,Lerner; Sorin,9999,0,9999,0
1653422328292,CSE 293,019,094923,Lovett; Shachar,9999,0,9999,0
1653422328292,CSE 293,020,094924,McAuley; Julian John,9999,0,9999,0
1653422328292,CSE 293,021,094925,Micciancio; Daniele,9999,0,9999,0
1653422328292,CSE 293,022,094926,Orailoglu; Alex,9999,0,9999,0
1653422328292,CSE 293,023,094927,Paturi; Ramamohan,9999,0,9999,0
1653422328292,CSE 293,024,094928,Polikarpova; Nadezhda,9999,0,9999,0
1653422328292,CSE 293,025,094929,Politz; Joseph Gibbs,9999,0,9999,0
1653422328292,CSE 293,026,094930,Porter; George M,9999,0,9999,0
1653422328292,CSE 293,027,094931,Porter; Leonard Emerson,9999,0,9999,0
1653422328292,CSE 293,028,094932,Ramamoorthi; Ravi,9999,0,9999,0
1653422328292,CSE 293,029,094933,Sahoo; Debashis,9999,0,9999,0
1653422328292,CSE 293,030,094934,Saul; Lawrence,9999,0,9999,0
1653422328292,CSE 293,031,094935,Savage; Stefan,9999,0,9999,0
1653422328292,CSE 293,032,094936,Schulze; Jurgen P.,9999,0,9999,0
1653422328292,CSE 293,033,094937,Snoeren; Alex C.,9999,0,9999,0
1653422328292,CSE 293,034,094938,Shang; Jingbo,9999,0,9999,0
1653422328292,CSE 293,035,094939,Stefan; Deian,9999,0,9999,0
1653422328292,CSE 293,036,094940,Su; Hao,9999,0,9999,0
1653422328292,CSE 293,037,094941,Swanson; Steven James,9999,0,9999,0
1653422328292,CSE 293,038,094942,Tullsen; Dean Michael,9999,0,9999,0
1653422328292,CSE 293,039,094943,Voelker; Geoffrey M.,9999,0,9999,0
1653422328292,CSE 293,040,094944,Zhao; Jishen,9999,0,9999,0
1653422328292,CSE 293,041,094945,Zhou; Yuan-Yuan,9999,0,9999,0
1653422328292,CSE 293,042,094946,Gao; Sicun,9998,0,9999,1
1653422328292,CSE 293,043,094947,Weibel; Nadir,9999,0,9999,0
1653422328292,CSE 293,044,094948,Gupta; Rajesh K.,9999,0,9999,0
1653422328815,CSE 294,A00,090143,Porter; George M,9,0,10,1
1653422329341,DSE 200,A00,091799,Staff,50,0,50,0
1653422329869,DSE 203,A00,091800,Gupta; Amarnath,30,0,30,0
1653422330392,DSE 250,A00,091801,Deutsch; Alin Bernard,30,0,30,0
1653422330920,DSE 290,A00,091802,Altintas De Callaf; Ilkay,50,0,50,0
1653422331470,ECE 200,001,091003,Antipa; Nicholas A,9999,0,9999,0
1653422331470,ECE 200,002,091004,Atanasov; Nikolay A.,9999,0,9999,0
1653422331470,ECE 200,003,091005,Bharadia; Dinesh,9999,0,9999,0
1653422331470,ECE 200,004,091006,Cheng; Chung Kuan,9999,0,9999,0
1653422331470,ECE 200,005,091007,Cosman; Pamela C.,9999,0,9999,0
1653422331470,ECE 200,006,091008,Staff,9999,0,9999,0
1653422331470,ECE 200,007,091009,Dayeh; Shadi Ahmad,9999,0,9999,0
1653422331470,ECE 200,008,091010,Fainman; Yeshaiahu,9999,0,9999,0
1653422331470,ECE 200,009,091011,Ford; Joseph Earl,9999,0,9999,0
1653422331470,ECE 200,010,091012,Franceschetti; Massimo,9999,0,9999,0
1653422331470,ECE 200,011,091013,Fullerton; Eric E,9999,0,9999,0
1653422331470,ECE 200,012,091014,Galton; Ian A,9999,0,9999,0
1653422331470,ECE 200,013,091015,Gilja; Vikash,9999,0,9999,0
1653422331470,ECE 200,014,091016,Hall; Drew A.,9999,0,9999,0
1653422331470,ECE 200,015,091017,Hsueh; Tzu-Chien,9999,0,9999,0
1653422331470,ECE 200,016,091018,Javidi; Tara,9999,0,9999,0
1653422331470,ECE 200,017,091019,Kahng; Andrew Byun,9999,0,9999,0
1653422331470,ECE 200,018,091020,Kim; Young-Han,9999,0,9999,0
1653422331470,ECE 200,019,091021,Koushanfar; Farinaz,9999,0,9999,0
1653422331470,ECE 200,020,091022,Kuzum; Duygu,9999,0,9999,0
1653422331470,ECE 200,021,091023,Le; Hanh-Phuc,9999,0,9999,0
1653422331470,ECE 200,022,091024,Lin; Bill,9999,0,9999,0
1653422331470,ECE 200,023,091025,Liu; Zhaowei,9999,0,9999,0
1653422331470,ECE 200,024,091026,Lo; Yu-Hwa,9999,0,9999,0
1653422331470,ECE 200,025,091027,Lomakin; Vitaliy,9999,0,9999,0
1653422331470,ECE 200,026,091028,Mercier; Patrick Philip,9999,0,9999,0
1653422331470,ECE 200,027,091029,Meyer; Florian,9999,0,9999,0
1653422331470,ECE 200,028,091030,Milstein; Laurence B.,9999,0,9999,0
1653422331470,ECE 200,029,091031,Mir Arabbaygi; Siavash,9999,0,9999,0
1653422331470,ECE 200,030,091032,Mookherjea; Shayan,9999,0,9999,0
1653422331470,ECE 200,031,091033,Morris; Karcher William,9999,0,9999,0
1653422331470,ECE 200,032,091034,Ng; Tse Nga,9999,0,9999,0
1653422331470,ECE 200,033,091035,Nguyen; Truong Quang,9999,0,9999,0
1653422331470,ECE 200,034,091036,Nomura; Kenji,9999,0,9999,0
1653422331470,ECE 200,035,091037,Orlitsky; Alon,9999,0,9999,0
1653422331470,ECE 200,036,091038,Pal; Piya,9999,0,9999,0
1653422331470,ECE 200,037,091039,Papen; George C.,9999,0,9999,0
1653422331470,ECE 200,038,091040,Radic; Stojan,9999,0,9999,0
1653422331470,ECE 200,039,091041,Rao; Bhaskar D.,9999,0,9999,0
1653422331470,ECE 200,040,091042,Rao; Ramesh R,9999,0,9999,0
1653422331470,ECE 200,041,091043,Rebeiz; Gabriel,9999,0,9999,0
1653422331470,ECE 200,042,091044,Sanford; John R,9999,0,9999,0
1653422331470,ECE 200,043,091045,Siegel; Paul H.,9999,0,9999,0
1653422331470,ECE 200,044,091046,Sievenpiper; Daniel F.,9999,0,9999,0
1653422331470,ECE 200,045,091047,Sworder; David D.,9999,0,9999,0
1653422331470,ECE 200,046,091048,Taur; Yuan,9999,0,9999,0
1653422331470,ECE 200,047,091049,Touri; Behrouz,9999,0,9999,0
1653422331470,ECE 200,048,091050,Trivedi; Mohan M.,9999,0,9999,0
1653422331470,ECE 200,049,091051,Vardy; Alexander,9999,0,9999,0
1653422331470,ECE 200,050,091052,Vasconcelos; Nuno,9999,0,9999,0
1653422331470,ECE 200,051,091053,Wang; Xiaolong,9999,0,9999,0
1653422331470,ECE 200,052,091054,Xie; Pengtao,9999,0,9999,0
1653422331470,ECE 200,053,091055,Yip; Michael,9999,0,9999,0
1653422331470,ECE 200,054,091056,Zeger; Kenneth A.,9999,0,9999,0
1653422331470,ECE 200,055,091057,Zhang; Xinyu,9999,0,9999,0
1653422331470,ECE 200,056,091058,Turakhia; Yatish Girish,9999,0,9999,0
1653422331470,ECE 200,057,091059,Kang; Mingu,9999,0,9999,0
1653422331470,ECE 200,058,091060,Shi; Yuanyuan,9999,0,9999,0
1653422331470,ECE 200,059,091061,Wang; Edward Jay,9999,0,9999,0
1653422331470,ECE 200,060,091062,Zheng; Yang,9999,0,9999,0
1653422332000,ECE 203,A00,091065,Mercier; Patrick Philip,0,0,0,0
1653422332526,ECE 207A,A00,091605,Liu; Thomas Tao-Ming,0,0,0,0
1653422333050,ECE 212AN,A00,091068,Nomura; Kenji,0,0,0,0
1653422333575,ECE 222A,A00,091069,Rebeiz; Gabriel,0,0,0,0
1653422334107,ECE 225A,A00,091070,Orlitsky; Alon,0,0,0,0
1653422334633,ECE 230A,A00,091071,Nomura; Kenji,0,0,0,0
1653422335172,ECE 236A,A00,091072,Dayeh; Shadi Ahmad,0,0,0,0
1653422335698,ECE 238A,A00,091073,Luo; Jian,0,0,0,0
1653422335698,ECE 238A,B00,091074,Luo; Jian,0,0,0,0
1653422336227,ECE 240A,A00,091075,Radic; Stojan,0,0,0,0
1653422336759,ECE 247A,A00,091592,Shi; Lingyan,0,0,0,0
1653422337283,ECE 250,A00,091076,Touri; Behrouz,0,0,0,0
1653422337813,ECE 251C,A00,091078,Nguyen; Truong Quang,0,0,0,0
1653422338336,ECE 253,A00,091079,Cosman; Pamela C.,0,0,0,0
1653422338860,ECE 255A,A00,091080,Orlitsky; Alon,0,0,0,0
1653422339398,ECE 257A,A00,091081,Zhang; Xinyu,0,0,0,0
1653422339924,ECE 260A,A01,091084,Eldon; John,0,0,0,0
1653422340447,ECE 264C,A00,091085,Galton; Ian A,0,0,0,0
1653422340984,ECE 265C,A00,094889,Presti; Calogero Davide,0,0,0,9
1653422341515,ECE 266,A01,091087,Hall; Drew A.,0,0,0,0
1653422342564,ECE 271A,A00,091090,Vasconcelos; Nuno,0,0,0,0
1653422343091,ECE 272B,A00,091091,Sworder; David D.,0,0,0,0
1653422343613,ECE 275A,A00,091092,Meyer; Florian,0,0,0,0
1653422344140,ECE 277,A00,091093,An; Cheolhong,0,0,0,0
1653422344672,ECE 283,A00,091094,Le; Hanh-Phuc,0,0,0,0
1653422345202,ECE 284,A00,091095,Kang; Mingu,0,0,0,0
1653422345202,ECE 284,B00,091096,Wang; Edward Jay,0,0,0,0
1653422345732,ECE 285,A00,094334,Touri; Behrouz,0,0,0,0
1653422346262,ECE 289,A00,091097,Whelan; David Arthur,0,0,0,0
1653422346790,MATH 200A,A00,087414,Salehi Golsefidy; Alireza,7,0,8,1
1653422347320,MATH 202A,A00,087415,Gill; Philip E.,3,0,8,5
1653422347843,MATH 203A,A00,087416,Oprea; Dragos N.,6,0,8,2
1653422348371,MATH 204A,A00,087417,Kedlaya; Kiran S.,6,0,8,2
1653422348900,MATH 205,A00,087418,Sorensen; Claus M,6,0,8,2
1653422349424,MATH 206A,A00,087419,Izadi; Elham,7,0,8,1
1653422349950,MATH 207A,A00,087420,Mohammadi; Amir,6,0,8,2
1653422350475,MATH 208,A00,087421,Staff,9,0,10,1
1653422351001,MATH 209,A00,087422,Staff,10,0,10,0
1653422351523,MATH 218,A00,087423,Staff,10,0,10,0
1653422352047,MATH 220A,A00,087424,Novak; Jonathan I,7,0,8,1
1653422352572,MATH 231A,A00,087425,Bejenaru; Ioan,4,0,8,4
1653422353096,MATH 240A,A00,087426,Ebenfelt; Peter F,5,0,8,3
1653422353630,MATH 243,A00,087427,Staff,9,0,10,1
1653422354153,MATH 248,A00,087429,Staff,10,0,10,0
1653422354675,MATH 250A,A00,087430,Spolaor; Luca,5,0,8,3
1653422355208,MATH 257A,A00,087431,Spolaor; Luca,7,0,8,1
1653422355730,MATH 258,A00,087432,Staff,9,0,10,1
1653422356255,MATH 264A,A00,087433,Warnke; Lutz Peter,5,0,8,3
1653422356784,MATH 268,A00,087434,Staff,15,0,15,0
1653422357314,MATH 269,A00,087435,Staff,14,0,15,1
1653422357845,MATH 270A,A00,087436,Nie; Jiawang,0,0,8,8
1653422358373,MATH 272A,A00,087437,Tian; Xiaochuan,2,0,8,6
1653422358905,MATH 274,A01,087439,Cheng; Li-Tien,9,0,10,1
1653422358905,MATH 274,A02,087440,Cheng; Li-Tien,10,0,10,0
1653422359430,MATH 278A,A00,087441,Staff,8,0,10,2
1653422359952,MATH 278B,A00,087442,Staff,8,0,10,2
1653422360488,MATH 278C,A00,087443,Staff,8,0,10,2
1653422361015,MATH 280A,A00,087444,Zheng; Tianyi,0,0,8,8
1653422361539,MATH 281A,A00,087445,Bradic; Jelena,0,0,8,8
1653422362063,MATH 282A,A00,087446,Zhang; Danna,0,0,8,8
1653422362585,MATH 283,A00,087447,Tesler; Glenn,0,0,0,14
1653422363109,MATH 286,A00,087448,Kemp; Todd Aahron,6,0,8,2
1653422363631,MATH 287D,A00,087449,Bradic; Jelena,8,0,8,0
1653422364156,MATH 288,A00,087450,Staff,14,0,15,1
1653422364156,MATH 288,B00,087451,Staff,15,0,15,0
1653422364156,MATH 288,C00,087452,Staff,15,0,15,0
1653422364688,MATH 290A,A00,087453,Xu; Zhouli,7,0,8,1
1653422365210,MATH 291A,A00,087454,Xu; Zhouli,7,0,8,1
1653422365755,MATH 292,A00,087455,Staff,10,0,10,0
1653422366277,MATH 295,A00,087456,Staff,50,0,50,0
1653422366812,MATH 297,001,087457,Staff,998,0,999,1
1653422932561,COGS 200,A01,087991,Staff,48,0,50,2
1653422933084,COGS 201,A01,094504,Rangel; Lara M,17,0,25,8
1653422933611,COGS 203,A00,087992,Coulson; Seana M,19,0,20,1
1653422934157,COGS 210A,001,087993,Greene; Deanna Jacquelyn,9998,0,9999,1
1653422934157,COGS 210A,002,087994,Saygin; Ayse P,9999,0,9999,0
1653422934157,COGS 210A,003,087995,Xia; Haijun,9999,0,9999,0
1653422934157,COGS 210A,004,087996,Nitz; Douglas A.,9999,0,9999,0
1653422934157,COGS 210A,005,087997,Hollan; James D.,9999,0,9999,0
1653422934157,COGS 210A,006,087998,Deak; Gedeon O.,9998,0,9999,1
1653422934157,COGS 210A,007,087999,Rossano; Federico,9999,0,9999,0
1653422934680,COGS 211A,A00,088000,Coulson; Seana M,9997,0,9999,2
1653422935208,COGS 229,A00,088002,Staff,23,0,25,2
1653422935731,COGS 260,B00,094231,Staff,17,0,20,3
1653422935731,COGS 260,A00,088004,Nitz; Douglas A.,9998,0,9999,1
1653422936260,CSE 202,A00,090110,Paturi; Ramamohan,0,0,0,0
1653422936260,CSE 202,B00,090111,Paturi; Ramamohan,0,0,0,0
1653422936787,CSE 207B,A00,090112,Heninger; Nadia A,0,0,0,0
1653422937309,CSE 208,A00,094858,Micciancio; Daniele,0,0,0,0
1653422937830,CSE 210,A00,090113,Powell; Thomas Allan,0,0,0,0
1653422938360,CSE 219,A00,090898,Staff,0,0,0,0
1653422938899,CSE 221,A00,090114,Zhou; Yuan-Yuan,0,0,0,0
1653422939424,CSE 229A,A00,090115,Porter; George M,0,0,0,0
1653422939953,CSE 229C,A00,090116,Savage; Stefan,0,0,0,0
1653422940488,CSE 230,A00,090117,Jhala; Ranjit,0,0,0,0
1653422941016,CSE 232,A00,090118,Papakonstantinou; Yannis,0,0,0,0
1653422941539,CSE 239A,A00,090121,Kumar; Arun Kumar,0,0,0,0
1653422942066,CSE 239B,A00,090122,Jhala; Ranjit,0,0,0,0
1653422942588,CSE 240A,A00,090123,Zhao; Jishen,0,0,189,189
1653422943111,CSE 243A,A00,090124,Orailoglu; Alex,3,0,15,12
1653422943634,CSE 249B,A00,090125,Kahng; Andrew Byun,13,0,20,7
1653422944161,CSE 250A,A00,090126,Berg-Kirkpatrick; Taylor D,0,0,0,0
1653422944686,CSE 252A,A00,090127,Ochoa; Benjamin Lawrence,0,0,0,0
1653422945214,CSE 258,A01,090129,McAuley; Julian John,0,0,0,0
1653422945737,CSE 258R,A01,090131,McAuley; Julian John,0,0,0,0
1653422946260,CSE 274,A00,090132,Ramamoorthi; Ravi,0,0,0,0
1653422946786,CSE 276A,A00,090133,Christensen; Henrik I,0,0,0,0
1653422947309,CSE 276C,A00,090134,Christensen; Henrik I,0,0,0,0
1653422947844,CSE 290,A00,090135,Bafna; Vineet,0,0,0,0
1653422947844,CSE 290,B00,090136,Ramamoorthi; Ravi,0,0,0,0
1653422947844,CSE 290,C00,090137,Li; Tzumao,9,0,10,1
1653422947844,CSE 290,D00,090138,Zhou; Yuan-Yuan,10,0,10,0
1653422947844,CSE 290,E00,090139,Christensen; Henrik I,10,0,10,0
1653422947844,CSE 290,F00,094053,Shalev; Aaron D,0,0,0,0
1653422948373,CSE 291,A00,090140,Munyaka; Imani N. S.,0,0,0,0
1653422948373,CSE 291,B00,094880,Yu; Qi,0,0,0,0
1653422948373,CSE 291,C00,090142,Pannuto; Patrick William,0,0,0,0
1653422948373,CSE 291,D00,094881,Zhang; Yiying,0,0,0,0
1653422948373,CSE 291,E00,095118,Su; Hao,0,0,0,0
1653422948934,CSE 293,001,094905,Bafna; Vineet,9999,0,9999,0
1653422948934,CSE 293,002,094906,Bellare; Mihir,9999,0,9999,0
1653422948934,CSE 293,003,094907,Berg-Kirkpatrick; Taylor D,9999,0,9999,0
1653422948934,CSE 293,004,094908,Christensen; Henrik I,9999,0,9999,0
1653422948934,CSE 293,005,094909,Cottrell; Garrison W,9999,0,9999,0
1653422948934,CSE 293,006,094910,Deutsch; Alin Bernard,9999,0,9999,0
1653422948934,CSE 293,007,094911,Esmaeilzadeh; Hadi,9999,0,9999,0
1653422948934,CSE 293,008,094912,Freund; Yoav,9999,0,9999,0
1653422948934,CSE 293,009,094913,Griswold; William G.,9999,0,9999,0
1653422948934,CSE 293,010,094914,Gymrek; Melissa Ann,9999,0,9999,0
1653422948934,CSE 293,011,094915,Heninger; Nadia A,9999,0,9999,0
1653422948934,CSE 293,012,094916,Impagliazzo; Russell,9999,0,9999,0
1653422948934,CSE 293,013,094917,Jhala; Ranjit,9999,0,9999,0
1653422948934,CSE 293,014,094918,Kahng; Andrew Byun,9999,0,9999,0
1653422948934,CSE 293,015,094919,Kane; Daniel Mertz,9999,0,9999,0
1653422948934,CSE 293,016,094920,Kriegman; David J,9999,0,9999,0
1653422948934,CSE 293,017,094921,Kumar; Arun Kumar,9999,0,9999,0
1653422948934,CSE 293,018,094922,Lerner; Sorin,9999,0,9999,0
1653422948934,CSE 293,019,094923,Lovett; Shachar,9999,0,9999,0
1653422948934,CSE 293,020,094924,McAuley; Julian John,9999,0,9999,0
1653422948934,CSE 293,021,094925,Micciancio; Daniele,9999,0,9999,0
1653422948934,CSE 293,022,094926,Orailoglu; Alex,9999,0,9999,0
1653422948934,CSE 293,023,094927,Paturi; Ramamohan,9999,0,9999,0
1653422948934,CSE 293,024,094928,Polikarpova; Nadezhda,9999,0,9999,0
1653422948934,CSE 293,025,094929,Politz; Joseph Gibbs,9999,0,9999,0
1653422948934,CSE 293,026,094930,Porter; George M,9999,0,9999,0
1653422948934,CSE 293,027,094931,Porter; Leonard Emerson,9999,0,9999,0
1653422948934,CSE 293,028,094932,Ramamoorthi; Ravi,9999,0,9999,0
1653422948934,CSE 293,029,094933,Sahoo; Debashis,9999,0,9999,0
1653422948934,CSE 293,030,094934,Saul; Lawrence,9999,0,9999,0
1653422948934,CSE 293,031,094935,Savage; Stefan,9999,0,9999,0
1653422948934,CSE 293,032,094936,Schulze; Jurgen P.,9999,0,9999,0
1653422948934,CSE 293,033,094937,Snoeren; Alex C.,9999,0,9999,0
1653422948934,CSE 293,034,094938,Shang; Jingbo,9999,0,9999,0
1653422948934,CSE 293,035,094939,Stefan; Deian,9999,0,9999,0
1653422948934,CSE 293,036,094940,Su; Hao,9999,0,9999,0
1653422948934,CSE 293,037,094941,Swanson; Steven James,9999,0,9999,0
1653422948934,CSE 293,038,094942,Tullsen; Dean Michael,9999,0,9999,0
1653422948934,CSE 293,039,094943,Voelker; Geoffrey M.,9999,0,9999,0
1653422948934,CSE 293,040,094944,Zhao; Jishen,9999,0,9999,0
1653422948934,CSE 293,041,094945,Zhou; Yuan-Yuan,9999,0,9999,0
1653422948934,CSE 293,042,094946,Gao; Sicun,9998,0,9999,1
1653422948934,CSE 293,043,094947,Weibel; Nadir,9999,0,9999,0
1653422948934,CSE 293,044,094948,Gupta; Rajesh K.,9999,0,9999,0
1653422949465,CSE 294,A00,090143,Porter; George M,9,0,10,1
1653422949994,DSE 200,A00,091799,Staff,50,0,50,0
1653422950523,DSE 203,A00,091800,Gupta; Amarnath,30,0,30,0
1653422951046,DSE 250,A00,091801,Deutsch; Alin Bernard,30,0,30,0
1653422951577,DSE 290,A00,091802,Altintas De Callaf; Ilkay,50,0,50,0
1653422952142,ECE 200,001,091003,Antipa; Nicholas A,9999,0,9999,0
1653422952142,ECE 200,002,091004,Atanasov; Nikolay A.,9999,0,9999,0
1653422952142,ECE 200,003,091005,Bharadia; Dinesh,9999,0,9999,0
1653422952142,ECE 200,004,091006,Cheng; Chung Kuan,9999,0,9999,0
1653422952142,ECE 200,005,091007,Cosman; Pamela C.,9999,0,9999,0
1653422952142,ECE 200,006,091008,Staff,9999,0,9999,0
1653422952142,ECE 200,007,091009,Dayeh; Shadi Ahmad,9999,0,9999,0
1653422952142,ECE 200,008,091010,Fainman; Yeshaiahu,9999,0,9999,0
1653422952142,ECE 200,009,091011,Ford; Joseph Earl,9999,0,9999,0
1653422952142,ECE 200,010,091012,Franceschetti; Massimo,9999,0,9999,0
1653422952142,ECE 200,011,091013,Fullerton; Eric E,9999,0,9999,0
1653422952142,ECE 200,012,091014,Galton; Ian A,9999,0,9999,0
1653422952142,ECE 200,013,091015,Gilja; Vikash,9999,0,9999,0
1653422952142,ECE 200,014,091016,Hall; Drew A.,9999,0,9999,0
1653422952142,ECE 200,015,091017,Hsueh; Tzu-Chien,9999,0,9999,0
1653422952142,ECE 200,016,091018,Javidi; Tara,9999,0,9999,0
1653422952142,ECE 200,017,091019,Kahng; Andrew Byun,9999,0,9999,0
1653422952142,ECE 200,018,091020,Kim; Young-Han,9999,0,9999,0
1653422952142,ECE 200,019,091021,Koushanfar; Farinaz,9999,0,9999,0
1653422952142,ECE 200,020,091022,Kuzum; Duygu,9999,0,9999,0
1653422952142,ECE 200,021,091023,Le; Hanh-Phuc,9999,0,9999,0
1653422952142,ECE 200,022,091024,Lin; Bill,9999,0,9999,0
1653422952142,ECE 200,023,091025,Liu; Zhaowei,9999,0,9999,0
1653422952142,ECE 200,024,091026,Lo; Yu-Hwa,9999,0,9999,0
1653422952142,ECE 200,025,091027,Lomakin; Vitaliy,9999,0,9999,0
1653422952142,ECE 200,026,091028,Mercier; Patrick Philip,9999,0,9999,0
1653422952142,ECE 200,027,091029,Meyer; Florian,9999,0,9999,0
1653422952142,ECE 200,028,091030,Milstein; Laurence B.,9999,0,9999,0
1653422952142,ECE 200,029,091031,Mir Arabbaygi; Siavash,9999,0,9999,0
1653422952142,ECE 200,030,091032,Mookherjea; Shayan,9999,0,9999,0
1653422952142,ECE 200,031,091033,Morris; Karcher William,9999,0,9999,0
1653422952142,ECE 200,032,091034,Ng; Tse Nga,9999,0,9999,0
1653422952142,ECE 200,033,091035,Nguyen; Truong Quang,9999,0,9999,0
1653422952142,ECE 200,034,091036,Nomura; Kenji,9999,0,9999,0
1653422952142,ECE 200,035,091037,Orlitsky; Alon,9999,0,9999,0
1653422952142,ECE 200,036,091038,Pal; Piya,9999,0,9999,0
1653422952142,ECE 200,037,091039,Papen; George C.,9999,0,9999,0
1653422952142,ECE 200,038,091040,Radic; Stojan,9999,0,9999,0
1653422952142,ECE 200,039,091041,Rao; Bhaskar D.,9999,0,9999,0
1653422952142,ECE 200,040,091042,Rao; Ramesh R,9999,0,9999,0
1653422952142,ECE 200,041,091043,Rebeiz; Gabriel,9999,0,9999,0
1653422952142,ECE 200,042,091044,Sanford; John R,9999,0,9999,0
1653422952142,ECE 200,043,091045,Siegel; Paul H.,9999,0,9999,0
1653422952142,ECE 200,044,091046,Sievenpiper; Daniel F.,9999,0,9999,0
1653422952142,ECE 200,045,091047,Sworder; David D.,9999,0,9999,0
1653422952142,ECE 200,046,091048,Taur; Yuan,9999,0,9999,0
1653422952142,ECE 200,047,091049,Touri; Behrouz,9999,0,9999,0
1653422952142,ECE 200,048,091050,Trivedi; Mohan M.,9999,0,9999,0
1653422952142,ECE 200,049,091051,Vardy; Alexander,9999,0,9999,0
1653422952142,ECE 200,050,091052,Vasconcelos; Nuno,9999,0,9999,0
1653422952142,ECE 200,051,091053,Wang; Xiaolong,9999,0,9999,0
1653422952142,ECE 200,052,091054,Xie; Pengtao,9999,0,9999,0
1653422952142,ECE 200,053,091055,Yip; Michael,9999,0,9999,0
1653422952142,ECE 200,054,091056,Zeger; Kenneth A.,9999,0,9999,0
1653422952142,ECE 200,055,091057,Zhang; Xinyu,9999,0,9999,0
1653422952142,ECE 200,056,091058,Turakhia; Yatish Girish,9999,0,9999,0
1653422952142,ECE 200,057,091059,Kang; Mingu,9999,0,9999,0
1653422952142,ECE 200,058,091060,Shi; Yuanyuan,9999,0,9999,0
1653422952142,ECE 200,059,091061,Wang; Edward Jay,9999,0,9999,0
1653422952142,ECE 200,060,091062,Zheng; Yang,9999,0,9999,0
1653422952677,ECE 203,A00,091065,Mercier; Patrick Philip,0,0,0,0
1653422953212,ECE 207A,A00,091605,Liu; Thomas Tao-Ming,0,0,0,0
1653422953747,ECE 212AN,A00,091068,Nomura; Kenji,0,0,0,0
1653422954270,ECE 222A,A00,091069,Rebeiz; Gabriel,0,0,0,0
1653422954804,ECE 225A,A00,091070,Orlitsky; Alon,0,0,0,0
1653422955334,ECE 230A,A00,091071,Nomura; Kenji,0,0,0,0
1653422955866,ECE 236A,A00,091072,Dayeh; Shadi Ahmad,0,0,0,0
1653422956392,ECE 238A,A00,091073,Luo; Jian,0,0,0,0
1653422956392,ECE 238A,B00,091074,Luo; Jian,0,0,0,0
1653422956925,ECE 240A,A00,091075,Radic; Stojan,0,0,0,0
1653422957447,ECE 247A,A00,091592,Shi; Lingyan,0,0,0,0
1653422957969,ECE 250,A00,091076,Touri; Behrouz,0,0,0,0
1653422958496,ECE 251C,A00,091078,Nguyen; Truong Quang,0,0,0,0
1653422959033,ECE 253,A00,091079,Cosman; Pamela C.,0,0,0,0
1653422959562,ECE 255A,A00,091080,Orlitsky; Alon,0,0,0,0
1653422960088,ECE 257A,A00,091081,Zhang; Xinyu,0,0,0,0
1653422960624,ECE 260A,A01,091084,Eldon; John,0,0,0,0
1653422961162,ECE 264C,A00,091085,Galton; Ian A,0,0,0,0
1653422961700,ECE 265C,A00,094889,Presti; Calogero Davide,0,0,0,9
1653422962227,ECE 266,A01,091087,Hall; Drew A.,0,0,0,0
1653422963281,ECE 271A,A00,091090,Vasconcelos; Nuno,0,0,0,0
1653422963810,ECE 272B,A00,091091,Sworder; David D.,0,0,0,0
1653422964336,ECE 275A,A00,091092,Meyer; Florian,0,0,0,0
1653422964862,ECE 277,A00,091093,An; Cheolhong,0,0,0,0
1653422965395,ECE 283,A00,091094,Le; Hanh-Phuc,0,0,0,0
1653422965918,ECE 284,A00,091095,Kang; Mingu,0,0,0,0
1653422965918,ECE 284,B00,091096,Wang; Edward Jay,0,0,0,0
1653422966441,ECE 285,A00,094334,Touri; Behrouz,0,0,0,0
1653422966980,ECE 289,A00,091097,Whelan; David Arthur,0,0,0,0
1653422967507,MATH 200A,A00,087414,Salehi Golsefidy; Alireza,7,0,8,1
1653422968034,MATH 202A,A00,087415,Gill; Philip E.,3,0,8,5
1653422968573,MATH 203A,A00,087416,Oprea; Dragos N.,6,0,8,2
1653422969109,MATH 204A,A00,087417,Kedlaya; Kiran S.,6,0,8,2
1653422969632,MATH 205,A00,087418,Sorensen; Claus M,6,0,8,2
1653422970177,MATH 206A,A00,087419,Izadi; Elham,7,0,8,1
1653422970702,MATH 207A,A00,087420,Mohammadi; Amir,6,0,8,2
1653422971226,MATH 208,A00,087421,Staff,9,0,10,1
1653422971748,MATH 209,A00,087422,Staff,10,0,10,0
1653422972272,MATH 218,A00,087423,Staff,10,0,10,0
1653422972875,MATH 220A,A00,087424,Novak; Jonathan I,7,0,8,1
1653422973398,MATH 231A,A00,087425,Bejenaru; Ioan,4,0,8,4
1653422973930,MATH 240A,A00,087426,Ebenfelt; Peter F,5,0,8,3
1653422974459,MATH 243,A00,087427,Staff,9,0,10,1
1653422974982,MATH 248,A00,087429,Staff,10,0,10,0
1653422975509,MATH 250A,A00,087430,Spolaor; Luca,5,0,8,3
1653422976039,MATH 257A,A00,087431,Spolaor; Luca,7,0,8,1
1653422976563,MATH 258,A00,087432,Staff,9,0,10,1
1653422977096,MATH 264A,A00,087433,Warnke; Lutz Peter,5,0,8,3
1653422977617,MATH 268,A00,087434,Staff,15,0,15,0
1653422978139,MATH 269,A00,087435,Staff,14,0,15,1
1653422978661,MATH 270A,A00,087436,Nie; Jiawang,0,0,8,8
1653422979191,MATH 272A,A00,087437,Tian; Xiaochuan,2,0,8,6
1653422979715,MATH 274,A01,087439,Cheng; Li-Tien,9,0,10,1
1653422979715,MATH 274,A02,087440,Cheng; Li-Tien,10,0,10,0
1653422980244,MATH 278A,A00,087441,Staff,8,0,10,2
1653422980768,MATH 278B,A00,087442,Staff,8,0,10,2
1653422981290,MATH 278C,A00,087443,Staff,8,0,10,2
1653422981814,MATH 280A,A00,087444,Zheng; Tianyi,0,0,8,8
1653422982337,MATH 281A,A00,087445,Bradic; Jelena,0,0,8,8
1653422982874,MATH 282A,A00,087446,Zhang; Danna,0,0,8,8
1653422983407,MATH 283,A00,087447,Tesler; Glenn,0,0,0,14
1653422983934,MATH 286,A00,087448,Kemp; Todd Aahron,6,0,8,2
1653422984495,MATH 287D,A00,087449,Bradic; Jelena,8,0,8,0
1653422985017,MATH 288,A00,087450,Staff,14,0,15,1
1653422985017,MATH 288,B00,087451,Staff,15,0,15,0
1653422985017,MATH 288,C00,087452,Staff,15,0,15,0
1653422985550,MATH 290A,A00,087453,Xu; Zhouli,7,0,8,1
1653422986076,MATH 291A,A00,087454,Xu; Zhouli,7,0,8,1
1653422986603,MATH 292,A00,087455,Staff,10,0,10,0
1653422987125,MATH 295,A00,087456,Staff,50,0,50,0
1653422987655,MATH 297,001,087457,Staff,998,0,999,1
1653423552454,COGS 200,A01,087991,Staff,48,0,50,2
1653423552980,COGS 201,A01,094504,Rangel; Lara M,17,0,25,8
1653423553506,COGS 203,A00,087992,Coulson; Seana M,19,0,20,1
1653423554035,COGS 210A,001,087993,Greene; Deanna Jacquelyn,9998,0,9999,1
1653423554035,COGS 210A,002,087994,Saygin; Ayse P,9999,0,9999,0
1653423554035,COGS 210A,003,087995,Xia; Haijun,9999,0,9999,0
1653423554035,COGS 210A,004,087996,Nitz; Douglas A.,9999,0,9999,0
1653423554035,COGS 210A,005,087997,Hollan; James D.,9999,0,9999,0
1653423554035,COGS 210A,006,087998,Deak; Gedeon O.,9998,0,9999,1
1653423554035,COGS 210A,007,087999,Rossano; Federico,9999,0,9999,0
1653423554566,COGS 211A,A00,088000,Coulson; Seana M,9997,0,9999,2
1653423555096,COGS 229,A00,088002,Staff,23,0,25,2
1653423555622,COGS 260,B00,094231,Staff,17,0,20,3
1653423555622,COGS 260,A00,088004,Nitz; Douglas A.,9998,0,9999,1
1653423556150,CSE 202,A00,090110,Paturi; Ramamohan,0,0,0,0
1653423556150,CSE 202,B00,090111,Paturi; Ramamohan,0,0,0,0
1653423556682,CSE 207B,A00,090112,Heninger; Nadia A,0,0,0,0
1653423557205,CSE 208,A00,094858,Micciancio; Daniele,0,0,0,0
1653423557728,CSE 210,A00,090113,Powell; Thomas Allan,0,0,0,0
1653423558251,CSE 219,A00,090898,Staff,0,0,0,0
1653423558795,CSE 221,A00,090114,Zhou; Yuan-Yuan,0,0,0,0
1653423559320,CSE 229A,A00,090115,Porter; George M,0,0,0,0
1653423559850,CSE 229C,A00,090116,Savage; Stefan,0,0,0,0
1653423560376,CSE 230,A00,090117,Jhala; Ranjit,0,0,0,0
1653423560901,CSE 232,A00,090118,Papakonstantinou; Yannis,0,0,0,0
1653423561426,CSE 239A,A00,090121,Kumar; Arun Kumar,0,0,0,0
1653423561958,CSE 239B,A00,090122,Jhala; Ranjit,0,0,0,0
1653423562509,CSE 240A,A00,090123,Zhao; Jishen,0,0,189,189
1653423563053,CSE 243A,A00,090124,Orailoglu; Alex,3,0,15,12
1653423563655,CSE 249B,A00,090125,Kahng; Andrew Byun,13,0,20,7
1653423564196,CSE 250A,A00,090126,Berg-Kirkpatrick; Taylor D,0,0,0,0
1653423564737,CSE 252A,A00,090127,Ochoa; Benjamin Lawrence,0,0,0,0
1653423565354,CSE 258,A01,090129,McAuley; Julian John,0,0,0,0
1653423565879,CSE 258R,A01,090131,McAuley; Julian John,0,0,0,0
1653423566403,CSE 274,A00,090132,Ramamoorthi; Ravi,0,0,0,0
1653423566936,CSE 276A,A00,090133,Christensen; Henrik I,0,0,0,0
1653423567475,CSE 276C,A00,090134,Christensen; Henrik I,0,0,0,0
1653423567999,CSE 290,A00,090135,Bafna; Vineet,0,0,0,0
1653423567999,CSE 290,B00,090136,Ramamoorthi; Ravi,0,0,0,0
1653423567999,CSE 290,C00,090137,Li; Tzumao,9,0,10,1
1653423567999,CSE 290,D00,090138,Zhou; Yuan-Yuan,10,0,10,0
1653423567999,CSE 290,E00,090139,Christensen; Henrik I,10,0,10,0
1653423567999,CSE 290,F00,094053,Shalev; Aaron D,0,0,0,0
1653423568523,CSE 291,A00,090140,Munyaka; Imani N. S.,0,0,0,0
1653423568523,CSE 291,B00,094880,Yu; Qi,0,0,0,0
1653423568523,CSE 291,C00,090142,Pannuto; Patrick William,0,0,0,0
1653423568523,CSE 291,D00,094881,Zhang; Yiying,0,0,0,0
1653423568523,CSE 291,E00,095118,Su; Hao,0,0,0,0
1653423569053,CSE 293,001,094905,Bafna; Vineet,9999,0,9999,0
1653423569053,CSE 293,002,094906,Bellare; Mihir,9999,0,9999,0
1653423569053,CSE 293,003,094907,Berg-Kirkpatrick; Taylor D,9999,0,9999,0
1653423569053,CSE 293,004,094908,Christensen; Henrik I,9999,0,9999,0
1653423569053,CSE 293,005,094909,Cottrell; Garrison W,9999,0,9999,0
1653423569053,CSE 293,006,094910,Deutsch; Alin Bernard,9999,0,9999,0
1653423569053,CSE 293,007,094911,Esmaeilzadeh; Hadi,9999,0,9999,0
1653423569053,CSE 293,008,094912,Freund; Yoav,9999,0,9999,0
1653423569053,CSE 293,009,094913,Griswold; William G.,9999,0,9999,0
1653423569053,CSE 293,010,094914,Gymrek; Melissa Ann,9999,0,9999,0
1653423569053,CSE 293,011,094915,Heninger; Nadia A,9999,0,9999,0
1653423569053,CSE 293,012,094916,Impagliazzo; Russell,9999,0,9999,0
1653423569053,CSE 293,013,094917,Jhala; Ranjit,9999,0,9999,0
1653423569053,CSE 293,014,094918,Kahng; Andrew Byun,9999,0,9999,0
1653423569053,CSE 293,015,094919,Kane; Daniel Mertz,9999,0,9999,0
1653423569053,CSE 293,016,094920,Kriegman; David J,9999,0,9999,0
1653423569053,CSE 293,017,094921,Kumar; Arun Kumar,9999,0,9999,0
1653423569053,CSE 293,018,094922,Lerner; Sorin,9999,0,9999,0
1653423569053,CSE 293,019,094923,Lovett; Shachar,9999,0,9999,0
1653423569053,CSE 293,020,094924,McAuley; Julian John,9999,0,9999,0
1653423569053,CSE 293,021,094925,Micciancio; Daniele,9999,0,9999,0
1653423569053,CSE 293,022,094926,Orailoglu; Alex,9999,0,9999,0
1653423569053,CSE 293,023,094927,Paturi; Ramamohan,9999,0,9999,0
1653423569053,CSE 293,024,094928,Polikarpova; Nadezhda,9999,0,9999,0
1653423569053,CSE 293,025,094929,Politz; Joseph Gibbs,9999,0,9999,0
1653423569053,CSE 293,026,094930,Porter; George M,9999,0,9999,0
1653423569053,CSE 293,027,094931,Porter; Leonard Emerson,9999,0,9999,0
1653423569053,CSE 293,028,094932,Ramamoorthi; Ravi,9999,0,9999,0
1653423569053,CSE 293,029,094933,Sahoo; Debashis,9999,0,9999,0
1653423569053,CSE 293,030,094934,Saul; Lawrence,9999,0,9999,0
1653423569053,CSE 293,031,094935,Savage; Stefan,9999,0,9999,0
1653423569053,CSE 293,032,094936,Schulze; Jurgen P.,9999,0,9999,0
1653423569053,CSE 293,033,094937,Snoeren; Alex C.,9999,0,9999,0
1653423569053,CSE 293,034,094938,Shang; Jingbo,9999,0,9999,0
1653423569053,CSE 293,035,094939,Stefan; Deian,9999,0,9999,0
1653423569053,CSE 293,036,094940,Su; Hao,9999,0,9999,0
1653423569053,CSE 293,037,094941,Swanson; Steven James,9999,0,9999,0
1653423569053,CSE 293,038,094942,Tullsen; Dean Michael,9999,0,9999,0
1653423569053,CSE 293,039,094943,Voelker; Geoffrey M.,9999,0,9999,0
1653423569053,CSE 293,040,094944,Zhao; Jishen,9999,0,9999,0
1653423569053,CSE 293,041,094945,Zhou; Yuan-Yuan,9999,0,9999,0
1653423569053,CSE 293,042,094946,Gao; Sicun,9998,0,9999,1
1653423569053,CSE 293,043,094947,Weibel; Nadir,9999,0,9999,0
1653423569053,CSE 293,044,094948,Gupta; Rajesh K.,9999,0,9999,0
1653423569594,CSE 294,A00,090143,Porter; George M,9,0,10,1
1653423570119,DSE 200,A00,091799,Staff,50,0,50,0
1653423570643,DSE 203,A00,091800,Gupta; Amarnath,30,0,30,0
1653423571174,DSE 250,A00,091801,Deutsch; Alin Bernard,30,0,30,0
1653423571705,DSE 290,A00,091802,Altintas De Callaf; Ilkay,50,0,50,0
1653423572236,ECE 200,001,091003,Antipa; Nicholas A,9999,0,9999,0
1653423572236,ECE 200,002,091004,Atanasov; Nikolay A.,9999,0,9999,0
1653423572236,ECE 200,003,091005,Bharadia; Dinesh,9999,0,9999,0
1653423572236,ECE 200,004,091006,Cheng; Chung Kuan,9999,0,9999,0
1653423572236,ECE 200,005,091007,Cosman; Pamela C.,9999,0,9999,0
1653423572236,ECE 200,006,091008,Staff,9999,0,9999,0
1653423572236,ECE 200,007,091009,Dayeh; Shadi Ahmad,9999,0,9999,0
1653423572236,ECE 200,008,091010,Fainman; Yeshaiahu,9999,0,9999,0
1653423572236,ECE 200,009,091011,Ford; Joseph Earl,9999,0,9999,0
1653423572236,ECE 200,010,091012,Franceschetti; Massimo,9999,0,9999,0
1653423572236,ECE 200,011,091013,Fullerton; Eric E,9999,0,9999,0
1653423572236,ECE 200,012,091014,Galton; Ian A,9999,0,9999,0
1653423572236,ECE 200,013,091015,Gilja; Vikash,9999,0,9999,0
1653423572236,ECE 200,014,091016,Hall; Drew A.,9999,0,9999,0
1653423572236,ECE 200,015,091017,Hsueh; Tzu-Chien,9999,0,9999,0
1653423572236,ECE 200,016,091018,Javidi; Tara,9999,0,9999,0
1653423572236,ECE 200,017,091019,Kahng; Andrew Byun,9999,0,9999,0
1653423572236,ECE 200,018,091020,Kim; Young-Han,9999,0,9999,0
1653423572236,ECE 200,019,091021,Koushanfar; Farinaz,9999,0,9999,0
1653423572236,ECE 200,020,091022,Kuzum; Duygu,9999,0,9999,0
1653423572236,ECE 200,021,091023,Le; Hanh-Phuc,9999,0,9999,0
1653423572236,ECE 200,022,091024,Lin; Bill,9999,0,9999,0
1653423572236,ECE 200,023,091025,Liu; Zhaowei,9999,0,9999,0
1653423572236,ECE 200,024,091026,Lo; Yu-Hwa,9999,0,9999,0
1653423572236,ECE 200,025,091027,Lomakin; Vitaliy,9999,0,9999,0
1653423572236,ECE 200,026,091028,Mercier; Patrick Philip,9999,0,9999,0
1653423572236,ECE 200,027,091029,Meyer; Florian,9999,0,9999,0
1653423572236,ECE 200,028,091030,Milstein; Laurence B.,9999,0,9999,0
1653423572236,ECE 200,029,091031,Mir Arabbaygi; Siavash,9999,0,9999,0
1653423572236,ECE 200,030,091032,Mookherjea; Shayan,9999,0,9999,0
1653423572236,ECE 200,031,091033,Morris; Karcher William,9999,0,9999,0
1653423572236,ECE 200,032,091034,Ng; Tse Nga,9999,0,9999,0
1653423572236,ECE 200,033,091035,Nguyen; Truong Quang,9999,0,9999,0
1653423572236,ECE 200,034,091036,Nomura; Kenji,9999,0,9999,0
1653423572236,ECE 200,035,091037,Orlitsky; Alon,9999,0,9999,0
1653423572236,ECE 200,036,091038,Pal; Piya,9999,0,9999,0
1653423572236,ECE 200,037,091039,Papen; George C.,9999,0,9999,0
1653423572236,ECE 200,038,091040,Radic; Stojan,9999,0,9999,0
1653423572236,ECE 200,039,091041,Rao; Bhaskar D.,9999,0,9999,0
1653423572236,ECE 200,040,091042,Rao; Ramesh R,9999,0,9999,0
1653423572236,ECE 200,041,091043,Rebeiz; Gabriel,9999,0,9999,0
1653423572236,ECE 200,042,091044,Sanford; John R,9999,0,9999,0
1653423572236,ECE 200,043,091045,Siegel; Paul H.,9999,0,9999,0
1653423572236,ECE 200,044,091046,Sievenpiper; Daniel F.,9999,0,9999,0
1653423572236,ECE 200,045,091047,Sworder; David D.,9999,0,9999,0
1653423572236,ECE 200,046,091048,Taur; Yuan,9999,0,9999,0
1653423572236,ECE 200,047,091049,Touri; Behrouz,9999,0,9999,0
1653423572236,ECE 200,048,091050,Trivedi; Mohan M.,9999,0,9999,0
1653423572236,ECE 200,049,091051,Vardy; Alexander,9999,0,9999,0
1653423572236,ECE 200,050,091052,Vasconcelos; Nuno,9999,0,9999,0
1653423572236,ECE 200,051,091053,Wang; Xiaolong,9999,0,9999,0
1653423572236,ECE 200,052,091054,Xie; Pengtao,9999,0,9999,0
1653423572236,ECE 200,053,091055,Yip; Michael,9999,0,9999,0
1653423572236,ECE 200,054,091056,Zeger; Kenneth A.,9999,0,9999,0
1653423572236,ECE 200,055,091057,Zhang; Xinyu,9999,0,9999,0
1653423572236,ECE 200,056,091058,Turakhia; Yatish Girish,9999,0,9999,0
1653423572236,ECE 200,057,091059,Kang; Mingu,9999,0,9999,0
1653423572236,ECE 200,058,091060,Shi; Yuanyuan,9999,0,9999,0
1653423572236,ECE 200,059,091061,Wang; Edward Jay,9999,0,9999,0
1653423572236,ECE 200,060,091062,Zheng; Yang,9999,0,9999,0
1653423572761,ECE 203,A00,091065,Mercier; Patrick Philip,0,0,0,0
1653423573299,ECE 207A,A00,091605,Liu; Thomas Tao-Ming,0,0,0,0
1653423573850,ECE 212AN,A00,091068,Nomura; Kenji,0,0,0,0
1653423574378,ECE 222A,A00,091069,Rebeiz; Gabriel,0,0,0,0
1653423574911,ECE 225A,A00,091070,Orlitsky; Alon,0,0,0,0
1653423575442,ECE 230A,A00,091071,Nomura; Kenji,0,0,0,0
1653423575968,ECE 236A,A00,091072,Dayeh; Shadi Ahmad,0,0,0,0
1653423576493,ECE 238A,A00,091073,Luo; Jian,0,0,0,0
1653423576493,ECE 238A,B00,091074,Luo; Jian,0,0,0,0
1653423577017,ECE 240A,A00,091075,Radic; Stojan,0,0,0,0
1653423577547,ECE 247A,A00,091592,Shi; Lingyan,0,0,0,0
1653423578068,ECE 250,A00,091076,Touri; Behrouz,0,0,0,0
1653423578611,ECE 251C,A00,091078,Nguyen; Truong Quang,0,0,0,0
1653423579135,ECE 253,A00,091079,Cosman; Pamela C.,0,0,0,0
1653423579668,ECE 255A,A00,091080,Orlitsky; Alon,0,0,0,0
1653423580201,ECE 257A,A00,091081,Zhang; Xinyu,0,0,0,0
1653423580725,ECE 260A,A01,091084,Eldon; John,0,0,0,0
1653423581253,ECE 264C,A00,091085,Galton; Ian A,0,0,0,0
1653423581777,ECE 265C,A00,094889,Presti; Calogero Davide,0,0,0,9
1653423582316,ECE 266,A01,091087,Hall; Drew A.,0,0,0,0
1653423583365,ECE 271A,A00,091090,Vasconcelos; Nuno,0,0,0,0
1653423583894,ECE 272B,A00,091091,Sworder; David D.,0,0,0,0
1653423584424,ECE 275A,A00,091092,Meyer; Florian,0,0,0,0
1653423584959,ECE 277,A00,091093,An; Cheolhong,0,0,0,0
1653423585494,ECE 283,A00,091094,Le; Hanh-Phuc,0,0,0,0
1653423586019,ECE 284,A00,091095,Kang; Mingu,0,0,0,0
1653423586019,ECE 284,B00,091096,Wang; Edward Jay,0,0,0,0
1653423586558,ECE 285,A00,094334,Touri; Behrouz,0,0,0,0
1653423587083,ECE 289,A00,091097,Whelan; David Arthur,0,0,0,0
1653423587604,MATH 200A,A00,087414,Salehi Golsefidy; Alireza,7,0,8,1
1653423588135,MATH 202A,A00,087415,Gill; Philip E.,3,0,8,5
1653423588660,MATH 203A,A00,087416,Oprea; Dragos N.,6,0,8,2
1653423589189,MATH 204A,A00,087417,Kedlaya; Kiran S.,6,0,8,2
1653423589712,MATH 205,A00,087418,Sorensen; Claus M,6,0,8,2
1653423590243,MATH 206A,A00,087419,Izadi; Elham,7,0,8,1
1653423590769,MATH 207A,A00,087420,Mohammadi; Amir,6,0,8,2
1653423591308,MATH 208,A00,087421,Staff,9,0,10,1
1653423591837,MATH 209,A00,087422,Staff,10,0,10,0
1653423592378,MATH 218,A00,087423,Staff,10,0,10,0
1653423592901,MATH 220A,A00,087424,Novak; Jonathan I,7,0,8,1
1653423593427,MATH 231A,A00,087425,Bejenaru; Ioan,4,0,8,4
1653423593959,MATH 240A,A00,087426,Ebenfelt; Peter F,5,0,8,3
1653423594487,MATH 243,A00,087427,Staff,9,0,10,1
1653423595011,MATH 248,A00,087429,Staff,10,0,10,0
1653423595545,MATH 250A,A00,087430,Spolaor; Luca,5,0,8,3
1653423596076,MATH 257A,A00,087431,Spolaor; Luca,7,0,8,1
1653423596605,MATH 258,A00,087432,Staff,9,0,10,1
1653423597132,MATH 264A,A00,087433,Warnke; Lutz Peter,5,0,8,3
1653423597666,MATH 268,A00,087434,Staff,15,0,15,0
1653423598189,MATH 269,A00,087435,Staff,14,0,15,1
1653423598720,MATH 270A,A00,087436,Nie; Jiawang,0,0,8,8
1653423599260,MATH 272A,A00,087437,Tian; Xiaochuan,2,0,8,6
1653423599790,MATH 274,A01,087439,Cheng; Li-Tien,9,0,10,1
1653423599790,MATH 274,A02,087440,Cheng; Li-Tien,10,0,10,0
1653423600328,MATH 278A,A00,087441,Staff,8,0,10,2
1653423601372,MATH 278B,A00,087442,Staff,8,0,10,2
1653423601921,MATH 278C,A00,087443,Staff,8,0,10,2
1653423602456,MATH 280A,A00,087444,Zheng; Tianyi,0,0,8,8
1653423602989,MATH 281A,A00,087445,Bradic; Jelena,0,0,8,8
1653423603538,MATH 282A,A00,087446,Zhang; Danna,0,0,8,8
1653423604065,MATH 283,A00,087447,Tesler; Glenn,0,0,0,14
1653423604616,MATH 286,A00,087448,Kemp; Todd Aahron,6,0,8,2
1653423605148,MATH 287D,A00,087449,Bradic; Jelena,8,0,8,0
1653423605752,MATH 288,A00,087450,Staff,14,0,15,1
1653423605752,MATH 288,B00,087451,Staff,15,0,15,0
1653423605752,MATH 288,C00,087452,Staff,15,0,15,0
1653423606281,MATH 290A,A00,087453,Xu; Zhouli,7,0,8,1
1653423606807,MATH 291A,A00,087454,Xu; Zhouli,7,0,8,1
1653423607346,MATH 292,A00,087455,Staff,10,0,10,0
1653423607867,MATH 295,A00,087456,Staff,50,0,50,0
1653423608393,MATH 297,001,087457,Staff,998,0,999,1
1653424186222,COGS 200,A01,087991,Staff,48,0,50,2
1653424186751,COGS 201,A01,094504,Rangel; Lara M,17,0,25,8
1653424187282,COGS 203,A00,087992,Coulson; Seana M,19,0,20,1
1653424187814,COGS 210A,001,087993,Greene; Deanna Jacquelyn,9998,0,9999,1
1653424187814,COGS 210A,002,087994,Saygin; Ayse P,9999,0,9999,0
1653424187814,COGS 210A,003,087995,Xia; Haijun,9999,0,9999,0
1653424187814,COGS 210A,004,087996,Nitz; Douglas A.,9999,0,9999,0
1653424187814,COGS 210A,005,087997,Hollan; James D.,9999,0,9999,0
1653424187814,COGS 210A,006,087998,Deak; Gedeon O.,9998,0,9999,1
1653424187814,COGS 210A,007,087999,Rossano; Federico,9999,0,9999,0
1653424188349,COGS 211A,A00,088000,Coulson; Seana M,9997,0,9999,2
1653424188875,COGS 229,A00,088002,Staff,23,0,25,2
1653424189418,COGS 260,B00,094231,Staff,17,0,20,3
1653424189418,COGS 260,A00,088004,Nitz; Douglas A.,9998,0,9999,1
1653424189945,CSE 202,A00,090110,Paturi; Ramamohan,0,0,0,0
1653424189945,CSE 202,B00,090111,Paturi; Ramamohan,0,0,0,0
1653424190472,CSE 207B,A00,090112,Heninger; Nadia A,0,0,0,0
1653424191008,CSE 208,A00,094858,Micciancio; Daniele,0,0,0,0
1653424191535,CSE 210,A00,090113,Powell; Thomas Allan,0,0,0,0
1653424192068,CSE 219,A00,090898,Staff,0,0,0,0
1653424192607,CSE 221,A00,090114,Zhou; Yuan-Yuan,0,0,0,0
1653424193128,CSE 229A,A00,090115,Porter; George M,0,0,0,0
1653424193667,CSE 229C,A00,090116,Savage; Stefan,0,0,0,0
1653424194193,CSE 230,A00,090117,Jhala; Ranjit,0,0,0,0
1653424194732,CSE 232,A00,090118,Papakonstantinou; Yannis,0,0,0,0
1653424195272,CSE 239A,A00,090121,Kumar; Arun Kumar,0,0,0,0
1653424195806,CSE 239B,A00,090122,Jhala; Ranjit,0,0,0,0
1653424196330,CSE 240A,A00,090123,Zhao; Jishen,0,0,189,189
1653424196861,CSE 243A,A00,090124,Orailoglu; Alex,3,0,15,12
1653424197403,CSE 249B,A00,090125,Kahng; Andrew Byun,13,0,20,7
1653424197928,CSE 250A,A00,090126,Berg-Kirkpatrick; Taylor D,0,0,0,0
1653424198459,CSE 252A,A00,090127,Ochoa; Benjamin Lawrence,0,0,0,0
1653424198981,CSE 258,A01,090129,McAuley; Julian John,0,0,0,0
1653424199513,CSE 258R,A01,090131,McAuley; Julian John,0,0,0,0
1653424200050,CSE 274,A00,090132,Ramamoorthi; Ravi,0,0,0,0
1653424200963,CSE 276A,A00,090133,Christensen; Henrik I,0,0,0,0
1653424201505,CSE 276C,A00,090134,Christensen; Henrik I,0,0,0,0
1653424202040,CSE 290,A00,090135,Bafna; Vineet,0,0,0,0
1653424202040,CSE 290,B00,090136,Ramamoorthi; Ravi,0,0,0,0
1653424202040,CSE 290,C00,090137,Li; Tzumao,9,0,10,1
1653424202040,CSE 290,D00,090138,Zhou; Yuan-Yuan,10,0,10,0
1653424202040,CSE 290,E00,090139,Christensen; Henrik I,10,0,10,0
1653424202040,CSE 290,F00,094053,Shalev; Aaron D,0,0,0,0
1653424202572,CSE 291,A00,090140,Munyaka; Imani N. S.,0,0,0,0
1653424202572,CSE 291,B00,094880,Yu; Qi,0,0,0,0
1653424202572,CSE 291,C00,090142,Pannuto; Patrick William,0,0,0,0
1653424202572,CSE 291,D00,094881,Zhang; Yiying,0,0,0,0
1653424202572,CSE 291,E00,095118,Su; Hao,0,0,0,0
1653424203113,CSE 293,001,094905,Bafna; Vineet,9999,0,9999,0
1653424203113,CSE 293,002,094906,Bellare; Mihir,9999,0,9999,0
1653424203113,CSE 293,003,094907,Berg-Kirkpatrick; Taylor D,9999,0,9999,0
1653424203113,CSE 293,004,094908,Christensen; Henrik I,9999,0,9999,0
1653424203113,CSE 293,005,094909,Cottrell; Garrison W,9999,0,9999,0
1653424203113,CSE 293,006,094910,Deutsch; Alin Bernard,9999,0,9999,0
1653424203113,CSE 293,007,094911,Esmaeilzadeh; Hadi,9999,0,9999,0
1653424203113,CSE 293,008,094912,Freund; Yoav,9999,0,9999,0
1653424203113,CSE 293,009,094913,Griswold; William G.,9999,0,9999,0
1653424203113,CSE 293,010,094914,Gymrek; Melissa Ann,9999,0,9999,0
1653424203113,CSE 293,011,094915,Heninger; Nadia A,9999,0,9999,0
1653424203113,CSE 293,012,094916,Impagliazzo; Russell,9999,0,9999,0
1653424203113,CSE 293,013,094917,Jhala; Ranjit,9999,0,9999,0
1653424203113,CSE 293,014,094918,Kahng; Andrew Byun,9999,0,9999,0
1653424203113,CSE 293,015,094919,Kane; Daniel Mertz,9999,0,9999,0
1653424203113,CSE 293,016,094920,Kriegman; David J,9999,0,9999,0
1653424203113,CSE 293,017,094921,Kumar; Arun Kumar,9999,0,9999,0
1653424203113,CSE 293,018,094922,Lerner; Sorin,9999,0,9999,0
1653424203113,CSE 293,019,094923,Lovett; Shachar,9999,0,9999,0
1653424203113,CSE 293,020,094924,McAuley; Julian John,9999,0,9999,0
1653424203113,CSE 293,021,094925,Micciancio; Daniele,9999,0,9999,0
1653424203113,CSE 293,022,094926,Orailoglu; Alex,9999,0,9999,0
1653424203113,CSE 293,023,094927,Paturi; Ramamohan,9999,0,9999,0
1653424203113,CSE 293,024,094928,Polikarpova; Nadezhda,9999,0,9999,0
1653424203113,CSE 293,025,094929,Politz; Joseph Gibbs,9999,0,9999,0
1653424203113,CSE 293,026,094930,Porter; George M,9999,0,9999,0
1653424203113,CSE 293,027,094931,Porter; Leonard Emerson,9999,0,9999,0
1653424203113,CSE 293,028,094932,Ramamoorthi; Ravi,9999,0,9999,0
1653424203113,CSE 293,029,094933,Sahoo; Debashis,9999,0,9999,0
1653424203113,CSE 293,030,094934,Saul; Lawrence,9999,0,9999,0
1653424203113,CSE 293,031,094935,Savage; Stefan,9999,0,9999,0
1653424203113,CSE 293,032,094936,Schulze; Jurgen P.,9999,0,9999,0
1653424203113,CSE 293,033,094937,Snoeren; Alex C.,9999,0,9999,0
1653424203113,CSE 293,034,094938,Shang; Jingbo,9999,0,9999,0
1653424203113,CSE 293,035,094939,Stefan; Deian,9999,0,9999,0
1653424203113,CSE 293,036,094940,Su; Hao,9999,0,9999,0
1653424203113,CSE 293,037,094941,Swanson; Steven James,9999,0,9999,0
1653424203113,CSE 293,038,094942,Tullsen; Dean Michael,9999,0,9999,0
1653424203113,CSE 293,039,094943,Voelker; Geoffrey M.,9999,0,9999,0
1653424203113,CSE 293,040,094944,Zhao; Jishen,9999,0,9999,0
1653424203113,CSE 293,041,094945,Zhou; Yuan-Yuan,9999,0,9999,0
1653424203113,CSE 293,042,094946,Gao; Sicun,9998,0,9999,1
1653424203113,CSE 293,043,094947,Weibel; Nadir,9999,0,9999,0
1653424203113,CSE 293,044,094948,Gupta; Rajesh K.,9999,0,9999,0
1653424203636,CSE 294,A00,090143,Porter; George M,9,0,10,1
1653424204159,DSE 200,A00,091799,Staff,50,0,50,0
1653424204686,DSE 203,A00,091800,Gupta; Amarnath,30,0,30,0
1653424205213,DSE 250,A00,091801,Deutsch; Alin Bernard,30,0,30,0
1653424205795,DSE 290,A00,091802,Altintas De Callaf; Ilkay,50,0,50,0
1653424206356,ECE 200,001,091003,Antipa; Nicholas A,9999,0,9999,0
1653424206356,ECE 200,002,091004,Atanasov; Nikolay A.,9999,0,9999,0
1653424206356,ECE 200,003,091005,Bharadia; Dinesh,9999,0,9999,0
1653424206356,ECE 200,004,091006,Cheng; Chung Kuan,9999,0,9999,0
1653424206356,ECE 200,005,091007,Cosman; Pamela C.,9999,0,9999,0
1653424206356,ECE 200,006,091008,Staff,9999,0,9999,0
1653424206356,ECE 200,007,091009,Dayeh; Shadi Ahmad,9999,0,9999,0
1653424206356,ECE 200,008,091010,Fainman; Yeshaiahu,9999,0,9999,0
1653424206356,ECE 200,009,091011,Ford; Joseph Earl,9999,0,9999,0
1653424206356,ECE 200,010,091012,Franceschetti; Massimo,9999,0,9999,0
1653424206356,ECE 200,011,091013,Fullerton; Eric E,9999,0,9999,0
1653424206356,ECE 200,012,091014,Galton; Ian A,9999,0,9999,0
1653424206356,ECE 200,013,091015,Gilja; Vikash,9999,0,9999,0
1653424206356,ECE 200,014,091016,Hall; Drew A.,9999,0,9999,0
1653424206356,ECE 200,015,091017,Hsueh; Tzu-Chien,9999,0,9999,0
1653424206356,ECE 200,016,091018,Javidi; Tara,9999,0,9999,0
1653424206356,ECE 200,017,091019,Kahng; Andrew Byun,9999,0,9999,0
1653424206356,ECE 200,018,091020,Kim; Young-Han,9999,0,9999,0
1653424206356,ECE 200,019,091021,Koushanfar; Farinaz,9999,0,9999,0
1653424206356,ECE 200,020,091022,Kuzum; Duygu,9999,0,9999,0
1653424206356,ECE 200,021,091023,Le; Hanh-Phuc,9999,0,9999,0
1653424206356,ECE 200,022,091024,Lin; Bill,9999,0,9999,0
1653424206356,ECE 200,023,091025,Liu; Zhaowei,9999,0,9999,0
1653424206356,ECE 200,024,091026,Lo; Yu-Hwa,9999,0,9999,0
1653424206356,ECE 200,025,091027,Lomakin; Vitaliy,9999,0,9999,0
1653424206356,ECE 200,026,091028,Mercier; Patrick Philip,9999,0,9999,0
1653424206356,ECE 200,027,091029,Meyer; Florian,9999,0,9999,0
1653424206356,ECE 200,028,091030,Milstein; Laurence B.,9999,0,9999,0
1653424206356,ECE 200,029,091031,Mir Arabbaygi; Siavash,9999,0,9999,0
1653424206356,ECE 200,030,091032,Mookherjea; Shayan,9999,0,9999,0
1653424206356,ECE 200,031,091033,Morris; Karcher William,9999,0,9999,0
1653424206356,ECE 200,032,091034,Ng; Tse Nga,9999,0,9999,0
1653424206356,ECE 200,033,091035,Nguyen; Truong Quang,9999,0,9999,0
1653424206356,ECE 200,034,091036,Nomura; Kenji,9999,0,9999,0
1653424206356,ECE 200,035,091037,Orlitsky; Alon,9999,0,9999,0
1653424206356,ECE 200,036,091038,Pal; Piya,9999,0,9999,0
1653424206356,ECE 200,037,091039,Papen; George C.,9999,0,9999,0
1653424206356,ECE 200,038,091040,Radic; Stojan,9999,0,9999,0
1653424206356,ECE 200,039,091041,Rao; Bhaskar D.,9999,0,9999,0
1653424206356,ECE 200,040,091042,Rao; Ramesh R,9999,0,9999,0
1653424206356,ECE 200,041,091043,Rebeiz; Gabriel,9999,0,9999,0
1653424206356,ECE 200,042,091044,Sanford; John R,9999,0,9999,0
1653424206356,ECE 200,043,091045,Siegel; Paul H.,9999,0,9999,0
1653424206356,ECE 200,044,091046,Sievenpiper; Daniel F.,9999,0,9999,0
1653424206356,ECE 200,045,091047,Sworder; David D.,9999,0,9999,0
1653424206356,ECE 200,046,091048,Taur; Yuan,9999,0,9999,0
1653424206356,ECE 200,047,091049,Touri; Behrouz,9999,0,9999,0
1653424206356,ECE 200,048,091050,Trivedi; Mohan M.,9999,0,9999,0
1653424206356,ECE 200,049,091051,Vardy; Alexander,9999,0,9999,0
1653424206356,ECE 200,050,091052,Vasconcelos; Nuno,9999,0,9999,0
1653424206356,ECE 200,051,091053,Wang; Xiaolong,9999,0,9999,0
1653424206356,ECE 200,052,091054,Xie; Pengtao,9999,0,9999,0
1653424206356,ECE 200,053,091055,Yip; Michael,9999,0,9999,0
1653424206356,ECE 200,054,091056,Zeger; Kenneth A.,9999,0,9999,0
1653424206356,ECE 200,055,091057,Zhang; Xinyu,9999,0,9999,0
1653424206356,ECE 200,056,091058,Turakhia; Yatish Girish,9999,0,9999,0
1653424206356,ECE 200,057,091059,Kang; Mingu,9999,0,9999,0
1653424206356,ECE 200,058,091060,Shi; Yuanyuan,9999,0,9999,0
1653424206356,ECE 200,059,091061,Wang; Edward Jay,9999,0,9999,0
1653424206356,ECE 200,060,091062,Zheng; Yang,9999,0,9999,0
1653424206887,ECE 203,A00,091065,Mercier; Patrick Philip,0,0,0,0
1653424207425,ECE 207A,A00,091605,Liu; Thomas Tao-Ming,0,0,0,0
1653424207955,ECE 212AN,A00,091068,Nomura; Kenji,0,0,0,0
1653424208483,ECE 222A,A00,091069,Rebeiz; Gabriel,0,0,0,0
1653424209014,ECE 225A,A00,091070,Orlitsky; Alon,0,0,0,0
1653424209537,ECE 230A,A00,091071,Nomura; Kenji,0,0,0,0
1653424210062,ECE 236A,A00,091072,Dayeh; Shadi Ahmad,0,0,0,0
1653424210592,ECE 238A,A00,091073,Luo; Jian,0,0,0,0
1653424210592,ECE 238A,B00,091074,Luo; Jian,0,0,0,0
1653424211122,ECE 240A,A00,091075,Radic; Stojan,0,0,0,0
1653424211822,ECE 247A,A00,091592,Shi; Lingyan,0,0,0,0
1653424212352,ECE 250,A00,091076,Touri; Behrouz,0,0,0,0
1653424212938,ECE 251C,A00,091078,Nguyen; Truong Quang,0,0,0,0
1653424213471,ECE 253,A00,091079,Cosman; Pamela C.,0,0,0,0
1653424214033,ECE 255A,A00,091080,Orlitsky; Alon,0,0,0,0
1653424214566,ECE 257A,A00,091081,Zhang; Xinyu,0,0,0,0
1653424215088,ECE 260A,A01,091084,Eldon; John,0,0,0,0
1653424215619,ECE 264C,A00,091085,Galton; Ian A,0,0,0,0
1653424216150,ECE 265C,A00,094889,Presti; Calogero Davide,0,0,0,9
1653424216673,ECE 266,A01,091087,Hall; Drew A.,0,0,0,0
1653424217724,ECE 271A,A00,091090,Vasconcelos; Nuno,0,0,0,0
1653424218265,ECE 272B,A00,091091,Sworder; David D.,0,0,0,0
1653424218798,ECE 275A,A00,091092,Meyer; Florian,0,0,0,0
1653424219342,ECE 277,A00,091093,An; Cheolhong,0,0,0,0
1653424219868,ECE 283,A00,091094,Le; Hanh-Phuc,0,0,0,0
1653424220396,ECE 284,A00,091095,Kang; Mingu,0,0,0,0
1653424220396,ECE 284,B00,091096,Wang; Edward Jay,0,0,0,0
1653424220946,ECE 285,A00,094334,Touri; Behrouz,0,0,0,0
1653424221487,ECE 289,A00,091097,Whelan; David Arthur,0,0,0,0
1653424222054,MATH 200A,A00,087414,Salehi Golsefidy; Alireza,7,0,8,1
1653424222603,MATH 202A,A00,087415,Gill; Philip E.,3,0,8,5
1653424223159,MATH 203A,A00,087416,Oprea; Dragos N.,6,0,8,2
1653424223799,MATH 204A,A00,087417,Kedlaya; Kiran S.,6,0,8,2
1653424224335,MATH 205,A00,087418,Sorensen; Claus M,6,0,8,2
1653424224868,MATH 206A,A00,087419,Izadi; Elham,7,0,8,1
1653424225520,MATH 207A,A00,087420,Mohammadi; Amir,6,0,8,2
1653424226154,MATH 208,A00,087421,Staff,9,0,10,1
1653424226696,MATH 209,A00,087422,Staff,10,0,10,0
1653424227247,MATH 218,A00,087423,Staff,10,0,10,0
1653424227770,MATH 220A,A00,087424,Novak; Jonathan I,7,0,8,1
1653424228301,MATH 231A,A00,087425,Bejenaru; Ioan,4,0,8,4
1653424228824,MATH 240A,A00,087426,Ebenfelt; Peter F,5,0,8,3
1653424229346,MATH 243,A00,087427,Staff,9,0,10,1
1653424229876,MATH 248,A00,087429,Staff,10,0,10,0
1653424230406,MATH 250A,A00,087430,Spolaor; Luca,5,0,8,3
1653424230933,MATH 257A,A00,087431,Spolaor; Luca,7,0,8,1
1653424231476,MATH 258,A00,087432,Staff,9,0,10,1
1653424232013,MATH 264A,A00,087433,Warnke; Lutz Peter,5,0,8,3
1653424232553,MATH 268,A00,087434,Staff,15,0,15,0
1653424233076,MATH 269,A00,087435,Staff,14,0,15,1
1653424233614,MATH 270A,A00,087436,Nie; Jiawang,0,0,8,8
1653424234145,MATH 272A,A00,087437,Tian; Xiaochuan,2,0,8,6
1653424234677,MATH 274,A01,087439,Cheng; Li-Tien,9,0,10,1
1653424234677,MATH 274,A02,087440,Cheng; Li-Tien,10,0,10,0
1653424235226,MATH 278A,A00,087441,Staff,8,0,10,2
1653424235762,MATH 278B,A00,087442,Staff,8,0,10,2
1653424236288,MATH 278C,A00,087443,Staff,8,0,10,2
1653424236810,MATH 280A,A00,087444,Zheng; Tianyi,0,0,8,8
1653424237340,MATH 281A,A00,087445,Bradic; Jelena,0,0,8,8
1653424237873,MATH 282A,A00,087446,Zhang; Danna,0,0,8,8
1653424238407,MATH 283,A00,087447,Tesler; Glenn,0,0,0,14
1653424238947,MATH 286,A00,087448,Kemp; Todd Aahron,6,0,8,2
1653424239478,MATH 287D,A00,087449,Bradic; Jelena,8,0,8,0
1653424240018,MATH 288,A00,087450,Staff,14,0,15,1
1653424240018,MATH 288,B00,087451,Staff,15,0,15,0
1653424240018,MATH 288,C00,087452,Staff,15,0,15,0
1653424240551,MATH 290A,A00,087453,Xu; Zhouli,7,0,8,1
1653424241076,MATH 291A,A00,087454,Xu; Zhouli,7,0,8,1
1653424241604,MATH 292,A00,087455,Staff,10,0,10,0
1653424242136,MATH 295,A00,087456,Staff,50,0,50,0
1653424242668,MATH 297,001,087457,Staff,998,0,999,1
1653424809858,COGS 200,A01,087991,Staff,48,0,50,2
1653424810392,COGS 201,A01,094504,Rangel; Lara M,17,0,25,8
1653424810922,COGS 203,A00,087992,Coulson; Seana M,19,0,20,1
1653424811457,COGS 210A,001,087993,Greene; Deanna Jacquelyn,9998,0,9999,1
1653424811457,COGS 210A,002,087994,Saygin; Ayse P,9999,0,9999,0
1653424811457,COGS 210A,003,087995,Xia; Haijun,9999,0,9999,0
1653424811457,COGS 210A,004,087996,Nitz; Douglas A.,9999,0,9999,0
1653424811457,COGS 210A,005,087997,Hollan; James D.,9999,0,9999,0
1653424811457,COGS 210A,006,087998,Deak; Gedeon O.,9998,0,9999,1
1653424811457,COGS 210A,007,087999,Rossano; Federico,9999,0,9999,0
1653424812349,COGS 211A,A00,088000,Coulson; Seana M,9997,0,9999,2
1653424812881,COGS 229,A00,088002,Staff,23,0,25,2
1653424813405,COGS 260,B00,094231,Staff,17,0,20,3
1653424813405,COGS 260,A00,088004,Nitz; Douglas A.,9998,0,9999,1
1653424813959,CSE 202,A00,090110,Paturi; Ramamohan,0,0,0,0
1653424813959,CSE 202,B00,090111,Paturi; Ramamohan,0,0,0,0
1653424814499,CSE 207B,A00,090112,Heninger; Nadia A,0,0,0,0
1653424815050,CSE 208,A00,094858,Micciancio; Daniele,0,0,0,0
1653424815577,CSE 210,A00,090113,Powell; Thomas Allan,0,0,0,0
1653424816116,CSE 219,A00,090898,Staff,0,0,0,0
1653424816647,CSE 221,A00,090114,Zhou; Yuan-Yuan,0,0,0,0
1653424817175,CSE 229A,A00,090115,Porter; George M,0,0,0,0
1653424817714,CSE 229C,A00,090116,Savage; Stefan,0,0,0,0
1653424818264,CSE 230,A00,090117,Jhala; Ranjit,0,0,0,0
1653424818833,CSE 232,A00,090118,Papakonstantinou; Yannis,0,0,0,0
1653424819361,CSE 239A,A00,090121,Kumar; Arun Kumar,0,0,0,0
1653424819900,CSE 239B,A00,090122,Jhala; Ranjit,0,0,0,0
1653424820456,CSE 240A,A00,090123,Zhao; Jishen,0,0,189,189
1653424820990,CSE 243A,A00,090124,Orailoglu; Alex,3,0,15,12
1653424821625,CSE 249B,A00,090125,Kahng; Andrew Byun,13,0,20,7
1653424822193,CSE 250A,A00,090126,Berg-Kirkpatrick; Taylor D,0,0,0,0
1653424822743,CSE 252A,A00,090127,Ochoa; Benjamin Lawrence,0,0,0,0
1653424823272,CSE 258,A01,090129,McAuley; Julian John,0,0,0,0
1653424823796,CSE 258R,A01,090131,McAuley; Julian John,0,0,0,0
1653424824327,CSE 274,A00,090132,Ramamoorthi; Ravi,0,0,0,0
1653424824855,CSE 276A,A00,090133,Christensen; Henrik I,0,0,0,0
1653424825386,CSE 276C,A00,090134,Christensen; Henrik I,0,0,0,0
1653424825915,CSE 290,A00,090135,Bafna; Vineet,0,0,0,0
1653424825915,CSE 290,B00,090136,Ramamoorthi; Ravi,0,0,0,0
1653424825915,CSE 290,C00,090137,Li; Tzumao,9,0,10,1
1653424825915,CSE 290,D00,090138,Zhou; Yuan-Yuan,10,0,10,0
1653424825915,CSE 290,E00,090139,Christensen; Henrik I,10,0,10,0
1653424825915,CSE 290,F00,094053,Shalev; Aaron D,0,0,0,0
1653424826445,CSE 291,A00,090140,Munyaka; Imani N. S.,0,0,0,0
1653424826445,CSE 291,B00,094880,Yu; Qi,0,0,0,0
1653424826445,CSE 291,C00,090142,Pannuto; Patrick William,0,0,0,0
1653424826445,CSE 291,D00,094881,Zhang; Yiying,0,0,0,0
1653424826445,CSE 291,E00,095118,Su; Hao,0,0,0,0
1653424826995,CSE 293,001,094905,Bafna; Vineet,9999,0,9999,0
1653424826995,CSE 293,002,094906,Bellare; Mihir,9999,0,9999,0
1653424826995,CSE 293,003,094907,Berg-Kirkpatrick; Taylor D,9999,0,9999,0
1653424826995,CSE 293,004,094908,Christensen; Henrik I,9999,0,9999,0
1653424826995,CSE 293,005,094909,Cottrell; Garrison W,9999,0,9999,0
1653424826995,CSE 293,006,094910,Deutsch; Alin Bernard,9999,0,9999,0
1653424826995,CSE 293,007,094911,Esmaeilzadeh; Hadi,9999,0,9999,0
1653424826995,CSE 293,008,094912,Freund; Yoav,9999,0,9999,0
1653424826995,CSE 293,009,094913,Griswold; William G.,9999,0,9999,0
1653424826995,CSE 293,010,094914,Gymrek; Melissa Ann,9999,0,9999,0
1653424826995,CSE 293,011,094915,Heninger; Nadia A,9999,0,9999,0
1653424826995,CSE 293,012,094916,Impagliazzo; Russell,9999,0,9999,0
1653424826995,CSE 293,013,094917,Jhala; Ranjit,9999,0,9999,0
1653424826995,CSE 293,014,094918,Kahng; Andrew Byun,9999,0,9999,0
1653424826995,CSE 293,015,094919,Kane; Daniel Mertz,9999,0,9999,0
1653424826995,CSE 293,016,094920,Kriegman; David J,9999,0,9999,0
1653424826995,CSE 293,017,094921,Kumar; Arun Kumar,9999,0,9999,0
1653424826995,CSE 293,018,094922,Lerner; Sorin,9999,0,9999,0
1653424826995,CSE 293,019,094923,Lovett; Shachar,9999,0,9999,0
1653424826995,CSE 293,020,094924,McAuley; Julian John,9999,0,9999,0
1653424826995,CSE 293,021,094925,Micciancio; Daniele,9999,0,9999,0
1653424826995,CSE 293,022,094926,Orailoglu; Alex,9999,0,9999,0
1653424826995,CSE 293,023,094927,Paturi; Ramamohan,9999,0,9999,0
1653424826995,CSE 293,024,094928,Polikarpova; Nadezhda,9999,0,9999,0
1653424826995,CSE 293,025,094929,Politz; Joseph Gibbs,9999,0,9999,0
1653424826995,CSE 293,026,094930,Porter; George M,9999,0,9999,0
1653424826995,CSE 293,027,094931,Porter; Leonard Emerson,9999,0,9999,0
1653424826995,CSE 293,028,094932,Ramamoorthi; Ravi,9999,0,9999,0
1653424826995,CSE 293,029,094933,Sahoo; Debashis,9999,0,9999,0
1653424826995,CSE 293,030,094934,Saul; Lawrence,9999,0,9999,0
1653424826995,CSE 293,031,094935,Savage; Stefan,9999,0,9999,0
1653424826995,CSE 293,032,094936,Schulze; Jurgen P.,9999,0,9999,0
1653424826995,CSE 293,033,094937,Snoeren; Alex C.,9999,0,9999,0
1653424826995,CSE 293,034,094938,Shang; Jingbo,9999,0,9999,0
1653424826995,CSE 293,035,094939,Stefan; Deian,9999,0,9999,0
1653424826995,CSE 293,036,094940,Su; Hao,9999,0,9999,0
1653424826995,CSE 293,037,094941,Swanson; Steven James,9999,0,9999,0
1653424826995,CSE 293,038,094942,Tullsen; Dean Michael,9999,0,9999,0
1653424826995,CSE 293,039,094943,Voelker; Geoffrey M.,9999,0,9999,0
1653424826995,CSE 293,040,094944,Zhao; Jishen,9999,0,9999,0
1653424826995,CSE 293,041,094945,Zhou; Yuan-Yuan,9999,0,9999,0
1653424826995,CSE 293,042,094946,Gao; Sicun,9998,0,9999,1
1653424826995,CSE 293,043,094947,Weibel; Nadir,9999,0,9999,0
1653424826995,CSE 293,044,094948,Gupta; Rajesh K.,9999,0,9999,0
1653424827524,CSE 294,A00,090143,Porter; George M,9,0,10,1
1653424828050,DSE 200,A00,091799,Staff,50,0,50,0
1653424828576,DSE 203,A00,091800,Gupta; Amarnath,30,0,30,0
1653424829108,DSE 250,A00,091801,Deutsch; Alin Bernard,30,0,30,0
1653424829638,DSE 290,A00,091802,Altintas De Callaf; Ilkay,50,0,50,0
1653424830228,ECE 200,001,091003,Antipa; Nicholas A,9999,0,9999,0
1653424830228,ECE 200,002,091004,Atanasov; Nikolay A.,9999,0,9999,0
1653424830228,ECE 200,003,091005,Bharadia; Dinesh,9999,0,9999,0
1653424830228,ECE 200,004,091006,Cheng; Chung Kuan,9999,0,9999,0
1653424830228,ECE 200,005,091007,Cosman; Pamela C.,9999,0,9999,0
1653424830228,ECE 200,006,091008,Staff,9999,0,9999,0
1653424830228,ECE 200,007,091009,Dayeh; Shadi Ahmad,9999,0,9999,0
1653424830228,ECE 200,008,091010,Fainman; Yeshaiahu,9999,0,9999,0
1653424830228,ECE 200,009,091011,Ford; Joseph Earl,9999,0,9999,0
1653424830228,ECE 200,010,091012,Franceschetti; Massimo,9999,0,9999,0
1653424830228,ECE 200,011,091013,Fullerton; Eric E,9999,0,9999,0
1653424830228,ECE 200,012,091014,Galton; Ian A,9999,0,9999,0
1653424830228,ECE 200,013,091015,Gilja; Vikash,9999,0,9999,0
1653424830228,ECE 200,014,091016,Hall; Drew A.,9999,0,9999,0
1653424830228,ECE 200,015,091017,Hsueh; Tzu-Chien,9999,0,9999,0
1653424830228,ECE 200,016,091018,Javidi; Tara,9999,0,9999,0
1653424830228,ECE 200,017,091019,Kahng; Andrew Byun,9999,0,9999,0
1653424830228,ECE 200,018,091020,Kim; Young-Han,9999,0,9999,0
1653424830228,ECE 200,019,091021,Koushanfar; Farinaz,9999,0,9999,0
1653424830228,ECE 200,020,091022,Kuzum; Duygu,9999,0,9999,0
1653424830228,ECE 200,021,091023,Le; Hanh-Phuc,9999,0,9999,0
1653424830228,ECE 200,022,091024,Lin; Bill,9999,0,9999,0
1653424830228,ECE 200,023,091025,Liu; Zhaowei,9999,0,9999,0
1653424830228,ECE 200,024,091026,Lo; Yu-Hwa,9999,0,9999,0
1653424830228,ECE 200,025,091027,Lomakin; Vitaliy,9999,0,9999,0
1653424830228,ECE 200,026,091028,Mercier; Patrick Philip,9999,0,9999,0
1653424830228,ECE 200,027,091029,Meyer; Florian,9999,0,9999,0
1653424830228,ECE 200,028,091030,Milstein; Laurence B.,9999,0,9999,0
1653424830228,ECE 200,029,091031,Mir Arabbaygi; Siavash,9999,0,9999,0
1653424830228,ECE 200,030,091032,Mookherjea; Shayan,9999,0,9999,0
1653424830228,ECE 200,031,091033,Morris; Karcher William,9999,0,9999,0
1653424830228,ECE 200,032,091034,Ng; Tse Nga,9999,0,9999,0
1653424830228,ECE 200,033,091035,Nguyen; Truong Quang,9999,0,9999,0
1653424830228,ECE 200,034,091036,Nomura; Kenji,9999,0,9999,0
1653424830228,ECE 200,035,091037,Orlitsky; Alon,9999,0,9999,0
1653424830228,ECE 200,036,091038,Pal; Piya,9999,0,9999,0
1653424830228,ECE 200,037,091039,Papen; George C.,9999,0,9999,0
1653424830228,ECE 200,038,091040,Radic; Stojan,9999,0,9999,0
1653424830228,ECE 200,039,091041,Rao; Bhaskar D.,9999,0,9999,0
1653424830228,ECE 200,040,091042,Rao; Ramesh R,9999,0,9999,0
1653424830228,ECE 200,041,091043,Rebeiz; Gabriel,9999,0,9999,0
1653424830228,ECE 200,042,091044,Sanford; John R,9999,0,9999,0
1653424830228,ECE 200,043,091045,Siegel; Paul H.,9999,0,9999,0
1653424830228,ECE 200,044,091046,Sievenpiper; Daniel F.,9999,0,9999,0
1653424830228,ECE 200,045,091047,Sworder; David D.,9999,0,9999,0
1653424830228,ECE 200,046,091048,Taur; Yuan,9999,0,9999,0
1653424830228,ECE 200,047,091049,Touri; Behrouz,9999,0,9999,0
1653424830228,ECE 200,048,091050,Trivedi; Mohan M.,9999,0,9999,0
1653424830228,ECE 200,049,091051,Vardy; Alexander,9999,0,9999,0
1653424830228,ECE 200,050,091052,Vasconcelos; Nuno,9999,0,9999,0
1653424830228,ECE 200,051,091053,Wang; Xiaolong,9999,0,9999,0
1653424830228,ECE 200,052,091054,Xie; Pengtao,9999,0,9999,0
1653424830228,ECE 200,053,091055,Yip; Michael,9999,0,9999,0
1653424830228,ECE 200,054,091056,Zeger; Kenneth A.,9999,0,9999,0
1653424830228,ECE 200,055,091057,Zhang; Xinyu,9999,0,9999,0
1653424830228,ECE 200,056,091058,Turakhia; Yatish Girish,9999,0,9999,0
1653424830228,ECE 200,057,091059,Kang; Mingu,9999,0,9999,0
1653424830228,ECE 200,058,091060,Shi; Yuanyuan,9999,0,9999,0
1653424830228,ECE 200,059,091061,Wang; Edward Jay,9999,0,9999,0
1653424830228,ECE 200,060,091062,Zheng; Yang,9999,0,9999,0
1653424830758,ECE 203,A00,091065,Mercier; Patrick Philip,0,0,0,0
1653424831295,ECE 207A,A00,091605,Liu; Thomas Tao-Ming,0,0,0,0
1653424831841,ECE 212AN,A00,091068,Nomura; Kenji,0,0,0,0
1653424832391,ECE 222A,A00,091069,Rebeiz; Gabriel,0,0,0,0
1653424832916,ECE 225A,A00,091070,Orlitsky; Alon,0,0,0,0
1653424833449,ECE 230A,A00,091071,Nomura; Kenji,0,0,0,0
1653424833988,ECE 236A,A00,091072,Dayeh; Shadi Ahmad,0,0,0,0
1653424834520,ECE 238A,A00,091073,Luo; Jian,0,0,0,0
1653424834520,ECE 238A,B00,091074,Luo; Jian,0,0,0,0
1653424835048,ECE 240A,A00,091075,Radic; Stojan,0,0,0,0
1653424835571,ECE 247A,A00,091592,Shi; Lingyan,0,0,0,0
1653424836111,ECE 250,A00,091076,Touri; Behrouz,0,0,0,0
1653424836637,ECE 251C,A00,091078,Nguyen; Truong Quang,0,0,0,0
1653424837174,ECE 253,A00,091079,Cosman; Pamela C.,0,0,0,0
1653424837706,ECE 255A,A00,091080,Orlitsky; Alon,0,0,0,0
1653424838243,ECE 257A,A00,091081,Zhang; Xinyu,0,0,0,0
1653424838783,ECE 260A,A01,091084,Eldon; John,0,0,0,0
1653424839321,ECE 264C,A00,091085,Galton; Ian A,0,0,0,0
1653424839853,ECE 265C,A00,094889,Presti; Calogero Davide,0,0,0,9
1653424840401,ECE 266,A01,091087,Hall; Drew A.,0,0,0,0
1653424841455,ECE 271A,A00,091090,Vasconcelos; Nuno,0,0,0,0
1653424841984,ECE 272B,A00,091091,Sworder; David D.,0,0,0,0
1653424842512,ECE 275A,A00,091092,Meyer; Florian,0,0,0,0
1653424843188,ECE 277,A00,091093,An; Cheolhong,0,0,0,0
1653424843724,ECE 283,A00,091094,Le; Hanh-Phuc,0,0,0,0
1653424844254,ECE 284,A00,091095,Kang; Mingu,0,0,0,0
1653424844254,ECE 284,B00,091096,Wang; Edward Jay,0,0,0,0
1653424844813,ECE 285,A00,094334,Touri; Behrouz,0,0,0,0
1653424845343,ECE 289,A00,091097,Whelan; David Arthur,0,0,0,0
1653424845889,MATH 200A,A00,087414,Salehi Golsefidy; Alireza,7,0,8,1
1653424846415,MATH 202A,A00,087415,Gill; Philip E.,3,0,8,5
1653424846947,MATH 203A,A00,087416,Oprea; Dragos N.,6,0,8,2
1653424847470,MATH 204A,A00,087417,Kedlaya; Kiran S.,6,0,8,2
1653424848009,MATH 205,A00,087418,Sorensen; Claus M,6,0,8,2
1653424848533,MATH 206A,A00,087419,Izadi; Elham,7,0,8,1
1653424849076,MATH 207A,A00,087420,Mohammadi; Amir,6,0,8,2
1653424849605,MATH 208,A00,087421,Staff,9,0,10,1
1653424850136,MATH 209,A00,087422,Staff,10,0,10,0
1653424850659,MATH 218,A00,087423,Staff,10,0,10,0
1653424851195,MATH 220A,A00,087424,Novak; Jonathan I,7,0,8,1
1653424851720,MATH 231A,A00,087425,Bejenaru; Ioan,4,0,8,4
1653424852254,MATH 240A,A00,087426,Ebenfelt; Peter F,5,0,8,3
1653424852777,MATH 243,A00,087427,Staff,9,0,10,1
1653424853303,MATH 248,A00,087429,Staff,10,0,10,0
1653424853842,MATH 250A,A00,087430,Spolaor; Luca,5,0,8,3
1653424854384,MATH 257A,A00,087431,Spolaor; Luca,7,0,8,1
1653424854907,MATH 258,A00,087432,Staff,9,0,10,1
1653424855443,MATH 264A,A00,087433,Warnke; Lutz Peter,5,0,8,3
1653424856045,MATH 268,A00,087434,Staff,15,0,15,0
1653424856573,MATH 269,A00,087435,Staff,14,0,15,1
1653424857102,MATH 270A,A00,087436,Nie; Jiawang,0,0,8,8
1653424857631,MATH 272A,A00,087437,Tian; Xiaochuan,2,0,8,6
1653424858170,MATH 274,A01,087439,Cheng; Li-Tien,9,0,10,1
1653424858170,MATH 274,A02,087440,Cheng; Li-Tien,10,0,10,0
1653424858696,MATH 278A,A00,087441,Staff,8,0,10,2
1653424859218,MATH 278B,A00,087442,Staff,8,0,10,2
1653424859751,MATH 278C,A00,087443,Staff,8,0,10,2
1653424860272,MATH 280A,A00,087444,Zheng; Tianyi,0,0,8,8
1653424860813,MATH 281A,A00,087445,Bradic; Jelena,0,0,8,8
1653424861367,MATH 282A,A00,087446,Zhang; Danna,0,0,8,8
1653424861892,MATH 283,A00,087447,Tesler; Glenn,0,0,0,14
1653424862434,MATH 286,A00,087448,Kemp; Todd Aahron,6,0,8,2
1653424862957,MATH 287D,A00,087449,Bradic; Jelena,8,0,8,0
1653424863480,MATH 288,A00,087450,Staff,14,0,15,1
1653424863480,MATH 288,B00,087451,Staff,15,0,15,0
1653424863480,MATH 288,C00,087452,Staff,15,0,15,0
1653424864011,MATH 290A,A00,087453,Xu; Zhouli,7,0,8,1
1653424864535,MATH 291A,A00,087454,Xu; Zhouli,7,0,8,1
1653424865065,MATH 292,A00,087455,Staff,10,0,10,0
1653424865597,MATH 295,A00,087456,Staff,50,0,50,0
1653424866118,MATH 297,001,087457,Staff,998,0,999,1
1653425431872,COGS 200,A01,087991,Staff,47,0,50,3
1653425432394,COGS 201,A01,094504,Rangel; Lara M,17,0,25,8
1653425432916,COGS 203,A00,087992,Coulson; Seana M,18,0,20,2
1653425433445,COGS 210A,001,087993,Greene; Deanna Jacquelyn,9998,0,9999,1
1653425433445,COGS 210A,002,087994,Saygin; Ayse P,9999,0,9999,0
1653425433445,COGS 210A,003,087995,Xia; Haijun,9999,0,9999,0
1653425433445,COGS 210A,004,087996,Nitz; Douglas A.,9999,0,9999,0
1653425433445,COGS 210A,005,087997,Hollan; James D.,9999,0,9999,0
1653425433445,COGS 210A,006,087998,Deak; Gedeon O.,9998,0,9999,1
1653425433445,COGS 210A,007,087999,Rossano; Federico,9999,0,9999,0
1653425433990,COGS 211A,A00,088000,Coulson; Seana M,9997,0,9999,2
1653425434515,COGS 229,A00,088002,Staff,23,0,25,2
1653425435060,COGS 260,B00,094231,Staff,17,0,20,3
1653425435060,COGS 260,A00,088004,Nitz; Douglas A.,9998,0,9999,1
1653425435583,CSE 202,A00,090110,Paturi; Ramamohan,0,0,0,0
1653425435583,CSE 202,B00,090111,Paturi; Ramamohan,0,0,0,0
1653425436124,CSE 207B,A00,090112,Heninger; Nadia A,0,0,0,0
1653425436673,CSE 208,A00,094858,Micciancio; Daniele,0,0,0,0
1653425437204,CSE 210,A00,090113,Powell; Thomas Allan,0,0,0,0
1653425437734,CSE 219,A00,090898,Staff,0,0,0,0
1653425438279,CSE 221,A00,090114,Zhou; Yuan-Yuan,0,0,0,0
1653425438821,CSE 229A,A00,090115,Porter; George M,0,0,0,0
1653425439349,CSE 229C,A00,090116,Savage; Stefan,0,0,0,0
1653425439882,CSE 230,A00,090117,Jhala; Ranjit,0,0,0,0
1653425440428,CSE 232,A00,090118,Papakonstantinou; Yannis,0,0,0,0
1653425440955,CSE 239A,A00,090121,Kumar; Arun Kumar,0,0,0,0
1653425441487,CSE 239B,A00,090122,Jhala; Ranjit,0,0,0,0
1653425442009,CSE 240A,A00,090123,Zhao; Jishen,0,0,189,189
1653425442536,CSE 243A,A00,090124,Orailoglu; Alex,3,0,15,12
1653425443061,CSE 249B,A00,090125,Kahng; Andrew Byun,13,0,20,7
1653425443588,CSE 250A,A00,090126,Berg-Kirkpatrick; Taylor D,0,0,0,0
1653425444121,CSE 252A,A00,090127,Ochoa; Benjamin Lawrence,0,0,0,0
1653425444644,CSE 258,A01,090129,McAuley; Julian John,0,0,0,0
1653425445197,CSE 258R,A01,090131,McAuley; Julian John,0,0,0,0
1653425445719,CSE 274,A00,090132,Ramamoorthi; Ravi,0,0,0,0
1653425446245,CSE 276A,A00,090133,Christensen; Henrik I,0,0,0,0
1653425446768,CSE 276C,A00,090134,Christensen; Henrik I,0,0,0,0
1653425447300,CSE 290,A00,090135,Bafna; Vineet,0,0,0,0
1653425447300,CSE 290,B00,090136,Ramamoorthi; Ravi,0,0,0,0
1653425447300,CSE 290,C00,090137,Li; Tzumao,9,0,10,1
1653425447300,CSE 290,D00,090138,Zhou; Yuan-Yuan,10,0,10,0
1653425447300,CSE 290,E00,090139,Christensen; Henrik I,10,0,10,0
1653425447300,CSE 290,F00,094053,Shalev; Aaron D,0,0,0,0
1653425447833,CSE 291,A00,090140,Munyaka; Imani N. S.,0,0,0,0
1653425447833,CSE 291,B00,094880,Yu; Qi,0,0,0,0
1653425447833,CSE 291,C00,090142,Pannuto; Patrick William,0,0,0,0
1653425447833,CSE 291,D00,094881,Zhang; Yiying,0,0,0,0
1653425447833,CSE 291,E00,095118,Su; Hao,0,0,0,0
1653425448365,CSE 293,001,094905,Bafna; Vineet,9999,0,9999,0
1653425448365,CSE 293,002,094906,Bellare; Mihir,9999,0,9999,0
1653425448365,CSE 293,003,094907,Berg-Kirkpatrick; Taylor D,9999,0,9999,0
1653425448365,CSE 293,004,094908,Christensen; Henrik I,9999,0,9999,0
1653425448365,CSE 293,005,094909,Cottrell; Garrison W,9999,0,9999,0
1653425448365,CSE 293,006,094910,Deutsch; Alin Bernard,9999,0,9999,0
1653425448365,CSE 293,007,094911,Esmaeilzadeh; Hadi,9999,0,9999,0
1653425448365,CSE 293,008,094912,Freund; Yoav,9999,0,9999,0
1653425448365,CSE 293,009,094913,Griswold; William G.,9999,0,9999,0
1653425448365,CSE 293,010,094914,Gymrek; Melissa Ann,9999,0,9999,0
1653425448365,CSE 293,011,094915,Heninger; Nadia A,9999,0,9999,0
1653425448365,CSE 293,012,094916,Impagliazzo; Russell,9999,0,9999,0
1653425448365,CSE 293,013,094917,Jhala; Ranjit,9999,0,9999,0
1653425448365,CSE 293,014,094918,Kahng; Andrew Byun,9999,0,9999,0
1653425448365,CSE 293,015,094919,Kane; Daniel Mertz,9999,0,9999,0
1653425448365,CSE 293,016,094920,Kriegman; David J,9999,0,9999,0
1653425448365,CSE 293,017,094921,Kumar; Arun Kumar,9999,0,9999,0
1653425448365,CSE 293,018,094922,Lerner; Sorin,9999,0,9999,0
1653425448365,CSE 293,019,094923,Lovett; Shachar,9999,0,9999,0
1653425448365,CSE 293,020,094924,McAuley; Julian John,9999,0,9999,0
1653425448365,CSE 293,021,094925,Micciancio; Daniele,9999,0,9999,0
1653425448365,CSE 293,022,094926,Orailoglu; Alex,9999,0,9999,0
1653425448365,CSE 293,023,094927,Paturi; Ramamohan,9999,0,9999,0
1653425448365,CSE 293,024,094928,Polikarpova; Nadezhda,9999,0,9999,0
1653425448365,CSE 293,025,094929,Politz; Joseph Gibbs,9999,0,9999,0
1653425448365,CSE 293,026,094930,Porter; George M,9999,0,9999,0
1653425448365,CSE 293,027,094931,Porter; Leonard Emerson,9999,0,9999,0
1653425448365,CSE 293,028,094932,Ramamoorthi; Ravi,9999,0,9999,0
1653425448365,CSE 293,029,094933,Sahoo; Debashis,9999,0,9999,0
1653425448365,CSE 293,030,094934,Saul; Lawrence,9999,0,9999,0
1653425448365,CSE 293,031,094935,Savage; Stefan,9999,0,9999,0
1653425448365,CSE 293,032,094936,Schulze; Jurgen P.,9999,0,9999,0
1653425448365,CSE 293,033,094937,Snoeren; Alex C.,9999,0,9999,0
1653425448365,CSE 293,034,094938,Shang; Jingbo,9999,0,9999,0
1653425448365,CSE 293,035,094939,Stefan; Deian,9999,0,9999,0
1653425448365,CSE 293,036,094940,Su; Hao,9999,0,9999,0
1653425448365,CSE 293,037,094941,Swanson; Steven James,9999,0,9999,0
1653425448365,CSE 293,038,094942,Tullsen; Dean Michael,9999,0,9999,0
1653425448365,CSE 293,039,094943,Voelker; Geoffrey M.,9999,0,9999,0
1653425448365,CSE 293,040,094944,Zhao; Jishen,9999,0,9999,0
1653425448365,CSE 293,041,094945,Zhou; Yuan-Yuan,9999,0,9999,0
1653425448365,CSE 293,042,094946,Gao; Sicun,9998,0,9999,1
1653425448365,CSE 293,043,094947,Weibel; Nadir,9999,0,9999,0
1653425448365,CSE 293,044,094948,Gupta; Rajesh K.,9999,0,9999,0
1653425448888,CSE 294,A00,090143,Porter; George M,9,0,10,1
1653425449423,DSE 200,A00,091799,Staff,50,0,50,0
1653425449946,DSE 203,A00,091800,Gupta; Amarnath,30,0,30,0
1653425450485,DSE 250,A00,091801,Deutsch; Alin Bernard,30,0,30,0
1653425451011,DSE 290,A00,091802,Altintas De Callaf; Ilkay,50,0,50,0
1653425451537,ECE 200,001,091003,Antipa; Nicholas A,9999,0,9999,0
1653425451537,ECE 200,002,091004,Atanasov; Nikolay A.,9999,0,9999,0
1653425451537,ECE 200,003,091005,Bharadia; Dinesh,9999,0,9999,0
1653425451537,ECE 200,004,091006,Cheng; Chung Kuan,9999,0,9999,0
1653425451537,ECE 200,005,091007,Cosman; Pamela C.,9999,0,9999,0
1653425451537,ECE 200,006,091008,Staff,9999,0,9999,0
1653425451537,ECE 200,007,091009,Dayeh; Shadi Ahmad,9999,0,9999,0
1653425451537,ECE 200,008,091010,Fainman; Yeshaiahu,9999,0,9999,0
1653425451537,ECE 200,009,091011,Ford; Joseph Earl,9999,0,9999,0
1653425451537,ECE 200,010,091012,Franceschetti; Massimo,9999,0,9999,0
1653425451537,ECE 200,011,091013,Fullerton; Eric E,9999,0,9999,0
1653425451537,ECE 200,012,091014,Galton; Ian A,9999,0,9999,0
1653425451537,ECE 200,013,091015,Gilja; Vikash,9999,0,9999,0
1653425451537,ECE 200,014,091016,Hall; Drew A.,9999,0,9999,0
1653425451537,ECE 200,015,091017,Hsueh; Tzu-Chien,9999,0,9999,0
1653425451537,ECE 200,016,091018,Javidi; Tara,9999,0,9999,0
1653425451537,ECE 200,017,091019,Kahng; Andrew Byun,9999,0,9999,0
1653425451537,ECE 200,018,091020,Kim; Young-Han,9999,0,9999,0
1653425451537,ECE 200,019,091021,Koushanfar; Farinaz,9999,0,9999,0
1653425451537,ECE 200,020,091022,Kuzum; Duygu,9999,0,9999,0
1653425451537,ECE 200,021,091023,Le; Hanh-Phuc,9999,0,9999,0
1653425451537,ECE 200,022,091024,Lin; Bill,9999,0,9999,0
1653425451537,ECE 200,023,091025,Liu; Zhaowei,9999,0,9999,0
1653425451537,ECE 200,024,091026,Lo; Yu-Hwa,9999,0,9999,0
1653425451537,ECE 200,025,091027,Lomakin; Vitaliy,9999,0,9999,0
1653425451537,ECE 200,026,091028,Mercier; Patrick Philip,9999,0,9999,0
1653425451537,ECE 200,027,091029,Meyer; Florian,9999,0,9999,0
1653425451537,ECE 200,028,091030,Milstein; Laurence B.,9999,0,9999,0
1653425451537,ECE 200,029,091031,Mir Arabbaygi; Siavash,9999,0,9999,0
1653425451537,ECE 200,030,091032,Mookherjea; Shayan,9999,0,9999,0
1653425451537,ECE 200,031,091033,Morris; Karcher William,9999,0,9999,0
1653425451537,ECE 200,032,091034,Ng; Tse Nga,9999,0,9999,0
1653425451537,ECE 200,033,091035,Nguyen; Truong Quang,9999,0,9999,0
1653425451537,ECE 200,034,091036,Nomura; Kenji,9999,0,9999,0
1653425451537,ECE 200,035,091037,Orlitsky; Alon,9999,0,9999,0
1653425451537,ECE 200,036,091038,Pal; Piya,9999,0,9999,0
1653425451537,ECE 200,037,091039,Papen; George C.,9999,0,9999,0
1653425451537,ECE 200,038,091040,Radic; Stojan,9999,0,9999,0
1653425451537,ECE 200,039,091041,Rao; Bhaskar D.,9999,0,9999,0
1653425451537,ECE 200,040,091042,Rao; Ramesh R,9999,0,9999,0
1653425451537,ECE 200,041,091043,Rebeiz; Gabriel,9999,0,9999,0
1653425451537,ECE 200,042,091044,Sanford; John R,9999,0,9999,0
1653425451537,ECE 200,043,091045,Siegel; Paul H.,9999,0,9999,0
1653425451537,ECE 200,044,091046,Sievenpiper; Daniel F.,9999,0,9999,0
1653425451537,ECE 200,045,091047,Sworder; David D.,9999,0,9999,0
1653425451537,ECE 200,046,091048,Taur; Yuan,9999,0,9999,0
1653425451537,ECE 200,047,091049,Touri; Behrouz,9999,0,9999,0
1653425451537,ECE 200,048,091050,Trivedi; Mohan M.,9999,0,9999,0
1653425451537,ECE 200,049,091051,Vardy; Alexander,9999,0,9999,0
1653425451537,ECE 200,050,091052,Vasconcelos; Nuno,9999,0,9999,0
1653425451537,ECE 200,051,091053,Wang; Xiaolong,9999,0,9999,0
1653425451537,ECE 200,052,091054,Xie; Pengtao,9999,0,9999,0
1653425451537,ECE 200,053,091055,Yip; Michael,9999,0,9999,0
1653425451537,ECE 200,054,091056,Zeger; Kenneth A.,9999,0,9999,0
1653425451537,ECE 200,055,091057,Zhang; Xinyu,9999,0,9999,0
1653425451537,ECE 200,056,091058,Turakhia; Yatish Girish,9999,0,9999,0
1653425451537,ECE 200,057,091059,Kang; Mingu,9999,0,9999,0
1653425451537,ECE 200,058,091060,Shi; Yuanyuan,9999,0,9999,0
1653425451537,ECE 200,059,091061,Wang; Edward Jay,9999,0,9999,0
1653425451537,ECE 200,060,091062,Zheng; Yang,9999,0,9999,0
1653425452076,ECE 203,A00,091065,Mercier; Patrick Philip,0,0,0,0
1653425452597,ECE 207A,A00,091605,Liu; Thomas Tao-Ming,0,0,0,0
1653425453129,ECE 212AN,A00,091068,Nomura; Kenji,0,0,0,0
1653425453654,ECE 222A,A00,091069,Rebeiz; Gabriel,0,0,0,0
1653425454181,ECE 225A,A00,091070,Orlitsky; Alon,0,0,0,0
1653425454713,ECE 230A,A00,091071,Nomura; Kenji,0,0,0,0
1653425455241,ECE 236A,A00,091072,Dayeh; Shadi Ahmad,0,0,0,0
1653425455776,ECE 238A,A00,091073,Luo; Jian,0,0,0,0
1653425455776,ECE 238A,B00,091074,Luo; Jian,0,0,0,0
1653425456327,ECE 240A,A00,091075,Radic; Stojan,0,0,0,0
1653425456854,ECE 247A,A00,091592,Shi; Lingyan,0,0,0,0
1653425457377,ECE 250,A00,091076,Touri; Behrouz,0,0,0,0
1653425457907,ECE 251C,A00,091078,Nguyen; Truong Quang,0,0,0,0
1653425458442,ECE 253,A00,091079,Cosman; Pamela C.,0,0,0,0
1653425458970,ECE 255A,A00,091080,Orlitsky; Alon,0,0,0,0
1653425459501,ECE 257A,A00,091081,Zhang; Xinyu,0,0,0,0
1653425460026,ECE 260A,A01,091084,Eldon; John,0,0,0,0
1653425460561,ECE 264C,A00,091085,Galton; Ian A,0,0,0,0
1653425461096,ECE 265C,A00,094889,Presti; Calogero Davide,0,0,0,9
1653425461626,ECE 266,A01,091087,Hall; Drew A.,0,0,0,0
1653425462881,ECE 271A,A00,091090,Vasconcelos; Nuno,0,0,0,0
1653425463420,ECE 272B,A00,091091,Sworder; David D.,0,0,0,0
1653425463949,ECE 275A,A00,091092,Meyer; Florian,0,0,0,0
1653425464492,ECE 277,A00,091093,An; Cheolhong,0,0,0,0
1653425465025,ECE 283,A00,091094,Le; Hanh-Phuc,0,0,0,0
1653425465557,ECE 284,A00,091095,Kang; Mingu,0,0,0,0
1653425465557,ECE 284,B00,091096,Wang; Edward Jay,0,0,0,0
1653425466163,ECE 285,A00,094334,Touri; Behrouz,0,0,0,0
1653425466734,ECE 289,A00,091097,Whelan; David Arthur,0,0,0,0
1653425467269,MATH 200A,A00,087414,Salehi Golsefidy; Alireza,7,0,8,1
1653425467799,MATH 202A,A00,087415,Gill; Philip E.,3,0,8,5
1653425468337,MATH 203A,A00,087416,Oprea; Dragos N.,6,0,8,2
1653425468873,MATH 204A,A00,087417,Kedlaya; Kiran S.,6,0,8,2
1653425469499,MATH 205,A00,087418,Sorensen; Claus M,6,0,8,2
1653425470035,MATH 206A,A00,087419,Izadi; Elham,7,0,8,1
1653425470570,MATH 207A,A00,087420,Mohammadi; Amir,6,0,8,2
1653425471094,MATH 208,A00,087421,Staff,9,0,10,1
1653425471625,MATH 209,A00,087422,Staff,10,0,10,0
1653425472150,MATH 218,A00,087423,Staff,10,0,10,0
1653425472686,MATH 220A,A00,087424,Novak; Jonathan I,7,0,8,1
1653425473218,MATH 231A,A00,087425,Bejenaru; Ioan,4,0,8,4
1653425473753,MATH 240A,A00,087426,Ebenfelt; Peter F,5,0,8,3
1653425474279,MATH 243,A00,087427,Staff,9,0,10,1
1653425474814,MATH 248,A00,087429,Staff,10,0,10,0
1653425475343,MATH 250A,A00,087430,Spolaor; Luca,5,0,8,3
1653425475877,MATH 257A,A00,087431,Spolaor; Luca,7,0,8,1
1653425476415,MATH 258,A00,087432,Staff,9,0,10,1
1653425476950,MATH 264A,A00,087433,Warnke; Lutz Peter,5,0,8,3
1653425477478,MATH 268,A00,087434,Staff,15,0,15,0
1653425478011,MATH 269,A00,087435,Staff,14,0,15,1
1653425478699,MATH 270A,A00,087436,Nie; Jiawang,0,0,8,8
1653425479222,MATH 272A,A00,087437,Tian; Xiaochuan,2,0,8,6
1653425479746,MATH 274,A01,087439,Cheng; Li-Tien,9,0,10,1
1653425479746,MATH 274,A02,087440,Cheng; Li-Tien,10,0,10,0
1653425480269,MATH 278A,A00,087441,Staff,8,0,10,2
1653425480796,MATH 278B,A00,087442,Staff,8,0,10,2
1653425481318,MATH 278C,A00,087443,Staff,8,0,10,2
1653425481849,MATH 280A,A00,087444,Zheng; Tianyi,0,0,8,8
1653425482377,MATH 281A,A00,087445,Bradic; Jelena,0,0,8,8
1653425482906,MATH 282A,A00,087446,Zhang; Danna,0,0,8,8
1653425483443,MATH 283,A00,087447,Tesler; Glenn,0,0,0,14
1653425484140,MATH 286,A00,087448,Kemp; Todd Aahron,6,0,8,2
1653425484670,MATH 287D,A00,087449,Bradic; Jelena,8,0,8,0
1653425485199,MATH 288,A00,087450,Staff,14,0,15,1
1653425485199,MATH 288,B00,087451,Staff,15,0,15,0
1653425485199,MATH 288,C00,087452,Staff,15,0,15,0
1653425485725,MATH 290A,A00,087453,Xu; Zhouli,7,0,8,1
1653425486249,MATH 291A,A00,087454,Xu; Zhouli,7,0,8,1
1653425486782,MATH 292,A00,087455,Staff,10,0,10,0
1653425487322,MATH 295,A00,087456,Staff,50,0,50,0
1653425487847,MATH 297,001,087457,Staff,998,0,999,1
