time,subj_course_id,sec_code,sec_id,prof,available,waitlist,total,enrolled_ct
1653502370517,COGS 200,A01,087991,Staff,47,0,50,3
1653502371039,COGS 201,A01,094504,Rangel; Lara M,17,0,25,8
1653502371563,COGS 203,A00,087992,Coulson; Seana M,18,0,20,2
1653502372095,COGS 210A,001,087993,Greene; Deanna Jacquelyn,9998,0,9999,1
1653502372095,COGS 210A,002,087994,Saygin; Ayse P,9999,0,9999,0
1653502372095,COGS 210A,003,087995,Xia; Haijun,9999,0,9999,0
1653502372095,COGS 210A,004,087996,Nitz; Douglas A.,9999,0,9999,0
1653502372095,COGS 210A,005,087997,Hollan; James D.,9999,0,9999,0
1653502372095,COGS 210A,006,087998,Deak; Gedeon O.,9998,0,9999,1
1653502372095,COGS 210A,007,087999,Rossano; Federico,9999,0,9999,0
1653502372618,COGS 211A,A00,088000,Coulson; Seana M,9997,0,9999,2
1653502373143,COGS 229,A00,088002,Staff,23,0,25,2
1653502373666,COGS 260,B00,094231,Staff,17,0,20,3
1653502373666,COGS 260,A00,088004,Nitz; Douglas A.,9998,0,9999,1
1653502374196,CSE 202,A00,090110,Paturi; Ramamohan,0,0,0,0
1653502374196,CSE 202,B00,090111,Paturi; Ramamohan,0,0,0,0
1653502374734,CSE 207B,A00,090112,Heninger; Nadia A,0,0,0,0
1653502375257,CSE 208,A00,094858,Micciancio; Daniele,0,0,0,0
1653502375780,CSE 210,A00,090113,Powell; Thomas Allan,0,0,0,0
1653502376310,CSE 219,A00,090898,Staff,0,0,0,0
1653502376836,CSE 221,A00,090114,Zhou; Yuan-Yuan,0,0,0,0
1653502377362,CSE 229A,A00,090115,Porter; George M,0,0,0,0
1653502377884,CSE 229C,A00,090116,Savage; Stefan,0,0,0,0
1653502378412,CSE 230,A00,090117,Jhala; Ranjit,0,0,0,0
1653502378935,CSE 232,A00,090118,Papakonstantinou; Yannis,0,0,0,0
1653502379460,CSE 239A,A00,090121,Kumar; Arun Kumar,0,0,0,0
1653502379983,CSE 239B,A00,090122,Jhala; Ranjit,0,0,0,0
1653502380542,CSE 240A,A00,090123,Zhao; Jishen,0,0,189,189
1653502381070,CSE 243A,A00,090124,Orailoglu; Alex,0,0,15,15
1653502381594,CSE 249B,A00,090125,Kahng; Andrew Byun,13,0,20,7
1653502382119,CSE 250A,A00,090126,Berg-Kirkpatrick; Taylor D,0,0,0,0
1653502382643,CSE 252A,A00,090127,Ochoa; Benjamin Lawrence,0,0,0,0
1653502383175,CSE 258,A01,090129,McAuley; Julian John,0,0,0,0
1653502383700,CSE 258R,A01,090131,McAuley; Julian John,0,0,0,0
1653502384226,CSE 274,A00,090132,Ramamoorthi; Ravi,0,0,0,0
1653502384749,CSE 276A,A00,090133,Christensen; Henrik I,0,0,0,0
1653502385275,CSE 276C,A00,090134,Christensen; Henrik I,0,0,0,0
1653502385798,CSE 290,A00,090135,Bafna; Vineet,0,0,0,0
1653502385798,CSE 290,B00,090136,Ramamoorthi; Ravi,0,0,0,0
1653502385798,CSE 290,C00,090137,Li; Tzumao,9,0,10,1
1653502385798,CSE 290,D00,090138,Zhou; Yuan-Yuan,10,0,10,0
1653502385798,CSE 290,E00,090139,Christensen; Henrik I,10,0,10,0
1653502385798,CSE 290,F00,094053,Shalev; Aaron D,0,0,0,0
1653502386328,CSE 291,A00,090140,Munyaka; Imani N. S.,0,0,0,0
1653502386328,CSE 291,B00,094880,Yu; Qi,0,0,0,0
1653502386328,CSE 291,C00,090142,Pannuto; Patrick William,0,0,0,0
1653502386328,CSE 291,D00,094881,Zhang; Yiying,0,0,0,0
1653502386328,CSE 291,E00,095118,Su; Hao,0,0,0,0
1653502386856,CSE 293,001,094905,Bafna; Vineet,9999,0,9999,0
1653502386856,CSE 293,002,094906,Bellare; Mihir,9999,0,9999,0
1653502386856,CSE 293,003,094907,Berg-Kirkpatrick; Taylor D,9999,0,9999,0
1653502386856,CSE 293,004,094908,Christensen; Henrik I,9999,0,9999,0
1653502386856,CSE 293,005,094909,Cottrell; Garrison W,9999,0,9999,0
1653502386856,CSE 293,006,094910,Deutsch; Alin Bernard,9999,0,9999,0
1653502386856,CSE 293,007,094911,Esmaeilzadeh; Hadi,9999,0,9999,0
1653502386856,CSE 293,008,094912,Freund; Yoav,9999,0,9999,0
1653502386856,CSE 293,009,094913,Griswold; William G.,9999,0,9999,0
1653502386856,CSE 293,010,094914,Gymrek; Melissa Ann,9999,0,9999,0
1653502386856,CSE 293,011,094915,Heninger; Nadia A,9999,0,9999,0
1653502386856,CSE 293,012,094916,Impagliazzo; Russell,9999,0,9999,0
1653502386856,CSE 293,013,094917,Jhala; Ranjit,9999,0,9999,0
1653502386856,CSE 293,014,094918,Kahng; Andrew Byun,9999,0,9999,0
1653502386856,CSE 293,015,094919,Kane; Daniel Mertz,9999,0,9999,0
1653502386856,CSE 293,016,094920,Kriegman; David J,9999,0,9999,0
1653502386856,CSE 293,017,094921,Kumar; Arun Kumar,9999,0,9999,0
1653502386856,CSE 293,018,094922,Lerner; Sorin,9999,0,9999,0
1653502386856,CSE 293,019,094923,Lovett; Shachar,9999,0,9999,0
1653502386856,CSE 293,020,094924,McAuley; Julian John,9999,0,9999,0
1653502386856,CSE 293,021,094925,Micciancio; Daniele,9999,0,9999,0
1653502386856,CSE 293,022,094926,Orailoglu; Alex,9999,0,9999,0
1653502386856,CSE 293,023,094927,Paturi; Ramamohan,9999,0,9999,0
1653502386856,CSE 293,024,094928,Polikarpova; Nadezhda,9999,0,9999,0
1653502386856,CSE 293,025,094929,Politz; Joseph Gibbs,9999,0,9999,0
1653502386856,CSE 293,026,094930,Porter; George M,9999,0,9999,0
1653502386856,CSE 293,027,094931,Porter; Leonard Emerson,9999,0,9999,0
1653502386856,CSE 293,028,094932,Ramamoorthi; Ravi,9999,0,9999,0
1653502386856,CSE 293,029,094933,Sahoo; Debashis,9999,0,9999,0
1653502386856,CSE 293,030,094934,Saul; Lawrence,9999,0,9999,0
1653502386856,CSE 293,031,094935,Savage; Stefan,9999,0,9999,0
1653502386856,CSE 293,032,094936,Schulze; Jurgen P.,9999,0,9999,0
1653502386856,CSE 293,033,094937,Snoeren; Alex C.,9999,0,9999,0
1653502386856,CSE 293,034,094938,Shang; Jingbo,9999,0,9999,0
1653502386856,CSE 293,035,094939,Stefan; Deian,9999,0,9999,0
1653502386856,CSE 293,036,094940,Su; Hao,9999,0,9999,0
1653502386856,CSE 293,037,094941,Swanson; Steven James,9999,0,9999,0
1653502386856,CSE 293,038,094942,Tullsen; Dean Michael,9999,0,9999,0
1653502386856,CSE 293,039,094943,Voelker; Geoffrey M.,9999,0,9999,0
1653502386856,CSE 293,040,094944,Zhao; Jishen,9999,0,9999,0
1653502386856,CSE 293,041,094945,Zhou; Yuan-Yuan,9999,0,9999,0
1653502386856,CSE 293,042,094946,Gao; Sicun,9998,0,9999,1
1653502386856,CSE 293,043,094947,Weibel; Nadir,9999,0,9999,0
1653502386856,CSE 293,044,094948,Gupta; Rajesh K.,9999,0,9999,0
1653502387381,CSE 294,A00,090143,Porter; George M,9,0,10,1
1653502387907,DSE 200,A00,091799,Staff,50,0,50,0
1653502388430,DSE 203,A00,091800,Gupta; Amarnath,30,0,30,0
1653502388962,DSE 250,A00,091801,Deutsch; Alin Bernard,30,0,30,0
1653502389490,DSE 290,A00,091802,Altintas De Callaf; Ilkay,50,0,50,0
1653502390044,ECE 200,001,091003,Antipa; Nicholas A,9999,0,9999,0
1653502390044,ECE 200,002,091004,Atanasov; Nikolay A.,9999,0,9999,0
1653502390044,ECE 200,003,091005,Bharadia; Dinesh,9999,0,9999,0
1653502390044,ECE 200,004,091006,Cheng; Chung Kuan,9999,0,9999,0
1653502390044,ECE 200,005,091007,Cosman; Pamela C.,9999,0,9999,0
1653502390044,ECE 200,006,091008,Staff,9999,0,9999,0
1653502390044,ECE 200,007,091009,Dayeh; Shadi Ahmad,9999,0,9999,0
1653502390044,ECE 200,008,091010,Fainman; Yeshaiahu,9999,0,9999,0
1653502390044,ECE 200,009,091011,Ford; Joseph Earl,9999,0,9999,0
1653502390044,ECE 200,010,091012,Franceschetti; Massimo,9999,0,9999,0
1653502390044,ECE 200,011,091013,Fullerton; Eric E,9999,0,9999,0
1653502390044,ECE 200,012,091014,Galton; Ian A,9999,0,9999,0
1653502390044,ECE 200,013,091015,Gilja; Vikash,9999,0,9999,0
1653502390044,ECE 200,014,091016,Hall; Drew A.,9999,0,9999,0
1653502390044,ECE 200,015,091017,Hsueh; Tzu-Chien,9999,0,9999,0
1653502390044,ECE 200,016,091018,Javidi; Tara,9999,0,9999,0
1653502390044,ECE 200,017,091019,Kahng; Andrew Byun,9999,0,9999,0
1653502390044,ECE 200,018,091020,Kim; Young-Han,9999,0,9999,0
1653502390044,ECE 200,019,091021,Koushanfar; Farinaz,9999,0,9999,0
1653502390044,ECE 200,020,091022,Kuzum; Duygu,9999,0,9999,0
1653502390044,ECE 200,021,091023,Le; Hanh-Phuc,9999,0,9999,0
1653502390044,ECE 200,022,091024,Lin; Bill,9999,0,9999,0
1653502390044,ECE 200,023,091025,Liu; Zhaowei,9999,0,9999,0
1653502390044,ECE 200,024,091026,Lo; Yu-Hwa,9999,0,9999,0
1653502390044,ECE 200,025,091027,Lomakin; Vitaliy,9999,0,9999,0
1653502390044,ECE 200,026,091028,Mercier; Patrick Philip,9999,0,9999,0
1653502390044,ECE 200,027,091029,Meyer; Florian,9999,0,9999,0
1653502390044,ECE 200,028,091030,Milstein; Laurence B.,9999,0,9999,0
1653502390044,ECE 200,029,091031,Mir Arabbaygi; Siavash,9999,0,9999,0
1653502390044,ECE 200,030,091032,Mookherjea; Shayan,9999,0,9999,0
1653502390044,ECE 200,031,091033,Morris; Karcher William,9999,0,9999,0
1653502390044,ECE 200,032,091034,Ng; Tse Nga,9999,0,9999,0
1653502390044,ECE 200,033,091035,Nguyen; Truong Quang,9999,0,9999,0
1653502390044,ECE 200,034,091036,Nomura; Kenji,9999,0,9999,0
1653502390044,ECE 200,035,091037,Orlitsky; Alon,9999,0,9999,0
1653502390044,ECE 200,036,091038,Pal; Piya,9999,0,9999,0
1653502390044,ECE 200,037,091039,Papen; George C.,9999,0,9999,0
1653502390044,ECE 200,038,091040,Radic; Stojan,9999,0,9999,0
1653502390044,ECE 200,039,091041,Rao; Bhaskar D.,9999,0,9999,0
1653502390044,ECE 200,040,091042,Rao; Ramesh R,9999,0,9999,0
1653502390044,ECE 200,041,091043,Rebeiz; Gabriel,9999,0,9999,0
1653502390044,ECE 200,042,091044,Sanford; John R,9999,0,9999,0
1653502390044,ECE 200,043,091045,Siegel; Paul H.,9999,0,9999,0
1653502390044,ECE 200,044,091046,Sievenpiper; Daniel F.,9999,0,9999,0
1653502390044,ECE 200,045,091047,Sworder; David D.,9999,0,9999,0
1653502390044,ECE 200,046,091048,Taur; Yuan,9999,0,9999,0
1653502390044,ECE 200,047,091049,Touri; Behrouz,9999,0,9999,0
1653502390044,ECE 200,048,091050,Trivedi; Mohan M.,9999,0,9999,0
1653502390044,ECE 200,049,091051,Vardy; Alexander,9999,0,9999,0
1653502390044,ECE 200,050,091052,Vasconcelos; Nuno,9999,0,9999,0
1653502390044,ECE 200,051,091053,Wang; Xiaolong,9999,0,9999,0
1653502390044,ECE 200,052,091054,Xie; Pengtao,9999,0,9999,0
1653502390044,ECE 200,053,091055,Yip; Michael,9999,0,9999,0
1653502390044,ECE 200,054,091056,Zeger; Kenneth A.,9999,0,9999,0
1653502390044,ECE 200,055,091057,Zhang; Xinyu,9999,0,9999,0
1653502390044,ECE 200,056,091058,Turakhia; Yatish Girish,9999,0,9999,0
1653502390044,ECE 200,057,091059,Kang; Mingu,9999,0,9999,0
1653502390044,ECE 200,058,091060,Shi; Yuanyuan,9999,0,9999,0
1653502390044,ECE 200,059,091061,Wang; Edward Jay,9999,0,9999,0
1653502390044,ECE 200,060,091062,Zheng; Yang,9999,0,9999,0
1653502390571,ECE 201,A00,095526,Lo; Yu-Hwa,50,0,50,0
1653502391097,ECE 203,A00,091065,Mercier; Patrick Philip,0,0,0,0
1653502391626,ECE 207A,A00,091605,Liu; Thomas Tao-Ming,0,0,0,0
1653502392169,ECE 212AN,A00,091068,Nomura; Kenji,0,0,0,0
1653502392693,ECE 222A,A00,091069,Rebeiz; Gabriel,0,0,0,0
1653502393231,ECE 225A,A00,091070,Orlitsky; Alon,0,0,0,0
1653502393753,ECE 230A,A00,091071,Nomura; Kenji,0,0,0,0
1653502394278,ECE 236A,A00,091072,Dayeh; Shadi Ahmad,0,0,0,0
1653502394802,ECE 238A,A00,091073,Luo; Jian,0,0,0,0
1653502394802,ECE 238A,B00,091074,Luo; Jian,0,0,0,0
1653502395326,ECE 240A,A00,091075,Radic; Stojan,0,0,0,0
1653502395856,ECE 247A,A00,091592,Shi; Lingyan,0,0,0,0
1653502396384,ECE 250,A00,091076,Touri; Behrouz,0,0,0,0
1653502397163,ECE 251C,A00,091078,Nguyen; Truong Quang,0,0,0,0
1653502397747,ECE 253,A00,091079,Cosman; Pamela C.,0,0,0,0
1653502398271,ECE 255A,A00,091080,Orlitsky; Alon,0,0,0,0
1653502398804,ECE 257A,A00,091081,Zhang; Xinyu,0,0,0,0
1653502399332,ECE 260A,A01,091084,Eldon; John,0,0,0,0
1653502399862,ECE 264C,A00,091085,Galton; Ian A,0,0,0,0
1653502400390,ECE 265C,A00,094889,Presti; Calogero Davide,0,0,0,9
1653502400921,ECE 266,A01,091087,Hall; Drew A.,0,0,0,0
1653502401971,ECE 271A,A00,091090,Vasconcelos; Nuno,0,0,0,0
1653502402501,ECE 272B,A00,091091,Sworder; David D.,0,0,0,0
1653502403029,ECE 275A,A00,091092,Meyer; Florian,0,0,0,0
1653502403556,ECE 277,A00,091093,An; Cheolhong,0,0,0,0
1653502404080,ECE 283,A00,091094,Le; Hanh-Phuc,0,0,0,0
1653502404616,ECE 284,A00,091095,Kang; Mingu,0,0,0,0
1653502404616,ECE 284,B00,091096,Wang; Edward Jay,0,0,0,0
1653502405140,ECE 285,A00,094334,Touri; Behrouz,0,0,0,0
1653502405677,ECE 289,A00,091097,Whelan; David Arthur,0,0,0,0
1653502406200,MATH 200A,A00,087414,Salehi Golsefidy; Alireza,7,0,8,1
1653502406733,MATH 202A,A00,087415,Gill; Philip E.,3,0,8,5
1653502407276,MATH 203A,A00,087416,Oprea; Dragos N.,6,0,8,2
1653502407806,MATH 204A,A00,087417,Kedlaya; Kiran S.,6,0,8,2
1653502408334,MATH 205,A00,087418,Sorensen; Claus M,6,0,8,2
1653502408857,MATH 206A,A00,087419,Izadi; Elham,7,0,8,1
1653502409390,MATH 207A,A00,087420,Mohammadi; Amir,5,0,8,3
1653502409917,MATH 208,A00,087421,Staff,9,0,10,1
1653502410446,MATH 209,A00,087422,Staff,10,0,10,0
1653502410969,MATH 218,A00,087423,Staff,10,0,10,0
1653502411498,MATH 220A,A00,087424,Novak; Jonathan I,7,0,8,1
1653502412031,MATH 231A,A00,087425,Bejenaru; Ioan,3,0,8,5
1653502412555,MATH 240A,A00,087426,Ebenfelt; Peter F,5,0,8,3
1653502413090,MATH 243,A00,087427,Staff,9,0,10,1
1653502413624,MATH 248,A00,087429,Staff,10,0,10,0
1653502414152,MATH 250A,A00,087430,Spolaor; Luca,4,0,8,4
1653502414677,MATH 257A,A00,087431,Spolaor; Luca,7,0,8,1
1653502415201,MATH 258,A00,087432,Staff,9,0,10,1
1653502415725,MATH 264A,A00,087433,Warnke; Lutz Peter,5,0,8,3
1653502416271,MATH 268,A00,087434,Staff,15,0,15,0
1653502416805,MATH 269,A00,087435,Staff,14,0,15,1
1653502417329,MATH 270A,A00,087436,Nie; Jiawang,0,0,8,8
1653502417862,MATH 272A,A00,087437,Tian; Xiaochuan,1,0,8,7
1653502418395,MATH 274,A01,087439,Cheng; Li-Tien,9,0,10,1
1653502418395,MATH 274,A02,087440,Cheng; Li-Tien,10,0,10,0
1653502418923,MATH 278A,A00,087441,Staff,8,0,10,2
1653502419470,MATH 278B,A00,087442,Staff,8,0,10,2
1653502419994,MATH 278C,A00,087443,Staff,8,0,10,2
1653502420522,MATH 280A,A00,087444,Zheng; Tianyi,0,0,8,8
1653502421049,MATH 281A,A00,087445,Bradic; Jelena,0,0,8,8
1653502421578,MATH 282A,A00,087446,Zhang; Danna,0,0,8,8
1653502422101,MATH 283,A00,087447,Tesler; Glenn,0,0,0,14
1653502422644,MATH 286,A00,087448,Kemp; Todd Aahron,5,0,8,3
1653502423173,MATH 287D,A00,087449,Bradic; Jelena,8,0,8,0
1653502423695,MATH 288,A00,087450,Staff,14,0,15,1
1653502423695,MATH 288,B00,087451,Staff,15,0,15,0
1653502423695,MATH 288,C00,087452,Staff,15,0,15,0
1653502424218,MATH 290A,A00,087453,Xu; Zhouli,6,0,8,2
1653502424748,MATH 291A,A00,087454,Xu; Zhouli,7,0,8,1
1653502425284,MATH 292,A00,087455,Staff,10,0,10,0
1653502425809,MATH 295,A00,087456,Staff,50,0,50,0
1653502426331,MATH 297,001,087457,Staff,998,0,999,1
1653502999465,COGS 200,A01,087991,Staff,47,0,50,3
1653502999987,COGS 201,A01,094504,Rangel; Lara M,17,0,25,8
1653503000520,COGS 203,A00,087992,Coulson; Seana M,18,0,20,2
1653503001065,COGS 210A,001,087993,Greene; Deanna Jacquelyn,9998,0,9999,1
1653503001065,COGS 210A,002,087994,Saygin; Ayse P,9999,0,9999,0
1653503001065,COGS 210A,003,087995,Xia; Haijun,9999,0,9999,0
1653503001065,COGS 210A,004,087996,Nitz; Douglas A.,9999,0,9999,0
1653503001065,COGS 210A,005,087997,Hollan; James D.,9999,0,9999,0
1653503001065,COGS 210A,006,087998,Deak; Gedeon O.,9998,0,9999,1
1653503001065,COGS 210A,007,087999,Rossano; Federico,9999,0,9999,0
1653503001589,COGS 211A,A00,088000,Coulson; Seana M,9997,0,9999,2
1653503002114,COGS 229,A00,088002,Staff,23,0,25,2
1653503002641,COGS 260,B00,094231,Staff,17,0,20,3
1653503002641,COGS 260,A00,088004,Nitz; Douglas A.,9998,0,9999,1
1653503003164,CSE 202,A00,090110,Paturi; Ramamohan,0,0,0,0
1653503003164,CSE 202,B00,090111,Paturi; Ramamohan,0,0,0,0
1653503003691,CSE 207B,A00,090112,Heninger; Nadia A,0,0,0,0
1653503004213,CSE 208,A00,094858,Micciancio; Daniele,0,0,0,0
1653503004741,CSE 210,A00,090113,Powell; Thomas Allan,0,0,0,0
1653503005272,CSE 219,A00,090898,Staff,0,0,0,0
1653503005800,CSE 221,A00,090114,Zhou; Yuan-Yuan,0,0,0,0
1653503006324,CSE 229A,A00,090115,Porter; George M,0,0,0,0
1653503006848,CSE 229C,A00,090116,Savage; Stefan,0,0,0,0
1653503007385,CSE 230,A00,090117,Jhala; Ranjit,0,0,0,0
1653503007910,CSE 232,A00,090118,Papakonstantinou; Yannis,0,0,0,0
1653503008434,CSE 239A,A00,090121,Kumar; Arun Kumar,0,0,0,0
1653503008955,CSE 239B,A00,090122,Jhala; Ranjit,0,0,0,0
1653503009478,CSE 240A,A00,090123,Zhao; Jishen,0,0,189,189
1653503010001,CSE 243A,A00,090124,Orailoglu; Alex,0,0,15,15
1653503010529,CSE 249B,A00,090125,Kahng; Andrew Byun,13,0,20,7
1653503011054,CSE 250A,A00,090126,Berg-Kirkpatrick; Taylor D,0,0,0,0
1653503011580,CSE 252A,A00,090127,Ochoa; Benjamin Lawrence,0,0,0,0
1653503012110,CSE 258,A01,090129,McAuley; Julian John,0,0,0,0
1653503012644,CSE 258R,A01,090131,McAuley; Julian John,0,0,0,0
1653503013169,CSE 274,A00,090132,Ramamoorthi; Ravi,0,0,0,0
1653503013693,CSE 276A,A00,090133,Christensen; Henrik I,0,0,0,0
1653503014219,CSE 276C,A00,090134,Christensen; Henrik I,0,0,0,0
1653503014745,CSE 290,A00,090135,Bafna; Vineet,0,0,0,0
1653503014745,CSE 290,B00,090136,Ramamoorthi; Ravi,0,0,0,0
1653503014745,CSE 290,C00,090137,Li; Tzumao,9,0,10,1
1653503014745,CSE 290,D00,090138,Zhou; Yuan-Yuan,10,0,10,0
1653503014745,CSE 290,E00,090139,Christensen; Henrik I,10,0,10,0
1653503014745,CSE 290,F00,094053,Shalev; Aaron D,0,0,0,0
1653503015277,CSE 291,A00,090140,Munyaka; Imani N. S.,0,0,0,0
1653503015277,CSE 291,B00,094880,Yu; Qi,0,0,0,0
1653503015277,CSE 291,C00,090142,Pannuto; Patrick William,0,0,0,0
1653503015277,CSE 291,D00,094881,Zhang; Yiying,0,0,0,0
1653503015277,CSE 291,E00,095118,Su; Hao,0,0,0,0
1653503015804,CSE 293,001,094905,Bafna; Vineet,9999,0,9999,0
1653503015804,CSE 293,002,094906,Bellare; Mihir,9999,0,9999,0
1653503015804,CSE 293,003,094907,Berg-Kirkpatrick; Taylor D,9999,0,9999,0
1653503015804,CSE 293,004,094908,Christensen; Henrik I,9999,0,9999,0
1653503015804,CSE 293,005,094909,Cottrell; Garrison W,9999,0,9999,0
1653503015804,CSE 293,006,094910,Deutsch; Alin Bernard,9999,0,9999,0
1653503015804,CSE 293,007,094911,Esmaeilzadeh; Hadi,9999,0,9999,0
1653503015804,CSE 293,008,094912,Freund; Yoav,9999,0,9999,0
1653503015804,CSE 293,009,094913,Griswold; William G.,9999,0,9999,0
1653503015804,CSE 293,010,094914,Gymrek; Melissa Ann,9999,0,9999,0
1653503015804,CSE 293,011,094915,Heninger; Nadia A,9999,0,9999,0
1653503015804,CSE 293,012,094916,Impagliazzo; Russell,9999,0,9999,0
1653503015804,CSE 293,013,094917,Jhala; Ranjit,9999,0,9999,0
1653503015804,CSE 293,014,094918,Kahng; Andrew Byun,9999,0,9999,0
1653503015804,CSE 293,015,094919,Kane; Daniel Mertz,9999,0,9999,0
1653503015804,CSE 293,016,094920,Kriegman; David J,9999,0,9999,0
1653503015804,CSE 293,017,094921,Kumar; Arun Kumar,9999,0,9999,0
1653503015804,CSE 293,018,094922,Lerner; Sorin,9999,0,9999,0
1653503015804,CSE 293,019,094923,Lovett; Shachar,9999,0,9999,0
1653503015804,CSE 293,020,094924,McAuley; Julian John,9999,0,9999,0
1653503015804,CSE 293,021,094925,Micciancio; Daniele,9999,0,9999,0
1653503015804,CSE 293,022,094926,Orailoglu; Alex,9999,0,9999,0
1653503015804,CSE 293,023,094927,Paturi; Ramamohan,9999,0,9999,0
1653503015804,CSE 293,024,094928,Polikarpova; Nadezhda,9999,0,9999,0
1653503015804,CSE 293,025,094929,Politz; Joseph Gibbs,9999,0,9999,0
1653503015804,CSE 293,026,094930,Porter; George M,9999,0,9999,0
1653503015804,CSE 293,027,094931,Porter; Leonard Emerson,9999,0,9999,0
1653503015804,CSE 293,028,094932,Ramamoorthi; Ravi,9999,0,9999,0
1653503015804,CSE 293,029,094933,Sahoo; Debashis,9999,0,9999,0
1653503015804,CSE 293,030,094934,Saul; Lawrence,9999,0,9999,0
1653503015804,CSE 293,031,094935,Savage; Stefan,9999,0,9999,0
1653503015804,CSE 293,032,094936,Schulze; Jurgen P.,9999,0,9999,0
1653503015804,CSE 293,033,094937,Snoeren; Alex C.,9999,0,9999,0
1653503015804,CSE 293,034,094938,Shang; Jingbo,9999,0,9999,0
1653503015804,CSE 293,035,094939,Stefan; Deian,9999,0,9999,0
1653503015804,CSE 293,036,094940,Su; Hao,9999,0,9999,0
1653503015804,CSE 293,037,094941,Swanson; Steven James,9999,0,9999,0
1653503015804,CSE 293,038,094942,Tullsen; Dean Michael,9999,0,9999,0
1653503015804,CSE 293,039,094943,Voelker; Geoffrey M.,9999,0,9999,0
1653503015804,CSE 293,040,094944,Zhao; Jishen,9999,0,9999,0
1653503015804,CSE 293,041,094945,Zhou; Yuan-Yuan,9999,0,9999,0
1653503015804,CSE 293,042,094946,Gao; Sicun,9998,0,9999,1
1653503015804,CSE 293,043,094947,Weibel; Nadir,9999,0,9999,0
1653503015804,CSE 293,044,094948,Gupta; Rajesh K.,9999,0,9999,0
1653503016335,CSE 294,A00,090143,Porter; George M,9,0,10,1
1653503016876,DSE 200,A00,091799,Staff,50,0,50,0
1653503017399,DSE 203,A00,091800,Gupta; Amarnath,30,0,30,0
1653503017926,DSE 250,A00,091801,Deutsch; Alin Bernard,30,0,30,0
1653503018457,DSE 290,A00,091802,Altintas De Callaf; Ilkay,50,0,50,0
1653503019020,ECE 200,001,091003,Antipa; Nicholas A,9999,0,9999,0
1653503019020,ECE 200,002,091004,Atanasov; Nikolay A.,9999,0,9999,0
1653503019020,ECE 200,003,091005,Bharadia; Dinesh,9999,0,9999,0
1653503019020,ECE 200,004,091006,Cheng; Chung Kuan,9999,0,9999,0
1653503019020,ECE 200,005,091007,Cosman; Pamela C.,9999,0,9999,0
1653503019020,ECE 200,006,091008,Staff,9999,0,9999,0
1653503019020,ECE 200,007,091009,Dayeh; Shadi Ahmad,9999,0,9999,0
1653503019020,ECE 200,008,091010,Fainman; Yeshaiahu,9999,0,9999,0
1653503019020,ECE 200,009,091011,Ford; Joseph Earl,9999,0,9999,0
1653503019020,ECE 200,010,091012,Franceschetti; Massimo,9999,0,9999,0
1653503019020,ECE 200,011,091013,Fullerton; Eric E,9999,0,9999,0
1653503019020,ECE 200,012,091014,Galton; Ian A,9999,0,9999,0
1653503019020,ECE 200,013,091015,Gilja; Vikash,9999,0,9999,0
1653503019020,ECE 200,014,091016,Hall; Drew A.,9999,0,9999,0
1653503019020,ECE 200,015,091017,Hsueh; Tzu-Chien,9999,0,9999,0
1653503019020,ECE 200,016,091018,Javidi; Tara,9999,0,9999,0
1653503019020,ECE 200,017,091019,Kahng; Andrew Byun,9999,0,9999,0
1653503019020,ECE 200,018,091020,Kim; Young-Han,9999,0,9999,0
1653503019020,ECE 200,019,091021,Koushanfar; Farinaz,9999,0,9999,0
1653503019020,ECE 200,020,091022,Kuzum; Duygu,9999,0,9999,0
1653503019020,ECE 200,021,091023,Le; Hanh-Phuc,9999,0,9999,0
1653503019020,ECE 200,022,091024,Lin; Bill,9999,0,9999,0
1653503019020,ECE 200,023,091025,Liu; Zhaowei,9999,0,9999,0
1653503019020,ECE 200,024,091026,Lo; Yu-Hwa,9999,0,9999,0
1653503019020,ECE 200,025,091027,Lomakin; Vitaliy,9999,0,9999,0
1653503019020,ECE 200,026,091028,Mercier; Patrick Philip,9999,0,9999,0
1653503019020,ECE 200,027,091029,Meyer; Florian,9999,0,9999,0
1653503019020,ECE 200,028,091030,Milstein; Laurence B.,9999,0,9999,0
1653503019020,ECE 200,029,091031,Mir Arabbaygi; Siavash,9999,0,9999,0
1653503019020,ECE 200,030,091032,Mookherjea; Shayan,9999,0,9999,0
1653503019020,ECE 200,031,091033,Morris; Karcher William,9999,0,9999,0
1653503019020,ECE 200,032,091034,Ng; Tse Nga,9999,0,9999,0
1653503019020,ECE 200,033,091035,Nguyen; Truong Quang,9999,0,9999,0
1653503019020,ECE 200,034,091036,Nomura; Kenji,9999,0,9999,0
1653503019020,ECE 200,035,091037,Orlitsky; Alon,9999,0,9999,0
1653503019020,ECE 200,036,091038,Pal; Piya,9999,0,9999,0
1653503019020,ECE 200,037,091039,Papen; George C.,9999,0,9999,0
1653503019020,ECE 200,038,091040,Radic; Stojan,9999,0,9999,0
1653503019020,ECE 200,039,091041,Rao; Bhaskar D.,9999,0,9999,0
1653503019020,ECE 200,040,091042,Rao; Ramesh R,9999,0,9999,0
1653503019020,ECE 200,041,091043,Rebeiz; Gabriel,9999,0,9999,0
1653503019020,ECE 200,042,091044,Sanford; John R,9999,0,9999,0
1653503019020,ECE 200,043,091045,Siegel; Paul H.,9999,0,9999,0
1653503019020,ECE 200,044,091046,Sievenpiper; Daniel F.,9999,0,9999,0
1653503019020,ECE 200,045,091047,Sworder; David D.,9999,0,9999,0
1653503019020,ECE 200,046,091048,Taur; Yuan,9999,0,9999,0
1653503019020,ECE 200,047,091049,Touri; Behrouz,9999,0,9999,0
1653503019020,ECE 200,048,091050,Trivedi; Mohan M.,9999,0,9999,0
1653503019020,ECE 200,049,091051,Vardy; Alexander,9999,0,9999,0
1653503019020,ECE 200,050,091052,Vasconcelos; Nuno,9999,0,9999,0
1653503019020,ECE 200,051,091053,Wang; Xiaolong,9999,0,9999,0
1653503019020,ECE 200,052,091054,Xie; Pengtao,9999,0,9999,0
1653503019020,ECE 200,053,091055,Yip; Michael,9999,0,9999,0
1653503019020,ECE 200,054,091056,Zeger; Kenneth A.,9999,0,9999,0
1653503019020,ECE 200,055,091057,Zhang; Xinyu,9999,0,9999,0
1653503019020,ECE 200,056,091058,Turakhia; Yatish Girish,9999,0,9999,0
1653503019020,ECE 200,057,091059,Kang; Mingu,9999,0,9999,0
1653503019020,ECE 200,058,091060,Shi; Yuanyuan,9999,0,9999,0
1653503019020,ECE 200,059,091061,Wang; Edward Jay,9999,0,9999,0
1653503019020,ECE 200,060,091062,Zheng; Yang,9999,0,9999,0
1653503019556,ECE 201,A00,095526,Lo; Yu-Hwa,50,0,50,0
1653503020094,ECE 203,A00,091065,Mercier; Patrick Philip,0,0,0,0
1653503020632,ECE 207A,A00,091605,Liu; Thomas Tao-Ming,0,0,0,0
1653503021155,ECE 212AN,A00,091068,Nomura; Kenji,0,0,0,0
1653503021678,ECE 222A,A00,091069,Rebeiz; Gabriel,0,0,0,0
1653503022200,ECE 225A,A00,091070,Orlitsky; Alon,0,0,0,0
1653503022729,ECE 230A,A00,091071,Nomura; Kenji,0,0,0,0
1653503023264,ECE 236A,A00,091072,Dayeh; Shadi Ahmad,0,0,0,0
1653503023788,ECE 238A,A00,091073,Luo; Jian,0,0,0,0
1653503023788,ECE 238A,B00,091074,Luo; Jian,0,0,0,0
1653503024317,ECE 240A,A00,091075,Radic; Stojan,0,0,0,0
1653503024846,ECE 247A,A00,091592,Shi; Lingyan,0,0,0,0
1653503025369,ECE 250,A00,091076,Touri; Behrouz,0,0,0,0
1653503025896,ECE 251C,A00,091078,Nguyen; Truong Quang,0,0,0,0
1653503026424,ECE 253,A00,091079,Cosman; Pamela C.,0,0,0,0
1653503026949,ECE 255A,A00,091080,Orlitsky; Alon,0,0,0,0
1653503027473,ECE 257A,A00,091081,Zhang; Xinyu,0,0,0,0
1653503028012,ECE 260A,A01,091084,Eldon; John,0,0,0,0
1653503028534,ECE 264C,A00,091085,Galton; Ian A,0,0,0,0
1653503029063,ECE 265C,A00,094889,Presti; Calogero Davide,0,0,0,9
1653503029591,ECE 266,A01,091087,Hall; Drew A.,0,0,0,0
1653503030662,ECE 271A,A00,091090,Vasconcelos; Nuno,0,0,0,0
1653503031184,ECE 272B,A00,091091,Sworder; David D.,0,0,0,0
1653503031706,ECE 275A,A00,091092,Meyer; Florian,0,0,0,0
1653503032232,ECE 277,A00,091093,An; Cheolhong,0,0,0,0
1653503032760,ECE 283,A00,091094,Le; Hanh-Phuc,0,0,0,0
1653503033289,ECE 284,A00,091095,Kang; Mingu,0,0,0,0
1653503033289,ECE 284,B00,091096,Wang; Edward Jay,0,0,0,0
1653503033822,ECE 285,A00,094334,Touri; Behrouz,0,0,0,0
1653503034343,ECE 289,A00,091097,Whelan; David Arthur,0,0,0,0
1653503034877,MATH 200A,A00,087414,Salehi Golsefidy; Alireza,7,0,8,1
1653503035399,MATH 202A,A00,087415,Gill; Philip E.,3,0,8,5
1653503035920,MATH 203A,A00,087416,Oprea; Dragos N.,6,0,8,2
1653503036443,MATH 204A,A00,087417,Kedlaya; Kiran S.,6,0,8,2
1653503036969,MATH 205,A00,087418,Sorensen; Claus M,6,0,8,2
1653503037498,MATH 206A,A00,087419,Izadi; Elham,7,0,8,1
1653503038036,MATH 207A,A00,087420,Mohammadi; Amir,5,0,8,3
1653503038561,MATH 208,A00,087421,Staff,9,0,10,1
1653503039087,MATH 209,A00,087422,Staff,10,0,10,0
1653503039622,MATH 218,A00,087423,Staff,10,0,10,0
1653503040160,MATH 220A,A00,087424,Novak; Jonathan I,7,0,8,1
1653503040691,MATH 231A,A00,087425,Bejenaru; Ioan,3,0,8,5
1653503041219,MATH 240A,A00,087426,Ebenfelt; Peter F,5,0,8,3
1653503041743,MATH 243,A00,087427,Staff,9,0,10,1
1653503042266,MATH 248,A00,087429,Staff,10,0,10,0
1653503042795,MATH 250A,A00,087430,Spolaor; Luca,4,0,8,4
1653503043320,MATH 257A,A00,087431,Spolaor; Luca,7,0,8,1
1653503043848,MATH 258,A00,087432,Staff,9,0,10,1
1653503044375,MATH 264A,A00,087433,Warnke; Lutz Peter,5,0,8,3
1653503044897,MATH 268,A00,087434,Staff,15,0,15,0
1653503045422,MATH 269,A00,087435,Staff,14,0,15,1
1653503045947,MATH 270A,A00,087436,Nie; Jiawang,0,0,8,8
1653503046478,MATH 272A,A00,087437,Tian; Xiaochuan,1,0,8,7
1653503047004,MATH 274,A01,087439,Cheng; Li-Tien,9,0,10,1
1653503047004,MATH 274,A02,087440,Cheng; Li-Tien,10,0,10,0
1653503047528,MATH 278A,A00,087441,Staff,8,0,10,2
1653503048051,MATH 278B,A00,087442,Staff,8,0,10,2
1653503048584,MATH 278C,A00,087443,Staff,8,0,10,2
1653503049108,MATH 280A,A00,087444,Zheng; Tianyi,0,0,8,8
1653503049647,MATH 281A,A00,087445,Bradic; Jelena,0,0,8,8
1653503050169,MATH 282A,A00,087446,Zhang; Danna,0,0,8,8
1653503050694,MATH 283,A00,087447,Tesler; Glenn,0,0,0,14
1653503051314,MATH 286,A00,087448,Kemp; Todd Aahron,5,0,8,3
1653503051838,MATH 287D,A00,087449,Bradic; Jelena,8,0,8,0
1653503052360,MATH 288,A00,087450,Staff,14,0,15,1
1653503052360,MATH 288,B00,087451,Staff,15,0,15,0
1653503052360,MATH 288,C00,087452,Staff,15,0,15,0
1653503052882,MATH 290A,A00,087453,Xu; Zhouli,6,0,8,2
1653503053408,MATH 291A,A00,087454,Xu; Zhouli,7,0,8,1
1653503053944,MATH 292,A00,087455,Staff,10,0,10,0
1653503054466,MATH 295,A00,087456,Staff,50,0,50,0
1653503054988,MATH 297,001,087457,Staff,998,0,999,1
1653503619801,COGS 200,A01,087991,Staff,47,0,50,3
1653503620327,COGS 201,A01,094504,Rangel; Lara M,17,0,25,8
1653503620851,COGS 203,A00,087992,Coulson; Seana M,18,0,20,2
1653503621381,COGS 210A,001,087993,Greene; Deanna Jacquelyn,9998,0,9999,1
1653503621381,COGS 210A,002,087994,Saygin; Ayse P,9999,0,9999,0
1653503621381,COGS 210A,003,087995,Xia; Haijun,9999,0,9999,0
1653503621381,COGS 210A,004,087996,Nitz; Douglas A.,9999,0,9999,0
1653503621381,COGS 210A,005,087997,Hollan; James D.,9999,0,9999,0
1653503621381,COGS 210A,006,087998,Deak; Gedeon O.,9998,0,9999,1
1653503621381,COGS 210A,007,087999,Rossano; Federico,9999,0,9999,0
1653503621905,COGS 211A,A00,088000,Coulson; Seana M,9997,0,9999,2
1653503622442,COGS 229,A00,088002,Staff,23,0,25,2
1653503622988,COGS 260,B00,094231,Staff,17,0,20,3
1653503622988,COGS 260,A00,088004,Nitz; Douglas A.,9998,0,9999,1
1653503623513,CSE 202,A00,090110,Paturi; Ramamohan,0,0,0,0
1653503623513,CSE 202,B00,090111,Paturi; Ramamohan,0,0,0,0
1653503624061,CSE 207B,A00,090112,Heninger; Nadia A,0,0,0,0
1653503624587,CSE 208,A00,094858,Micciancio; Daniele,0,0,0,0
1653503625115,CSE 210,A00,090113,Powell; Thomas Allan,0,0,0,0
1653503625642,CSE 219,A00,090898,Staff,0,0,0,0
1653503626165,CSE 221,A00,090114,Zhou; Yuan-Yuan,0,0,0,0
1653503626689,CSE 229A,A00,090115,Porter; George M,0,0,0,0
1653503627218,CSE 229C,A00,090116,Savage; Stefan,0,0,0,0
1653503627746,CSE 230,A00,090117,Jhala; Ranjit,0,0,0,0
1653503628281,CSE 232,A00,090118,Papakonstantinou; Yannis,0,0,0,0
1653503628817,CSE 239A,A00,090121,Kumar; Arun Kumar,0,0,0,0
1653503629341,CSE 239B,A00,090122,Jhala; Ranjit,0,0,0,0
1653503629867,CSE 240A,A00,090123,Zhao; Jishen,0,0,189,189
1653503630403,CSE 243A,A00,090124,Orailoglu; Alex,0,0,15,15
1653503630927,CSE 249B,A00,090125,Kahng; Andrew Byun,13,0,20,7
1653503631449,CSE 250A,A00,090126,Berg-Kirkpatrick; Taylor D,0,0,0,0
1653503631972,CSE 252A,A00,090127,Ochoa; Benjamin Lawrence,0,0,0,0
1653503632494,CSE 258,A01,090129,McAuley; Julian John,0,0,0,0
1653503633016,CSE 258R,A01,090131,McAuley; Julian John,0,0,0,0
1653503633539,CSE 274,A00,090132,Ramamoorthi; Ravi,0,0,0,0
1653503634064,CSE 276A,A00,090133,Christensen; Henrik I,0,0,0,0
1653503634593,CSE 276C,A00,090134,Christensen; Henrik I,0,0,0,0
1653503635122,CSE 290,A00,090135,Bafna; Vineet,0,0,0,0
1653503635122,CSE 290,B00,090136,Ramamoorthi; Ravi,0,0,0,0
1653503635122,CSE 290,C00,090137,Li; Tzumao,9,0,10,1
1653503635122,CSE 290,D00,090138,Zhou; Yuan-Yuan,10,0,10,0
1653503635122,CSE 290,E00,090139,Christensen; Henrik I,10,0,10,0
1653503635122,CSE 290,F00,094053,Shalev; Aaron D,0,0,0,0
1653503635652,CSE 291,A00,090140,Munyaka; Imani N. S.,0,0,0,0
1653503635652,CSE 291,B00,094880,Yu; Qi,0,0,0,0
1653503635652,CSE 291,C00,090142,Pannuto; Patrick William,0,0,0,0
1653503635652,CSE 291,D00,094881,Zhang; Yiying,0,0,0,0
1653503635652,CSE 291,E00,095118,Su; Hao,0,0,0,0
1653503636189,CSE 293,001,094905,Bafna; Vineet,9999,0,9999,0
1653503636189,CSE 293,002,094906,Bellare; Mihir,9999,0,9999,0
1653503636189,CSE 293,003,094907,Berg-Kirkpatrick; Taylor D,9999,0,9999,0
1653503636189,CSE 293,004,094908,Christensen; Henrik I,9999,0,9999,0
1653503636189,CSE 293,005,094909,Cottrell; Garrison W,9999,0,9999,0
1653503636189,CSE 293,006,094910,Deutsch; Alin Bernard,9999,0,9999,0
1653503636189,CSE 293,007,094911,Esmaeilzadeh; Hadi,9999,0,9999,0
1653503636189,CSE 293,008,094912,Freund; Yoav,9999,0,9999,0
1653503636189,CSE 293,009,094913,Griswold; William G.,9999,0,9999,0
1653503636189,CSE 293,010,094914,Gymrek; Melissa Ann,9999,0,9999,0
1653503636189,CSE 293,011,094915,Heninger; Nadia A,9999,0,9999,0
1653503636189,CSE 293,012,094916,Impagliazzo; Russell,9999,0,9999,0
1653503636189,CSE 293,013,094917,Jhala; Ranjit,9999,0,9999,0
1653503636189,CSE 293,014,094918,Kahng; Andrew Byun,9999,0,9999,0
1653503636189,CSE 293,015,094919,Kane; Daniel Mertz,9999,0,9999,0
1653503636189,CSE 293,016,094920,Kriegman; David J,9999,0,9999,0
1653503636189,CSE 293,017,094921,Kumar; Arun Kumar,9999,0,9999,0
1653503636189,CSE 293,018,094922,Lerner; Sorin,9999,0,9999,0
1653503636189,CSE 293,019,094923,Lovett; Shachar,9999,0,9999,0
1653503636189,CSE 293,020,094924,McAuley; Julian John,9999,0,9999,0
1653503636189,CSE 293,021,094925,Micciancio; Daniele,9999,0,9999,0
1653503636189,CSE 293,022,094926,Orailoglu; Alex,9999,0,9999,0
1653503636189,CSE 293,023,094927,Paturi; Ramamohan,9999,0,9999,0
1653503636189,CSE 293,024,094928,Polikarpova; Nadezhda,9999,0,9999,0
1653503636189,CSE 293,025,094929,Politz; Joseph Gibbs,9999,0,9999,0
1653503636189,CSE 293,026,094930,Porter; George M,9999,0,9999,0
1653503636189,CSE 293,027,094931,Porter; Leonard Emerson,9999,0,9999,0
1653503636189,CSE 293,028,094932,Ramamoorthi; Ravi,9999,0,9999,0
1653503636189,CSE 293,029,094933,Sahoo; Debashis,9999,0,9999,0
1653503636189,CSE 293,030,094934,Saul; Lawrence,9999,0,9999,0
1653503636189,CSE 293,031,094935,Savage; Stefan,9999,0,9999,0
1653503636189,CSE 293,032,094936,Schulze; Jurgen P.,9999,0,9999,0
1653503636189,CSE 293,033,094937,Snoeren; Alex C.,9999,0,9999,0
1653503636189,CSE 293,034,094938,Shang; Jingbo,9999,0,9999,0
1653503636189,CSE 293,035,094939,Stefan; Deian,9999,0,9999,0
1653503636189,CSE 293,036,094940,Su; Hao,9999,0,9999,0
1653503636189,CSE 293,037,094941,Swanson; Steven James,9999,0,9999,0
1653503636189,CSE 293,038,094942,Tullsen; Dean Michael,9999,0,9999,0
1653503636189,CSE 293,039,094943,Voelker; Geoffrey M.,9999,0,9999,0
1653503636189,CSE 293,040,094944,Zhao; Jishen,9999,0,9999,0
1653503636189,CSE 293,041,094945,Zhou; Yuan-Yuan,9999,0,9999,0
1653503636189,CSE 293,042,094946,Gao; Sicun,9998,0,9999,1
1653503636189,CSE 293,043,094947,Weibel; Nadir,9999,0,9999,0
1653503636189,CSE 293,044,094948,Gupta; Rajesh K.,9999,0,9999,0
1653503636729,CSE 294,A00,090143,Porter; George M,9,0,10,1
1653503637254,DSE 200,A00,091799,Staff,50,0,50,0
1653503637776,DSE 203,A00,091800,Gupta; Amarnath,30,0,30,0
1653503638301,DSE 250,A00,091801,Deutsch; Alin Bernard,30,0,30,0
1653503638833,DSE 290,A00,091802,Altintas De Callaf; Ilkay,50,0,50,0
1653503639398,ECE 200,001,091003,Antipa; Nicholas A,9999,0,9999,0
1653503639398,ECE 200,002,091004,Atanasov; Nikolay A.,9999,0,9999,0
1653503639398,ECE 200,003,091005,Bharadia; Dinesh,9999,0,9999,0
1653503639398,ECE 200,004,091006,Cheng; Chung Kuan,9999,0,9999,0
1653503639398,ECE 200,005,091007,Cosman; Pamela C.,9999,0,9999,0
1653503639398,ECE 200,006,091008,Staff,9999,0,9999,0
1653503639398,ECE 200,007,091009,Dayeh; Shadi Ahmad,9999,0,9999,0
1653503639398,ECE 200,008,091010,Fainman; Yeshaiahu,9999,0,9999,0
1653503639398,ECE 200,009,091011,Ford; Joseph Earl,9999,0,9999,0
1653503639398,ECE 200,010,091012,Franceschetti; Massimo,9999,0,9999,0
1653503639398,ECE 200,011,091013,Fullerton; Eric E,9999,0,9999,0
1653503639398,ECE 200,012,091014,Galton; Ian A,9999,0,9999,0
1653503639398,ECE 200,013,091015,Gilja; Vikash,9999,0,9999,0
1653503639398,ECE 200,014,091016,Hall; Drew A.,9999,0,9999,0
1653503639398,ECE 200,015,091017,Hsueh; Tzu-Chien,9999,0,9999,0
1653503639398,ECE 200,016,091018,Javidi; Tara,9999,0,9999,0
1653503639398,ECE 200,017,091019,Kahng; Andrew Byun,9999,0,9999,0
1653503639398,ECE 200,018,091020,Kim; Young-Han,9999,0,9999,0
1653503639398,ECE 200,019,091021,Koushanfar; Farinaz,9999,0,9999,0
1653503639398,ECE 200,020,091022,Kuzum; Duygu,9999,0,9999,0
1653503639398,ECE 200,021,091023,Le; Hanh-Phuc,9999,0,9999,0
1653503639398,ECE 200,022,091024,Lin; Bill,9999,0,9999,0
1653503639398,ECE 200,023,091025,Liu; Zhaowei,9999,0,9999,0
1653503639398,ECE 200,024,091026,Lo; Yu-Hwa,9999,0,9999,0
1653503639398,ECE 200,025,091027,Lomakin; Vitaliy,9999,0,9999,0
1653503639398,ECE 200,026,091028,Mercier; Patrick Philip,9999,0,9999,0
1653503639398,ECE 200,027,091029,Meyer; Florian,9999,0,9999,0
1653503639398,ECE 200,028,091030,Milstein; Laurence B.,9999,0,9999,0
1653503639398,ECE 200,029,091031,Mir Arabbaygi; Siavash,9999,0,9999,0
1653503639398,ECE 200,030,091032,Mookherjea; Shayan,9999,0,9999,0
1653503639398,ECE 200,031,091033,Morris; Karcher William,9999,0,9999,0
1653503639398,ECE 200,032,091034,Ng; Tse Nga,9999,0,9999,0
1653503639398,ECE 200,033,091035,Nguyen; Truong Quang,9999,0,9999,0
1653503639398,ECE 200,034,091036,Nomura; Kenji,9999,0,9999,0
1653503639398,ECE 200,035,091037,Orlitsky; Alon,9999,0,9999,0
1653503639398,ECE 200,036,091038,Pal; Piya,9999,0,9999,0
1653503639398,ECE 200,037,091039,Papen; George C.,9999,0,9999,0
1653503639398,ECE 200,038,091040,Radic; Stojan,9999,0,9999,0
1653503639398,ECE 200,039,091041,Rao; Bhaskar D.,9999,0,9999,0
1653503639398,ECE 200,040,091042,Rao; Ramesh R,9999,0,9999,0
1653503639398,ECE 200,041,091043,Rebeiz; Gabriel,9999,0,9999,0
1653503639398,ECE 200,042,091044,Sanford; John R,9999,0,9999,0
1653503639398,ECE 200,043,091045,Siegel; Paul H.,9999,0,9999,0
1653503639398,ECE 200,044,091046,Sievenpiper; Daniel F.,9999,0,9999,0
1653503639398,ECE 200,045,091047,Sworder; David D.,9999,0,9999,0
1653503639398,ECE 200,046,091048,Taur; Yuan,9999,0,9999,0
1653503639398,ECE 200,047,091049,Touri; Behrouz,9999,0,9999,0
1653503639398,ECE 200,048,091050,Trivedi; Mohan M.,9999,0,9999,0
1653503639398,ECE 200,049,091051,Vardy; Alexander,9999,0,9999,0
1653503639398,ECE 200,050,091052,Vasconcelos; Nuno,9999,0,9999,0
1653503639398,ECE 200,051,091053,Wang; Xiaolong,9999,0,9999,0
1653503639398,ECE 200,052,091054,Xie; Pengtao,9999,0,9999,0
1653503639398,ECE 200,053,091055,Yip; Michael,9999,0,9999,0
1653503639398,ECE 200,054,091056,Zeger; Kenneth A.,9999,0,9999,0
1653503639398,ECE 200,055,091057,Zhang; Xinyu,9999,0,9999,0
1653503639398,ECE 200,056,091058,Turakhia; Yatish Girish,9999,0,9999,0
1653503639398,ECE 200,057,091059,Kang; Mingu,9999,0,9999,0
1653503639398,ECE 200,058,091060,Shi; Yuanyuan,9999,0,9999,0
1653503639398,ECE 200,059,091061,Wang; Edward Jay,9999,0,9999,0
1653503639398,ECE 200,060,091062,Zheng; Yang,9999,0,9999,0
1653503639923,ECE 201,A00,095526,Lo; Yu-Hwa,50,0,50,0
1653503640451,ECE 203,A00,091065,Mercier; Patrick Philip,0,0,0,0
1653503640979,ECE 207A,A00,091605,Liu; Thomas Tao-Ming,0,0,0,0
1653503641503,ECE 212AN,A00,091068,Nomura; Kenji,0,0,0,0
1653503642026,ECE 222A,A00,091069,Rebeiz; Gabriel,0,0,0,0
1653503642550,ECE 225A,A00,091070,Orlitsky; Alon,0,0,0,0
1653503643076,ECE 230A,A00,091071,Nomura; Kenji,0,0,0,0
1653503643689,ECE 236A,A00,091072,Dayeh; Shadi Ahmad,0,0,0,0
1653503644225,ECE 238A,A00,091073,Luo; Jian,0,0,0,0
1653503644225,ECE 238A,B00,091074,Luo; Jian,0,0,0,0
1653503644750,ECE 240A,A00,091075,Radic; Stojan,0,0,0,0
1653503645285,ECE 247A,A00,091592,Shi; Lingyan,0,0,0,0
1653503645814,ECE 250,A00,091076,Touri; Behrouz,0,0,0,0
1653503646337,ECE 251C,A00,091078,Nguyen; Truong Quang,0,0,0,0
1653503646862,ECE 253,A00,091079,Cosman; Pamela C.,0,0,0,0
1653503647391,ECE 255A,A00,091080,Orlitsky; Alon,0,0,0,0
1653503647915,ECE 257A,A00,091081,Zhang; Xinyu,0,0,0,0
1653503648453,ECE 260A,A01,091084,Eldon; John,0,0,0,0
1653503648976,ECE 264C,A00,091085,Galton; Ian A,0,0,0,0
1653503649501,ECE 265C,A00,094889,Presti; Calogero Davide,0,0,0,9
1653503650024,ECE 266,A01,091087,Hall; Drew A.,0,0,0,0
1653503651080,ECE 271A,A00,091090,Vasconcelos; Nuno,0,0,0,0
1653503651607,ECE 272B,A00,091091,Sworder; David D.,0,0,0,0
1653503652146,ECE 275A,A00,091092,Meyer; Florian,0,0,0,0
1653503652677,ECE 277,A00,091093,An; Cheolhong,0,0,0,0
1653503653208,ECE 283,A00,091094,Le; Hanh-Phuc,0,0,0,0
1653503653999,ECE 284,A00,091095,Kang; Mingu,0,0,0,0
1653503653999,ECE 284,B00,091096,Wang; Edward Jay,0,0,0,0
1653503654528,ECE 285,A00,094334,Touri; Behrouz,0,0,0,0
1653503655051,ECE 289,A00,091097,Whelan; David Arthur,0,0,0,0
1653503655574,MATH 200A,A00,087414,Salehi Golsefidy; Alireza,7,0,8,1
1653503656097,MATH 202A,A00,087415,Gill; Philip E.,3,0,8,5
1653503656620,MATH 203A,A00,087416,Oprea; Dragos N.,6,0,8,2
1653503657149,MATH 204A,A00,087417,Kedlaya; Kiran S.,6,0,8,2
1653503657674,MATH 205,A00,087418,Sorensen; Claus M,6,0,8,2
1653503658208,MATH 206A,A00,087419,Izadi; Elham,7,0,8,1
1653503658742,MATH 207A,A00,087420,Mohammadi; Amir,5,0,8,3
1653503659266,MATH 208,A00,087421,Staff,9,0,10,1
1653503659792,MATH 209,A00,087422,Staff,10,0,10,0
1653503660316,MATH 218,A00,087423,Staff,10,0,10,0
1653503660843,MATH 220A,A00,087424,Novak; Jonathan I,7,0,8,1
1653503661370,MATH 231A,A00,087425,Bejenaru; Ioan,3,0,8,5
1653503661898,MATH 240A,A00,087426,Ebenfelt; Peter F,5,0,8,3
1653503662420,MATH 243,A00,087427,Staff,9,0,10,1
1653503662947,MATH 248,A00,087429,Staff,10,0,10,0
1653503663474,MATH 250A,A00,087430,Spolaor; Luca,4,0,8,4
1653503664001,MATH 257A,A00,087431,Spolaor; Luca,7,0,8,1
1653503664525,MATH 258,A00,087432,Staff,9,0,10,1
1653503665052,MATH 264A,A00,087433,Warnke; Lutz Peter,5,0,8,3
1653503665585,MATH 268,A00,087434,Staff,15,0,15,0
1653503666108,MATH 269,A00,087435,Staff,14,0,15,1
1653503666640,MATH 270A,A00,087436,Nie; Jiawang,0,0,8,8
1653503667172,MATH 272A,A00,087437,Tian; Xiaochuan,1,0,8,7
1653503667695,MATH 274,A01,087439,Cheng; Li-Tien,9,0,10,1
1653503667695,MATH 274,A02,087440,Cheng; Li-Tien,10,0,10,0
1653503668221,MATH 278A,A00,087441,Staff,8,0,10,2
1653503668750,MATH 278B,A00,087442,Staff,8,0,10,2
1653503669273,MATH 278C,A00,087443,Staff,8,0,10,2
1653503669795,MATH 280A,A00,087444,Zheng; Tianyi,0,0,8,8
1653503670324,MATH 281A,A00,087445,Bradic; Jelena,0,0,8,8
1653503670852,MATH 282A,A00,087446,Zhang; Danna,0,0,8,8
1653503671375,MATH 283,A00,087447,Tesler; Glenn,0,0,0,15
1653503671901,MATH 286,A00,087448,Kemp; Todd Aahron,5,0,8,3
1653503672435,MATH 287D,A00,087449,Bradic; Jelena,8,0,8,0
1653503672958,MATH 288,A00,087450,Staff,14,0,15,1
1653503672958,MATH 288,B00,087451,Staff,15,0,15,0
1653503672958,MATH 288,C00,087452,Staff,15,0,15,0
1653503673483,MATH 290A,A00,087453,Xu; Zhouli,6,0,8,2
1653503674022,MATH 291A,A00,087454,Xu; Zhouli,7,0,8,1
1653503674556,MATH 292,A00,087455,Staff,10,0,10,0
1653503675082,MATH 295,A00,087456,Staff,50,0,50,0
1653503675609,MATH 297,001,087457,Staff,998,0,999,1
1653504239208,COGS 200,A01,087991,Staff,47,0,50,3
1653504239731,COGS 201,A01,094504,Rangel; Lara M,17,0,25,8
1653504240257,COGS 203,A00,087992,Coulson; Seana M,18,0,20,2
1653504240783,COGS 210A,001,087993,Greene; Deanna Jacquelyn,9998,0,9999,1
1653504240783,COGS 210A,002,087994,Saygin; Ayse P,9999,0,9999,0
1653504240783,COGS 210A,003,087995,Xia; Haijun,9999,0,9999,0
1653504240783,COGS 210A,004,087996,Nitz; Douglas A.,9999,0,9999,0
1653504240783,COGS 210A,005,087997,Hollan; James D.,9999,0,9999,0
1653504240783,COGS 210A,006,087998,Deak; Gedeon O.,9998,0,9999,1
1653504240783,COGS 210A,007,087999,Rossano; Federico,9999,0,9999,0
1653504241317,COGS 211A,A00,088000,Coulson; Seana M,9997,0,9999,2
1653504241851,COGS 229,A00,088002,Staff,23,0,25,2
1653504242375,COGS 260,B00,094231,Staff,17,0,20,3
1653504242375,COGS 260,A00,088004,Nitz; Douglas A.,9998,0,9999,1
1653504242901,CSE 202,A00,090110,Paturi; Ramamohan,0,0,0,0
1653504242901,CSE 202,B00,090111,Paturi; Ramamohan,0,0,0,0
1653504243428,CSE 207B,A00,090112,Heninger; Nadia A,0,0,0,0
1653504243952,CSE 208,A00,094858,Micciancio; Daniele,0,0,0,0
1653504244486,CSE 210,A00,090113,Powell; Thomas Allan,0,0,0,0
1653504245013,CSE 219,A00,090898,Staff,0,0,0,0
1653504245536,CSE 221,A00,090114,Zhou; Yuan-Yuan,0,0,0,0
1653504246062,CSE 229A,A00,090115,Porter; George M,0,0,0,0
1653504246590,CSE 229C,A00,090116,Savage; Stefan,0,0,0,0
1653504247122,CSE 230,A00,090117,Jhala; Ranjit,0,0,0,0
1653504247653,CSE 232,A00,090118,Papakonstantinou; Yannis,0,0,0,0
1653504248183,CSE 239A,A00,090121,Kumar; Arun Kumar,0,0,0,0
1653504248706,CSE 239B,A00,090122,Jhala; Ranjit,0,0,0,0
1653504249235,CSE 240A,A00,090123,Zhao; Jishen,0,0,189,189
1653504249762,CSE 243A,A00,090124,Orailoglu; Alex,0,0,15,15
1653504250288,CSE 249B,A00,090125,Kahng; Andrew Byun,13,0,20,7
1653504250817,CSE 250A,A00,090126,Berg-Kirkpatrick; Taylor D,0,0,0,0
1653504251341,CSE 252A,A00,090127,Ochoa; Benjamin Lawrence,0,0,0,0
1653504251871,CSE 258,A01,090129,McAuley; Julian John,0,0,0,0
1653504252396,CSE 258R,A01,090131,McAuley; Julian John,0,0,0,0
1653504252924,CSE 274,A00,090132,Ramamoorthi; Ravi,0,0,0,0
1653504253451,CSE 276A,A00,090133,Christensen; Henrik I,0,0,0,0
1653504253973,CSE 276C,A00,090134,Christensen; Henrik I,0,0,0,0
1653504254507,CSE 290,A00,090135,Bafna; Vineet,0,0,0,0
1653504254507,CSE 290,B00,090136,Ramamoorthi; Ravi,0,0,0,0
1653504254507,CSE 290,C00,090137,Li; Tzumao,9,0,10,1
1653504254507,CSE 290,D00,090138,Zhou; Yuan-Yuan,10,0,10,0
1653504254507,CSE 290,E00,090139,Christensen; Henrik I,10,0,10,0
1653504254507,CSE 290,F00,094053,Shalev; Aaron D,0,0,0,0
1653504255036,CSE 291,A00,090140,Munyaka; Imani N. S.,0,0,0,0
1653504255036,CSE 291,B00,094880,Yu; Qi,0,0,0,0
1653504255036,CSE 291,C00,090142,Pannuto; Patrick William,0,0,0,0
1653504255036,CSE 291,D00,094881,Zhang; Yiying,0,0,0,0
1653504255036,CSE 291,E00,095118,Su; Hao,0,0,0,0
1653504255579,CSE 293,001,094905,Bafna; Vineet,9999,0,9999,0
1653504255579,CSE 293,002,094906,Bellare; Mihir,9999,0,9999,0
1653504255579,CSE 293,003,094907,Berg-Kirkpatrick; Taylor D,9999,0,9999,0
1653504255579,CSE 293,004,094908,Christensen; Henrik I,9999,0,9999,0
1653504255579,CSE 293,005,094909,Cottrell; Garrison W,9999,0,9999,0
1653504255579,CSE 293,006,094910,Deutsch; Alin Bernard,9999,0,9999,0
1653504255579,CSE 293,007,094911,Esmaeilzadeh; Hadi,9999,0,9999,0
1653504255579,CSE 293,008,094912,Freund; Yoav,9999,0,9999,0
1653504255579,CSE 293,009,094913,Griswold; William G.,9999,0,9999,0
1653504255579,CSE 293,010,094914,Gymrek; Melissa Ann,9999,0,9999,0
1653504255579,CSE 293,011,094915,Heninger; Nadia A,9999,0,9999,0
1653504255579,CSE 293,012,094916,Impagliazzo; Russell,9999,0,9999,0
1653504255579,CSE 293,013,094917,Jhala; Ranjit,9999,0,9999,0
1653504255579,CSE 293,014,094918,Kahng; Andrew Byun,9999,0,9999,0
1653504255579,CSE 293,015,094919,Kane; Daniel Mertz,9999,0,9999,0
1653504255579,CSE 293,016,094920,Kriegman; David J,9999,0,9999,0
1653504255579,CSE 293,017,094921,Kumar; Arun Kumar,9999,0,9999,0
1653504255579,CSE 293,018,094922,Lerner; Sorin,9999,0,9999,0
1653504255579,CSE 293,019,094923,Lovett; Shachar,9999,0,9999,0
1653504255579,CSE 293,020,094924,McAuley; Julian John,9999,0,9999,0
1653504255579,CSE 293,021,094925,Micciancio; Daniele,9999,0,9999,0
1653504255579,CSE 293,022,094926,Orailoglu; Alex,9999,0,9999,0
1653504255579,CSE 293,023,094927,Paturi; Ramamohan,9999,0,9999,0
1653504255579,CSE 293,024,094928,Polikarpova; Nadezhda,9999,0,9999,0
1653504255579,CSE 293,025,094929,Politz; Joseph Gibbs,9999,0,9999,0
1653504255579,CSE 293,026,094930,Porter; George M,9999,0,9999,0
1653504255579,CSE 293,027,094931,Porter; Leonard Emerson,9999,0,9999,0
1653504255579,CSE 293,028,094932,Ramamoorthi; Ravi,9999,0,9999,0
1653504255579,CSE 293,029,094933,Sahoo; Debashis,9999,0,9999,0
1653504255579,CSE 293,030,094934,Saul; Lawrence,9999,0,9999,0
1653504255579,CSE 293,031,094935,Savage; Stefan,9999,0,9999,0
1653504255579,CSE 293,032,094936,Schulze; Jurgen P.,9999,0,9999,0
1653504255579,CSE 293,033,094937,Snoeren; Alex C.,9999,0,9999,0
1653504255579,CSE 293,034,094938,Shang; Jingbo,9999,0,9999,0
1653504255579,CSE 293,035,094939,Stefan; Deian,9999,0,9999,0
1653504255579,CSE 293,036,094940,Su; Hao,9999,0,9999,0
1653504255579,CSE 293,037,094941,Swanson; Steven James,9999,0,9999,0
1653504255579,CSE 293,038,094942,Tullsen; Dean Michael,9999,0,9999,0
1653504255579,CSE 293,039,094943,Voelker; Geoffrey M.,9999,0,9999,0
1653504255579,CSE 293,040,094944,Zhao; Jishen,9999,0,9999,0
1653504255579,CSE 293,041,094945,Zhou; Yuan-Yuan,9999,0,9999,0
1653504255579,CSE 293,042,094946,Gao; Sicun,9998,0,9999,1
1653504255579,CSE 293,043,094947,Weibel; Nadir,9999,0,9999,0
1653504255579,CSE 293,044,094948,Gupta; Rajesh K.,9999,0,9999,0
1653504256106,CSE 294,A00,090143,Porter; George M,8,0,10,2
1653504256644,DSE 200,A00,091799,Staff,50,0,50,0
1653504257178,DSE 203,A00,091800,Gupta; Amarnath,30,0,30,0
1653504257702,DSE 250,A00,091801,Deutsch; Alin Bernard,30,0,30,0
1653504258223,DSE 290,A00,091802,Altintas De Callaf; Ilkay,50,0,50,0
1653504258755,ECE 200,001,091003,Antipa; Nicholas A,9999,0,9999,0
1653504258755,ECE 200,002,091004,Atanasov; Nikolay A.,9999,0,9999,0
1653504258755,ECE 200,003,091005,Bharadia; Dinesh,9999,0,9999,0
1653504258755,ECE 200,004,091006,Cheng; Chung Kuan,9999,0,9999,0
1653504258755,ECE 200,005,091007,Cosman; Pamela C.,9999,0,9999,0
1653504258755,ECE 200,006,091008,Staff,9999,0,9999,0
1653504258755,ECE 200,007,091009,Dayeh; Shadi Ahmad,9999,0,9999,0
1653504258755,ECE 200,008,091010,Fainman; Yeshaiahu,9999,0,9999,0
1653504258755,ECE 200,009,091011,Ford; Joseph Earl,9999,0,9999,0
1653504258755,ECE 200,010,091012,Franceschetti; Massimo,9999,0,9999,0
1653504258755,ECE 200,011,091013,Fullerton; Eric E,9999,0,9999,0
1653504258755,ECE 200,012,091014,Galton; Ian A,9999,0,9999,0
1653504258755,ECE 200,013,091015,Gilja; Vikash,9999,0,9999,0
1653504258755,ECE 200,014,091016,Hall; Drew A.,9999,0,9999,0
1653504258755,ECE 200,015,091017,Hsueh; Tzu-Chien,9999,0,9999,0
1653504258755,ECE 200,016,091018,Javidi; Tara,9999,0,9999,0
1653504258755,ECE 200,017,091019,Kahng; Andrew Byun,9999,0,9999,0
1653504258755,ECE 200,018,091020,Kim; Young-Han,9999,0,9999,0
1653504258755,ECE 200,019,091021,Koushanfar; Farinaz,9999,0,9999,0
1653504258755,ECE 200,020,091022,Kuzum; Duygu,9999,0,9999,0
1653504258755,ECE 200,021,091023,Le; Hanh-Phuc,9999,0,9999,0
1653504258755,ECE 200,022,091024,Lin; Bill,9999,0,9999,0
1653504258755,ECE 200,023,091025,Liu; Zhaowei,9999,0,9999,0
1653504258755,ECE 200,024,091026,Lo; Yu-Hwa,9999,0,9999,0
1653504258755,ECE 200,025,091027,Lomakin; Vitaliy,9999,0,9999,0
1653504258755,ECE 200,026,091028,Mercier; Patrick Philip,9999,0,9999,0
1653504258755,ECE 200,027,091029,Meyer; Florian,9999,0,9999,0
1653504258755,ECE 200,028,091030,Milstein; Laurence B.,9999,0,9999,0
1653504258755,ECE 200,029,091031,Mir Arabbaygi; Siavash,9999,0,9999,0
1653504258755,ECE 200,030,091032,Mookherjea; Shayan,9999,0,9999,0
1653504258755,ECE 200,031,091033,Morris; Karcher William,9999,0,9999,0
1653504258755,ECE 200,032,091034,Ng; Tse Nga,9999,0,9999,0
1653504258755,ECE 200,033,091035,Nguyen; Truong Quang,9999,0,9999,0
1653504258755,ECE 200,034,091036,Nomura; Kenji,9999,0,9999,0
1653504258755,ECE 200,035,091037,Orlitsky; Alon,9999,0,9999,0
1653504258755,ECE 200,036,091038,Pal; Piya,9999,0,9999,0
1653504258755,ECE 200,037,091039,Papen; George C.,9999,0,9999,0
1653504258755,ECE 200,038,091040,Radic; Stojan,9999,0,9999,0
1653504258755,ECE 200,039,091041,Rao; Bhaskar D.,9999,0,9999,0
1653504258755,ECE 200,040,091042,Rao; Ramesh R,9999,0,9999,0
1653504258755,ECE 200,041,091043,Rebeiz; Gabriel,9999,0,9999,0
1653504258755,ECE 200,042,091044,Sanford; John R,9999,0,9999,0
1653504258755,ECE 200,043,091045,Siegel; Paul H.,9999,0,9999,0
1653504258755,ECE 200,044,091046,Sievenpiper; Daniel F.,9999,0,9999,0
1653504258755,ECE 200,045,091047,Sworder; David D.,9999,0,9999,0
1653504258755,ECE 200,046,091048,Taur; Yuan,9999,0,9999,0
1653504258755,ECE 200,047,091049,Touri; Behrouz,9999,0,9999,0
1653504258755,ECE 200,048,091050,Trivedi; Mohan M.,9999,0,9999,0
1653504258755,ECE 200,049,091051,Vardy; Alexander,9999,0,9999,0
1653504258755,ECE 200,050,091052,Vasconcelos; Nuno,9999,0,9999,0
1653504258755,ECE 200,051,091053,Wang; Xiaolong,9999,0,9999,0
1653504258755,ECE 200,052,091054,Xie; Pengtao,9999,0,9999,0
1653504258755,ECE 200,053,091055,Yip; Michael,9999,0,9999,0
1653504258755,ECE 200,054,091056,Zeger; Kenneth A.,9999,0,9999,0
1653504258755,ECE 200,055,091057,Zhang; Xinyu,9999,0,9999,0
1653504258755,ECE 200,056,091058,Turakhia; Yatish Girish,9999,0,9999,0
1653504258755,ECE 200,057,091059,Kang; Mingu,9999,0,9999,0
1653504258755,ECE 200,058,091060,Shi; Yuanyuan,9999,0,9999,0
1653504258755,ECE 200,059,091061,Wang; Edward Jay,9999,0,9999,0
1653504258755,ECE 200,060,091062,Zheng; Yang,9999,0,9999,0
1653504259283,ECE 201,A00,095526,Lo; Yu-Hwa,50,0,50,0
1653504259806,ECE 203,A00,091065,Mercier; Patrick Philip,0,0,0,0
1653504260346,ECE 207A,A00,091605,Liu; Thomas Tao-Ming,0,0,0,0
1653504260876,ECE 212AN,A00,091068,Nomura; Kenji,0,0,0,0
1653504261399,ECE 222A,A00,091069,Rebeiz; Gabriel,0,0,0,0
1653504261920,ECE 225A,A00,091070,Orlitsky; Alon,0,0,0,0
1653504262443,ECE 230A,A00,091071,Nomura; Kenji,0,0,0,0
1653504262970,ECE 236A,A00,091072,Dayeh; Shadi Ahmad,0,0,0,0
1653504263493,ECE 238A,A00,091073,Luo; Jian,0,0,0,0
1653504263493,ECE 238A,B00,091074,Luo; Jian,0,0,0,0
1653504264018,ECE 240A,A00,091075,Radic; Stojan,0,0,0,0
1653504264544,ECE 247A,A00,091592,Shi; Lingyan,0,0,0,0
1653504265066,ECE 250,A00,091076,Touri; Behrouz,0,0,0,0
1653504265591,ECE 251C,A00,091078,Nguyen; Truong Quang,0,0,0,0
1653504266114,ECE 253,A00,091079,Cosman; Pamela C.,0,0,0,0
1653504266640,ECE 255A,A00,091080,Orlitsky; Alon,0,0,0,0
1653504267165,ECE 257A,A00,091081,Zhang; Xinyu,0,0,0,0
1653504267689,ECE 260A,A01,091084,Eldon; John,0,0,0,0
1653504268221,ECE 264C,A00,091085,Galton; Ian A,0,0,0,0
1653504268745,ECE 265C,A00,094889,Presti; Calogero Davide,0,0,0,9
1653504269275,ECE 266,A01,091087,Hall; Drew A.,0,0,0,0
1653504270321,ECE 271A,A00,091090,Vasconcelos; Nuno,0,0,0,0
1653504270850,ECE 272B,A00,091091,Sworder; David D.,0,0,0,0
1653504271380,ECE 275A,A00,091092,Meyer; Florian,0,0,0,0
1653504271906,ECE 277,A00,091093,An; Cheolhong,0,0,0,0
1653504272429,ECE 283,A00,091094,Le; Hanh-Phuc,0,0,0,0
1653504272958,ECE 284,A00,091095,Kang; Mingu,0,0,0,0
1653504272958,ECE 284,B00,091096,Wang; Edward Jay,0,0,0,0
1653504273481,ECE 285,A00,094334,Touri; Behrouz,0,0,0,0
1653504274003,ECE 289,A00,091097,Whelan; David Arthur,0,0,0,0
1653504274528,MATH 200A,A00,087414,Salehi Golsefidy; Alireza,7,0,8,1
1653504275051,MATH 202A,A00,087415,Gill; Philip E.,3,0,8,5
1653504275577,MATH 203A,A00,087416,Oprea; Dragos N.,6,0,8,2
1653504276110,MATH 204A,A00,087417,Kedlaya; Kiran S.,6,0,8,2
1653504276641,MATH 205,A00,087418,Sorensen; Claus M,6,0,8,2
1653504277173,MATH 206A,A00,087419,Izadi; Elham,7,0,8,1
1653504277695,MATH 207A,A00,087420,Mohammadi; Amir,5,0,8,3
1653504278217,MATH 208,A00,087421,Staff,9,0,10,1
1653504278739,MATH 209,A00,087422,Staff,10,0,10,0
1653504279262,MATH 218,A00,087423,Staff,10,0,10,0
1653504279794,MATH 220A,A00,087424,Novak; Jonathan I,7,0,8,1
1653504280320,MATH 231A,A00,087425,Bejenaru; Ioan,3,0,8,5
1653504280844,MATH 240A,A00,087426,Ebenfelt; Peter F,5,0,8,3
1653504281374,MATH 243,A00,087427,Staff,9,0,10,1
1653504281901,MATH 248,A00,087429,Staff,10,0,10,0
1653504282431,MATH 250A,A00,087430,Spolaor; Luca,4,0,8,4
1653504282964,MATH 257A,A00,087431,Spolaor; Luca,7,0,8,1
1653504283488,MATH 258,A00,087432,Staff,9,0,10,1
1653504284010,MATH 264A,A00,087433,Warnke; Lutz Peter,5,0,8,3
1653504284532,MATH 268,A00,087434,Staff,15,0,15,0
1653504285053,MATH 269,A00,087435,Staff,14,0,15,1
1653504285579,MATH 270A,A00,087436,Nie; Jiawang,0,0,8,8
1653504286102,MATH 272A,A00,087437,Tian; Xiaochuan,1,0,8,7
1653504286625,MATH 274,A01,087439,Cheng; Li-Tien,9,0,10,1
1653504286625,MATH 274,A02,087440,Cheng; Li-Tien,10,0,10,0
1653504287147,MATH 278A,A00,087441,Staff,8,0,10,2
1653504287670,MATH 278B,A00,087442,Staff,8,0,10,2
1653504288297,MATH 278C,A00,087443,Staff,8,0,10,2
1653504288828,MATH 280A,A00,087444,Zheng; Tianyi,0,0,8,8
1653504289351,MATH 281A,A00,087445,Bradic; Jelena,0,0,8,8
1653504289874,MATH 282A,A00,087446,Zhang; Danna,0,0,8,8
1653504290397,MATH 283,A00,087447,Tesler; Glenn,0,0,0,15
1653504290924,MATH 286,A00,087448,Kemp; Todd Aahron,5,0,8,3
1653504291451,MATH 287D,A00,087449,Bradic; Jelena,8,0,8,0
1653504291974,MATH 288,A00,087450,Staff,14,0,15,1
1653504291974,MATH 288,B00,087451,Staff,15,0,15,0
1653504291974,MATH 288,C00,087452,Staff,15,0,15,0
1653504292506,MATH 290A,A00,087453,Xu; Zhouli,6,0,8,2
1653504293030,MATH 291A,A00,087454,Xu; Zhouli,7,0,8,1
1653504293564,MATH 292,A00,087455,Staff,10,0,10,0
1653504294093,MATH 295,A00,087456,Staff,50,0,50,0
1653504294617,MATH 297,001,087457,Staff,998,0,999,1
1653504858879,COGS 200,A01,087991,Staff,47,0,50,3
1653504859403,COGS 201,A01,094504,Rangel; Lara M,17,0,25,8
1653504859927,COGS 203,A00,087992,Coulson; Seana M,18,0,20,2
1653504860451,COGS 210A,001,087993,Greene; Deanna Jacquelyn,9998,0,9999,1
1653504860451,COGS 210A,002,087994,Saygin; Ayse P,9999,0,9999,0
1653504860451,COGS 210A,003,087995,Xia; Haijun,9999,0,9999,0
1653504860451,COGS 210A,004,087996,Nitz; Douglas A.,9999,0,9999,0
1653504860451,COGS 210A,005,087997,Hollan; James D.,9999,0,9999,0
1653504860451,COGS 210A,006,087998,Deak; Gedeon O.,9998,0,9999,1
1653504860451,COGS 210A,007,087999,Rossano; Federico,9999,0,9999,0
1653504860974,COGS 211A,A00,088000,Coulson; Seana M,9997,0,9999,2
1653504861495,COGS 229,A00,088002,Staff,23,0,25,2
1653504862027,COGS 260,B00,094231,Staff,17,0,20,3
1653504862027,COGS 260,A00,088004,Nitz; Douglas A.,9998,0,9999,1
1653504862550,CSE 202,A00,090110,Paturi; Ramamohan,0,0,0,0
1653504862550,CSE 202,B00,090111,Paturi; Ramamohan,0,0,0,0
1653504863079,CSE 207B,A00,090112,Heninger; Nadia A,0,0,0,0
1653504863602,CSE 208,A00,094858,Micciancio; Daniele,0,0,0,0
1653504864133,CSE 210,A00,090113,Powell; Thomas Allan,0,0,0,0
1653504864654,CSE 219,A00,090898,Staff,0,0,0,0
1653504865185,CSE 221,A00,090114,Zhou; Yuan-Yuan,0,0,0,0
1653504865714,CSE 229A,A00,090115,Porter; George M,0,0,0,0
1653504866238,CSE 229C,A00,090116,Savage; Stefan,0,0,0,0
1653504866766,CSE 230,A00,090117,Jhala; Ranjit,0,0,0,0
1653504867299,CSE 232,A00,090118,Papakonstantinou; Yannis,0,0,0,0
1653504867823,CSE 239A,A00,090121,Kumar; Arun Kumar,0,0,0,0
1653504868349,CSE 239B,A00,090122,Jhala; Ranjit,0,0,0,0
1653504868882,CSE 240A,A00,090123,Zhao; Jishen,0,0,189,189
1653504869415,CSE 243A,A00,090124,Orailoglu; Alex,0,0,15,15
1653504869939,CSE 249B,A00,090125,Kahng; Andrew Byun,13,0,20,7
1653504870480,CSE 250A,A00,090126,Berg-Kirkpatrick; Taylor D,0,0,0,0
1653504871014,CSE 252A,A00,090127,Ochoa; Benjamin Lawrence,0,0,0,0
1653504871543,CSE 258,A01,090129,McAuley; Julian John,0,0,0,0
1653504872066,CSE 258R,A01,090131,McAuley; Julian John,0,0,0,0
1653504872589,CSE 274,A00,090132,Ramamoorthi; Ravi,0,0,0,0
1653504873119,CSE 276A,A00,090133,Christensen; Henrik I,0,0,0,0
1653504873643,CSE 276C,A00,090134,Christensen; Henrik I,0,0,0,0
1653504874170,CSE 290,A00,090135,Bafna; Vineet,0,0,0,0
1653504874170,CSE 290,B00,090136,Ramamoorthi; Ravi,0,0,0,0
1653504874170,CSE 290,C00,090137,Li; Tzumao,9,0,10,1
1653504874170,CSE 290,D00,090138,Zhou; Yuan-Yuan,10,0,10,0
1653504874170,CSE 290,E00,090139,Christensen; Henrik I,10,0,10,0
1653504874170,CSE 290,F00,094053,Shalev; Aaron D,0,0,0,0
1653504874692,CSE 291,A00,090140,Munyaka; Imani N. S.,0,0,0,0
1653504874692,CSE 291,B00,094880,Yu; Qi,0,0,0,0
1653504874692,CSE 291,C00,090142,Pannuto; Patrick William,0,0,0,0
1653504874692,CSE 291,D00,094881,Zhang; Yiying,0,0,0,0
1653504874692,CSE 291,E00,095118,Su; Hao,0,0,0,0
1653504875218,CSE 293,001,094905,Bafna; Vineet,9999,0,9999,0
1653504875218,CSE 293,002,094906,Bellare; Mihir,9999,0,9999,0
1653504875218,CSE 293,003,094907,Berg-Kirkpatrick; Taylor D,9999,0,9999,0
1653504875218,CSE 293,004,094908,Christensen; Henrik I,9999,0,9999,0
1653504875218,CSE 293,005,094909,Cottrell; Garrison W,9999,0,9999,0
1653504875218,CSE 293,006,094910,Deutsch; Alin Bernard,9999,0,9999,0
1653504875218,CSE 293,007,094911,Esmaeilzadeh; Hadi,9999,0,9999,0
1653504875218,CSE 293,008,094912,Freund; Yoav,9999,0,9999,0
1653504875218,CSE 293,009,094913,Griswold; William G.,9999,0,9999,0
1653504875218,CSE 293,010,094914,Gymrek; Melissa Ann,9999,0,9999,0
1653504875218,CSE 293,011,094915,Heninger; Nadia A,9999,0,9999,0
1653504875218,CSE 293,012,094916,Impagliazzo; Russell,9999,0,9999,0
1653504875218,CSE 293,013,094917,Jhala; Ranjit,9999,0,9999,0
1653504875218,CSE 293,014,094918,Kahng; Andrew Byun,9999,0,9999,0
1653504875218,CSE 293,015,094919,Kane; Daniel Mertz,9999,0,9999,0
1653504875218,CSE 293,016,094920,Kriegman; David J,9999,0,9999,0
1653504875218,CSE 293,017,094921,Kumar; Arun Kumar,9999,0,9999,0
1653504875218,CSE 293,018,094922,Lerner; Sorin,9999,0,9999,0
1653504875218,CSE 293,019,094923,Lovett; Shachar,9999,0,9999,0
1653504875218,CSE 293,020,094924,McAuley; Julian John,9999,0,9999,0
1653504875218,CSE 293,021,094925,Micciancio; Daniele,9999,0,9999,0
1653504875218,CSE 293,022,094926,Orailoglu; Alex,9999,0,9999,0
1653504875218,CSE 293,023,094927,Paturi; Ramamohan,9999,0,9999,0
1653504875218,CSE 293,024,094928,Polikarpova; Nadezhda,9999,0,9999,0
1653504875218,CSE 293,025,094929,Politz; Joseph Gibbs,9999,0,9999,0
1653504875218,CSE 293,026,094930,Porter; George M,9999,0,9999,0
1653504875218,CSE 293,027,094931,Porter; Leonard Emerson,9999,0,9999,0
1653504875218,CSE 293,028,094932,Ramamoorthi; Ravi,9999,0,9999,0
1653504875218,CSE 293,029,094933,Sahoo; Debashis,9999,0,9999,0
1653504875218,CSE 293,030,094934,Saul; Lawrence,9999,0,9999,0
1653504875218,CSE 293,031,094935,Savage; Stefan,9999,0,9999,0
1653504875218,CSE 293,032,094936,Schulze; Jurgen P.,9999,0,9999,0
1653504875218,CSE 293,033,094937,Snoeren; Alex C.,9999,0,9999,0
1653504875218,CSE 293,034,094938,Shang; Jingbo,9999,0,9999,0
1653504875218,CSE 293,035,094939,Stefan; Deian,9999,0,9999,0
1653504875218,CSE 293,036,094940,Su; Hao,9999,0,9999,0
1653504875218,CSE 293,037,094941,Swanson; Steven James,9999,0,9999,0
1653504875218,CSE 293,038,094942,Tullsen; Dean Michael,9999,0,9999,0
1653504875218,CSE 293,039,094943,Voelker; Geoffrey M.,9999,0,9999,0
1653504875218,CSE 293,040,094944,Zhao; Jishen,9999,0,9999,0
1653504875218,CSE 293,041,094945,Zhou; Yuan-Yuan,9999,0,9999,0
1653504875218,CSE 293,042,094946,Gao; Sicun,9998,0,9999,1
1653504875218,CSE 293,043,094947,Weibel; Nadir,9999,0,9999,0
1653504875218,CSE 293,044,094948,Gupta; Rajesh K.,9999,0,9999,0
1653504875746,CSE 294,A00,090143,Porter; George M,8,0,10,2
1653504876268,DSE 200,A00,091799,Staff,50,0,50,0
1653504876794,DSE 203,A00,091800,Gupta; Amarnath,30,0,30,0
1653504877316,DSE 250,A00,091801,Deutsch; Alin Bernard,30,0,30,0
1653504877854,DSE 290,A00,091802,Altintas De Callaf; Ilkay,50,0,50,0
1653504878395,ECE 200,001,091003,Antipa; Nicholas A,9999,0,9999,0
1653504878395,ECE 200,002,091004,Atanasov; Nikolay A.,9999,0,9999,0
1653504878395,ECE 200,003,091005,Bharadia; Dinesh,9999,0,9999,0
1653504878395,ECE 200,004,091006,Cheng; Chung Kuan,9999,0,9999,0
1653504878395,ECE 200,005,091007,Cosman; Pamela C.,9999,0,9999,0
1653504878395,ECE 200,006,091008,Staff,9999,0,9999,0
1653504878395,ECE 200,007,091009,Dayeh; Shadi Ahmad,9999,0,9999,0
1653504878395,ECE 200,008,091010,Fainman; Yeshaiahu,9999,0,9999,0
1653504878395,ECE 200,009,091011,Ford; Joseph Earl,9999,0,9999,0
1653504878395,ECE 200,010,091012,Franceschetti; Massimo,9999,0,9999,0
1653504878395,ECE 200,011,091013,Fullerton; Eric E,9999,0,9999,0
1653504878395,ECE 200,012,091014,Galton; Ian A,9999,0,9999,0
1653504878395,ECE 200,013,091015,Gilja; Vikash,9999,0,9999,0
1653504878395,ECE 200,014,091016,Hall; Drew A.,9999,0,9999,0
1653504878395,ECE 200,015,091017,Hsueh; Tzu-Chien,9999,0,9999,0
1653504878395,ECE 200,016,091018,Javidi; Tara,9999,0,9999,0
1653504878395,ECE 200,017,091019,Kahng; Andrew Byun,9999,0,9999,0
1653504878395,ECE 200,018,091020,Kim; Young-Han,9999,0,9999,0
1653504878395,ECE 200,019,091021,Koushanfar; Farinaz,9999,0,9999,0
1653504878395,ECE 200,020,091022,Kuzum; Duygu,9999,0,9999,0
1653504878395,ECE 200,021,091023,Le; Hanh-Phuc,9999,0,9999,0
1653504878395,ECE 200,022,091024,Lin; Bill,9999,0,9999,0
1653504878395,ECE 200,023,091025,Liu; Zhaowei,9999,0,9999,0
1653504878395,ECE 200,024,091026,Lo; Yu-Hwa,9999,0,9999,0
1653504878395,ECE 200,025,091027,Lomakin; Vitaliy,9999,0,9999,0
1653504878395,ECE 200,026,091028,Mercier; Patrick Philip,9999,0,9999,0
1653504878395,ECE 200,027,091029,Meyer; Florian,9999,0,9999,0
1653504878395,ECE 200,028,091030,Milstein; Laurence B.,9999,0,9999,0
1653504878395,ECE 200,029,091031,Mir Arabbaygi; Siavash,9999,0,9999,0
1653504878395,ECE 200,030,091032,Mookherjea; Shayan,9999,0,9999,0
1653504878395,ECE 200,031,091033,Morris; Karcher William,9999,0,9999,0
1653504878395,ECE 200,032,091034,Ng; Tse Nga,9999,0,9999,0
1653504878395,ECE 200,033,091035,Nguyen; Truong Quang,9999,0,9999,0
1653504878395,ECE 200,034,091036,Nomura; Kenji,9999,0,9999,0
1653504878395,ECE 200,035,091037,Orlitsky; Alon,9999,0,9999,0
1653504878395,ECE 200,036,091038,Pal; Piya,9999,0,9999,0
1653504878395,ECE 200,037,091039,Papen; George C.,9999,0,9999,0
1653504878395,ECE 200,038,091040,Radic; Stojan,9999,0,9999,0
1653504878395,ECE 200,039,091041,Rao; Bhaskar D.,9999,0,9999,0
1653504878395,ECE 200,040,091042,Rao; Ramesh R,9999,0,9999,0
1653504878395,ECE 200,041,091043,Rebeiz; Gabriel,9999,0,9999,0
1653504878395,ECE 200,042,091044,Sanford; John R,9999,0,9999,0
1653504878395,ECE 200,043,091045,Siegel; Paul H.,9999,0,9999,0
1653504878395,ECE 200,044,091046,Sievenpiper; Daniel F.,9999,0,9999,0
1653504878395,ECE 200,045,091047,Sworder; David D.,9999,0,9999,0
1653504878395,ECE 200,046,091048,Taur; Yuan,9999,0,9999,0
1653504878395,ECE 200,047,091049,Touri; Behrouz,9999,0,9999,0
1653504878395,ECE 200,048,091050,Trivedi; Mohan M.,9999,0,9999,0
1653504878395,ECE 200,049,091051,Vardy; Alexander,9999,0,9999,0
1653504878395,ECE 200,050,091052,Vasconcelos; Nuno,9999,0,9999,0
1653504878395,ECE 200,051,091053,Wang; Xiaolong,9999,0,9999,0
1653504878395,ECE 200,052,091054,Xie; Pengtao,9999,0,9999,0
1653504878395,ECE 200,053,091055,Yip; Michael,9999,0,9999,0
1653504878395,ECE 200,054,091056,Zeger; Kenneth A.,9999,0,9999,0
1653504878395,ECE 200,055,091057,Zhang; Xinyu,9999,0,9999,0
1653504878395,ECE 200,056,091058,Turakhia; Yatish Girish,9999,0,9999,0
1653504878395,ECE 200,057,091059,Kang; Mingu,9999,0,9999,0
1653504878395,ECE 200,058,091060,Shi; Yuanyuan,9999,0,9999,0
1653504878395,ECE 200,059,091061,Wang; Edward Jay,9999,0,9999,0
1653504878395,ECE 200,060,091062,Zheng; Yang,9999,0,9999,0
1653504878917,ECE 201,A00,095526,Lo; Yu-Hwa,50,0,50,0
1653504879439,ECE 203,A00,091065,Mercier; Patrick Philip,0,0,0,0
1653504880052,ECE 207A,A00,091605,Liu; Thomas Tao-Ming,0,0,0,0
1653504880575,ECE 212AN,A00,091068,Nomura; Kenji,0,0,0,0
1653504881102,ECE 222A,A00,091069,Rebeiz; Gabriel,0,0,0,0
1653504881633,ECE 225A,A00,091070,Orlitsky; Alon,0,0,0,0
1653504882159,ECE 230A,A00,091071,Nomura; Kenji,0,0,0,0
1653504882704,ECE 236A,A00,091072,Dayeh; Shadi Ahmad,0,0,0,0
1653504883229,ECE 238A,A00,091073,Luo; Jian,0,0,0,0
1653504883229,ECE 238A,B00,091074,Luo; Jian,0,0,0,0
1653504883755,ECE 240A,A00,091075,Radic; Stojan,0,0,0,0
1653504884277,ECE 247A,A00,091592,Shi; Lingyan,0,0,0,0
1653504884804,ECE 250,A00,091076,Touri; Behrouz,0,0,0,0
1653504885327,ECE 251C,A00,091078,Nguyen; Truong Quang,0,0,0,0
1653504885856,ECE 253,A00,091079,Cosman; Pamela C.,0,0,0,0
1653504886379,ECE 255A,A00,091080,Orlitsky; Alon,0,0,0,0
1653504886909,ECE 257A,A00,091081,Zhang; Xinyu,0,0,0,0
1653504887431,ECE 260A,A01,091084,Eldon; John,0,0,0,0
1653504887957,ECE 264C,A00,091085,Galton; Ian A,0,0,0,0
1653504888482,ECE 265C,A00,094889,Presti; Calogero Davide,0,0,0,9
1653504889004,ECE 266,A01,091087,Hall; Drew A.,0,0,0,0
1653504890069,ECE 271A,A00,091090,Vasconcelos; Nuno,0,0,0,0
1653504890602,ECE 272B,A00,091091,Sworder; David D.,0,0,0,0
1653504891129,ECE 275A,A00,091092,Meyer; Florian,0,0,0,0
1653504891651,ECE 277,A00,091093,An; Cheolhong,0,0,0,0
1653504892183,ECE 283,A00,091094,Le; Hanh-Phuc,0,0,0,0
1653504892719,ECE 284,A00,091095,Kang; Mingu,0,0,0,0
1653504892719,ECE 284,B00,091096,Wang; Edward Jay,0,0,0,0
1653504893250,ECE 285,A00,094334,Touri; Behrouz,0,0,0,0
1653504893772,ECE 289,A00,091097,Whelan; David Arthur,0,0,0,0
1653504894295,MATH 200A,A00,087414,Salehi Golsefidy; Alireza,7,0,8,1
1653504894821,MATH 202A,A00,087415,Gill; Philip E.,3,0,8,5
1653504895344,MATH 203A,A00,087416,Oprea; Dragos N.,6,0,8,2
1653504895865,MATH 204A,A00,087417,Kedlaya; Kiran S.,6,0,8,2
1653504896391,MATH 205,A00,087418,Sorensen; Claus M,6,0,8,2
1653504896916,MATH 206A,A00,087419,Izadi; Elham,7,0,8,1
1653504897439,MATH 207A,A00,087420,Mohammadi; Amir,5,0,8,3
1653504897960,MATH 208,A00,087421,Staff,9,0,10,1
1653504898490,MATH 209,A00,087422,Staff,10,0,10,0
1653504899019,MATH 218,A00,087423,Staff,10,0,10,0
1653504899547,MATH 220A,A00,087424,Novak; Jonathan I,7,0,8,1
1653504900069,MATH 231A,A00,087425,Bejenaru; Ioan,3,0,8,5
1653504900596,MATH 240A,A00,087426,Ebenfelt; Peter F,5,0,8,3
1653504901121,MATH 243,A00,087427,Staff,9,0,10,1
1653504901647,MATH 248,A00,087429,Staff,10,0,10,0
1653504902172,MATH 250A,A00,087430,Spolaor; Luca,4,0,8,4
1653504902704,MATH 257A,A00,087431,Spolaor; Luca,7,0,8,1
1653504903239,MATH 258,A00,087432,Staff,9,0,10,1
1653504903765,MATH 264A,A00,087433,Warnke; Lutz Peter,5,0,8,3
1653504904289,MATH 268,A00,087434,Staff,15,0,15,0
1653504904812,MATH 269,A00,087435,Staff,14,0,15,1
1653504905335,MATH 270A,A00,087436,Nie; Jiawang,0,0,8,8
1653504905865,MATH 272A,A00,087437,Tian; Xiaochuan,1,0,8,7
1653504906401,MATH 274,A01,087439,Cheng; Li-Tien,9,0,10,1
1653504906401,MATH 274,A02,087440,Cheng; Li-Tien,10,0,10,0
1653504906923,MATH 278A,A00,087441,Staff,8,0,10,2
1653504907445,MATH 278B,A00,087442,Staff,8,0,10,2
1653504907968,MATH 278C,A00,087443,Staff,8,0,10,2
1653504908507,MATH 280A,A00,087444,Zheng; Tianyi,0,0,8,8
1653504909034,MATH 281A,A00,087445,Bradic; Jelena,0,0,8,8
1653504909559,MATH 282A,A00,087446,Zhang; Danna,0,0,8,8
1653504910081,MATH 283,A00,087447,Tesler; Glenn,0,0,0,15
1653504910604,MATH 286,A00,087448,Kemp; Todd Aahron,5,0,8,3
1653504911129,MATH 287D,A00,087449,Bradic; Jelena,8,0,8,0
1653504911652,MATH 288,A00,087450,Staff,14,0,15,1
1653504911652,MATH 288,B00,087451,Staff,15,0,15,0
1653504911652,MATH 288,C00,087452,Staff,15,0,15,0
1653504912185,MATH 290A,A00,087453,Xu; Zhouli,6,0,8,2
1653504912746,MATH 291A,A00,087454,Xu; Zhouli,7,0,8,1
1653504913275,MATH 292,A00,087455,Staff,10,0,10,0
1653504913800,MATH 295,A00,087456,Staff,50,0,50,0
1653504914323,MATH 297,001,087457,Staff,998,0,999,1
1653505478834,COGS 200,A01,087991,Staff,47,0,50,3
1653505479365,COGS 201,A01,094504,Rangel; Lara M,17,0,25,8
1653505479889,COGS 203,A00,087992,Coulson; Seana M,18,0,20,2
1653505480414,COGS 210A,001,087993,Greene; Deanna Jacquelyn,9998,0,9999,1
1653505480414,COGS 210A,002,087994,Saygin; Ayse P,9999,0,9999,0
1653505480414,COGS 210A,003,087995,Xia; Haijun,9999,0,9999,0
1653505480414,COGS 210A,004,087996,Nitz; Douglas A.,9999,0,9999,0
1653505480414,COGS 210A,005,087997,Hollan; James D.,9999,0,9999,0
1653505480414,COGS 210A,006,087998,Deak; Gedeon O.,9998,0,9999,1
1653505480414,COGS 210A,007,087999,Rossano; Federico,9999,0,9999,0
1653505480939,COGS 211A,A00,088000,Coulson; Seana M,9997,0,9999,2
1653505481462,COGS 229,A00,088002,Staff,23,0,25,2
1653505482004,COGS 260,B00,094231,Staff,17,0,20,3
1653505482004,COGS 260,A00,088004,Nitz; Douglas A.,9998,0,9999,1
1653505482526,CSE 202,A00,090110,Paturi; Ramamohan,0,0,0,0
1653505482526,CSE 202,B00,090111,Paturi; Ramamohan,0,0,0,0
1653505483050,CSE 207B,A00,090112,Heninger; Nadia A,0,0,0,0
1653505483574,CSE 208,A00,094858,Micciancio; Daniele,0,0,0,0
1653505484105,CSE 210,A00,090113,Powell; Thomas Allan,0,0,0,0
1653505484627,CSE 219,A00,090898,Staff,0,0,0,0
1653505485159,CSE 221,A00,090114,Zhou; Yuan-Yuan,0,0,0,0
1653505485681,CSE 229A,A00,090115,Porter; George M,0,0,0,0
1653505486220,CSE 229C,A00,090116,Savage; Stefan,0,0,0,0
1653505486760,CSE 230,A00,090117,Jhala; Ranjit,0,0,0,0
1653505487284,CSE 232,A00,090118,Papakonstantinou; Yannis,0,0,0,0
1653505487812,CSE 239A,A00,090121,Kumar; Arun Kumar,0,0,0,0
1653505488340,CSE 239B,A00,090122,Jhala; Ranjit,0,0,0,0
1653505488862,CSE 240A,A00,090123,Zhao; Jishen,0,0,189,189
1653505489394,CSE 243A,A00,090124,Orailoglu; Alex,0,0,15,15
1653505489926,CSE 249B,A00,090125,Kahng; Andrew Byun,13,0,20,7
1653505490451,CSE 250A,A00,090126,Berg-Kirkpatrick; Taylor D,0,0,0,0
1653505490978,CSE 252A,A00,090127,Ochoa; Benjamin Lawrence,0,0,0,0
1653505491502,CSE 258,A01,090129,McAuley; Julian John,0,0,0,0
1653505492025,CSE 258R,A01,090131,McAuley; Julian John,0,0,0,0
1653505492547,CSE 274,A00,090132,Ramamoorthi; Ravi,0,0,0,0
1653505493077,CSE 276A,A00,090133,Christensen; Henrik I,0,0,0,0
1653505493604,CSE 276C,A00,090134,Christensen; Henrik I,0,0,0,0
1653505494139,CSE 290,A00,090135,Bafna; Vineet,0,0,0,0
1653505494139,CSE 290,B00,090136,Ramamoorthi; Ravi,0,0,0,0
1653505494139,CSE 290,C00,090137,Li; Tzumao,9,0,10,1
1653505494139,CSE 290,D00,090138,Zhou; Yuan-Yuan,10,0,10,0
1653505494139,CSE 290,E00,090139,Christensen; Henrik I,10,0,10,0
1653505494139,CSE 290,F00,094053,Shalev; Aaron D,0,0,0,0
1653505494667,CSE 291,A00,090140,Munyaka; Imani N. S.,0,0,0,0
1653505494667,CSE 291,B00,094880,Yu; Qi,0,0,0,0
1653505494667,CSE 291,C00,090142,Pannuto; Patrick William,0,0,0,0
1653505494667,CSE 291,D00,094881,Zhang; Yiying,0,0,0,0
1653505494667,CSE 291,E00,095118,Su; Hao,0,0,0,0
1653505495237,CSE 293,001,094905,Bafna; Vineet,9999,0,9999,0
1653505495237,CSE 293,002,094906,Bellare; Mihir,9999,0,9999,0
1653505495237,CSE 293,003,094907,Berg-Kirkpatrick; Taylor D,9999,0,9999,0
1653505495237,CSE 293,004,094908,Christensen; Henrik I,9999,0,9999,0
1653505495237,CSE 293,005,094909,Cottrell; Garrison W,9999,0,9999,0
1653505495237,CSE 293,006,094910,Deutsch; Alin Bernard,9999,0,9999,0
1653505495237,CSE 293,007,094911,Esmaeilzadeh; Hadi,9999,0,9999,0
1653505495237,CSE 293,008,094912,Freund; Yoav,9999,0,9999,0
1653505495237,CSE 293,009,094913,Griswold; William G.,9999,0,9999,0
1653505495237,CSE 293,010,094914,Gymrek; Melissa Ann,9999,0,9999,0
1653505495237,CSE 293,011,094915,Heninger; Nadia A,9999,0,9999,0
1653505495237,CSE 293,012,094916,Impagliazzo; Russell,9999,0,9999,0
1653505495237,CSE 293,013,094917,Jhala; Ranjit,9999,0,9999,0
1653505495237,CSE 293,014,094918,Kahng; Andrew Byun,9999,0,9999,0
1653505495237,CSE 293,015,094919,Kane; Daniel Mertz,9999,0,9999,0
1653505495237,CSE 293,016,094920,Kriegman; David J,9999,0,9999,0
1653505495237,CSE 293,017,094921,Kumar; Arun Kumar,9999,0,9999,0
1653505495237,CSE 293,018,094922,Lerner; Sorin,9999,0,9999,0
1653505495237,CSE 293,019,094923,Lovett; Shachar,9999,0,9999,0
1653505495237,CSE 293,020,094924,McAuley; Julian John,9999,0,9999,0
1653505495237,CSE 293,021,094925,Micciancio; Daniele,9999,0,9999,0
1653505495237,CSE 293,022,094926,Orailoglu; Alex,9999,0,9999,0
1653505495237,CSE 293,023,094927,Paturi; Ramamohan,9999,0,9999,0
1653505495237,CSE 293,024,094928,Polikarpova; Nadezhda,9999,0,9999,0
1653505495237,CSE 293,025,094929,Politz; Joseph Gibbs,9999,0,9999,0
1653505495237,CSE 293,026,094930,Porter; George M,9999,0,9999,0
1653505495237,CSE 293,027,094931,Porter; Leonard Emerson,9999,0,9999,0
1653505495237,CSE 293,028,094932,Ramamoorthi; Ravi,9999,0,9999,0
1653505495237,CSE 293,029,094933,Sahoo; Debashis,9999,0,9999,0
1653505495237,CSE 293,030,094934,Saul; Lawrence,9999,0,9999,0
1653505495237,CSE 293,031,094935,Savage; Stefan,9999,0,9999,0
1653505495237,CSE 293,032,094936,Schulze; Jurgen P.,9999,0,9999,0
1653505495237,CSE 293,033,094937,Snoeren; Alex C.,9999,0,9999,0
1653505495237,CSE 293,034,094938,Shang; Jingbo,9999,0,9999,0
1653505495237,CSE 293,035,094939,Stefan; Deian,9999,0,9999,0
1653505495237,CSE 293,036,094940,Su; Hao,9999,0,9999,0
1653505495237,CSE 293,037,094941,Swanson; Steven James,9999,0,9999,0
1653505495237,CSE 293,038,094942,Tullsen; Dean Michael,9999,0,9999,0
1653505495237,CSE 293,039,094943,Voelker; Geoffrey M.,9999,0,9999,0
1653505495237,CSE 293,040,094944,Zhao; Jishen,9999,0,9999,0
1653505495237,CSE 293,041,094945,Zhou; Yuan-Yuan,9999,0,9999,0
1653505495237,CSE 293,042,094946,Gao; Sicun,9998,0,9999,1
1653505495237,CSE 293,043,094947,Weibel; Nadir,9999,0,9999,0
1653505495237,CSE 293,044,094948,Gupta; Rajesh K.,9999,0,9999,0
1653505495760,CSE 294,A00,090143,Porter; George M,8,0,10,2
1653505496292,DSE 200,A00,091799,Staff,50,0,50,0
1653505496826,DSE 203,A00,091800,Gupta; Amarnath,30,0,30,0
1653505497359,DSE 250,A00,091801,Deutsch; Alin Bernard,30,0,30,0
1653505497881,DSE 290,A00,091802,Altintas De Callaf; Ilkay,50,0,50,0
1653505498413,ECE 200,001,091003,Antipa; Nicholas A,9999,0,9999,0
1653505498413,ECE 200,002,091004,Atanasov; Nikolay A.,9999,0,9999,0
1653505498413,ECE 200,003,091005,Bharadia; Dinesh,9999,0,9999,0
1653505498413,ECE 200,004,091006,Cheng; Chung Kuan,9999,0,9999,0
1653505498413,ECE 200,005,091007,Cosman; Pamela C.,9999,0,9999,0
1653505498413,ECE 200,006,091008,Staff,9999,0,9999,0
1653505498413,ECE 200,007,091009,Dayeh; Shadi Ahmad,9999,0,9999,0
1653505498413,ECE 200,008,091010,Fainman; Yeshaiahu,9999,0,9999,0
1653505498413,ECE 200,009,091011,Ford; Joseph Earl,9999,0,9999,0
1653505498413,ECE 200,010,091012,Franceschetti; Massimo,9999,0,9999,0
1653505498413,ECE 200,011,091013,Fullerton; Eric E,9999,0,9999,0
1653505498413,ECE 200,012,091014,Galton; Ian A,9999,0,9999,0
1653505498413,ECE 200,013,091015,Gilja; Vikash,9999,0,9999,0
1653505498413,ECE 200,014,091016,Hall; Drew A.,9999,0,9999,0
1653505498413,ECE 200,015,091017,Hsueh; Tzu-Chien,9999,0,9999,0
1653505498413,ECE 200,016,091018,Javidi; Tara,9999,0,9999,0
1653505498413,ECE 200,017,091019,Kahng; Andrew Byun,9999,0,9999,0
1653505498413,ECE 200,018,091020,Kim; Young-Han,9999,0,9999,0
1653505498413,ECE 200,019,091021,Koushanfar; Farinaz,9999,0,9999,0
1653505498413,ECE 200,020,091022,Kuzum; Duygu,9999,0,9999,0
1653505498413,ECE 200,021,091023,Le; Hanh-Phuc,9999,0,9999,0
1653505498413,ECE 200,022,091024,Lin; Bill,9999,0,9999,0
1653505498413,ECE 200,023,091025,Liu; Zhaowei,9999,0,9999,0
1653505498413,ECE 200,024,091026,Lo; Yu-Hwa,9999,0,9999,0
1653505498413,ECE 200,025,091027,Lomakin; Vitaliy,9999,0,9999,0
1653505498413,ECE 200,026,091028,Mercier; Patrick Philip,9999,0,9999,0
1653505498413,ECE 200,027,091029,Meyer; Florian,9999,0,9999,0
1653505498413,ECE 200,028,091030,Milstein; Laurence B.,9999,0,9999,0
1653505498413,ECE 200,029,091031,Mir Arabbaygi; Siavash,9999,0,9999,0
1653505498413,ECE 200,030,091032,Mookherjea; Shayan,9999,0,9999,0
1653505498413,ECE 200,031,091033,Morris; Karcher William,9999,0,9999,0
1653505498413,ECE 200,032,091034,Ng; Tse Nga,9999,0,9999,0
1653505498413,ECE 200,033,091035,Nguyen; Truong Quang,9999,0,9999,0
1653505498413,ECE 200,034,091036,Nomura; Kenji,9999,0,9999,0
1653505498413,ECE 200,035,091037,Orlitsky; Alon,9999,0,9999,0
1653505498413,ECE 200,036,091038,Pal; Piya,9999,0,9999,0
1653505498413,ECE 200,037,091039,Papen; George C.,9999,0,9999,0
1653505498413,ECE 200,038,091040,Radic; Stojan,9999,0,9999,0
1653505498413,ECE 200,039,091041,Rao; Bhaskar D.,9999,0,9999,0
1653505498413,ECE 200,040,091042,Rao; Ramesh R,9999,0,9999,0
1653505498413,ECE 200,041,091043,Rebeiz; Gabriel,9999,0,9999,0
1653505498413,ECE 200,042,091044,Sanford; John R,9999,0,9999,0
1653505498413,ECE 200,043,091045,Siegel; Paul H.,9999,0,9999,0
1653505498413,ECE 200,044,091046,Sievenpiper; Daniel F.,9999,0,9999,0
1653505498413,ECE 200,045,091047,Sworder; David D.,9999,0,9999,0
1653505498413,ECE 200,046,091048,Taur; Yuan,9999,0,9999,0
1653505498413,ECE 200,047,091049,Touri; Behrouz,9999,0,9999,0
1653505498413,ECE 200,048,091050,Trivedi; Mohan M.,9999,0,9999,0
1653505498413,ECE 200,049,091051,Vardy; Alexander,9999,0,9999,0
1653505498413,ECE 200,050,091052,Vasconcelos; Nuno,9999,0,9999,0
1653505498413,ECE 200,051,091053,Wang; Xiaolong,9999,0,9999,0
1653505498413,ECE 200,052,091054,Xie; Pengtao,9999,0,9999,0
1653505498413,ECE 200,053,091055,Yip; Michael,9999,0,9999,0
1653505498413,ECE 200,054,091056,Zeger; Kenneth A.,9999,0,9999,0
1653505498413,ECE 200,055,091057,Zhang; Xinyu,9999,0,9999,0
1653505498413,ECE 200,056,091058,Turakhia; Yatish Girish,9999,0,9999,0
1653505498413,ECE 200,057,091059,Kang; Mingu,9999,0,9999,0
1653505498413,ECE 200,058,091060,Shi; Yuanyuan,9999,0,9999,0
1653505498413,ECE 200,059,091061,Wang; Edward Jay,9999,0,9999,0
1653505498413,ECE 200,060,091062,Zheng; Yang,9999,0,9999,0
1653505498938,ECE 201,A00,095526,Lo; Yu-Hwa,50,0,50,0
1653505499464,ECE 203,A00,091065,Mercier; Patrick Philip,0,0,0,0
1653505499990,ECE 207A,A00,091605,Liu; Thomas Tao-Ming,0,0,0,0
1653505500519,ECE 212AN,A00,091068,Nomura; Kenji,0,0,0,0
1653505501053,ECE 222A,A00,091069,Rebeiz; Gabriel,0,0,0,0
1653505501600,ECE 225A,A00,091070,Orlitsky; Alon,0,0,0,0
1653505502125,ECE 230A,A00,091071,Nomura; Kenji,0,0,0,0
1653505502652,ECE 236A,A00,091072,Dayeh; Shadi Ahmad,0,0,0,0
1653505503181,ECE 238A,A00,091073,Luo; Jian,0,0,0,0
1653505503181,ECE 238A,B00,091074,Luo; Jian,0,0,0,0
1653505503707,ECE 240A,A00,091075,Radic; Stojan,0,0,0,0
1653505504244,ECE 247A,A00,091592,Shi; Lingyan,0,0,0,0
1653505504780,ECE 250,A00,091076,Touri; Behrouz,0,0,0,0
1653505505312,ECE 251C,A00,091078,Nguyen; Truong Quang,0,0,0,0
1653505505835,ECE 253,A00,091079,Cosman; Pamela C.,0,0,0,0
1653505506379,ECE 255A,A00,091080,Orlitsky; Alon,0,0,0,0
1653505506901,ECE 257A,A00,091081,Zhang; Xinyu,0,0,0,0
1653505507426,ECE 260A,A01,091084,Eldon; John,0,0,0,0
1653505507955,ECE 264C,A00,091085,Galton; Ian A,0,0,0,0
1653505508489,ECE 265C,A00,094889,Presti; Calogero Davide,0,0,0,9
1653505509018,ECE 266,A01,091087,Hall; Drew A.,0,0,0,0
1653505510073,ECE 271A,A00,091090,Vasconcelos; Nuno,0,0,0,0
1653505510597,ECE 272B,A00,091091,Sworder; David D.,0,0,0,0
1653505511119,ECE 275A,A00,091092,Meyer; Florian,0,0,0,0
1653505512266,ECE 277,A00,091093,An; Cheolhong,0,0,0,0
1653505512787,ECE 283,A00,091094,Le; Hanh-Phuc,0,0,0,0
1653505513317,ECE 284,A00,091095,Kang; Mingu,0,0,0,0
1653505513317,ECE 284,B00,091096,Wang; Edward Jay,0,0,0,0
1653505513847,ECE 285,A00,094334,Touri; Behrouz,0,0,0,0
1653505514371,ECE 289,A00,091097,Whelan; David Arthur,0,0,0,0
1653505514896,MATH 200A,A00,087414,Salehi Golsefidy; Alireza,7,0,8,1
1653505515426,MATH 202A,A00,087415,Gill; Philip E.,3,0,8,5
1653505515956,MATH 203A,A00,087416,Oprea; Dragos N.,6,0,8,2
1653505516487,MATH 204A,A00,087417,Kedlaya; Kiran S.,6,0,8,2
1653505517011,MATH 205,A00,087418,Sorensen; Claus M,6,0,8,2
1653505517537,MATH 206A,A00,087419,Izadi; Elham,7,0,8,1
1653505518060,MATH 207A,A00,087420,Mohammadi; Amir,5,0,8,3
1653505518585,MATH 208,A00,087421,Staff,9,0,10,1
1653505519109,MATH 209,A00,087422,Staff,10,0,10,0
1653505519640,MATH 218,A00,087423,Staff,10,0,10,0
1653505520164,MATH 220A,A00,087424,Novak; Jonathan I,7,0,8,1
1653505520687,MATH 231A,A00,087425,Bejenaru; Ioan,3,0,8,5
1653505521213,MATH 240A,A00,087426,Ebenfelt; Peter F,5,0,8,3
1653505521736,MATH 243,A00,087427,Staff,9,0,10,1
1653505522264,MATH 248,A00,087429,Staff,10,0,10,0
1653505522817,MATH 250A,A00,087430,Spolaor; Luca,4,0,8,4
1653505523343,MATH 257A,A00,087431,Spolaor; Luca,7,0,8,1
1653505523865,MATH 258,A00,087432,Staff,9,0,10,1
1653505524394,MATH 264A,A00,087433,Warnke; Lutz Peter,5,0,8,3
1653505524924,MATH 268,A00,087434,Staff,15,0,15,0
1653505525459,MATH 269,A00,087435,Staff,14,0,15,1
1653505526061,MATH 270A,A00,087436,Nie; Jiawang,0,0,8,8
1653505526595,MATH 272A,A00,087437,Tian; Xiaochuan,1,0,8,7
1653505527137,MATH 274,A01,087439,Cheng; Li-Tien,9,0,10,1
1653505527137,MATH 274,A02,087440,Cheng; Li-Tien,10,0,10,0
1653505527661,MATH 278A,A00,087441,Staff,8,0,10,2
1653505528184,MATH 278B,A00,087442,Staff,8,0,10,2
1653505528707,MATH 278C,A00,087443,Staff,8,0,10,2
1653505529235,MATH 280A,A00,087444,Zheng; Tianyi,0,0,8,8
1653505529763,MATH 281A,A00,087445,Bradic; Jelena,0,0,8,8
1653505530285,MATH 282A,A00,087446,Zhang; Danna,0,0,8,8
1653505530810,MATH 283,A00,087447,Tesler; Glenn,0,0,0,15
1653505531333,MATH 286,A00,087448,Kemp; Todd Aahron,5,0,8,3
1653505531855,MATH 287D,A00,087449,Bradic; Jelena,8,0,8,0
1653505532380,MATH 288,A00,087450,Staff,14,0,15,1
1653505532380,MATH 288,B00,087451,Staff,15,0,15,0
1653505532380,MATH 288,C00,087452,Staff,15,0,15,0
1653505532921,MATH 290A,A00,087453,Xu; Zhouli,6,0,8,2
1653505533452,MATH 291A,A00,087454,Xu; Zhouli,7,0,8,1
1653505533974,MATH 292,A00,087455,Staff,10,0,10,0
1653505534498,MATH 295,A00,087456,Staff,50,0,50,0
1653505535025,MATH 297,001,087457,Staff,998,0,999,1
1653506107997,COGS 200,A01,087991,Staff,47,0,50,3
1653506108527,COGS 201,A01,094504,Rangel; Lara M,17,0,25,8
1653506109064,COGS 203,A00,087992,Coulson; Seana M,18,0,20,2
1653506109589,COGS 210A,001,087993,Greene; Deanna Jacquelyn,9998,0,9999,1
1653506109589,COGS 210A,002,087994,Saygin; Ayse P,9999,0,9999,0
1653506109589,COGS 210A,003,087995,Xia; Haijun,9999,0,9999,0
1653506109589,COGS 210A,004,087996,Nitz; Douglas A.,9999,0,9999,0
1653506109589,COGS 210A,005,087997,Hollan; James D.,9999,0,9999,0
1653506109589,COGS 210A,006,087998,Deak; Gedeon O.,9998,0,9999,1
1653506109589,COGS 210A,007,087999,Rossano; Federico,9999,0,9999,0
1653506110123,COGS 211A,A00,088000,Coulson; Seana M,9997,0,9999,2
1653506110654,COGS 229,A00,088002,Staff,23,0,25,2
1653506111186,COGS 260,B00,094231,Staff,17,0,20,3
1653506111186,COGS 260,A00,088004,Nitz; Douglas A.,9998,0,9999,1
1653506111709,CSE 202,A00,090110,Paturi; Ramamohan,0,0,0,0
1653506111709,CSE 202,B00,090111,Paturi; Ramamohan,0,0,0,0
1653506112231,CSE 207B,A00,090112,Heninger; Nadia A,0,0,0,0
1653506112753,CSE 208,A00,094858,Micciancio; Daniele,0,0,0,0
1653506113279,CSE 210,A00,090113,Powell; Thomas Allan,0,0,0,0
1653506113819,CSE 219,A00,090898,Staff,0,0,0,0
1653506114346,CSE 221,A00,090114,Zhou; Yuan-Yuan,0,0,0,0
1653506114869,CSE 229A,A00,090115,Porter; George M,0,0,0,0
1653506115408,CSE 229C,A00,090116,Savage; Stefan,0,0,0,0
1653506115930,CSE 230,A00,090117,Jhala; Ranjit,0,0,0,0
1653506116466,CSE 232,A00,090118,Papakonstantinou; Yannis,0,0,0,0
1653506116988,CSE 239A,A00,090121,Kumar; Arun Kumar,0,0,0,0
1653506117514,CSE 239B,A00,090122,Jhala; Ranjit,0,0,0,0
1653506118040,CSE 240A,A00,090123,Zhao; Jishen,0,0,189,189
1653506118565,CSE 243A,A00,090124,Orailoglu; Alex,0,0,15,15
1653506119088,CSE 249B,A00,090125,Kahng; Andrew Byun,13,0,20,7
1653506119624,CSE 250A,A00,090126,Berg-Kirkpatrick; Taylor D,0,0,0,0
1653506120173,CSE 252A,A00,090127,Ochoa; Benjamin Lawrence,0,0,0,0
1653506120697,CSE 258,A01,090129,McAuley; Julian John,0,0,0,0
1653506121230,CSE 258R,A01,090131,McAuley; Julian John,0,0,0,0
1653506121756,CSE 274,A00,090132,Ramamoorthi; Ravi,0,0,0,0
1653506122290,CSE 276A,A00,090133,Christensen; Henrik I,0,0,0,0
1653506122824,CSE 276C,A00,090134,Christensen; Henrik I,0,0,0,0
1653506123347,CSE 290,A00,090135,Bafna; Vineet,0,0,0,0
1653506123347,CSE 290,B00,090136,Ramamoorthi; Ravi,0,0,0,0
1653506123347,CSE 290,C00,090137,Li; Tzumao,9,0,10,1
1653506123347,CSE 290,D00,090138,Zhou; Yuan-Yuan,10,0,10,0
1653506123347,CSE 290,E00,090139,Christensen; Henrik I,10,0,10,0
1653506123347,CSE 290,F00,094053,Shalev; Aaron D,0,0,0,0
1653506123887,CSE 291,A00,090140,Munyaka; Imani N. S.,0,0,0,0
1653506123887,CSE 291,B00,094880,Yu; Qi,0,0,0,0
1653506123887,CSE 291,C00,090142,Pannuto; Patrick William,0,0,0,0
1653506123887,CSE 291,D00,094881,Zhang; Yiying,0,0,0,0
1653506123887,CSE 291,E00,095118,Su; Hao,0,0,0,0
1653506124416,CSE 293,001,094905,Bafna; Vineet,9999,0,9999,0
1653506124416,CSE 293,002,094906,Bellare; Mihir,9999,0,9999,0
1653506124416,CSE 293,003,094907,Berg-Kirkpatrick; Taylor D,9999,0,9999,0
1653506124416,CSE 293,004,094908,Christensen; Henrik I,9999,0,9999,0
1653506124416,CSE 293,005,094909,Cottrell; Garrison W,9999,0,9999,0
1653506124416,CSE 293,006,094910,Deutsch; Alin Bernard,9999,0,9999,0
1653506124416,CSE 293,007,094911,Esmaeilzadeh; Hadi,9999,0,9999,0
1653506124416,CSE 293,008,094912,Freund; Yoav,9999,0,9999,0
1653506124416,CSE 293,009,094913,Griswold; William G.,9999,0,9999,0
1653506124416,CSE 293,010,094914,Gymrek; Melissa Ann,9999,0,9999,0
1653506124416,CSE 293,011,094915,Heninger; Nadia A,9999,0,9999,0
1653506124416,CSE 293,012,094916,Impagliazzo; Russell,9999,0,9999,0
1653506124416,CSE 293,013,094917,Jhala; Ranjit,9999,0,9999,0
1653506124416,CSE 293,014,094918,Kahng; Andrew Byun,9999,0,9999,0
1653506124416,CSE 293,015,094919,Kane; Daniel Mertz,9999,0,9999,0
1653506124416,CSE 293,016,094920,Kriegman; David J,9999,0,9999,0
1653506124416,CSE 293,017,094921,Kumar; Arun Kumar,9999,0,9999,0
1653506124416,CSE 293,018,094922,Lerner; Sorin,9999,0,9999,0
1653506124416,CSE 293,019,094923,Lovett; Shachar,9999,0,9999,0
1653506124416,CSE 293,020,094924,McAuley; Julian John,9999,0,9999,0
1653506124416,CSE 293,021,094925,Micciancio; Daniele,9999,0,9999,0
1653506124416,CSE 293,022,094926,Orailoglu; Alex,9999,0,9999,0
1653506124416,CSE 293,023,094927,Paturi; Ramamohan,9999,0,9999,0
1653506124416,CSE 293,024,094928,Polikarpova; Nadezhda,9999,0,9999,0
1653506124416,CSE 293,025,094929,Politz; Joseph Gibbs,9999,0,9999,0
1653506124416,CSE 293,026,094930,Porter; George M,9999,0,9999,0
1653506124416,CSE 293,027,094931,Porter; Leonard Emerson,9999,0,9999,0
1653506124416,CSE 293,028,094932,Ramamoorthi; Ravi,9999,0,9999,0
1653506124416,CSE 293,029,094933,Sahoo; Debashis,9999,0,9999,0
1653506124416,CSE 293,030,094934,Saul; Lawrence,9999,0,9999,0
1653506124416,CSE 293,031,094935,Savage; Stefan,9999,0,9999,0
1653506124416,CSE 293,032,094936,Schulze; Jurgen P.,9999,0,9999,0
1653506124416,CSE 293,033,094937,Snoeren; Alex C.,9999,0,9999,0
1653506124416,CSE 293,034,094938,Shang; Jingbo,9999,0,9999,0
1653506124416,CSE 293,035,094939,Stefan; Deian,9999,0,9999,0
1653506124416,CSE 293,036,094940,Su; Hao,9999,0,9999,0
1653506124416,CSE 293,037,094941,Swanson; Steven James,9999,0,9999,0
1653506124416,CSE 293,038,094942,Tullsen; Dean Michael,9999,0,9999,0
1653506124416,CSE 293,039,094943,Voelker; Geoffrey M.,9999,0,9999,0
1653506124416,CSE 293,040,094944,Zhao; Jishen,9999,0,9999,0
1653506124416,CSE 293,041,094945,Zhou; Yuan-Yuan,9999,0,9999,0
1653506124416,CSE 293,042,094946,Gao; Sicun,9998,0,9999,1
1653506124416,CSE 293,043,094947,Weibel; Nadir,9999,0,9999,0
1653506124416,CSE 293,044,094948,Gupta; Rajesh K.,9999,0,9999,0
1653506124943,CSE 294,A00,090143,Porter; George M,8,0,10,2
1653506125481,DSE 200,A00,091799,Staff,50,0,50,0
1653506126020,DSE 203,A00,091800,Gupta; Amarnath,30,0,30,0
1653506126618,DSE 250,A00,091801,Deutsch; Alin Bernard,30,0,30,0
1653506127146,DSE 290,A00,091802,Altintas De Callaf; Ilkay,50,0,50,0
1653506127689,ECE 200,001,091003,Antipa; Nicholas A,9999,0,9999,0
1653506127689,ECE 200,002,091004,Atanasov; Nikolay A.,9999,0,9999,0
1653506127689,ECE 200,003,091005,Bharadia; Dinesh,9999,0,9999,0
1653506127689,ECE 200,004,091006,Cheng; Chung Kuan,9999,0,9999,0
1653506127689,ECE 200,005,091007,Cosman; Pamela C.,9999,0,9999,0
1653506127689,ECE 200,006,091008,Staff,9999,0,9999,0
1653506127689,ECE 200,007,091009,Dayeh; Shadi Ahmad,9999,0,9999,0
1653506127689,ECE 200,008,091010,Fainman; Yeshaiahu,9999,0,9999,0
1653506127689,ECE 200,009,091011,Ford; Joseph Earl,9999,0,9999,0
1653506127689,ECE 200,010,091012,Franceschetti; Massimo,9999,0,9999,0
1653506127689,ECE 200,011,091013,Fullerton; Eric E,9999,0,9999,0
1653506127689,ECE 200,012,091014,Galton; Ian A,9999,0,9999,0
1653506127689,ECE 200,013,091015,Gilja; Vikash,9999,0,9999,0
1653506127689,ECE 200,014,091016,Hall; Drew A.,9999,0,9999,0
1653506127689,ECE 200,015,091017,Hsueh; Tzu-Chien,9999,0,9999,0
1653506127689,ECE 200,016,091018,Javidi; Tara,9999,0,9999,0
1653506127689,ECE 200,017,091019,Kahng; Andrew Byun,9999,0,9999,0
1653506127689,ECE 200,018,091020,Kim; Young-Han,9999,0,9999,0
1653506127689,ECE 200,019,091021,Koushanfar; Farinaz,9999,0,9999,0
1653506127689,ECE 200,020,091022,Kuzum; Duygu,9999,0,9999,0
1653506127689,ECE 200,021,091023,Le; Hanh-Phuc,9999,0,9999,0
1653506127689,ECE 200,022,091024,Lin; Bill,9999,0,9999,0
1653506127689,ECE 200,023,091025,Liu; Zhaowei,9999,0,9999,0
1653506127689,ECE 200,024,091026,Lo; Yu-Hwa,9999,0,9999,0
1653506127689,ECE 200,025,091027,Lomakin; Vitaliy,9999,0,9999,0
1653506127689,ECE 200,026,091028,Mercier; Patrick Philip,9999,0,9999,0
1653506127689,ECE 200,027,091029,Meyer; Florian,9999,0,9999,0
1653506127689,ECE 200,028,091030,Milstein; Laurence B.,9999,0,9999,0
1653506127689,ECE 200,029,091031,Mir Arabbaygi; Siavash,9999,0,9999,0
1653506127689,ECE 200,030,091032,Mookherjea; Shayan,9999,0,9999,0
1653506127689,ECE 200,031,091033,Morris; Karcher William,9999,0,9999,0
1653506127689,ECE 200,032,091034,Ng; Tse Nga,9999,0,9999,0
1653506127689,ECE 200,033,091035,Nguyen; Truong Quang,9999,0,9999,0
1653506127689,ECE 200,034,091036,Nomura; Kenji,9999,0,9999,0
1653506127689,ECE 200,035,091037,Orlitsky; Alon,9999,0,9999,0
1653506127689,ECE 200,036,091038,Pal; Piya,9999,0,9999,0
1653506127689,ECE 200,037,091039,Papen; George C.,9999,0,9999,0
1653506127689,ECE 200,038,091040,Radic; Stojan,9999,0,9999,0
1653506127689,ECE 200,039,091041,Rao; Bhaskar D.,9999,0,9999,0
1653506127689,ECE 200,040,091042,Rao; Ramesh R,9999,0,9999,0
1653506127689,ECE 200,041,091043,Rebeiz; Gabriel,9999,0,9999,0
1653506127689,ECE 200,042,091044,Sanford; John R,9999,0,9999,0
1653506127689,ECE 200,043,091045,Siegel; Paul H.,9999,0,9999,0
1653506127689,ECE 200,044,091046,Sievenpiper; Daniel F.,9999,0,9999,0
1653506127689,ECE 200,045,091047,Sworder; David D.,9999,0,9999,0
1653506127689,ECE 200,046,091048,Taur; Yuan,9999,0,9999,0
1653506127689,ECE 200,047,091049,Touri; Behrouz,9999,0,9999,0
1653506127689,ECE 200,048,091050,Trivedi; Mohan M.,9999,0,9999,0
1653506127689,ECE 200,049,091051,Vardy; Alexander,9999,0,9999,0
1653506127689,ECE 200,050,091052,Vasconcelos; Nuno,9999,0,9999,0
1653506127689,ECE 200,051,091053,Wang; Xiaolong,9999,0,9999,0
1653506127689,ECE 200,052,091054,Xie; Pengtao,9999,0,9999,0
1653506127689,ECE 200,053,091055,Yip; Michael,9999,0,9999,0
1653506127689,ECE 200,054,091056,Zeger; Kenneth A.,9999,0,9999,0
1653506127689,ECE 200,055,091057,Zhang; Xinyu,9999,0,9999,0
1653506127689,ECE 200,056,091058,Turakhia; Yatish Girish,9999,0,9999,0
1653506127689,ECE 200,057,091059,Kang; Mingu,9999,0,9999,0
1653506127689,ECE 200,058,091060,Shi; Yuanyuan,9999,0,9999,0
1653506127689,ECE 200,059,091061,Wang; Edward Jay,9999,0,9999,0
1653506127689,ECE 200,060,091062,Zheng; Yang,9999,0,9999,0
1653506128211,ECE 201,A00,095526,Lo; Yu-Hwa,50,0,50,0
1653506128734,ECE 203,A00,091065,Mercier; Patrick Philip,0,0,0,0
1653506129258,ECE 207A,A00,091605,Liu; Thomas Tao-Ming,0,0,0,0
1653506129780,ECE 212AN,A00,091068,Nomura; Kenji,0,0,0,0
1653506130308,ECE 222A,A00,091069,Rebeiz; Gabriel,0,0,0,0
1653506130837,ECE 225A,A00,091070,Orlitsky; Alon,0,0,0,0
1653506131360,ECE 230A,A00,091071,Nomura; Kenji,0,0,0,0
1653506131883,ECE 236A,A00,091072,Dayeh; Shadi Ahmad,0,0,0,0
1653506132420,ECE 238A,A00,091073,Luo; Jian,0,0,0,0
1653506132420,ECE 238A,B00,091074,Luo; Jian,0,0,0,0
1653506132948,ECE 240A,A00,091075,Radic; Stojan,0,0,0,0
1653506133471,ECE 247A,A00,091592,Shi; Lingyan,0,0,0,0
1653506133994,ECE 250,A00,091076,Touri; Behrouz,0,0,0,0
1653506134516,ECE 251C,A00,091078,Nguyen; Truong Quang,0,0,0,0
1653506135043,ECE 253,A00,091079,Cosman; Pamela C.,0,0,0,0
1653506135566,ECE 255A,A00,091080,Orlitsky; Alon,0,0,0,0
1653506136088,ECE 257A,A00,091081,Zhang; Xinyu,0,0,0,0
1653506136615,ECE 260A,A01,091084,Eldon; John,0,0,0,0
1653506137151,ECE 264C,A00,091085,Galton; Ian A,0,0,0,0
1653506137679,ECE 265C,A00,094889,Presti; Calogero Davide,0,0,0,9
1653506138201,ECE 266,A01,091087,Hall; Drew A.,0,0,0,0
1653506139251,ECE 271A,A00,091090,Vasconcelos; Nuno,0,0,0,0
1653506139778,ECE 272B,A00,091091,Sworder; David D.,0,0,0,0
1653506140316,ECE 275A,A00,091092,Meyer; Florian,0,0,0,0
1653506140839,ECE 277,A00,091093,An; Cheolhong,0,0,0,0
1653506141372,ECE 283,A00,091094,Le; Hanh-Phuc,0,0,0,0
1653506141896,ECE 284,A00,091095,Kang; Mingu,0,0,0,0
1653506141896,ECE 284,B00,091096,Wang; Edward Jay,0,0,0,0
1653506142423,ECE 285,A00,094334,Touri; Behrouz,0,0,0,0
1653506142960,ECE 289,A00,091097,Whelan; David Arthur,0,0,0,0
1653506143487,MATH 200A,A00,087414,Salehi Golsefidy; Alireza,7,0,8,1
1653506144012,MATH 202A,A00,087415,Gill; Philip E.,3,0,8,5
1653506144538,MATH 203A,A00,087416,Oprea; Dragos N.,6,0,8,2
1653506145075,MATH 204A,A00,087417,Kedlaya; Kiran S.,6,0,8,2
1653506145606,MATH 205,A00,087418,Sorensen; Claus M,6,0,8,2
1653506146130,MATH 206A,A00,087419,Izadi; Elham,7,0,8,1
1653506146662,MATH 207A,A00,087420,Mohammadi; Amir,5,0,8,3
1653506147185,MATH 208,A00,087421,Staff,9,0,10,1
1653506147714,MATH 209,A00,087422,Staff,10,0,10,0
1653506148244,MATH 218,A00,087423,Staff,10,0,10,0
1653506148779,MATH 220A,A00,087424,Novak; Jonathan I,7,0,8,1
1653506149303,MATH 231A,A00,087425,Bejenaru; Ioan,3,0,8,5
1653506149829,MATH 240A,A00,087426,Ebenfelt; Peter F,5,0,8,3
1653506150354,MATH 243,A00,087427,Staff,9,0,10,1
1653506150878,MATH 248,A00,087429,Staff,10,0,10,0
1653506151417,MATH 250A,A00,087430,Spolaor; Luca,4,0,8,4
1653506151940,MATH 257A,A00,087431,Spolaor; Luca,7,0,8,1
1653506152476,MATH 258,A00,087432,Staff,9,0,10,1
1653506153003,MATH 264A,A00,087433,Warnke; Lutz Peter,5,0,8,3
1653506153527,MATH 268,A00,087434,Staff,15,0,15,0
1653506154055,MATH 269,A00,087435,Staff,14,0,15,1
1653506154579,MATH 270A,A00,087436,Nie; Jiawang,0,0,8,8
1653506155102,MATH 272A,A00,087437,Tian; Xiaochuan,1,0,8,7
1653506155633,MATH 274,A01,087439,Cheng; Li-Tien,9,0,10,1
1653506155633,MATH 274,A02,087440,Cheng; Li-Tien,10,0,10,0
1653506156158,MATH 278A,A00,087441,Staff,8,0,10,2
1653506156681,MATH 278B,A00,087442,Staff,8,0,10,2
1653506157212,MATH 278C,A00,087443,Staff,8,0,10,2
1653506157739,MATH 280A,A00,087444,Zheng; Tianyi,0,0,8,8
1653506158262,MATH 281A,A00,087445,Bradic; Jelena,0,0,8,8
1653506158784,MATH 282A,A00,087446,Zhang; Danna,0,0,8,8
1653506159322,MATH 283,A00,087447,Tesler; Glenn,0,0,0,15
1653506159854,MATH 286,A00,087448,Kemp; Todd Aahron,5,0,8,3
1653506160377,MATH 287D,A00,087449,Bradic; Jelena,8,0,8,0
1653506160904,MATH 288,A00,087450,Staff,14,0,15,1
1653506160904,MATH 288,B00,087451,Staff,15,0,15,0
1653506160904,MATH 288,C00,087452,Staff,15,0,15,0
1653506161433,MATH 290A,A00,087453,Xu; Zhouli,6,0,8,2
1653506161973,MATH 291A,A00,087454,Xu; Zhouli,7,0,8,1
1653506162503,MATH 292,A00,087455,Staff,10,0,10,0
1653506163037,MATH 295,A00,087456,Staff,50,0,50,0
1653506163559,MATH 297,001,087457,Staff,998,0,999,1
1653506725925,COGS 200,A01,087991,Staff,47,0,50,3
1653506726451,COGS 201,A01,094504,Rangel; Lara M,17,0,25,8
1653506726975,COGS 203,A00,087992,Coulson; Seana M,18,0,20,2
1653506727499,COGS 210A,001,087993,Greene; Deanna Jacquelyn,9998,0,9999,1
1653506727499,COGS 210A,002,087994,Saygin; Ayse P,9999,0,9999,0
1653506727499,COGS 210A,003,087995,Xia; Haijun,9999,0,9999,0
1653506727499,COGS 210A,004,087996,Nitz; Douglas A.,9999,0,9999,0
1653506727499,COGS 210A,005,087997,Hollan; James D.,9999,0,9999,0
1653506727499,COGS 210A,006,087998,Deak; Gedeon O.,9998,0,9999,1
1653506727499,COGS 210A,007,087999,Rossano; Federico,9999,0,9999,0
1653506728034,COGS 211A,A00,088000,Coulson; Seana M,9997,0,9999,2
1653506728570,COGS 229,A00,088002,Staff,23,0,25,2
1653506729119,COGS 260,B00,094231,Staff,17,0,20,3
1653506729119,COGS 260,A00,088004,Nitz; Douglas A.,9998,0,9999,1
1653506729644,CSE 202,A00,090110,Paturi; Ramamohan,0,0,0,0
1653506729644,CSE 202,B00,090111,Paturi; Ramamohan,0,0,0,0
1653506730180,CSE 207B,A00,090112,Heninger; Nadia A,0,0,0,0
1653506730708,CSE 208,A00,094858,Micciancio; Daniele,0,0,0,0
1653506731235,CSE 210,A00,090113,Powell; Thomas Allan,0,0,0,0
1653506731756,CSE 219,A00,090898,Staff,0,0,0,0
1653506732289,CSE 221,A00,090114,Zhou; Yuan-Yuan,0,0,0,0
1653506732811,CSE 229A,A00,090115,Porter; George M,0,0,0,0
1653506733338,CSE 229C,A00,090116,Savage; Stefan,0,0,0,0
1653506733873,CSE 230,A00,090117,Jhala; Ranjit,0,0,0,0
1653506734409,CSE 232,A00,090118,Papakonstantinou; Yannis,0,0,0,0
1653506734935,CSE 239A,A00,090121,Kumar; Arun Kumar,0,0,0,0
1653506735458,CSE 239B,A00,090122,Jhala; Ranjit,0,0,0,0
1653506735992,CSE 240A,A00,090123,Zhao; Jishen,0,0,189,189
1653506736516,CSE 243A,A00,090124,Orailoglu; Alex,0,0,15,15
1653506737041,CSE 249B,A00,090125,Kahng; Andrew Byun,13,0,20,7
1653506737563,CSE 250A,A00,090126,Berg-Kirkpatrick; Taylor D,0,0,0,0
1653506738086,CSE 252A,A00,090127,Ochoa; Benjamin Lawrence,0,0,0,0
1653506738611,CSE 258,A01,090129,McAuley; Julian John,0,0,0,0
1653506739135,CSE 258R,A01,090131,McAuley; Julian John,0,0,0,0
1653506739662,CSE 274,A00,090132,Ramamoorthi; Ravi,0,0,0,0
1653506740194,CSE 276A,A00,090133,Christensen; Henrik I,0,0,0,0
1653506740719,CSE 276C,A00,090134,Christensen; Henrik I,0,0,0,0
1653506741246,CSE 290,A00,090135,Bafna; Vineet,0,0,0,0
1653506741246,CSE 290,B00,090136,Ramamoorthi; Ravi,0,0,0,0
1653506741246,CSE 290,C00,090137,Li; Tzumao,9,0,10,1
1653506741246,CSE 290,D00,090138,Zhou; Yuan-Yuan,10,0,10,0
1653506741246,CSE 290,E00,090139,Christensen; Henrik I,10,0,10,0
1653506741246,CSE 290,F00,094053,Shalev; Aaron D,0,0,0,0
1653506741771,CSE 291,A00,090140,Munyaka; Imani N. S.,0,0,0,0
1653506741771,CSE 291,B00,094880,Yu; Qi,0,0,0,0
1653506741771,CSE 291,C00,090142,Pannuto; Patrick William,0,0,0,0
1653506741771,CSE 291,D00,094881,Zhang; Yiying,0,0,0,0
1653506741771,CSE 291,E00,095118,Su; Hao,0,0,0,0
1653506742297,CSE 293,001,094905,Bafna; Vineet,9999,0,9999,0
1653506742297,CSE 293,002,094906,Bellare; Mihir,9999,0,9999,0
1653506742297,CSE 293,003,094907,Berg-Kirkpatrick; Taylor D,9999,0,9999,0
1653506742297,CSE 293,004,094908,Christensen; Henrik I,9999,0,9999,0
1653506742297,CSE 293,005,094909,Cottrell; Garrison W,9999,0,9999,0
1653506742297,CSE 293,006,094910,Deutsch; Alin Bernard,9999,0,9999,0
1653506742297,CSE 293,007,094911,Esmaeilzadeh; Hadi,9999,0,9999,0
1653506742297,CSE 293,008,094912,Freund; Yoav,9999,0,9999,0
1653506742297,CSE 293,009,094913,Griswold; William G.,9999,0,9999,0
1653506742297,CSE 293,010,094914,Gymrek; Melissa Ann,9999,0,9999,0
1653506742297,CSE 293,011,094915,Heninger; Nadia A,9999,0,9999,0
1653506742297,CSE 293,012,094916,Impagliazzo; Russell,9999,0,9999,0
1653506742297,CSE 293,013,094917,Jhala; Ranjit,9999,0,9999,0
1653506742297,CSE 293,014,094918,Kahng; Andrew Byun,9999,0,9999,0
1653506742297,CSE 293,015,094919,Kane; Daniel Mertz,9999,0,9999,0
1653506742297,CSE 293,016,094920,Kriegman; David J,9999,0,9999,0
1653506742297,CSE 293,017,094921,Kumar; Arun Kumar,9999,0,9999,0
1653506742297,CSE 293,018,094922,Lerner; Sorin,9999,0,9999,0
1653506742297,CSE 293,019,094923,Lovett; Shachar,9999,0,9999,0
1653506742297,CSE 293,020,094924,McAuley; Julian John,9999,0,9999,0
1653506742297,CSE 293,021,094925,Micciancio; Daniele,9999,0,9999,0
1653506742297,CSE 293,022,094926,Orailoglu; Alex,9999,0,9999,0
1653506742297,CSE 293,023,094927,Paturi; Ramamohan,9999,0,9999,0
1653506742297,CSE 293,024,094928,Polikarpova; Nadezhda,9999,0,9999,0
1653506742297,CSE 293,025,094929,Politz; Joseph Gibbs,9999,0,9999,0
1653506742297,CSE 293,026,094930,Porter; George M,9999,0,9999,0
1653506742297,CSE 293,027,094931,Porter; Leonard Emerson,9999,0,9999,0
1653506742297,CSE 293,028,094932,Ramamoorthi; Ravi,9999,0,9999,0
1653506742297,CSE 293,029,094933,Sahoo; Debashis,9999,0,9999,0
1653506742297,CSE 293,030,094934,Saul; Lawrence,9999,0,9999,0
1653506742297,CSE 293,031,094935,Savage; Stefan,9999,0,9999,0
1653506742297,CSE 293,032,094936,Schulze; Jurgen P.,9999,0,9999,0
1653506742297,CSE 293,033,094937,Snoeren; Alex C.,9999,0,9999,0
1653506742297,CSE 293,034,094938,Shang; Jingbo,9999,0,9999,0
1653506742297,CSE 293,035,094939,Stefan; Deian,9999,0,9999,0
1653506742297,CSE 293,036,094940,Su; Hao,9999,0,9999,0
1653506742297,CSE 293,037,094941,Swanson; Steven James,9999,0,9999,0
1653506742297,CSE 293,038,094942,Tullsen; Dean Michael,9999,0,9999,0
1653506742297,CSE 293,039,094943,Voelker; Geoffrey M.,9999,0,9999,0
1653506742297,CSE 293,040,094944,Zhao; Jishen,9999,0,9999,0
1653506742297,CSE 293,041,094945,Zhou; Yuan-Yuan,9999,0,9999,0
1653506742297,CSE 293,042,094946,Gao; Sicun,9998,0,9999,1
1653506742297,CSE 293,043,094947,Weibel; Nadir,9999,0,9999,0
1653506742297,CSE 293,044,094948,Gupta; Rajesh K.,9999,0,9999,0
1653506742820,CSE 294,A00,090143,Porter; George M,8,0,10,2
1653506743350,DSE 200,A00,091799,Staff,50,0,50,0
1653506743876,DSE 203,A00,091800,Gupta; Amarnath,30,0,30,0
1653506744400,DSE 250,A00,091801,Deutsch; Alin Bernard,30,0,30,0
1653506744936,DSE 290,A00,091802,Altintas De Callaf; Ilkay,50,0,50,0
1653506745463,ECE 200,001,091003,Antipa; Nicholas A,9999,0,9999,0
1653506745463,ECE 200,002,091004,Atanasov; Nikolay A.,9999,0,9999,0
1653506745463,ECE 200,003,091005,Bharadia; Dinesh,9999,0,9999,0
1653506745463,ECE 200,004,091006,Cheng; Chung Kuan,9999,0,9999,0
1653506745463,ECE 200,005,091007,Cosman; Pamela C.,9999,0,9999,0
1653506745463,ECE 200,006,091008,Staff,9999,0,9999,0
1653506745463,ECE 200,007,091009,Dayeh; Shadi Ahmad,9999,0,9999,0
1653506745463,ECE 200,008,091010,Fainman; Yeshaiahu,9999,0,9999,0
1653506745463,ECE 200,009,091011,Ford; Joseph Earl,9999,0,9999,0
1653506745463,ECE 200,010,091012,Franceschetti; Massimo,9999,0,9999,0
1653506745463,ECE 200,011,091013,Fullerton; Eric E,9999,0,9999,0
1653506745463,ECE 200,012,091014,Galton; Ian A,9999,0,9999,0
1653506745463,ECE 200,013,091015,Gilja; Vikash,9999,0,9999,0
1653506745463,ECE 200,014,091016,Hall; Drew A.,9999,0,9999,0
1653506745463,ECE 200,015,091017,Hsueh; Tzu-Chien,9999,0,9999,0
1653506745463,ECE 200,016,091018,Javidi; Tara,9999,0,9999,0
1653506745463,ECE 200,017,091019,Kahng; Andrew Byun,9999,0,9999,0
1653506745463,ECE 200,018,091020,Kim; Young-Han,9999,0,9999,0
1653506745463,ECE 200,019,091021,Koushanfar; Farinaz,9999,0,9999,0
1653506745463,ECE 200,020,091022,Kuzum; Duygu,9999,0,9999,0
1653506745463,ECE 200,021,091023,Le; Hanh-Phuc,9999,0,9999,0
1653506745463,ECE 200,022,091024,Lin; Bill,9999,0,9999,0
1653506745463,ECE 200,023,091025,Liu; Zhaowei,9999,0,9999,0
1653506745463,ECE 200,024,091026,Lo; Yu-Hwa,9999,0,9999,0
1653506745463,ECE 200,025,091027,Lomakin; Vitaliy,9999,0,9999,0
1653506745463,ECE 200,026,091028,Mercier; Patrick Philip,9999,0,9999,0
1653506745463,ECE 200,027,091029,Meyer; Florian,9999,0,9999,0
1653506745463,ECE 200,028,091030,Milstein; Laurence B.,9999,0,9999,0
1653506745463,ECE 200,029,091031,Mir Arabbaygi; Siavash,9999,0,9999,0
1653506745463,ECE 200,030,091032,Mookherjea; Shayan,9999,0,9999,0
1653506745463,ECE 200,031,091033,Morris; Karcher William,9999,0,9999,0
1653506745463,ECE 200,032,091034,Ng; Tse Nga,9999,0,9999,0
1653506745463,ECE 200,033,091035,Nguyen; Truong Quang,9999,0,9999,0
1653506745463,ECE 200,034,091036,Nomura; Kenji,9999,0,9999,0
1653506745463,ECE 200,035,091037,Orlitsky; Alon,9999,0,9999,0
1653506745463,ECE 200,036,091038,Pal; Piya,9999,0,9999,0
1653506745463,ECE 200,037,091039,Papen; George C.,9999,0,9999,0
1653506745463,ECE 200,038,091040,Radic; Stojan,9999,0,9999,0
1653506745463,ECE 200,039,091041,Rao; Bhaskar D.,9999,0,9999,0
1653506745463,ECE 200,040,091042,Rao; Ramesh R,9999,0,9999,0
1653506745463,ECE 200,041,091043,Rebeiz; Gabriel,9999,0,9999,0
1653506745463,ECE 200,042,091044,Sanford; John R,9999,0,9999,0
1653506745463,ECE 200,043,091045,Siegel; Paul H.,9999,0,9999,0
1653506745463,ECE 200,044,091046,Sievenpiper; Daniel F.,9999,0,9999,0
1653506745463,ECE 200,045,091047,Sworder; David D.,9999,0,9999,0
1653506745463,ECE 200,046,091048,Taur; Yuan,9999,0,9999,0
1653506745463,ECE 200,047,091049,Touri; Behrouz,9999,0,9999,0
1653506745463,ECE 200,048,091050,Trivedi; Mohan M.,9999,0,9999,0
1653506745463,ECE 200,049,091051,Vardy; Alexander,9999,0,9999,0
1653506745463,ECE 200,050,091052,Vasconcelos; Nuno,9999,0,9999,0
1653506745463,ECE 200,051,091053,Wang; Xiaolong,9999,0,9999,0
1653506745463,ECE 200,052,091054,Xie; Pengtao,9999,0,9999,0
1653506745463,ECE 200,053,091055,Yip; Michael,9999,0,9999,0
1653506745463,ECE 200,054,091056,Zeger; Kenneth A.,9999,0,9999,0
1653506745463,ECE 200,055,091057,Zhang; Xinyu,9999,0,9999,0
1653506745463,ECE 200,056,091058,Turakhia; Yatish Girish,9999,0,9999,0
1653506745463,ECE 200,057,091059,Kang; Mingu,9999,0,9999,0
1653506745463,ECE 200,058,091060,Shi; Yuanyuan,9999,0,9999,0
1653506745463,ECE 200,059,091061,Wang; Edward Jay,9999,0,9999,0
1653506745463,ECE 200,060,091062,Zheng; Yang,9999,0,9999,0
1653506746003,ECE 201,A00,095526,Lo; Yu-Hwa,50,0,50,0
1653506746530,ECE 203,A00,091065,Mercier; Patrick Philip,0,0,0,0
1653506747057,ECE 207A,A00,091605,Liu; Thomas Tao-Ming,0,0,0,0
1653506747583,ECE 212AN,A00,091068,Nomura; Kenji,0,0,0,0
1653506748105,ECE 222A,A00,091069,Rebeiz; Gabriel,0,0,0,0
1653506748631,ECE 225A,A00,091070,Orlitsky; Alon,0,0,0,0
1653506749156,ECE 230A,A00,091071,Nomura; Kenji,0,0,0,0
1653506749682,ECE 236A,A00,091072,Dayeh; Shadi Ahmad,0,0,0,0
1653506750217,ECE 238A,A00,091073,Luo; Jian,0,0,0,0
1653506750217,ECE 238A,B00,091074,Luo; Jian,0,0,0,0
1653506750747,ECE 240A,A00,091075,Radic; Stojan,0,0,0,0
1653506751279,ECE 247A,A00,091592,Shi; Lingyan,0,0,0,0
1653506751805,ECE 250,A00,091076,Touri; Behrouz,0,0,0,0
1653506752339,ECE 251C,A00,091078,Nguyen; Truong Quang,0,0,0,0
1653506752877,ECE 253,A00,091079,Cosman; Pamela C.,0,0,0,0
1653506753403,ECE 255A,A00,091080,Orlitsky; Alon,0,0,0,0
1653506753931,ECE 257A,A00,091081,Zhang; Xinyu,0,0,0,0
1653506754456,ECE 260A,A01,091084,Eldon; John,0,0,0,0
1653506754981,ECE 264C,A00,091085,Galton; Ian A,0,0,0,0
1653506755518,ECE 265C,A00,094889,Presti; Calogero Davide,0,0,0,9
1653506756044,ECE 266,A01,091087,Hall; Drew A.,0,0,0,0
1653506757112,ECE 271A,A00,091090,Vasconcelos; Nuno,0,0,0,0
1653506757647,ECE 272B,A00,091091,Sworder; David D.,0,0,0,0
1653506758170,ECE 275A,A00,091092,Meyer; Florian,0,0,0,0
1653506758692,ECE 277,A00,091093,An; Cheolhong,0,0,0,0
1653506759224,ECE 283,A00,091094,Le; Hanh-Phuc,0,0,0,0
1653506759750,ECE 284,A00,091095,Kang; Mingu,0,0,0,0
1653506759750,ECE 284,B00,091096,Wang; Edward Jay,0,0,0,0
1653506760278,ECE 285,A00,094334,Touri; Behrouz,0,0,0,0
1653506760805,ECE 289,A00,091097,Whelan; David Arthur,0,0,0,0
1653506761340,MATH 200A,A00,087414,Salehi Golsefidy; Alireza,7,0,8,1
1653506761882,MATH 202A,A00,087415,Gill; Philip E.,3,0,8,5
1653506762408,MATH 203A,A00,087416,Oprea; Dragos N.,6,0,8,2
1653506762936,MATH 204A,A00,087417,Kedlaya; Kiran S.,6,0,8,2
1653506763474,MATH 205,A00,087418,Sorensen; Claus M,6,0,8,2
1653506763997,MATH 206A,A00,087419,Izadi; Elham,7,0,8,1
1653506764521,MATH 207A,A00,087420,Mohammadi; Amir,5,0,8,3
1653506765046,MATH 208,A00,087421,Staff,9,0,10,1
1653506765575,MATH 209,A00,087422,Staff,10,0,10,0
1653506766097,MATH 218,A00,087423,Staff,10,0,10,0
1653506766625,MATH 220A,A00,087424,Novak; Jonathan I,7,0,8,1
1653506767149,MATH 231A,A00,087425,Bejenaru; Ioan,3,0,8,5
1653506767673,MATH 240A,A00,087426,Ebenfelt; Peter F,5,0,8,3
1653506768197,MATH 243,A00,087427,Staff,9,0,10,1
1653506768723,MATH 248,A00,087429,Staff,10,0,10,0
1653506769245,MATH 250A,A00,087430,Spolaor; Luca,4,0,8,4
1653506769875,MATH 257A,A00,087431,Spolaor; Luca,7,0,8,1
1653506770398,MATH 258,A00,087432,Staff,9,0,10,1
1653506770924,MATH 264A,A00,087433,Warnke; Lutz Peter,5,0,8,3
1653506771455,MATH 268,A00,087434,Staff,15,0,15,0
1653506771988,MATH 269,A00,087435,Staff,14,0,15,1
1653506772514,MATH 270A,A00,087436,Nie; Jiawang,0,0,8,8
1653506773040,MATH 272A,A00,087437,Tian; Xiaochuan,1,0,8,7
1653506773564,MATH 274,A01,087439,Cheng; Li-Tien,9,0,10,1
1653506773564,MATH 274,A02,087440,Cheng; Li-Tien,10,0,10,0
1653506774095,MATH 278A,A00,087441,Staff,8,0,10,2
1653506774621,MATH 278B,A00,087442,Staff,8,0,10,2
1653506775156,MATH 278C,A00,087443,Staff,8,0,10,2
1653506775690,MATH 280A,A00,087444,Zheng; Tianyi,0,0,8,8
1653506776217,MATH 281A,A00,087445,Bradic; Jelena,0,0,8,8
1653506776742,MATH 282A,A00,087446,Zhang; Danna,0,0,8,8
1653506777268,MATH 283,A00,087447,Tesler; Glenn,0,0,0,15
1653506777801,MATH 286,A00,087448,Kemp; Todd Aahron,5,0,8,3
1653506778330,MATH 287D,A00,087449,Bradic; Jelena,8,0,8,0
1653506778878,MATH 288,A00,087450,Staff,14,0,15,1
1653506778878,MATH 288,B00,087451,Staff,15,0,15,0
1653506778878,MATH 288,C00,087452,Staff,15,0,15,0
1653506779402,MATH 290A,A00,087453,Xu; Zhouli,6,0,8,2
1653506779925,MATH 291A,A00,087454,Xu; Zhouli,7,0,8,1
1653506780451,MATH 292,A00,087455,Staff,10,0,10,0
1653506780975,MATH 295,A00,087456,Staff,50,0,50,0
1653506781501,MATH 297,001,087457,Staff,998,0,999,1
1653507342847,COGS 200,A01,087991,Staff,47,0,50,3
1653507343370,COGS 201,A01,094504,Rangel; Lara M,17,0,25,8
1653507343906,COGS 203,A00,087992,Coulson; Seana M,18,0,20,2
1653507344435,COGS 210A,001,087993,Greene; Deanna Jacquelyn,9998,0,9999,1
1653507344435,COGS 210A,002,087994,Saygin; Ayse P,9999,0,9999,0
1653507344435,COGS 210A,003,087995,Xia; Haijun,9999,0,9999,0
1653507344435,COGS 210A,004,087996,Nitz; Douglas A.,9999,0,9999,0
1653507344435,COGS 210A,005,087997,Hollan; James D.,9999,0,9999,0
1653507344435,COGS 210A,006,087998,Deak; Gedeon O.,9998,0,9999,1
1653507344435,COGS 210A,007,087999,Rossano; Federico,9999,0,9999,0
1653507344961,COGS 211A,A00,088000,Coulson; Seana M,9997,0,9999,2
1653507345500,COGS 229,A00,088002,Staff,23,0,25,2
1653507346024,COGS 260,B00,094231,Staff,17,0,20,3
1653507346024,COGS 260,A00,088004,Nitz; Douglas A.,9998,0,9999,1
1653507346551,CSE 202,A00,090110,Paturi; Ramamohan,0,0,0,0
1653507346551,CSE 202,B00,090111,Paturi; Ramamohan,0,0,0,0
1653507347083,CSE 207B,A00,090112,Heninger; Nadia A,0,0,0,0
1653507347609,CSE 208,A00,094858,Micciancio; Daniele,0,0,0,0
1653507348131,CSE 210,A00,090113,Powell; Thomas Allan,0,0,0,0
1653507348653,CSE 219,A00,090898,Staff,0,0,0,0
1653507349175,CSE 221,A00,090114,Zhou; Yuan-Yuan,0,0,0,0
1653507349702,CSE 229A,A00,090115,Porter; George M,0,0,0,0
1653507350225,CSE 229C,A00,090116,Savage; Stefan,0,0,0,0
1653507350754,CSE 230,A00,090117,Jhala; Ranjit,0,0,0,0
1653507351279,CSE 232,A00,090118,Papakonstantinou; Yannis,0,0,0,0
1653507351802,CSE 239A,A00,090121,Kumar; Arun Kumar,0,0,0,0
1653507352331,CSE 239B,A00,090122,Jhala; Ranjit,0,0,0,0
1653507352854,CSE 240A,A00,090123,Zhao; Jishen,0,0,189,189
1653507353377,CSE 243A,A00,090124,Orailoglu; Alex,0,0,15,15
1653507353911,CSE 249B,A00,090125,Kahng; Andrew Byun,13,0,20,7
1653507354433,CSE 250A,A00,090126,Berg-Kirkpatrick; Taylor D,0,0,0,0
1653507354961,CSE 252A,A00,090127,Ochoa; Benjamin Lawrence,0,0,0,0
1653507355486,CSE 258,A01,090129,McAuley; Julian John,0,0,0,0
1653507356007,CSE 258R,A01,090131,McAuley; Julian John,0,0,0,0
1653507356533,CSE 274,A00,090132,Ramamoorthi; Ravi,0,0,0,0
1653507357057,CSE 276A,A00,090133,Christensen; Henrik I,0,0,0,0
1653507357584,CSE 276C,A00,090134,Christensen; Henrik I,0,0,0,0
1653507358111,CSE 290,A00,090135,Bafna; Vineet,0,0,0,0
1653507358111,CSE 290,B00,090136,Ramamoorthi; Ravi,0,0,0,0
1653507358111,CSE 290,C00,090137,Li; Tzumao,9,0,10,1
1653507358111,CSE 290,D00,090138,Zhou; Yuan-Yuan,10,0,10,0
1653507358111,CSE 290,E00,090139,Christensen; Henrik I,10,0,10,0
1653507358111,CSE 290,F00,094053,Shalev; Aaron D,0,0,0,0
1653507358725,CSE 291,A00,090140,Munyaka; Imani N. S.,0,0,0,0
1653507358725,CSE 291,B00,094880,Yu; Qi,0,0,0,0
1653507358725,CSE 291,C00,090142,Pannuto; Patrick William,0,0,0,0
1653507358725,CSE 291,D00,094881,Zhang; Yiying,0,0,0,0
1653507358725,CSE 291,E00,095118,Su; Hao,0,0,0,0
1653507359274,CSE 293,001,094905,Bafna; Vineet,9999,0,9999,0
1653507359274,CSE 293,002,094906,Bellare; Mihir,9999,0,9999,0
1653507359274,CSE 293,003,094907,Berg-Kirkpatrick; Taylor D,9999,0,9999,0
1653507359274,CSE 293,004,094908,Christensen; Henrik I,9999,0,9999,0
1653507359274,CSE 293,005,094909,Cottrell; Garrison W,9999,0,9999,0
1653507359274,CSE 293,006,094910,Deutsch; Alin Bernard,9999,0,9999,0
1653507359274,CSE 293,007,094911,Esmaeilzadeh; Hadi,9999,0,9999,0
1653507359274,CSE 293,008,094912,Freund; Yoav,9999,0,9999,0
1653507359274,CSE 293,009,094913,Griswold; William G.,9999,0,9999,0
1653507359274,CSE 293,010,094914,Gymrek; Melissa Ann,9999,0,9999,0
1653507359274,CSE 293,011,094915,Heninger; Nadia A,9999,0,9999,0
1653507359274,CSE 293,012,094916,Impagliazzo; Russell,9999,0,9999,0
1653507359274,CSE 293,013,094917,Jhala; Ranjit,9999,0,9999,0
1653507359274,CSE 293,014,094918,Kahng; Andrew Byun,9999,0,9999,0
1653507359274,CSE 293,015,094919,Kane; Daniel Mertz,9999,0,9999,0
1653507359274,CSE 293,016,094920,Kriegman; David J,9999,0,9999,0
1653507359274,CSE 293,017,094921,Kumar; Arun Kumar,9999,0,9999,0
1653507359274,CSE 293,018,094922,Lerner; Sorin,9999,0,9999,0
1653507359274,CSE 293,019,094923,Lovett; Shachar,9999,0,9999,0
1653507359274,CSE 293,020,094924,McAuley; Julian John,9999,0,9999,0
1653507359274,CSE 293,021,094925,Micciancio; Daniele,9999,0,9999,0
1653507359274,CSE 293,022,094926,Orailoglu; Alex,9999,0,9999,0
1653507359274,CSE 293,023,094927,Paturi; Ramamohan,9999,0,9999,0
1653507359274,CSE 293,024,094928,Polikarpova; Nadezhda,9999,0,9999,0
1653507359274,CSE 293,025,094929,Politz; Joseph Gibbs,9999,0,9999,0
1653507359274,CSE 293,026,094930,Porter; George M,9999,0,9999,0
1653507359274,CSE 293,027,094931,Porter; Leonard Emerson,9999,0,9999,0
1653507359274,CSE 293,028,094932,Ramamoorthi; Ravi,9999,0,9999,0
1653507359274,CSE 293,029,094933,Sahoo; Debashis,9999,0,9999,0
1653507359274,CSE 293,030,094934,Saul; Lawrence,9999,0,9999,0
1653507359274,CSE 293,031,094935,Savage; Stefan,9999,0,9999,0
1653507359274,CSE 293,032,094936,Schulze; Jurgen P.,9999,0,9999,0
1653507359274,CSE 293,033,094937,Snoeren; Alex C.,9999,0,9999,0
1653507359274,CSE 293,034,094938,Shang; Jingbo,9999,0,9999,0
1653507359274,CSE 293,035,094939,Stefan; Deian,9999,0,9999,0
1653507359274,CSE 293,036,094940,Su; Hao,9999,0,9999,0
1653507359274,CSE 293,037,094941,Swanson; Steven James,9999,0,9999,0
1653507359274,CSE 293,038,094942,Tullsen; Dean Michael,9999,0,9999,0
1653507359274,CSE 293,039,094943,Voelker; Geoffrey M.,9999,0,9999,0
1653507359274,CSE 293,040,094944,Zhao; Jishen,9999,0,9999,0
1653507359274,CSE 293,041,094945,Zhou; Yuan-Yuan,9999,0,9999,0
1653507359274,CSE 293,042,094946,Gao; Sicun,9998,0,9999,1
1653507359274,CSE 293,043,094947,Weibel; Nadir,9999,0,9999,0
1653507359274,CSE 293,044,094948,Gupta; Rajesh K.,9999,0,9999,0
1653507359795,CSE 294,A00,090143,Porter; George M,8,0,10,2
1653507360335,DSE 200,A00,091799,Staff,50,0,50,0
1653507360872,DSE 203,A00,091800,Gupta; Amarnath,30,0,30,0
1653507361404,DSE 250,A00,091801,Deutsch; Alin Bernard,30,0,30,0
1653507361933,DSE 290,A00,091802,Altintas De Callaf; Ilkay,50,0,50,0
1653507362475,ECE 200,001,091003,Antipa; Nicholas A,9999,0,9999,0
1653507362475,ECE 200,002,091004,Atanasov; Nikolay A.,9999,0,9999,0
1653507362475,ECE 200,003,091005,Bharadia; Dinesh,9999,0,9999,0
1653507362475,ECE 200,004,091006,Cheng; Chung Kuan,9999,0,9999,0
1653507362475,ECE 200,005,091007,Cosman; Pamela C.,9999,0,9999,0
1653507362475,ECE 200,006,091008,Staff,9999,0,9999,0
1653507362475,ECE 200,007,091009,Dayeh; Shadi Ahmad,9999,0,9999,0
1653507362475,ECE 200,008,091010,Fainman; Yeshaiahu,9999,0,9999,0
1653507362475,ECE 200,009,091011,Ford; Joseph Earl,9999,0,9999,0
1653507362475,ECE 200,010,091012,Franceschetti; Massimo,9999,0,9999,0
1653507362475,ECE 200,011,091013,Fullerton; Eric E,9999,0,9999,0
1653507362475,ECE 200,012,091014,Galton; Ian A,9999,0,9999,0
1653507362475,ECE 200,013,091015,Gilja; Vikash,9999,0,9999,0
1653507362475,ECE 200,014,091016,Hall; Drew A.,9999,0,9999,0
1653507362475,ECE 200,015,091017,Hsueh; Tzu-Chien,9999,0,9999,0
1653507362475,ECE 200,016,091018,Javidi; Tara,9999,0,9999,0
1653507362475,ECE 200,017,091019,Kahng; Andrew Byun,9999,0,9999,0
1653507362475,ECE 200,018,091020,Kim; Young-Han,9999,0,9999,0
1653507362475,ECE 200,019,091021,Koushanfar; Farinaz,9999,0,9999,0
1653507362475,ECE 200,020,091022,Kuzum; Duygu,9999,0,9999,0
1653507362475,ECE 200,021,091023,Le; Hanh-Phuc,9999,0,9999,0
1653507362475,ECE 200,022,091024,Lin; Bill,9999,0,9999,0
1653507362475,ECE 200,023,091025,Liu; Zhaowei,9999,0,9999,0
1653507362475,ECE 200,024,091026,Lo; Yu-Hwa,9999,0,9999,0
1653507362475,ECE 200,025,091027,Lomakin; Vitaliy,9999,0,9999,0
1653507362475,ECE 200,026,091028,Mercier; Patrick Philip,9999,0,9999,0
1653507362475,ECE 200,027,091029,Meyer; Florian,9999,0,9999,0
1653507362475,ECE 200,028,091030,Milstein; Laurence B.,9999,0,9999,0
1653507362475,ECE 200,029,091031,Mir Arabbaygi; Siavash,9999,0,9999,0
1653507362475,ECE 200,030,091032,Mookherjea; Shayan,9999,0,9999,0
1653507362475,ECE 200,031,091033,Morris; Karcher William,9999,0,9999,0
1653507362475,ECE 200,032,091034,Ng; Tse Nga,9999,0,9999,0
1653507362475,ECE 200,033,091035,Nguyen; Truong Quang,9999,0,9999,0
1653507362475,ECE 200,034,091036,Nomura; Kenji,9999,0,9999,0
1653507362475,ECE 200,035,091037,Orlitsky; Alon,9999,0,9999,0
1653507362475,ECE 200,036,091038,Pal; Piya,9999,0,9999,0
1653507362475,ECE 200,037,091039,Papen; George C.,9999,0,9999,0
1653507362475,ECE 200,038,091040,Radic; Stojan,9999,0,9999,0
1653507362475,ECE 200,039,091041,Rao; Bhaskar D.,9999,0,9999,0
1653507362475,ECE 200,040,091042,Rao; Ramesh R,9999,0,9999,0
1653507362475,ECE 200,041,091043,Rebeiz; Gabriel,9999,0,9999,0
1653507362475,ECE 200,042,091044,Sanford; John R,9999,0,9999,0
1653507362475,ECE 200,043,091045,Siegel; Paul H.,9999,0,9999,0
1653507362475,ECE 200,044,091046,Sievenpiper; Daniel F.,9999,0,9999,0
1653507362475,ECE 200,045,091047,Sworder; David D.,9999,0,9999,0
1653507362475,ECE 200,046,091048,Taur; Yuan,9999,0,9999,0
1653507362475,ECE 200,047,091049,Touri; Behrouz,9999,0,9999,0
1653507362475,ECE 200,048,091050,Trivedi; Mohan M.,9999,0,9999,0
1653507362475,ECE 200,049,091051,Vardy; Alexander,9999,0,9999,0
1653507362475,ECE 200,050,091052,Vasconcelos; Nuno,9999,0,9999,0
1653507362475,ECE 200,051,091053,Wang; Xiaolong,9999,0,9999,0
1653507362475,ECE 200,052,091054,Xie; Pengtao,9999,0,9999,0
1653507362475,ECE 200,053,091055,Yip; Michael,9999,0,9999,0
1653507362475,ECE 200,054,091056,Zeger; Kenneth A.,9999,0,9999,0
1653507362475,ECE 200,055,091057,Zhang; Xinyu,9999,0,9999,0
1653507362475,ECE 200,056,091058,Turakhia; Yatish Girish,9999,0,9999,0
1653507362475,ECE 200,057,091059,Kang; Mingu,9999,0,9999,0
1653507362475,ECE 200,058,091060,Shi; Yuanyuan,9999,0,9999,0
1653507362475,ECE 200,059,091061,Wang; Edward Jay,9999,0,9999,0
1653507362475,ECE 200,060,091062,Zheng; Yang,9999,0,9999,0
1653507363003,ECE 201,A00,095526,Lo; Yu-Hwa,50,0,50,0
1653507363537,ECE 203,A00,091065,Mercier; Patrick Philip,0,0,0,0
1653507364059,ECE 207A,A00,091605,Liu; Thomas Tao-Ming,0,0,0,0
1653507364584,ECE 212AN,A00,091068,Nomura; Kenji,0,0,0,0
1653507365106,ECE 222A,A00,091069,Rebeiz; Gabriel,0,0,0,0
1653507365634,ECE 225A,A00,091070,Orlitsky; Alon,0,0,0,0
1653507366157,ECE 230A,A00,091071,Nomura; Kenji,0,0,0,0
1653507366683,ECE 236A,A00,091072,Dayeh; Shadi Ahmad,0,0,0,0
1653507367212,ECE 238A,A00,091073,Luo; Jian,0,0,0,0
1653507367212,ECE 238A,B00,091074,Luo; Jian,0,0,0,0
1653507367735,ECE 240A,A00,091075,Radic; Stojan,0,0,0,0
1653507368263,ECE 247A,A00,091592,Shi; Lingyan,0,0,0,0
1653507368787,ECE 250,A00,091076,Touri; Behrouz,0,0,0,0
1653507369308,ECE 251C,A00,091078,Nguyen; Truong Quang,0,0,0,0
1653507369830,ECE 253,A00,091079,Cosman; Pamela C.,0,0,0,0
1653507370366,ECE 255A,A00,091080,Orlitsky; Alon,0,0,0,0
1653507370887,ECE 257A,A00,091081,Zhang; Xinyu,0,0,0,0
1653507371438,ECE 260A,A01,091084,Eldon; John,0,0,0,0
1653507371960,ECE 264C,A00,091085,Galton; Ian A,0,0,0,0
1653507372484,ECE 265C,A00,094889,Presti; Calogero Davide,0,0,0,9
1653507373013,ECE 266,A01,091087,Hall; Drew A.,0,0,0,0
1653507374058,ECE 271A,A00,091090,Vasconcelos; Nuno,0,0,0,0
1653507374581,ECE 272B,A00,091091,Sworder; David D.,0,0,0,0
1653507375107,ECE 275A,A00,091092,Meyer; Florian,0,0,0,0
1653507375631,ECE 277,A00,091093,An; Cheolhong,0,0,0,0
1653507376157,ECE 283,A00,091094,Le; Hanh-Phuc,0,0,0,0
1653507376684,ECE 284,A00,091095,Kang; Mingu,0,0,0,0
1653507376684,ECE 284,B00,091096,Wang; Edward Jay,0,0,0,0
1653507377209,ECE 285,A00,094334,Touri; Behrouz,0,0,0,0
1653507377735,ECE 289,A00,091097,Whelan; David Arthur,0,0,0,0
1653507378266,MATH 200A,A00,087414,Salehi Golsefidy; Alireza,7,0,8,1
1653507378793,MATH 202A,A00,087415,Gill; Philip E.,3,0,8,5
1653507379323,MATH 203A,A00,087416,Oprea; Dragos N.,6,0,8,2
1653507379848,MATH 204A,A00,087417,Kedlaya; Kiran S.,6,0,8,2
1653507380381,MATH 205,A00,087418,Sorensen; Claus M,6,0,8,2
1653507380919,MATH 206A,A00,087419,Izadi; Elham,7,0,8,1
1653507381454,MATH 207A,A00,087420,Mohammadi; Amir,5,0,8,3
1653507381977,MATH 208,A00,087421,Staff,9,0,10,1
1653507382517,MATH 209,A00,087422,Staff,10,0,10,0
1653507383048,MATH 218,A00,087423,Staff,10,0,10,0
1653507383571,MATH 220A,A00,087424,Novak; Jonathan I,7,0,8,1
1653507384093,MATH 231A,A00,087425,Bejenaru; Ioan,3,0,8,5
1653507384620,MATH 240A,A00,087426,Ebenfelt; Peter F,5,0,8,3
1653507385147,MATH 243,A00,087427,Staff,9,0,10,1
1653507385677,MATH 248,A00,087429,Staff,10,0,10,0
1653507386200,MATH 250A,A00,087430,Spolaor; Luca,4,0,8,4
1653507386725,MATH 257A,A00,087431,Spolaor; Luca,7,0,8,1
1653507387249,MATH 258,A00,087432,Staff,9,0,10,1
1653507387776,MATH 264A,A00,087433,Warnke; Lutz Peter,5,0,8,3
1653507388299,MATH 268,A00,087434,Staff,15,0,15,0
1653507388835,MATH 269,A00,087435,Staff,14,0,15,1
1653507389365,MATH 270A,A00,087436,Nie; Jiawang,0,0,8,8
1653507389892,MATH 272A,A00,087437,Tian; Xiaochuan,1,0,8,7
1653507390415,MATH 274,A01,087439,Cheng; Li-Tien,9,0,10,1
1653507390415,MATH 274,A02,087440,Cheng; Li-Tien,10,0,10,0
1653507390938,MATH 278A,A00,087441,Staff,8,0,10,2
1653507391461,MATH 278B,A00,087442,Staff,8,0,10,2
1653507391987,MATH 278C,A00,087443,Staff,8,0,10,2
1653507392518,MATH 280A,A00,087444,Zheng; Tianyi,0,0,8,8
1653507393041,MATH 281A,A00,087445,Bradic; Jelena,0,0,8,8
1653507393563,MATH 282A,A00,087446,Zhang; Danna,0,0,8,8
1653507394096,MATH 283,A00,087447,Tesler; Glenn,0,0,0,15
1653507394622,MATH 286,A00,087448,Kemp; Todd Aahron,5,0,8,3
1653507395146,MATH 287D,A00,087449,Bradic; Jelena,8,0,8,0
1653507395668,MATH 288,A00,087450,Staff,14,0,15,1
1653507395668,MATH 288,B00,087451,Staff,15,0,15,0
1653507395668,MATH 288,C00,087452,Staff,15,0,15,0
1653507396205,MATH 290A,A00,087453,Xu; Zhouli,6,0,8,2
1653507396732,MATH 291A,A00,087454,Xu; Zhouli,7,0,8,1
1653507397261,MATH 292,A00,087455,Staff,10,0,10,0
1653507397784,MATH 295,A00,087456,Staff,50,0,50,0
1653507398306,MATH 297,001,087457,Staff,998,0,999,1
1653507959845,COGS 200,A01,087991,Staff,47,0,50,3
1653507960372,COGS 201,A01,094504,Rangel; Lara M,17,0,25,8
1653507960916,COGS 203,A00,087992,Coulson; Seana M,18,0,20,2
1653507961448,COGS 210A,001,087993,Greene; Deanna Jacquelyn,9998,0,9999,1
1653507961448,COGS 210A,002,087994,Saygin; Ayse P,9999,0,9999,0
1653507961448,COGS 210A,003,087995,Xia; Haijun,9999,0,9999,0
1653507961448,COGS 210A,004,087996,Nitz; Douglas A.,9999,0,9999,0
1653507961448,COGS 210A,005,087997,Hollan; James D.,9999,0,9999,0
1653507961448,COGS 210A,006,087998,Deak; Gedeon O.,9998,0,9999,1
1653507961448,COGS 210A,007,087999,Rossano; Federico,9999,0,9999,0
1653507961972,COGS 211A,A00,088000,Coulson; Seana M,9997,0,9999,2
1653507962501,COGS 229,A00,088002,Staff,23,0,25,2
1653507963031,COGS 260,B00,094231,Staff,17,0,20,3
1653507963031,COGS 260,A00,088004,Nitz; Douglas A.,9998,0,9999,1
1653507963556,CSE 202,A00,090110,Paturi; Ramamohan,0,0,0,0
1653507963556,CSE 202,B00,090111,Paturi; Ramamohan,0,0,0,0
1653507964080,CSE 207B,A00,090112,Heninger; Nadia A,0,0,0,0
1653507964606,CSE 208,A00,094858,Micciancio; Daniele,0,0,0,0
1653507965133,CSE 210,A00,090113,Powell; Thomas Allan,0,0,0,0
1653507965661,CSE 219,A00,090898,Staff,0,0,0,0
1653507966187,CSE 221,A00,090114,Zhou; Yuan-Yuan,0,0,0,0
1653507966721,CSE 229A,A00,090115,Porter; George M,0,0,0,0
1653507967244,CSE 229C,A00,090116,Savage; Stefan,0,0,0,0
1653507967768,CSE 230,A00,090117,Jhala; Ranjit,0,0,0,0
1653507968292,CSE 232,A00,090118,Papakonstantinou; Yannis,0,0,0,0
1653507968823,CSE 239A,A00,090121,Kumar; Arun Kumar,0,0,0,0
1653507969348,CSE 239B,A00,090122,Jhala; Ranjit,0,0,0,0
1653507969874,CSE 240A,A00,090123,Zhao; Jishen,0,0,189,189
1653507970416,CSE 243A,A00,090124,Orailoglu; Alex,0,0,15,15
1653507970949,CSE 249B,A00,090125,Kahng; Andrew Byun,13,0,20,7
1653507971487,CSE 250A,A00,090126,Berg-Kirkpatrick; Taylor D,0,0,0,0
1653507972010,CSE 252A,A00,090127,Ochoa; Benjamin Lawrence,0,0,0,0
1653507972541,CSE 258,A01,090129,McAuley; Julian John,0,0,0,0
1653507973068,CSE 258R,A01,090131,McAuley; Julian John,0,0,0,0
1653507973596,CSE 274,A00,090132,Ramamoorthi; Ravi,0,0,0,0
1653507974120,CSE 276A,A00,090133,Christensen; Henrik I,0,0,0,0
1653507974643,CSE 276C,A00,090134,Christensen; Henrik I,0,0,0,0
1653507975169,CSE 290,A00,090135,Bafna; Vineet,0,0,0,0
1653507975169,CSE 290,B00,090136,Ramamoorthi; Ravi,0,0,0,0
1653507975169,CSE 290,C00,090137,Li; Tzumao,9,0,10,1
1653507975169,CSE 290,D00,090138,Zhou; Yuan-Yuan,10,0,10,0
1653507975169,CSE 290,E00,090139,Christensen; Henrik I,10,0,10,0
1653507975169,CSE 290,F00,094053,Shalev; Aaron D,0,0,0,0
1653507975692,CSE 291,A00,090140,Munyaka; Imani N. S.,0,0,0,0
1653507975692,CSE 291,B00,094880,Yu; Qi,0,0,0,0
1653507975692,CSE 291,C00,090142,Pannuto; Patrick William,0,0,0,0
1653507975692,CSE 291,D00,094881,Zhang; Yiying,0,0,0,0
1653507975692,CSE 291,E00,095118,Su; Hao,0,0,0,0
1653507976219,CSE 293,001,094905,Bafna; Vineet,9999,0,9999,0
1653507976219,CSE 293,002,094906,Bellare; Mihir,9999,0,9999,0
1653507976219,CSE 293,003,094907,Berg-Kirkpatrick; Taylor D,9999,0,9999,0
1653507976219,CSE 293,004,094908,Christensen; Henrik I,9999,0,9999,0
1653507976219,CSE 293,005,094909,Cottrell; Garrison W,9999,0,9999,0
1653507976219,CSE 293,006,094910,Deutsch; Alin Bernard,9999,0,9999,0
1653507976219,CSE 293,007,094911,Esmaeilzadeh; Hadi,9999,0,9999,0
1653507976219,CSE 293,008,094912,Freund; Yoav,9999,0,9999,0
1653507976219,CSE 293,009,094913,Griswold; William G.,9999,0,9999,0
1653507976219,CSE 293,010,094914,Gymrek; Melissa Ann,9999,0,9999,0
1653507976219,CSE 293,011,094915,Heninger; Nadia A,9999,0,9999,0
1653507976219,CSE 293,012,094916,Impagliazzo; Russell,9999,0,9999,0
1653507976219,CSE 293,013,094917,Jhala; Ranjit,9999,0,9999,0
1653507976219,CSE 293,014,094918,Kahng; Andrew Byun,9999,0,9999,0
1653507976219,CSE 293,015,094919,Kane; Daniel Mertz,9999,0,9999,0
1653507976219,CSE 293,016,094920,Kriegman; David J,9999,0,9999,0
1653507976219,CSE 293,017,094921,Kumar; Arun Kumar,9999,0,9999,0
1653507976219,CSE 293,018,094922,Lerner; Sorin,9999,0,9999,0
1653507976219,CSE 293,019,094923,Lovett; Shachar,9999,0,9999,0
1653507976219,CSE 293,020,094924,McAuley; Julian John,9999,0,9999,0
1653507976219,CSE 293,021,094925,Micciancio; Daniele,9999,0,9999,0
1653507976219,CSE 293,022,094926,Orailoglu; Alex,9999,0,9999,0
1653507976219,CSE 293,023,094927,Paturi; Ramamohan,9999,0,9999,0
1653507976219,CSE 293,024,094928,Polikarpova; Nadezhda,9999,0,9999,0
1653507976219,CSE 293,025,094929,Politz; Joseph Gibbs,9999,0,9999,0
1653507976219,CSE 293,026,094930,Porter; George M,9999,0,9999,0
1653507976219,CSE 293,027,094931,Porter; Leonard Emerson,9999,0,9999,0
1653507976219,CSE 293,028,094932,Ramamoorthi; Ravi,9999,0,9999,0
1653507976219,CSE 293,029,094933,Sahoo; Debashis,9999,0,9999,0
1653507976219,CSE 293,030,094934,Saul; Lawrence,9999,0,9999,0
1653507976219,CSE 293,031,094935,Savage; Stefan,9999,0,9999,0
1653507976219,CSE 293,032,094936,Schulze; Jurgen P.,9999,0,9999,0
1653507976219,CSE 293,033,094937,Snoeren; Alex C.,9999,0,9999,0
1653507976219,CSE 293,034,094938,Shang; Jingbo,9999,0,9999,0
1653507976219,CSE 293,035,094939,Stefan; Deian,9999,0,9999,0
1653507976219,CSE 293,036,094940,Su; Hao,9999,0,9999,0
1653507976219,CSE 293,037,094941,Swanson; Steven James,9999,0,9999,0
1653507976219,CSE 293,038,094942,Tullsen; Dean Michael,9999,0,9999,0
1653507976219,CSE 293,039,094943,Voelker; Geoffrey M.,9999,0,9999,0
1653507976219,CSE 293,040,094944,Zhao; Jishen,9999,0,9999,0
1653507976219,CSE 293,041,094945,Zhou; Yuan-Yuan,9999,0,9999,0
1653507976219,CSE 293,042,094946,Gao; Sicun,9998,0,9999,1
1653507976219,CSE 293,043,094947,Weibel; Nadir,9999,0,9999,0
1653507976219,CSE 293,044,094948,Gupta; Rajesh K.,9999,0,9999,0
1653507976742,CSE 294,A00,090143,Porter; George M,8,0,10,2
1653507977266,DSE 200,A00,091799,Staff,50,0,50,0
1653507977791,DSE 203,A00,091800,Gupta; Amarnath,30,0,30,0
1653507978314,DSE 250,A00,091801,Deutsch; Alin Bernard,30,0,30,0
1653507978838,DSE 290,A00,091802,Altintas De Callaf; Ilkay,50,0,50,0
1653507979390,ECE 200,001,091003,Antipa; Nicholas A,9999,0,9999,0
1653507979390,ECE 200,002,091004,Atanasov; Nikolay A.,9999,0,9999,0
1653507979390,ECE 200,003,091005,Bharadia; Dinesh,9999,0,9999,0
1653507979390,ECE 200,004,091006,Cheng; Chung Kuan,9999,0,9999,0
1653507979390,ECE 200,005,091007,Cosman; Pamela C.,9999,0,9999,0
1653507979390,ECE 200,006,091008,Staff,9999,0,9999,0
1653507979390,ECE 200,007,091009,Dayeh; Shadi Ahmad,9999,0,9999,0
1653507979390,ECE 200,008,091010,Fainman; Yeshaiahu,9999,0,9999,0
1653507979390,ECE 200,009,091011,Ford; Joseph Earl,9999,0,9999,0
1653507979390,ECE 200,010,091012,Franceschetti; Massimo,9999,0,9999,0
1653507979390,ECE 200,011,091013,Fullerton; Eric E,9999,0,9999,0
1653507979390,ECE 200,012,091014,Galton; Ian A,9999,0,9999,0
1653507979390,ECE 200,013,091015,Gilja; Vikash,9999,0,9999,0
1653507979390,ECE 200,014,091016,Hall; Drew A.,9999,0,9999,0
1653507979390,ECE 200,015,091017,Hsueh; Tzu-Chien,9999,0,9999,0
1653507979390,ECE 200,016,091018,Javidi; Tara,9999,0,9999,0
1653507979390,ECE 200,017,091019,Kahng; Andrew Byun,9999,0,9999,0
1653507979390,ECE 200,018,091020,Kim; Young-Han,9999,0,9999,0
1653507979390,ECE 200,019,091021,Koushanfar; Farinaz,9999,0,9999,0
1653507979390,ECE 200,020,091022,Kuzum; Duygu,9999,0,9999,0
1653507979390,ECE 200,021,091023,Le; Hanh-Phuc,9999,0,9999,0
1653507979390,ECE 200,022,091024,Lin; Bill,9999,0,9999,0
1653507979390,ECE 200,023,091025,Liu; Zhaowei,9999,0,9999,0
1653507979390,ECE 200,024,091026,Lo; Yu-Hwa,9999,0,9999,0
1653507979390,ECE 200,025,091027,Lomakin; Vitaliy,9999,0,9999,0
1653507979390,ECE 200,026,091028,Mercier; Patrick Philip,9999,0,9999,0
1653507979390,ECE 200,027,091029,Meyer; Florian,9999,0,9999,0
1653507979390,ECE 200,028,091030,Milstein; Laurence B.,9999,0,9999,0
1653507979390,ECE 200,029,091031,Mir Arabbaygi; Siavash,9999,0,9999,0
1653507979390,ECE 200,030,091032,Mookherjea; Shayan,9999,0,9999,0
1653507979390,ECE 200,031,091033,Morris; Karcher William,9999,0,9999,0
1653507979390,ECE 200,032,091034,Ng; Tse Nga,9999,0,9999,0
1653507979390,ECE 200,033,091035,Nguyen; Truong Quang,9999,0,9999,0
1653507979390,ECE 200,034,091036,Nomura; Kenji,9999,0,9999,0
1653507979390,ECE 200,035,091037,Orlitsky; Alon,9999,0,9999,0
1653507979390,ECE 200,036,091038,Pal; Piya,9999,0,9999,0
1653507979390,ECE 200,037,091039,Papen; George C.,9999,0,9999,0
1653507979390,ECE 200,038,091040,Radic; Stojan,9999,0,9999,0
1653507979390,ECE 200,039,091041,Rao; Bhaskar D.,9999,0,9999,0
1653507979390,ECE 200,040,091042,Rao; Ramesh R,9999,0,9999,0
1653507979390,ECE 200,041,091043,Rebeiz; Gabriel,9999,0,9999,0
1653507979390,ECE 200,042,091044,Sanford; John R,9999,0,9999,0
1653507979390,ECE 200,043,091045,Siegel; Paul H.,9999,0,9999,0
1653507979390,ECE 200,044,091046,Sievenpiper; Daniel F.,9999,0,9999,0
1653507979390,ECE 200,045,091047,Sworder; David D.,9999,0,9999,0
1653507979390,ECE 200,046,091048,Taur; Yuan,9999,0,9999,0
1653507979390,ECE 200,047,091049,Touri; Behrouz,9999,0,9999,0
1653507979390,ECE 200,048,091050,Trivedi; Mohan M.,9999,0,9999,0
1653507979390,ECE 200,049,091051,Vardy; Alexander,9999,0,9999,0
1653507979390,ECE 200,050,091052,Vasconcelos; Nuno,9999,0,9999,0
1653507979390,ECE 200,051,091053,Wang; Xiaolong,9999,0,9999,0
1653507979390,ECE 200,052,091054,Xie; Pengtao,9999,0,9999,0
1653507979390,ECE 200,053,091055,Yip; Michael,9999,0,9999,0
1653507979390,ECE 200,054,091056,Zeger; Kenneth A.,9999,0,9999,0
1653507979390,ECE 200,055,091057,Zhang; Xinyu,9999,0,9999,0
1653507979390,ECE 200,056,091058,Turakhia; Yatish Girish,9999,0,9999,0
1653507979390,ECE 200,057,091059,Kang; Mingu,9999,0,9999,0
1653507979390,ECE 200,058,091060,Shi; Yuanyuan,9999,0,9999,0
1653507979390,ECE 200,059,091061,Wang; Edward Jay,9999,0,9999,0
1653507979390,ECE 200,060,091062,Zheng; Yang,9999,0,9999,0
1653507979917,ECE 201,A00,095526,Lo; Yu-Hwa,50,0,50,0
1653507980440,ECE 203,A00,091065,Mercier; Patrick Philip,0,0,0,0
1653507980962,ECE 207A,A00,091605,Liu; Thomas Tao-Ming,0,0,0,0
1653507981491,ECE 212AN,A00,091068,Nomura; Kenji,0,0,0,0
1653507982036,ECE 222A,A00,091069,Rebeiz; Gabriel,0,0,0,0
1653507982572,ECE 225A,A00,091070,Orlitsky; Alon,0,0,0,0
1653507983099,ECE 230A,A00,091071,Nomura; Kenji,0,0,0,0
1653507983622,ECE 236A,A00,091072,Dayeh; Shadi Ahmad,0,0,0,0
1653507984148,ECE 238A,A00,091073,Luo; Jian,0,0,0,0
1653507984148,ECE 238A,B00,091074,Luo; Jian,0,0,0,0
1653507984674,ECE 240A,A00,091075,Radic; Stojan,0,0,0,0
1653507985197,ECE 247A,A00,091592,Shi; Lingyan,0,0,0,0
1653507985720,ECE 250,A00,091076,Touri; Behrouz,0,0,0,0
1653507986254,ECE 251C,A00,091078,Nguyen; Truong Quang,0,0,0,0
1653507986776,ECE 253,A00,091079,Cosman; Pamela C.,0,0,0,0
1653507987299,ECE 255A,A00,091080,Orlitsky; Alon,0,0,0,0
1653507987831,ECE 257A,A00,091081,Zhang; Xinyu,0,0,0,0
1653507988359,ECE 260A,A01,091084,Eldon; John,0,0,0,0
1653507988895,ECE 264C,A00,091085,Galton; Ian A,0,0,0,0
1653507989418,ECE 265C,A00,094889,Presti; Calogero Davide,0,0,0,9
1653507989959,ECE 266,A01,091087,Hall; Drew A.,0,0,0,0
1653507991011,ECE 271A,A00,091090,Vasconcelos; Nuno,0,0,0,0
1653507991537,ECE 272B,A00,091091,Sworder; David D.,0,0,0,0
1653507992062,ECE 275A,A00,091092,Meyer; Florian,0,0,0,0
1653507992584,ECE 277,A00,091093,An; Cheolhong,0,0,0,0
1653507993107,ECE 283,A00,091094,Le; Hanh-Phuc,0,0,0,0
1653507993634,ECE 284,A00,091095,Kang; Mingu,0,0,0,0
1653507993634,ECE 284,B00,091096,Wang; Edward Jay,0,0,0,0
1653507994156,ECE 285,A00,094334,Touri; Behrouz,0,0,0,0
1653507994689,ECE 289,A00,091097,Whelan; David Arthur,0,0,0,0
1653507995216,MATH 200A,A00,087414,Salehi Golsefidy; Alireza,7,0,8,1
1653507995742,MATH 202A,A00,087415,Gill; Philip E.,3,0,8,5
1653507996272,MATH 203A,A00,087416,Oprea; Dragos N.,6,0,8,2
1653507996798,MATH 204A,A00,087417,Kedlaya; Kiran S.,6,0,8,2
1653507997331,MATH 205,A00,087418,Sorensen; Claus M,6,0,8,2
1653507997855,MATH 206A,A00,087419,Izadi; Elham,7,0,8,1
1653507998377,MATH 207A,A00,087420,Mohammadi; Amir,5,0,8,3
1653507998911,MATH 208,A00,087421,Staff,9,0,10,1
1653507999433,MATH 209,A00,087422,Staff,10,0,10,0
1653507999963,MATH 218,A00,087423,Staff,10,0,10,0
1653508000485,MATH 220A,A00,087424,Novak; Jonathan I,7,0,8,1
1653508001079,MATH 231A,A00,087425,Bejenaru; Ioan,3,0,8,5
1653508001601,MATH 240A,A00,087426,Ebenfelt; Peter F,5,0,8,3
1653508002126,MATH 243,A00,087427,Staff,9,0,10,1
1653508002651,MATH 248,A00,087429,Staff,10,0,10,0
1653508003176,MATH 250A,A00,087430,Spolaor; Luca,4,0,8,4
1653508003700,MATH 257A,A00,087431,Spolaor; Luca,7,0,8,1
1653508004222,MATH 258,A00,087432,Staff,9,0,10,1
1653508004749,MATH 264A,A00,087433,Warnke; Lutz Peter,5,0,8,3
1653508005275,MATH 268,A00,087434,Staff,15,0,15,0
1653508005798,MATH 269,A00,087435,Staff,14,0,15,1
1653508006323,MATH 270A,A00,087436,Nie; Jiawang,0,0,8,8
1653508006858,MATH 272A,A00,087437,Tian; Xiaochuan,1,0,8,7
1653508007381,MATH 274,A01,087439,Cheng; Li-Tien,9,0,10,1
1653508007381,MATH 274,A02,087440,Cheng; Li-Tien,10,0,10,0
1653508007907,MATH 278A,A00,087441,Staff,8,0,10,2
1653508008429,MATH 278B,A00,087442,Staff,8,0,10,2
1653508008962,MATH 278C,A00,087443,Staff,8,0,10,2
1653508009484,MATH 280A,A00,087444,Zheng; Tianyi,0,0,8,8
1653508010010,MATH 281A,A00,087445,Bradic; Jelena,0,0,8,8
1653508010534,MATH 282A,A00,087446,Zhang; Danna,0,0,8,8
1653508011056,MATH 283,A00,087447,Tesler; Glenn,0,0,0,15
1653508011593,MATH 286,A00,087448,Kemp; Todd Aahron,5,0,8,3
1653508012119,MATH 287D,A00,087449,Bradic; Jelena,8,0,8,0
1653508012654,MATH 288,A00,087450,Staff,14,0,15,1
1653508012654,MATH 288,B00,087451,Staff,15,0,15,0
1653508012654,MATH 288,C00,087452,Staff,15,0,15,0
1653508013181,MATH 290A,A00,087453,Xu; Zhouli,6,0,8,2
1653508013705,MATH 291A,A00,087454,Xu; Zhouli,7,0,8,1
1653508014238,MATH 292,A00,087455,Staff,10,0,10,0
1653508014765,MATH 295,A00,087456,Staff,50,0,50,0
1653508015290,MATH 297,001,087457,Staff,998,0,999,1
1653508576322,COGS 200,A01,087991,Staff,47,0,50,3
1653508576845,COGS 201,A01,094504,Rangel; Lara M,17,0,25,8
1653508577370,COGS 203,A00,087992,Coulson; Seana M,18,0,20,2
1653508577899,COGS 210A,001,087993,Greene; Deanna Jacquelyn,9998,0,9999,1
1653508577899,COGS 210A,002,087994,Saygin; Ayse P,9999,0,9999,0
1653508577899,COGS 210A,003,087995,Xia; Haijun,9999,0,9999,0
1653508577899,COGS 210A,004,087996,Nitz; Douglas A.,9999,0,9999,0
1653508577899,COGS 210A,005,087997,Hollan; James D.,9999,0,9999,0
1653508577899,COGS 210A,006,087998,Deak; Gedeon O.,9998,0,9999,1
1653508577899,COGS 210A,007,087999,Rossano; Federico,9999,0,9999,0
1653508578422,COGS 211A,A00,088000,Coulson; Seana M,9997,0,9999,2
1653508578954,COGS 229,A00,088002,Staff,23,0,25,2
1653508579491,COGS 260,B00,094231,Staff,17,0,20,3
1653508579491,COGS 260,A00,088004,Nitz; Douglas A.,9998,0,9999,1
1653508580013,CSE 202,A00,090110,Paturi; Ramamohan,0,0,0,0
1653508580013,CSE 202,B00,090111,Paturi; Ramamohan,0,0,0,0
1653508580550,CSE 207B,A00,090112,Heninger; Nadia A,0,0,0,0
1653508581081,CSE 208,A00,094858,Micciancio; Daniele,0,0,0,0
1653508581604,CSE 210,A00,090113,Powell; Thomas Allan,0,0,0,0
1653508582132,CSE 219,A00,090898,Staff,0,0,0,0
1653508582659,CSE 221,A00,090114,Zhou; Yuan-Yuan,0,0,0,0
1653508583186,CSE 229A,A00,090115,Porter; George M,0,0,0,0
1653508583709,CSE 229C,A00,090116,Savage; Stefan,0,0,0,0
1653508584231,CSE 230,A00,090117,Jhala; Ranjit,0,0,0,0
1653508584754,CSE 232,A00,090118,Papakonstantinou; Yannis,0,0,0,0
1653508585276,CSE 239A,A00,090121,Kumar; Arun Kumar,0,0,0,0
1653508585808,CSE 239B,A00,090122,Jhala; Ranjit,0,0,0,0
1653508586341,CSE 240A,A00,090123,Zhao; Jishen,0,0,189,189
1653508586887,CSE 243A,A00,090124,Orailoglu; Alex,0,0,15,15
1653508587409,CSE 249B,A00,090125,Kahng; Andrew Byun,13,0,20,7
1653508587932,CSE 250A,A00,090126,Berg-Kirkpatrick; Taylor D,0,0,0,0
1653508588453,CSE 252A,A00,090127,Ochoa; Benjamin Lawrence,0,0,0,0
1653508588975,CSE 258,A01,090129,McAuley; Julian John,0,0,0,0
1653508589585,CSE 258R,A01,090131,McAuley; Julian John,0,0,0,0
1653508590109,CSE 274,A00,090132,Ramamoorthi; Ravi,0,0,0,0
1653508590640,CSE 276A,A00,090133,Christensen; Henrik I,0,0,0,0
1653508591168,CSE 276C,A00,090134,Christensen; Henrik I,0,0,0,0
1653508591691,CSE 290,A00,090135,Bafna; Vineet,0,0,0,0
1653508591691,CSE 290,B00,090136,Ramamoorthi; Ravi,0,0,0,0
1653508591691,CSE 290,C00,090137,Li; Tzumao,9,0,10,1
1653508591691,CSE 290,D00,090138,Zhou; Yuan-Yuan,10,0,10,0
1653508591691,CSE 290,E00,090139,Christensen; Henrik I,10,0,10,0
1653508591691,CSE 290,F00,094053,Shalev; Aaron D,0,0,0,0
1653508592221,CSE 291,A00,090140,Munyaka; Imani N. S.,0,0,0,0
1653508592221,CSE 291,B00,094880,Yu; Qi,0,0,0,0
1653508592221,CSE 291,C00,090142,Pannuto; Patrick William,0,0,0,0
1653508592221,CSE 291,D00,094881,Zhang; Yiying,0,0,0,0
1653508592221,CSE 291,E00,095118,Su; Hao,0,0,0,0
1653508592757,CSE 293,001,094905,Bafna; Vineet,9999,0,9999,0
1653508592757,CSE 293,002,094906,Bellare; Mihir,9999,0,9999,0
1653508592757,CSE 293,003,094907,Berg-Kirkpatrick; Taylor D,9999,0,9999,0
1653508592757,CSE 293,004,094908,Christensen; Henrik I,9999,0,9999,0
1653508592757,CSE 293,005,094909,Cottrell; Garrison W,9999,0,9999,0
1653508592757,CSE 293,006,094910,Deutsch; Alin Bernard,9999,0,9999,0
1653508592757,CSE 293,007,094911,Esmaeilzadeh; Hadi,9999,0,9999,0
1653508592757,CSE 293,008,094912,Freund; Yoav,9999,0,9999,0
1653508592757,CSE 293,009,094913,Griswold; William G.,9999,0,9999,0
1653508592757,CSE 293,010,094914,Gymrek; Melissa Ann,9999,0,9999,0
1653508592757,CSE 293,011,094915,Heninger; Nadia A,9999,0,9999,0
1653508592757,CSE 293,012,094916,Impagliazzo; Russell,9999,0,9999,0
1653508592757,CSE 293,013,094917,Jhala; Ranjit,9999,0,9999,0
1653508592757,CSE 293,014,094918,Kahng; Andrew Byun,9999,0,9999,0
1653508592757,CSE 293,015,094919,Kane; Daniel Mertz,9999,0,9999,0
1653508592757,CSE 293,016,094920,Kriegman; David J,9999,0,9999,0
1653508592757,CSE 293,017,094921,Kumar; Arun Kumar,9999,0,9999,0
1653508592757,CSE 293,018,094922,Lerner; Sorin,9999,0,9999,0
1653508592757,CSE 293,019,094923,Lovett; Shachar,9999,0,9999,0
1653508592757,CSE 293,020,094924,McAuley; Julian John,9999,0,9999,0
1653508592757,CSE 293,021,094925,Micciancio; Daniele,9999,0,9999,0
1653508592757,CSE 293,022,094926,Orailoglu; Alex,9999,0,9999,0
1653508592757,CSE 293,023,094927,Paturi; Ramamohan,9999,0,9999,0
1653508592757,CSE 293,024,094928,Polikarpova; Nadezhda,9999,0,9999,0
1653508592757,CSE 293,025,094929,Politz; Joseph Gibbs,9999,0,9999,0
1653508592757,CSE 293,026,094930,Porter; George M,9999,0,9999,0
1653508592757,CSE 293,027,094931,Porter; Leonard Emerson,9999,0,9999,0
1653508592757,CSE 293,028,094932,Ramamoorthi; Ravi,9999,0,9999,0
1653508592757,CSE 293,029,094933,Sahoo; Debashis,9999,0,9999,0
1653508592757,CSE 293,030,094934,Saul; Lawrence,9999,0,9999,0
1653508592757,CSE 293,031,094935,Savage; Stefan,9999,0,9999,0
1653508592757,CSE 293,032,094936,Schulze; Jurgen P.,9999,0,9999,0
1653508592757,CSE 293,033,094937,Snoeren; Alex C.,9999,0,9999,0
1653508592757,CSE 293,034,094938,Shang; Jingbo,9999,0,9999,0
1653508592757,CSE 293,035,094939,Stefan; Deian,9999,0,9999,0
1653508592757,CSE 293,036,094940,Su; Hao,9999,0,9999,0
1653508592757,CSE 293,037,094941,Swanson; Steven James,9999,0,9999,0
1653508592757,CSE 293,038,094942,Tullsen; Dean Michael,9999,0,9999,0
1653508592757,CSE 293,039,094943,Voelker; Geoffrey M.,9999,0,9999,0
1653508592757,CSE 293,040,094944,Zhao; Jishen,9999,0,9999,0
1653508592757,CSE 293,041,094945,Zhou; Yuan-Yuan,9999,0,9999,0
1653508592757,CSE 293,042,094946,Gao; Sicun,9998,0,9999,1
1653508592757,CSE 293,043,094947,Weibel; Nadir,9999,0,9999,0
1653508592757,CSE 293,044,094948,Gupta; Rajesh K.,9999,0,9999,0
1653508593280,CSE 294,A00,090143,Porter; George M,8,0,10,2
1653508593803,DSE 200,A00,091799,Staff,50,0,50,0
1653508594324,DSE 203,A00,091800,Gupta; Amarnath,30,0,30,0
1653508594846,DSE 250,A00,091801,Deutsch; Alin Bernard,30,0,30,0
1653508595368,DSE 290,A00,091802,Altintas De Callaf; Ilkay,50,0,50,0
1653508595895,ECE 200,001,091003,Antipa; Nicholas A,9999,0,9999,0
1653508595895,ECE 200,002,091004,Atanasov; Nikolay A.,9999,0,9999,0
1653508595895,ECE 200,003,091005,Bharadia; Dinesh,9999,0,9999,0
1653508595895,ECE 200,004,091006,Cheng; Chung Kuan,9999,0,9999,0
1653508595895,ECE 200,005,091007,Cosman; Pamela C.,9999,0,9999,0
1653508595895,ECE 200,006,091008,Staff,9999,0,9999,0
1653508595895,ECE 200,007,091009,Dayeh; Shadi Ahmad,9999,0,9999,0
1653508595895,ECE 200,008,091010,Fainman; Yeshaiahu,9999,0,9999,0
1653508595895,ECE 200,009,091011,Ford; Joseph Earl,9999,0,9999,0
1653508595895,ECE 200,010,091012,Franceschetti; Massimo,9999,0,9999,0
1653508595895,ECE 200,011,091013,Fullerton; Eric E,9999,0,9999,0
1653508595895,ECE 200,012,091014,Galton; Ian A,9999,0,9999,0
1653508595895,ECE 200,013,091015,Gilja; Vikash,9999,0,9999,0
1653508595895,ECE 200,014,091016,Hall; Drew A.,9999,0,9999,0
1653508595895,ECE 200,015,091017,Hsueh; Tzu-Chien,9999,0,9999,0
1653508595895,ECE 200,016,091018,Javidi; Tara,9999,0,9999,0
1653508595895,ECE 200,017,091019,Kahng; Andrew Byun,9999,0,9999,0
1653508595895,ECE 200,018,091020,Kim; Young-Han,9999,0,9999,0
1653508595895,ECE 200,019,091021,Koushanfar; Farinaz,9999,0,9999,0
1653508595895,ECE 200,020,091022,Kuzum; Duygu,9999,0,9999,0
1653508595895,ECE 200,021,091023,Le; Hanh-Phuc,9999,0,9999,0
1653508595895,ECE 200,022,091024,Lin; Bill,9999,0,9999,0
1653508595895,ECE 200,023,091025,Liu; Zhaowei,9999,0,9999,0
1653508595895,ECE 200,024,091026,Lo; Yu-Hwa,9999,0,9999,0
1653508595895,ECE 200,025,091027,Lomakin; Vitaliy,9999,0,9999,0
1653508595895,ECE 200,026,091028,Mercier; Patrick Philip,9999,0,9999,0
1653508595895,ECE 200,027,091029,Meyer; Florian,9999,0,9999,0
1653508595895,ECE 200,028,091030,Milstein; Laurence B.,9999,0,9999,0
1653508595895,ECE 200,029,091031,Mir Arabbaygi; Siavash,9999,0,9999,0
1653508595895,ECE 200,030,091032,Mookherjea; Shayan,9999,0,9999,0
1653508595895,ECE 200,031,091033,Morris; Karcher William,9999,0,9999,0
1653508595895,ECE 200,032,091034,Ng; Tse Nga,9999,0,9999,0
1653508595895,ECE 200,033,091035,Nguyen; Truong Quang,9999,0,9999,0
1653508595895,ECE 200,034,091036,Nomura; Kenji,9999,0,9999,0
1653508595895,ECE 200,035,091037,Orlitsky; Alon,9999,0,9999,0
1653508595895,ECE 200,036,091038,Pal; Piya,9999,0,9999,0
1653508595895,ECE 200,037,091039,Papen; George C.,9999,0,9999,0
1653508595895,ECE 200,038,091040,Radic; Stojan,9999,0,9999,0
1653508595895,ECE 200,039,091041,Rao; Bhaskar D.,9999,0,9999,0
1653508595895,ECE 200,040,091042,Rao; Ramesh R,9999,0,9999,0
1653508595895,ECE 200,041,091043,Rebeiz; Gabriel,9999,0,9999,0
1653508595895,ECE 200,042,091044,Sanford; John R,9999,0,9999,0
1653508595895,ECE 200,043,091045,Siegel; Paul H.,9999,0,9999,0
1653508595895,ECE 200,044,091046,Sievenpiper; Daniel F.,9999,0,9999,0
1653508595895,ECE 200,045,091047,Sworder; David D.,9999,0,9999,0
1653508595895,ECE 200,046,091048,Taur; Yuan,9999,0,9999,0
1653508595895,ECE 200,047,091049,Touri; Behrouz,9999,0,9999,0
1653508595895,ECE 200,048,091050,Trivedi; Mohan M.,9999,0,9999,0
1653508595895,ECE 200,049,091051,Vardy; Alexander,9999,0,9999,0
1653508595895,ECE 200,050,091052,Vasconcelos; Nuno,9999,0,9999,0
1653508595895,ECE 200,051,091053,Wang; Xiaolong,9999,0,9999,0
1653508595895,ECE 200,052,091054,Xie; Pengtao,9999,0,9999,0
1653508595895,ECE 200,053,091055,Yip; Michael,9999,0,9999,0
1653508595895,ECE 200,054,091056,Zeger; Kenneth A.,9999,0,9999,0
1653508595895,ECE 200,055,091057,Zhang; Xinyu,9999,0,9999,0
1653508595895,ECE 200,056,091058,Turakhia; Yatish Girish,9999,0,9999,0
1653508595895,ECE 200,057,091059,Kang; Mingu,9999,0,9999,0
1653508595895,ECE 200,058,091060,Shi; Yuanyuan,9999,0,9999,0
1653508595895,ECE 200,059,091061,Wang; Edward Jay,9999,0,9999,0
1653508595895,ECE 200,060,091062,Zheng; Yang,9999,0,9999,0
1653508596426,ECE 201,A00,095526,Lo; Yu-Hwa,50,0,50,0
1653508596951,ECE 203,A00,091065,Mercier; Patrick Philip,0,0,0,0
1653508597483,ECE 207A,A00,091605,Liu; Thomas Tao-Ming,0,0,0,0
1653508598014,ECE 212AN,A00,091068,Nomura; Kenji,0,0,0,0
1653508598539,ECE 222A,A00,091069,Rebeiz; Gabriel,0,0,0,0
1653508599062,ECE 225A,A00,091070,Orlitsky; Alon,0,0,0,0
1653508599588,ECE 230A,A00,091071,Nomura; Kenji,0,0,0,0
1653508600110,ECE 236A,A00,091072,Dayeh; Shadi Ahmad,0,0,0,0
1653508600634,ECE 238A,A00,091073,Luo; Jian,0,0,0,0
1653508600634,ECE 238A,B00,091074,Luo; Jian,0,0,0,0
1653508601160,ECE 240A,A00,091075,Radic; Stojan,0,0,0,0
1653508601684,ECE 247A,A00,091592,Shi; Lingyan,0,0,0,0
1653508602207,ECE 250,A00,091076,Touri; Behrouz,0,0,0,0
1653508602732,ECE 251C,A00,091078,Nguyen; Truong Quang,0,0,0,0
1653508603257,ECE 253,A00,091079,Cosman; Pamela C.,0,0,0,0
1653508603793,ECE 255A,A00,091080,Orlitsky; Alon,0,0,0,0
1653508604315,ECE 257A,A00,091081,Zhang; Xinyu,0,0,0,0
1653508604847,ECE 260A,A01,091084,Eldon; John,0,0,0,0
1653508605385,ECE 264C,A00,091085,Galton; Ian A,0,0,0,0
1653508605909,ECE 265C,A00,094889,Presti; Calogero Davide,0,0,0,9
1653508606432,ECE 266,A01,091087,Hall; Drew A.,0,0,0,0
1653508607497,ECE 271A,A00,091090,Vasconcelos; Nuno,0,0,0,0
1653508608021,ECE 272B,A00,091091,Sworder; David D.,0,0,0,0
1653508608555,ECE 275A,A00,091092,Meyer; Florian,0,0,0,0
1653508609080,ECE 277,A00,091093,An; Cheolhong,0,0,0,0
1653508609606,ECE 283,A00,091094,Le; Hanh-Phuc,0,0,0,0
1653508610145,ECE 284,A00,091095,Kang; Mingu,0,0,0,0
1653508610145,ECE 284,B00,091096,Wang; Edward Jay,0,0,0,0
1653508610676,ECE 285,A00,094334,Touri; Behrouz,0,0,0,0
1653508611200,ECE 289,A00,091097,Whelan; David Arthur,0,0,0,0
1653508611723,MATH 200A,A00,087414,Salehi Golsefidy; Alireza,7,0,8,1
1653508612246,MATH 202A,A00,087415,Gill; Philip E.,3,0,8,5
1653508612775,MATH 203A,A00,087416,Oprea; Dragos N.,6,0,8,2
1653508613306,MATH 204A,A00,087417,Kedlaya; Kiran S.,6,0,8,2
1653508613829,MATH 205,A00,087418,Sorensen; Claus M,6,0,8,2
1653508614355,MATH 206A,A00,087419,Izadi; Elham,7,0,8,1
1653508614889,MATH 207A,A00,087420,Mohammadi; Amir,5,0,8,3
1653508615412,MATH 208,A00,087421,Staff,9,0,10,1
1653508615940,MATH 209,A00,087422,Staff,10,0,10,0
1653508616465,MATH 218,A00,087423,Staff,10,0,10,0
1653508616990,MATH 220A,A00,087424,Novak; Jonathan I,7,0,8,1
1653508617512,MATH 231A,A00,087425,Bejenaru; Ioan,3,0,8,5
1653508618037,MATH 240A,A00,087426,Ebenfelt; Peter F,5,0,8,3
1653508618563,MATH 243,A00,087427,Staff,9,0,10,1
1653508619088,MATH 248,A00,087429,Staff,10,0,10,0
1653508619612,MATH 250A,A00,087430,Spolaor; Luca,4,0,8,4
1653508620136,MATH 257A,A00,087431,Spolaor; Luca,7,0,8,1
1653508620659,MATH 258,A00,087432,Staff,9,0,10,1
1653508621181,MATH 264A,A00,087433,Warnke; Lutz Peter,5,0,8,3
1653508621718,MATH 268,A00,087434,Staff,15,0,15,0
1653508622243,MATH 269,A00,087435,Staff,14,0,15,1
1653508622773,MATH 270A,A00,087436,Nie; Jiawang,0,0,8,8
1653508623299,MATH 272A,A00,087437,Tian; Xiaochuan,1,0,8,7
1653508623821,MATH 274,A01,087439,Cheng; Li-Tien,9,0,10,1
1653508623821,MATH 274,A02,087440,Cheng; Li-Tien,10,0,10,0
1653508624344,MATH 278A,A00,087441,Staff,8,0,10,2
1653508624875,MATH 278B,A00,087442,Staff,8,0,10,2
1653508625400,MATH 278C,A00,087443,Staff,8,0,10,2
1653508625928,MATH 280A,A00,087444,Zheng; Tianyi,0,0,8,8
1653508626454,MATH 281A,A00,087445,Bradic; Jelena,0,0,8,8
1653508626980,MATH 282A,A00,087446,Zhang; Danna,0,0,8,8
1653508627506,MATH 283,A00,087447,Tesler; Glenn,0,0,0,15
1653508628029,MATH 286,A00,087448,Kemp; Todd Aahron,5,0,8,3
1653508628551,MATH 287D,A00,087449,Bradic; Jelena,8,0,8,0
1653508629077,MATH 288,A00,087450,Staff,14,0,15,1
1653508629077,MATH 288,B00,087451,Staff,15,0,15,0
1653508629077,MATH 288,C00,087452,Staff,15,0,15,0
1653508629599,MATH 290A,A00,087453,Xu; Zhouli,6,0,8,2
1653508630125,MATH 291A,A00,087454,Xu; Zhouli,7,0,8,1
1653508630669,MATH 292,A00,087455,Staff,10,0,10,0
1653508631192,MATH 295,A00,087456,Staff,50,0,50,0
1653508631714,MATH 297,001,087457,Staff,998,0,999,1
1653509203292,COGS 200,A01,087991,Staff,47,0,50,3
1653509203825,COGS 201,A01,094504,Rangel; Lara M,17,0,25,8
1653509204352,COGS 203,A00,087992,Coulson; Seana M,18,0,20,2
1653509204881,COGS 210A,001,087993,Greene; Deanna Jacquelyn,9998,0,9999,1
1653509204881,COGS 210A,002,087994,Saygin; Ayse P,9999,0,9999,0
1653509204881,COGS 210A,003,087995,Xia; Haijun,9999,0,9999,0
1653509204881,COGS 210A,004,087996,Nitz; Douglas A.,9999,0,9999,0
1653509204881,COGS 210A,005,087997,Hollan; James D.,9999,0,9999,0
1653509204881,COGS 210A,006,087998,Deak; Gedeon O.,9998,0,9999,1
1653509204881,COGS 210A,007,087999,Rossano; Federico,9999,0,9999,0
1653509205412,COGS 211A,A00,088000,Coulson; Seana M,9997,0,9999,2
1653509205933,COGS 229,A00,088002,Staff,23,0,25,2
1653509206467,COGS 260,B00,094231,Staff,17,0,20,3
1653509206467,COGS 260,A00,088004,Nitz; Douglas A.,9998,0,9999,1
1653509206998,CSE 202,A00,090110,Paturi; Ramamohan,0,0,0,0
1653509206998,CSE 202,B00,090111,Paturi; Ramamohan,0,0,0,0
1653509207528,CSE 207B,A00,090112,Heninger; Nadia A,0,0,0,0
1653509208056,CSE 208,A00,094858,Micciancio; Daniele,0,0,0,0
1653509208580,CSE 210,A00,090113,Powell; Thomas Allan,0,0,0,0
1653509209109,CSE 219,A00,090898,Staff,0,0,0,0
1653509209633,CSE 221,A00,090114,Zhou; Yuan-Yuan,0,0,0,0
1653509210159,CSE 229A,A00,090115,Porter; George M,0,0,0,0
1653509210683,CSE 229C,A00,090116,Savage; Stefan,0,0,0,0
1653509211205,CSE 230,A00,090117,Jhala; Ranjit,0,0,0,0
1653509211727,CSE 232,A00,090118,Papakonstantinou; Yannis,0,0,0,0
1653509212256,CSE 239A,A00,090121,Kumar; Arun Kumar,0,0,0,0
1653509212792,CSE 239B,A00,090122,Jhala; Ranjit,0,0,0,0
1653509213324,CSE 240A,A00,090123,Zhao; Jishen,0,0,189,189
1653509213860,CSE 243A,A00,090124,Orailoglu; Alex,0,0,15,15
1653509214382,CSE 249B,A00,090125,Kahng; Andrew Byun,13,0,20,7
1653509214910,CSE 250A,A00,090126,Berg-Kirkpatrick; Taylor D,0,0,0,0
1653509215441,CSE 252A,A00,090127,Ochoa; Benjamin Lawrence,0,0,0,0
1653509215963,CSE 258,A01,090129,McAuley; Julian John,0,0,0,0
1653509216485,CSE 258R,A01,090131,McAuley; Julian John,0,0,0,0
1653509217016,CSE 274,A00,090132,Ramamoorthi; Ravi,0,0,0,0
1653509217543,CSE 276A,A00,090133,Christensen; Henrik I,0,0,0,0
1653509218076,CSE 276C,A00,090134,Christensen; Henrik I,0,0,0,0
1653509218609,CSE 290,A00,090135,Bafna; Vineet,0,0,0,0
1653509218609,CSE 290,B00,090136,Ramamoorthi; Ravi,0,0,0,0
1653509218609,CSE 290,C00,090137,Li; Tzumao,9,0,10,1
1653509218609,CSE 290,D00,090138,Zhou; Yuan-Yuan,10,0,10,0
1653509218609,CSE 290,E00,090139,Christensen; Henrik I,10,0,10,0
1653509218609,CSE 290,F00,094053,Shalev; Aaron D,0,0,0,0
1653509219136,CSE 291,A00,090140,Munyaka; Imani N. S.,0,0,0,0
1653509219136,CSE 291,B00,094880,Yu; Qi,0,0,0,0
1653509219136,CSE 291,C00,090142,Pannuto; Patrick William,0,0,0,0
1653509219136,CSE 291,D00,094881,Zhang; Yiying,0,0,0,0
1653509219136,CSE 291,E00,095118,Su; Hao,0,0,0,0
1653509219661,CSE 293,001,094905,Bafna; Vineet,9999,0,9999,0
1653509219661,CSE 293,002,094906,Bellare; Mihir,9999,0,9999,0
1653509219661,CSE 293,003,094907,Berg-Kirkpatrick; Taylor D,9999,0,9999,0
1653509219661,CSE 293,004,094908,Christensen; Henrik I,9999,0,9999,0
1653509219661,CSE 293,005,094909,Cottrell; Garrison W,9999,0,9999,0
1653509219661,CSE 293,006,094910,Deutsch; Alin Bernard,9999,0,9999,0
1653509219661,CSE 293,007,094911,Esmaeilzadeh; Hadi,9999,0,9999,0
1653509219661,CSE 293,008,094912,Freund; Yoav,9999,0,9999,0
1653509219661,CSE 293,009,094913,Griswold; William G.,9999,0,9999,0
1653509219661,CSE 293,010,094914,Gymrek; Melissa Ann,9999,0,9999,0
1653509219661,CSE 293,011,094915,Heninger; Nadia A,9999,0,9999,0
1653509219661,CSE 293,012,094916,Impagliazzo; Russell,9999,0,9999,0
1653509219661,CSE 293,013,094917,Jhala; Ranjit,9999,0,9999,0
1653509219661,CSE 293,014,094918,Kahng; Andrew Byun,9999,0,9999,0
1653509219661,CSE 293,015,094919,Kane; Daniel Mertz,9999,0,9999,0
1653509219661,CSE 293,016,094920,Kriegman; David J,9999,0,9999,0
1653509219661,CSE 293,017,094921,Kumar; Arun Kumar,9999,0,9999,0
1653509219661,CSE 293,018,094922,Lerner; Sorin,9999,0,9999,0
1653509219661,CSE 293,019,094923,Lovett; Shachar,9999,0,9999,0
1653509219661,CSE 293,020,094924,McAuley; Julian John,9999,0,9999,0
1653509219661,CSE 293,021,094925,Micciancio; Daniele,9999,0,9999,0
1653509219661,CSE 293,022,094926,Orailoglu; Alex,9999,0,9999,0
1653509219661,CSE 293,023,094927,Paturi; Ramamohan,9999,0,9999,0
1653509219661,CSE 293,024,094928,Polikarpova; Nadezhda,9999,0,9999,0
1653509219661,CSE 293,025,094929,Politz; Joseph Gibbs,9999,0,9999,0
1653509219661,CSE 293,026,094930,Porter; George M,9999,0,9999,0
1653509219661,CSE 293,027,094931,Porter; Leonard Emerson,9999,0,9999,0
1653509219661,CSE 293,028,094932,Ramamoorthi; Ravi,9999,0,9999,0
1653509219661,CSE 293,029,094933,Sahoo; Debashis,9999,0,9999,0
1653509219661,CSE 293,030,094934,Saul; Lawrence,9999,0,9999,0
1653509219661,CSE 293,031,094935,Savage; Stefan,9999,0,9999,0
1653509219661,CSE 293,032,094936,Schulze; Jurgen P.,9999,0,9999,0
1653509219661,CSE 293,033,094937,Snoeren; Alex C.,9999,0,9999,0
1653509219661,CSE 293,034,094938,Shang; Jingbo,9999,0,9999,0
1653509219661,CSE 293,035,094939,Stefan; Deian,9999,0,9999,0
1653509219661,CSE 293,036,094940,Su; Hao,9999,0,9999,0
1653509219661,CSE 293,037,094941,Swanson; Steven James,9999,0,9999,0
1653509219661,CSE 293,038,094942,Tullsen; Dean Michael,9999,0,9999,0
1653509219661,CSE 293,039,094943,Voelker; Geoffrey M.,9999,0,9999,0
1653509219661,CSE 293,040,094944,Zhao; Jishen,9999,0,9999,0
1653509219661,CSE 293,041,094945,Zhou; Yuan-Yuan,9999,0,9999,0
1653509219661,CSE 293,042,094946,Gao; Sicun,9998,0,9999,1
1653509219661,CSE 293,043,094947,Weibel; Nadir,9999,0,9999,0
1653509219661,CSE 293,044,094948,Gupta; Rajesh K.,9999,0,9999,0
1653509220182,CSE 294,A00,090143,Porter; George M,8,0,10,2
1653509220708,DSE 200,A00,091799,Staff,50,0,50,0
1653509221234,DSE 203,A00,091800,Gupta; Amarnath,30,0,30,0
1653509221773,DSE 250,A00,091801,Deutsch; Alin Bernard,30,0,30,0
1653509222307,DSE 290,A00,091802,Altintas De Callaf; Ilkay,50,0,50,0
1653509222930,ECE 200,001,091003,Antipa; Nicholas A,9999,0,9999,0
1653509222930,ECE 200,002,091004,Atanasov; Nikolay A.,9999,0,9999,0
1653509222930,ECE 200,003,091005,Bharadia; Dinesh,9999,0,9999,0
1653509222930,ECE 200,004,091006,Cheng; Chung Kuan,9999,0,9999,0
1653509222930,ECE 200,005,091007,Cosman; Pamela C.,9999,0,9999,0
1653509222930,ECE 200,006,091008,Staff,9999,0,9999,0
1653509222930,ECE 200,007,091009,Dayeh; Shadi Ahmad,9999,0,9999,0
1653509222930,ECE 200,008,091010,Fainman; Yeshaiahu,9999,0,9999,0
1653509222930,ECE 200,009,091011,Ford; Joseph Earl,9999,0,9999,0
1653509222930,ECE 200,010,091012,Franceschetti; Massimo,9999,0,9999,0
1653509222930,ECE 200,011,091013,Fullerton; Eric E,9999,0,9999,0
1653509222930,ECE 200,012,091014,Galton; Ian A,9999,0,9999,0
1653509222930,ECE 200,013,091015,Gilja; Vikash,9999,0,9999,0
1653509222930,ECE 200,014,091016,Hall; Drew A.,9999,0,9999,0
1653509222930,ECE 200,015,091017,Hsueh; Tzu-Chien,9999,0,9999,0
1653509222930,ECE 200,016,091018,Javidi; Tara,9999,0,9999,0
1653509222930,ECE 200,017,091019,Kahng; Andrew Byun,9999,0,9999,0
1653509222930,ECE 200,018,091020,Kim; Young-Han,9999,0,9999,0
1653509222930,ECE 200,019,091021,Koushanfar; Farinaz,9999,0,9999,0
1653509222930,ECE 200,020,091022,Kuzum; Duygu,9999,0,9999,0
1653509222930,ECE 200,021,091023,Le; Hanh-Phuc,9999,0,9999,0
1653509222930,ECE 200,022,091024,Lin; Bill,9999,0,9999,0
1653509222930,ECE 200,023,091025,Liu; Zhaowei,9999,0,9999,0
1653509222930,ECE 200,024,091026,Lo; Yu-Hwa,9999,0,9999,0
1653509222930,ECE 200,025,091027,Lomakin; Vitaliy,9999,0,9999,0
1653509222930,ECE 200,026,091028,Mercier; Patrick Philip,9999,0,9999,0
1653509222930,ECE 200,027,091029,Meyer; Florian,9999,0,9999,0
1653509222930,ECE 200,028,091030,Milstein; Laurence B.,9999,0,9999,0
1653509222930,ECE 200,029,091031,Mir Arabbaygi; Siavash,9999,0,9999,0
1653509222930,ECE 200,030,091032,Mookherjea; Shayan,9999,0,9999,0
1653509222930,ECE 200,031,091033,Morris; Karcher William,9999,0,9999,0
1653509222930,ECE 200,032,091034,Ng; Tse Nga,9999,0,9999,0
1653509222930,ECE 200,033,091035,Nguyen; Truong Quang,9999,0,9999,0
1653509222930,ECE 200,034,091036,Nomura; Kenji,9999,0,9999,0
1653509222930,ECE 200,035,091037,Orlitsky; Alon,9999,0,9999,0
1653509222930,ECE 200,036,091038,Pal; Piya,9999,0,9999,0
1653509222930,ECE 200,037,091039,Papen; George C.,9999,0,9999,0
1653509222930,ECE 200,038,091040,Radic; Stojan,9999,0,9999,0
1653509222930,ECE 200,039,091041,Rao; Bhaskar D.,9999,0,9999,0
1653509222930,ECE 200,040,091042,Rao; Ramesh R,9999,0,9999,0
1653509222930,ECE 200,041,091043,Rebeiz; Gabriel,9999,0,9999,0
1653509222930,ECE 200,042,091044,Sanford; John R,9999,0,9999,0
1653509222930,ECE 200,043,091045,Siegel; Paul H.,9999,0,9999,0
1653509222930,ECE 200,044,091046,Sievenpiper; Daniel F.,9999,0,9999,0
1653509222930,ECE 200,045,091047,Sworder; David D.,9999,0,9999,0
1653509222930,ECE 200,046,091048,Taur; Yuan,9999,0,9999,0
1653509222930,ECE 200,047,091049,Touri; Behrouz,9999,0,9999,0
1653509222930,ECE 200,048,091050,Trivedi; Mohan M.,9999,0,9999,0
1653509222930,ECE 200,049,091051,Vardy; Alexander,9999,0,9999,0
1653509222930,ECE 200,050,091052,Vasconcelos; Nuno,9999,0,9999,0
1653509222930,ECE 200,051,091053,Wang; Xiaolong,9999,0,9999,0
1653509222930,ECE 200,052,091054,Xie; Pengtao,9999,0,9999,0
1653509222930,ECE 200,053,091055,Yip; Michael,9999,0,9999,0
1653509222930,ECE 200,054,091056,Zeger; Kenneth A.,9999,0,9999,0
1653509222930,ECE 200,055,091057,Zhang; Xinyu,9999,0,9999,0
1653509222930,ECE 200,056,091058,Turakhia; Yatish Girish,9999,0,9999,0
1653509222930,ECE 200,057,091059,Kang; Mingu,9999,0,9999,0
1653509222930,ECE 200,058,091060,Shi; Yuanyuan,9999,0,9999,0
1653509222930,ECE 200,059,091061,Wang; Edward Jay,9999,0,9999,0
1653509222930,ECE 200,060,091062,Zheng; Yang,9999,0,9999,0
1653509223456,ECE 201,A00,095526,Lo; Yu-Hwa,50,0,50,0
1653509223988,ECE 203,A00,091065,Mercier; Patrick Philip,0,0,0,0
1653509224516,ECE 207A,A00,091605,Liu; Thomas Tao-Ming,0,0,0,0
1653509225038,ECE 212AN,A00,091068,Nomura; Kenji,0,0,0,0
1653509225562,ECE 222A,A00,091069,Rebeiz; Gabriel,0,0,0,0
1653509226086,ECE 225A,A00,091070,Orlitsky; Alon,0,0,0,0
1653509226608,ECE 230A,A00,091071,Nomura; Kenji,0,0,0,0
1653509227140,ECE 236A,A00,091072,Dayeh; Shadi Ahmad,0,0,0,0
1653509227674,ECE 238A,A00,091073,Luo; Jian,0,0,0,0
1653509227674,ECE 238A,B00,091074,Luo; Jian,0,0,0,0
1653509228212,ECE 240A,A00,091075,Radic; Stojan,0,0,0,0
1653509228744,ECE 247A,A00,091592,Shi; Lingyan,0,0,0,0
1653509229273,ECE 250,A00,091076,Touri; Behrouz,0,0,0,0
1653509229797,ECE 251C,A00,091078,Nguyen; Truong Quang,0,0,0,0
1653509230321,ECE 253,A00,091079,Cosman; Pamela C.,0,0,0,0
1653509230854,ECE 255A,A00,091080,Orlitsky; Alon,0,0,0,0
1653509231385,ECE 257A,A00,091081,Zhang; Xinyu,0,0,0,0
1653509231912,ECE 260A,A01,091084,Eldon; John,0,0,0,0
1653509232442,ECE 264C,A00,091085,Galton; Ian A,0,0,0,0
1653509232976,ECE 265C,A00,094889,Presti; Calogero Davide,0,0,0,9
1653509233503,ECE 266,A01,091087,Hall; Drew A.,0,0,0,0
1653509234560,ECE 271A,A00,091090,Vasconcelos; Nuno,0,0,0,0
1653509235082,ECE 272B,A00,091091,Sworder; David D.,0,0,0,0
1653509235605,ECE 275A,A00,091092,Meyer; Florian,0,0,0,0
1653509236131,ECE 277,A00,091093,An; Cheolhong,0,0,0,0
1653509236662,ECE 283,A00,091094,Le; Hanh-Phuc,0,0,0,0
1653509237197,ECE 284,A00,091095,Kang; Mingu,0,0,0,0
1653509237197,ECE 284,B00,091096,Wang; Edward Jay,0,0,0,0
1653509237727,ECE 285,A00,094334,Touri; Behrouz,0,0,0,0
1653509238273,ECE 289,A00,091097,Whelan; David Arthur,0,0,0,0
1653509238803,MATH 200A,A00,087414,Salehi Golsefidy; Alireza,7,0,8,1
1653509239326,MATH 202A,A00,087415,Gill; Philip E.,3,0,8,5
1653509239855,MATH 203A,A00,087416,Oprea; Dragos N.,6,0,8,2
1653509240380,MATH 204A,A00,087417,Kedlaya; Kiran S.,6,0,8,2
1653509240908,MATH 205,A00,087418,Sorensen; Claus M,6,0,8,2
1653509241430,MATH 206A,A00,087419,Izadi; Elham,7,0,8,1
1653509242027,MATH 207A,A00,087420,Mohammadi; Amir,5,0,8,3
1653509242550,MATH 208,A00,087421,Staff,9,0,10,1
1653509243077,MATH 209,A00,087422,Staff,10,0,10,0
1653509243599,MATH 218,A00,087423,Staff,10,0,10,0
1653509244128,MATH 220A,A00,087424,Novak; Jonathan I,7,0,8,1
1653509244655,MATH 231A,A00,087425,Bejenaru; Ioan,3,0,8,5
1653509245177,MATH 240A,A00,087426,Ebenfelt; Peter F,5,0,8,3
1653509245708,MATH 243,A00,087427,Staff,9,0,10,1
1653509246241,MATH 248,A00,087429,Staff,10,0,10,0
1653509246767,MATH 250A,A00,087430,Spolaor; Luca,4,0,8,4
1653509247296,MATH 257A,A00,087431,Spolaor; Luca,7,0,8,1
1653509247830,MATH 258,A00,087432,Staff,9,0,10,1
1653509248354,MATH 264A,A00,087433,Warnke; Lutz Peter,5,0,8,3
1653509248883,MATH 268,A00,087434,Staff,15,0,15,0
1653509249405,MATH 269,A00,087435,Staff,14,0,15,1
1653509249944,MATH 270A,A00,087436,Nie; Jiawang,0,0,8,8
1653509250511,MATH 272A,A00,087437,Tian; Xiaochuan,1,0,8,7
1653509251048,MATH 274,A01,087439,Cheng; Li-Tien,9,0,10,1
1653509251048,MATH 274,A02,087440,Cheng; Li-Tien,10,0,10,0
1653509251573,MATH 278A,A00,087441,Staff,8,0,10,2
1653509252111,MATH 278B,A00,087442,Staff,8,0,10,2
1653509252633,MATH 278C,A00,087443,Staff,8,0,10,2
1653509253153,MATH 280A,A00,087444,Zheng; Tianyi,0,0,8,8
1653509253696,MATH 281A,A00,087445,Bradic; Jelena,0,0,8,8
1653509254221,MATH 282A,A00,087446,Zhang; Danna,0,0,8,8
1653509254749,MATH 283,A00,087447,Tesler; Glenn,0,0,0,15
1653509255281,MATH 286,A00,087448,Kemp; Todd Aahron,5,0,8,3
1653509255810,MATH 287D,A00,087449,Bradic; Jelena,8,0,8,0
1653509256334,MATH 288,A00,087450,Staff,14,0,15,1
1653509256334,MATH 288,B00,087451,Staff,15,0,15,0
1653509256334,MATH 288,C00,087452,Staff,15,0,15,0
1653509256867,MATH 290A,A00,087453,Xu; Zhouli,6,0,8,2
1653509257394,MATH 291A,A00,087454,Xu; Zhouli,7,0,8,1
1653509257923,MATH 292,A00,087455,Staff,10,0,10,0
1653509258447,MATH 295,A00,087456,Staff,50,0,50,0
1653509258980,MATH 297,001,087457,Staff,998,0,999,1
1653509820482,COGS 200,A01,087991,Staff,47,0,50,3
1653509821005,COGS 201,A01,094504,Rangel; Lara M,17,0,25,8
1653509821535,COGS 203,A00,087992,Coulson; Seana M,18,0,20,2
1653509822059,COGS 210A,001,087993,Greene; Deanna Jacquelyn,9998,0,9999,1
1653509822059,COGS 210A,002,087994,Saygin; Ayse P,9999,0,9999,0
1653509822059,COGS 210A,003,087995,Xia; Haijun,9999,0,9999,0
1653509822059,COGS 210A,004,087996,Nitz; Douglas A.,9999,0,9999,0
1653509822059,COGS 210A,005,087997,Hollan; James D.,9999,0,9999,0
1653509822059,COGS 210A,006,087998,Deak; Gedeon O.,9998,0,9999,1
1653509822059,COGS 210A,007,087999,Rossano; Federico,9999,0,9999,0
1653509822581,COGS 211A,A00,088000,Coulson; Seana M,9997,0,9999,2
1653509823120,COGS 229,A00,088002,Staff,23,0,25,2
1653509823646,COGS 260,B00,094231,Staff,17,0,20,3
1653509823646,COGS 260,A00,088004,Nitz; Douglas A.,9998,0,9999,1
1653509824169,CSE 202,A00,090110,Paturi; Ramamohan,0,0,0,0
1653509824169,CSE 202,B00,090111,Paturi; Ramamohan,0,0,0,0
1653509824696,CSE 207B,A00,090112,Heninger; Nadia A,0,0,0,0
1653509825219,CSE 208,A00,094858,Micciancio; Daniele,0,0,0,0
1653509825823,CSE 210,A00,090113,Powell; Thomas Allan,0,0,0,0
1653509826348,CSE 219,A00,090898,Staff,0,0,0,0
1653509826871,CSE 221,A00,090114,Zhou; Yuan-Yuan,0,0,0,0
1653509827397,CSE 229A,A00,090115,Porter; George M,0,0,0,0
1653509827920,CSE 229C,A00,090116,Savage; Stefan,0,0,0,0
1653509828450,CSE 230,A00,090117,Jhala; Ranjit,0,0,0,0
1653509828973,CSE 232,A00,090118,Papakonstantinou; Yannis,0,0,0,0
1653509829522,CSE 239A,A00,090121,Kumar; Arun Kumar,0,0,0,0
1653509830047,CSE 239B,A00,090122,Jhala; Ranjit,0,0,0,0
1653509830577,CSE 240A,A00,090123,Zhao; Jishen,0,0,189,189
1653509831179,CSE 243A,A00,090124,Orailoglu; Alex,0,0,15,15
1653509831715,CSE 249B,A00,090125,Kahng; Andrew Byun,13,0,20,7
1653509832244,CSE 250A,A00,090126,Berg-Kirkpatrick; Taylor D,0,0,0,0
1653509832787,CSE 252A,A00,090127,Ochoa; Benjamin Lawrence,0,0,0,0
1653509833312,CSE 258,A01,090129,McAuley; Julian John,0,0,0,0
1653509833843,CSE 258R,A01,090131,McAuley; Julian John,0,0,0,0
1653509834366,CSE 274,A00,090132,Ramamoorthi; Ravi,0,0,0,0
1653509834892,CSE 276A,A00,090133,Christensen; Henrik I,0,0,0,0
1653509835413,CSE 276C,A00,090134,Christensen; Henrik I,0,0,0,0
1653509835935,CSE 290,A00,090135,Bafna; Vineet,0,0,0,0
1653509835935,CSE 290,B00,090136,Ramamoorthi; Ravi,0,0,0,0
1653509835935,CSE 290,C00,090137,Li; Tzumao,8,0,10,2
1653509835935,CSE 290,D00,090138,Zhou; Yuan-Yuan,9,0,10,1
1653509835935,CSE 290,E00,090139,Christensen; Henrik I,9,0,10,1
1653509835935,CSE 290,F00,094053,Shalev; Aaron D,0,0,0,0
1653509836462,CSE 291,A00,090140,Munyaka; Imani N. S.,0,0,0,0
1653509836462,CSE 291,B00,094880,Yu; Qi,0,0,0,0
1653509836462,CSE 291,C00,090142,Pannuto; Patrick William,0,0,0,0
1653509836462,CSE 291,D00,094881,Zhang; Yiying,0,0,0,0
1653509836462,CSE 291,E00,095118,Su; Hao,0,0,0,0
1653509837007,CSE 293,001,094905,Bafna; Vineet,9999,0,9999,0
1653509837007,CSE 293,002,094906,Bellare; Mihir,9999,0,9999,0
1653509837007,CSE 293,003,094907,Berg-Kirkpatrick; Taylor D,9999,0,9999,0
1653509837007,CSE 293,004,094908,Christensen; Henrik I,9999,0,9999,0
1653509837007,CSE 293,005,094909,Cottrell; Garrison W,9999,0,9999,0
1653509837007,CSE 293,006,094910,Deutsch; Alin Bernard,9999,0,9999,0
1653509837007,CSE 293,007,094911,Esmaeilzadeh; Hadi,9999,0,9999,0
1653509837007,CSE 293,008,094912,Freund; Yoav,9999,0,9999,0
1653509837007,CSE 293,009,094913,Griswold; William G.,9999,0,9999,0
1653509837007,CSE 293,010,094914,Gymrek; Melissa Ann,9999,0,9999,0
1653509837007,CSE 293,011,094915,Heninger; Nadia A,9999,0,9999,0
1653509837007,CSE 293,012,094916,Impagliazzo; Russell,9999,0,9999,0
1653509837007,CSE 293,013,094917,Jhala; Ranjit,9999,0,9999,0
1653509837007,CSE 293,014,094918,Kahng; Andrew Byun,9999,0,9999,0
1653509837007,CSE 293,015,094919,Kane; Daniel Mertz,9999,0,9999,0
1653509837007,CSE 293,016,094920,Kriegman; David J,9999,0,9999,0
1653509837007,CSE 293,017,094921,Kumar; Arun Kumar,9999,0,9999,0
1653509837007,CSE 293,018,094922,Lerner; Sorin,9999,0,9999,0
1653509837007,CSE 293,019,094923,Lovett; Shachar,9999,0,9999,0
1653509837007,CSE 293,020,094924,McAuley; Julian John,9999,0,9999,0
1653509837007,CSE 293,021,094925,Micciancio; Daniele,9999,0,9999,0
1653509837007,CSE 293,022,094926,Orailoglu; Alex,9999,0,9999,0
1653509837007,CSE 293,023,094927,Paturi; Ramamohan,9999,0,9999,0
1653509837007,CSE 293,024,094928,Polikarpova; Nadezhda,9999,0,9999,0
1653509837007,CSE 293,025,094929,Politz; Joseph Gibbs,9999,0,9999,0
1653509837007,CSE 293,026,094930,Porter; George M,9999,0,9999,0
1653509837007,CSE 293,027,094931,Porter; Leonard Emerson,9999,0,9999,0
1653509837007,CSE 293,028,094932,Ramamoorthi; Ravi,9999,0,9999,0
1653509837007,CSE 293,029,094933,Sahoo; Debashis,9999,0,9999,0
1653509837007,CSE 293,030,094934,Saul; Lawrence,9999,0,9999,0
1653509837007,CSE 293,031,094935,Savage; Stefan,9999,0,9999,0
1653509837007,CSE 293,032,094936,Schulze; Jurgen P.,9999,0,9999,0
1653509837007,CSE 293,033,094937,Snoeren; Alex C.,9999,0,9999,0
1653509837007,CSE 293,034,094938,Shang; Jingbo,9999,0,9999,0
1653509837007,CSE 293,035,094939,Stefan; Deian,9999,0,9999,0
1653509837007,CSE 293,036,094940,Su; Hao,9999,0,9999,0
1653509837007,CSE 293,037,094941,Swanson; Steven James,9999,0,9999,0
1653509837007,CSE 293,038,094942,Tullsen; Dean Michael,9999,0,9999,0
1653509837007,CSE 293,039,094943,Voelker; Geoffrey M.,9999,0,9999,0
1653509837007,CSE 293,040,094944,Zhao; Jishen,9999,0,9999,0
1653509837007,CSE 293,041,094945,Zhou; Yuan-Yuan,9999,0,9999,0
1653509837007,CSE 293,042,094946,Gao; Sicun,9998,0,9999,1
1653509837007,CSE 293,043,094947,Weibel; Nadir,9999,0,9999,0
1653509837007,CSE 293,044,094948,Gupta; Rajesh K.,9999,0,9999,0
1653509837528,CSE 294,A00,090143,Porter; George M,8,0,10,2
1653509838054,DSE 200,A00,091799,Staff,50,0,50,0
1653509838576,DSE 203,A00,091800,Gupta; Amarnath,30,0,30,0
1653509839098,DSE 250,A00,091801,Deutsch; Alin Bernard,30,0,30,0
1653509839623,DSE 290,A00,091802,Altintas De Callaf; Ilkay,50,0,50,0
1653509840150,ECE 200,001,091003,Antipa; Nicholas A,9999,0,9999,0
1653509840150,ECE 200,002,091004,Atanasov; Nikolay A.,9999,0,9999,0
1653509840150,ECE 200,003,091005,Bharadia; Dinesh,9999,0,9999,0
1653509840150,ECE 200,004,091006,Cheng; Chung Kuan,9999,0,9999,0
1653509840150,ECE 200,005,091007,Cosman; Pamela C.,9999,0,9999,0
1653509840150,ECE 200,006,091008,Staff,9999,0,9999,0
1653509840150,ECE 200,007,091009,Dayeh; Shadi Ahmad,9999,0,9999,0
1653509840150,ECE 200,008,091010,Fainman; Yeshaiahu,9999,0,9999,0
1653509840150,ECE 200,009,091011,Ford; Joseph Earl,9999,0,9999,0
1653509840150,ECE 200,010,091012,Franceschetti; Massimo,9999,0,9999,0
1653509840150,ECE 200,011,091013,Fullerton; Eric E,9999,0,9999,0
1653509840150,ECE 200,012,091014,Galton; Ian A,9999,0,9999,0
1653509840150,ECE 200,013,091015,Gilja; Vikash,9999,0,9999,0
1653509840150,ECE 200,014,091016,Hall; Drew A.,9999,0,9999,0
1653509840150,ECE 200,015,091017,Hsueh; Tzu-Chien,9999,0,9999,0
1653509840150,ECE 200,016,091018,Javidi; Tara,9999,0,9999,0
1653509840150,ECE 200,017,091019,Kahng; Andrew Byun,9999,0,9999,0
1653509840150,ECE 200,018,091020,Kim; Young-Han,9999,0,9999,0
1653509840150,ECE 200,019,091021,Koushanfar; Farinaz,9999,0,9999,0
1653509840150,ECE 200,020,091022,Kuzum; Duygu,9999,0,9999,0
1653509840150,ECE 200,021,091023,Le; Hanh-Phuc,9999,0,9999,0
1653509840150,ECE 200,022,091024,Lin; Bill,9999,0,9999,0
1653509840150,ECE 200,023,091025,Liu; Zhaowei,9999,0,9999,0
1653509840150,ECE 200,024,091026,Lo; Yu-Hwa,9999,0,9999,0
1653509840150,ECE 200,025,091027,Lomakin; Vitaliy,9999,0,9999,0
1653509840150,ECE 200,026,091028,Mercier; Patrick Philip,9999,0,9999,0
1653509840150,ECE 200,027,091029,Meyer; Florian,9999,0,9999,0
1653509840150,ECE 200,028,091030,Milstein; Laurence B.,9999,0,9999,0
1653509840150,ECE 200,029,091031,Mir Arabbaygi; Siavash,9999,0,9999,0
1653509840150,ECE 200,030,091032,Mookherjea; Shayan,9999,0,9999,0
1653509840150,ECE 200,031,091033,Morris; Karcher William,9999,0,9999,0
1653509840150,ECE 200,032,091034,Ng; Tse Nga,9999,0,9999,0
1653509840150,ECE 200,033,091035,Nguyen; Truong Quang,9999,0,9999,0
1653509840150,ECE 200,034,091036,Nomura; Kenji,9999,0,9999,0
1653509840150,ECE 200,035,091037,Orlitsky; Alon,9999,0,9999,0
1653509840150,ECE 200,036,091038,Pal; Piya,9999,0,9999,0
1653509840150,ECE 200,037,091039,Papen; George C.,9999,0,9999,0
1653509840150,ECE 200,038,091040,Radic; Stojan,9999,0,9999,0
1653509840150,ECE 200,039,091041,Rao; Bhaskar D.,9999,0,9999,0
1653509840150,ECE 200,040,091042,Rao; Ramesh R,9999,0,9999,0
1653509840150,ECE 200,041,091043,Rebeiz; Gabriel,9999,0,9999,0
1653509840150,ECE 200,042,091044,Sanford; John R,9999,0,9999,0
1653509840150,ECE 200,043,091045,Siegel; Paul H.,9999,0,9999,0
1653509840150,ECE 200,044,091046,Sievenpiper; Daniel F.,9999,0,9999,0
1653509840150,ECE 200,045,091047,Sworder; David D.,9999,0,9999,0
1653509840150,ECE 200,046,091048,Taur; Yuan,9999,0,9999,0
1653509840150,ECE 200,047,091049,Touri; Behrouz,9999,0,9999,0
1653509840150,ECE 200,048,091050,Trivedi; Mohan M.,9999,0,9999,0
1653509840150,ECE 200,049,091051,Vardy; Alexander,9999,0,9999,0
1653509840150,ECE 200,050,091052,Vasconcelos; Nuno,9999,0,9999,0
1653509840150,ECE 200,051,091053,Wang; Xiaolong,9999,0,9999,0
1653509840150,ECE 200,052,091054,Xie; Pengtao,9999,0,9999,0
1653509840150,ECE 200,053,091055,Yip; Michael,9999,0,9999,0
1653509840150,ECE 200,054,091056,Zeger; Kenneth A.,9999,0,9999,0
1653509840150,ECE 200,055,091057,Zhang; Xinyu,9999,0,9999,0
1653509840150,ECE 200,056,091058,Turakhia; Yatish Girish,9999,0,9999,0
1653509840150,ECE 200,057,091059,Kang; Mingu,9999,0,9999,0
1653509840150,ECE 200,058,091060,Shi; Yuanyuan,9999,0,9999,0
1653509840150,ECE 200,059,091061,Wang; Edward Jay,9999,0,9999,0
1653509840150,ECE 200,060,091062,Zheng; Yang,9999,0,9999,0
1653509840675,ECE 201,A00,095526,Lo; Yu-Hwa,50,0,50,0
1653509841202,ECE 203,A00,091065,Mercier; Patrick Philip,0,0,0,0
1653509841724,ECE 207A,A00,091605,Liu; Thomas Tao-Ming,0,0,0,0
1653509842253,ECE 212AN,A00,091068,Nomura; Kenji,0,0,0,0
1653509842780,ECE 222A,A00,091069,Rebeiz; Gabriel,0,0,0,0
1653509843315,ECE 225A,A00,091070,Orlitsky; Alon,0,0,0,0
1653509843840,ECE 230A,A00,091071,Nomura; Kenji,0,0,0,0
1653509844365,ECE 236A,A00,091072,Dayeh; Shadi Ahmad,0,0,0,0
1653509844888,ECE 238A,A00,091073,Luo; Jian,0,0,0,0
1653509844888,ECE 238A,B00,091074,Luo; Jian,0,0,0,0
1653509845410,ECE 240A,A00,091075,Radic; Stojan,0,0,0,0
1653509845933,ECE 247A,A00,091592,Shi; Lingyan,0,0,0,0
1653509846457,ECE 250,A00,091076,Touri; Behrouz,0,0,0,0
1653509846984,ECE 251C,A00,091078,Nguyen; Truong Quang,0,0,0,0
1653509847514,ECE 253,A00,091079,Cosman; Pamela C.,0,0,0,0
1653509848036,ECE 255A,A00,091080,Orlitsky; Alon,0,0,0,0
1653509848558,ECE 257A,A00,091081,Zhang; Xinyu,0,0,0,0
1653509849083,ECE 260A,A01,091084,Eldon; John,0,0,0,0
1653509849616,ECE 264C,A00,091085,Galton; Ian A,0,0,0,0
1653509850143,ECE 265C,A00,094889,Presti; Calogero Davide,0,0,0,9
1653509850665,ECE 266,A01,091087,Hall; Drew A.,0,0,0,0
1653509851723,ECE 271A,A00,091090,Vasconcelos; Nuno,0,0,0,0
1653509852254,ECE 272B,A00,091091,Sworder; David D.,0,0,0,0
1653509852787,ECE 275A,A00,091092,Meyer; Florian,0,0,0,0
1653509853312,ECE 277,A00,091093,An; Cheolhong,0,0,0,0
1653509853835,ECE 283,A00,091094,Le; Hanh-Phuc,0,0,0,0
1653509854369,ECE 284,A00,091095,Kang; Mingu,0,0,0,0
1653509854369,ECE 284,B00,091096,Wang; Edward Jay,0,0,0,0
1653509854894,ECE 285,A00,094334,Touri; Behrouz,0,0,0,0
1653509855415,ECE 289,A00,091097,Whelan; David Arthur,0,0,0,0
1653509855943,MATH 200A,A00,087414,Salehi Golsefidy; Alireza,7,0,8,1
1653509856470,MATH 202A,A00,087415,Gill; Philip E.,3,0,8,5
1653509857018,MATH 203A,A00,087416,Oprea; Dragos N.,6,0,8,2
1653509857540,MATH 204A,A00,087417,Kedlaya; Kiran S.,6,0,8,2
1653509858063,MATH 205,A00,087418,Sorensen; Claus M,6,0,8,2
1653509858592,MATH 206A,A00,087419,Izadi; Elham,7,0,8,1
1653509859117,MATH 207A,A00,087420,Mohammadi; Amir,5,0,8,3
1653509859639,MATH 208,A00,087421,Staff,9,0,10,1
1653509860164,MATH 209,A00,087422,Staff,10,0,10,0
1653509860688,MATH 218,A00,087423,Staff,10,0,10,0
1653509861212,MATH 220A,A00,087424,Novak; Jonathan I,7,0,8,1
1653509861741,MATH 231A,A00,087425,Bejenaru; Ioan,3,0,8,5
1653509862266,MATH 240A,A00,087426,Ebenfelt; Peter F,5,0,8,3
1653509862788,MATH 243,A00,087427,Staff,9,0,10,1
1653509863310,MATH 248,A00,087429,Staff,10,0,10,0
1653509863836,MATH 250A,A00,087430,Spolaor; Luca,4,0,8,4
1653509864359,MATH 257A,A00,087431,Spolaor; Luca,7,0,8,1
1653509864883,MATH 258,A00,087432,Staff,9,0,10,1
1653509865425,MATH 264A,A00,087433,Warnke; Lutz Peter,5,0,8,3
1653509865949,MATH 268,A00,087434,Staff,15,0,15,0
1653509866471,MATH 269,A00,087435,Staff,14,0,15,1
1653509867006,MATH 270A,A00,087436,Nie; Jiawang,0,0,8,8
1653509867530,MATH 272A,A00,087437,Tian; Xiaochuan,1,0,8,7
1653509868067,MATH 274,A01,087439,Cheng; Li-Tien,9,0,10,1
1653509868067,MATH 274,A02,087440,Cheng; Li-Tien,10,0,10,0
1653509868591,MATH 278A,A00,087441,Staff,8,0,10,2
1653509869115,MATH 278B,A00,087442,Staff,8,0,10,2
1653509869642,MATH 278C,A00,087443,Staff,8,0,10,2
1653509870168,MATH 280A,A00,087444,Zheng; Tianyi,0,0,8,8
1653509870691,MATH 281A,A00,087445,Bradic; Jelena,0,0,8,8
1653509871216,MATH 282A,A00,087446,Zhang; Danna,0,0,8,8
1653509871740,MATH 283,A00,087447,Tesler; Glenn,0,0,0,15
1653509872271,MATH 286,A00,087448,Kemp; Todd Aahron,5,0,8,3
1653509872794,MATH 287D,A00,087449,Bradic; Jelena,8,0,8,0
1653509873317,MATH 288,A00,087450,Staff,14,0,15,1
1653509873317,MATH 288,B00,087451,Staff,15,0,15,0
1653509873317,MATH 288,C00,087452,Staff,15,0,15,0
1653509873840,MATH 290A,A00,087453,Xu; Zhouli,6,0,8,2
1653509874365,MATH 291A,A00,087454,Xu; Zhouli,7,0,8,1
1653509874893,MATH 292,A00,087455,Staff,10,0,10,0
1653509875417,MATH 295,A00,087456,Staff,50,0,50,0
1653509875938,MATH 297,001,087457,Staff,998,0,999,1
1653510436778,COGS 200,A01,087991,Staff,47,0,50,3
1653510437300,COGS 201,A01,094504,Rangel; Lara M,17,0,25,8
1653510437828,COGS 203,A00,087992,Coulson; Seana M,18,0,20,2
1653510438361,COGS 210A,001,087993,Greene; Deanna Jacquelyn,9998,0,9999,1
1653510438361,COGS 210A,002,087994,Saygin; Ayse P,9999,0,9999,0
1653510438361,COGS 210A,003,087995,Xia; Haijun,9999,0,9999,0
1653510438361,COGS 210A,004,087996,Nitz; Douglas A.,9999,0,9999,0
1653510438361,COGS 210A,005,087997,Hollan; James D.,9999,0,9999,0
1653510438361,COGS 210A,006,087998,Deak; Gedeon O.,9998,0,9999,1
1653510438361,COGS 210A,007,087999,Rossano; Federico,9999,0,9999,0
1653510438884,COGS 211A,A00,088000,Coulson; Seana M,9997,0,9999,2
1653510439423,COGS 229,A00,088002,Staff,23,0,25,2
1653510439957,COGS 260,B00,094231,Staff,17,0,20,3
1653510439957,COGS 260,A00,088004,Nitz; Douglas A.,9998,0,9999,1
1653510440484,CSE 202,A00,090110,Paturi; Ramamohan,0,0,0,0
1653510440484,CSE 202,B00,090111,Paturi; Ramamohan,0,0,0,0
1653510441007,CSE 207B,A00,090112,Heninger; Nadia A,0,0,0,0
1653510441541,CSE 208,A00,094858,Micciancio; Daniele,0,0,0,0
1653510442076,CSE 210,A00,090113,Powell; Thomas Allan,0,0,0,0
1653510442599,CSE 219,A00,090898,Staff,0,0,0,0
1653510443127,CSE 221,A00,090114,Zhou; Yuan-Yuan,0,0,0,0
1653510443651,CSE 229A,A00,090115,Porter; George M,0,0,0,0
1653510444176,CSE 229C,A00,090116,Savage; Stefan,0,0,0,0
1653510444701,CSE 230,A00,090117,Jhala; Ranjit,0,0,0,0
1653510445223,CSE 232,A00,090118,Papakonstantinou; Yannis,0,0,0,0
1653510445752,CSE 239A,A00,090121,Kumar; Arun Kumar,0,0,0,0
1653510446285,CSE 239B,A00,090122,Jhala; Ranjit,0,0,0,0
1653510446810,CSE 240A,A00,090123,Zhao; Jishen,0,0,189,189
1653510447334,CSE 243A,A00,090124,Orailoglu; Alex,0,0,15,15
1653510447856,CSE 249B,A00,090125,Kahng; Andrew Byun,13,0,20,7
1653510448379,CSE 250A,A00,090126,Berg-Kirkpatrick; Taylor D,0,0,0,0
1653510448912,CSE 252A,A00,090127,Ochoa; Benjamin Lawrence,0,0,0,0
1653510449438,CSE 258,A01,090129,McAuley; Julian John,0,0,0,0
1653510449961,CSE 258R,A01,090131,McAuley; Julian John,0,0,0,0
1653510450491,CSE 274,A00,090132,Ramamoorthi; Ravi,0,0,0,0
1653510451013,CSE 276A,A00,090133,Christensen; Henrik I,0,0,0,0
1653510451545,CSE 276C,A00,090134,Christensen; Henrik I,0,0,0,0
1653510452068,CSE 290,A00,090135,Bafna; Vineet,0,0,0,0
1653510452068,CSE 290,B00,090136,Ramamoorthi; Ravi,0,0,0,0
1653510452068,CSE 290,C00,090137,Li; Tzumao,8,0,10,2
1653510452068,CSE 290,D00,090138,Zhou; Yuan-Yuan,9,0,10,1
1653510452068,CSE 290,E00,090139,Christensen; Henrik I,9,0,10,1
1653510452068,CSE 290,F00,094053,Shalev; Aaron D,0,0,0,0
1653510452592,CSE 291,A00,090140,Munyaka; Imani N. S.,0,0,0,0
1653510452592,CSE 291,B00,094880,Yu; Qi,0,0,0,0
1653510452592,CSE 291,C00,090142,Pannuto; Patrick William,0,0,0,0
1653510452592,CSE 291,D00,094881,Zhang; Yiying,0,0,0,0
1653510452592,CSE 291,E00,095118,Su; Hao,0,0,0,0
1653510453126,CSE 293,001,094905,Bafna; Vineet,9999,0,9999,0
1653510453126,CSE 293,002,094906,Bellare; Mihir,9999,0,9999,0
1653510453126,CSE 293,003,094907,Berg-Kirkpatrick; Taylor D,9999,0,9999,0
1653510453126,CSE 293,004,094908,Christensen; Henrik I,9999,0,9999,0
1653510453126,CSE 293,005,094909,Cottrell; Garrison W,9999,0,9999,0
1653510453126,CSE 293,006,094910,Deutsch; Alin Bernard,9999,0,9999,0
1653510453126,CSE 293,007,094911,Esmaeilzadeh; Hadi,9999,0,9999,0
1653510453126,CSE 293,008,094912,Freund; Yoav,9999,0,9999,0
1653510453126,CSE 293,009,094913,Griswold; William G.,9999,0,9999,0
1653510453126,CSE 293,010,094914,Gymrek; Melissa Ann,9999,0,9999,0
1653510453126,CSE 293,011,094915,Heninger; Nadia A,9999,0,9999,0
1653510453126,CSE 293,012,094916,Impagliazzo; Russell,9999,0,9999,0
1653510453126,CSE 293,013,094917,Jhala; Ranjit,9999,0,9999,0
1653510453126,CSE 293,014,094918,Kahng; Andrew Byun,9999,0,9999,0
1653510453126,CSE 293,015,094919,Kane; Daniel Mertz,9999,0,9999,0
1653510453126,CSE 293,016,094920,Kriegman; David J,9999,0,9999,0
1653510453126,CSE 293,017,094921,Kumar; Arun Kumar,9999,0,9999,0
1653510453126,CSE 293,018,094922,Lerner; Sorin,9999,0,9999,0
1653510453126,CSE 293,019,094923,Lovett; Shachar,9999,0,9999,0
1653510453126,CSE 293,020,094924,McAuley; Julian John,9999,0,9999,0
1653510453126,CSE 293,021,094925,Micciancio; Daniele,9999,0,9999,0
1653510453126,CSE 293,022,094926,Orailoglu; Alex,9999,0,9999,0
1653510453126,CSE 293,023,094927,Paturi; Ramamohan,9999,0,9999,0
1653510453126,CSE 293,024,094928,Polikarpova; Nadezhda,9999,0,9999,0
1653510453126,CSE 293,025,094929,Politz; Joseph Gibbs,9999,0,9999,0
1653510453126,CSE 293,026,094930,Porter; George M,9999,0,9999,0
1653510453126,CSE 293,027,094931,Porter; Leonard Emerson,9999,0,9999,0
1653510453126,CSE 293,028,094932,Ramamoorthi; Ravi,9999,0,9999,0
1653510453126,CSE 293,029,094933,Sahoo; Debashis,9999,0,9999,0
1653510453126,CSE 293,030,094934,Saul; Lawrence,9999,0,9999,0
1653510453126,CSE 293,031,094935,Savage; Stefan,9999,0,9999,0
1653510453126,CSE 293,032,094936,Schulze; Jurgen P.,9999,0,9999,0
1653510453126,CSE 293,033,094937,Snoeren; Alex C.,9999,0,9999,0
1653510453126,CSE 293,034,094938,Shang; Jingbo,9999,0,9999,0
1653510453126,CSE 293,035,094939,Stefan; Deian,9999,0,9999,0
1653510453126,CSE 293,036,094940,Su; Hao,9999,0,9999,0
1653510453126,CSE 293,037,094941,Swanson; Steven James,9999,0,9999,0
1653510453126,CSE 293,038,094942,Tullsen; Dean Michael,9999,0,9999,0
1653510453126,CSE 293,039,094943,Voelker; Geoffrey M.,9999,0,9999,0
1653510453126,CSE 293,040,094944,Zhao; Jishen,9999,0,9999,0
1653510453126,CSE 293,041,094945,Zhou; Yuan-Yuan,9999,0,9999,0
1653510453126,CSE 293,042,094946,Gao; Sicun,9998,0,9999,1
1653510453126,CSE 293,043,094947,Weibel; Nadir,9999,0,9999,0
1653510453126,CSE 293,044,094948,Gupta; Rajesh K.,9999,0,9999,0
1653510453647,CSE 294,A00,090143,Porter; George M,8,0,10,2
1653510454172,DSE 200,A00,091799,Staff,50,0,50,0
1653510454700,DSE 203,A00,091800,Gupta; Amarnath,30,0,30,0
1653510455233,DSE 250,A00,091801,Deutsch; Alin Bernard,30,0,30,0
1653510455758,DSE 290,A00,091802,Altintas De Callaf; Ilkay,50,0,50,0
1653510456304,ECE 200,001,091003,Antipa; Nicholas A,9999,0,9999,0
1653510456304,ECE 200,002,091004,Atanasov; Nikolay A.,9999,0,9999,0
1653510456304,ECE 200,003,091005,Bharadia; Dinesh,9999,0,9999,0
1653510456304,ECE 200,004,091006,Cheng; Chung Kuan,9999,0,9999,0
1653510456304,ECE 200,005,091007,Cosman; Pamela C.,9999,0,9999,0
1653510456304,ECE 200,006,091008,Staff,9999,0,9999,0
1653510456304,ECE 200,007,091009,Dayeh; Shadi Ahmad,9999,0,9999,0
1653510456304,ECE 200,008,091010,Fainman; Yeshaiahu,9999,0,9999,0
1653510456304,ECE 200,009,091011,Ford; Joseph Earl,9999,0,9999,0
1653510456304,ECE 200,010,091012,Franceschetti; Massimo,9999,0,9999,0
1653510456304,ECE 200,011,091013,Fullerton; Eric E,9999,0,9999,0
1653510456304,ECE 200,012,091014,Galton; Ian A,9999,0,9999,0
1653510456304,ECE 200,013,091015,Gilja; Vikash,9999,0,9999,0
1653510456304,ECE 200,014,091016,Hall; Drew A.,9999,0,9999,0
1653510456304,ECE 200,015,091017,Hsueh; Tzu-Chien,9999,0,9999,0
1653510456304,ECE 200,016,091018,Javidi; Tara,9999,0,9999,0
1653510456304,ECE 200,017,091019,Kahng; Andrew Byun,9999,0,9999,0
1653510456304,ECE 200,018,091020,Kim; Young-Han,9999,0,9999,0
1653510456304,ECE 200,019,091021,Koushanfar; Farinaz,9999,0,9999,0
1653510456304,ECE 200,020,091022,Kuzum; Duygu,9999,0,9999,0
1653510456304,ECE 200,021,091023,Le; Hanh-Phuc,9999,0,9999,0
1653510456304,ECE 200,022,091024,Lin; Bill,9999,0,9999,0
1653510456304,ECE 200,023,091025,Liu; Zhaowei,9999,0,9999,0
1653510456304,ECE 200,024,091026,Lo; Yu-Hwa,9999,0,9999,0
1653510456304,ECE 200,025,091027,Lomakin; Vitaliy,9999,0,9999,0
1653510456304,ECE 200,026,091028,Mercier; Patrick Philip,9999,0,9999,0
1653510456304,ECE 200,027,091029,Meyer; Florian,9999,0,9999,0
1653510456304,ECE 200,028,091030,Milstein; Laurence B.,9999,0,9999,0
1653510456304,ECE 200,029,091031,Mir Arabbaygi; Siavash,9999,0,9999,0
1653510456304,ECE 200,030,091032,Mookherjea; Shayan,9999,0,9999,0
1653510456304,ECE 200,031,091033,Morris; Karcher William,9999,0,9999,0
1653510456304,ECE 200,032,091034,Ng; Tse Nga,9999,0,9999,0
1653510456304,ECE 200,033,091035,Nguyen; Truong Quang,9999,0,9999,0
1653510456304,ECE 200,034,091036,Nomura; Kenji,9999,0,9999,0
1653510456304,ECE 200,035,091037,Orlitsky; Alon,9999,0,9999,0
1653510456304,ECE 200,036,091038,Pal; Piya,9999,0,9999,0
1653510456304,ECE 200,037,091039,Papen; George C.,9999,0,9999,0
1653510456304,ECE 200,038,091040,Radic; Stojan,9999,0,9999,0
1653510456304,ECE 200,039,091041,Rao; Bhaskar D.,9999,0,9999,0
1653510456304,ECE 200,040,091042,Rao; Ramesh R,9999,0,9999,0
1653510456304,ECE 200,041,091043,Rebeiz; Gabriel,9999,0,9999,0
1653510456304,ECE 200,042,091044,Sanford; John R,9999,0,9999,0
1653510456304,ECE 200,043,091045,Siegel; Paul H.,9999,0,9999,0
1653510456304,ECE 200,044,091046,Sievenpiper; Daniel F.,9999,0,9999,0
1653510456304,ECE 200,045,091047,Sworder; David D.,9999,0,9999,0
1653510456304,ECE 200,046,091048,Taur; Yuan,9999,0,9999,0
1653510456304,ECE 200,047,091049,Touri; Behrouz,9999,0,9999,0
1653510456304,ECE 200,048,091050,Trivedi; Mohan M.,9999,0,9999,0
1653510456304,ECE 200,049,091051,Vardy; Alexander,9999,0,9999,0
1653510456304,ECE 200,050,091052,Vasconcelos; Nuno,9999,0,9999,0
1653510456304,ECE 200,051,091053,Wang; Xiaolong,9999,0,9999,0
1653510456304,ECE 200,052,091054,Xie; Pengtao,9999,0,9999,0
1653510456304,ECE 200,053,091055,Yip; Michael,9999,0,9999,0
1653510456304,ECE 200,054,091056,Zeger; Kenneth A.,9999,0,9999,0
1653510456304,ECE 200,055,091057,Zhang; Xinyu,9999,0,9999,0
1653510456304,ECE 200,056,091058,Turakhia; Yatish Girish,9999,0,9999,0
1653510456304,ECE 200,057,091059,Kang; Mingu,9999,0,9999,0
1653510456304,ECE 200,058,091060,Shi; Yuanyuan,9999,0,9999,0
1653510456304,ECE 200,059,091061,Wang; Edward Jay,9999,0,9999,0
1653510456304,ECE 200,060,091062,Zheng; Yang,9999,0,9999,0
1653510456826,ECE 201,A00,095526,Lo; Yu-Hwa,0,0,0,0
1653510457351,ECE 203,A00,091065,Mercier; Patrick Philip,0,0,0,0
1653510457874,ECE 207A,A00,091605,Liu; Thomas Tao-Ming,0,0,0,0
1653510458395,ECE 212AN,A00,091068,Nomura; Kenji,0,0,0,0
1653510458918,ECE 222A,A00,091069,Rebeiz; Gabriel,0,0,0,0
1653510459441,ECE 225A,A00,091070,Orlitsky; Alon,0,0,0,0
1653510459971,ECE 230A,A00,091071,Nomura; Kenji,0,0,0,0
1653510460494,ECE 236A,A00,091072,Dayeh; Shadi Ahmad,0,0,0,0
1653510461024,ECE 238A,A00,091073,Luo; Jian,0,0,0,0
1653510461024,ECE 238A,B00,091074,Luo; Jian,0,0,0,0
1653510461552,ECE 240A,A00,091075,Radic; Stojan,0,0,0,0
1653510462079,ECE 247A,A00,091592,Shi; Lingyan,0,0,0,0
1653510462602,ECE 250,A00,091076,Touri; Behrouz,0,0,0,0
1653510463130,ECE 251C,A00,091078,Nguyen; Truong Quang,0,0,0,0
1653510463654,ECE 253,A00,091079,Cosman; Pamela C.,0,0,0,0
1653510464177,ECE 255A,A00,091080,Orlitsky; Alon,0,0,0,0
1653510464698,ECE 257A,A00,091081,Zhang; Xinyu,0,0,0,0
1653510465221,ECE 260A,A01,091084,Eldon; John,0,0,0,0
1653510465749,ECE 264C,A00,091085,Galton; Ian A,0,0,0,0
1653510466275,ECE 265C,A00,094889,Presti; Calogero Davide,0,0,0,9
1653510466804,ECE 266,A01,091087,Hall; Drew A.,0,0,0,0
1653510467858,ECE 271A,A00,091090,Vasconcelos; Nuno,0,0,0,0
1653510468395,ECE 272B,A00,091091,Sworder; David D.,0,0,0,0
1653510468921,ECE 275A,A00,091092,Meyer; Florian,0,0,0,0
1653510469443,ECE 277,A00,091093,An; Cheolhong,0,0,0,0
1653510469975,ECE 283,A00,091094,Le; Hanh-Phuc,0,0,0,0
1653510470516,ECE 284,A00,091095,Kang; Mingu,0,0,0,0
1653510470516,ECE 284,B00,091096,Wang; Edward Jay,0,0,0,0
1653510471045,ECE 285,A00,094334,Touri; Behrouz,0,0,0,0
1653510471571,ECE 289,A00,091097,Whelan; David Arthur,0,0,0,0
1653510472118,MATH 200A,A00,087414,Salehi Golsefidy; Alireza,7,0,8,1
1653510472732,MATH 202A,A00,087415,Gill; Philip E.,3,0,8,5
1653510473255,MATH 203A,A00,087416,Oprea; Dragos N.,6,0,8,2
1653510473777,MATH 204A,A00,087417,Kedlaya; Kiran S.,6,0,8,2
1653510474301,MATH 205,A00,087418,Sorensen; Claus M,6,0,8,2
1653510474823,MATH 206A,A00,087419,Izadi; Elham,7,0,8,1
1653510475348,MATH 207A,A00,087420,Mohammadi; Amir,5,0,8,3
1653510475881,MATH 208,A00,087421,Staff,9,0,10,1
1653510476403,MATH 209,A00,087422,Staff,10,0,10,0
1653510476934,MATH 218,A00,087423,Staff,10,0,10,0
1653510477460,MATH 220A,A00,087424,Novak; Jonathan I,7,0,8,1
1653510477992,MATH 231A,A00,087425,Bejenaru; Ioan,3,0,8,5
1653510478523,MATH 240A,A00,087426,Ebenfelt; Peter F,5,0,8,3
1653510479047,MATH 243,A00,087427,Staff,9,0,10,1
1653510479576,MATH 248,A00,087429,Staff,10,0,10,0
1653510480098,MATH 250A,A00,087430,Spolaor; Luca,4,0,8,4
1653510480622,MATH 257A,A00,087431,Spolaor; Luca,7,0,8,1
1653510481147,MATH 258,A00,087432,Staff,9,0,10,1
1653510481678,MATH 264A,A00,087433,Warnke; Lutz Peter,5,0,8,3
1653510482204,MATH 268,A00,087434,Staff,15,0,15,0
1653510482726,MATH 269,A00,087435,Staff,14,0,15,1
1653510483256,MATH 270A,A00,087436,Nie; Jiawang,0,0,8,8
1653510483782,MATH 272A,A00,087437,Tian; Xiaochuan,1,0,8,7
1653510484309,MATH 274,A01,087439,Cheng; Li-Tien,9,0,10,1
1653510484309,MATH 274,A02,087440,Cheng; Li-Tien,10,0,10,0
1653510484831,MATH 278A,A00,087441,Staff,8,0,10,2
1653510485356,MATH 278B,A00,087442,Staff,8,0,10,2
1653510485884,MATH 278C,A00,087443,Staff,8,0,10,2
1653510486411,MATH 280A,A00,087444,Zheng; Tianyi,0,0,8,8
1653510486933,MATH 281A,A00,087445,Bradic; Jelena,0,0,8,8
1653510487459,MATH 282A,A00,087446,Zhang; Danna,0,0,8,8
1653510487982,MATH 283,A00,087447,Tesler; Glenn,0,0,0,15
1653510488504,MATH 286,A00,087448,Kemp; Todd Aahron,5,0,8,3
1653510489031,MATH 287D,A00,087449,Bradic; Jelena,8,0,8,0
1653510489553,MATH 288,A00,087450,Staff,14,0,15,1
1653510489553,MATH 288,B00,087451,Staff,15,0,15,0
1653510489553,MATH 288,C00,087452,Staff,15,0,15,0
1653510490077,MATH 290A,A00,087453,Xu; Zhouli,6,0,8,2
1653510490605,MATH 291A,A00,087454,Xu; Zhouli,7,0,8,1
1653510491130,MATH 292,A00,087455,Staff,10,0,10,0
1653510491652,MATH 295,A00,087456,Staff,50,0,50,0
1653510492180,MATH 297,001,087457,Staff,998,0,999,1
1653511053374,COGS 200,A01,087991,Staff,47,0,50,3
1653511053972,COGS 201,A01,094504,Rangel; Lara M,17,0,25,8
1653511054497,COGS 203,A00,087992,Coulson; Seana M,18,0,20,2
1653511055022,COGS 210A,001,087993,Greene; Deanna Jacquelyn,9998,0,9999,1
1653511055022,COGS 210A,002,087994,Saygin; Ayse P,9999,0,9999,0
1653511055022,COGS 210A,003,087995,Xia; Haijun,9999,0,9999,0
1653511055022,COGS 210A,004,087996,Nitz; Douglas A.,9999,0,9999,0
1653511055022,COGS 210A,005,087997,Hollan; James D.,9999,0,9999,0
1653511055022,COGS 210A,006,087998,Deak; Gedeon O.,9998,0,9999,1
1653511055022,COGS 210A,007,087999,Rossano; Federico,9999,0,9999,0
1653511055547,COGS 211A,A00,088000,Coulson; Seana M,9997,0,9999,2
1653511056077,COGS 229,A00,088002,Staff,23,0,25,2
1653511056604,COGS 260,B00,094231,Staff,17,0,20,3
1653511056604,COGS 260,A00,088004,Nitz; Douglas A.,9998,0,9999,1
1653511057125,CSE 202,A00,090110,Paturi; Ramamohan,0,0,0,0
1653511057125,CSE 202,B00,090111,Paturi; Ramamohan,0,0,0,0
1653511057650,CSE 207B,A00,090112,Heninger; Nadia A,0,0,0,0
1653511058171,CSE 208,A00,094858,Micciancio; Daniele,0,0,0,0
1653511058717,CSE 210,A00,090113,Powell; Thomas Allan,0,0,0,0
1653511059243,CSE 219,A00,090898,Staff,0,0,0,0
1653511059769,CSE 221,A00,090114,Zhou; Yuan-Yuan,0,0,0,0
1653511060298,CSE 229A,A00,090115,Porter; George M,0,0,0,0
1653511060828,CSE 229C,A00,090116,Savage; Stefan,0,0,0,0
1653511061435,CSE 230,A00,090117,Jhala; Ranjit,0,0,0,0
1653511061961,CSE 232,A00,090118,Papakonstantinou; Yannis,0,0,0,0
1653511062492,CSE 239A,A00,090121,Kumar; Arun Kumar,0,0,0,0
1653511063016,CSE 239B,A00,090122,Jhala; Ranjit,0,0,0,0
1653511063538,CSE 240A,A00,090123,Zhao; Jishen,0,0,189,189
1653511064060,CSE 243A,A00,090124,Orailoglu; Alex,0,0,15,15
1653511064581,CSE 249B,A00,090125,Kahng; Andrew Byun,13,0,20,7
1653511065104,CSE 250A,A00,090126,Berg-Kirkpatrick; Taylor D,0,0,0,0
1653511065626,CSE 252A,A00,090127,Ochoa; Benjamin Lawrence,0,0,0,0
1653511066149,CSE 258,A01,090129,McAuley; Julian John,0,0,0,0
1653511066669,CSE 258R,A01,090131,McAuley; Julian John,0,0,0,0
1653511067192,CSE 274,A00,090132,Ramamoorthi; Ravi,0,0,0,0
1653511067721,CSE 276A,A00,090133,Christensen; Henrik I,0,0,0,0
1653511068256,CSE 276C,A00,090134,Christensen; Henrik I,0,0,0,0
1653511068778,CSE 290,A00,090135,Bafna; Vineet,0,0,0,0
1653511068778,CSE 290,B00,090136,Ramamoorthi; Ravi,0,0,0,0
1653511068778,CSE 290,C00,090137,Li; Tzumao,8,0,10,2
1653511068778,CSE 290,D00,090138,Zhou; Yuan-Yuan,9,0,10,1
1653511068778,CSE 290,E00,090139,Christensen; Henrik I,9,0,10,1
1653511068778,CSE 290,F00,094053,Shalev; Aaron D,0,0,0,0
1653511069302,CSE 291,A00,090140,Munyaka; Imani N. S.,0,0,0,0
1653511069302,CSE 291,B00,094880,Yu; Qi,0,0,0,0
1653511069302,CSE 291,C00,090142,Pannuto; Patrick William,0,0,0,0
1653511069302,CSE 291,D00,094881,Zhang; Yiying,0,0,0,0
1653511069302,CSE 291,E00,095118,Su; Hao,0,0,0,0
1653511069828,CSE 293,001,094905,Bafna; Vineet,9999,0,9999,0
1653511069828,CSE 293,002,094906,Bellare; Mihir,9999,0,9999,0
1653511069828,CSE 293,003,094907,Berg-Kirkpatrick; Taylor D,9999,0,9999,0
1653511069828,CSE 293,004,094908,Christensen; Henrik I,9999,0,9999,0
1653511069828,CSE 293,005,094909,Cottrell; Garrison W,9999,0,9999,0
1653511069828,CSE 293,006,094910,Deutsch; Alin Bernard,9999,0,9999,0
1653511069828,CSE 293,007,094911,Esmaeilzadeh; Hadi,9999,0,9999,0
1653511069828,CSE 293,008,094912,Freund; Yoav,9999,0,9999,0
1653511069828,CSE 293,009,094913,Griswold; William G.,9999,0,9999,0
1653511069828,CSE 293,010,094914,Gymrek; Melissa Ann,9999,0,9999,0
1653511069828,CSE 293,011,094915,Heninger; Nadia A,9999,0,9999,0
1653511069828,CSE 293,012,094916,Impagliazzo; Russell,9999,0,9999,0
1653511069828,CSE 293,013,094917,Jhala; Ranjit,9999,0,9999,0
1653511069828,CSE 293,014,094918,Kahng; Andrew Byun,9999,0,9999,0
1653511069828,CSE 293,015,094919,Kane; Daniel Mertz,9999,0,9999,0
1653511069828,CSE 293,016,094920,Kriegman; David J,9999,0,9999,0
1653511069828,CSE 293,017,094921,Kumar; Arun Kumar,9999,0,9999,0
1653511069828,CSE 293,018,094922,Lerner; Sorin,9999,0,9999,0
1653511069828,CSE 293,019,094923,Lovett; Shachar,9999,0,9999,0
1653511069828,CSE 293,020,094924,McAuley; Julian John,9999,0,9999,0
1653511069828,CSE 293,021,094925,Micciancio; Daniele,9999,0,9999,0
1653511069828,CSE 293,022,094926,Orailoglu; Alex,9999,0,9999,0
1653511069828,CSE 293,023,094927,Paturi; Ramamohan,9999,0,9999,0
1653511069828,CSE 293,024,094928,Polikarpova; Nadezhda,9999,0,9999,0
1653511069828,CSE 293,025,094929,Politz; Joseph Gibbs,9999,0,9999,0
1653511069828,CSE 293,026,094930,Porter; George M,9999,0,9999,0
1653511069828,CSE 293,027,094931,Porter; Leonard Emerson,9999,0,9999,0
1653511069828,CSE 293,028,094932,Ramamoorthi; Ravi,9999,0,9999,0
1653511069828,CSE 293,029,094933,Sahoo; Debashis,9999,0,9999,0
1653511069828,CSE 293,030,094934,Saul; Lawrence,9999,0,9999,0
1653511069828,CSE 293,031,094935,Savage; Stefan,9999,0,9999,0
1653511069828,CSE 293,032,094936,Schulze; Jurgen P.,9999,0,9999,0
1653511069828,CSE 293,033,094937,Snoeren; Alex C.,9999,0,9999,0
1653511069828,CSE 293,034,094938,Shang; Jingbo,9999,0,9999,0
1653511069828,CSE 293,035,094939,Stefan; Deian,9999,0,9999,0
1653511069828,CSE 293,036,094940,Su; Hao,9999,0,9999,0
1653511069828,CSE 293,037,094941,Swanson; Steven James,9999,0,9999,0
1653511069828,CSE 293,038,094942,Tullsen; Dean Michael,9999,0,9999,0
1653511069828,CSE 293,039,094943,Voelker; Geoffrey M.,9999,0,9999,0
1653511069828,CSE 293,040,094944,Zhao; Jishen,9999,0,9999,0
1653511069828,CSE 293,041,094945,Zhou; Yuan-Yuan,9999,0,9999,0
1653511069828,CSE 293,042,094946,Gao; Sicun,9998,0,9999,1
1653511069828,CSE 293,043,094947,Weibel; Nadir,9999,0,9999,0
1653511069828,CSE 293,044,094948,Gupta; Rajesh K.,9999,0,9999,0
1653511070353,CSE 294,A00,090143,Porter; George M,8,0,10,2
1653511070875,DSE 200,A00,091799,Staff,50,0,50,0
1653511071399,DSE 203,A00,091800,Gupta; Amarnath,30,0,30,0
1653511071923,DSE 250,A00,091801,Deutsch; Alin Bernard,30,0,30,0
1653511072458,DSE 290,A00,091802,Altintas De Callaf; Ilkay,50,0,50,0
1653511072998,ECE 200,001,091003,Antipa; Nicholas A,9999,0,9999,0
1653511072998,ECE 200,002,091004,Atanasov; Nikolay A.,9999,0,9999,0
1653511072998,ECE 200,003,091005,Bharadia; Dinesh,9999,0,9999,0
1653511072998,ECE 200,004,091006,Cheng; Chung Kuan,9999,0,9999,0
1653511072998,ECE 200,005,091007,Cosman; Pamela C.,9999,0,9999,0
1653511072998,ECE 200,006,091008,Staff,9999,0,9999,0
1653511072998,ECE 200,007,091009,Dayeh; Shadi Ahmad,9999,0,9999,0
1653511072998,ECE 200,008,091010,Fainman; Yeshaiahu,9999,0,9999,0
1653511072998,ECE 200,009,091011,Ford; Joseph Earl,9999,0,9999,0
1653511072998,ECE 200,010,091012,Franceschetti; Massimo,9999,0,9999,0
1653511072998,ECE 200,011,091013,Fullerton; Eric E,9999,0,9999,0
1653511072998,ECE 200,012,091014,Galton; Ian A,9999,0,9999,0
1653511072998,ECE 200,013,091015,Gilja; Vikash,9999,0,9999,0
1653511072998,ECE 200,014,091016,Hall; Drew A.,9999,0,9999,0
1653511072998,ECE 200,015,091017,Hsueh; Tzu-Chien,9999,0,9999,0
1653511072998,ECE 200,016,091018,Javidi; Tara,9999,0,9999,0
1653511072998,ECE 200,017,091019,Kahng; Andrew Byun,9999,0,9999,0
1653511072998,ECE 200,018,091020,Kim; Young-Han,9999,0,9999,0
1653511072998,ECE 200,019,091021,Koushanfar; Farinaz,9999,0,9999,0
1653511072998,ECE 200,020,091022,Kuzum; Duygu,9999,0,9999,0
1653511072998,ECE 200,021,091023,Le; Hanh-Phuc,9999,0,9999,0
1653511072998,ECE 200,022,091024,Lin; Bill,9999,0,9999,0
1653511072998,ECE 200,023,091025,Liu; Zhaowei,9999,0,9999,0
1653511072998,ECE 200,024,091026,Lo; Yu-Hwa,9999,0,9999,0
1653511072998,ECE 200,025,091027,Lomakin; Vitaliy,9999,0,9999,0
1653511072998,ECE 200,026,091028,Mercier; Patrick Philip,9999,0,9999,0
1653511072998,ECE 200,027,091029,Meyer; Florian,9999,0,9999,0
1653511072998,ECE 200,028,091030,Milstein; Laurence B.,9999,0,9999,0
1653511072998,ECE 200,029,091031,Mir Arabbaygi; Siavash,9999,0,9999,0
1653511072998,ECE 200,030,091032,Mookherjea; Shayan,9999,0,9999,0
1653511072998,ECE 200,031,091033,Morris; Karcher William,9999,0,9999,0
1653511072998,ECE 200,032,091034,Ng; Tse Nga,9999,0,9999,0
1653511072998,ECE 200,033,091035,Nguyen; Truong Quang,9999,0,9999,0
1653511072998,ECE 200,034,091036,Nomura; Kenji,9999,0,9999,0
1653511072998,ECE 200,035,091037,Orlitsky; Alon,9999,0,9999,0
1653511072998,ECE 200,036,091038,Pal; Piya,9999,0,9999,0
1653511072998,ECE 200,037,091039,Papen; George C.,9999,0,9999,0
1653511072998,ECE 200,038,091040,Radic; Stojan,9999,0,9999,0
1653511072998,ECE 200,039,091041,Rao; Bhaskar D.,9999,0,9999,0
1653511072998,ECE 200,040,091042,Rao; Ramesh R,9999,0,9999,0
1653511072998,ECE 200,041,091043,Rebeiz; Gabriel,9999,0,9999,0
1653511072998,ECE 200,042,091044,Sanford; John R,9999,0,9999,0
1653511072998,ECE 200,043,091045,Siegel; Paul H.,9999,0,9999,0
1653511072998,ECE 200,044,091046,Sievenpiper; Daniel F.,9999,0,9999,0
1653511072998,ECE 200,045,091047,Sworder; David D.,9999,0,9999,0
1653511072998,ECE 200,046,091048,Taur; Yuan,9999,0,9999,0
1653511072998,ECE 200,047,091049,Touri; Behrouz,9999,0,9999,0
1653511072998,ECE 200,048,091050,Trivedi; Mohan M.,9999,0,9999,0
1653511072998,ECE 200,049,091051,Vardy; Alexander,9999,0,9999,0
1653511072998,ECE 200,050,091052,Vasconcelos; Nuno,9999,0,9999,0
1653511072998,ECE 200,051,091053,Wang; Xiaolong,9999,0,9999,0
1653511072998,ECE 200,052,091054,Xie; Pengtao,9999,0,9999,0
1653511072998,ECE 200,053,091055,Yip; Michael,9999,0,9999,0
1653511072998,ECE 200,054,091056,Zeger; Kenneth A.,9999,0,9999,0
1653511072998,ECE 200,055,091057,Zhang; Xinyu,9999,0,9999,0
1653511072998,ECE 200,056,091058,Turakhia; Yatish Girish,9999,0,9999,0
1653511072998,ECE 200,057,091059,Kang; Mingu,9999,0,9999,0
1653511072998,ECE 200,058,091060,Shi; Yuanyuan,9999,0,9999,0
1653511072998,ECE 200,059,091061,Wang; Edward Jay,9999,0,9999,0
1653511072998,ECE 200,060,091062,Zheng; Yang,9999,0,9999,0
1653511073521,ECE 201,A00,095526,Lo; Yu-Hwa,0,0,0,0
1653511074047,ECE 203,A00,091065,Mercier; Patrick Philip,0,0,0,0
1653511074569,ECE 207A,A00,091605,Liu; Thomas Tao-Ming,0,0,0,0
1653511075099,ECE 212AN,A00,091068,Nomura; Kenji,0,0,0,0
1653511075626,ECE 222A,A00,091069,Rebeiz; Gabriel,0,0,0,0
1653511076148,ECE 225A,A00,091070,Orlitsky; Alon,0,0,0,0
1653511076677,ECE 230A,A00,091071,Nomura; Kenji,0,0,0,0
1653511077199,ECE 236A,A00,091072,Dayeh; Shadi Ahmad,0,0,0,0
1653511077729,ECE 238A,A00,091073,Luo; Jian,0,0,0,0
1653511077729,ECE 238A,B00,091074,Luo; Jian,0,0,0,0
1653511078256,ECE 240A,A00,091075,Radic; Stojan,0,0,0,0
1653511078777,ECE 247A,A00,091592,Shi; Lingyan,0,0,0,0
1653511079305,ECE 250,A00,091076,Touri; Behrouz,0,0,0,0
1653511079828,ECE 251C,A00,091078,Nguyen; Truong Quang,0,0,0,0
1653511080352,ECE 253,A00,091079,Cosman; Pamela C.,0,0,0,0
1653511080882,ECE 255A,A00,091080,Orlitsky; Alon,0,0,0,0
1653511081420,ECE 257A,A00,091081,Zhang; Xinyu,0,0,0,0
1653511081943,ECE 260A,A01,091084,Eldon; John,0,0,0,0
1653511082477,ECE 264C,A00,091085,Galton; Ian A,0,0,0,0
1653511082998,ECE 265C,A00,094889,Presti; Calogero Davide,0,0,0,9
1653511083529,ECE 266,A01,091087,Hall; Drew A.,0,0,0,0
1653511084575,ECE 271A,A00,091090,Vasconcelos; Nuno,0,0,0,0
1653511085102,ECE 272B,A00,091091,Sworder; David D.,0,0,0,0
1653511085624,ECE 275A,A00,091092,Meyer; Florian,0,0,0,0
1653511086148,ECE 277,A00,091093,An; Cheolhong,0,0,0,0
1653511086671,ECE 283,A00,091094,Le; Hanh-Phuc,0,0,0,0
1653511087210,ECE 284,A00,091095,Kang; Mingu,0,0,0,0
1653511087210,ECE 284,B00,091096,Wang; Edward Jay,0,0,0,0
1653511087732,ECE 285,A00,094334,Touri; Behrouz,0,0,0,0
1653511088255,ECE 289,A00,091097,Whelan; David Arthur,0,0,0,0
1653511088787,MATH 200A,A00,087414,Salehi Golsefidy; Alireza,7,0,8,1
1653511089317,MATH 202A,A00,087415,Gill; Philip E.,3,0,8,5
1653511089843,MATH 203A,A00,087416,Oprea; Dragos N.,6,0,8,2
1653511090369,MATH 204A,A00,087417,Kedlaya; Kiran S.,6,0,8,2
1653511090890,MATH 205,A00,087418,Sorensen; Claus M,6,0,8,2
1653511091413,MATH 206A,A00,087419,Izadi; Elham,7,0,8,1
1653511091935,MATH 207A,A00,087420,Mohammadi; Amir,5,0,8,3
1653511092456,MATH 208,A00,087421,Staff,9,0,10,1
1653511092979,MATH 209,A00,087422,Staff,10,0,10,0
1653511093565,MATH 218,A00,087423,Staff,10,0,10,0
1653511094096,MATH 220A,A00,087424,Novak; Jonathan I,7,0,8,1
1653511094618,MATH 231A,A00,087425,Bejenaru; Ioan,3,0,8,5
1653511095142,MATH 240A,A00,087426,Ebenfelt; Peter F,5,0,8,3
1653511095671,MATH 243,A00,087427,Staff,9,0,10,1
1653511096193,MATH 248,A00,087429,Staff,10,0,10,0
1653511096715,MATH 250A,A00,087430,Spolaor; Luca,4,0,8,4
1653511097239,MATH 257A,A00,087431,Spolaor; Luca,7,0,8,1
1653511097762,MATH 258,A00,087432,Staff,9,0,10,1
1653511098288,MATH 264A,A00,087433,Warnke; Lutz Peter,5,0,8,3
1653511098821,MATH 268,A00,087434,Staff,15,0,15,0
1653511099344,MATH 269,A00,087435,Staff,14,0,15,1
1653511099867,MATH 270A,A00,087436,Nie; Jiawang,0,0,8,8
1653511100389,MATH 272A,A00,087437,Tian; Xiaochuan,1,0,8,7
1653511100917,MATH 274,A01,087439,Cheng; Li-Tien,9,0,10,1
1653511100917,MATH 274,A02,087440,Cheng; Li-Tien,10,0,10,0
1653511101443,MATH 278A,A00,087441,Staff,8,0,10,2
1653511101968,MATH 278B,A00,087442,Staff,8,0,10,2
1653511102494,MATH 278C,A00,087443,Staff,8,0,10,2
1653511103020,MATH 280A,A00,087444,Zheng; Tianyi,0,0,8,8
1653511103548,MATH 281A,A00,087445,Bradic; Jelena,0,0,8,8
1653511104070,MATH 282A,A00,087446,Zhang; Danna,0,0,8,8
1653511104596,MATH 283,A00,087447,Tesler; Glenn,0,0,0,15
1653511105123,MATH 286,A00,087448,Kemp; Todd Aahron,5,0,8,3
1653511105658,MATH 287D,A00,087449,Bradic; Jelena,8,0,8,0
1653511106181,MATH 288,A00,087450,Staff,14,0,15,1
1653511106181,MATH 288,B00,087451,Staff,15,0,15,0
1653511106181,MATH 288,C00,087452,Staff,15,0,15,0
1653511106707,MATH 290A,A00,087453,Xu; Zhouli,6,0,8,2
1653511107231,MATH 291A,A00,087454,Xu; Zhouli,7,0,8,1
1653511107756,MATH 292,A00,087455,Staff,10,0,10,0
1653511108277,MATH 295,A00,087456,Staff,50,0,50,0
1653511108800,MATH 297,001,087457,Staff,998,0,999,1
1653511669616,COGS 200,A01,087991,Staff,47,0,50,3
1653511670138,COGS 201,A01,094504,Rangel; Lara M,17,0,25,8
1653511670659,COGS 203,A00,087992,Coulson; Seana M,18,0,20,2
1653511671181,COGS 210A,001,087993,Greene; Deanna Jacquelyn,9998,0,9999,1
1653511671181,COGS 210A,002,087994,Saygin; Ayse P,9999,0,9999,0
1653511671181,COGS 210A,003,087995,Xia; Haijun,9999,0,9999,0
1653511671181,COGS 210A,004,087996,Nitz; Douglas A.,9999,0,9999,0
1653511671181,COGS 210A,005,087997,Hollan; James D.,9999,0,9999,0
1653511671181,COGS 210A,006,087998,Deak; Gedeon O.,9998,0,9999,1
1653511671181,COGS 210A,007,087999,Rossano; Federico,9999,0,9999,0
1653511671710,COGS 211A,A00,088000,Coulson; Seana M,9997,0,9999,2
1653511672249,COGS 229,A00,088002,Staff,23,0,25,2
1653511672782,COGS 260,B00,094231,Staff,17,0,20,3
1653511672782,COGS 260,A00,088004,Nitz; Douglas A.,9998,0,9999,1
1653511673305,CSE 202,A00,090110,Paturi; Ramamohan,0,0,0,0
1653511673305,CSE 202,B00,090111,Paturi; Ramamohan,0,0,0,0
1653511673827,CSE 207B,A00,090112,Heninger; Nadia A,0,0,0,0
1653511674348,CSE 208,A00,094858,Micciancio; Daniele,0,0,0,0
1653511674884,CSE 210,A00,090113,Powell; Thomas Allan,0,0,0,0
1653511675412,CSE 219,A00,090898,Staff,0,0,0,0
1653511675935,CSE 221,A00,090114,Zhou; Yuan-Yuan,0,0,0,0
1653511676460,CSE 229A,A00,090115,Porter; George M,0,0,0,0
1653511676985,CSE 229C,A00,090116,Savage; Stefan,0,0,0,0
1653511677507,CSE 230,A00,090117,Jhala; Ranjit,0,0,0,0
1653511678042,CSE 232,A00,090118,Papakonstantinou; Yannis,0,0,0,0
1653511678564,CSE 239A,A00,090121,Kumar; Arun Kumar,0,0,0,0
1653511679093,CSE 239B,A00,090122,Jhala; Ranjit,0,0,0,0
1653511679615,CSE 240A,A00,090123,Zhao; Jishen,0,0,189,189
1653511680135,CSE 243A,A00,090124,Orailoglu; Alex,0,0,15,15
1653511680667,CSE 249B,A00,090125,Kahng; Andrew Byun,13,0,20,7
1653511681192,CSE 250A,A00,090126,Berg-Kirkpatrick; Taylor D,0,0,0,0
1653511681724,CSE 252A,A00,090127,Ochoa; Benjamin Lawrence,0,0,0,0
1653511682250,CSE 258,A01,090129,McAuley; Julian John,0,0,0,0
1653511682777,CSE 258R,A01,090131,McAuley; Julian John,0,0,0,0
1653511683301,CSE 274,A00,090132,Ramamoorthi; Ravi,0,0,0,0
1653511683822,CSE 276A,A00,090133,Christensen; Henrik I,0,0,0,0
1653511684350,CSE 276C,A00,090134,Christensen; Henrik I,0,0,0,0
1653511684873,CSE 290,A00,090135,Bafna; Vineet,0,0,0,0
1653511684873,CSE 290,B00,090136,Ramamoorthi; Ravi,0,0,0,0
1653511684873,CSE 290,C00,090137,Li; Tzumao,8,0,10,2
1653511684873,CSE 290,D00,090138,Zhou; Yuan-Yuan,9,0,10,1
1653511684873,CSE 290,E00,090139,Christensen; Henrik I,9,0,10,1
1653511684873,CSE 290,F00,094053,Shalev; Aaron D,0,0,0,0
1653511685396,CSE 291,A00,090140,Munyaka; Imani N. S.,0,0,0,0
1653511685396,CSE 291,B00,094880,Yu; Qi,0,0,0,0
1653511685396,CSE 291,C00,090142,Pannuto; Patrick William,0,0,0,0
1653511685396,CSE 291,D00,094881,Zhang; Yiying,0,0,0,0
1653511685396,CSE 291,E00,095118,Su; Hao,0,0,0,0
1653511685919,CSE 293,001,094905,Bafna; Vineet,9999,0,9999,0
1653511685919,CSE 293,002,094906,Bellare; Mihir,9999,0,9999,0
1653511685919,CSE 293,003,094907,Berg-Kirkpatrick; Taylor D,9999,0,9999,0
1653511685919,CSE 293,004,094908,Christensen; Henrik I,9999,0,9999,0
1653511685919,CSE 293,005,094909,Cottrell; Garrison W,9999,0,9999,0
1653511685919,CSE 293,006,094910,Deutsch; Alin Bernard,9999,0,9999,0
1653511685919,CSE 293,007,094911,Esmaeilzadeh; Hadi,9999,0,9999,0
1653511685919,CSE 293,008,094912,Freund; Yoav,9999,0,9999,0
1653511685919,CSE 293,009,094913,Griswold; William G.,9999,0,9999,0
1653511685919,CSE 293,010,094914,Gymrek; Melissa Ann,9999,0,9999,0
1653511685919,CSE 293,011,094915,Heninger; Nadia A,9999,0,9999,0
1653511685919,CSE 293,012,094916,Impagliazzo; Russell,9999,0,9999,0
1653511685919,CSE 293,013,094917,Jhala; Ranjit,9999,0,9999,0
1653511685919,CSE 293,014,094918,Kahng; Andrew Byun,9999,0,9999,0
1653511685919,CSE 293,015,094919,Kane; Daniel Mertz,9999,0,9999,0
1653511685919,CSE 293,016,094920,Kriegman; David J,9999,0,9999,0
1653511685919,CSE 293,017,094921,Kumar; Arun Kumar,9999,0,9999,0
1653511685919,CSE 293,018,094922,Lerner; Sorin,9999,0,9999,0
1653511685919,CSE 293,019,094923,Lovett; Shachar,9999,0,9999,0
1653511685919,CSE 293,020,094924,McAuley; Julian John,9999,0,9999,0
1653511685919,CSE 293,021,094925,Micciancio; Daniele,9999,0,9999,0
1653511685919,CSE 293,022,094926,Orailoglu; Alex,9999,0,9999,0
1653511685919,CSE 293,023,094927,Paturi; Ramamohan,9999,0,9999,0
1653511685919,CSE 293,024,094928,Polikarpova; Nadezhda,9999,0,9999,0
1653511685919,CSE 293,025,094929,Politz; Joseph Gibbs,9999,0,9999,0
1653511685919,CSE 293,026,094930,Porter; George M,9999,0,9999,0
1653511685919,CSE 293,027,094931,Porter; Leonard Emerson,9999,0,9999,0
1653511685919,CSE 293,028,094932,Ramamoorthi; Ravi,9999,0,9999,0
1653511685919,CSE 293,029,094933,Sahoo; Debashis,9999,0,9999,0
1653511685919,CSE 293,030,094934,Saul; Lawrence,9999,0,9999,0
1653511685919,CSE 293,031,094935,Savage; Stefan,9999,0,9999,0
1653511685919,CSE 293,032,094936,Schulze; Jurgen P.,9999,0,9999,0
1653511685919,CSE 293,033,094937,Snoeren; Alex C.,9999,0,9999,0
1653511685919,CSE 293,034,094938,Shang; Jingbo,9999,0,9999,0
1653511685919,CSE 293,035,094939,Stefan; Deian,9999,0,9999,0
1653511685919,CSE 293,036,094940,Su; Hao,9999,0,9999,0
1653511685919,CSE 293,037,094941,Swanson; Steven James,9999,0,9999,0
1653511685919,CSE 293,038,094942,Tullsen; Dean Michael,9999,0,9999,0
1653511685919,CSE 293,039,094943,Voelker; Geoffrey M.,9999,0,9999,0
1653511685919,CSE 293,040,094944,Zhao; Jishen,9999,0,9999,0
1653511685919,CSE 293,041,094945,Zhou; Yuan-Yuan,9999,0,9999,0
1653511685919,CSE 293,042,094946,Gao; Sicun,9998,0,9999,1
1653511685919,CSE 293,043,094947,Weibel; Nadir,9999,0,9999,0
1653511685919,CSE 293,044,094948,Gupta; Rajesh K.,9999,0,9999,0
1653511686446,CSE 294,A00,090143,Porter; George M,8,0,10,2
1653511686969,DSE 200,A00,091799,Staff,50,0,50,0
1653511687506,DSE 203,A00,091800,Gupta; Amarnath,30,0,30,0
1653511688030,DSE 250,A00,091801,Deutsch; Alin Bernard,30,0,30,0
1653511688554,DSE 290,A00,091802,Altintas De Callaf; Ilkay,50,0,50,0
1653511689090,ECE 200,001,091003,Antipa; Nicholas A,9999,0,9999,0
1653511689090,ECE 200,002,091004,Atanasov; Nikolay A.,9999,0,9999,0
1653511689090,ECE 200,003,091005,Bharadia; Dinesh,9999,0,9999,0
1653511689090,ECE 200,004,091006,Cheng; Chung Kuan,9999,0,9999,0
1653511689090,ECE 200,005,091007,Cosman; Pamela C.,9999,0,9999,0
1653511689090,ECE 200,006,091008,Staff,9999,0,9999,0
1653511689090,ECE 200,007,091009,Dayeh; Shadi Ahmad,9999,0,9999,0
1653511689090,ECE 200,008,091010,Fainman; Yeshaiahu,9999,0,9999,0
1653511689090,ECE 200,009,091011,Ford; Joseph Earl,9999,0,9999,0
1653511689090,ECE 200,010,091012,Franceschetti; Massimo,9999,0,9999,0
1653511689090,ECE 200,011,091013,Fullerton; Eric E,9999,0,9999,0
1653511689090,ECE 200,012,091014,Galton; Ian A,9999,0,9999,0
1653511689090,ECE 200,013,091015,Gilja; Vikash,9999,0,9999,0
1653511689090,ECE 200,014,091016,Hall; Drew A.,9999,0,9999,0
1653511689090,ECE 200,015,091017,Hsueh; Tzu-Chien,9999,0,9999,0
1653511689090,ECE 200,016,091018,Javidi; Tara,9999,0,9999,0
1653511689090,ECE 200,017,091019,Kahng; Andrew Byun,9999,0,9999,0
1653511689090,ECE 200,018,091020,Kim; Young-Han,9999,0,9999,0
1653511689090,ECE 200,019,091021,Koushanfar; Farinaz,9999,0,9999,0
1653511689090,ECE 200,020,091022,Kuzum; Duygu,9999,0,9999,0
1653511689090,ECE 200,021,091023,Le; Hanh-Phuc,9999,0,9999,0
1653511689090,ECE 200,022,091024,Lin; Bill,9999,0,9999,0
1653511689090,ECE 200,023,091025,Liu; Zhaowei,9999,0,9999,0
1653511689090,ECE 200,024,091026,Lo; Yu-Hwa,9999,0,9999,0
1653511689090,ECE 200,025,091027,Lomakin; Vitaliy,9999,0,9999,0
1653511689090,ECE 200,026,091028,Mercier; Patrick Philip,9999,0,9999,0
1653511689090,ECE 200,027,091029,Meyer; Florian,9999,0,9999,0
1653511689090,ECE 200,028,091030,Milstein; Laurence B.,9999,0,9999,0
1653511689090,ECE 200,029,091031,Mir Arabbaygi; Siavash,9999,0,9999,0
1653511689090,ECE 200,030,091032,Mookherjea; Shayan,9999,0,9999,0
1653511689090,ECE 200,031,091033,Morris; Karcher William,9999,0,9999,0
1653511689090,ECE 200,032,091034,Ng; Tse Nga,9999,0,9999,0
1653511689090,ECE 200,033,091035,Nguyen; Truong Quang,9999,0,9999,0
1653511689090,ECE 200,034,091036,Nomura; Kenji,9999,0,9999,0
1653511689090,ECE 200,035,091037,Orlitsky; Alon,9999,0,9999,0
1653511689090,ECE 200,036,091038,Pal; Piya,9999,0,9999,0
1653511689090,ECE 200,037,091039,Papen; George C.,9999,0,9999,0
1653511689090,ECE 200,038,091040,Radic; Stojan,9999,0,9999,0
1653511689090,ECE 200,039,091041,Rao; Bhaskar D.,9999,0,9999,0
1653511689090,ECE 200,040,091042,Rao; Ramesh R,9999,0,9999,0
1653511689090,ECE 200,041,091043,Rebeiz; Gabriel,9999,0,9999,0
1653511689090,ECE 200,042,091044,Sanford; John R,9999,0,9999,0
1653511689090,ECE 200,043,091045,Siegel; Paul H.,9999,0,9999,0
1653511689090,ECE 200,044,091046,Sievenpiper; Daniel F.,9999,0,9999,0
1653511689090,ECE 200,045,091047,Sworder; David D.,9999,0,9999,0
1653511689090,ECE 200,046,091048,Taur; Yuan,9999,0,9999,0
1653511689090,ECE 200,047,091049,Touri; Behrouz,9999,0,9999,0
1653511689090,ECE 200,048,091050,Trivedi; Mohan M.,9999,0,9999,0
1653511689090,ECE 200,049,091051,Vardy; Alexander,9999,0,9999,0
1653511689090,ECE 200,050,091052,Vasconcelos; Nuno,9999,0,9999,0
1653511689090,ECE 200,051,091053,Wang; Xiaolong,9999,0,9999,0
1653511689090,ECE 200,052,091054,Xie; Pengtao,9999,0,9999,0
1653511689090,ECE 200,053,091055,Yip; Michael,9999,0,9999,0
1653511689090,ECE 200,054,091056,Zeger; Kenneth A.,9999,0,9999,0
1653511689090,ECE 200,055,091057,Zhang; Xinyu,9999,0,9999,0
1653511689090,ECE 200,056,091058,Turakhia; Yatish Girish,9999,0,9999,0
1653511689090,ECE 200,057,091059,Kang; Mingu,9999,0,9999,0
1653511689090,ECE 200,058,091060,Shi; Yuanyuan,9999,0,9999,0
1653511689090,ECE 200,059,091061,Wang; Edward Jay,9999,0,9999,0
1653511689090,ECE 200,060,091062,Zheng; Yang,9999,0,9999,0
1653511689618,ECE 201,A00,095526,Lo; Yu-Hwa,0,0,0,0
1653511690147,ECE 203,A00,091065,Mercier; Patrick Philip,0,0,0,0
1653511690677,ECE 207A,A00,091605,Liu; Thomas Tao-Ming,0,0,0,0
1653511691221,ECE 212AN,A00,091068,Nomura; Kenji,0,0,0,0
1653511691751,ECE 222A,A00,091069,Rebeiz; Gabriel,0,0,0,0
1653511692277,ECE 225A,A00,091070,Orlitsky; Alon,0,0,0,0
1653511692799,ECE 230A,A00,091071,Nomura; Kenji,0,0,0,0
1653511693336,ECE 236A,A00,091072,Dayeh; Shadi Ahmad,0,0,0,0
1653511693864,ECE 238A,A00,091073,Luo; Jian,0,0,0,0
1653511693864,ECE 238A,B00,091074,Luo; Jian,0,0,0,0
1653511694387,ECE 240A,A00,091075,Radic; Stojan,0,0,0,0
1653511694916,ECE 247A,A00,091592,Shi; Lingyan,0,0,0,0
1653511695438,ECE 250,A00,091076,Touri; Behrouz,0,0,0,0
1653511695964,ECE 251C,A00,091078,Nguyen; Truong Quang,0,0,0,0
1653511696489,ECE 253,A00,091079,Cosman; Pamela C.,0,0,0,0
1653511697014,ECE 255A,A00,091080,Orlitsky; Alon,0,0,0,0
1653511697537,ECE 257A,A00,091081,Zhang; Xinyu,0,0,0,0
1653511698061,ECE 260A,A01,091084,Eldon; John,0,0,0,0
1653511698592,ECE 264C,A00,091085,Galton; Ian A,0,0,0,0
1653511699117,ECE 265C,A00,094889,Presti; Calogero Davide,0,0,0,9
1653511699643,ECE 266,A01,091087,Hall; Drew A.,0,0,0,0
1653511700694,ECE 271A,A00,091090,Vasconcelos; Nuno,0,0,0,0
1653511701219,ECE 272B,A00,091091,Sworder; David D.,0,0,0,0
1653511701742,ECE 275A,A00,091092,Meyer; Florian,0,0,0,0
1653511702265,ECE 277,A00,091093,An; Cheolhong,0,0,0,0
1653511702866,ECE 283,A00,091094,Le; Hanh-Phuc,0,0,0,0
1653511703405,ECE 284,A00,091095,Kang; Mingu,0,0,0,0
1653511703405,ECE 284,B00,091096,Wang; Edward Jay,0,0,0,0
1653511703941,ECE 285,A00,094334,Touri; Behrouz,0,0,0,0
1653511704466,ECE 289,A00,091097,Whelan; David Arthur,0,0,0,0
1653511704992,MATH 200A,A00,087414,Salehi Golsefidy; Alireza,7,0,8,1
1653511705514,MATH 202A,A00,087415,Gill; Philip E.,3,0,8,5
1653511706043,MATH 203A,A00,087416,Oprea; Dragos N.,6,0,8,2
1653511706573,MATH 204A,A00,087417,Kedlaya; Kiran S.,6,0,8,2
1653511707100,MATH 205,A00,087418,Sorensen; Claus M,6,0,8,2
1653511707628,MATH 206A,A00,087419,Izadi; Elham,7,0,8,1
1653511708158,MATH 207A,A00,087420,Mohammadi; Amir,5,0,8,3
1653511708685,MATH 208,A00,087421,Staff,9,0,10,1
1653511709208,MATH 209,A00,087422,Staff,10,0,10,0
1653511709739,MATH 218,A00,087423,Staff,10,0,10,0
1653511710264,MATH 220A,A00,087424,Novak; Jonathan I,7,0,8,1
1653511710785,MATH 231A,A00,087425,Bejenaru; Ioan,3,0,8,5
1653511711311,MATH 240A,A00,087426,Ebenfelt; Peter F,5,0,8,3
1653511711836,MATH 243,A00,087427,Staff,9,0,10,1
1653511712365,MATH 248,A00,087429,Staff,10,0,10,0
1653511712889,MATH 250A,A00,087430,Spolaor; Luca,4,0,8,4
1653511713420,MATH 257A,A00,087431,Spolaor; Luca,7,0,8,1
1653511713944,MATH 258,A00,087432,Staff,9,0,10,1
1653511714488,MATH 264A,A00,087433,Warnke; Lutz Peter,5,0,8,3
1653511715011,MATH 268,A00,087434,Staff,15,0,15,0
1653511715536,MATH 269,A00,087435,Staff,14,0,15,1
1653511716066,MATH 270A,A00,087436,Nie; Jiawang,0,0,8,8
1653511716594,MATH 272A,A00,087437,Tian; Xiaochuan,1,0,8,7
1653511717124,MATH 274,A01,087439,Cheng; Li-Tien,9,0,10,1
1653511717124,MATH 274,A02,087440,Cheng; Li-Tien,10,0,10,0
1653511717646,MATH 278A,A00,087441,Staff,8,0,10,2
1653511718174,MATH 278B,A00,087442,Staff,8,0,10,2
1653511718701,MATH 278C,A00,087443,Staff,8,0,10,2
1653511719229,MATH 280A,A00,087444,Zheng; Tianyi,0,0,8,8
1653511719755,MATH 281A,A00,087445,Bradic; Jelena,0,0,8,8
1653511720277,MATH 282A,A00,087446,Zhang; Danna,0,0,8,8
1653511720799,MATH 283,A00,087447,Tesler; Glenn,0,0,0,15
1653511721323,MATH 286,A00,087448,Kemp; Todd Aahron,5,0,8,3
1653511721845,MATH 287D,A00,087449,Bradic; Jelena,8,0,8,0
1653511722367,MATH 288,A00,087450,Staff,14,0,15,1
1653511722367,MATH 288,B00,087451,Staff,15,0,15,0
1653511722367,MATH 288,C00,087452,Staff,15,0,15,0
1653511722890,MATH 290A,A00,087453,Xu; Zhouli,6,0,8,2
1653511723412,MATH 291A,A00,087454,Xu; Zhouli,7,0,8,1
1653511723934,MATH 292,A00,087455,Staff,10,0,10,0
1653511724471,MATH 295,A00,087456,Staff,50,0,50,0
1653511724993,MATH 297,001,087457,Staff,998,0,999,1
1653512286165,COGS 200,A01,087991,Staff,47,0,50,3
1653512286693,COGS 201,A01,094504,Rangel; Lara M,17,0,25,8
1653512287229,COGS 203,A00,087992,Coulson; Seana M,18,0,20,2
1653512287756,COGS 210A,001,087993,Greene; Deanna Jacquelyn,9998,0,9999,1
1653512287756,COGS 210A,002,087994,Saygin; Ayse P,9999,0,9999,0
1653512287756,COGS 210A,003,087995,Xia; Haijun,9999,0,9999,0
1653512287756,COGS 210A,004,087996,Nitz; Douglas A.,9999,0,9999,0
1653512287756,COGS 210A,005,087997,Hollan; James D.,9999,0,9999,0
1653512287756,COGS 210A,006,087998,Deak; Gedeon O.,9998,0,9999,1
1653512287756,COGS 210A,007,087999,Rossano; Federico,9999,0,9999,0
1653512288280,COGS 211A,A00,088000,Coulson; Seana M,9997,0,9999,2
1653512288814,COGS 229,A00,088002,Staff,23,0,25,2
1653512289343,COGS 260,B00,094231,Staff,17,0,20,3
1653512289343,COGS 260,A00,088004,Nitz; Douglas A.,9998,0,9999,1
1653512289871,CSE 202,A00,090110,Paturi; Ramamohan,0,0,0,0
1653512289871,CSE 202,B00,090111,Paturi; Ramamohan,0,0,0,0
1653512290394,CSE 207B,A00,090112,Heninger; Nadia A,0,0,0,0
1653512290926,CSE 208,A00,094858,Micciancio; Daniele,0,0,0,0
1653512291545,CSE 210,A00,090113,Powell; Thomas Allan,0,0,0,0
1653512292070,CSE 219,A00,090898,Staff,0,0,0,0
1653512292595,CSE 221,A00,090114,Zhou; Yuan-Yuan,0,0,0,0
1653512293124,CSE 229A,A00,090115,Porter; George M,0,0,0,0
1653512293652,CSE 229C,A00,090116,Savage; Stefan,0,0,0,0
1653512294180,CSE 230,A00,090117,Jhala; Ranjit,0,0,0,0
1653512294710,CSE 232,A00,090118,Papakonstantinou; Yannis,0,0,0,0
1653512295234,CSE 239A,A00,090121,Kumar; Arun Kumar,0,0,0,0
1653512295775,CSE 239B,A00,090122,Jhala; Ranjit,0,0,0,0
1653512296299,CSE 240A,A00,090123,Zhao; Jishen,0,0,189,189
1653512296834,CSE 243A,A00,090124,Orailoglu; Alex,0,0,15,15
1653512297367,CSE 249B,A00,090125,Kahng; Andrew Byun,13,0,20,7
1653512297889,CSE 250A,A00,090126,Berg-Kirkpatrick; Taylor D,0,0,0,0
1653512298411,CSE 252A,A00,090127,Ochoa; Benjamin Lawrence,0,0,0,0
1653512298943,CSE 258,A01,090129,McAuley; Julian John,0,0,0,0
1653512299466,CSE 258R,A01,090131,McAuley; Julian John,0,0,0,0
1653512299988,CSE 274,A00,090132,Ramamoorthi; Ravi,0,0,0,0
1653512300511,CSE 276A,A00,090133,Christensen; Henrik I,0,0,0,0
1653512301039,CSE 276C,A00,090134,Christensen; Henrik I,0,0,0,0
1653512301568,CSE 290,A00,090135,Bafna; Vineet,0,0,0,0
1653512301568,CSE 290,B00,090136,Ramamoorthi; Ravi,0,0,0,0
1653512301568,CSE 290,C00,090137,Li; Tzumao,8,0,10,2
1653512301568,CSE 290,D00,090138,Zhou; Yuan-Yuan,9,0,10,1
1653512301568,CSE 290,E00,090139,Christensen; Henrik I,9,0,10,1
1653512301568,CSE 290,F00,094053,Shalev; Aaron D,0,0,0,0
1653512302098,CSE 291,A00,090140,Munyaka; Imani N. S.,0,0,0,0
1653512302098,CSE 291,B00,094880,Yu; Qi,0,0,0,0
1653512302098,CSE 291,C00,090142,Pannuto; Patrick William,0,0,0,0
1653512302098,CSE 291,D00,094881,Zhang; Yiying,0,0,0,0
1653512302098,CSE 291,E00,095118,Su; Hao,0,0,0,0
1653512302631,CSE 293,001,094905,Bafna; Vineet,9999,0,9999,0
1653512302631,CSE 293,002,094906,Bellare; Mihir,9999,0,9999,0
1653512302631,CSE 293,003,094907,Berg-Kirkpatrick; Taylor D,9999,0,9999,0
1653512302631,CSE 293,004,094908,Christensen; Henrik I,9999,0,9999,0
1653512302631,CSE 293,005,094909,Cottrell; Garrison W,9999,0,9999,0
1653512302631,CSE 293,006,094910,Deutsch; Alin Bernard,9999,0,9999,0
1653512302631,CSE 293,007,094911,Esmaeilzadeh; Hadi,9999,0,9999,0
1653512302631,CSE 293,008,094912,Freund; Yoav,9999,0,9999,0
1653512302631,CSE 293,009,094913,Griswold; William G.,9999,0,9999,0
1653512302631,CSE 293,010,094914,Gymrek; Melissa Ann,9999,0,9999,0
1653512302631,CSE 293,011,094915,Heninger; Nadia A,9999,0,9999,0
1653512302631,CSE 293,012,094916,Impagliazzo; Russell,9999,0,9999,0
1653512302631,CSE 293,013,094917,Jhala; Ranjit,9999,0,9999,0
1653512302631,CSE 293,014,094918,Kahng; Andrew Byun,9999,0,9999,0
1653512302631,CSE 293,015,094919,Kane; Daniel Mertz,9999,0,9999,0
1653512302631,CSE 293,016,094920,Kriegman; David J,9999,0,9999,0
1653512302631,CSE 293,017,094921,Kumar; Arun Kumar,9999,0,9999,0
1653512302631,CSE 293,018,094922,Lerner; Sorin,9999,0,9999,0
1653512302631,CSE 293,019,094923,Lovett; Shachar,9999,0,9999,0
1653512302631,CSE 293,020,094924,McAuley; Julian John,9999,0,9999,0
1653512302631,CSE 293,021,094925,Micciancio; Daniele,9999,0,9999,0
1653512302631,CSE 293,022,094926,Orailoglu; Alex,9999,0,9999,0
1653512302631,CSE 293,023,094927,Paturi; Ramamohan,9999,0,9999,0
1653512302631,CSE 293,024,094928,Polikarpova; Nadezhda,9999,0,9999,0
1653512302631,CSE 293,025,094929,Politz; Joseph Gibbs,9999,0,9999,0
1653512302631,CSE 293,026,094930,Porter; George M,9999,0,9999,0
1653512302631,CSE 293,027,094931,Porter; Leonard Emerson,9999,0,9999,0
1653512302631,CSE 293,028,094932,Ramamoorthi; Ravi,9999,0,9999,0
1653512302631,CSE 293,029,094933,Sahoo; Debashis,9999,0,9999,0
1653512302631,CSE 293,030,094934,Saul; Lawrence,9999,0,9999,0
1653512302631,CSE 293,031,094935,Savage; Stefan,9999,0,9999,0
1653512302631,CSE 293,032,094936,Schulze; Jurgen P.,9999,0,9999,0
1653512302631,CSE 293,033,094937,Snoeren; Alex C.,9999,0,9999,0
1653512302631,CSE 293,034,094938,Shang; Jingbo,9999,0,9999,0
1653512302631,CSE 293,035,094939,Stefan; Deian,9999,0,9999,0
1653512302631,CSE 293,036,094940,Su; Hao,9999,0,9999,0
1653512302631,CSE 293,037,094941,Swanson; Steven James,9999,0,9999,0
1653512302631,CSE 293,038,094942,Tullsen; Dean Michael,9999,0,9999,0
1653512302631,CSE 293,039,094943,Voelker; Geoffrey M.,9999,0,9999,0
1653512302631,CSE 293,040,094944,Zhao; Jishen,9999,0,9999,0
1653512302631,CSE 293,041,094945,Zhou; Yuan-Yuan,9999,0,9999,0
1653512302631,CSE 293,042,094946,Gao; Sicun,9998,0,9999,1
1653512302631,CSE 293,043,094947,Weibel; Nadir,9999,0,9999,0
1653512302631,CSE 293,044,094948,Gupta; Rajesh K.,9999,0,9999,0
1653512303162,CSE 294,A00,090143,Porter; George M,8,0,10,2
1653512303684,DSE 200,A00,091799,Staff,50,0,50,0
1653512304205,DSE 203,A00,091800,Gupta; Amarnath,30,0,30,0
1653512304729,DSE 250,A00,091801,Deutsch; Alin Bernard,30,0,30,0
1653512305251,DSE 290,A00,091802,Altintas De Callaf; Ilkay,50,0,50,0
1653512305781,ECE 200,001,091003,Antipa; Nicholas A,9999,0,9999,0
1653512305781,ECE 200,002,091004,Atanasov; Nikolay A.,9999,0,9999,0
1653512305781,ECE 200,003,091005,Bharadia; Dinesh,9999,0,9999,0
1653512305781,ECE 200,004,091006,Cheng; Chung Kuan,9999,0,9999,0
1653512305781,ECE 200,005,091007,Cosman; Pamela C.,9999,0,9999,0
1653512305781,ECE 200,006,091008,Staff,9999,0,9999,0
1653512305781,ECE 200,007,091009,Dayeh; Shadi Ahmad,9999,0,9999,0
1653512305781,ECE 200,008,091010,Fainman; Yeshaiahu,9999,0,9999,0
1653512305781,ECE 200,009,091011,Ford; Joseph Earl,9999,0,9999,0
1653512305781,ECE 200,010,091012,Franceschetti; Massimo,9999,0,9999,0
1653512305781,ECE 200,011,091013,Fullerton; Eric E,9999,0,9999,0
1653512305781,ECE 200,012,091014,Galton; Ian A,9999,0,9999,0
1653512305781,ECE 200,013,091015,Gilja; Vikash,9999,0,9999,0
1653512305781,ECE 200,014,091016,Hall; Drew A.,9999,0,9999,0
1653512305781,ECE 200,015,091017,Hsueh; Tzu-Chien,9999,0,9999,0
1653512305781,ECE 200,016,091018,Javidi; Tara,9999,0,9999,0
1653512305781,ECE 200,017,091019,Kahng; Andrew Byun,9999,0,9999,0
1653512305781,ECE 200,018,091020,Kim; Young-Han,9999,0,9999,0
1653512305781,ECE 200,019,091021,Koushanfar; Farinaz,9999,0,9999,0
1653512305781,ECE 200,020,091022,Kuzum; Duygu,9999,0,9999,0
1653512305781,ECE 200,021,091023,Le; Hanh-Phuc,9999,0,9999,0
1653512305781,ECE 200,022,091024,Lin; Bill,9999,0,9999,0
1653512305781,ECE 200,023,091025,Liu; Zhaowei,9999,0,9999,0
1653512305781,ECE 200,024,091026,Lo; Yu-Hwa,9999,0,9999,0
1653512305781,ECE 200,025,091027,Lomakin; Vitaliy,9999,0,9999,0
1653512305781,ECE 200,026,091028,Mercier; Patrick Philip,9999,0,9999,0
1653512305781,ECE 200,027,091029,Meyer; Florian,9999,0,9999,0
1653512305781,ECE 200,028,091030,Milstein; Laurence B.,9999,0,9999,0
1653512305781,ECE 200,029,091031,Mir Arabbaygi; Siavash,9999,0,9999,0
1653512305781,ECE 200,030,091032,Mookherjea; Shayan,9999,0,9999,0
1653512305781,ECE 200,031,091033,Morris; Karcher William,9999,0,9999,0
1653512305781,ECE 200,032,091034,Ng; Tse Nga,9999,0,9999,0
1653512305781,ECE 200,033,091035,Nguyen; Truong Quang,9999,0,9999,0
1653512305781,ECE 200,034,091036,Nomura; Kenji,9999,0,9999,0
1653512305781,ECE 200,035,091037,Orlitsky; Alon,9999,0,9999,0
1653512305781,ECE 200,036,091038,Pal; Piya,9999,0,9999,0
1653512305781,ECE 200,037,091039,Papen; George C.,9999,0,9999,0
1653512305781,ECE 200,038,091040,Radic; Stojan,9999,0,9999,0
1653512305781,ECE 200,039,091041,Rao; Bhaskar D.,9999,0,9999,0
1653512305781,ECE 200,040,091042,Rao; Ramesh R,9999,0,9999,0
1653512305781,ECE 200,041,091043,Rebeiz; Gabriel,9999,0,9999,0
1653512305781,ECE 200,042,091044,Sanford; John R,9999,0,9999,0
1653512305781,ECE 200,043,091045,Siegel; Paul H.,9999,0,9999,0
1653512305781,ECE 200,044,091046,Sievenpiper; Daniel F.,9999,0,9999,0
1653512305781,ECE 200,045,091047,Sworder; David D.,9999,0,9999,0
1653512305781,ECE 200,046,091048,Taur; Yuan,9999,0,9999,0
1653512305781,ECE 200,047,091049,Touri; Behrouz,9999,0,9999,0
1653512305781,ECE 200,048,091050,Trivedi; Mohan M.,9999,0,9999,0
1653512305781,ECE 200,049,091051,Vardy; Alexander,9999,0,9999,0
1653512305781,ECE 200,050,091052,Vasconcelos; Nuno,9999,0,9999,0
1653512305781,ECE 200,051,091053,Wang; Xiaolong,9999,0,9999,0
1653512305781,ECE 200,052,091054,Xie; Pengtao,9999,0,9999,0
1653512305781,ECE 200,053,091055,Yip; Michael,9999,0,9999,0
1653512305781,ECE 200,054,091056,Zeger; Kenneth A.,9999,0,9999,0
1653512305781,ECE 200,055,091057,Zhang; Xinyu,9999,0,9999,0
1653512305781,ECE 200,056,091058,Turakhia; Yatish Girish,9999,0,9999,0
1653512305781,ECE 200,057,091059,Kang; Mingu,9999,0,9999,0
1653512305781,ECE 200,058,091060,Shi; Yuanyuan,9999,0,9999,0
1653512305781,ECE 200,059,091061,Wang; Edward Jay,9999,0,9999,0
1653512305781,ECE 200,060,091062,Zheng; Yang,9999,0,9999,0
1653512306314,ECE 201,A00,095526,Lo; Yu-Hwa,0,0,0,0
1653512306838,ECE 203,A00,091065,Mercier; Patrick Philip,0,0,0,0
1653512307366,ECE 207A,A00,091605,Liu; Thomas Tao-Ming,0,0,0,0
1653512307889,ECE 212AN,A00,091068,Nomura; Kenji,0,0,0,0
1653512308415,ECE 222A,A00,091069,Rebeiz; Gabriel,0,0,0,0
1653512308937,ECE 225A,A00,091070,Orlitsky; Alon,0,0,0,0
1653512309468,ECE 230A,A00,091071,Nomura; Kenji,0,0,0,0
1653512309989,ECE 236A,A00,091072,Dayeh; Shadi Ahmad,0,0,0,0
1653512310513,ECE 238A,A00,091073,Luo; Jian,0,0,0,0
1653512310513,ECE 238A,B00,091074,Luo; Jian,0,0,0,0
1653512311045,ECE 240A,A00,091075,Radic; Stojan,0,0,0,0
1653512311578,ECE 247A,A00,091592,Shi; Lingyan,0,0,0,0
1653512312112,ECE 250,A00,091076,Touri; Behrouz,0,0,0,0
1653512312637,ECE 251C,A00,091078,Nguyen; Truong Quang,0,0,0,0
1653512313169,ECE 253,A00,091079,Cosman; Pamela C.,0,0,0,0
1653512313692,ECE 255A,A00,091080,Orlitsky; Alon,0,0,0,0
1653512314227,ECE 257A,A00,091081,Zhang; Xinyu,0,0,0,0
1653512314751,ECE 260A,A01,091084,Eldon; John,0,0,0,0
1653512315273,ECE 264C,A00,091085,Galton; Ian A,0,0,0,0
1653512315801,ECE 265C,A00,094889,Presti; Calogero Davide,0,0,0,9
1653512316322,ECE 266,A01,091087,Hall; Drew A.,0,0,0,0
1653512317378,ECE 271A,A00,091090,Vasconcelos; Nuno,0,0,0,0
1653512317900,ECE 272B,A00,091091,Sworder; David D.,0,0,0,0
1653512318422,ECE 275A,A00,091092,Meyer; Florian,0,0,0,0
1653512318945,ECE 277,A00,091093,An; Cheolhong,0,0,0,0
1653512319467,ECE 283,A00,091094,Le; Hanh-Phuc,0,0,0,0
1653512319994,ECE 284,A00,091095,Kang; Mingu,0,0,0,0
1653512319994,ECE 284,B00,091096,Wang; Edward Jay,0,0,0,0
1653512320520,ECE 285,A00,094334,Touri; Behrouz,0,0,0,0
1653512321043,ECE 289,A00,091097,Whelan; David Arthur,0,0,0,0
1653512321577,MATH 200A,A00,087414,Salehi Golsefidy; Alireza,7,0,8,1
1653512322107,MATH 202A,A00,087415,Gill; Philip E.,3,0,8,5
1653512322637,MATH 203A,A00,087416,Oprea; Dragos N.,6,0,8,2
1653512323162,MATH 204A,A00,087417,Kedlaya; Kiran S.,6,0,8,2
1653512323688,MATH 205,A00,087418,Sorensen; Claus M,6,0,8,2
1653512324214,MATH 206A,A00,087419,Izadi; Elham,7,0,8,1
1653512324739,MATH 207A,A00,087420,Mohammadi; Amir,5,0,8,3
1653512325262,MATH 208,A00,087421,Staff,9,0,10,1
1653512325784,MATH 209,A00,087422,Staff,10,0,10,0
1653512326306,MATH 218,A00,087423,Staff,10,0,10,0
1653512326832,MATH 220A,A00,087424,Novak; Jonathan I,7,0,8,1
1653512327355,MATH 231A,A00,087425,Bejenaru; Ioan,3,0,8,5
1653512327880,MATH 240A,A00,087426,Ebenfelt; Peter F,5,0,8,3
1653512328402,MATH 243,A00,087427,Staff,9,0,10,1
1653512328927,MATH 248,A00,087429,Staff,10,0,10,0
1653512329456,MATH 250A,A00,087430,Spolaor; Luca,4,0,8,4
1653512329981,MATH 257A,A00,087431,Spolaor; Luca,7,0,8,1
1653512330503,MATH 258,A00,087432,Staff,9,0,10,1
1653512331026,MATH 264A,A00,087433,Warnke; Lutz Peter,5,0,8,3
1653512331550,MATH 268,A00,087434,Staff,15,0,15,0
1653512332081,MATH 269,A00,087435,Staff,14,0,15,1
1653512332609,MATH 270A,A00,087436,Nie; Jiawang,0,0,8,8
1653512333138,MATH 272A,A00,087437,Tian; Xiaochuan,1,0,8,7
1653512333661,MATH 274,A01,087439,Cheng; Li-Tien,9,0,10,1
1653512333661,MATH 274,A02,087440,Cheng; Li-Tien,10,0,10,0
1653512334196,MATH 278A,A00,087441,Staff,8,0,10,2
1653512334726,MATH 278B,A00,087442,Staff,8,0,10,2
1653512335256,MATH 278C,A00,087443,Staff,8,0,10,2
1653512335786,MATH 280A,A00,087444,Zheng; Tianyi,0,0,8,8
1653512336309,MATH 281A,A00,087445,Bradic; Jelena,0,0,8,8
1653512336841,MATH 282A,A00,087446,Zhang; Danna,0,0,8,8
1653512337373,MATH 283,A00,087447,Tesler; Glenn,0,0,0,15
1653512337907,MATH 286,A00,087448,Kemp; Todd Aahron,5,0,8,3
1653512338432,MATH 287D,A00,087449,Bradic; Jelena,8,0,8,0
1653512338970,MATH 288,A00,087450,Staff,14,0,15,1
1653512338970,MATH 288,B00,087451,Staff,15,0,15,0
1653512338970,MATH 288,C00,087452,Staff,15,0,15,0
1653512339499,MATH 290A,A00,087453,Xu; Zhouli,6,0,8,2
1653512340026,MATH 291A,A00,087454,Xu; Zhouli,7,0,8,1
1653512340549,MATH 292,A00,087455,Staff,10,0,10,0
1653512341072,MATH 295,A00,087456,Staff,50,0,50,0
1653512341597,MATH 297,001,087457,Staff,998,0,999,1
1653512903316,COGS 200,A01,087991,Staff,47,0,50,3
1653512903839,COGS 201,A01,094504,Rangel; Lara M,17,0,25,8
1653512904363,COGS 203,A00,087992,Coulson; Seana M,18,0,20,2
1653512904889,COGS 210A,001,087993,Greene; Deanna Jacquelyn,9998,0,9999,1
1653512904889,COGS 210A,002,087994,Saygin; Ayse P,9999,0,9999,0
1653512904889,COGS 210A,003,087995,Xia; Haijun,9999,0,9999,0
1653512904889,COGS 210A,004,087996,Nitz; Douglas A.,9999,0,9999,0
1653512904889,COGS 210A,005,087997,Hollan; James D.,9999,0,9999,0
1653512904889,COGS 210A,006,087998,Deak; Gedeon O.,9998,0,9999,1
1653512904889,COGS 210A,007,087999,Rossano; Federico,9999,0,9999,0
1653512905419,COGS 211A,A00,088000,Coulson; Seana M,9997,0,9999,2
1653512905941,COGS 229,A00,088002,Staff,23,0,25,2
1653512906469,COGS 260,B00,094231,Staff,17,0,20,3
1653512906469,COGS 260,A00,088004,Nitz; Douglas A.,9998,0,9999,1
1653512907004,CSE 202,A00,090110,Paturi; Ramamohan,0,0,0,0
1653512907004,CSE 202,B00,090111,Paturi; Ramamohan,0,0,0,0
1653512907530,CSE 207B,A00,090112,Heninger; Nadia A,0,0,0,0
1653512908057,CSE 208,A00,094858,Micciancio; Daniele,0,0,0,0
1653512908593,CSE 210,A00,090113,Powell; Thomas Allan,0,0,0,0
1653512909125,CSE 219,A00,090898,Staff,0,0,0,0
1653512909650,CSE 221,A00,090114,Zhou; Yuan-Yuan,0,0,0,0
1653512910173,CSE 229A,A00,090115,Porter; George M,0,0,0,0
1653512910696,CSE 229C,A00,090116,Savage; Stefan,0,0,0,0
1653512911219,CSE 230,A00,090117,Jhala; Ranjit,0,0,0,0
1653512911743,CSE 232,A00,090118,Papakonstantinou; Yannis,0,0,0,0
1653512912267,CSE 239A,A00,090121,Kumar; Arun Kumar,0,0,0,0
1653512912793,CSE 239B,A00,090122,Jhala; Ranjit,0,0,0,0
1653512913319,CSE 240A,A00,090123,Zhao; Jishen,0,0,189,189
1653512913845,CSE 243A,A00,090124,Orailoglu; Alex,0,0,15,15
1653512914376,CSE 249B,A00,090125,Kahng; Andrew Byun,13,0,20,7
1653512914913,CSE 250A,A00,090126,Berg-Kirkpatrick; Taylor D,0,0,0,0
1653512915439,CSE 252A,A00,090127,Ochoa; Benjamin Lawrence,0,0,0,0
1653512915970,CSE 258,A01,090129,McAuley; Julian John,0,0,0,0
1653512916491,CSE 258R,A01,090131,McAuley; Julian John,0,0,0,0
1653512917029,CSE 274,A00,090132,Ramamoorthi; Ravi,0,0,0,0
1653512917586,CSE 276A,A00,090133,Christensen; Henrik I,0,0,0,0
1653512918121,CSE 276C,A00,090134,Christensen; Henrik I,0,0,0,0
1653512918644,CSE 290,A00,090135,Bafna; Vineet,0,0,0,0
1653512918644,CSE 290,B00,090136,Ramamoorthi; Ravi,0,0,0,0
1653512918644,CSE 290,C00,090137,Li; Tzumao,8,0,10,2
1653512918644,CSE 290,D00,090138,Zhou; Yuan-Yuan,9,0,10,1
1653512918644,CSE 290,E00,090139,Christensen; Henrik I,9,0,10,1
1653512918644,CSE 290,F00,094053,Shalev; Aaron D,0,0,0,0
1653512919178,CSE 291,A00,090140,Munyaka; Imani N. S.,0,0,0,0
1653512919178,CSE 291,B00,094880,Yu; Qi,0,0,0,0
1653512919178,CSE 291,C00,090142,Pannuto; Patrick William,0,0,0,0
1653512919178,CSE 291,D00,094881,Zhang; Yiying,0,0,0,0
1653512919178,CSE 291,E00,095118,Su; Hao,0,0,0,0
1653512919740,CSE 293,001,094905,Bafna; Vineet,9999,0,9999,0
1653512919740,CSE 293,002,094906,Bellare; Mihir,9999,0,9999,0
1653512919740,CSE 293,003,094907,Berg-Kirkpatrick; Taylor D,9999,0,9999,0
1653512919740,CSE 293,004,094908,Christensen; Henrik I,9999,0,9999,0
1653512919740,CSE 293,005,094909,Cottrell; Garrison W,9999,0,9999,0
1653512919740,CSE 293,006,094910,Deutsch; Alin Bernard,9999,0,9999,0
1653512919740,CSE 293,007,094911,Esmaeilzadeh; Hadi,9999,0,9999,0
1653512919740,CSE 293,008,094912,Freund; Yoav,9999,0,9999,0
1653512919740,CSE 293,009,094913,Griswold; William G.,9999,0,9999,0
1653512919740,CSE 293,010,094914,Gymrek; Melissa Ann,9999,0,9999,0
1653512919740,CSE 293,011,094915,Heninger; Nadia A,9999,0,9999,0
1653512919740,CSE 293,012,094916,Impagliazzo; Russell,9999,0,9999,0
1653512919740,CSE 293,013,094917,Jhala; Ranjit,9999,0,9999,0
1653512919740,CSE 293,014,094918,Kahng; Andrew Byun,9999,0,9999,0
1653512919740,CSE 293,015,094919,Kane; Daniel Mertz,9999,0,9999,0
1653512919740,CSE 293,016,094920,Kriegman; David J,9999,0,9999,0
1653512919740,CSE 293,017,094921,Kumar; Arun Kumar,9999,0,9999,0
1653512919740,CSE 293,018,094922,Lerner; Sorin,9999,0,9999,0
1653512919740,CSE 293,019,094923,Lovett; Shachar,9999,0,9999,0
1653512919740,CSE 293,020,094924,McAuley; Julian John,9999,0,9999,0
1653512919740,CSE 293,021,094925,Micciancio; Daniele,9999,0,9999,0
1653512919740,CSE 293,022,094926,Orailoglu; Alex,9999,0,9999,0
1653512919740,CSE 293,023,094927,Paturi; Ramamohan,9999,0,9999,0
1653512919740,CSE 293,024,094928,Polikarpova; Nadezhda,9999,0,9999,0
1653512919740,CSE 293,025,094929,Politz; Joseph Gibbs,9999,0,9999,0
1653512919740,CSE 293,026,094930,Porter; George M,9999,0,9999,0
1653512919740,CSE 293,027,094931,Porter; Leonard Emerson,9999,0,9999,0
1653512919740,CSE 293,028,094932,Ramamoorthi; Ravi,9999,0,9999,0
1653512919740,CSE 293,029,094933,Sahoo; Debashis,9999,0,9999,0
1653512919740,CSE 293,030,094934,Saul; Lawrence,9999,0,9999,0
1653512919740,CSE 293,031,094935,Savage; Stefan,9999,0,9999,0
1653512919740,CSE 293,032,094936,Schulze; Jurgen P.,9999,0,9999,0
1653512919740,CSE 293,033,094937,Snoeren; Alex C.,9999,0,9999,0
1653512919740,CSE 293,034,094938,Shang; Jingbo,9999,0,9999,0
1653512919740,CSE 293,035,094939,Stefan; Deian,9999,0,9999,0
1653512919740,CSE 293,036,094940,Su; Hao,9999,0,9999,0
1653512919740,CSE 293,037,094941,Swanson; Steven James,9999,0,9999,0
1653512919740,CSE 293,038,094942,Tullsen; Dean Michael,9999,0,9999,0
1653512919740,CSE 293,039,094943,Voelker; Geoffrey M.,9999,0,9999,0
1653512919740,CSE 293,040,094944,Zhao; Jishen,9999,0,9999,0
1653512919740,CSE 293,041,094945,Zhou; Yuan-Yuan,9999,0,9999,0
1653512919740,CSE 293,042,094946,Gao; Sicun,9998,0,9999,1
1653512919740,CSE 293,043,094947,Weibel; Nadir,9999,0,9999,0
1653512919740,CSE 293,044,094948,Gupta; Rajesh K.,9999,0,9999,0
1653512920263,CSE 294,A00,090143,Porter; George M,8,0,10,2
1653512920787,DSE 200,A00,091799,Staff,50,0,50,0
1653512921313,DSE 203,A00,091800,Gupta; Amarnath,30,0,30,0
1653512921837,DSE 250,A00,091801,Deutsch; Alin Bernard,30,0,30,0
1653512922364,DSE 290,A00,091802,Altintas De Callaf; Ilkay,50,0,50,0
1653512922896,ECE 200,001,091003,Antipa; Nicholas A,9999,0,9999,0
1653512922896,ECE 200,002,091004,Atanasov; Nikolay A.,9999,0,9999,0
1653512922896,ECE 200,003,091005,Bharadia; Dinesh,9999,0,9999,0
1653512922896,ECE 200,004,091006,Cheng; Chung Kuan,9999,0,9999,0
1653512922896,ECE 200,005,091007,Cosman; Pamela C.,9999,0,9999,0
1653512922896,ECE 200,006,091008,Staff,9999,0,9999,0
1653512922896,ECE 200,007,091009,Dayeh; Shadi Ahmad,9999,0,9999,0
1653512922896,ECE 200,008,091010,Fainman; Yeshaiahu,9999,0,9999,0
1653512922896,ECE 200,009,091011,Ford; Joseph Earl,9999,0,9999,0
1653512922896,ECE 200,010,091012,Franceschetti; Massimo,9999,0,9999,0
1653512922896,ECE 200,011,091013,Fullerton; Eric E,9999,0,9999,0
1653512922896,ECE 200,012,091014,Galton; Ian A,9999,0,9999,0
1653512922896,ECE 200,013,091015,Gilja; Vikash,9999,0,9999,0
1653512922896,ECE 200,014,091016,Hall; Drew A.,9999,0,9999,0
1653512922896,ECE 200,015,091017,Hsueh; Tzu-Chien,9999,0,9999,0
1653512922896,ECE 200,016,091018,Javidi; Tara,9999,0,9999,0
1653512922896,ECE 200,017,091019,Kahng; Andrew Byun,9999,0,9999,0
1653512922896,ECE 200,018,091020,Kim; Young-Han,9999,0,9999,0
1653512922896,ECE 200,019,091021,Koushanfar; Farinaz,9999,0,9999,0
1653512922896,ECE 200,020,091022,Kuzum; Duygu,9999,0,9999,0
1653512922896,ECE 200,021,091023,Le; Hanh-Phuc,9999,0,9999,0
1653512922896,ECE 200,022,091024,Lin; Bill,9999,0,9999,0
1653512922896,ECE 200,023,091025,Liu; Zhaowei,9999,0,9999,0
1653512922896,ECE 200,024,091026,Lo; Yu-Hwa,9999,0,9999,0
1653512922896,ECE 200,025,091027,Lomakin; Vitaliy,9999,0,9999,0
1653512922896,ECE 200,026,091028,Mercier; Patrick Philip,9999,0,9999,0
1653512922896,ECE 200,027,091029,Meyer; Florian,9999,0,9999,0
1653512922896,ECE 200,028,091030,Milstein; Laurence B.,9999,0,9999,0
1653512922896,ECE 200,029,091031,Mir Arabbaygi; Siavash,9999,0,9999,0
1653512922896,ECE 200,030,091032,Mookherjea; Shayan,9999,0,9999,0
1653512922896,ECE 200,031,091033,Morris; Karcher William,9999,0,9999,0
1653512922896,ECE 200,032,091034,Ng; Tse Nga,9999,0,9999,0
1653512922896,ECE 200,033,091035,Nguyen; Truong Quang,9999,0,9999,0
1653512922896,ECE 200,034,091036,Nomura; Kenji,9999,0,9999,0
1653512922896,ECE 200,035,091037,Orlitsky; Alon,9999,0,9999,0
1653512922896,ECE 200,036,091038,Pal; Piya,9999,0,9999,0
1653512922896,ECE 200,037,091039,Papen; George C.,9999,0,9999,0
1653512922896,ECE 200,038,091040,Radic; Stojan,9999,0,9999,0
1653512922896,ECE 200,039,091041,Rao; Bhaskar D.,9999,0,9999,0
1653512922896,ECE 200,040,091042,Rao; Ramesh R,9999,0,9999,0
1653512922896,ECE 200,041,091043,Rebeiz; Gabriel,9999,0,9999,0
1653512922896,ECE 200,042,091044,Sanford; John R,9999,0,9999,0
1653512922896,ECE 200,043,091045,Siegel; Paul H.,9999,0,9999,0
1653512922896,ECE 200,044,091046,Sievenpiper; Daniel F.,9999,0,9999,0
1653512922896,ECE 200,045,091047,Sworder; David D.,9999,0,9999,0
1653512922896,ECE 200,046,091048,Taur; Yuan,9999,0,9999,0
1653512922896,ECE 200,047,091049,Touri; Behrouz,9999,0,9999,0
1653512922896,ECE 200,048,091050,Trivedi; Mohan M.,9999,0,9999,0
1653512922896,ECE 200,049,091051,Vardy; Alexander,9999,0,9999,0
1653512922896,ECE 200,050,091052,Vasconcelos; Nuno,9999,0,9999,0
1653512922896,ECE 200,051,091053,Wang; Xiaolong,9999,0,9999,0
1653512922896,ECE 200,052,091054,Xie; Pengtao,9999,0,9999,0
1653512922896,ECE 200,053,091055,Yip; Michael,9999,0,9999,0
1653512922896,ECE 200,054,091056,Zeger; Kenneth A.,9999,0,9999,0
1653512922896,ECE 200,055,091057,Zhang; Xinyu,9999,0,9999,0
1653512922896,ECE 200,056,091058,Turakhia; Yatish Girish,9999,0,9999,0
1653512922896,ECE 200,057,091059,Kang; Mingu,9999,0,9999,0
1653512922896,ECE 200,058,091060,Shi; Yuanyuan,9999,0,9999,0
1653512922896,ECE 200,059,091061,Wang; Edward Jay,9999,0,9999,0
1653512922896,ECE 200,060,091062,Zheng; Yang,9999,0,9999,0
1653512923421,ECE 201,A00,095526,Lo; Yu-Hwa,0,0,0,0
1653512923944,ECE 203,A00,091065,Mercier; Patrick Philip,0,0,0,0
1653512924466,ECE 207A,A00,091605,Liu; Thomas Tao-Ming,0,0,0,0
1653512924993,ECE 212AN,A00,091068,Nomura; Kenji,0,0,0,0
1653512925522,ECE 222A,A00,091069,Rebeiz; Gabriel,0,0,0,0
1653512926049,ECE 225A,A00,091070,Orlitsky; Alon,0,0,0,0
1653512926577,ECE 230A,A00,091071,Nomura; Kenji,0,0,0,0
1653512927099,ECE 236A,A00,091072,Dayeh; Shadi Ahmad,0,0,0,0
1653512927627,ECE 238A,A00,091073,Luo; Jian,0,0,0,0
1653512927627,ECE 238A,B00,091074,Luo; Jian,0,0,0,0
1653512928152,ECE 240A,A00,091075,Radic; Stojan,0,0,0,0
1653512928687,ECE 247A,A00,091592,Shi; Lingyan,0,0,0,0
1653512929228,ECE 250,A00,091076,Touri; Behrouz,0,0,0,0
1653512929752,ECE 251C,A00,091078,Nguyen; Truong Quang,0,0,0,0
1653512930275,ECE 253,A00,091079,Cosman; Pamela C.,0,0,0,0
1653512930798,ECE 255A,A00,091080,Orlitsky; Alon,0,0,0,0
1653512931323,ECE 257A,A00,091081,Zhang; Xinyu,0,0,0,0
1653512931847,ECE 260A,A01,091084,Eldon; John,0,0,0,0
1653512932372,ECE 264C,A00,091085,Galton; Ian A,0,0,0,0
1653512932898,ECE 265C,A00,094889,Presti; Calogero Davide,0,0,0,9
1653512933422,ECE 266,A01,091087,Hall; Drew A.,0,0,0,0
1653512934558,ECE 271A,A00,091090,Vasconcelos; Nuno,0,0,0,0
1653512935081,ECE 272B,A00,091091,Sworder; David D.,0,0,0,0
1653512935603,ECE 275A,A00,091092,Meyer; Florian,0,0,0,0
1653512936124,ECE 277,A00,091093,An; Cheolhong,0,0,0,0
1653512936650,ECE 283,A00,091094,Le; Hanh-Phuc,0,0,0,0
1653512937186,ECE 284,A00,091095,Kang; Mingu,0,0,0,0
1653512937186,ECE 284,B00,091096,Wang; Edward Jay,0,0,0,0
1653512937723,ECE 285,A00,094334,Touri; Behrouz,0,0,0,0
1653512938245,ECE 289,A00,091097,Whelan; David Arthur,0,0,0,0
1653512938766,MATH 200A,A00,087414,Salehi Golsefidy; Alireza,7,0,8,1
1653512939292,MATH 202A,A00,087415,Gill; Philip E.,3,0,8,5
1653512939834,MATH 203A,A00,087416,Oprea; Dragos N.,6,0,8,2
1653512940357,MATH 204A,A00,087417,Kedlaya; Kiran S.,6,0,8,2
1653512940886,MATH 205,A00,087418,Sorensen; Claus M,6,0,8,2
1653512941410,MATH 206A,A00,087419,Izadi; Elham,7,0,8,1
1653512941934,MATH 207A,A00,087420,Mohammadi; Amir,5,0,8,3
1653512942459,MATH 208,A00,087421,Staff,9,0,10,1
1653512942983,MATH 209,A00,087422,Staff,10,0,10,0
1653512943505,MATH 218,A00,087423,Staff,10,0,10,0
1653512944033,MATH 220A,A00,087424,Novak; Jonathan I,7,0,8,1
1653512944563,MATH 231A,A00,087425,Bejenaru; Ioan,3,0,8,5
1653512945086,MATH 240A,A00,087426,Ebenfelt; Peter F,5,0,8,3
1653512945610,MATH 243,A00,087427,Staff,9,0,10,1
1653512946132,MATH 248,A00,087429,Staff,10,0,10,0
1653512946656,MATH 250A,A00,087430,Spolaor; Luca,4,0,8,4
1653512947179,MATH 257A,A00,087431,Spolaor; Luca,7,0,8,1
1653512947711,MATH 258,A00,087432,Staff,9,0,10,1
1653512948239,MATH 264A,A00,087433,Warnke; Lutz Peter,5,0,8,3
1653512948773,MATH 268,A00,087434,Staff,15,0,15,0
1653512949295,MATH 269,A00,087435,Staff,14,0,15,1
1653512949829,MATH 270A,A00,087436,Nie; Jiawang,0,0,8,8
1653512950356,MATH 272A,A00,087437,Tian; Xiaochuan,1,0,8,7
1653512950879,MATH 274,A01,087439,Cheng; Li-Tien,9,0,10,1
1653512950879,MATH 274,A02,087440,Cheng; Li-Tien,10,0,10,0
1653512951403,MATH 278A,A00,087441,Staff,8,0,10,2
1653512951929,MATH 278B,A00,087442,Staff,8,0,10,2
1653512952455,MATH 278C,A00,087443,Staff,8,0,10,2
1653512952979,MATH 280A,A00,087444,Zheng; Tianyi,0,0,8,8
1653512953503,MATH 281A,A00,087445,Bradic; Jelena,0,0,8,8
1653512954031,MATH 282A,A00,087446,Zhang; Danna,0,0,8,8
1653512954554,MATH 283,A00,087447,Tesler; Glenn,0,0,0,15
1653512955080,MATH 286,A00,087448,Kemp; Todd Aahron,5,0,8,3
1653512955612,MATH 287D,A00,087449,Bradic; Jelena,8,0,8,0
1653512956135,MATH 288,A00,087450,Staff,14,0,15,1
1653512956135,MATH 288,B00,087451,Staff,15,0,15,0
1653512956135,MATH 288,C00,087452,Staff,15,0,15,0
1653512956659,MATH 290A,A00,087453,Xu; Zhouli,6,0,8,2
1653512957181,MATH 291A,A00,087454,Xu; Zhouli,7,0,8,1
1653512957706,MATH 292,A00,087455,Staff,10,0,10,0
1653512958241,MATH 295,A00,087456,Staff,50,0,50,0
1653512958769,MATH 297,001,087457,Staff,998,0,999,1
1653513531966,COGS 200,A01,087991,Staff,47,0,50,3
1653513532492,COGS 201,A01,094504,Rangel; Lara M,17,0,25,8
1653513533017,COGS 203,A00,087992,Coulson; Seana M,18,0,20,2
1653513533543,COGS 210A,001,087993,Greene; Deanna Jacquelyn,9998,0,9999,1
1653513533543,COGS 210A,002,087994,Saygin; Ayse P,9999,0,9999,0
1653513533543,COGS 210A,003,087995,Xia; Haijun,9999,0,9999,0
1653513533543,COGS 210A,004,087996,Nitz; Douglas A.,9999,0,9999,0
1653513533543,COGS 210A,005,087997,Hollan; James D.,9999,0,9999,0
1653513533543,COGS 210A,006,087998,Deak; Gedeon O.,9998,0,9999,1
1653513533543,COGS 210A,007,087999,Rossano; Federico,9999,0,9999,0
1653513534066,COGS 211A,A00,088000,Coulson; Seana M,9997,0,9999,2
1653513534664,COGS 229,A00,088002,Staff,23,0,25,2
1653513535187,COGS 260,B00,094231,Staff,17,0,20,3
1653513535187,COGS 260,A00,088004,Nitz; Douglas A.,9998,0,9999,1
1653513535711,CSE 202,A00,090110,Paturi; Ramamohan,0,0,0,0
1653513535711,CSE 202,B00,090111,Paturi; Ramamohan,0,0,0,0
1653513536238,CSE 207B,A00,090112,Heninger; Nadia A,0,0,0,0
1653513536762,CSE 208,A00,094858,Micciancio; Daniele,0,0,0,0
1653513537287,CSE 210,A00,090113,Powell; Thomas Allan,0,0,0,0
1653513537813,CSE 219,A00,090898,Staff,0,0,0,0
1653513538338,CSE 221,A00,090114,Zhou; Yuan-Yuan,0,0,0,0
1653513538874,CSE 229A,A00,090115,Porter; George M,0,0,0,0
1653513539396,CSE 229C,A00,090116,Savage; Stefan,0,0,0,0
1653513539919,CSE 230,A00,090117,Jhala; Ranjit,0,0,0,0
1653513540447,CSE 232,A00,090118,Papakonstantinou; Yannis,0,0,0,0
1653513540970,CSE 239A,A00,090121,Kumar; Arun Kumar,0,0,0,0
1653513541499,CSE 239B,A00,090122,Jhala; Ranjit,0,0,0,0
1653513542022,CSE 240A,A00,090123,Zhao; Jishen,0,0,189,189
1653513542547,CSE 243A,A00,090124,Orailoglu; Alex,0,0,15,15
1653513543081,CSE 249B,A00,090125,Kahng; Andrew Byun,13,0,20,7
1653513543604,CSE 250A,A00,090126,Berg-Kirkpatrick; Taylor D,0,0,0,0
1653513544130,CSE 252A,A00,090127,Ochoa; Benjamin Lawrence,0,0,0,0
1653513544655,CSE 258,A01,090129,McAuley; Julian John,0,0,0,0
1653513545181,CSE 258R,A01,090131,McAuley; Julian John,0,0,0,0
1653513545706,CSE 274,A00,090132,Ramamoorthi; Ravi,0,0,0,0
1653513546235,CSE 276A,A00,090133,Christensen; Henrik I,0,0,0,0
1653513546758,CSE 276C,A00,090134,Christensen; Henrik I,0,0,0,0
1653513547280,CSE 290,A00,090135,Bafna; Vineet,0,0,0,0
1653513547280,CSE 290,B00,090136,Ramamoorthi; Ravi,0,0,0,0
1653513547280,CSE 290,C00,090137,Li; Tzumao,8,0,10,2
1653513547280,CSE 290,D00,090138,Zhou; Yuan-Yuan,9,0,10,1
1653513547280,CSE 290,E00,090139,Christensen; Henrik I,9,0,10,1
1653513547280,CSE 290,F00,094053,Shalev; Aaron D,0,0,0,0
1653513547803,CSE 291,A00,090140,Munyaka; Imani N. S.,0,0,0,0
1653513547803,CSE 291,B00,094880,Yu; Qi,0,0,0,0
1653513547803,CSE 291,C00,090142,Pannuto; Patrick William,0,0,0,0
1653513547803,CSE 291,D00,094881,Zhang; Yiying,0,0,0,0
1653513547803,CSE 291,E00,095118,Su; Hao,0,0,0,0
1653513548342,CSE 293,001,094905,Bafna; Vineet,9999,0,9999,0
1653513548342,CSE 293,002,094906,Bellare; Mihir,9999,0,9999,0
1653513548342,CSE 293,003,094907,Berg-Kirkpatrick; Taylor D,9999,0,9999,0
1653513548342,CSE 293,004,094908,Christensen; Henrik I,9999,0,9999,0
1653513548342,CSE 293,005,094909,Cottrell; Garrison W,9999,0,9999,0
1653513548342,CSE 293,006,094910,Deutsch; Alin Bernard,9999,0,9999,0
1653513548342,CSE 293,007,094911,Esmaeilzadeh; Hadi,9999,0,9999,0
1653513548342,CSE 293,008,094912,Freund; Yoav,9999,0,9999,0
1653513548342,CSE 293,009,094913,Griswold; William G.,9999,0,9999,0
1653513548342,CSE 293,010,094914,Gymrek; Melissa Ann,9999,0,9999,0
1653513548342,CSE 293,011,094915,Heninger; Nadia A,9999,0,9999,0
1653513548342,CSE 293,012,094916,Impagliazzo; Russell,9999,0,9999,0
1653513548342,CSE 293,013,094917,Jhala; Ranjit,9999,0,9999,0
1653513548342,CSE 293,014,094918,Kahng; Andrew Byun,9999,0,9999,0
1653513548342,CSE 293,015,094919,Kane; Daniel Mertz,9999,0,9999,0
1653513548342,CSE 293,016,094920,Kriegman; David J,9999,0,9999,0
1653513548342,CSE 293,017,094921,Kumar; Arun Kumar,9999,0,9999,0
1653513548342,CSE 293,018,094922,Lerner; Sorin,9999,0,9999,0
1653513548342,CSE 293,019,094923,Lovett; Shachar,9999,0,9999,0
1653513548342,CSE 293,020,094924,McAuley; Julian John,9999,0,9999,0
1653513548342,CSE 293,021,094925,Micciancio; Daniele,9999,0,9999,0
1653513548342,CSE 293,022,094926,Orailoglu; Alex,9999,0,9999,0
1653513548342,CSE 293,023,094927,Paturi; Ramamohan,9999,0,9999,0
1653513548342,CSE 293,024,094928,Polikarpova; Nadezhda,9999,0,9999,0
1653513548342,CSE 293,025,094929,Politz; Joseph Gibbs,9999,0,9999,0
1653513548342,CSE 293,026,094930,Porter; George M,9999,0,9999,0
1653513548342,CSE 293,027,094931,Porter; Leonard Emerson,9999,0,9999,0
1653513548342,CSE 293,028,094932,Ramamoorthi; Ravi,9999,0,9999,0
1653513548342,CSE 293,029,094933,Sahoo; Debashis,9999,0,9999,0
1653513548342,CSE 293,030,094934,Saul; Lawrence,9999,0,9999,0
1653513548342,CSE 293,031,094935,Savage; Stefan,9999,0,9999,0
1653513548342,CSE 293,032,094936,Schulze; Jurgen P.,9999,0,9999,0
1653513548342,CSE 293,033,094937,Snoeren; Alex C.,9999,0,9999,0
1653513548342,CSE 293,034,094938,Shang; Jingbo,9999,0,9999,0
1653513548342,CSE 293,035,094939,Stefan; Deian,9999,0,9999,0
1653513548342,CSE 293,036,094940,Su; Hao,9999,0,9999,0
1653513548342,CSE 293,037,094941,Swanson; Steven James,9999,0,9999,0
1653513548342,CSE 293,038,094942,Tullsen; Dean Michael,9999,0,9999,0
1653513548342,CSE 293,039,094943,Voelker; Geoffrey M.,9999,0,9999,0
1653513548342,CSE 293,040,094944,Zhao; Jishen,9999,0,9999,0
1653513548342,CSE 293,041,094945,Zhou; Yuan-Yuan,9999,0,9999,0
1653513548342,CSE 293,042,094946,Gao; Sicun,9998,0,9999,1
1653513548342,CSE 293,043,094947,Weibel; Nadir,9999,0,9999,0
1653513548342,CSE 293,044,094948,Gupta; Rajesh K.,9999,0,9999,0
1653513548868,CSE 294,A00,090143,Porter; George M,8,0,10,2
1653513549390,DSE 200,A00,091799,Staff,50,0,50,0
1653513549916,DSE 203,A00,091800,Gupta; Amarnath,30,0,30,0
1653513550442,DSE 250,A00,091801,Deutsch; Alin Bernard,30,0,30,0
1653513550965,DSE 290,A00,091802,Altintas De Callaf; Ilkay,50,0,50,0
1653513551495,ECE 200,001,091003,Antipa; Nicholas A,9999,0,9999,0
1653513551495,ECE 200,002,091004,Atanasov; Nikolay A.,9999,0,9999,0
1653513551495,ECE 200,003,091005,Bharadia; Dinesh,9999,0,9999,0
1653513551495,ECE 200,004,091006,Cheng; Chung Kuan,9999,0,9999,0
1653513551495,ECE 200,005,091007,Cosman; Pamela C.,9999,0,9999,0
1653513551495,ECE 200,006,091008,Staff,9999,0,9999,0
1653513551495,ECE 200,007,091009,Dayeh; Shadi Ahmad,9999,0,9999,0
1653513551495,ECE 200,008,091010,Fainman; Yeshaiahu,9999,0,9999,0
1653513551495,ECE 200,009,091011,Ford; Joseph Earl,9999,0,9999,0
1653513551495,ECE 200,010,091012,Franceschetti; Massimo,9999,0,9999,0
1653513551495,ECE 200,011,091013,Fullerton; Eric E,9999,0,9999,0
1653513551495,ECE 200,012,091014,Galton; Ian A,9999,0,9999,0
1653513551495,ECE 200,013,091015,Gilja; Vikash,9999,0,9999,0
1653513551495,ECE 200,014,091016,Hall; Drew A.,9999,0,9999,0
1653513551495,ECE 200,015,091017,Hsueh; Tzu-Chien,9999,0,9999,0
1653513551495,ECE 200,016,091018,Javidi; Tara,9999,0,9999,0
1653513551495,ECE 200,017,091019,Kahng; Andrew Byun,9999,0,9999,0
1653513551495,ECE 200,018,091020,Kim; Young-Han,9999,0,9999,0
1653513551495,ECE 200,019,091021,Koushanfar; Farinaz,9999,0,9999,0
1653513551495,ECE 200,020,091022,Kuzum; Duygu,9999,0,9999,0
1653513551495,ECE 200,021,091023,Le; Hanh-Phuc,9999,0,9999,0
1653513551495,ECE 200,022,091024,Lin; Bill,9999,0,9999,0
1653513551495,ECE 200,023,091025,Liu; Zhaowei,9999,0,9999,0
1653513551495,ECE 200,024,091026,Lo; Yu-Hwa,9999,0,9999,0
1653513551495,ECE 200,025,091027,Lomakin; Vitaliy,9999,0,9999,0
1653513551495,ECE 200,026,091028,Mercier; Patrick Philip,9999,0,9999,0
1653513551495,ECE 200,027,091029,Meyer; Florian,9999,0,9999,0
1653513551495,ECE 200,028,091030,Milstein; Laurence B.,9999,0,9999,0
1653513551495,ECE 200,029,091031,Mir Arabbaygi; Siavash,9999,0,9999,0
1653513551495,ECE 200,030,091032,Mookherjea; Shayan,9999,0,9999,0
1653513551495,ECE 200,031,091033,Morris; Karcher William,9999,0,9999,0
1653513551495,ECE 200,032,091034,Ng; Tse Nga,9999,0,9999,0
1653513551495,ECE 200,033,091035,Nguyen; Truong Quang,9999,0,9999,0
1653513551495,ECE 200,034,091036,Nomura; Kenji,9999,0,9999,0
1653513551495,ECE 200,035,091037,Orlitsky; Alon,9999,0,9999,0
1653513551495,ECE 200,036,091038,Pal; Piya,9999,0,9999,0
1653513551495,ECE 200,037,091039,Papen; George C.,9999,0,9999,0
1653513551495,ECE 200,038,091040,Radic; Stojan,9999,0,9999,0
1653513551495,ECE 200,039,091041,Rao; Bhaskar D.,9999,0,9999,0
1653513551495,ECE 200,040,091042,Rao; Ramesh R,9999,0,9999,0
1653513551495,ECE 200,041,091043,Rebeiz; Gabriel,9999,0,9999,0
1653513551495,ECE 200,042,091044,Sanford; John R,9999,0,9999,0
1653513551495,ECE 200,043,091045,Siegel; Paul H.,9999,0,9999,0
1653513551495,ECE 200,044,091046,Sievenpiper; Daniel F.,9999,0,9999,0
1653513551495,ECE 200,045,091047,Sworder; David D.,9999,0,9999,0
1653513551495,ECE 200,046,091048,Taur; Yuan,9999,0,9999,0
1653513551495,ECE 200,047,091049,Touri; Behrouz,9999,0,9999,0
1653513551495,ECE 200,048,091050,Trivedi; Mohan M.,9999,0,9999,0
1653513551495,ECE 200,049,091051,Vardy; Alexander,9999,0,9999,0
1653513551495,ECE 200,050,091052,Vasconcelos; Nuno,9999,0,9999,0
1653513551495,ECE 200,051,091053,Wang; Xiaolong,9999,0,9999,0
1653513551495,ECE 200,052,091054,Xie; Pengtao,9999,0,9999,0
1653513551495,ECE 200,053,091055,Yip; Michael,9999,0,9999,0
1653513551495,ECE 200,054,091056,Zeger; Kenneth A.,9999,0,9999,0
1653513551495,ECE 200,055,091057,Zhang; Xinyu,9999,0,9999,0
1653513551495,ECE 200,056,091058,Turakhia; Yatish Girish,9999,0,9999,0
1653513551495,ECE 200,057,091059,Kang; Mingu,9999,0,9999,0
1653513551495,ECE 200,058,091060,Shi; Yuanyuan,9999,0,9999,0
1653513551495,ECE 200,059,091061,Wang; Edward Jay,9999,0,9999,0
1653513551495,ECE 200,060,091062,Zheng; Yang,9999,0,9999,0
1653513552026,ECE 201,A00,095526,Lo; Yu-Hwa,0,0,0,0
1653513552552,ECE 203,A00,091065,Mercier; Patrick Philip,0,0,0,0
1653513553078,ECE 207A,A00,091605,Liu; Thomas Tao-Ming,0,0,0,0
1653513553600,ECE 212AN,A00,091068,Nomura; Kenji,0,0,0,0
1653513554143,ECE 222A,A00,091069,Rebeiz; Gabriel,0,0,0,0
1653513554669,ECE 225A,A00,091070,Orlitsky; Alon,0,0,0,0
1653513555193,ECE 230A,A00,091071,Nomura; Kenji,0,0,0,0
1653513555720,ECE 236A,A00,091072,Dayeh; Shadi Ahmad,0,0,0,0
1653513556243,ECE 238A,A00,091073,Luo; Jian,0,0,0,0
1653513556243,ECE 238A,B00,091074,Luo; Jian,0,0,0,0
1653513556769,ECE 240A,A00,091075,Radic; Stojan,0,0,0,0
1653513557294,ECE 247A,A00,091592,Shi; Lingyan,0,0,0,0
1653513557821,ECE 250,A00,091076,Touri; Behrouz,0,0,0,0
1653513558344,ECE 251C,A00,091078,Nguyen; Truong Quang,0,0,0,0
1653513558872,ECE 253,A00,091079,Cosman; Pamela C.,0,0,0,0
1653513559395,ECE 255A,A00,091080,Orlitsky; Alon,0,0,0,0
1653513559917,ECE 257A,A00,091081,Zhang; Xinyu,0,0,0,0
1653513560441,ECE 260A,A01,091084,Eldon; John,0,0,0,0
1653513560969,ECE 264C,A00,091085,Galton; Ian A,0,0,0,0
1653513561491,ECE 265C,A00,094889,Presti; Calogero Davide,0,0,0,9
1653513562014,ECE 266,A01,091087,Hall; Drew A.,0,0,0,0
1653513563073,ECE 271A,A00,091090,Vasconcelos; Nuno,0,0,0,0
1653513563596,ECE 272B,A00,091091,Sworder; David D.,0,0,0,0
1653513564125,ECE 275A,A00,091092,Meyer; Florian,0,0,0,0
1653513564648,ECE 277,A00,091093,An; Cheolhong,0,0,0,0
1653513565171,ECE 283,A00,091094,Le; Hanh-Phuc,0,0,0,0
1653513565699,ECE 284,A00,091095,Kang; Mingu,0,0,0,0
1653513565699,ECE 284,B00,091096,Wang; Edward Jay,0,0,0,0
1653513566233,ECE 285,A00,094334,Touri; Behrouz,0,0,0,0
1653513566755,ECE 289,A00,091097,Whelan; David Arthur,0,0,0,0
1653513567276,MATH 200A,A00,087414,Salehi Golsefidy; Alireza,7,0,8,1
1653513567804,MATH 202A,A00,087415,Gill; Philip E.,3,0,8,5
1653513568327,MATH 203A,A00,087416,Oprea; Dragos N.,6,0,8,2
1653513568852,MATH 204A,A00,087417,Kedlaya; Kiran S.,6,0,8,2
1653513569385,MATH 205,A00,087418,Sorensen; Claus M,6,0,8,2
1653513569911,MATH 206A,A00,087419,Izadi; Elham,7,0,8,1
1653513570438,MATH 207A,A00,087420,Mohammadi; Amir,5,0,8,3
1653513571072,MATH 208,A00,087421,Staff,9,0,10,1
1653513571598,MATH 209,A00,087422,Staff,10,0,10,0
1653513572122,MATH 218,A00,087423,Staff,10,0,10,0
1653513572648,MATH 220A,A00,087424,Novak; Jonathan I,7,0,8,1
1653513573171,MATH 231A,A00,087425,Bejenaru; Ioan,3,0,8,5
1653513573695,MATH 240A,A00,087426,Ebenfelt; Peter F,5,0,8,3
1653513574222,MATH 243,A00,087427,Staff,9,0,10,1
1653513574744,MATH 248,A00,087429,Staff,10,0,10,0
1653513575270,MATH 250A,A00,087430,Spolaor; Luca,4,0,8,4
1653513575793,MATH 257A,A00,087431,Spolaor; Luca,7,0,8,1
1653513576314,MATH 258,A00,087432,Staff,9,0,10,1
1653513576844,MATH 264A,A00,087433,Warnke; Lutz Peter,5,0,8,3
1653513577373,MATH 268,A00,087434,Staff,15,0,15,0
1653513577899,MATH 269,A00,087435,Staff,14,0,15,1
1653513578425,MATH 270A,A00,087436,Nie; Jiawang,0,0,8,8
1653513578948,MATH 272A,A00,087437,Tian; Xiaochuan,1,0,8,7
1653513579477,MATH 274,A01,087439,Cheng; Li-Tien,9,0,10,1
1653513579477,MATH 274,A02,087440,Cheng; Li-Tien,10,0,10,0
1653513580007,MATH 278A,A00,087441,Staff,8,0,10,2
1653513580544,MATH 278B,A00,087442,Staff,8,0,10,2
1653513581076,MATH 278C,A00,087443,Staff,8,0,10,2
1653513581618,MATH 280A,A00,087444,Zheng; Tianyi,0,0,8,8
1653513582150,MATH 281A,A00,087445,Bradic; Jelena,0,0,8,8
1653513582692,MATH 282A,A00,087446,Zhang; Danna,0,0,8,8
1653513583226,MATH 283,A00,087447,Tesler; Glenn,0,0,0,15
1653513583753,MATH 286,A00,087448,Kemp; Todd Aahron,5,0,8,3
1653513584277,MATH 287D,A00,087449,Bradic; Jelena,8,0,8,0
1653513584800,MATH 288,A00,087450,Staff,14,0,15,1
1653513584800,MATH 288,B00,087451,Staff,15,0,15,0
1653513584800,MATH 288,C00,087452,Staff,15,0,15,0
1653513585323,MATH 290A,A00,087453,Xu; Zhouli,6,0,8,2
1653513585855,MATH 291A,A00,087454,Xu; Zhouli,7,0,8,1
1653513586388,MATH 292,A00,087455,Staff,10,0,10,0
1653513586921,MATH 295,A00,087456,Staff,50,0,50,0
1653513587445,MATH 297,001,087457,Staff,998,0,999,1
1653514149453,COGS 200,A01,087991,Staff,47,0,50,3
1653514149975,COGS 201,A01,094504,Rangel; Lara M,17,0,25,8
1653514150502,COGS 203,A00,087992,Coulson; Seana M,18,0,20,2
1653514151024,COGS 210A,001,087993,Greene; Deanna Jacquelyn,9998,0,9999,1
1653514151024,COGS 210A,002,087994,Saygin; Ayse P,9999,0,9999,0
1653514151024,COGS 210A,003,087995,Xia; Haijun,9999,0,9999,0
1653514151024,COGS 210A,004,087996,Nitz; Douglas A.,9999,0,9999,0
1653514151024,COGS 210A,005,087997,Hollan; James D.,9999,0,9999,0
1653514151024,COGS 210A,006,087998,Deak; Gedeon O.,9998,0,9999,1
1653514151024,COGS 210A,007,087999,Rossano; Federico,9999,0,9999,0
1653514151553,COGS 211A,A00,088000,Coulson; Seana M,9997,0,9999,2
1653514152077,COGS 229,A00,088002,Staff,23,0,25,2
1653514152602,COGS 260,B00,094231,Staff,17,0,20,3
1653514152602,COGS 260,A00,088004,Nitz; Douglas A.,9998,0,9999,1
1653514153135,CSE 202,A00,090110,Paturi; Ramamohan,0,0,0,0
1653514153135,CSE 202,B00,090111,Paturi; Ramamohan,0,0,0,0
1653514153660,CSE 207B,A00,090112,Heninger; Nadia A,0,0,0,0
1653514154184,CSE 208,A00,094858,Micciancio; Daniele,0,0,0,0
1653514154710,CSE 210,A00,090113,Powell; Thomas Allan,0,0,0,0
1653514155239,CSE 219,A00,090898,Staff,0,0,0,0
1653514155773,CSE 221,A00,090114,Zhou; Yuan-Yuan,0,0,0,0
1653514156295,CSE 229A,A00,090115,Porter; George M,0,0,0,0
1653514156819,CSE 229C,A00,090116,Savage; Stefan,0,0,0,0
1653514157362,CSE 230,A00,090117,Jhala; Ranjit,0,0,0,0
1653514157885,CSE 232,A00,090118,Papakonstantinou; Yannis,0,0,0,0
1653514158411,CSE 239A,A00,090121,Kumar; Arun Kumar,0,0,0,0
1653514158938,CSE 239B,A00,090122,Jhala; Ranjit,0,0,0,0
1653514159461,CSE 240A,A00,090123,Zhao; Jishen,0,0,189,189
1653514159987,CSE 243A,A00,090124,Orailoglu; Alex,0,0,15,15
1653514160510,CSE 249B,A00,090125,Kahng; Andrew Byun,13,0,20,7
1653514161037,CSE 250A,A00,090126,Berg-Kirkpatrick; Taylor D,0,0,0,0
1653514161563,CSE 252A,A00,090127,Ochoa; Benjamin Lawrence,0,0,0,0
1653514162088,CSE 258,A01,090129,McAuley; Julian John,0,0,0,0
1653514162614,CSE 258R,A01,090131,McAuley; Julian John,0,0,0,0
1653514163138,CSE 274,A00,090132,Ramamoorthi; Ravi,0,0,0,0
1653514163668,CSE 276A,A00,090133,Christensen; Henrik I,0,0,0,0
1653514164193,CSE 276C,A00,090134,Christensen; Henrik I,0,0,0,0
1653514164719,CSE 290,A00,090135,Bafna; Vineet,0,0,0,0
1653514164719,CSE 290,B00,090136,Ramamoorthi; Ravi,0,0,0,0
1653514164719,CSE 290,C00,090137,Li; Tzumao,8,0,10,2
1653514164719,CSE 290,D00,090138,Zhou; Yuan-Yuan,9,0,10,1
1653514164719,CSE 290,E00,090139,Christensen; Henrik I,9,0,10,1
1653514164719,CSE 290,F00,094053,Shalev; Aaron D,0,0,0,0
1653514165245,CSE 291,A00,090140,Munyaka; Imani N. S.,0,0,0,0
1653514165245,CSE 291,B00,094880,Yu; Qi,0,0,0,0
1653514165245,CSE 291,C00,090142,Pannuto; Patrick William,0,0,0,0
1653514165245,CSE 291,D00,094881,Zhang; Yiying,0,0,0,0
1653514165245,CSE 291,E00,095118,Su; Hao,0,0,0,0
1653514165775,CSE 293,001,094905,Bafna; Vineet,9999,0,9999,0
1653514165775,CSE 293,002,094906,Bellare; Mihir,9999,0,9999,0
1653514165775,CSE 293,003,094907,Berg-Kirkpatrick; Taylor D,9999,0,9999,0
1653514165775,CSE 293,004,094908,Christensen; Henrik I,9999,0,9999,0
1653514165775,CSE 293,005,094909,Cottrell; Garrison W,9999,0,9999,0
1653514165775,CSE 293,006,094910,Deutsch; Alin Bernard,9999,0,9999,0
1653514165775,CSE 293,007,094911,Esmaeilzadeh; Hadi,9999,0,9999,0
1653514165775,CSE 293,008,094912,Freund; Yoav,9999,0,9999,0
1653514165775,CSE 293,009,094913,Griswold; William G.,9999,0,9999,0
1653514165775,CSE 293,010,094914,Gymrek; Melissa Ann,9999,0,9999,0
1653514165775,CSE 293,011,094915,Heninger; Nadia A,9999,0,9999,0
1653514165775,CSE 293,012,094916,Impagliazzo; Russell,9999,0,9999,0
1653514165775,CSE 293,013,094917,Jhala; Ranjit,9999,0,9999,0
1653514165775,CSE 293,014,094918,Kahng; Andrew Byun,9999,0,9999,0
1653514165775,CSE 293,015,094919,Kane; Daniel Mertz,9999,0,9999,0
1653514165775,CSE 293,016,094920,Kriegman; David J,9999,0,9999,0
1653514165775,CSE 293,017,094921,Kumar; Arun Kumar,9999,0,9999,0
1653514165775,CSE 293,018,094922,Lerner; Sorin,9999,0,9999,0
1653514165775,CSE 293,019,094923,Lovett; Shachar,9999,0,9999,0
1653514165775,CSE 293,020,094924,McAuley; Julian John,9999,0,9999,0
1653514165775,CSE 293,021,094925,Micciancio; Daniele,9999,0,9999,0
1653514165775,CSE 293,022,094926,Orailoglu; Alex,9999,0,9999,0
1653514165775,CSE 293,023,094927,Paturi; Ramamohan,9999,0,9999,0
1653514165775,CSE 293,024,094928,Polikarpova; Nadezhda,9999,0,9999,0
1653514165775,CSE 293,025,094929,Politz; Joseph Gibbs,9999,0,9999,0
1653514165775,CSE 293,026,094930,Porter; George M,9999,0,9999,0
1653514165775,CSE 293,027,094931,Porter; Leonard Emerson,9999,0,9999,0
1653514165775,CSE 293,028,094932,Ramamoorthi; Ravi,9999,0,9999,0
1653514165775,CSE 293,029,094933,Sahoo; Debashis,9999,0,9999,0
1653514165775,CSE 293,030,094934,Saul; Lawrence,9999,0,9999,0
1653514165775,CSE 293,031,094935,Savage; Stefan,9999,0,9999,0
1653514165775,CSE 293,032,094936,Schulze; Jurgen P.,9999,0,9999,0
1653514165775,CSE 293,033,094937,Snoeren; Alex C.,9999,0,9999,0
1653514165775,CSE 293,034,094938,Shang; Jingbo,9999,0,9999,0
1653514165775,CSE 293,035,094939,Stefan; Deian,9999,0,9999,0
1653514165775,CSE 293,036,094940,Su; Hao,9999,0,9999,0
1653514165775,CSE 293,037,094941,Swanson; Steven James,9999,0,9999,0
1653514165775,CSE 293,038,094942,Tullsen; Dean Michael,9999,0,9999,0
1653514165775,CSE 293,039,094943,Voelker; Geoffrey M.,9999,0,9999,0
1653514165775,CSE 293,040,094944,Zhao; Jishen,9999,0,9999,0
1653514165775,CSE 293,041,094945,Zhou; Yuan-Yuan,9999,0,9999,0
1653514165775,CSE 293,042,094946,Gao; Sicun,9998,0,9999,1
1653514165775,CSE 293,043,094947,Weibel; Nadir,9999,0,9999,0
1653514165775,CSE 293,044,094948,Gupta; Rajesh K.,9999,0,9999,0
1653514166316,CSE 294,A00,090143,Porter; George M,8,0,10,2
1653514166842,DSE 200,A00,091799,Staff,50,0,50,0
1653514167367,DSE 203,A00,091800,Gupta; Amarnath,30,0,30,0
1653514167901,DSE 250,A00,091801,Deutsch; Alin Bernard,30,0,30,0
1653514168437,DSE 290,A00,091802,Altintas De Callaf; Ilkay,50,0,50,0
1653514168969,ECE 200,001,091003,Antipa; Nicholas A,9999,0,9999,0
1653514168969,ECE 200,002,091004,Atanasov; Nikolay A.,9999,0,9999,0
1653514168969,ECE 200,003,091005,Bharadia; Dinesh,9999,0,9999,0
1653514168969,ECE 200,004,091006,Cheng; Chung Kuan,9999,0,9999,0
1653514168969,ECE 200,005,091007,Cosman; Pamela C.,9999,0,9999,0
1653514168969,ECE 200,006,091008,Staff,9999,0,9999,0
1653514168969,ECE 200,007,091009,Dayeh; Shadi Ahmad,9999,0,9999,0
1653514168969,ECE 200,008,091010,Fainman; Yeshaiahu,9999,0,9999,0
1653514168969,ECE 200,009,091011,Ford; Joseph Earl,9999,0,9999,0
1653514168969,ECE 200,010,091012,Franceschetti; Massimo,9999,0,9999,0
1653514168969,ECE 200,011,091013,Fullerton; Eric E,9999,0,9999,0
1653514168969,ECE 200,012,091014,Galton; Ian A,9999,0,9999,0
1653514168969,ECE 200,013,091015,Gilja; Vikash,9999,0,9999,0
1653514168969,ECE 200,014,091016,Hall; Drew A.,9999,0,9999,0
1653514168969,ECE 200,015,091017,Hsueh; Tzu-Chien,9999,0,9999,0
1653514168969,ECE 200,016,091018,Javidi; Tara,9999,0,9999,0
1653514168969,ECE 200,017,091019,Kahng; Andrew Byun,9999,0,9999,0
1653514168969,ECE 200,018,091020,Kim; Young-Han,9999,0,9999,0
1653514168969,ECE 200,019,091021,Koushanfar; Farinaz,9999,0,9999,0
1653514168969,ECE 200,020,091022,Kuzum; Duygu,9999,0,9999,0
1653514168969,ECE 200,021,091023,Le; Hanh-Phuc,9999,0,9999,0
1653514168969,ECE 200,022,091024,Lin; Bill,9999,0,9999,0
1653514168969,ECE 200,023,091025,Liu; Zhaowei,9999,0,9999,0
1653514168969,ECE 200,024,091026,Lo; Yu-Hwa,9999,0,9999,0
1653514168969,ECE 200,025,091027,Lomakin; Vitaliy,9999,0,9999,0
1653514168969,ECE 200,026,091028,Mercier; Patrick Philip,9999,0,9999,0
1653514168969,ECE 200,027,091029,Meyer; Florian,9999,0,9999,0
1653514168969,ECE 200,028,091030,Milstein; Laurence B.,9999,0,9999,0
1653514168969,ECE 200,029,091031,Mir Arabbaygi; Siavash,9999,0,9999,0
1653514168969,ECE 200,030,091032,Mookherjea; Shayan,9999,0,9999,0
1653514168969,ECE 200,031,091033,Morris; Karcher William,9999,0,9999,0
1653514168969,ECE 200,032,091034,Ng; Tse Nga,9999,0,9999,0
1653514168969,ECE 200,033,091035,Nguyen; Truong Quang,9999,0,9999,0
1653514168969,ECE 200,034,091036,Nomura; Kenji,9999,0,9999,0
1653514168969,ECE 200,035,091037,Orlitsky; Alon,9999,0,9999,0
1653514168969,ECE 200,036,091038,Pal; Piya,9999,0,9999,0
1653514168969,ECE 200,037,091039,Papen; George C.,9999,0,9999,0
1653514168969,ECE 200,038,091040,Radic; Stojan,9999,0,9999,0
1653514168969,ECE 200,039,091041,Rao; Bhaskar D.,9999,0,9999,0
1653514168969,ECE 200,040,091042,Rao; Ramesh R,9999,0,9999,0
1653514168969,ECE 200,041,091043,Rebeiz; Gabriel,9999,0,9999,0
1653514168969,ECE 200,042,091044,Sanford; John R,9999,0,9999,0
1653514168969,ECE 200,043,091045,Siegel; Paul H.,9999,0,9999,0
1653514168969,ECE 200,044,091046,Sievenpiper; Daniel F.,9999,0,9999,0
1653514168969,ECE 200,045,091047,Sworder; David D.,9999,0,9999,0
1653514168969,ECE 200,046,091048,Taur; Yuan,9999,0,9999,0
1653514168969,ECE 200,047,091049,Touri; Behrouz,9999,0,9999,0
1653514168969,ECE 200,048,091050,Trivedi; Mohan M.,9999,0,9999,0
1653514168969,ECE 200,049,091051,Vardy; Alexander,9999,0,9999,0
1653514168969,ECE 200,050,091052,Vasconcelos; Nuno,9999,0,9999,0
1653514168969,ECE 200,051,091053,Wang; Xiaolong,9999,0,9999,0
1653514168969,ECE 200,052,091054,Xie; Pengtao,9999,0,9999,0
1653514168969,ECE 200,053,091055,Yip; Michael,9999,0,9999,0
1653514168969,ECE 200,054,091056,Zeger; Kenneth A.,9999,0,9999,0
1653514168969,ECE 200,055,091057,Zhang; Xinyu,9999,0,9999,0
1653514168969,ECE 200,056,091058,Turakhia; Yatish Girish,9999,0,9999,0
1653514168969,ECE 200,057,091059,Kang; Mingu,9999,0,9999,0
1653514168969,ECE 200,058,091060,Shi; Yuanyuan,9999,0,9999,0
1653514168969,ECE 200,059,091061,Wang; Edward Jay,9999,0,9999,0
1653514168969,ECE 200,060,091062,Zheng; Yang,9999,0,9999,0
1653514169493,ECE 201,A00,095526,Lo; Yu-Hwa,0,0,0,0
1653514170016,ECE 203,A00,091065,Mercier; Patrick Philip,0,0,0,0
1653514170540,ECE 207A,A00,091605,Liu; Thomas Tao-Ming,0,0,0,0
1653514171062,ECE 212AN,A00,091068,Nomura; Kenji,0,0,0,0
1653514171586,ECE 222A,A00,091069,Rebeiz; Gabriel,0,0,0,0
1653514172115,ECE 225A,A00,091070,Orlitsky; Alon,0,0,0,0
1653514172638,ECE 230A,A00,091071,Nomura; Kenji,0,0,0,0
1653514173163,ECE 236A,A00,091072,Dayeh; Shadi Ahmad,0,0,0,0
1653514173690,ECE 238A,A00,091073,Luo; Jian,0,0,0,0
1653514173690,ECE 238A,B00,091074,Luo; Jian,0,0,0,0
1653514174216,ECE 240A,A00,091075,Radic; Stojan,0,0,0,0
1653514174747,ECE 247A,A00,091592,Shi; Lingyan,0,0,0,0
1653514175272,ECE 250,A00,091076,Touri; Behrouz,0,0,0,0
1653514175804,ECE 251C,A00,091078,Nguyen; Truong Quang,0,0,0,0
1653514176327,ECE 253,A00,091079,Cosman; Pamela C.,0,0,0,0
1653514176849,ECE 255A,A00,091080,Orlitsky; Alon,0,0,0,0
1653514177468,ECE 257A,A00,091081,Zhang; Xinyu,0,0,0,0
1653514177999,ECE 260A,A01,091084,Eldon; John,0,0,0,0
1653514178531,ECE 264C,A00,091085,Galton; Ian A,0,0,0,0
1653514179069,ECE 265C,A00,094889,Presti; Calogero Davide,0,0,0,9
1653514179598,ECE 266,A01,091087,Hall; Drew A.,0,0,0,0
1653514180661,ECE 271A,A00,091090,Vasconcelos; Nuno,0,0,0,0
1653514181183,ECE 272B,A00,091091,Sworder; David D.,0,0,0,0
1653514181706,ECE 275A,A00,091092,Meyer; Florian,0,0,0,0
1653514182229,ECE 277,A00,091093,An; Cheolhong,0,0,0,0
1653514182752,ECE 283,A00,091094,Le; Hanh-Phuc,0,0,0,0
1653514183275,ECE 284,A00,091095,Kang; Mingu,0,0,0,0
1653514183275,ECE 284,B00,091096,Wang; Edward Jay,0,0,0,0
1653514183798,ECE 285,A00,094334,Touri; Behrouz,0,0,0,0
1653514184325,ECE 289,A00,091097,Whelan; David Arthur,0,0,0,0
1653514184851,MATH 200A,A00,087414,Salehi Golsefidy; Alireza,7,0,8,1
1653514185386,MATH 202A,A00,087415,Gill; Philip E.,3,0,8,5
1653514185910,MATH 203A,A00,087416,Oprea; Dragos N.,6,0,8,2
1653514186433,MATH 204A,A00,087417,Kedlaya; Kiran S.,6,0,8,2
1653514186956,MATH 205,A00,087418,Sorensen; Claus M,6,0,8,2
1653514187482,MATH 206A,A00,087419,Izadi; Elham,7,0,8,1
1653514188006,MATH 207A,A00,087420,Mohammadi; Amir,5,0,8,3
1653514188528,MATH 208,A00,087421,Staff,9,0,10,1
1653514189060,MATH 209,A00,087422,Staff,10,0,10,0
1653514189595,MATH 218,A00,087423,Staff,10,0,10,0
1653514190117,MATH 220A,A00,087424,Novak; Jonathan I,7,0,8,1
1653514190647,MATH 231A,A00,087425,Bejenaru; Ioan,3,0,8,5
1653514191180,MATH 240A,A00,087426,Ebenfelt; Peter F,5,0,8,3
1653514191703,MATH 243,A00,087427,Staff,9,0,10,1
1653514192228,MATH 248,A00,087429,Staff,10,0,10,0
1653514192752,MATH 250A,A00,087430,Spolaor; Luca,4,0,8,4
1653514193284,MATH 257A,A00,087431,Spolaor; Luca,7,0,8,1
1653514193814,MATH 258,A00,087432,Staff,9,0,10,1
1653514194344,MATH 264A,A00,087433,Warnke; Lutz Peter,5,0,8,3
1653514194870,MATH 268,A00,087434,Staff,15,0,15,0
1653514195393,MATH 269,A00,087435,Staff,14,0,15,1
1653514195920,MATH 270A,A00,087436,Nie; Jiawang,0,0,8,8
1653514196449,MATH 272A,A00,087437,Tian; Xiaochuan,1,0,8,7
1653514196979,MATH 274,A01,087439,Cheng; Li-Tien,9,0,10,1
1653514196979,MATH 274,A02,087440,Cheng; Li-Tien,10,0,10,0
1653514197504,MATH 278A,A00,087441,Staff,8,0,10,2
1653514198039,MATH 278B,A00,087442,Staff,8,0,10,2
1653514198573,MATH 278C,A00,087443,Staff,8,0,10,2
1653514199102,MATH 280A,A00,087444,Zheng; Tianyi,0,0,8,8
1653514199633,MATH 281A,A00,087445,Bradic; Jelena,0,0,8,8
1653514200169,MATH 282A,A00,087446,Zhang; Danna,0,0,8,8
1653514200692,MATH 283,A00,087447,Tesler; Glenn,0,0,0,15
1653514201216,MATH 286,A00,087448,Kemp; Todd Aahron,5,0,8,3
1653514201746,MATH 287D,A00,087449,Bradic; Jelena,8,0,8,0
1653514202302,MATH 288,A00,087450,Staff,14,0,15,1
1653514202302,MATH 288,B00,087451,Staff,15,0,15,0
1653514202302,MATH 288,C00,087452,Staff,15,0,15,0
1653514202837,MATH 290A,A00,087453,Xu; Zhouli,6,0,8,2
1653514203360,MATH 291A,A00,087454,Xu; Zhouli,7,0,8,1
1653514203892,MATH 292,A00,087455,Staff,10,0,10,0
1653514204415,MATH 295,A00,087456,Staff,50,0,50,0
1653514204940,MATH 297,001,087457,Staff,998,0,999,1
1653514766649,COGS 200,A01,087991,Staff,47,0,50,3
1653514767171,COGS 201,A01,094504,Rangel; Lara M,17,0,25,8
1653514767704,COGS 203,A00,087992,Coulson; Seana M,18,0,20,2
1653514768235,COGS 210A,001,087993,Greene; Deanna Jacquelyn,9998,0,9999,1
1653514768235,COGS 210A,002,087994,Saygin; Ayse P,9999,0,9999,0
1653514768235,COGS 210A,003,087995,Xia; Haijun,9999,0,9999,0
1653514768235,COGS 210A,004,087996,Nitz; Douglas A.,9999,0,9999,0
1653514768235,COGS 210A,005,087997,Hollan; James D.,9999,0,9999,0
1653514768235,COGS 210A,006,087998,Deak; Gedeon O.,9998,0,9999,1
1653514768235,COGS 210A,007,087999,Rossano; Federico,9999,0,9999,0
1653514768770,COGS 211A,A00,088000,Coulson; Seana M,9997,0,9999,2
1653514769293,COGS 229,A00,088002,Staff,23,0,25,2
1653514769818,COGS 260,B00,094231,Staff,17,0,20,3
1653514769818,COGS 260,A00,088004,Nitz; Douglas A.,9998,0,9999,1
1653514770340,CSE 202,A00,090110,Paturi; Ramamohan,0,0,0,0
1653514770340,CSE 202,B00,090111,Paturi; Ramamohan,0,0,0,0
1653514770870,CSE 207B,A00,090112,Heninger; Nadia A,0,0,0,0
1653514771420,CSE 208,A00,094858,Micciancio; Daniele,0,0,0,0
1653514771949,CSE 210,A00,090113,Powell; Thomas Allan,0,0,0,0
1653514772473,CSE 219,A00,090898,Staff,0,0,0,0
1653514772999,CSE 221,A00,090114,Zhou; Yuan-Yuan,0,0,0,0
1653514773527,CSE 229A,A00,090115,Porter; George M,0,0,0,0
1653514774063,CSE 229C,A00,090116,Savage; Stefan,0,0,0,0
1653514774596,CSE 230,A00,090117,Jhala; Ranjit,0,0,0,0
1653514775121,CSE 232,A00,090118,Papakonstantinou; Yannis,0,0,0,0
1653514775660,CSE 239A,A00,090121,Kumar; Arun Kumar,0,0,0,0
1653514776192,CSE 239B,A00,090122,Jhala; Ranjit,0,0,0,0
1653514776718,CSE 240A,A00,090123,Zhao; Jishen,0,0,189,189
1653514777242,CSE 243A,A00,090124,Orailoglu; Alex,0,0,15,15
1653514777766,CSE 249B,A00,090125,Kahng; Andrew Byun,13,0,20,7
1653514778292,CSE 250A,A00,090126,Berg-Kirkpatrick; Taylor D,0,0,0,0
1653514778818,CSE 252A,A00,090127,Ochoa; Benjamin Lawrence,0,0,0,0
1653514779344,CSE 258,A01,090129,McAuley; Julian John,0,0,0,0
1653514779869,CSE 258R,A01,090131,McAuley; Julian John,0,0,0,0
1653514780415,CSE 274,A00,090132,Ramamoorthi; Ravi,0,0,0,0
1653514780938,CSE 276A,A00,090133,Christensen; Henrik I,0,0,0,0
1653514781471,CSE 276C,A00,090134,Christensen; Henrik I,0,0,0,0
1653514781999,CSE 290,A00,090135,Bafna; Vineet,0,0,0,0
1653514781999,CSE 290,B00,090136,Ramamoorthi; Ravi,0,0,0,0
1653514781999,CSE 290,C00,090137,Li; Tzumao,8,0,10,2
1653514781999,CSE 290,D00,090138,Zhou; Yuan-Yuan,9,0,10,1
1653514781999,CSE 290,E00,090139,Christensen; Henrik I,9,0,10,1
1653514781999,CSE 290,F00,094053,Shalev; Aaron D,0,0,0,0
1653514782536,CSE 291,A00,090140,Munyaka; Imani N. S.,0,0,0,0
1653514782536,CSE 291,B00,094880,Yu; Qi,0,0,0,0
1653514782536,CSE 291,C00,090142,Pannuto; Patrick William,0,0,0,0
1653514782536,CSE 291,D00,094881,Zhang; Yiying,0,0,0,0
1653514782536,CSE 291,E00,095118,Su; Hao,0,0,0,0
1653514783062,CSE 293,001,094905,Bafna; Vineet,9999,0,9999,0
1653514783062,CSE 293,002,094906,Bellare; Mihir,9999,0,9999,0
1653514783062,CSE 293,003,094907,Berg-Kirkpatrick; Taylor D,9999,0,9999,0
1653514783062,CSE 293,004,094908,Christensen; Henrik I,9999,0,9999,0
1653514783062,CSE 293,005,094909,Cottrell; Garrison W,9999,0,9999,0
1653514783062,CSE 293,006,094910,Deutsch; Alin Bernard,9999,0,9999,0
1653514783062,CSE 293,007,094911,Esmaeilzadeh; Hadi,9999,0,9999,0
1653514783062,CSE 293,008,094912,Freund; Yoav,9999,0,9999,0
1653514783062,CSE 293,009,094913,Griswold; William G.,9999,0,9999,0
1653514783062,CSE 293,010,094914,Gymrek; Melissa Ann,9999,0,9999,0
1653514783062,CSE 293,011,094915,Heninger; Nadia A,9999,0,9999,0
1653514783062,CSE 293,012,094916,Impagliazzo; Russell,9999,0,9999,0
1653514783062,CSE 293,013,094917,Jhala; Ranjit,9999,0,9999,0
1653514783062,CSE 293,014,094918,Kahng; Andrew Byun,9999,0,9999,0
1653514783062,CSE 293,015,094919,Kane; Daniel Mertz,9999,0,9999,0
1653514783062,CSE 293,016,094920,Kriegman; David J,9999,0,9999,0
1653514783062,CSE 293,017,094921,Kumar; Arun Kumar,9999,0,9999,0
1653514783062,CSE 293,018,094922,Lerner; Sorin,9999,0,9999,0
1653514783062,CSE 293,019,094923,Lovett; Shachar,9999,0,9999,0
1653514783062,CSE 293,020,094924,McAuley; Julian John,9999,0,9999,0
1653514783062,CSE 293,021,094925,Micciancio; Daniele,9999,0,9999,0
1653514783062,CSE 293,022,094926,Orailoglu; Alex,9999,0,9999,0
1653514783062,CSE 293,023,094927,Paturi; Ramamohan,9999,0,9999,0
1653514783062,CSE 293,024,094928,Polikarpova; Nadezhda,9999,0,9999,0
1653514783062,CSE 293,025,094929,Politz; Joseph Gibbs,9999,0,9999,0
1653514783062,CSE 293,026,094930,Porter; George M,9999,0,9999,0
1653514783062,CSE 293,027,094931,Porter; Leonard Emerson,9999,0,9999,0
1653514783062,CSE 293,028,094932,Ramamoorthi; Ravi,9999,0,9999,0
1653514783062,CSE 293,029,094933,Sahoo; Debashis,9999,0,9999,0
1653514783062,CSE 293,030,094934,Saul; Lawrence,9999,0,9999,0
1653514783062,CSE 293,031,094935,Savage; Stefan,9999,0,9999,0
1653514783062,CSE 293,032,094936,Schulze; Jurgen P.,9999,0,9999,0
1653514783062,CSE 293,033,094937,Snoeren; Alex C.,9999,0,9999,0
1653514783062,CSE 293,034,094938,Shang; Jingbo,9999,0,9999,0
1653514783062,CSE 293,035,094939,Stefan; Deian,9999,0,9999,0
1653514783062,CSE 293,036,094940,Su; Hao,9999,0,9999,0
1653514783062,CSE 293,037,094941,Swanson; Steven James,9999,0,9999,0
1653514783062,CSE 293,038,094942,Tullsen; Dean Michael,9999,0,9999,0
1653514783062,CSE 293,039,094943,Voelker; Geoffrey M.,9999,0,9999,0
1653514783062,CSE 293,040,094944,Zhao; Jishen,9999,0,9999,0
1653514783062,CSE 293,041,094945,Zhou; Yuan-Yuan,9999,0,9999,0
1653514783062,CSE 293,042,094946,Gao; Sicun,9998,0,9999,1
1653514783062,CSE 293,043,094947,Weibel; Nadir,9999,0,9999,0
1653514783062,CSE 293,044,094948,Gupta; Rajesh K.,9999,0,9999,0
1653514783595,CSE 294,A00,090143,Porter; George M,8,0,10,2
1653514784121,DSE 200,A00,091799,Staff,50,0,50,0
1653514784656,DSE 203,A00,091800,Gupta; Amarnath,30,0,30,0
1653514785180,DSE 250,A00,091801,Deutsch; Alin Bernard,30,0,30,0
1653514785720,DSE 290,A00,091802,Altintas De Callaf; Ilkay,50,0,50,0
1653514786250,ECE 200,001,091003,Antipa; Nicholas A,9999,0,9999,0
1653514786250,ECE 200,002,091004,Atanasov; Nikolay A.,9999,0,9999,0
1653514786250,ECE 200,003,091005,Bharadia; Dinesh,9999,0,9999,0
1653514786250,ECE 200,004,091006,Cheng; Chung Kuan,9999,0,9999,0
1653514786250,ECE 200,005,091007,Cosman; Pamela C.,9999,0,9999,0
1653514786250,ECE 200,006,091008,Staff,9999,0,9999,0
1653514786250,ECE 200,007,091009,Dayeh; Shadi Ahmad,9999,0,9999,0
1653514786250,ECE 200,008,091010,Fainman; Yeshaiahu,9999,0,9999,0
1653514786250,ECE 200,009,091011,Ford; Joseph Earl,9999,0,9999,0
1653514786250,ECE 200,010,091012,Franceschetti; Massimo,9999,0,9999,0
1653514786250,ECE 200,011,091013,Fullerton; Eric E,9999,0,9999,0
1653514786250,ECE 200,012,091014,Galton; Ian A,9999,0,9999,0
1653514786250,ECE 200,013,091015,Gilja; Vikash,9999,0,9999,0
1653514786250,ECE 200,014,091016,Hall; Drew A.,9999,0,9999,0
1653514786250,ECE 200,015,091017,Hsueh; Tzu-Chien,9999,0,9999,0
1653514786250,ECE 200,016,091018,Javidi; Tara,9999,0,9999,0
1653514786250,ECE 200,017,091019,Kahng; Andrew Byun,9999,0,9999,0
1653514786250,ECE 200,018,091020,Kim; Young-Han,9999,0,9999,0
1653514786250,ECE 200,019,091021,Koushanfar; Farinaz,9999,0,9999,0
1653514786250,ECE 200,020,091022,Kuzum; Duygu,9999,0,9999,0
1653514786250,ECE 200,021,091023,Le; Hanh-Phuc,9999,0,9999,0
1653514786250,ECE 200,022,091024,Lin; Bill,9999,0,9999,0
1653514786250,ECE 200,023,091025,Liu; Zhaowei,9999,0,9999,0
1653514786250,ECE 200,024,091026,Lo; Yu-Hwa,9999,0,9999,0
1653514786250,ECE 200,025,091027,Lomakin; Vitaliy,9999,0,9999,0
1653514786250,ECE 200,026,091028,Mercier; Patrick Philip,9999,0,9999,0
1653514786250,ECE 200,027,091029,Meyer; Florian,9999,0,9999,0
1653514786250,ECE 200,028,091030,Milstein; Laurence B.,9999,0,9999,0
1653514786250,ECE 200,029,091031,Mir Arabbaygi; Siavash,9999,0,9999,0
1653514786250,ECE 200,030,091032,Mookherjea; Shayan,9999,0,9999,0
1653514786250,ECE 200,031,091033,Morris; Karcher William,9999,0,9999,0
1653514786250,ECE 200,032,091034,Ng; Tse Nga,9999,0,9999,0
1653514786250,ECE 200,033,091035,Nguyen; Truong Quang,9999,0,9999,0
1653514786250,ECE 200,034,091036,Nomura; Kenji,9999,0,9999,0
1653514786250,ECE 200,035,091037,Orlitsky; Alon,9999,0,9999,0
1653514786250,ECE 200,036,091038,Pal; Piya,9999,0,9999,0
1653514786250,ECE 200,037,091039,Papen; George C.,9999,0,9999,0
1653514786250,ECE 200,038,091040,Radic; Stojan,9999,0,9999,0
1653514786250,ECE 200,039,091041,Rao; Bhaskar D.,9999,0,9999,0
1653514786250,ECE 200,040,091042,Rao; Ramesh R,9999,0,9999,0
1653514786250,ECE 200,041,091043,Rebeiz; Gabriel,9999,0,9999,0
1653514786250,ECE 200,042,091044,Sanford; John R,9999,0,9999,0
1653514786250,ECE 200,043,091045,Siegel; Paul H.,9999,0,9999,0
1653514786250,ECE 200,044,091046,Sievenpiper; Daniel F.,9999,0,9999,0
1653514786250,ECE 200,045,091047,Sworder; David D.,9999,0,9999,0
1653514786250,ECE 200,046,091048,Taur; Yuan,9999,0,9999,0
1653514786250,ECE 200,047,091049,Touri; Behrouz,9999,0,9999,0
1653514786250,ECE 200,048,091050,Trivedi; Mohan M.,9999,0,9999,0
1653514786250,ECE 200,049,091051,Vardy; Alexander,9999,0,9999,0
1653514786250,ECE 200,050,091052,Vasconcelos; Nuno,9999,0,9999,0
1653514786250,ECE 200,051,091053,Wang; Xiaolong,9999,0,9999,0
1653514786250,ECE 200,052,091054,Xie; Pengtao,9999,0,9999,0
1653514786250,ECE 200,053,091055,Yip; Michael,9999,0,9999,0
1653514786250,ECE 200,054,091056,Zeger; Kenneth A.,9999,0,9999,0
1653514786250,ECE 200,055,091057,Zhang; Xinyu,9999,0,9999,0
1653514786250,ECE 200,056,091058,Turakhia; Yatish Girish,9999,0,9999,0
1653514786250,ECE 200,057,091059,Kang; Mingu,9999,0,9999,0
1653514786250,ECE 200,058,091060,Shi; Yuanyuan,9999,0,9999,0
1653514786250,ECE 200,059,091061,Wang; Edward Jay,9999,0,9999,0
1653514786250,ECE 200,060,091062,Zheng; Yang,9999,0,9999,0
1653514786777,ECE 201,A00,095526,Lo; Yu-Hwa,0,0,0,0
1653514787312,ECE 203,A00,091065,Mercier; Patrick Philip,0,0,0,0
1653514787836,ECE 207A,A00,091605,Liu; Thomas Tao-Ming,0,0,0,0
1653514788357,ECE 212AN,A00,091068,Nomura; Kenji,0,0,0,0
1653514788884,ECE 222A,A00,091069,Rebeiz; Gabriel,0,0,0,0
1653514789422,ECE 225A,A00,091070,Orlitsky; Alon,0,0,0,0
1653514789972,ECE 230A,A00,091071,Nomura; Kenji,0,0,0,0
1653514790507,ECE 236A,A00,091072,Dayeh; Shadi Ahmad,0,0,0,0
1653514791030,ECE 238A,A00,091073,Luo; Jian,0,0,0,0
1653514791030,ECE 238A,B00,091074,Luo; Jian,0,0,0,0
1653514791554,ECE 240A,A00,091075,Radic; Stojan,0,0,0,0
1653514792083,ECE 247A,A00,091592,Shi; Lingyan,0,0,0,0
1653514792610,ECE 250,A00,091076,Touri; Behrouz,0,0,0,0
1653514793141,ECE 251C,A00,091078,Nguyen; Truong Quang,0,0,0,0
1653514793668,ECE 253,A00,091079,Cosman; Pamela C.,0,0,0,0
1653514794190,ECE 255A,A00,091080,Orlitsky; Alon,0,0,0,0
1653514794715,ECE 257A,A00,091081,Zhang; Xinyu,0,0,0,0
1653514795242,ECE 260A,A01,091084,Eldon; John,0,0,0,0
1653514795768,ECE 264C,A00,091085,Galton; Ian A,0,0,0,0
1653514796298,ECE 265C,A00,094889,Presti; Calogero Davide,0,0,0,9
1653514796831,ECE 266,A01,091087,Hall; Drew A.,0,0,0,0
1653514797887,ECE 271A,A00,091090,Vasconcelos; Nuno,0,0,0,0
1653514798413,ECE 272B,A00,091091,Sworder; David D.,0,0,0,0
1653514798937,ECE 275A,A00,091092,Meyer; Florian,0,0,0,0
1653514799473,ECE 277,A00,091093,An; Cheolhong,0,0,0,0
1653514799998,ECE 283,A00,091094,Le; Hanh-Phuc,0,0,0,0
1653514800524,ECE 284,A00,091095,Kang; Mingu,0,0,0,0
1653514800524,ECE 284,B00,091096,Wang; Edward Jay,0,0,0,0
1653514801063,ECE 285,A00,094334,Touri; Behrouz,0,0,0,0
1653514801590,ECE 289,A00,091097,Whelan; David Arthur,0,0,0,0
1653514802128,MATH 200A,A00,087414,Salehi Golsefidy; Alireza,7,0,8,1
1653514802656,MATH 202A,A00,087415,Gill; Philip E.,3,0,8,5
1653514803182,MATH 203A,A00,087416,Oprea; Dragos N.,6,0,8,2
1653514803706,MATH 204A,A00,087417,Kedlaya; Kiran S.,6,0,8,2
1653514804229,MATH 205,A00,087418,Sorensen; Claus M,6,0,8,2
1653514804754,MATH 206A,A00,087419,Izadi; Elham,7,0,8,1
1653514805290,MATH 207A,A00,087420,Mohammadi; Amir,5,0,8,3
1653514805829,MATH 208,A00,087421,Staff,9,0,10,1
1653514806351,MATH 209,A00,087422,Staff,10,0,10,0
1653514806877,MATH 218,A00,087423,Staff,10,0,10,0
1653514807400,MATH 220A,A00,087424,Novak; Jonathan I,7,0,8,1
1653514807931,MATH 231A,A00,087425,Bejenaru; Ioan,3,0,8,5
1653514808480,MATH 240A,A00,087426,Ebenfelt; Peter F,5,0,8,3
1653514809002,MATH 243,A00,087427,Staff,9,0,10,1
1653514809529,MATH 248,A00,087429,Staff,10,0,10,0
1653514810057,MATH 250A,A00,087430,Spolaor; Luca,4,0,8,4
1653514810590,MATH 257A,A00,087431,Spolaor; Luca,7,0,8,1
1653514811124,MATH 258,A00,087432,Staff,9,0,10,1
1653514811649,MATH 264A,A00,087433,Warnke; Lutz Peter,5,0,8,3
1653514812180,MATH 268,A00,087434,Staff,15,0,15,0
1653514812716,MATH 269,A00,087435,Staff,14,0,15,1
1653514813239,MATH 270A,A00,087436,Nie; Jiawang,0,0,8,8
1653514813761,MATH 272A,A00,087437,Tian; Xiaochuan,1,0,8,7
1653514814297,MATH 274,A01,087439,Cheng; Li-Tien,9,0,10,1
1653514814297,MATH 274,A02,087440,Cheng; Li-Tien,10,0,10,0
1653514814822,MATH 278A,A00,087441,Staff,8,0,10,2
1653514815345,MATH 278B,A00,087442,Staff,8,0,10,2
1653514815870,MATH 278C,A00,087443,Staff,8,0,10,2
1653514816393,MATH 280A,A00,087444,Zheng; Tianyi,0,0,8,8
1653514816920,MATH 281A,A00,087445,Bradic; Jelena,0,0,8,8
1653514817443,MATH 282A,A00,087446,Zhang; Danna,0,0,8,8
1653514817971,MATH 283,A00,087447,Tesler; Glenn,0,0,0,15
1653514818508,MATH 286,A00,087448,Kemp; Todd Aahron,5,0,8,3
1653514819038,MATH 287D,A00,087449,Bradic; Jelena,8,0,8,0
1653514819568,MATH 288,A00,087450,Staff,14,0,15,1
1653514819568,MATH 288,B00,087451,Staff,15,0,15,0
1653514819568,MATH 288,C00,087452,Staff,15,0,15,0
1653514820190,MATH 290A,A00,087453,Xu; Zhouli,6,0,8,2
1653514820712,MATH 291A,A00,087454,Xu; Zhouli,7,0,8,1
1653514821242,MATH 292,A00,087455,Staff,10,0,10,0
1653514821773,MATH 295,A00,087456,Staff,50,0,50,0
1653514822296,MATH 297,001,087457,Staff,998,0,999,1
1653515384621,COGS 200,A01,087991,Staff,47,0,50,3
1653515385147,COGS 201,A01,094504,Rangel; Lara M,17,0,25,8
1653515385672,COGS 203,A00,087992,Coulson; Seana M,18,0,20,2
1653515386202,COGS 210A,001,087993,Greene; Deanna Jacquelyn,9998,0,9999,1
1653515386202,COGS 210A,002,087994,Saygin; Ayse P,9999,0,9999,0
1653515386202,COGS 210A,003,087995,Xia; Haijun,9999,0,9999,0
1653515386202,COGS 210A,004,087996,Nitz; Douglas A.,9999,0,9999,0
1653515386202,COGS 210A,005,087997,Hollan; James D.,9999,0,9999,0
1653515386202,COGS 210A,006,087998,Deak; Gedeon O.,9998,0,9999,1
1653515386202,COGS 210A,007,087999,Rossano; Federico,9999,0,9999,0
1653515386733,COGS 211A,A00,088000,Coulson; Seana M,9997,0,9999,2
1653515387260,COGS 229,A00,088002,Staff,23,0,25,2
1653515387788,COGS 260,B00,094231,Staff,17,0,20,3
1653515387788,COGS 260,A00,088004,Nitz; Douglas A.,9998,0,9999,1
1653515388312,CSE 202,A00,090110,Paturi; Ramamohan,0,0,0,0
1653515388312,CSE 202,B00,090111,Paturi; Ramamohan,0,0,0,0
1653515388847,CSE 207B,A00,090112,Heninger; Nadia A,0,0,0,0
1653515389381,CSE 208,A00,094858,Micciancio; Daniele,0,0,0,0
1653515389910,CSE 210,A00,090113,Powell; Thomas Allan,0,0,0,0
1653515390432,CSE 219,A00,090898,Staff,0,0,0,0
1653515390958,CSE 221,A00,090114,Zhou; Yuan-Yuan,0,0,0,0
1653515391483,CSE 229A,A00,090115,Porter; George M,0,0,0,0
1653515392011,CSE 229C,A00,090116,Savage; Stefan,0,0,0,0
1653515392538,CSE 230,A00,090117,Jhala; Ranjit,0,0,0,0
1653515393062,CSE 232,A00,090118,Papakonstantinou; Yannis,0,0,0,0
1653515393591,CSE 239A,A00,090121,Kumar; Arun Kumar,0,0,0,0
1653515394131,CSE 239B,A00,090122,Jhala; Ranjit,0,0,0,0
1653515394657,CSE 240A,A00,090123,Zhao; Jishen,0,0,189,189
1653515395193,CSE 243A,A00,090124,Orailoglu; Alex,0,0,15,15
1653515395719,CSE 249B,A00,090125,Kahng; Andrew Byun,13,0,20,7
1653515396253,CSE 250A,A00,090126,Berg-Kirkpatrick; Taylor D,0,0,0,0
1653515396775,CSE 252A,A00,090127,Ochoa; Benjamin Lawrence,0,0,0,0
1653515397298,CSE 258,A01,090129,McAuley; Julian John,0,0,0,0
1653515397824,CSE 258R,A01,090131,McAuley; Julian John,0,0,0,0
1653515398349,CSE 274,A00,090132,Ramamoorthi; Ravi,0,0,0,0
1653515398876,CSE 276A,A00,090133,Christensen; Henrik I,0,0,0,0
1653515399411,CSE 276C,A00,090134,Christensen; Henrik I,0,0,0,0
1653515399938,CSE 290,A00,090135,Bafna; Vineet,0,0,0,0
1653515399938,CSE 290,B00,090136,Ramamoorthi; Ravi,0,0,0,0
1653515399938,CSE 290,C00,090137,Li; Tzumao,8,0,10,2
1653515399938,CSE 290,D00,090138,Zhou; Yuan-Yuan,9,0,10,1
1653515399938,CSE 290,E00,090139,Christensen; Henrik I,9,0,10,1
1653515399938,CSE 290,F00,094053,Shalev; Aaron D,0,0,0,0
1653515400460,CSE 291,A00,090140,Munyaka; Imani N. S.,0,0,0,0
1653515400460,CSE 291,B00,094880,Yu; Qi,0,0,0,0
1653515400460,CSE 291,C00,090142,Pannuto; Patrick William,0,0,0,0
1653515400460,CSE 291,D00,094881,Zhang; Yiying,0,0,0,0
1653515400460,CSE 291,E00,095118,Su; Hao,0,0,0,0
1653515401014,CSE 293,001,094905,Bafna; Vineet,9999,0,9999,0
1653515401014,CSE 293,002,094906,Bellare; Mihir,9999,0,9999,0
1653515401014,CSE 293,003,094907,Berg-Kirkpatrick; Taylor D,9999,0,9999,0
1653515401014,CSE 293,004,094908,Christensen; Henrik I,9999,0,9999,0
1653515401014,CSE 293,005,094909,Cottrell; Garrison W,9999,0,9999,0
1653515401014,CSE 293,006,094910,Deutsch; Alin Bernard,9999,0,9999,0
1653515401014,CSE 293,007,094911,Esmaeilzadeh; Hadi,9999,0,9999,0
1653515401014,CSE 293,008,094912,Freund; Yoav,9999,0,9999,0
1653515401014,CSE 293,009,094913,Griswold; William G.,9999,0,9999,0
1653515401014,CSE 293,010,094914,Gymrek; Melissa Ann,9999,0,9999,0
1653515401014,CSE 293,011,094915,Heninger; Nadia A,9999,0,9999,0
1653515401014,CSE 293,012,094916,Impagliazzo; Russell,9999,0,9999,0
1653515401014,CSE 293,013,094917,Jhala; Ranjit,9999,0,9999,0
1653515401014,CSE 293,014,094918,Kahng; Andrew Byun,9999,0,9999,0
1653515401014,CSE 293,015,094919,Kane; Daniel Mertz,9999,0,9999,0
1653515401014,CSE 293,016,094920,Kriegman; David J,9999,0,9999,0
1653515401014,CSE 293,017,094921,Kumar; Arun Kumar,9999,0,9999,0
1653515401014,CSE 293,018,094922,Lerner; Sorin,9999,0,9999,0
1653515401014,CSE 293,019,094923,Lovett; Shachar,9999,0,9999,0
1653515401014,CSE 293,020,094924,McAuley; Julian John,9999,0,9999,0
1653515401014,CSE 293,021,094925,Micciancio; Daniele,9999,0,9999,0
1653515401014,CSE 293,022,094926,Orailoglu; Alex,9999,0,9999,0
1653515401014,CSE 293,023,094927,Paturi; Ramamohan,9999,0,9999,0
1653515401014,CSE 293,024,094928,Polikarpova; Nadezhda,9999,0,9999,0
1653515401014,CSE 293,025,094929,Politz; Joseph Gibbs,9999,0,9999,0
1653515401014,CSE 293,026,094930,Porter; George M,9999,0,9999,0
1653515401014,CSE 293,027,094931,Porter; Leonard Emerson,9999,0,9999,0
1653515401014,CSE 293,028,094932,Ramamoorthi; Ravi,9999,0,9999,0
1653515401014,CSE 293,029,094933,Sahoo; Debashis,9999,0,9999,0
1653515401014,CSE 293,030,094934,Saul; Lawrence,9999,0,9999,0
1653515401014,CSE 293,031,094935,Savage; Stefan,9999,0,9999,0
1653515401014,CSE 293,032,094936,Schulze; Jurgen P.,9999,0,9999,0
1653515401014,CSE 293,033,094937,Snoeren; Alex C.,9999,0,9999,0
1653515401014,CSE 293,034,094938,Shang; Jingbo,9999,0,9999,0
1653515401014,CSE 293,035,094939,Stefan; Deian,9999,0,9999,0
1653515401014,CSE 293,036,094940,Su; Hao,9999,0,9999,0
1653515401014,CSE 293,037,094941,Swanson; Steven James,9999,0,9999,0
1653515401014,CSE 293,038,094942,Tullsen; Dean Michael,9999,0,9999,0
1653515401014,CSE 293,039,094943,Voelker; Geoffrey M.,9999,0,9999,0
1653515401014,CSE 293,040,094944,Zhao; Jishen,9999,0,9999,0
1653515401014,CSE 293,041,094945,Zhou; Yuan-Yuan,9999,0,9999,0
1653515401014,CSE 293,042,094946,Gao; Sicun,9998,0,9999,1
1653515401014,CSE 293,043,094947,Weibel; Nadir,9999,0,9999,0
1653515401014,CSE 293,044,094948,Gupta; Rajesh K.,9999,0,9999,0
1653515401548,CSE 294,A00,090143,Porter; George M,8,0,10,2
1653515402082,DSE 200,A00,091799,Staff,50,0,50,0
1653515402608,DSE 203,A00,091800,Gupta; Amarnath,30,0,30,0
1653515403136,DSE 250,A00,091801,Deutsch; Alin Bernard,30,0,30,0
1653515403664,DSE 290,A00,091802,Altintas De Callaf; Ilkay,50,0,50,0
1653515404192,ECE 200,001,091003,Antipa; Nicholas A,9999,0,9999,0
1653515404192,ECE 200,002,091004,Atanasov; Nikolay A.,9999,0,9999,0
1653515404192,ECE 200,003,091005,Bharadia; Dinesh,9999,0,9999,0
1653515404192,ECE 200,004,091006,Cheng; Chung Kuan,9999,0,9999,0
1653515404192,ECE 200,005,091007,Cosman; Pamela C.,9999,0,9999,0
1653515404192,ECE 200,006,091008,Staff,9999,0,9999,0
1653515404192,ECE 200,007,091009,Dayeh; Shadi Ahmad,9999,0,9999,0
1653515404192,ECE 200,008,091010,Fainman; Yeshaiahu,9999,0,9999,0
1653515404192,ECE 200,009,091011,Ford; Joseph Earl,9999,0,9999,0
1653515404192,ECE 200,010,091012,Franceschetti; Massimo,9999,0,9999,0
1653515404192,ECE 200,011,091013,Fullerton; Eric E,9999,0,9999,0
1653515404192,ECE 200,012,091014,Galton; Ian A,9999,0,9999,0
1653515404192,ECE 200,013,091015,Gilja; Vikash,9999,0,9999,0
1653515404192,ECE 200,014,091016,Hall; Drew A.,9999,0,9999,0
1653515404192,ECE 200,015,091017,Hsueh; Tzu-Chien,9999,0,9999,0
1653515404192,ECE 200,016,091018,Javidi; Tara,9999,0,9999,0
1653515404192,ECE 200,017,091019,Kahng; Andrew Byun,9999,0,9999,0
1653515404192,ECE 200,018,091020,Kim; Young-Han,9999,0,9999,0
1653515404192,ECE 200,019,091021,Koushanfar; Farinaz,9999,0,9999,0
1653515404192,ECE 200,020,091022,Kuzum; Duygu,9999,0,9999,0
1653515404192,ECE 200,021,091023,Le; Hanh-Phuc,9999,0,9999,0
1653515404192,ECE 200,022,091024,Lin; Bill,9999,0,9999,0
1653515404192,ECE 200,023,091025,Liu; Zhaowei,9999,0,9999,0
1653515404192,ECE 200,024,091026,Lo; Yu-Hwa,9999,0,9999,0
1653515404192,ECE 200,025,091027,Lomakin; Vitaliy,9999,0,9999,0
1653515404192,ECE 200,026,091028,Mercier; Patrick Philip,9999,0,9999,0
1653515404192,ECE 200,027,091029,Meyer; Florian,9999,0,9999,0
1653515404192,ECE 200,028,091030,Milstein; Laurence B.,9999,0,9999,0
1653515404192,ECE 200,029,091031,Mir Arabbaygi; Siavash,9999,0,9999,0
1653515404192,ECE 200,030,091032,Mookherjea; Shayan,9999,0,9999,0
1653515404192,ECE 200,031,091033,Morris; Karcher William,9999,0,9999,0
1653515404192,ECE 200,032,091034,Ng; Tse Nga,9999,0,9999,0
1653515404192,ECE 200,033,091035,Nguyen; Truong Quang,9999,0,9999,0
1653515404192,ECE 200,034,091036,Nomura; Kenji,9999,0,9999,0
1653515404192,ECE 200,035,091037,Orlitsky; Alon,9999,0,9999,0
1653515404192,ECE 200,036,091038,Pal; Piya,9999,0,9999,0
1653515404192,ECE 200,037,091039,Papen; George C.,9999,0,9999,0
1653515404192,ECE 200,038,091040,Radic; Stojan,9999,0,9999,0
1653515404192,ECE 200,039,091041,Rao; Bhaskar D.,9999,0,9999,0
1653515404192,ECE 200,040,091042,Rao; Ramesh R,9999,0,9999,0
1653515404192,ECE 200,041,091043,Rebeiz; Gabriel,9999,0,9999,0
1653515404192,ECE 200,042,091044,Sanford; John R,9999,0,9999,0
1653515404192,ECE 200,043,091045,Siegel; Paul H.,9999,0,9999,0
1653515404192,ECE 200,044,091046,Sievenpiper; Daniel F.,9999,0,9999,0
1653515404192,ECE 200,045,091047,Sworder; David D.,9999,0,9999,0
1653515404192,ECE 200,046,091048,Taur; Yuan,9999,0,9999,0
1653515404192,ECE 200,047,091049,Touri; Behrouz,9999,0,9999,0
1653515404192,ECE 200,048,091050,Trivedi; Mohan M.,9999,0,9999,0
1653515404192,ECE 200,049,091051,Vardy; Alexander,9999,0,9999,0
1653515404192,ECE 200,050,091052,Vasconcelos; Nuno,9999,0,9999,0
1653515404192,ECE 200,051,091053,Wang; Xiaolong,9999,0,9999,0
1653515404192,ECE 200,052,091054,Xie; Pengtao,9999,0,9999,0
1653515404192,ECE 200,053,091055,Yip; Michael,9999,0,9999,0
1653515404192,ECE 200,054,091056,Zeger; Kenneth A.,9999,0,9999,0
1653515404192,ECE 200,055,091057,Zhang; Xinyu,9999,0,9999,0
1653515404192,ECE 200,056,091058,Turakhia; Yatish Girish,9999,0,9999,0
1653515404192,ECE 200,057,091059,Kang; Mingu,9999,0,9999,0
1653515404192,ECE 200,058,091060,Shi; Yuanyuan,9999,0,9999,0
1653515404192,ECE 200,059,091061,Wang; Edward Jay,9999,0,9999,0
1653515404192,ECE 200,060,091062,Zheng; Yang,9999,0,9999,0
1653515404717,ECE 201,A00,095526,Lo; Yu-Hwa,0,0,0,0
1653515405245,ECE 203,A00,091065,Mercier; Patrick Philip,0,0,0,0
1653515405768,ECE 207A,A00,091605,Liu; Thomas Tao-Ming,0,0,0,0
1653515406290,ECE 212AN,A00,091068,Nomura; Kenji,0,0,0,0
1653515406830,ECE 222A,A00,091069,Rebeiz; Gabriel,0,0,0,0
1653515407361,ECE 225A,A00,091070,Orlitsky; Alon,0,0,0,0
1653515407897,ECE 230A,A00,091071,Nomura; Kenji,0,0,0,0
1653515408420,ECE 236A,A00,091072,Dayeh; Shadi Ahmad,0,0,0,0
1653515408944,ECE 238A,A00,091073,Luo; Jian,0,0,0,0
1653515408944,ECE 238A,B00,091074,Luo; Jian,0,0,0,0
1653515409467,ECE 240A,A00,091075,Radic; Stojan,0,0,0,0
1653515410079,ECE 247A,A00,091592,Shi; Lingyan,0,0,0,0
1653515410619,ECE 250,A00,091076,Touri; Behrouz,0,0,0,0
1653515411144,ECE 251C,A00,091078,Nguyen; Truong Quang,0,0,0,0
1653515411669,ECE 253,A00,091079,Cosman; Pamela C.,0,0,0,0
1653515412191,ECE 255A,A00,091080,Orlitsky; Alon,0,0,0,0
1653515412722,ECE 257A,A00,091081,Zhang; Xinyu,0,0,0,0
1653515413253,ECE 260A,A01,091084,Eldon; John,0,0,0,0
1653515413777,ECE 264C,A00,091085,Galton; Ian A,0,0,0,0
1653515414318,ECE 265C,A00,094889,Presti; Calogero Davide,0,0,0,9
1653515414841,ECE 266,A01,091087,Hall; Drew A.,0,0,0,0
1653515415893,ECE 271A,A00,091090,Vasconcelos; Nuno,0,0,0,0
1653515416416,ECE 272B,A00,091091,Sworder; David D.,0,0,0,0
1653515416939,ECE 275A,A00,091092,Meyer; Florian,0,0,0,0
1653515417469,ECE 277,A00,091093,An; Cheolhong,0,0,0,0
1653515418004,ECE 283,A00,091094,Le; Hanh-Phuc,0,0,0,0
1653515418539,ECE 284,A00,091095,Kang; Mingu,0,0,0,0
1653515418539,ECE 284,B00,091096,Wang; Edward Jay,0,0,0,0
1653515419064,ECE 285,A00,094334,Touri; Behrouz,0,0,0,0
1653515419588,ECE 289,A00,091097,Whelan; David Arthur,0,0,0,0
1653515420111,MATH 200A,A00,087414,Salehi Golsefidy; Alireza,7,0,8,1
1653515420638,MATH 202A,A00,087415,Gill; Philip E.,3,0,8,5
1653515421161,MATH 203A,A00,087416,Oprea; Dragos N.,6,0,8,2
1653515421687,MATH 204A,A00,087417,Kedlaya; Kiran S.,6,0,8,2
1653515422210,MATH 205,A00,087418,Sorensen; Claus M,6,0,8,2
1653515422733,MATH 206A,A00,087419,Izadi; Elham,7,0,8,1
1653515423258,MATH 207A,A00,087420,Mohammadi; Amir,5,0,8,3
1653515423784,MATH 208,A00,087421,Staff,9,0,10,1
1653515424305,MATH 209,A00,087422,Staff,10,0,10,0
1653515424850,MATH 218,A00,087423,Staff,10,0,10,0
1653515425372,MATH 220A,A00,087424,Novak; Jonathan I,7,0,8,1
1653515425913,MATH 231A,A00,087425,Bejenaru; Ioan,3,0,8,5
1653515426436,MATH 240A,A00,087426,Ebenfelt; Peter F,5,0,8,3
1653515426963,MATH 243,A00,087427,Staff,9,0,10,1
1653515427496,MATH 248,A00,087429,Staff,10,0,10,0
1653515428020,MATH 250A,A00,087430,Spolaor; Luca,4,0,8,4
1653515428557,MATH 257A,A00,087431,Spolaor; Luca,7,0,8,1
1653515429083,MATH 258,A00,087432,Staff,9,0,10,1
1653515429618,MATH 264A,A00,087433,Warnke; Lutz Peter,5,0,8,3
1653515430142,MATH 268,A00,087434,Staff,15,0,15,0
1653515430665,MATH 269,A00,087435,Staff,14,0,15,1
1653515431190,MATH 270A,A00,087436,Nie; Jiawang,0,0,8,8
1653515431715,MATH 272A,A00,087437,Tian; Xiaochuan,1,0,8,7
1653515432244,MATH 274,A01,087439,Cheng; Li-Tien,9,0,10,1
1653515432244,MATH 274,A02,087440,Cheng; Li-Tien,10,0,10,0
1653515432780,MATH 278A,A00,087441,Staff,8,0,10,2
1653515433309,MATH 278B,A00,087442,Staff,8,0,10,2
1653515433849,MATH 278C,A00,087443,Staff,8,0,10,2
1653515434373,MATH 280A,A00,087444,Zheng; Tianyi,0,0,8,8
1653515434903,MATH 281A,A00,087445,Bradic; Jelena,0,0,8,8
1653515435425,MATH 282A,A00,087446,Zhang; Danna,0,0,8,8
1653515435952,MATH 283,A00,087447,Tesler; Glenn,0,0,0,15
1653515436487,MATH 286,A00,087448,Kemp; Todd Aahron,5,0,8,3
1653515437015,MATH 287D,A00,087449,Bradic; Jelena,8,0,8,0
1653515437542,MATH 288,A00,087450,Staff,14,0,15,1
1653515437542,MATH 288,B00,087451,Staff,15,0,15,0
1653515437542,MATH 288,C00,087452,Staff,15,0,15,0
1653515438069,MATH 290A,A00,087453,Xu; Zhouli,6,0,8,2
1653515438592,MATH 291A,A00,087454,Xu; Zhouli,7,0,8,1
1653515439122,MATH 292,A00,087455,Staff,10,0,10,0
1653515439647,MATH 295,A00,087456,Staff,50,0,50,0
1653515440175,MATH 297,001,087457,Staff,998,0,999,1
1653516001877,COGS 200,A01,087991,Staff,47,0,50,3
1653516002402,COGS 201,A01,094504,Rangel; Lara M,17,0,25,8
1653516002927,COGS 203,A00,087992,Coulson; Seana M,18,0,20,2
1653516003468,COGS 210A,001,087993,Greene; Deanna Jacquelyn,9998,0,9999,1
1653516003468,COGS 210A,002,087994,Saygin; Ayse P,9999,0,9999,0
1653516003468,COGS 210A,003,087995,Xia; Haijun,9999,0,9999,0
1653516003468,COGS 210A,004,087996,Nitz; Douglas A.,9999,0,9999,0
1653516003468,COGS 210A,005,087997,Hollan; James D.,9999,0,9999,0
1653516003468,COGS 210A,006,087998,Deak; Gedeon O.,9998,0,9999,1
1653516003468,COGS 210A,007,087999,Rossano; Federico,9999,0,9999,0
1653516003990,COGS 211A,A00,088000,Coulson; Seana M,9997,0,9999,2
1653516004513,COGS 229,A00,088002,Staff,23,0,25,2
1653516005037,COGS 260,B00,094231,Staff,17,0,20,3
1653516005037,COGS 260,A00,088004,Nitz; Douglas A.,9998,0,9999,1
1653516005559,CSE 202,A00,090110,Paturi; Ramamohan,0,0,0,0
1653516005559,CSE 202,B00,090111,Paturi; Ramamohan,0,0,0,0
1653516006097,CSE 207B,A00,090112,Heninger; Nadia A,0,0,0,0
1653516006620,CSE 208,A00,094858,Micciancio; Daniele,0,0,0,0
1653516007149,CSE 210,A00,090113,Powell; Thomas Allan,0,0,0,0
1653516007693,CSE 219,A00,090898,Staff,0,0,0,0
1653516008226,CSE 221,A00,090114,Zhou; Yuan-Yuan,0,0,0,0
1653516008749,CSE 229A,A00,090115,Porter; George M,0,0,0,0
1653516009274,CSE 229C,A00,090116,Savage; Stefan,0,0,0,0
1653516009819,CSE 230,A00,090117,Jhala; Ranjit,0,0,0,0
1653516010355,CSE 232,A00,090118,Papakonstantinou; Yannis,0,0,0,0
1653516010877,CSE 239A,A00,090121,Kumar; Arun Kumar,0,0,0,0
1653516011411,CSE 239B,A00,090122,Jhala; Ranjit,0,0,0,0
1653516011933,CSE 240A,A00,090123,Zhao; Jishen,0,0,189,189
1653516012463,CSE 243A,A00,090124,Orailoglu; Alex,0,0,15,15
1653516012989,CSE 249B,A00,090125,Kahng; Andrew Byun,13,0,20,7
1653516013517,CSE 250A,A00,090126,Berg-Kirkpatrick; Taylor D,0,0,0,0
1653516014056,CSE 252A,A00,090127,Ochoa; Benjamin Lawrence,0,0,0,0
1653516014583,CSE 258,A01,090129,McAuley; Julian John,0,0,0,0
1653516015121,CSE 258R,A01,090131,McAuley; Julian John,0,0,0,0
1653516015648,CSE 274,A00,090132,Ramamoorthi; Ravi,0,0,0,0
1653516016181,CSE 276A,A00,090133,Christensen; Henrik I,0,0,0,0
1653516016724,CSE 276C,A00,090134,Christensen; Henrik I,0,0,0,0
1653516017251,CSE 290,A00,090135,Bafna; Vineet,0,0,0,0
1653516017251,CSE 290,B00,090136,Ramamoorthi; Ravi,0,0,0,0
1653516017251,CSE 290,C00,090137,Li; Tzumao,8,0,10,2
1653516017251,CSE 290,D00,090138,Zhou; Yuan-Yuan,9,0,10,1
1653516017251,CSE 290,E00,090139,Christensen; Henrik I,9,0,10,1
1653516017251,CSE 290,F00,094053,Shalev; Aaron D,0,0,0,0
1653516017787,CSE 291,A00,090140,Munyaka; Imani N. S.,0,0,0,0
1653516017787,CSE 291,B00,094880,Yu; Qi,0,0,0,0
1653516017787,CSE 291,C00,090142,Pannuto; Patrick William,0,0,0,0
1653516017787,CSE 291,D00,094881,Zhang; Yiying,0,0,0,0
1653516017787,CSE 291,E00,095118,Su; Hao,0,0,0,0
1653516018343,CSE 293,001,094905,Bafna; Vineet,9999,0,9999,0
1653516018343,CSE 293,002,094906,Bellare; Mihir,9999,0,9999,0
1653516018343,CSE 293,003,094907,Berg-Kirkpatrick; Taylor D,9999,0,9999,0
1653516018343,CSE 293,004,094908,Christensen; Henrik I,9999,0,9999,0
1653516018343,CSE 293,005,094909,Cottrell; Garrison W,9999,0,9999,0
1653516018343,CSE 293,006,094910,Deutsch; Alin Bernard,9999,0,9999,0
1653516018343,CSE 293,007,094911,Esmaeilzadeh; Hadi,9999,0,9999,0
1653516018343,CSE 293,008,094912,Freund; Yoav,9999,0,9999,0
1653516018343,CSE 293,009,094913,Griswold; William G.,9999,0,9999,0
1653516018343,CSE 293,010,094914,Gymrek; Melissa Ann,9999,0,9999,0
1653516018343,CSE 293,011,094915,Heninger; Nadia A,9999,0,9999,0
1653516018343,CSE 293,012,094916,Impagliazzo; Russell,9999,0,9999,0
1653516018343,CSE 293,013,094917,Jhala; Ranjit,9999,0,9999,0
1653516018343,CSE 293,014,094918,Kahng; Andrew Byun,9999,0,9999,0
1653516018343,CSE 293,015,094919,Kane; Daniel Mertz,9999,0,9999,0
1653516018343,CSE 293,016,094920,Kriegman; David J,9999,0,9999,0
1653516018343,CSE 293,017,094921,Kumar; Arun Kumar,9999,0,9999,0
1653516018343,CSE 293,018,094922,Lerner; Sorin,9999,0,9999,0
1653516018343,CSE 293,019,094923,Lovett; Shachar,9999,0,9999,0
1653516018343,CSE 293,020,094924,McAuley; Julian John,9999,0,9999,0
1653516018343,CSE 293,021,094925,Micciancio; Daniele,9999,0,9999,0
1653516018343,CSE 293,022,094926,Orailoglu; Alex,9999,0,9999,0
1653516018343,CSE 293,023,094927,Paturi; Ramamohan,9999,0,9999,0
1653516018343,CSE 293,024,094928,Polikarpova; Nadezhda,9999,0,9999,0
1653516018343,CSE 293,025,094929,Politz; Joseph Gibbs,9999,0,9999,0
1653516018343,CSE 293,026,094930,Porter; George M,9999,0,9999,0
1653516018343,CSE 293,027,094931,Porter; Leonard Emerson,9999,0,9999,0
1653516018343,CSE 293,028,094932,Ramamoorthi; Ravi,9999,0,9999,0
1653516018343,CSE 293,029,094933,Sahoo; Debashis,9999,0,9999,0
1653516018343,CSE 293,030,094934,Saul; Lawrence,9999,0,9999,0
1653516018343,CSE 293,031,094935,Savage; Stefan,9999,0,9999,0
1653516018343,CSE 293,032,094936,Schulze; Jurgen P.,9999,0,9999,0
1653516018343,CSE 293,033,094937,Snoeren; Alex C.,9999,0,9999,0
1653516018343,CSE 293,034,094938,Shang; Jingbo,9999,0,9999,0
1653516018343,CSE 293,035,094939,Stefan; Deian,9999,0,9999,0
1653516018343,CSE 293,036,094940,Su; Hao,9999,0,9999,0
1653516018343,CSE 293,037,094941,Swanson; Steven James,9999,0,9999,0
1653516018343,CSE 293,038,094942,Tullsen; Dean Michael,9999,0,9999,0
1653516018343,CSE 293,039,094943,Voelker; Geoffrey M.,9999,0,9999,0
1653516018343,CSE 293,040,094944,Zhao; Jishen,9999,0,9999,0
1653516018343,CSE 293,041,094945,Zhou; Yuan-Yuan,9999,0,9999,0
1653516018343,CSE 293,042,094946,Gao; Sicun,9998,0,9999,1
1653516018343,CSE 293,043,094947,Weibel; Nadir,9999,0,9999,0
1653516018343,CSE 293,044,094948,Gupta; Rajesh K.,9999,0,9999,0
1653516018867,CSE 294,A00,090143,Porter; George M,8,0,10,2
1653516019390,DSE 200,A00,091799,Staff,50,0,50,0
1653516019915,DSE 203,A00,091800,Gupta; Amarnath,30,0,30,0
1653516020437,DSE 250,A00,091801,Deutsch; Alin Bernard,30,0,30,0
1653516020959,DSE 290,A00,091802,Altintas De Callaf; Ilkay,50,0,50,0
1653516021543,ECE 200,001,091003,Antipa; Nicholas A,9999,0,9999,0
1653516021543,ECE 200,002,091004,Atanasov; Nikolay A.,9999,0,9999,0
1653516021543,ECE 200,003,091005,Bharadia; Dinesh,9999,0,9999,0
1653516021543,ECE 200,004,091006,Cheng; Chung Kuan,9999,0,9999,0
1653516021543,ECE 200,005,091007,Cosman; Pamela C.,9999,0,9999,0
1653516021543,ECE 200,006,091008,Staff,9999,0,9999,0
1653516021543,ECE 200,007,091009,Dayeh; Shadi Ahmad,9999,0,9999,0
1653516021543,ECE 200,008,091010,Fainman; Yeshaiahu,9999,0,9999,0
1653516021543,ECE 200,009,091011,Ford; Joseph Earl,9999,0,9999,0
1653516021543,ECE 200,010,091012,Franceschetti; Massimo,9999,0,9999,0
1653516021543,ECE 200,011,091013,Fullerton; Eric E,9999,0,9999,0
1653516021543,ECE 200,012,091014,Galton; Ian A,9999,0,9999,0
1653516021543,ECE 200,013,091015,Gilja; Vikash,9999,0,9999,0
1653516021543,ECE 200,014,091016,Hall; Drew A.,9999,0,9999,0
1653516021543,ECE 200,015,091017,Hsueh; Tzu-Chien,9999,0,9999,0
1653516021543,ECE 200,016,091018,Javidi; Tara,9999,0,9999,0
1653516021543,ECE 200,017,091019,Kahng; Andrew Byun,9999,0,9999,0
1653516021543,ECE 200,018,091020,Kim; Young-Han,9999,0,9999,0
1653516021543,ECE 200,019,091021,Koushanfar; Farinaz,9999,0,9999,0
1653516021543,ECE 200,020,091022,Kuzum; Duygu,9999,0,9999,0
1653516021543,ECE 200,021,091023,Le; Hanh-Phuc,9999,0,9999,0
1653516021543,ECE 200,022,091024,Lin; Bill,9999,0,9999,0
1653516021543,ECE 200,023,091025,Liu; Zhaowei,9999,0,9999,0
1653516021543,ECE 200,024,091026,Lo; Yu-Hwa,9999,0,9999,0
1653516021543,ECE 200,025,091027,Lomakin; Vitaliy,9999,0,9999,0
1653516021543,ECE 200,026,091028,Mercier; Patrick Philip,9999,0,9999,0
1653516021543,ECE 200,027,091029,Meyer; Florian,9999,0,9999,0
1653516021543,ECE 200,028,091030,Milstein; Laurence B.,9999,0,9999,0
1653516021543,ECE 200,029,091031,Mir Arabbaygi; Siavash,9999,0,9999,0
1653516021543,ECE 200,030,091032,Mookherjea; Shayan,9999,0,9999,0
1653516021543,ECE 200,031,091033,Morris; Karcher William,9999,0,9999,0
1653516021543,ECE 200,032,091034,Ng; Tse Nga,9999,0,9999,0
1653516021543,ECE 200,033,091035,Nguyen; Truong Quang,9999,0,9999,0
1653516021543,ECE 200,034,091036,Nomura; Kenji,9999,0,9999,0
1653516021543,ECE 200,035,091037,Orlitsky; Alon,9999,0,9999,0
1653516021543,ECE 200,036,091038,Pal; Piya,9999,0,9999,0
1653516021543,ECE 200,037,091039,Papen; George C.,9999,0,9999,0
1653516021543,ECE 200,038,091040,Radic; Stojan,9999,0,9999,0
1653516021543,ECE 200,039,091041,Rao; Bhaskar D.,9999,0,9999,0
1653516021543,ECE 200,040,091042,Rao; Ramesh R,9999,0,9999,0
1653516021543,ECE 200,041,091043,Rebeiz; Gabriel,9999,0,9999,0
1653516021543,ECE 200,042,091044,Sanford; John R,9999,0,9999,0
1653516021543,ECE 200,043,091045,Siegel; Paul H.,9999,0,9999,0
1653516021543,ECE 200,044,091046,Sievenpiper; Daniel F.,9999,0,9999,0
1653516021543,ECE 200,045,091047,Sworder; David D.,9999,0,9999,0
1653516021543,ECE 200,046,091048,Taur; Yuan,9999,0,9999,0
1653516021543,ECE 200,047,091049,Touri; Behrouz,9999,0,9999,0
1653516021543,ECE 200,048,091050,Trivedi; Mohan M.,9999,0,9999,0
1653516021543,ECE 200,049,091051,Vardy; Alexander,9999,0,9999,0
1653516021543,ECE 200,050,091052,Vasconcelos; Nuno,9999,0,9999,0
1653516021543,ECE 200,051,091053,Wang; Xiaolong,9999,0,9999,0
1653516021543,ECE 200,052,091054,Xie; Pengtao,9999,0,9999,0
1653516021543,ECE 200,053,091055,Yip; Michael,9999,0,9999,0
1653516021543,ECE 200,054,091056,Zeger; Kenneth A.,9999,0,9999,0
1653516021543,ECE 200,055,091057,Zhang; Xinyu,9999,0,9999,0
1653516021543,ECE 200,056,091058,Turakhia; Yatish Girish,9999,0,9999,0
1653516021543,ECE 200,057,091059,Kang; Mingu,9999,0,9999,0
1653516021543,ECE 200,058,091060,Shi; Yuanyuan,9999,0,9999,0
1653516021543,ECE 200,059,091061,Wang; Edward Jay,9999,0,9999,0
1653516021543,ECE 200,060,091062,Zheng; Yang,9999,0,9999,0
1653516022069,ECE 201,A00,095526,Lo; Yu-Hwa,0,0,0,0
1653516022592,ECE 203,A00,091065,Mercier; Patrick Philip,0,0,0,0
1653516023114,ECE 207A,A00,091605,Liu; Thomas Tao-Ming,0,0,0,0
1653516023636,ECE 212AN,A00,091068,Nomura; Kenji,0,0,0,0
1653516024158,ECE 222A,A00,091069,Rebeiz; Gabriel,0,0,0,0
1653516024680,ECE 225A,A00,091070,Orlitsky; Alon,0,0,0,0
1653516025213,ECE 230A,A00,091071,Nomura; Kenji,0,0,0,0
1653516025749,ECE 236A,A00,091072,Dayeh; Shadi Ahmad,0,0,0,0
1653516026276,ECE 238A,A00,091073,Luo; Jian,0,0,0,0
1653516026276,ECE 238A,B00,091074,Luo; Jian,0,0,0,0
1653516026810,ECE 240A,A00,091075,Radic; Stojan,0,0,0,0
1653516027333,ECE 247A,A00,091592,Shi; Lingyan,0,0,0,0
1653516027859,ECE 250,A00,091076,Touri; Behrouz,0,0,0,0
1653516028396,ECE 251C,A00,091078,Nguyen; Truong Quang,0,0,0,0
1653516028931,ECE 253,A00,091079,Cosman; Pamela C.,0,0,0,0
1653516029461,ECE 255A,A00,091080,Orlitsky; Alon,0,0,0,0
1653516029994,ECE 257A,A00,091081,Zhang; Xinyu,0,0,0,0
1653516030524,ECE 260A,A01,091084,Eldon; John,0,0,0,0
1653516031055,ECE 264C,A00,091085,Galton; Ian A,0,0,0,0
1653516031576,ECE 265C,A00,094889,Presti; Calogero Davide,0,0,0,9
1653516032100,ECE 266,A01,091087,Hall; Drew A.,0,0,0,0
1653516033154,ECE 271A,A00,091090,Vasconcelos; Nuno,0,0,0,0
1653516033691,ECE 272B,A00,091091,Sworder; David D.,0,0,0,0
1653516034227,ECE 275A,A00,091092,Meyer; Florian,0,0,0,0
1653516034760,ECE 277,A00,091093,An; Cheolhong,0,0,0,0
1653516035300,ECE 283,A00,091094,Le; Hanh-Phuc,0,0,0,0
1653516035831,ECE 284,A00,091095,Kang; Mingu,0,0,0,0
1653516035831,ECE 284,B00,091096,Wang; Edward Jay,0,0,0,0
1653516036362,ECE 285,A00,094334,Touri; Behrouz,0,0,0,0
1653516036888,ECE 289,A00,091097,Whelan; David Arthur,0,0,0,0
1653516037414,MATH 200A,A00,087414,Salehi Golsefidy; Alireza,7,0,8,1
1653516037939,MATH 202A,A00,087415,Gill; Philip E.,3,0,8,5
1653516038476,MATH 203A,A00,087416,Oprea; Dragos N.,6,0,8,2
1653516039003,MATH 204A,A00,087417,Kedlaya; Kiran S.,6,0,8,2
1653516039530,MATH 205,A00,087418,Sorensen; Claus M,6,0,8,2
1653516040061,MATH 206A,A00,087419,Izadi; Elham,7,0,8,1
1653516040586,MATH 207A,A00,087420,Mohammadi; Amir,5,0,8,3
1653516041111,MATH 208,A00,087421,Staff,9,0,10,1
1653516041638,MATH 209,A00,087422,Staff,10,0,10,0
1653516042164,MATH 218,A00,087423,Staff,10,0,10,0
1653516042688,MATH 220A,A00,087424,Novak; Jonathan I,7,0,8,1
1653516043219,MATH 231A,A00,087425,Bejenaru; Ioan,3,0,8,5
1653516043747,MATH 240A,A00,087426,Ebenfelt; Peter F,5,0,8,3
1653516044269,MATH 243,A00,087427,Staff,9,0,10,1
1653516044795,MATH 248,A00,087429,Staff,10,0,10,0
1653516045320,MATH 250A,A00,087430,Spolaor; Luca,4,0,8,4
1653516045849,MATH 257A,A00,087431,Spolaor; Luca,7,0,8,1
1653516046380,MATH 258,A00,087432,Staff,9,0,10,1
1653516046906,MATH 264A,A00,087433,Warnke; Lutz Peter,5,0,8,3
1653516047427,MATH 268,A00,087434,Staff,15,0,15,0
1653516047958,MATH 269,A00,087435,Staff,14,0,15,1
1653516048489,MATH 270A,A00,087436,Nie; Jiawang,0,0,8,8
1653516049020,MATH 272A,A00,087437,Tian; Xiaochuan,1,0,8,7
1653516049558,MATH 274,A01,087439,Cheng; Li-Tien,9,0,10,1
1653516049558,MATH 274,A02,087440,Cheng; Li-Tien,10,0,10,0
1653516050081,MATH 278A,A00,087441,Staff,8,0,10,2
1653516050606,MATH 278B,A00,087442,Staff,8,0,10,2
1653516051138,MATH 278C,A00,087443,Staff,8,0,10,2
1653516051666,MATH 280A,A00,087444,Zheng; Tianyi,0,0,8,8
1653516052195,MATH 281A,A00,087445,Bradic; Jelena,0,0,8,8
1653516052812,MATH 282A,A00,087446,Zhang; Danna,0,0,8,8
1653516053340,MATH 283,A00,087447,Tesler; Glenn,0,0,0,15
1653516053863,MATH 286,A00,087448,Kemp; Todd Aahron,5,0,8,3
1653516054384,MATH 287D,A00,087449,Bradic; Jelena,8,0,8,0
1653516054911,MATH 288,A00,087450,Staff,14,0,15,1
1653516054911,MATH 288,B00,087451,Staff,15,0,15,0
1653516054911,MATH 288,C00,087452,Staff,15,0,15,0
1653516055433,MATH 290A,A00,087453,Xu; Zhouli,6,0,8,2
1653516055956,MATH 291A,A00,087454,Xu; Zhouli,7,0,8,1
1653516056478,MATH 292,A00,087455,Staff,10,0,10,0
1653516057007,MATH 295,A00,087456,Staff,50,0,50,0
1653516057534,MATH 297,001,087457,Staff,998,0,999,1
1653516619111,COGS 200,A01,087991,Staff,47,0,50,3
1653516619638,COGS 201,A01,094504,Rangel; Lara M,17,0,25,8
1653516620179,COGS 203,A00,087992,Coulson; Seana M,18,0,20,2
1653516620706,COGS 210A,001,087993,Greene; Deanna Jacquelyn,9998,0,9999,1
1653516620706,COGS 210A,002,087994,Saygin; Ayse P,9999,0,9999,0
1653516620706,COGS 210A,003,087995,Xia; Haijun,9999,0,9999,0
1653516620706,COGS 210A,004,087996,Nitz; Douglas A.,9999,0,9999,0
1653516620706,COGS 210A,005,087997,Hollan; James D.,9999,0,9999,0
1653516620706,COGS 210A,006,087998,Deak; Gedeon O.,9998,0,9999,1
1653516620706,COGS 210A,007,087999,Rossano; Federico,9999,0,9999,0
1653516621227,COGS 211A,A00,088000,Coulson; Seana M,9997,0,9999,2
1653516621750,COGS 229,A00,088002,Staff,23,0,25,2
1653516622276,COGS 260,B00,094231,Staff,17,0,20,3
1653516622276,COGS 260,A00,088004,Nitz; Douglas A.,9998,0,9999,1
1653516622801,CSE 202,A00,090110,Paturi; Ramamohan,0,0,0,0
1653516622801,CSE 202,B00,090111,Paturi; Ramamohan,0,0,0,0
1653516623325,CSE 207B,A00,090112,Heninger; Nadia A,0,0,0,0
1653516623847,CSE 208,A00,094858,Micciancio; Daniele,0,0,0,0
1653516624370,CSE 210,A00,090113,Powell; Thomas Allan,0,0,0,0
1653516624891,CSE 219,A00,090898,Staff,0,0,0,0
1653516625418,CSE 221,A00,090114,Zhou; Yuan-Yuan,0,0,0,0
1653516625941,CSE 229A,A00,090115,Porter; George M,0,0,0,0
1653516626482,CSE 229C,A00,090116,Savage; Stefan,0,0,0,0
1653516627009,CSE 230,A00,090117,Jhala; Ranjit,0,0,0,0
1653516627534,CSE 232,A00,090118,Papakonstantinou; Yannis,0,0,0,0
1653516628070,CSE 239A,A00,090121,Kumar; Arun Kumar,0,0,0,0
1653516628592,CSE 239B,A00,090122,Jhala; Ranjit,0,0,0,0
1653516629123,CSE 240A,A00,090123,Zhao; Jishen,0,0,189,189
1653516629661,CSE 243A,A00,090124,Orailoglu; Alex,0,0,15,15
1653516630188,CSE 249B,A00,090125,Kahng; Andrew Byun,13,0,20,7
1653516630710,CSE 250A,A00,090126,Berg-Kirkpatrick; Taylor D,0,0,0,0
1653516631236,CSE 252A,A00,090127,Ochoa; Benjamin Lawrence,0,0,0,0
1653516631765,CSE 258,A01,090129,McAuley; Julian John,0,0,0,0
1653516632287,CSE 258R,A01,090131,McAuley; Julian John,0,0,0,0
1653516632817,CSE 274,A00,090132,Ramamoorthi; Ravi,0,0,0,0
1653516633342,CSE 276A,A00,090133,Christensen; Henrik I,0,0,0,0
1653516633873,CSE 276C,A00,090134,Christensen; Henrik I,0,0,0,0
1653516634401,CSE 290,A00,090135,Bafna; Vineet,0,0,0,0
1653516634401,CSE 290,B00,090136,Ramamoorthi; Ravi,0,0,0,0
1653516634401,CSE 290,C00,090137,Li; Tzumao,8,0,10,2
1653516634401,CSE 290,D00,090138,Zhou; Yuan-Yuan,9,0,10,1
1653516634401,CSE 290,E00,090139,Christensen; Henrik I,9,0,10,1
1653516634401,CSE 290,F00,094053,Shalev; Aaron D,0,0,0,0
1653516634943,CSE 291,A00,090140,Munyaka; Imani N. S.,0,0,0,0
1653516634943,CSE 291,B00,094880,Yu; Qi,0,0,0,0
1653516634943,CSE 291,C00,090142,Pannuto; Patrick William,0,0,0,0
1653516634943,CSE 291,D00,094881,Zhang; Yiying,0,0,0,0
1653516634943,CSE 291,E00,095118,Su; Hao,0,0,0,0
1653516635510,CSE 293,001,094905,Bafna; Vineet,9999,0,9999,0
1653516635510,CSE 293,002,094906,Bellare; Mihir,9999,0,9999,0
1653516635510,CSE 293,003,094907,Berg-Kirkpatrick; Taylor D,9999,0,9999,0
1653516635510,CSE 293,004,094908,Christensen; Henrik I,9999,0,9999,0
1653516635510,CSE 293,005,094909,Cottrell; Garrison W,9999,0,9999,0
1653516635510,CSE 293,006,094910,Deutsch; Alin Bernard,9999,0,9999,0
1653516635510,CSE 293,007,094911,Esmaeilzadeh; Hadi,9999,0,9999,0
1653516635510,CSE 293,008,094912,Freund; Yoav,9999,0,9999,0
1653516635510,CSE 293,009,094913,Griswold; William G.,9999,0,9999,0
1653516635510,CSE 293,010,094914,Gymrek; Melissa Ann,9999,0,9999,0
1653516635510,CSE 293,011,094915,Heninger; Nadia A,9999,0,9999,0
1653516635510,CSE 293,012,094916,Impagliazzo; Russell,9999,0,9999,0
1653516635510,CSE 293,013,094917,Jhala; Ranjit,9999,0,9999,0
1653516635510,CSE 293,014,094918,Kahng; Andrew Byun,9999,0,9999,0
1653516635510,CSE 293,015,094919,Kane; Daniel Mertz,9999,0,9999,0
1653516635510,CSE 293,016,094920,Kriegman; David J,9999,0,9999,0
1653516635510,CSE 293,017,094921,Kumar; Arun Kumar,9999,0,9999,0
1653516635510,CSE 293,018,094922,Lerner; Sorin,9999,0,9999,0
1653516635510,CSE 293,019,094923,Lovett; Shachar,9999,0,9999,0
1653516635510,CSE 293,020,094924,McAuley; Julian John,9999,0,9999,0
1653516635510,CSE 293,021,094925,Micciancio; Daniele,9999,0,9999,0
1653516635510,CSE 293,022,094926,Orailoglu; Alex,9999,0,9999,0
1653516635510,CSE 293,023,094927,Paturi; Ramamohan,9999,0,9999,0
1653516635510,CSE 293,024,094928,Polikarpova; Nadezhda,9999,0,9999,0
1653516635510,CSE 293,025,094929,Politz; Joseph Gibbs,9999,0,9999,0
1653516635510,CSE 293,026,094930,Porter; George M,9999,0,9999,0
1653516635510,CSE 293,027,094931,Porter; Leonard Emerson,9999,0,9999,0
1653516635510,CSE 293,028,094932,Ramamoorthi; Ravi,9999,0,9999,0
1653516635510,CSE 293,029,094933,Sahoo; Debashis,9999,0,9999,0
1653516635510,CSE 293,030,094934,Saul; Lawrence,9999,0,9999,0
1653516635510,CSE 293,031,094935,Savage; Stefan,9999,0,9999,0
1653516635510,CSE 293,032,094936,Schulze; Jurgen P.,9999,0,9999,0
1653516635510,CSE 293,033,094937,Snoeren; Alex C.,9999,0,9999,0
1653516635510,CSE 293,034,094938,Shang; Jingbo,9999,0,9999,0
1653516635510,CSE 293,035,094939,Stefan; Deian,9999,0,9999,0
1653516635510,CSE 293,036,094940,Su; Hao,9999,0,9999,0
1653516635510,CSE 293,037,094941,Swanson; Steven James,9999,0,9999,0
1653516635510,CSE 293,038,094942,Tullsen; Dean Michael,9999,0,9999,0
1653516635510,CSE 293,039,094943,Voelker; Geoffrey M.,9999,0,9999,0
1653516635510,CSE 293,040,094944,Zhao; Jishen,9999,0,9999,0
1653516635510,CSE 293,041,094945,Zhou; Yuan-Yuan,9999,0,9999,0
1653516635510,CSE 293,042,094946,Gao; Sicun,9998,0,9999,1
1653516635510,CSE 293,043,094947,Weibel; Nadir,9999,0,9999,0
1653516635510,CSE 293,044,094948,Gupta; Rajesh K.,9999,0,9999,0
1653516636056,CSE 294,A00,090143,Porter; George M,8,0,10,2
1653516636578,DSE 200,A00,091799,Staff,50,0,50,0
1653516637100,DSE 203,A00,091800,Gupta; Amarnath,30,0,30,0
1653516637627,DSE 250,A00,091801,Deutsch; Alin Bernard,30,0,30,0
1653516638151,DSE 290,A00,091802,Altintas De Callaf; Ilkay,50,0,50,0
1653516638676,ECE 200,001,091003,Antipa; Nicholas A,9999,0,9999,0
1653516638676,ECE 200,002,091004,Atanasov; Nikolay A.,9999,0,9999,0
1653516638676,ECE 200,003,091005,Bharadia; Dinesh,9999,0,9999,0
1653516638676,ECE 200,004,091006,Cheng; Chung Kuan,9999,0,9999,0
1653516638676,ECE 200,005,091007,Cosman; Pamela C.,9999,0,9999,0
1653516638676,ECE 200,006,091008,Staff,9999,0,9999,0
1653516638676,ECE 200,007,091009,Dayeh; Shadi Ahmad,9999,0,9999,0
1653516638676,ECE 200,008,091010,Fainman; Yeshaiahu,9999,0,9999,0
1653516638676,ECE 200,009,091011,Ford; Joseph Earl,9999,0,9999,0
1653516638676,ECE 200,010,091012,Franceschetti; Massimo,9999,0,9999,0
1653516638676,ECE 200,011,091013,Fullerton; Eric E,9999,0,9999,0
1653516638676,ECE 200,012,091014,Galton; Ian A,9999,0,9999,0
1653516638676,ECE 200,013,091015,Gilja; Vikash,9999,0,9999,0
1653516638676,ECE 200,014,091016,Hall; Drew A.,9999,0,9999,0
1653516638676,ECE 200,015,091017,Hsueh; Tzu-Chien,9999,0,9999,0
1653516638676,ECE 200,016,091018,Javidi; Tara,9999,0,9999,0
1653516638676,ECE 200,017,091019,Kahng; Andrew Byun,9999,0,9999,0
1653516638676,ECE 200,018,091020,Kim; Young-Han,9999,0,9999,0
1653516638676,ECE 200,019,091021,Koushanfar; Farinaz,9999,0,9999,0
1653516638676,ECE 200,020,091022,Kuzum; Duygu,9999,0,9999,0
1653516638676,ECE 200,021,091023,Le; Hanh-Phuc,9999,0,9999,0
1653516638676,ECE 200,022,091024,Lin; Bill,9999,0,9999,0
1653516638676,ECE 200,023,091025,Liu; Zhaowei,9999,0,9999,0
1653516638676,ECE 200,024,091026,Lo; Yu-Hwa,9999,0,9999,0
1653516638676,ECE 200,025,091027,Lomakin; Vitaliy,9999,0,9999,0
1653516638676,ECE 200,026,091028,Mercier; Patrick Philip,9999,0,9999,0
1653516638676,ECE 200,027,091029,Meyer; Florian,9999,0,9999,0
1653516638676,ECE 200,028,091030,Milstein; Laurence B.,9999,0,9999,0
1653516638676,ECE 200,029,091031,Mir Arabbaygi; Siavash,9999,0,9999,0
1653516638676,ECE 200,030,091032,Mookherjea; Shayan,9999,0,9999,0
1653516638676,ECE 200,031,091033,Morris; Karcher William,9999,0,9999,0
1653516638676,ECE 200,032,091034,Ng; Tse Nga,9999,0,9999,0
1653516638676,ECE 200,033,091035,Nguyen; Truong Quang,9999,0,9999,0
1653516638676,ECE 200,034,091036,Nomura; Kenji,9999,0,9999,0
1653516638676,ECE 200,035,091037,Orlitsky; Alon,9999,0,9999,0
1653516638676,ECE 200,036,091038,Pal; Piya,9999,0,9999,0
1653516638676,ECE 200,037,091039,Papen; George C.,9999,0,9999,0
1653516638676,ECE 200,038,091040,Radic; Stojan,9999,0,9999,0
1653516638676,ECE 200,039,091041,Rao; Bhaskar D.,9999,0,9999,0
1653516638676,ECE 200,040,091042,Rao; Ramesh R,9999,0,9999,0
1653516638676,ECE 200,041,091043,Rebeiz; Gabriel,9999,0,9999,0
1653516638676,ECE 200,042,091044,Sanford; John R,9999,0,9999,0
1653516638676,ECE 200,043,091045,Siegel; Paul H.,9999,0,9999,0
1653516638676,ECE 200,044,091046,Sievenpiper; Daniel F.,9999,0,9999,0
1653516638676,ECE 200,045,091047,Sworder; David D.,9999,0,9999,0
1653516638676,ECE 200,046,091048,Taur; Yuan,9999,0,9999,0
1653516638676,ECE 200,047,091049,Touri; Behrouz,9999,0,9999,0
1653516638676,ECE 200,048,091050,Trivedi; Mohan M.,9999,0,9999,0
1653516638676,ECE 200,049,091051,Vardy; Alexander,9999,0,9999,0
1653516638676,ECE 200,050,091052,Vasconcelos; Nuno,9999,0,9999,0
1653516638676,ECE 200,051,091053,Wang; Xiaolong,9999,0,9999,0
1653516638676,ECE 200,052,091054,Xie; Pengtao,9999,0,9999,0
1653516638676,ECE 200,053,091055,Yip; Michael,9999,0,9999,0
1653516638676,ECE 200,054,091056,Zeger; Kenneth A.,9999,0,9999,0
1653516638676,ECE 200,055,091057,Zhang; Xinyu,9999,0,9999,0
1653516638676,ECE 200,056,091058,Turakhia; Yatish Girish,9999,0,9999,0
1653516638676,ECE 200,057,091059,Kang; Mingu,9999,0,9999,0
1653516638676,ECE 200,058,091060,Shi; Yuanyuan,9999,0,9999,0
1653516638676,ECE 200,059,091061,Wang; Edward Jay,9999,0,9999,0
1653516638676,ECE 200,060,091062,Zheng; Yang,9999,0,9999,0
1653516639203,ECE 201,A00,095526,Lo; Yu-Hwa,0,0,0,0
1653516639725,ECE 203,A00,091065,Mercier; Patrick Philip,0,0,0,0
1653516640256,ECE 207A,A00,091605,Liu; Thomas Tao-Ming,0,0,0,0
1653516640780,ECE 212AN,A00,091068,Nomura; Kenji,0,0,0,0
1653516641310,ECE 222A,A00,091069,Rebeiz; Gabriel,0,0,0,0
1653516641925,ECE 225A,A00,091070,Orlitsky; Alon,0,0,0,0
1653516642451,ECE 230A,A00,091071,Nomura; Kenji,0,0,0,0
1653516642976,ECE 236A,A00,091072,Dayeh; Shadi Ahmad,0,0,0,0
1653516643501,ECE 238A,A00,091073,Luo; Jian,0,0,0,0
1653516643501,ECE 238A,B00,091074,Luo; Jian,0,0,0,0
1653516644026,ECE 240A,A00,091075,Radic; Stojan,0,0,0,0
1653516644549,ECE 247A,A00,091592,Shi; Lingyan,0,0,0,0
1653516645072,ECE 250,A00,091076,Touri; Behrouz,0,0,0,0
1653516645595,ECE 251C,A00,091078,Nguyen; Truong Quang,0,0,0,0
1653516646121,ECE 253,A00,091079,Cosman; Pamela C.,0,0,0,0
1653516646647,ECE 255A,A00,091080,Orlitsky; Alon,0,0,0,0
1653516647185,ECE 257A,A00,091081,Zhang; Xinyu,0,0,0,0
1653516647709,ECE 260A,A01,091084,Eldon; John,0,0,0,0
1653516648235,ECE 264C,A00,091085,Galton; Ian A,0,0,0,0
1653516648761,ECE 265C,A00,094889,Presti; Calogero Davide,0,0,0,9
1653516649283,ECE 266,A01,091087,Hall; Drew A.,0,0,0,0
1653516650331,ECE 271A,A00,091090,Vasconcelos; Nuno,0,0,0,0
1653516650857,ECE 272B,A00,091091,Sworder; David D.,0,0,0,0
1653516651380,ECE 275A,A00,091092,Meyer; Florian,0,0,0,0
1653516651907,ECE 277,A00,091093,An; Cheolhong,0,0,0,0
1653516652436,ECE 283,A00,091094,Le; Hanh-Phuc,0,0,0,0
1653516652961,ECE 284,A00,091095,Kang; Mingu,0,0,0,0
1653516652961,ECE 284,B00,091096,Wang; Edward Jay,0,0,0,0
1653516653482,ECE 285,A00,094334,Touri; Behrouz,0,0,0,0
1653516654010,ECE 289,A00,091097,Whelan; David Arthur,0,0,0,0
1653516654546,MATH 200A,A00,087414,Salehi Golsefidy; Alireza,7,0,8,1
1653516655078,MATH 202A,A00,087415,Gill; Philip E.,3,0,8,5
1653516655603,MATH 203A,A00,087416,Oprea; Dragos N.,6,0,8,2
1653516656129,MATH 204A,A00,087417,Kedlaya; Kiran S.,6,0,8,2
1653516656662,MATH 205,A00,087418,Sorensen; Claus M,6,0,8,2
1653516657188,MATH 206A,A00,087419,Izadi; Elham,7,0,8,1
1653516657713,MATH 207A,A00,087420,Mohammadi; Amir,5,0,8,3
1653516658244,MATH 208,A00,087421,Staff,9,0,10,1
1653516658771,MATH 209,A00,087422,Staff,10,0,10,0
1653516659306,MATH 218,A00,087423,Staff,10,0,10,0
1653516659831,MATH 220A,A00,087424,Novak; Jonathan I,7,0,8,1
1653516660354,MATH 231A,A00,087425,Bejenaru; Ioan,3,0,8,5
1653516660878,MATH 240A,A00,087426,Ebenfelt; Peter F,5,0,8,3
1653516661406,MATH 243,A00,087427,Staff,9,0,10,1
1653516661949,MATH 248,A00,087429,Staff,10,0,10,0
1653516662474,MATH 250A,A00,087430,Spolaor; Luca,4,0,8,4
1653516663007,MATH 257A,A00,087431,Spolaor; Luca,7,0,8,1
1653516663529,MATH 258,A00,087432,Staff,9,0,10,1
1653516664052,MATH 264A,A00,087433,Warnke; Lutz Peter,5,0,8,3
1653516664574,MATH 268,A00,087434,Staff,15,0,15,0
1653516665104,MATH 269,A00,087435,Staff,14,0,15,1
1653516665628,MATH 270A,A00,087436,Nie; Jiawang,0,0,8,8
1653516666151,MATH 272A,A00,087437,Tian; Xiaochuan,1,0,8,7
1653516666673,MATH 274,A01,087439,Cheng; Li-Tien,9,0,10,1
1653516666673,MATH 274,A02,087440,Cheng; Li-Tien,10,0,10,0
1653516667195,MATH 278A,A00,087441,Staff,8,0,10,2
1653516667720,MATH 278B,A00,087442,Staff,8,0,10,2
1653516668257,MATH 278C,A00,087443,Staff,8,0,10,2
1653516668779,MATH 280A,A00,087444,Zheng; Tianyi,0,0,8,8
1653516669308,MATH 281A,A00,087445,Bradic; Jelena,0,0,8,8
1653516669832,MATH 282A,A00,087446,Zhang; Danna,0,0,8,8
1653516670363,MATH 283,A00,087447,Tesler; Glenn,0,0,0,15
1653516670887,MATH 286,A00,087448,Kemp; Todd Aahron,5,0,8,3
1653516671409,MATH 287D,A00,087449,Bradic; Jelena,8,0,8,0
1653516671934,MATH 288,A00,087450,Staff,14,0,15,1
1653516671934,MATH 288,B00,087451,Staff,15,0,15,0
1653516671934,MATH 288,C00,087452,Staff,15,0,15,0
1653516672456,MATH 290A,A00,087453,Xu; Zhouli,6,0,8,2
1653516672986,MATH 291A,A00,087454,Xu; Zhouli,7,0,8,1
1653516673507,MATH 292,A00,087455,Staff,10,0,10,0
1653516674030,MATH 295,A00,087456,Staff,50,0,50,0
1653516674561,MATH 297,001,087457,Staff,998,0,999,1
1653517246521,COGS 200,A01,087991,Staff,47,0,50,3
1653517247052,COGS 201,A01,094504,Rangel; Lara M,17,0,25,8
1653517247576,COGS 203,A00,087992,Coulson; Seana M,18,0,20,2
1653517248099,COGS 210A,001,087993,Greene; Deanna Jacquelyn,9998,0,9999,1
1653517248099,COGS 210A,002,087994,Saygin; Ayse P,9999,0,9999,0
1653517248099,COGS 210A,003,087995,Xia; Haijun,9999,0,9999,0
1653517248099,COGS 210A,004,087996,Nitz; Douglas A.,9999,0,9999,0
1653517248099,COGS 210A,005,087997,Hollan; James D.,9999,0,9999,0
1653517248099,COGS 210A,006,087998,Deak; Gedeon O.,9998,0,9999,1
1653517248099,COGS 210A,007,087999,Rossano; Federico,9999,0,9999,0
1653517248622,COGS 211A,A00,088000,Coulson; Seana M,9997,0,9999,2
1653517249144,COGS 229,A00,088002,Staff,23,0,25,2
1653517249671,COGS 260,B00,094231,Staff,17,0,20,3
1653517249671,COGS 260,A00,088004,Nitz; Douglas A.,9998,0,9999,1
1653517250199,CSE 202,A00,090110,Paturi; Ramamohan,0,0,0,0
1653517250199,CSE 202,B00,090111,Paturi; Ramamohan,0,0,0,0
1653517250721,CSE 207B,A00,090112,Heninger; Nadia A,0,0,0,0
1653517251250,CSE 208,A00,094858,Micciancio; Daniele,0,0,0,0
1653517251783,CSE 210,A00,090113,Powell; Thomas Allan,0,0,0,0
1653517252313,CSE 219,A00,090898,Staff,0,0,0,0
1653517252837,CSE 221,A00,090114,Zhou; Yuan-Yuan,0,0,0,0
1653517253376,CSE 229A,A00,090115,Porter; George M,0,0,0,0
1653517253902,CSE 229C,A00,090116,Savage; Stefan,0,0,0,0
1653517254424,CSE 230,A00,090117,Jhala; Ranjit,0,0,0,0
1653517254949,CSE 232,A00,090118,Papakonstantinou; Yannis,0,0,0,0
1653517255479,CSE 239A,A00,090121,Kumar; Arun Kumar,0,0,0,0
1653517256015,CSE 239B,A00,090122,Jhala; Ranjit,0,0,0,0
1653517256548,CSE 240A,A00,090123,Zhao; Jishen,0,0,189,189
1653517257074,CSE 243A,A00,090124,Orailoglu; Alex,0,0,15,15
1653517257604,CSE 249B,A00,090125,Kahng; Andrew Byun,13,0,20,7
1653517258137,CSE 250A,A00,090126,Berg-Kirkpatrick; Taylor D,0,0,0,0
1653517258664,CSE 252A,A00,090127,Ochoa; Benjamin Lawrence,0,0,0,0
1653517259189,CSE 258,A01,090129,McAuley; Julian John,0,0,0,0
1653517259718,CSE 258R,A01,090131,McAuley; Julian John,0,0,0,0
1653517260248,CSE 274,A00,090132,Ramamoorthi; Ravi,0,0,0,0
1653517260776,CSE 276A,A00,090133,Christensen; Henrik I,0,0,0,0
1653517261301,CSE 276C,A00,090134,Christensen; Henrik I,0,0,0,0
1653517261827,CSE 290,A00,090135,Bafna; Vineet,0,0,0,0
1653517261827,CSE 290,B00,090136,Ramamoorthi; Ravi,0,0,0,0
1653517261827,CSE 290,C00,090137,Li; Tzumao,8,0,10,2
1653517261827,CSE 290,D00,090138,Zhou; Yuan-Yuan,9,0,10,1
1653517261827,CSE 290,E00,090139,Christensen; Henrik I,9,0,10,1
1653517261827,CSE 290,F00,094053,Shalev; Aaron D,0,0,0,0
1653517262356,CSE 291,A00,090140,Munyaka; Imani N. S.,0,0,0,0
1653517262356,CSE 291,B00,094880,Yu; Qi,0,0,0,0
1653517262356,CSE 291,C00,090142,Pannuto; Patrick William,0,0,0,0
1653517262356,CSE 291,D00,094881,Zhang; Yiying,0,0,0,0
1653517262356,CSE 291,E00,095118,Su; Hao,0,0,0,0
1653517262882,CSE 293,001,094905,Bafna; Vineet,9999,0,9999,0
1653517262882,CSE 293,002,094906,Bellare; Mihir,9999,0,9999,0
1653517262882,CSE 293,003,094907,Berg-Kirkpatrick; Taylor D,9999,0,9999,0
1653517262882,CSE 293,004,094908,Christensen; Henrik I,9999,0,9999,0
1653517262882,CSE 293,005,094909,Cottrell; Garrison W,9999,0,9999,0
1653517262882,CSE 293,006,094910,Deutsch; Alin Bernard,9999,0,9999,0
1653517262882,CSE 293,007,094911,Esmaeilzadeh; Hadi,9999,0,9999,0
1653517262882,CSE 293,008,094912,Freund; Yoav,9999,0,9999,0
1653517262882,CSE 293,009,094913,Griswold; William G.,9999,0,9999,0
1653517262882,CSE 293,010,094914,Gymrek; Melissa Ann,9999,0,9999,0
1653517262882,CSE 293,011,094915,Heninger; Nadia A,9999,0,9999,0
1653517262882,CSE 293,012,094916,Impagliazzo; Russell,9999,0,9999,0
1653517262882,CSE 293,013,094917,Jhala; Ranjit,9999,0,9999,0
1653517262882,CSE 293,014,094918,Kahng; Andrew Byun,9999,0,9999,0
1653517262882,CSE 293,015,094919,Kane; Daniel Mertz,9999,0,9999,0
1653517262882,CSE 293,016,094920,Kriegman; David J,9999,0,9999,0
1653517262882,CSE 293,017,094921,Kumar; Arun Kumar,9999,0,9999,0
1653517262882,CSE 293,018,094922,Lerner; Sorin,9999,0,9999,0
1653517262882,CSE 293,019,094923,Lovett; Shachar,9999,0,9999,0
1653517262882,CSE 293,020,094924,McAuley; Julian John,9999,0,9999,0
1653517262882,CSE 293,021,094925,Micciancio; Daniele,9999,0,9999,0
1653517262882,CSE 293,022,094926,Orailoglu; Alex,9999,0,9999,0
1653517262882,CSE 293,023,094927,Paturi; Ramamohan,9999,0,9999,0
1653517262882,CSE 293,024,094928,Polikarpova; Nadezhda,9999,0,9999,0
1653517262882,CSE 293,025,094929,Politz; Joseph Gibbs,9999,0,9999,0
1653517262882,CSE 293,026,094930,Porter; George M,9999,0,9999,0
1653517262882,CSE 293,027,094931,Porter; Leonard Emerson,9999,0,9999,0
1653517262882,CSE 293,028,094932,Ramamoorthi; Ravi,9999,0,9999,0
1653517262882,CSE 293,029,094933,Sahoo; Debashis,9999,0,9999,0
1653517262882,CSE 293,030,094934,Saul; Lawrence,9999,0,9999,0
1653517262882,CSE 293,031,094935,Savage; Stefan,9999,0,9999,0
1653517262882,CSE 293,032,094936,Schulze; Jurgen P.,9999,0,9999,0
1653517262882,CSE 293,033,094937,Snoeren; Alex C.,9999,0,9999,0
1653517262882,CSE 293,034,094938,Shang; Jingbo,9999,0,9999,0
1653517262882,CSE 293,035,094939,Stefan; Deian,9999,0,9999,0
1653517262882,CSE 293,036,094940,Su; Hao,9999,0,9999,0
1653517262882,CSE 293,037,094941,Swanson; Steven James,9999,0,9999,0
1653517262882,CSE 293,038,094942,Tullsen; Dean Michael,9999,0,9999,0
1653517262882,CSE 293,039,094943,Voelker; Geoffrey M.,9999,0,9999,0
1653517262882,CSE 293,040,094944,Zhao; Jishen,9999,0,9999,0
1653517262882,CSE 293,041,094945,Zhou; Yuan-Yuan,9999,0,9999,0
1653517262882,CSE 293,042,094946,Gao; Sicun,9998,0,9999,1
1653517262882,CSE 293,043,094947,Weibel; Nadir,9999,0,9999,0
1653517262882,CSE 293,044,094948,Gupta; Rajesh K.,9999,0,9999,0
1653517263404,CSE 294,A00,090143,Porter; George M,8,0,10,2
1653517263935,DSE 200,A00,091799,Staff,50,0,50,0
1653517264466,DSE 203,A00,091800,Gupta; Amarnath,30,0,30,0
1653517264988,DSE 250,A00,091801,Deutsch; Alin Bernard,30,0,30,0
1653517265514,DSE 290,A00,091802,Altintas De Callaf; Ilkay,50,0,50,0
1653517266059,ECE 200,001,091003,Antipa; Nicholas A,9999,0,9999,0
1653517266059,ECE 200,002,091004,Atanasov; Nikolay A.,9999,0,9999,0
1653517266059,ECE 200,003,091005,Bharadia; Dinesh,9999,0,9999,0
1653517266059,ECE 200,004,091006,Cheng; Chung Kuan,9999,0,9999,0
1653517266059,ECE 200,005,091007,Cosman; Pamela C.,9999,0,9999,0
1653517266059,ECE 200,006,091008,Staff,9999,0,9999,0
1653517266059,ECE 200,007,091009,Dayeh; Shadi Ahmad,9999,0,9999,0
1653517266059,ECE 200,008,091010,Fainman; Yeshaiahu,9999,0,9999,0
1653517266059,ECE 200,009,091011,Ford; Joseph Earl,9999,0,9999,0
1653517266059,ECE 200,010,091012,Franceschetti; Massimo,9999,0,9999,0
1653517266059,ECE 200,011,091013,Fullerton; Eric E,9999,0,9999,0
1653517266059,ECE 200,012,091014,Galton; Ian A,9999,0,9999,0
1653517266059,ECE 200,013,091015,Gilja; Vikash,9999,0,9999,0
1653517266059,ECE 200,014,091016,Hall; Drew A.,9999,0,9999,0
1653517266059,ECE 200,015,091017,Hsueh; Tzu-Chien,9999,0,9999,0
1653517266059,ECE 200,016,091018,Javidi; Tara,9999,0,9999,0
1653517266059,ECE 200,017,091019,Kahng; Andrew Byun,9999,0,9999,0
1653517266059,ECE 200,018,091020,Kim; Young-Han,9999,0,9999,0
1653517266059,ECE 200,019,091021,Koushanfar; Farinaz,9999,0,9999,0
1653517266059,ECE 200,020,091022,Kuzum; Duygu,9999,0,9999,0
1653517266059,ECE 200,021,091023,Le; Hanh-Phuc,9999,0,9999,0
1653517266059,ECE 200,022,091024,Lin; Bill,9999,0,9999,0
1653517266059,ECE 200,023,091025,Liu; Zhaowei,9999,0,9999,0
1653517266059,ECE 200,024,091026,Lo; Yu-Hwa,9999,0,9999,0
1653517266059,ECE 200,025,091027,Lomakin; Vitaliy,9999,0,9999,0
1653517266059,ECE 200,026,091028,Mercier; Patrick Philip,9999,0,9999,0
1653517266059,ECE 200,027,091029,Meyer; Florian,9999,0,9999,0
1653517266059,ECE 200,028,091030,Milstein; Laurence B.,9999,0,9999,0
1653517266059,ECE 200,029,091031,Mir Arabbaygi; Siavash,9999,0,9999,0
1653517266059,ECE 200,030,091032,Mookherjea; Shayan,9999,0,9999,0
1653517266059,ECE 200,031,091033,Morris; Karcher William,9999,0,9999,0
1653517266059,ECE 200,032,091034,Ng; Tse Nga,9999,0,9999,0
1653517266059,ECE 200,033,091035,Nguyen; Truong Quang,9999,0,9999,0
1653517266059,ECE 200,034,091036,Nomura; Kenji,9999,0,9999,0
1653517266059,ECE 200,035,091037,Orlitsky; Alon,9999,0,9999,0
1653517266059,ECE 200,036,091038,Pal; Piya,9999,0,9999,0
1653517266059,ECE 200,037,091039,Papen; George C.,9999,0,9999,0
1653517266059,ECE 200,038,091040,Radic; Stojan,9999,0,9999,0
1653517266059,ECE 200,039,091041,Rao; Bhaskar D.,9999,0,9999,0
1653517266059,ECE 200,040,091042,Rao; Ramesh R,9999,0,9999,0
1653517266059,ECE 200,041,091043,Rebeiz; Gabriel,9999,0,9999,0
1653517266059,ECE 200,042,091044,Sanford; John R,9999,0,9999,0
1653517266059,ECE 200,043,091045,Siegel; Paul H.,9999,0,9999,0
1653517266059,ECE 200,044,091046,Sievenpiper; Daniel F.,9999,0,9999,0
1653517266059,ECE 200,045,091047,Sworder; David D.,9999,0,9999,0
1653517266059,ECE 200,046,091048,Taur; Yuan,9999,0,9999,0
1653517266059,ECE 200,047,091049,Touri; Behrouz,9999,0,9999,0
1653517266059,ECE 200,048,091050,Trivedi; Mohan M.,9999,0,9999,0
1653517266059,ECE 200,049,091051,Vardy; Alexander,9999,0,9999,0
1653517266059,ECE 200,050,091052,Vasconcelos; Nuno,9999,0,9999,0
1653517266059,ECE 200,051,091053,Wang; Xiaolong,9999,0,9999,0
1653517266059,ECE 200,052,091054,Xie; Pengtao,9999,0,9999,0
1653517266059,ECE 200,053,091055,Yip; Michael,9999,0,9999,0
1653517266059,ECE 200,054,091056,Zeger; Kenneth A.,9999,0,9999,0
1653517266059,ECE 200,055,091057,Zhang; Xinyu,9999,0,9999,0
1653517266059,ECE 200,056,091058,Turakhia; Yatish Girish,9999,0,9999,0
1653517266059,ECE 200,057,091059,Kang; Mingu,9999,0,9999,0
1653517266059,ECE 200,058,091060,Shi; Yuanyuan,9999,0,9999,0
1653517266059,ECE 200,059,091061,Wang; Edward Jay,9999,0,9999,0
1653517266059,ECE 200,060,091062,Zheng; Yang,9999,0,9999,0
1653517266585,ECE 201,A00,095526,Lo; Yu-Hwa,0,0,0,0
1653517267111,ECE 203,A00,091065,Mercier; Patrick Philip,0,0,0,0
1653517267636,ECE 207A,A00,091605,Liu; Thomas Tao-Ming,0,0,0,0
1653517268166,ECE 212AN,A00,091068,Nomura; Kenji,0,0,0,0
1653517268688,ECE 222A,A00,091069,Rebeiz; Gabriel,0,0,0,0
1653517269224,ECE 225A,A00,091070,Orlitsky; Alon,0,0,0,0
1653517269746,ECE 230A,A00,091071,Nomura; Kenji,0,0,0,0
1653517270282,ECE 236A,A00,091072,Dayeh; Shadi Ahmad,0,0,0,0
1653517270808,ECE 238A,A00,091073,Luo; Jian,0,0,0,0
1653517270808,ECE 238A,B00,091074,Luo; Jian,0,0,0,0
1653517271331,ECE 240A,A00,091075,Radic; Stojan,0,0,0,0
1653517271854,ECE 247A,A00,091592,Shi; Lingyan,0,0,0,0
1653517272385,ECE 250,A00,091076,Touri; Behrouz,0,0,0,0
1653517272908,ECE 251C,A00,091078,Nguyen; Truong Quang,0,0,0,0
1653517273449,ECE 253,A00,091079,Cosman; Pamela C.,0,0,0,0
1653517273977,ECE 255A,A00,091080,Orlitsky; Alon,0,0,0,0
1653517274499,ECE 257A,A00,091081,Zhang; Xinyu,0,0,0,0
1653517275022,ECE 260A,A01,091084,Eldon; John,0,0,0,0
1653517275546,ECE 264C,A00,091085,Galton; Ian A,0,0,0,0
1653517276072,ECE 265C,A00,094889,Presti; Calogero Davide,0,0,0,9
1653517276597,ECE 266,A01,091087,Hall; Drew A.,0,0,0,0
1653517277650,ECE 271A,A00,091090,Vasconcelos; Nuno,0,0,0,0
1653517278176,ECE 272B,A00,091091,Sworder; David D.,0,0,0,0
1653517278707,ECE 275A,A00,091092,Meyer; Florian,0,0,0,0
1653517279245,ECE 277,A00,091093,An; Cheolhong,0,0,0,0
1653517279769,ECE 283,A00,091094,Le; Hanh-Phuc,0,0,0,0
1653517280292,ECE 284,A00,091095,Kang; Mingu,0,0,0,0
1653517280292,ECE 284,B00,091096,Wang; Edward Jay,0,0,0,0
1653517280823,ECE 285,A00,094334,Touri; Behrouz,0,0,0,0
1653517281346,ECE 289,A00,091097,Whelan; David Arthur,0,0,0,0
1653517281868,MATH 200A,A00,087414,Salehi Golsefidy; Alireza,7,0,8,1
1653517282403,MATH 202A,A00,087415,Gill; Philip E.,3,0,8,5
1653517282929,MATH 203A,A00,087416,Oprea; Dragos N.,6,0,8,2
1653517283451,MATH 204A,A00,087417,Kedlaya; Kiran S.,6,0,8,2
1653517283974,MATH 205,A00,087418,Sorensen; Claus M,6,0,8,2
1653517284497,MATH 206A,A00,087419,Izadi; Elham,7,0,8,1
1653517285020,MATH 207A,A00,087420,Mohammadi; Amir,5,0,8,3
1653517285548,MATH 208,A00,087421,Staff,9,0,10,1
1653517286074,MATH 209,A00,087422,Staff,10,0,10,0
1653517286609,MATH 218,A00,087423,Staff,10,0,10,0
1653517287149,MATH 220A,A00,087424,Novak; Jonathan I,7,0,8,1
1653517287681,MATH 231A,A00,087425,Bejenaru; Ioan,3,0,8,5
1653517288211,MATH 240A,A00,087426,Ebenfelt; Peter F,5,0,8,3
1653517288736,MATH 243,A00,087427,Staff,9,0,10,1
1653517289260,MATH 248,A00,087429,Staff,10,0,10,0
1653517289788,MATH 250A,A00,087430,Spolaor; Luca,4,0,8,4
1653517290320,MATH 257A,A00,087431,Spolaor; Luca,7,0,8,1
1653517290859,MATH 258,A00,087432,Staff,9,0,10,1
1653517291384,MATH 264A,A00,087433,Warnke; Lutz Peter,5,0,8,3
1653517291910,MATH 268,A00,087434,Staff,15,0,15,0
1653517292435,MATH 269,A00,087435,Staff,14,0,15,1
1653517292960,MATH 270A,A00,087436,Nie; Jiawang,0,0,8,8
1653517293482,MATH 272A,A00,087437,Tian; Xiaochuan,1,0,8,7
1653517294009,MATH 274,A01,087439,Cheng; Li-Tien,9,0,10,1
1653517294009,MATH 274,A02,087440,Cheng; Li-Tien,10,0,10,0
1653517294619,MATH 278A,A00,087441,Staff,8,0,10,2
1653517295150,MATH 278B,A00,087442,Staff,8,0,10,2
1653517295673,MATH 278C,A00,087443,Staff,8,0,10,2
1653517296195,MATH 280A,A00,087444,Zheng; Tianyi,0,0,8,8
1653517296732,MATH 281A,A00,087445,Bradic; Jelena,0,0,8,8
1653517297264,MATH 282A,A00,087446,Zhang; Danna,0,0,8,8
1653517297790,MATH 283,A00,087447,Tesler; Glenn,0,0,0,15
1653517298316,MATH 286,A00,087448,Kemp; Todd Aahron,5,0,8,3
1653517298843,MATH 287D,A00,087449,Bradic; Jelena,8,0,8,0
1653517299369,MATH 288,A00,087450,Staff,14,0,15,1
1653517299369,MATH 288,B00,087451,Staff,15,0,15,0
1653517299369,MATH 288,C00,087452,Staff,15,0,15,0
1653517299894,MATH 290A,A00,087453,Xu; Zhouli,6,0,8,2
1653517300415,MATH 291A,A00,087454,Xu; Zhouli,7,0,8,1
1653517300942,MATH 292,A00,087455,Staff,10,0,10,0
1653517301465,MATH 295,A00,087456,Staff,50,0,50,0
1653517301999,MATH 297,001,087457,Staff,998,0,999,1
1653517864428,COGS 200,A01,087991,Staff,47,0,50,3
1653517864955,COGS 201,A01,094504,Rangel; Lara M,17,0,25,8
1653517865484,COGS 203,A00,087992,Coulson; Seana M,18,0,20,2
1653517866014,COGS 210A,001,087993,Greene; Deanna Jacquelyn,9998,0,9999,1
1653517866014,COGS 210A,002,087994,Saygin; Ayse P,9999,0,9999,0
1653517866014,COGS 210A,003,087995,Xia; Haijun,9999,0,9999,0
1653517866014,COGS 210A,004,087996,Nitz; Douglas A.,9999,0,9999,0
1653517866014,COGS 210A,005,087997,Hollan; James D.,9999,0,9999,0
1653517866014,COGS 210A,006,087998,Deak; Gedeon O.,9998,0,9999,1
1653517866014,COGS 210A,007,087999,Rossano; Federico,9999,0,9999,0
1653517866540,COGS 211A,A00,088000,Coulson; Seana M,9997,0,9999,2
1653517867070,COGS 229,A00,088002,Staff,23,0,25,2
1653517867605,COGS 260,B00,094231,Staff,17,0,20,3
1653517867605,COGS 260,A00,088004,Nitz; Douglas A.,9998,0,9999,1
1653517868133,CSE 202,A00,090110,Paturi; Ramamohan,0,0,0,0
1653517868133,CSE 202,B00,090111,Paturi; Ramamohan,0,0,0,0
1653517868658,CSE 207B,A00,090112,Heninger; Nadia A,0,0,0,0
1653517869179,CSE 208,A00,094858,Micciancio; Daniele,0,0,0,0
1653517869711,CSE 210,A00,090113,Powell; Thomas Allan,0,0,0,0
1653517870235,CSE 219,A00,090898,Staff,0,0,0,0
1653517870762,CSE 221,A00,090114,Zhou; Yuan-Yuan,0,0,0,0
1653517871286,CSE 229A,A00,090115,Porter; George M,0,0,0,0
1653517871810,CSE 229C,A00,090116,Savage; Stefan,0,0,0,0
1653517872341,CSE 230,A00,090117,Jhala; Ranjit,0,0,0,0
1653517872879,CSE 232,A00,090118,Papakonstantinou; Yannis,0,0,0,0
1653517873407,CSE 239A,A00,090121,Kumar; Arun Kumar,0,0,0,0
1653517873933,CSE 239B,A00,090122,Jhala; Ranjit,0,0,0,0
1653517874456,CSE 240A,A00,090123,Zhao; Jishen,0,0,189,189
1653517874993,CSE 243A,A00,090124,Orailoglu; Alex,0,0,15,15
1653517875516,CSE 249B,A00,090125,Kahng; Andrew Byun,13,0,20,7
1653517876039,CSE 250A,A00,090126,Berg-Kirkpatrick; Taylor D,0,0,0,0
1653517876575,CSE 252A,A00,090127,Ochoa; Benjamin Lawrence,0,0,0,0
1653517877116,CSE 258,A01,090129,McAuley; Julian John,0,0,0,0
1653517877639,CSE 258R,A01,090131,McAuley; Julian John,0,0,0,0
1653517878169,CSE 274,A00,090132,Ramamoorthi; Ravi,0,0,0,0
1653517878695,CSE 276A,A00,090133,Christensen; Henrik I,0,0,0,0
1653517879230,CSE 276C,A00,090134,Christensen; Henrik I,0,0,0,0
1653517879757,CSE 290,A00,090135,Bafna; Vineet,0,0,0,0
1653517879757,CSE 290,B00,090136,Ramamoorthi; Ravi,0,0,0,0
1653517879757,CSE 290,C00,090137,Li; Tzumao,8,0,10,2
1653517879757,CSE 290,D00,090138,Zhou; Yuan-Yuan,9,0,10,1
1653517879757,CSE 290,E00,090139,Christensen; Henrik I,9,0,10,1
1653517879757,CSE 290,F00,094053,Shalev; Aaron D,0,0,0,0
1653517880280,CSE 291,A00,090140,Munyaka; Imani N. S.,0,0,0,0
1653517880280,CSE 291,B00,094880,Yu; Qi,0,0,0,0
1653517880280,CSE 291,C00,090142,Pannuto; Patrick William,0,0,0,0
1653517880280,CSE 291,D00,094881,Zhang; Yiying,0,0,0,0
1653517880280,CSE 291,E00,095118,Su; Hao,0,0,0,0
1653517880806,CSE 293,001,094905,Bafna; Vineet,9999,0,9999,0
1653517880806,CSE 293,002,094906,Bellare; Mihir,9999,0,9999,0
1653517880806,CSE 293,003,094907,Berg-Kirkpatrick; Taylor D,9999,0,9999,0
1653517880806,CSE 293,004,094908,Christensen; Henrik I,9999,0,9999,0
1653517880806,CSE 293,005,094909,Cottrell; Garrison W,9999,0,9999,0
1653517880806,CSE 293,006,094910,Deutsch; Alin Bernard,9999,0,9999,0
1653517880806,CSE 293,007,094911,Esmaeilzadeh; Hadi,9999,0,9999,0
1653517880806,CSE 293,008,094912,Freund; Yoav,9999,0,9999,0
1653517880806,CSE 293,009,094913,Griswold; William G.,9999,0,9999,0
1653517880806,CSE 293,010,094914,Gymrek; Melissa Ann,9999,0,9999,0
1653517880806,CSE 293,011,094915,Heninger; Nadia A,9999,0,9999,0
1653517880806,CSE 293,012,094916,Impagliazzo; Russell,9999,0,9999,0
1653517880806,CSE 293,013,094917,Jhala; Ranjit,9999,0,9999,0
1653517880806,CSE 293,014,094918,Kahng; Andrew Byun,9999,0,9999,0
1653517880806,CSE 293,015,094919,Kane; Daniel Mertz,9999,0,9999,0
1653517880806,CSE 293,016,094920,Kriegman; David J,9999,0,9999,0
1653517880806,CSE 293,017,094921,Kumar; Arun Kumar,9999,0,9999,0
1653517880806,CSE 293,018,094922,Lerner; Sorin,9999,0,9999,0
1653517880806,CSE 293,019,094923,Lovett; Shachar,9999,0,9999,0
1653517880806,CSE 293,020,094924,McAuley; Julian John,9999,0,9999,0
1653517880806,CSE 293,021,094925,Micciancio; Daniele,9999,0,9999,0
1653517880806,CSE 293,022,094926,Orailoglu; Alex,9999,0,9999,0
1653517880806,CSE 293,023,094927,Paturi; Ramamohan,9999,0,9999,0
1653517880806,CSE 293,024,094928,Polikarpova; Nadezhda,9999,0,9999,0
1653517880806,CSE 293,025,094929,Politz; Joseph Gibbs,9999,0,9999,0
1653517880806,CSE 293,026,094930,Porter; George M,9999,0,9999,0
1653517880806,CSE 293,027,094931,Porter; Leonard Emerson,9999,0,9999,0
1653517880806,CSE 293,028,094932,Ramamoorthi; Ravi,9999,0,9999,0
1653517880806,CSE 293,029,094933,Sahoo; Debashis,9999,0,9999,0
1653517880806,CSE 293,030,094934,Saul; Lawrence,9999,0,9999,0
1653517880806,CSE 293,031,094935,Savage; Stefan,9999,0,9999,0
1653517880806,CSE 293,032,094936,Schulze; Jurgen P.,9999,0,9999,0
1653517880806,CSE 293,033,094937,Snoeren; Alex C.,9999,0,9999,0
1653517880806,CSE 293,034,094938,Shang; Jingbo,9999,0,9999,0
1653517880806,CSE 293,035,094939,Stefan; Deian,9999,0,9999,0
1653517880806,CSE 293,036,094940,Su; Hao,9999,0,9999,0
1653517880806,CSE 293,037,094941,Swanson; Steven James,9999,0,9999,0
1653517880806,CSE 293,038,094942,Tullsen; Dean Michael,9999,0,9999,0
1653517880806,CSE 293,039,094943,Voelker; Geoffrey M.,9999,0,9999,0
1653517880806,CSE 293,040,094944,Zhao; Jishen,9999,0,9999,0
1653517880806,CSE 293,041,094945,Zhou; Yuan-Yuan,9999,0,9999,0
1653517880806,CSE 293,042,094946,Gao; Sicun,9998,0,9999,1
1653517880806,CSE 293,043,094947,Weibel; Nadir,9999,0,9999,0
1653517880806,CSE 293,044,094948,Gupta; Rajesh K.,9999,0,9999,0
1653517881331,CSE 294,A00,090143,Porter; George M,8,0,10,2
1653517881855,DSE 200,A00,091799,Staff,50,0,50,0
1653517882379,DSE 203,A00,091800,Gupta; Amarnath,30,0,30,0
1653517882908,DSE 250,A00,091801,Deutsch; Alin Bernard,30,0,30,0
1653517883434,DSE 290,A00,091802,Altintas De Callaf; Ilkay,50,0,50,0
1653517883977,ECE 200,001,091003,Antipa; Nicholas A,9999,0,9999,0
1653517883977,ECE 200,002,091004,Atanasov; Nikolay A.,9999,0,9999,0
1653517883977,ECE 200,003,091005,Bharadia; Dinesh,9999,0,9999,0
1653517883977,ECE 200,004,091006,Cheng; Chung Kuan,9999,0,9999,0
1653517883977,ECE 200,005,091007,Cosman; Pamela C.,9999,0,9999,0
1653517883977,ECE 200,006,091008,Staff,9999,0,9999,0
1653517883977,ECE 200,007,091009,Dayeh; Shadi Ahmad,9999,0,9999,0
1653517883977,ECE 200,008,091010,Fainman; Yeshaiahu,9999,0,9999,0
1653517883977,ECE 200,009,091011,Ford; Joseph Earl,9999,0,9999,0
1653517883977,ECE 200,010,091012,Franceschetti; Massimo,9999,0,9999,0
1653517883977,ECE 200,011,091013,Fullerton; Eric E,9999,0,9999,0
1653517883977,ECE 200,012,091014,Galton; Ian A,9999,0,9999,0
1653517883977,ECE 200,013,091015,Gilja; Vikash,9999,0,9999,0
1653517883977,ECE 200,014,091016,Hall; Drew A.,9999,0,9999,0
1653517883977,ECE 200,015,091017,Hsueh; Tzu-Chien,9999,0,9999,0
1653517883977,ECE 200,016,091018,Javidi; Tara,9999,0,9999,0
1653517883977,ECE 200,017,091019,Kahng; Andrew Byun,9999,0,9999,0
1653517883977,ECE 200,018,091020,Kim; Young-Han,9999,0,9999,0
1653517883977,ECE 200,019,091021,Koushanfar; Farinaz,9999,0,9999,0
1653517883977,ECE 200,020,091022,Kuzum; Duygu,9999,0,9999,0
1653517883977,ECE 200,021,091023,Le; Hanh-Phuc,9999,0,9999,0
1653517883977,ECE 200,022,091024,Lin; Bill,9999,0,9999,0
1653517883977,ECE 200,023,091025,Liu; Zhaowei,9999,0,9999,0
1653517883977,ECE 200,024,091026,Lo; Yu-Hwa,9999,0,9999,0
1653517883977,ECE 200,025,091027,Lomakin; Vitaliy,9999,0,9999,0
1653517883977,ECE 200,026,091028,Mercier; Patrick Philip,9999,0,9999,0
1653517883977,ECE 200,027,091029,Meyer; Florian,9999,0,9999,0
1653517883977,ECE 200,028,091030,Milstein; Laurence B.,9999,0,9999,0
1653517883977,ECE 200,029,091031,Mir Arabbaygi; Siavash,9999,0,9999,0
1653517883977,ECE 200,030,091032,Mookherjea; Shayan,9999,0,9999,0
1653517883977,ECE 200,031,091033,Morris; Karcher William,9999,0,9999,0
1653517883977,ECE 200,032,091034,Ng; Tse Nga,9999,0,9999,0
1653517883977,ECE 200,033,091035,Nguyen; Truong Quang,9999,0,9999,0
1653517883977,ECE 200,034,091036,Nomura; Kenji,9999,0,9999,0
1653517883977,ECE 200,035,091037,Orlitsky; Alon,9999,0,9999,0
1653517883977,ECE 200,036,091038,Pal; Piya,9999,0,9999,0
1653517883977,ECE 200,037,091039,Papen; George C.,9999,0,9999,0
1653517883977,ECE 200,038,091040,Radic; Stojan,9999,0,9999,0
1653517883977,ECE 200,039,091041,Rao; Bhaskar D.,9999,0,9999,0
1653517883977,ECE 200,040,091042,Rao; Ramesh R,9999,0,9999,0
1653517883977,ECE 200,041,091043,Rebeiz; Gabriel,9999,0,9999,0
1653517883977,ECE 200,042,091044,Sanford; John R,9999,0,9999,0
1653517883977,ECE 200,043,091045,Siegel; Paul H.,9999,0,9999,0
1653517883977,ECE 200,044,091046,Sievenpiper; Daniel F.,9999,0,9999,0
1653517883977,ECE 200,045,091047,Sworder; David D.,9999,0,9999,0
1653517883977,ECE 200,046,091048,Taur; Yuan,9999,0,9999,0
1653517883977,ECE 200,047,091049,Touri; Behrouz,9999,0,9999,0
1653517883977,ECE 200,048,091050,Trivedi; Mohan M.,9999,0,9999,0
1653517883977,ECE 200,049,091051,Vardy; Alexander,9999,0,9999,0
1653517883977,ECE 200,050,091052,Vasconcelos; Nuno,9999,0,9999,0
1653517883977,ECE 200,051,091053,Wang; Xiaolong,9999,0,9999,0
1653517883977,ECE 200,052,091054,Xie; Pengtao,9999,0,9999,0
1653517883977,ECE 200,053,091055,Yip; Michael,9999,0,9999,0
1653517883977,ECE 200,054,091056,Zeger; Kenneth A.,9999,0,9999,0
1653517883977,ECE 200,055,091057,Zhang; Xinyu,9999,0,9999,0
1653517883977,ECE 200,056,091058,Turakhia; Yatish Girish,9999,0,9999,0
1653517883977,ECE 200,057,091059,Kang; Mingu,9999,0,9999,0
1653517883977,ECE 200,058,091060,Shi; Yuanyuan,9999,0,9999,0
1653517883977,ECE 200,059,091061,Wang; Edward Jay,9999,0,9999,0
1653517883977,ECE 200,060,091062,Zheng; Yang,9999,0,9999,0
1653517884599,ECE 201,A00,095526,Lo; Yu-Hwa,0,0,0,0
1653517885130,ECE 203,A00,091065,Mercier; Patrick Philip,0,0,0,0
1653517885671,ECE 207A,A00,091605,Liu; Thomas Tao-Ming,0,0,0,0
1653517886201,ECE 212AN,A00,091068,Nomura; Kenji,0,0,0,0
1653517886772,ECE 222A,A00,091069,Rebeiz; Gabriel,0,0,0,0
1653517887298,ECE 225A,A00,091070,Orlitsky; Alon,0,0,0,0
1653517887821,ECE 230A,A00,091071,Nomura; Kenji,0,0,0,0
1653517888347,ECE 236A,A00,091072,Dayeh; Shadi Ahmad,0,0,0,0
1653517888879,ECE 238A,A00,091073,Luo; Jian,0,0,0,0
1653517888879,ECE 238A,B00,091074,Luo; Jian,0,0,0,0
1653517889419,ECE 240A,A00,091075,Radic; Stojan,0,0,0,0
1653517889943,ECE 247A,A00,091592,Shi; Lingyan,0,0,0,0
1653517890468,ECE 250,A00,091076,Touri; Behrouz,0,0,0,0
1653517890990,ECE 251C,A00,091078,Nguyen; Truong Quang,0,0,0,0
1653517891518,ECE 253,A00,091079,Cosman; Pamela C.,0,0,0,0
1653517892051,ECE 255A,A00,091080,Orlitsky; Alon,0,0,0,0
1653517892574,ECE 257A,A00,091081,Zhang; Xinyu,0,0,0,0
1653517893099,ECE 260A,A01,091084,Eldon; John,0,0,0,0
1653517893627,ECE 264C,A00,091085,Galton; Ian A,0,0,0,0
1653517894151,ECE 265C,A00,094889,Presti; Calogero Davide,0,0,0,9
1653517894677,ECE 266,A01,091087,Hall; Drew A.,0,0,0,0
1653517895738,ECE 271A,A00,091090,Vasconcelos; Nuno,0,0,0,0
1653517896262,ECE 272B,A00,091091,Sworder; David D.,0,0,0,0
1653517896789,ECE 275A,A00,091092,Meyer; Florian,0,0,0,0
1653517897320,ECE 277,A00,091093,An; Cheolhong,0,0,0,0
1653517897844,ECE 283,A00,091094,Le; Hanh-Phuc,0,0,0,0
1653517898378,ECE 284,A00,091095,Kang; Mingu,0,0,0,0
1653517898378,ECE 284,B00,091096,Wang; Edward Jay,0,0,0,0
1653517898905,ECE 285,A00,094334,Touri; Behrouz,0,0,0,0
1653517899458,ECE 289,A00,091097,Whelan; David Arthur,0,0,0,0
1653517899984,MATH 200A,A00,087414,Salehi Golsefidy; Alireza,7,0,8,1
1653517900513,MATH 202A,A00,087415,Gill; Philip E.,3,0,8,5
1653517901038,MATH 203A,A00,087416,Oprea; Dragos N.,6,0,8,2
1653517901571,MATH 204A,A00,087417,Kedlaya; Kiran S.,6,0,8,2
1653517902103,MATH 205,A00,087418,Sorensen; Claus M,6,0,8,2
1653517902631,MATH 206A,A00,087419,Izadi; Elham,7,0,8,1
1653517903158,MATH 207A,A00,087420,Mohammadi; Amir,5,0,8,3
1653517903681,MATH 208,A00,087421,Staff,9,0,10,1
1653517904213,MATH 209,A00,087422,Staff,10,0,10,0
1653517904750,MATH 218,A00,087423,Staff,10,0,10,0
1653517905275,MATH 220A,A00,087424,Novak; Jonathan I,7,0,8,1
1653517905816,MATH 231A,A00,087425,Bejenaru; Ioan,3,0,8,5
1653517906339,MATH 240A,A00,087426,Ebenfelt; Peter F,5,0,8,3
1653517906862,MATH 243,A00,087427,Staff,9,0,10,1
1653517907385,MATH 248,A00,087429,Staff,10,0,10,0
1653517907909,MATH 250A,A00,087430,Spolaor; Luca,4,0,8,4
1653517908432,MATH 257A,A00,087431,Spolaor; Luca,7,0,8,1
1653517908960,MATH 258,A00,087432,Staff,9,0,10,1
1653517909484,MATH 264A,A00,087433,Warnke; Lutz Peter,5,0,8,3
1653517910014,MATH 268,A00,087434,Staff,15,0,15,0
1653517910543,MATH 269,A00,087435,Staff,14,0,15,1
1653517911075,MATH 270A,A00,087436,Nie; Jiawang,0,0,8,8
1653517911611,MATH 272A,A00,087437,Tian; Xiaochuan,1,0,8,7
1653517912138,MATH 274,A01,087439,Cheng; Li-Tien,9,0,10,1
1653517912138,MATH 274,A02,087440,Cheng; Li-Tien,10,0,10,0
1653517912670,MATH 278A,A00,087441,Staff,8,0,10,2
1653517913193,MATH 278B,A00,087442,Staff,8,0,10,2
1653517913731,MATH 278C,A00,087443,Staff,8,0,10,2
1653517914257,MATH 280A,A00,087444,Zheng; Tianyi,0,0,8,8
1653517914779,MATH 281A,A00,087445,Bradic; Jelena,0,0,8,8
1653517915316,MATH 282A,A00,087446,Zhang; Danna,0,0,8,8
1653517915843,MATH 283,A00,087447,Tesler; Glenn,0,0,0,15
1653517916369,MATH 286,A00,087448,Kemp; Todd Aahron,5,0,8,3
1653517916896,MATH 287D,A00,087449,Bradic; Jelena,8,0,8,0
1653517917430,MATH 288,A00,087450,Staff,14,0,15,1
1653517917430,MATH 288,B00,087451,Staff,15,0,15,0
1653517917430,MATH 288,C00,087452,Staff,15,0,15,0
1653517917959,MATH 290A,A00,087453,Xu; Zhouli,6,0,8,2
1653517918486,MATH 291A,A00,087454,Xu; Zhouli,7,0,8,1
1653517919010,MATH 292,A00,087455,Staff,10,0,10,0
1653517919534,MATH 295,A00,087456,Staff,50,0,50,0
1653517920064,MATH 297,001,087457,Staff,998,0,999,1
1653518481727,COGS 200,A01,087991,Staff,47,0,50,3
1653518482250,COGS 201,A01,094504,Rangel; Lara M,17,0,25,8
1653518482780,COGS 203,A00,087992,Coulson; Seana M,18,0,20,2
1653518483308,COGS 210A,001,087993,Greene; Deanna Jacquelyn,9998,0,9999,1
1653518483308,COGS 210A,002,087994,Saygin; Ayse P,9999,0,9999,0
1653518483308,COGS 210A,003,087995,Xia; Haijun,9999,0,9999,0
1653518483308,COGS 210A,004,087996,Nitz; Douglas A.,9999,0,9999,0
1653518483308,COGS 210A,005,087997,Hollan; James D.,9999,0,9999,0
1653518483308,COGS 210A,006,087998,Deak; Gedeon O.,9998,0,9999,1
1653518483308,COGS 210A,007,087999,Rossano; Federico,9999,0,9999,0
1653518483832,COGS 211A,A00,088000,Coulson; Seana M,9997,0,9999,2
1653518484366,COGS 229,A00,088002,Staff,23,0,25,2
1653518484890,COGS 260,B00,094231,Staff,17,0,20,3
1653518484890,COGS 260,A00,088004,Nitz; Douglas A.,9998,0,9999,1
1653518485421,CSE 202,A00,090110,Paturi; Ramamohan,0,0,0,0
1653518485421,CSE 202,B00,090111,Paturi; Ramamohan,0,0,0,0
1653518485946,CSE 207B,A00,090112,Heninger; Nadia A,0,0,0,0
1653518486473,CSE 208,A00,094858,Micciancio; Daniele,0,0,0,0
1653518487004,CSE 210,A00,090113,Powell; Thomas Allan,0,0,0,0
1653518487529,CSE 219,A00,090898,Staff,0,0,0,0
1653518488061,CSE 221,A00,090114,Zhou; Yuan-Yuan,0,0,0,0
1653518488586,CSE 229A,A00,090115,Porter; George M,0,0,0,0
1653518489111,CSE 229C,A00,090116,Savage; Stefan,0,0,0,0
1653518489643,CSE 230,A00,090117,Jhala; Ranjit,0,0,0,0
1653518490165,CSE 232,A00,090118,Papakonstantinou; Yannis,0,0,0,0
1653518490688,CSE 239A,A00,090121,Kumar; Arun Kumar,0,0,0,0
1653518491217,CSE 239B,A00,090122,Jhala; Ranjit,0,0,0,0
1653518491745,CSE 240A,A00,090123,Zhao; Jishen,0,0,189,189
1653518492283,CSE 243A,A00,090124,Orailoglu; Alex,0,0,15,15
1653518492808,CSE 249B,A00,090125,Kahng; Andrew Byun,13,0,20,7
1653518493346,CSE 250A,A00,090126,Berg-Kirkpatrick; Taylor D,0,0,0,0
1653518493870,CSE 252A,A00,090127,Ochoa; Benjamin Lawrence,0,0,0,0
1653518494392,CSE 258,A01,090129,McAuley; Julian John,0,0,0,0
1653518494929,CSE 258R,A01,090131,McAuley; Julian John,0,0,0,0
1653518495460,CSE 274,A00,090132,Ramamoorthi; Ravi,0,0,0,0
1653518495989,CSE 276A,A00,090133,Christensen; Henrik I,0,0,0,0
1653518496515,CSE 276C,A00,090134,Christensen; Henrik I,0,0,0,0
1653518497039,CSE 290,A00,090135,Bafna; Vineet,0,0,0,0
1653518497039,CSE 290,B00,090136,Ramamoorthi; Ravi,0,0,0,0
1653518497039,CSE 290,C00,090137,Li; Tzumao,8,0,10,2
1653518497039,CSE 290,D00,090138,Zhou; Yuan-Yuan,9,0,10,1
1653518497039,CSE 290,E00,090139,Christensen; Henrik I,9,0,10,1
1653518497039,CSE 290,F00,094053,Shalev; Aaron D,0,0,0,0
1653518497576,CSE 291,A00,090140,Munyaka; Imani N. S.,0,0,0,0
1653518497576,CSE 291,B00,094880,Yu; Qi,0,0,0,0
1653518497576,CSE 291,C00,090142,Pannuto; Patrick William,0,0,0,0
1653518497576,CSE 291,D00,094881,Zhang; Yiying,0,0,0,0
1653518497576,CSE 291,E00,095118,Su; Hao,0,0,0,0
1653518498131,CSE 293,001,094905,Bafna; Vineet,9999,0,9999,0
1653518498131,CSE 293,002,094906,Bellare; Mihir,9999,0,9999,0
1653518498131,CSE 293,003,094907,Berg-Kirkpatrick; Taylor D,9999,0,9999,0
1653518498131,CSE 293,004,094908,Christensen; Henrik I,9999,0,9999,0
1653518498131,CSE 293,005,094909,Cottrell; Garrison W,9999,0,9999,0
1653518498131,CSE 293,006,094910,Deutsch; Alin Bernard,9999,0,9999,0
1653518498131,CSE 293,007,094911,Esmaeilzadeh; Hadi,9999,0,9999,0
1653518498131,CSE 293,008,094912,Freund; Yoav,9999,0,9999,0
1653518498131,CSE 293,009,094913,Griswold; William G.,9999,0,9999,0
1653518498131,CSE 293,010,094914,Gymrek; Melissa Ann,9999,0,9999,0
1653518498131,CSE 293,011,094915,Heninger; Nadia A,9999,0,9999,0
1653518498131,CSE 293,012,094916,Impagliazzo; Russell,9999,0,9999,0
1653518498131,CSE 293,013,094917,Jhala; Ranjit,9999,0,9999,0
1653518498131,CSE 293,014,094918,Kahng; Andrew Byun,9999,0,9999,0
1653518498131,CSE 293,015,094919,Kane; Daniel Mertz,9999,0,9999,0
1653518498131,CSE 293,016,094920,Kriegman; David J,9999,0,9999,0
1653518498131,CSE 293,017,094921,Kumar; Arun Kumar,9999,0,9999,0
1653518498131,CSE 293,018,094922,Lerner; Sorin,9999,0,9999,0
1653518498131,CSE 293,019,094923,Lovett; Shachar,9999,0,9999,0
1653518498131,CSE 293,020,094924,McAuley; Julian John,9999,0,9999,0
1653518498131,CSE 293,021,094925,Micciancio; Daniele,9999,0,9999,0
1653518498131,CSE 293,022,094926,Orailoglu; Alex,9999,0,9999,0
1653518498131,CSE 293,023,094927,Paturi; Ramamohan,9999,0,9999,0
1653518498131,CSE 293,024,094928,Polikarpova; Nadezhda,9999,0,9999,0
1653518498131,CSE 293,025,094929,Politz; Joseph Gibbs,9999,0,9999,0
1653518498131,CSE 293,026,094930,Porter; George M,9999,0,9999,0
1653518498131,CSE 293,027,094931,Porter; Leonard Emerson,9999,0,9999,0
1653518498131,CSE 293,028,094932,Ramamoorthi; Ravi,9999,0,9999,0
1653518498131,CSE 293,029,094933,Sahoo; Debashis,9999,0,9999,0
1653518498131,CSE 293,030,094934,Saul; Lawrence,9999,0,9999,0
1653518498131,CSE 293,031,094935,Savage; Stefan,9999,0,9999,0
1653518498131,CSE 293,032,094936,Schulze; Jurgen P.,9999,0,9999,0
1653518498131,CSE 293,033,094937,Snoeren; Alex C.,9999,0,9999,0
1653518498131,CSE 293,034,094938,Shang; Jingbo,9999,0,9999,0
1653518498131,CSE 293,035,094939,Stefan; Deian,9999,0,9999,0
1653518498131,CSE 293,036,094940,Su; Hao,9999,0,9999,0
1653518498131,CSE 293,037,094941,Swanson; Steven James,9999,0,9999,0
1653518498131,CSE 293,038,094942,Tullsen; Dean Michael,9999,0,9999,0
1653518498131,CSE 293,039,094943,Voelker; Geoffrey M.,9999,0,9999,0
1653518498131,CSE 293,040,094944,Zhao; Jishen,9999,0,9999,0
1653518498131,CSE 293,041,094945,Zhou; Yuan-Yuan,9999,0,9999,0
1653518498131,CSE 293,042,094946,Gao; Sicun,9998,0,9999,1
1653518498131,CSE 293,043,094947,Weibel; Nadir,9999,0,9999,0
1653518498131,CSE 293,044,094948,Gupta; Rajesh K.,9999,0,9999,0
1653518498668,CSE 294,A00,090143,Porter; George M,8,0,10,2
1653518499193,DSE 200,A00,091799,Staff,50,0,50,0
1653518499716,DSE 203,A00,091800,Gupta; Amarnath,30,0,30,0
1653518500238,DSE 250,A00,091801,Deutsch; Alin Bernard,30,0,30,0
1653518500777,DSE 290,A00,091802,Altintas De Callaf; Ilkay,50,0,50,0
1653518501316,ECE 200,001,091003,Antipa; Nicholas A,9999,0,9999,0
1653518501316,ECE 200,002,091004,Atanasov; Nikolay A.,9999,0,9999,0
1653518501316,ECE 200,003,091005,Bharadia; Dinesh,9999,0,9999,0
1653518501316,ECE 200,004,091006,Cheng; Chung Kuan,9999,0,9999,0
1653518501316,ECE 200,005,091007,Cosman; Pamela C.,9999,0,9999,0
1653518501316,ECE 200,006,091008,Staff,9999,0,9999,0
1653518501316,ECE 200,007,091009,Dayeh; Shadi Ahmad,9999,0,9999,0
1653518501316,ECE 200,008,091010,Fainman; Yeshaiahu,9999,0,9999,0
1653518501316,ECE 200,009,091011,Ford; Joseph Earl,9999,0,9999,0
1653518501316,ECE 200,010,091012,Franceschetti; Massimo,9999,0,9999,0
1653518501316,ECE 200,011,091013,Fullerton; Eric E,9999,0,9999,0
1653518501316,ECE 200,012,091014,Galton; Ian A,9999,0,9999,0
1653518501316,ECE 200,013,091015,Gilja; Vikash,9999,0,9999,0
1653518501316,ECE 200,014,091016,Hall; Drew A.,9999,0,9999,0
1653518501316,ECE 200,015,091017,Hsueh; Tzu-Chien,9999,0,9999,0
1653518501316,ECE 200,016,091018,Javidi; Tara,9999,0,9999,0
1653518501316,ECE 200,017,091019,Kahng; Andrew Byun,9999,0,9999,0
1653518501316,ECE 200,018,091020,Kim; Young-Han,9999,0,9999,0
1653518501316,ECE 200,019,091021,Koushanfar; Farinaz,9999,0,9999,0
1653518501316,ECE 200,020,091022,Kuzum; Duygu,9999,0,9999,0
1653518501316,ECE 200,021,091023,Le; Hanh-Phuc,9999,0,9999,0
1653518501316,ECE 200,022,091024,Lin; Bill,9999,0,9999,0
1653518501316,ECE 200,023,091025,Liu; Zhaowei,9999,0,9999,0
1653518501316,ECE 200,024,091026,Lo; Yu-Hwa,9999,0,9999,0
1653518501316,ECE 200,025,091027,Lomakin; Vitaliy,9999,0,9999,0
1653518501316,ECE 200,026,091028,Mercier; Patrick Philip,9999,0,9999,0
1653518501316,ECE 200,027,091029,Meyer; Florian,9999,0,9999,0
1653518501316,ECE 200,028,091030,Milstein; Laurence B.,9999,0,9999,0
1653518501316,ECE 200,029,091031,Mir Arabbaygi; Siavash,9999,0,9999,0
1653518501316,ECE 200,030,091032,Mookherjea; Shayan,9999,0,9999,0
1653518501316,ECE 200,031,091033,Morris; Karcher William,9999,0,9999,0
1653518501316,ECE 200,032,091034,Ng; Tse Nga,9999,0,9999,0
1653518501316,ECE 200,033,091035,Nguyen; Truong Quang,9999,0,9999,0
1653518501316,ECE 200,034,091036,Nomura; Kenji,9999,0,9999,0
1653518501316,ECE 200,035,091037,Orlitsky; Alon,9999,0,9999,0
1653518501316,ECE 200,036,091038,Pal; Piya,9999,0,9999,0
1653518501316,ECE 200,037,091039,Papen; George C.,9999,0,9999,0
1653518501316,ECE 200,038,091040,Radic; Stojan,9999,0,9999,0
1653518501316,ECE 200,039,091041,Rao; Bhaskar D.,9999,0,9999,0
1653518501316,ECE 200,040,091042,Rao; Ramesh R,9999,0,9999,0
1653518501316,ECE 200,041,091043,Rebeiz; Gabriel,9999,0,9999,0
1653518501316,ECE 200,042,091044,Sanford; John R,9999,0,9999,0
1653518501316,ECE 200,043,091045,Siegel; Paul H.,9999,0,9999,0
1653518501316,ECE 200,044,091046,Sievenpiper; Daniel F.,9999,0,9999,0
1653518501316,ECE 200,045,091047,Sworder; David D.,9999,0,9999,0
1653518501316,ECE 200,046,091048,Taur; Yuan,9999,0,9999,0
1653518501316,ECE 200,047,091049,Touri; Behrouz,9999,0,9999,0
1653518501316,ECE 200,048,091050,Trivedi; Mohan M.,9999,0,9999,0
1653518501316,ECE 200,049,091051,Vardy; Alexander,9999,0,9999,0
1653518501316,ECE 200,050,091052,Vasconcelos; Nuno,9999,0,9999,0
1653518501316,ECE 200,051,091053,Wang; Xiaolong,9999,0,9999,0
1653518501316,ECE 200,052,091054,Xie; Pengtao,9999,0,9999,0
1653518501316,ECE 200,053,091055,Yip; Michael,9999,0,9999,0
1653518501316,ECE 200,054,091056,Zeger; Kenneth A.,9999,0,9999,0
1653518501316,ECE 200,055,091057,Zhang; Xinyu,9999,0,9999,0
1653518501316,ECE 200,056,091058,Turakhia; Yatish Girish,9999,0,9999,0
1653518501316,ECE 200,057,091059,Kang; Mingu,9999,0,9999,0
1653518501316,ECE 200,058,091060,Shi; Yuanyuan,9999,0,9999,0
1653518501316,ECE 200,059,091061,Wang; Edward Jay,9999,0,9999,0
1653518501316,ECE 200,060,091062,Zheng; Yang,9999,0,9999,0
1653518501852,ECE 201,A00,095526,Lo; Yu-Hwa,0,0,0,0
1653518502386,ECE 203,A00,091065,Mercier; Patrick Philip,0,0,0,0
1653518502916,ECE 207A,A00,091605,Liu; Thomas Tao-Ming,0,0,0,0
1653518503448,ECE 212AN,A00,091068,Nomura; Kenji,0,0,0,0
1653518503980,ECE 222A,A00,091069,Rebeiz; Gabriel,0,0,0,0
1653518504506,ECE 225A,A00,091070,Orlitsky; Alon,0,0,0,0
1653518505032,ECE 230A,A00,091071,Nomura; Kenji,0,0,0,0
1653518505554,ECE 236A,A00,091072,Dayeh; Shadi Ahmad,0,0,0,0
1653518506082,ECE 238A,A00,091073,Luo; Jian,0,0,0,0
1653518506082,ECE 238A,B00,091074,Luo; Jian,0,0,0,0
1653518506607,ECE 240A,A00,091075,Radic; Stojan,0,0,0,0
1653518507133,ECE 247A,A00,091592,Shi; Lingyan,0,0,0,0
1653518507659,ECE 250,A00,091076,Touri; Behrouz,0,0,0,0
1653518508186,ECE 251C,A00,091078,Nguyen; Truong Quang,0,0,0,0
1653518508711,ECE 253,A00,091079,Cosman; Pamela C.,0,0,0,0
1653518509242,ECE 255A,A00,091080,Orlitsky; Alon,0,0,0,0
1653518509784,ECE 257A,A00,091081,Zhang; Xinyu,0,0,0,0
1653518510311,ECE 260A,A01,091084,Eldon; John,0,0,0,0
1653518510837,ECE 264C,A00,091085,Galton; Ian A,0,0,0,0
1653518511362,ECE 265C,A00,094889,Presti; Calogero Davide,0,0,0,9
1653518511885,ECE 266,A01,091087,Hall; Drew A.,0,0,0,0
1653518512939,ECE 271A,A00,091090,Vasconcelos; Nuno,0,0,0,0
1653518513477,ECE 272B,A00,091091,Sworder; David D.,0,0,0,0
1653518514024,ECE 275A,A00,091092,Meyer; Florian,0,0,0,0
1653518514547,ECE 277,A00,091093,An; Cheolhong,0,0,0,0
1653518515072,ECE 283,A00,091094,Le; Hanh-Phuc,0,0,0,0
1653518515600,ECE 284,A00,091095,Kang; Mingu,0,0,0,0
1653518515600,ECE 284,B00,091096,Wang; Edward Jay,0,0,0,0
1653518516124,ECE 285,A00,094334,Touri; Behrouz,0,0,0,0
1653518516662,ECE 289,A00,091097,Whelan; David Arthur,0,0,0,0
1653518517198,MATH 200A,A00,087414,Salehi Golsefidy; Alireza,7,0,8,1
1653518517728,MATH 202A,A00,087415,Gill; Philip E.,3,0,8,5
1653518518255,MATH 203A,A00,087416,Oprea; Dragos N.,6,0,8,2
1653518518781,MATH 204A,A00,087417,Kedlaya; Kiran S.,6,0,8,2
1653518519310,MATH 205,A00,087418,Sorensen; Claus M,6,0,8,2
1653518519839,MATH 206A,A00,087419,Izadi; Elham,7,0,8,1
1653518520375,MATH 207A,A00,087420,Mohammadi; Amir,5,0,8,3
1653518520915,MATH 208,A00,087421,Staff,9,0,10,1
1653518521449,MATH 209,A00,087422,Staff,10,0,10,0
1653518521982,MATH 218,A00,087423,Staff,10,0,10,0
1653518522510,MATH 220A,A00,087424,Novak; Jonathan I,7,0,8,1
1653518523035,MATH 231A,A00,087425,Bejenaru; Ioan,3,0,8,5
1653518523561,MATH 240A,A00,087426,Ebenfelt; Peter F,5,0,8,3
1653518524087,MATH 243,A00,087427,Staff,9,0,10,1
1653518524613,MATH 248,A00,087429,Staff,10,0,10,0
1653518525138,MATH 250A,A00,087430,Spolaor; Luca,4,0,8,4
1653518525662,MATH 257A,A00,087431,Spolaor; Luca,7,0,8,1
1653518526197,MATH 258,A00,087432,Staff,9,0,10,1
1653518526724,MATH 264A,A00,087433,Warnke; Lutz Peter,5,0,8,3
1653518527343,MATH 268,A00,087434,Staff,15,0,15,0
1653518527865,MATH 269,A00,087435,Staff,14,0,15,1
1653518528401,MATH 270A,A00,087436,Nie; Jiawang,0,0,8,8
1653518528924,MATH 272A,A00,087437,Tian; Xiaochuan,1,0,8,7
1653518529464,MATH 274,A01,087439,Cheng; Li-Tien,9,0,10,1
1653518529464,MATH 274,A02,087440,Cheng; Li-Tien,10,0,10,0
1653518529997,MATH 278A,A00,087441,Staff,8,0,10,2
1653518530524,MATH 278B,A00,087442,Staff,8,0,10,2
1653518531056,MATH 278C,A00,087443,Staff,8,0,10,2
1653518531596,MATH 280A,A00,087444,Zheng; Tianyi,0,0,8,8
1653518532123,MATH 281A,A00,087445,Bradic; Jelena,0,0,8,8
1653518532650,MATH 282A,A00,087446,Zhang; Danna,0,0,8,8
1653518533174,MATH 283,A00,087447,Tesler; Glenn,0,0,0,15
1653518533702,MATH 286,A00,087448,Kemp; Todd Aahron,5,0,8,3
1653518534225,MATH 287D,A00,087449,Bradic; Jelena,8,0,8,0
1653518534752,MATH 288,A00,087450,Staff,14,0,15,1
1653518534752,MATH 288,B00,087451,Staff,15,0,15,0
1653518534752,MATH 288,C00,087452,Staff,15,0,15,0
1653518535278,MATH 290A,A00,087453,Xu; Zhouli,6,0,8,2
1653518535806,MATH 291A,A00,087454,Xu; Zhouli,7,0,8,1
1653518536331,MATH 292,A00,087455,Staff,10,0,10,0
1653518536856,MATH 295,A00,087456,Staff,50,0,50,0
1653518537380,MATH 297,001,087457,Staff,998,0,999,1
1653519099470,COGS 200,A01,087991,Staff,47,0,50,3
1653519100004,COGS 201,A01,094504,Rangel; Lara M,17,0,25,8
1653519100530,COGS 203,A00,087992,Coulson; Seana M,18,0,20,2
1653519101053,COGS 210A,001,087993,Greene; Deanna Jacquelyn,9998,0,9999,1
1653519101053,COGS 210A,002,087994,Saygin; Ayse P,9999,0,9999,0
1653519101053,COGS 210A,003,087995,Xia; Haijun,9999,0,9999,0
1653519101053,COGS 210A,004,087996,Nitz; Douglas A.,9999,0,9999,0
1653519101053,COGS 210A,005,087997,Hollan; James D.,9999,0,9999,0
1653519101053,COGS 210A,006,087998,Deak; Gedeon O.,9998,0,9999,1
1653519101053,COGS 210A,007,087999,Rossano; Federico,9999,0,9999,0
1653519101580,COGS 211A,A00,088000,Coulson; Seana M,9997,0,9999,2
1653519102118,COGS 229,A00,088002,Staff,23,0,25,2
1653519102644,COGS 260,B00,094231,Staff,17,0,20,3
1653519102644,COGS 260,A00,088004,Nitz; Douglas A.,9998,0,9999,1
1653519103173,CSE 202,A00,090110,Paturi; Ramamohan,0,0,0,0
1653519103173,CSE 202,B00,090111,Paturi; Ramamohan,0,0,0,0
1653519103707,CSE 207B,A00,090112,Heninger; Nadia A,0,0,0,0
1653519104240,CSE 208,A00,094858,Micciancio; Daniele,0,0,0,0
1653519104767,CSE 210,A00,090113,Powell; Thomas Allan,0,0,0,0
1653519105289,CSE 219,A00,090898,Staff,0,0,0,0
1653519105814,CSE 221,A00,090114,Zhou; Yuan-Yuan,0,0,0,0
1653519106342,CSE 229A,A00,090115,Porter; George M,0,0,0,0
1653519106875,CSE 229C,A00,090116,Savage; Stefan,0,0,0,0
1653519107402,CSE 230,A00,090117,Jhala; Ranjit,0,0,0,0
1653519107933,CSE 232,A00,090118,Papakonstantinou; Yannis,0,0,0,0
1653519108479,CSE 239A,A00,090121,Kumar; Arun Kumar,0,0,0,0
1653519109010,CSE 239B,A00,090122,Jhala; Ranjit,0,0,0,0
1653519109537,CSE 240A,A00,090123,Zhao; Jishen,0,0,189,189
1653519110060,CSE 243A,A00,090124,Orailoglu; Alex,0,0,15,15
1653519110586,CSE 249B,A00,090125,Kahng; Andrew Byun,13,0,20,7
1653519111119,CSE 250A,A00,090126,Berg-Kirkpatrick; Taylor D,0,0,0,0
1653519111645,CSE 252A,A00,090127,Ochoa; Benjamin Lawrence,0,0,0,0
1653519112177,CSE 258,A01,090129,McAuley; Julian John,0,0,0,0
1653519112701,CSE 258R,A01,090131,McAuley; Julian John,0,0,0,0
1653519113223,CSE 274,A00,090132,Ramamoorthi; Ravi,0,0,0,0
1653519113746,CSE 276A,A00,090133,Christensen; Henrik I,0,0,0,0
1653519114277,CSE 276C,A00,090134,Christensen; Henrik I,0,0,0,0
1653519114808,CSE 290,A00,090135,Bafna; Vineet,0,0,0,0
1653519114808,CSE 290,B00,090136,Ramamoorthi; Ravi,0,0,0,0
1653519114808,CSE 290,C00,090137,Li; Tzumao,8,0,10,2
1653519114808,CSE 290,D00,090138,Zhou; Yuan-Yuan,9,0,10,1
1653519114808,CSE 290,E00,090139,Christensen; Henrik I,9,0,10,1
1653519114808,CSE 290,F00,094053,Shalev; Aaron D,0,0,0,0
1653519115332,CSE 291,A00,090140,Munyaka; Imani N. S.,0,0,0,0
1653519115332,CSE 291,B00,094880,Yu; Qi,0,0,0,0
1653519115332,CSE 291,C00,090142,Pannuto; Patrick William,0,0,0,0
1653519115332,CSE 291,D00,094881,Zhang; Yiying,0,0,0,0
1653519115332,CSE 291,E00,095118,Su; Hao,0,0,0,0
1653519115860,CSE 293,001,094905,Bafna; Vineet,9999,0,9999,0
1653519115860,CSE 293,002,094906,Bellare; Mihir,9999,0,9999,0
1653519115860,CSE 293,003,094907,Berg-Kirkpatrick; Taylor D,9999,0,9999,0
1653519115860,CSE 293,004,094908,Christensen; Henrik I,9999,0,9999,0
1653519115860,CSE 293,005,094909,Cottrell; Garrison W,9999,0,9999,0
1653519115860,CSE 293,006,094910,Deutsch; Alin Bernard,9999,0,9999,0
1653519115860,CSE 293,007,094911,Esmaeilzadeh; Hadi,9999,0,9999,0
1653519115860,CSE 293,008,094912,Freund; Yoav,9999,0,9999,0
1653519115860,CSE 293,009,094913,Griswold; William G.,9999,0,9999,0
1653519115860,CSE 293,010,094914,Gymrek; Melissa Ann,9999,0,9999,0
1653519115860,CSE 293,011,094915,Heninger; Nadia A,9999,0,9999,0
1653519115860,CSE 293,012,094916,Impagliazzo; Russell,9999,0,9999,0
1653519115860,CSE 293,013,094917,Jhala; Ranjit,9999,0,9999,0
1653519115860,CSE 293,014,094918,Kahng; Andrew Byun,9999,0,9999,0
1653519115860,CSE 293,015,094919,Kane; Daniel Mertz,9999,0,9999,0
1653519115860,CSE 293,016,094920,Kriegman; David J,9999,0,9999,0
1653519115860,CSE 293,017,094921,Kumar; Arun Kumar,9999,0,9999,0
1653519115860,CSE 293,018,094922,Lerner; Sorin,9999,0,9999,0
1653519115860,CSE 293,019,094923,Lovett; Shachar,9999,0,9999,0
1653519115860,CSE 293,020,094924,McAuley; Julian John,9999,0,9999,0
1653519115860,CSE 293,021,094925,Micciancio; Daniele,9999,0,9999,0
1653519115860,CSE 293,022,094926,Orailoglu; Alex,9999,0,9999,0
1653519115860,CSE 293,023,094927,Paturi; Ramamohan,9999,0,9999,0
1653519115860,CSE 293,024,094928,Polikarpova; Nadezhda,9999,0,9999,0
1653519115860,CSE 293,025,094929,Politz; Joseph Gibbs,9999,0,9999,0
1653519115860,CSE 293,026,094930,Porter; George M,9999,0,9999,0
1653519115860,CSE 293,027,094931,Porter; Leonard Emerson,9999,0,9999,0
1653519115860,CSE 293,028,094932,Ramamoorthi; Ravi,9999,0,9999,0
1653519115860,CSE 293,029,094933,Sahoo; Debashis,9999,0,9999,0
1653519115860,CSE 293,030,094934,Saul; Lawrence,9999,0,9999,0
1653519115860,CSE 293,031,094935,Savage; Stefan,9999,0,9999,0
1653519115860,CSE 293,032,094936,Schulze; Jurgen P.,9999,0,9999,0
1653519115860,CSE 293,033,094937,Snoeren; Alex C.,9999,0,9999,0
1653519115860,CSE 293,034,094938,Shang; Jingbo,9999,0,9999,0
1653519115860,CSE 293,035,094939,Stefan; Deian,9999,0,9999,0
1653519115860,CSE 293,036,094940,Su; Hao,9999,0,9999,0
1653519115860,CSE 293,037,094941,Swanson; Steven James,9999,0,9999,0
1653519115860,CSE 293,038,094942,Tullsen; Dean Michael,9999,0,9999,0
1653519115860,CSE 293,039,094943,Voelker; Geoffrey M.,9999,0,9999,0
1653519115860,CSE 293,040,094944,Zhao; Jishen,9999,0,9999,0
1653519115860,CSE 293,041,094945,Zhou; Yuan-Yuan,9999,0,9999,0
1653519115860,CSE 293,042,094946,Gao; Sicun,9998,0,9999,1
1653519115860,CSE 293,043,094947,Weibel; Nadir,9999,0,9999,0
1653519115860,CSE 293,044,094948,Gupta; Rajesh K.,9999,0,9999,0
1653519116385,CSE 294,A00,090143,Porter; George M,8,0,10,2
1653519116987,DSE 200,A00,091799,Staff,50,0,50,0
1653519117513,DSE 203,A00,091800,Gupta; Amarnath,30,0,30,0
1653519118036,DSE 250,A00,091801,Deutsch; Alin Bernard,30,0,30,0
1653519118622,DSE 290,A00,091802,Altintas De Callaf; Ilkay,50,0,50,0
1653519119201,ECE 200,001,091003,Antipa; Nicholas A,9999,0,9999,0
1653519119201,ECE 200,002,091004,Atanasov; Nikolay A.,9999,0,9999,0
1653519119201,ECE 200,003,091005,Bharadia; Dinesh,9999,0,9999,0
1653519119201,ECE 200,004,091006,Cheng; Chung Kuan,9999,0,9999,0
1653519119201,ECE 200,005,091007,Cosman; Pamela C.,9999,0,9999,0
1653519119201,ECE 200,006,091008,Staff,9999,0,9999,0
1653519119201,ECE 200,007,091009,Dayeh; Shadi Ahmad,9999,0,9999,0
1653519119201,ECE 200,008,091010,Fainman; Yeshaiahu,9999,0,9999,0
1653519119201,ECE 200,009,091011,Ford; Joseph Earl,9999,0,9999,0
1653519119201,ECE 200,010,091012,Franceschetti; Massimo,9999,0,9999,0
1653519119201,ECE 200,011,091013,Fullerton; Eric E,9999,0,9999,0
1653519119201,ECE 200,012,091014,Galton; Ian A,9999,0,9999,0
1653519119201,ECE 200,013,091015,Gilja; Vikash,9999,0,9999,0
1653519119201,ECE 200,014,091016,Hall; Drew A.,9999,0,9999,0
1653519119201,ECE 200,015,091017,Hsueh; Tzu-Chien,9999,0,9999,0
1653519119201,ECE 200,016,091018,Javidi; Tara,9999,0,9999,0
1653519119201,ECE 200,017,091019,Kahng; Andrew Byun,9999,0,9999,0
1653519119201,ECE 200,018,091020,Kim; Young-Han,9999,0,9999,0
1653519119201,ECE 200,019,091021,Koushanfar; Farinaz,9999,0,9999,0
1653519119201,ECE 200,020,091022,Kuzum; Duygu,9999,0,9999,0
1653519119201,ECE 200,021,091023,Le; Hanh-Phuc,9999,0,9999,0
1653519119201,ECE 200,022,091024,Lin; Bill,9999,0,9999,0
1653519119201,ECE 200,023,091025,Liu; Zhaowei,9999,0,9999,0
1653519119201,ECE 200,024,091026,Lo; Yu-Hwa,9999,0,9999,0
1653519119201,ECE 200,025,091027,Lomakin; Vitaliy,9999,0,9999,0
1653519119201,ECE 200,026,091028,Mercier; Patrick Philip,9999,0,9999,0
1653519119201,ECE 200,027,091029,Meyer; Florian,9999,0,9999,0
1653519119201,ECE 200,028,091030,Milstein; Laurence B.,9999,0,9999,0
1653519119201,ECE 200,029,091031,Mir Arabbaygi; Siavash,9999,0,9999,0
1653519119201,ECE 200,030,091032,Mookherjea; Shayan,9999,0,9999,0
1653519119201,ECE 200,031,091033,Morris; Karcher William,9999,0,9999,0
1653519119201,ECE 200,032,091034,Ng; Tse Nga,9999,0,9999,0
1653519119201,ECE 200,033,091035,Nguyen; Truong Quang,9999,0,9999,0
1653519119201,ECE 200,034,091036,Nomura; Kenji,9999,0,9999,0
1653519119201,ECE 200,035,091037,Orlitsky; Alon,9999,0,9999,0
1653519119201,ECE 200,036,091038,Pal; Piya,9999,0,9999,0
1653519119201,ECE 200,037,091039,Papen; George C.,9999,0,9999,0
1653519119201,ECE 200,038,091040,Radic; Stojan,9999,0,9999,0
1653519119201,ECE 200,039,091041,Rao; Bhaskar D.,9999,0,9999,0
1653519119201,ECE 200,040,091042,Rao; Ramesh R,9999,0,9999,0
1653519119201,ECE 200,041,091043,Rebeiz; Gabriel,9999,0,9999,0
1653519119201,ECE 200,042,091044,Sanford; John R,9999,0,9999,0
1653519119201,ECE 200,043,091045,Siegel; Paul H.,9999,0,9999,0
1653519119201,ECE 200,044,091046,Sievenpiper; Daniel F.,9999,0,9999,0
1653519119201,ECE 200,045,091047,Sworder; David D.,9999,0,9999,0
1653519119201,ECE 200,046,091048,Taur; Yuan,9999,0,9999,0
1653519119201,ECE 200,047,091049,Touri; Behrouz,9999,0,9999,0
1653519119201,ECE 200,048,091050,Trivedi; Mohan M.,9999,0,9999,0
1653519119201,ECE 200,049,091051,Vardy; Alexander,9999,0,9999,0
1653519119201,ECE 200,050,091052,Vasconcelos; Nuno,9999,0,9999,0
1653519119201,ECE 200,051,091053,Wang; Xiaolong,9999,0,9999,0
1653519119201,ECE 200,052,091054,Xie; Pengtao,9999,0,9999,0
1653519119201,ECE 200,053,091055,Yip; Michael,9999,0,9999,0
1653519119201,ECE 200,054,091056,Zeger; Kenneth A.,9999,0,9999,0
1653519119201,ECE 200,055,091057,Zhang; Xinyu,9999,0,9999,0
1653519119201,ECE 200,056,091058,Turakhia; Yatish Girish,9999,0,9999,0
1653519119201,ECE 200,057,091059,Kang; Mingu,9999,0,9999,0
1653519119201,ECE 200,058,091060,Shi; Yuanyuan,9999,0,9999,0
1653519119201,ECE 200,059,091061,Wang; Edward Jay,9999,0,9999,0
1653519119201,ECE 200,060,091062,Zheng; Yang,9999,0,9999,0
1653519119733,ECE 201,A00,095526,Lo; Yu-Hwa,0,0,0,0
1653519120259,ECE 203,A00,091065,Mercier; Patrick Philip,0,0,0,0
1653519120782,ECE 207A,A00,091605,Liu; Thomas Tao-Ming,0,0,0,0
1653519121307,ECE 212AN,A00,091068,Nomura; Kenji,0,0,0,0
1653519121831,ECE 222A,A00,091069,Rebeiz; Gabriel,0,0,0,0
1653519122354,ECE 225A,A00,091070,Orlitsky; Alon,0,0,0,0
1653519122876,ECE 230A,A00,091071,Nomura; Kenji,0,0,0,0
1653519123400,ECE 236A,A00,091072,Dayeh; Shadi Ahmad,0,0,0,0
1653519123922,ECE 238A,A00,091073,Luo; Jian,0,0,0,0
1653519123922,ECE 238A,B00,091074,Luo; Jian,0,0,0,0
1653519124454,ECE 240A,A00,091075,Radic; Stojan,0,0,0,0
1653519124982,ECE 247A,A00,091592,Shi; Lingyan,0,0,0,0
1653519125506,ECE 250,A00,091076,Touri; Behrouz,0,0,0,0
1653519126033,ECE 251C,A00,091078,Nguyen; Truong Quang,0,0,0,0
1653519126559,ECE 253,A00,091079,Cosman; Pamela C.,0,0,0,0
1653519127087,ECE 255A,A00,091080,Orlitsky; Alon,0,0,0,0
1653519127620,ECE 257A,A00,091081,Zhang; Xinyu,0,0,0,0
1653519128152,ECE 260A,A01,091084,Eldon; John,0,0,0,0
1653519128684,ECE 264C,A00,091085,Galton; Ian A,0,0,0,0
1653519129212,ECE 265C,A00,094889,Presti; Calogero Davide,0,0,0,9
1653519129742,ECE 266,A01,091087,Hall; Drew A.,0,0,0,0
1653519130792,ECE 271A,A00,091090,Vasconcelos; Nuno,0,0,0,0
1653519131319,ECE 272B,A00,091091,Sworder; David D.,0,0,0,0
1653519131856,ECE 275A,A00,091092,Meyer; Florian,0,0,0,0
1653519132379,ECE 277,A00,091093,An; Cheolhong,0,0,0,0
1653519132903,ECE 283,A00,091094,Le; Hanh-Phuc,0,0,0,0
1653519133434,ECE 284,A00,091095,Kang; Mingu,0,0,0,0
1653519133434,ECE 284,B00,091096,Wang; Edward Jay,0,0,0,0
1653519133956,ECE 285,A00,094334,Touri; Behrouz,0,0,0,0
1653519134480,ECE 289,A00,091097,Whelan; David Arthur,0,0,0,0
1653519135004,MATH 200A,A00,087414,Salehi Golsefidy; Alireza,7,0,8,1
1653519135527,MATH 202A,A00,087415,Gill; Philip E.,3,0,8,5
1653519136048,MATH 203A,A00,087416,Oprea; Dragos N.,6,0,8,2
1653519136572,MATH 204A,A00,087417,Kedlaya; Kiran S.,6,0,8,2
1653519137099,MATH 205,A00,087418,Sorensen; Claus M,6,0,8,2
1653519137624,MATH 206A,A00,087419,Izadi; Elham,7,0,8,1
1653519138152,MATH 207A,A00,087420,Mohammadi; Amir,5,0,8,3
1653519138688,MATH 208,A00,087421,Staff,9,0,10,1
1653519139212,MATH 209,A00,087422,Staff,10,0,10,0
1653519139747,MATH 218,A00,087423,Staff,10,0,10,0
1653519140273,MATH 220A,A00,087424,Novak; Jonathan I,7,0,8,1
1653519140803,MATH 231A,A00,087425,Bejenaru; Ioan,3,0,8,5
1653519141327,MATH 240A,A00,087426,Ebenfelt; Peter F,5,0,8,3
1653519141852,MATH 243,A00,087427,Staff,9,0,10,1
1653519142378,MATH 248,A00,087429,Staff,10,0,10,0
1653519142908,MATH 250A,A00,087430,Spolaor; Luca,4,0,8,4
1653519143435,MATH 257A,A00,087431,Spolaor; Luca,7,0,8,1
1653519143960,MATH 258,A00,087432,Staff,9,0,10,1
1653519144486,MATH 264A,A00,087433,Warnke; Lutz Peter,5,0,8,3
1653519145013,MATH 268,A00,087434,Staff,15,0,15,0
1653519145535,MATH 269,A00,087435,Staff,14,0,15,1
1653519146059,MATH 270A,A00,087436,Nie; Jiawang,0,0,8,8
1653519146587,MATH 272A,A00,087437,Tian; Xiaochuan,1,0,8,7
1653519147112,MATH 274,A01,087439,Cheng; Li-Tien,9,0,10,1
1653519147112,MATH 274,A02,087440,Cheng; Li-Tien,10,0,10,0
1653519147638,MATH 278A,A00,087441,Staff,8,0,10,2
1653519148164,MATH 278B,A00,087442,Staff,8,0,10,2
1653519148688,MATH 278C,A00,087443,Staff,8,0,10,2
1653519149219,MATH 280A,A00,087444,Zheng; Tianyi,0,0,8,8
1653519149742,MATH 281A,A00,087445,Bradic; Jelena,0,0,8,8
1653519150269,MATH 282A,A00,087446,Zhang; Danna,0,0,8,8
1653519150792,MATH 283,A00,087447,Tesler; Glenn,0,0,0,15
1653519151323,MATH 286,A00,087448,Kemp; Todd Aahron,5,0,8,3
1653519151846,MATH 287D,A00,087449,Bradic; Jelena,8,0,8,0
1653519152372,MATH 288,A00,087450,Staff,14,0,15,1
1653519152372,MATH 288,B00,087451,Staff,15,0,15,0
1653519152372,MATH 288,C00,087452,Staff,15,0,15,0
1653519152898,MATH 290A,A00,087453,Xu; Zhouli,6,0,8,2
1653519153423,MATH 291A,A00,087454,Xu; Zhouli,7,0,8,1
1653519153949,MATH 292,A00,087455,Staff,10,0,10,0
1653519154475,MATH 295,A00,087456,Staff,50,0,50,0
1653519154998,MATH 297,001,087457,Staff,998,0,999,1
1653519717210,COGS 200,A01,087991,Staff,47,0,50,3
1653519717737,COGS 201,A01,094504,Rangel; Lara M,17,0,25,8
1653519718262,COGS 203,A00,087992,Coulson; Seana M,18,0,20,2
1653519718785,COGS 210A,001,087993,Greene; Deanna Jacquelyn,9998,0,9999,1
1653519718785,COGS 210A,002,087994,Saygin; Ayse P,9999,0,9999,0
1653519718785,COGS 210A,003,087995,Xia; Haijun,9999,0,9999,0
1653519718785,COGS 210A,004,087996,Nitz; Douglas A.,9999,0,9999,0
1653519718785,COGS 210A,005,087997,Hollan; James D.,9999,0,9999,0
1653519718785,COGS 210A,006,087998,Deak; Gedeon O.,9998,0,9999,1
1653519718785,COGS 210A,007,087999,Rossano; Federico,9999,0,9999,0
1653519719311,COGS 211A,A00,088000,Coulson; Seana M,9997,0,9999,2
1653519719834,COGS 229,A00,088002,Staff,23,0,25,2
1653519720357,COGS 260,B00,094231,Staff,17,0,20,3
1653519720357,COGS 260,A00,088004,Nitz; Douglas A.,9998,0,9999,1
1653519720888,CSE 202,A00,090110,Paturi; Ramamohan,0,0,0,0
1653519720888,CSE 202,B00,090111,Paturi; Ramamohan,0,0,0,0
1653519721410,CSE 207B,A00,090112,Heninger; Nadia A,0,0,0,0
1653519721950,CSE 208,A00,094858,Micciancio; Daniele,0,0,0,0
1653519722472,CSE 210,A00,090113,Powell; Thomas Allan,0,0,0,0
1653519722997,CSE 219,A00,090898,Staff,0,0,0,0
1653519723532,CSE 221,A00,090114,Zhou; Yuan-Yuan,0,0,0,0
1653519724056,CSE 229A,A00,090115,Porter; George M,0,0,0,0
1653519724594,CSE 229C,A00,090116,Savage; Stefan,0,0,0,0
1653519725128,CSE 230,A00,090117,Jhala; Ranjit,0,0,0,0
1653519725653,CSE 232,A00,090118,Papakonstantinou; Yannis,0,0,0,0
1653519726179,CSE 239A,A00,090121,Kumar; Arun Kumar,0,0,0,0
1653519726703,CSE 239B,A00,090122,Jhala; Ranjit,0,0,0,0
1653519727228,CSE 240A,A00,090123,Zhao; Jishen,0,0,189,189
1653519727754,CSE 243A,A00,090124,Orailoglu; Alex,0,0,15,15
1653519728275,CSE 249B,A00,090125,Kahng; Andrew Byun,13,0,20,7
1653519728799,CSE 250A,A00,090126,Berg-Kirkpatrick; Taylor D,0,0,0,0
1653519729321,CSE 252A,A00,090127,Ochoa; Benjamin Lawrence,0,0,0,0
1653519729850,CSE 258,A01,090129,McAuley; Julian John,0,0,0,0
1653519730380,CSE 258R,A01,090131,McAuley; Julian John,0,0,0,0
1653519730902,CSE 274,A00,090132,Ramamoorthi; Ravi,0,0,0,0
1653519731433,CSE 276A,A00,090133,Christensen; Henrik I,0,0,0,0
1653519731963,CSE 276C,A00,090134,Christensen; Henrik I,0,0,0,0
1653519732493,CSE 290,A00,090135,Bafna; Vineet,0,0,0,0
1653519732493,CSE 290,B00,090136,Ramamoorthi; Ravi,0,0,0,0
1653519732493,CSE 290,C00,090137,Li; Tzumao,8,0,10,2
1653519732493,CSE 290,D00,090138,Zhou; Yuan-Yuan,9,0,10,1
1653519732493,CSE 290,E00,090139,Christensen; Henrik I,9,0,10,1
1653519732493,CSE 290,F00,094053,Shalev; Aaron D,0,0,0,0
1653519733017,CSE 291,A00,090140,Munyaka; Imani N. S.,0,0,0,0
1653519733017,CSE 291,B00,094880,Yu; Qi,0,0,0,0
1653519733017,CSE 291,C00,090142,Pannuto; Patrick William,0,0,0,0
1653519733017,CSE 291,D00,094881,Zhang; Yiying,0,0,0,0
1653519733017,CSE 291,E00,095118,Su; Hao,0,0,0,0
1653519733573,CSE 293,001,094905,Bafna; Vineet,9999,0,9999,0
1653519733573,CSE 293,002,094906,Bellare; Mihir,9999,0,9999,0
1653519733573,CSE 293,003,094907,Berg-Kirkpatrick; Taylor D,9999,0,9999,0
1653519733573,CSE 293,004,094908,Christensen; Henrik I,9999,0,9999,0
1653519733573,CSE 293,005,094909,Cottrell; Garrison W,9999,0,9999,0
1653519733573,CSE 293,006,094910,Deutsch; Alin Bernard,9999,0,9999,0
1653519733573,CSE 293,007,094911,Esmaeilzadeh; Hadi,9999,0,9999,0
1653519733573,CSE 293,008,094912,Freund; Yoav,9999,0,9999,0
1653519733573,CSE 293,009,094913,Griswold; William G.,9999,0,9999,0
1653519733573,CSE 293,010,094914,Gymrek; Melissa Ann,9999,0,9999,0
1653519733573,CSE 293,011,094915,Heninger; Nadia A,9999,0,9999,0
1653519733573,CSE 293,012,094916,Impagliazzo; Russell,9999,0,9999,0
1653519733573,CSE 293,013,094917,Jhala; Ranjit,9999,0,9999,0
1653519733573,CSE 293,014,094918,Kahng; Andrew Byun,9999,0,9999,0
1653519733573,CSE 293,015,094919,Kane; Daniel Mertz,9999,0,9999,0
1653519733573,CSE 293,016,094920,Kriegman; David J,9999,0,9999,0
1653519733573,CSE 293,017,094921,Kumar; Arun Kumar,9999,0,9999,0
1653519733573,CSE 293,018,094922,Lerner; Sorin,9999,0,9999,0
1653519733573,CSE 293,019,094923,Lovett; Shachar,9999,0,9999,0
1653519733573,CSE 293,020,094924,McAuley; Julian John,9999,0,9999,0
1653519733573,CSE 293,021,094925,Micciancio; Daniele,9999,0,9999,0
1653519733573,CSE 293,022,094926,Orailoglu; Alex,9999,0,9999,0
1653519733573,CSE 293,023,094927,Paturi; Ramamohan,9999,0,9999,0
1653519733573,CSE 293,024,094928,Polikarpova; Nadezhda,9999,0,9999,0
1653519733573,CSE 293,025,094929,Politz; Joseph Gibbs,9999,0,9999,0
1653519733573,CSE 293,026,094930,Porter; George M,9999,0,9999,0
1653519733573,CSE 293,027,094931,Porter; Leonard Emerson,9999,0,9999,0
1653519733573,CSE 293,028,094932,Ramamoorthi; Ravi,9999,0,9999,0
1653519733573,CSE 293,029,094933,Sahoo; Debashis,9999,0,9999,0
1653519733573,CSE 293,030,094934,Saul; Lawrence,9999,0,9999,0
1653519733573,CSE 293,031,094935,Savage; Stefan,9999,0,9999,0
1653519733573,CSE 293,032,094936,Schulze; Jurgen P.,9999,0,9999,0
1653519733573,CSE 293,033,094937,Snoeren; Alex C.,9999,0,9999,0
1653519733573,CSE 293,034,094938,Shang; Jingbo,9999,0,9999,0
1653519733573,CSE 293,035,094939,Stefan; Deian,9999,0,9999,0
1653519733573,CSE 293,036,094940,Su; Hao,9999,0,9999,0
1653519733573,CSE 293,037,094941,Swanson; Steven James,9999,0,9999,0
1653519733573,CSE 293,038,094942,Tullsen; Dean Michael,9999,0,9999,0
1653519733573,CSE 293,039,094943,Voelker; Geoffrey M.,9999,0,9999,0
1653519733573,CSE 293,040,094944,Zhao; Jishen,9999,0,9999,0
1653519733573,CSE 293,041,094945,Zhou; Yuan-Yuan,9999,0,9999,0
1653519733573,CSE 293,042,094946,Gao; Sicun,9998,0,9999,1
1653519733573,CSE 293,043,094947,Weibel; Nadir,9999,0,9999,0
1653519733573,CSE 293,044,094948,Gupta; Rajesh K.,9999,0,9999,0
1653519734096,CSE 294,A00,090143,Porter; George M,8,0,10,2
1653519734625,DSE 200,A00,091799,Staff,50,0,50,0
1653519735154,DSE 203,A00,091800,Gupta; Amarnath,30,0,30,0
1653519735678,DSE 250,A00,091801,Deutsch; Alin Bernard,30,0,30,0
1653519736202,DSE 290,A00,091802,Altintas De Callaf; Ilkay,50,0,50,0
1653519736755,ECE 200,001,091003,Antipa; Nicholas A,9999,0,9999,0
1653519736755,ECE 200,002,091004,Atanasov; Nikolay A.,9999,0,9999,0
1653519736755,ECE 200,003,091005,Bharadia; Dinesh,9999,0,9999,0
1653519736755,ECE 200,004,091006,Cheng; Chung Kuan,9999,0,9999,0
1653519736755,ECE 200,005,091007,Cosman; Pamela C.,9999,0,9999,0
1653519736755,ECE 200,006,091008,Staff,9999,0,9999,0
1653519736755,ECE 200,007,091009,Dayeh; Shadi Ahmad,9999,0,9999,0
1653519736755,ECE 200,008,091010,Fainman; Yeshaiahu,9999,0,9999,0
1653519736755,ECE 200,009,091011,Ford; Joseph Earl,9999,0,9999,0
1653519736755,ECE 200,010,091012,Franceschetti; Massimo,9999,0,9999,0
1653519736755,ECE 200,011,091013,Fullerton; Eric E,9999,0,9999,0
1653519736755,ECE 200,012,091014,Galton; Ian A,9999,0,9999,0
1653519736755,ECE 200,013,091015,Gilja; Vikash,9999,0,9999,0
1653519736755,ECE 200,014,091016,Hall; Drew A.,9999,0,9999,0
1653519736755,ECE 200,015,091017,Hsueh; Tzu-Chien,9999,0,9999,0
1653519736755,ECE 200,016,091018,Javidi; Tara,9999,0,9999,0
1653519736755,ECE 200,017,091019,Kahng; Andrew Byun,9999,0,9999,0
1653519736755,ECE 200,018,091020,Kim; Young-Han,9999,0,9999,0
1653519736755,ECE 200,019,091021,Koushanfar; Farinaz,9999,0,9999,0
1653519736755,ECE 200,020,091022,Kuzum; Duygu,9999,0,9999,0
1653519736755,ECE 200,021,091023,Le; Hanh-Phuc,9999,0,9999,0
1653519736755,ECE 200,022,091024,Lin; Bill,9999,0,9999,0
1653519736755,ECE 200,023,091025,Liu; Zhaowei,9999,0,9999,0
1653519736755,ECE 200,024,091026,Lo; Yu-Hwa,9999,0,9999,0
1653519736755,ECE 200,025,091027,Lomakin; Vitaliy,9999,0,9999,0
1653519736755,ECE 200,026,091028,Mercier; Patrick Philip,9999,0,9999,0
1653519736755,ECE 200,027,091029,Meyer; Florian,9999,0,9999,0
1653519736755,ECE 200,028,091030,Milstein; Laurence B.,9999,0,9999,0
1653519736755,ECE 200,029,091031,Mir Arabbaygi; Siavash,9999,0,9999,0
1653519736755,ECE 200,030,091032,Mookherjea; Shayan,9999,0,9999,0
1653519736755,ECE 200,031,091033,Morris; Karcher William,9999,0,9999,0
1653519736755,ECE 200,032,091034,Ng; Tse Nga,9999,0,9999,0
1653519736755,ECE 200,033,091035,Nguyen; Truong Quang,9999,0,9999,0
1653519736755,ECE 200,034,091036,Nomura; Kenji,9999,0,9999,0
1653519736755,ECE 200,035,091037,Orlitsky; Alon,9999,0,9999,0
1653519736755,ECE 200,036,091038,Pal; Piya,9999,0,9999,0
1653519736755,ECE 200,037,091039,Papen; George C.,9999,0,9999,0
1653519736755,ECE 200,038,091040,Radic; Stojan,9999,0,9999,0
1653519736755,ECE 200,039,091041,Rao; Bhaskar D.,9999,0,9999,0
1653519736755,ECE 200,040,091042,Rao; Ramesh R,9999,0,9999,0
1653519736755,ECE 200,041,091043,Rebeiz; Gabriel,9999,0,9999,0
1653519736755,ECE 200,042,091044,Sanford; John R,9999,0,9999,0
1653519736755,ECE 200,043,091045,Siegel; Paul H.,9999,0,9999,0
1653519736755,ECE 200,044,091046,Sievenpiper; Daniel F.,9999,0,9999,0
1653519736755,ECE 200,045,091047,Sworder; David D.,9999,0,9999,0
1653519736755,ECE 200,046,091048,Taur; Yuan,9999,0,9999,0
1653519736755,ECE 200,047,091049,Touri; Behrouz,9999,0,9999,0
1653519736755,ECE 200,048,091050,Trivedi; Mohan M.,9999,0,9999,0
1653519736755,ECE 200,049,091051,Vardy; Alexander,9999,0,9999,0
1653519736755,ECE 200,050,091052,Vasconcelos; Nuno,9999,0,9999,0
1653519736755,ECE 200,051,091053,Wang; Xiaolong,9999,0,9999,0
1653519736755,ECE 200,052,091054,Xie; Pengtao,9999,0,9999,0
1653519736755,ECE 200,053,091055,Yip; Michael,9999,0,9999,0
1653519736755,ECE 200,054,091056,Zeger; Kenneth A.,9999,0,9999,0
1653519736755,ECE 200,055,091057,Zhang; Xinyu,9999,0,9999,0
1653519736755,ECE 200,056,091058,Turakhia; Yatish Girish,9999,0,9999,0
1653519736755,ECE 200,057,091059,Kang; Mingu,9999,0,9999,0
1653519736755,ECE 200,058,091060,Shi; Yuanyuan,9999,0,9999,0
1653519736755,ECE 200,059,091061,Wang; Edward Jay,9999,0,9999,0
1653519736755,ECE 200,060,091062,Zheng; Yang,9999,0,9999,0
1653519737296,ECE 201,A00,095526,Lo; Yu-Hwa,0,0,0,0
1653519737825,ECE 203,A00,091065,Mercier; Patrick Philip,0,0,0,0
1653519738348,ECE 207A,A00,091605,Liu; Thomas Tao-Ming,0,0,0,0
1653519738874,ECE 212AN,A00,091068,Nomura; Kenji,0,0,0,0
1653519739398,ECE 222A,A00,091069,Rebeiz; Gabriel,0,0,0,0
1653519739928,ECE 225A,A00,091070,Orlitsky; Alon,0,0,0,0
1653519740458,ECE 230A,A00,091071,Nomura; Kenji,0,0,0,0
1653519740983,ECE 236A,A00,091072,Dayeh; Shadi Ahmad,0,0,0,0
1653519741508,ECE 238A,A00,091073,Luo; Jian,0,0,0,0
1653519741508,ECE 238A,B00,091074,Luo; Jian,0,0,0,0
1653519742035,ECE 240A,A00,091075,Radic; Stojan,0,0,0,0
1653519742561,ECE 247A,A00,091592,Shi; Lingyan,0,0,0,0
1653519743087,ECE 250,A00,091076,Touri; Behrouz,0,0,0,0
1653519743613,ECE 251C,A00,091078,Nguyen; Truong Quang,0,0,0,0
1653519744139,ECE 253,A00,091079,Cosman; Pamela C.,0,0,0,0
1653519744661,ECE 255A,A00,091080,Orlitsky; Alon,0,0,0,0
1653519745185,ECE 257A,A00,091081,Zhang; Xinyu,0,0,0,0
1653519745711,ECE 260A,A01,091084,Eldon; John,0,0,0,0
1653519746241,ECE 264C,A00,091085,Galton; Ian A,0,0,0,0
1653519746763,ECE 265C,A00,094889,Presti; Calogero Davide,0,0,0,9
1653519747285,ECE 266,A01,091087,Hall; Drew A.,0,0,0,0
1653519748344,ECE 271A,A00,091090,Vasconcelos; Nuno,0,0,0,0
1653519748869,ECE 272B,A00,091091,Sworder; David D.,0,0,0,0
1653519749390,ECE 275A,A00,091092,Meyer; Florian,0,0,0,0
1653519749914,ECE 277,A00,091093,An; Cheolhong,0,0,0,0
1653519750454,ECE 283,A00,091094,Le; Hanh-Phuc,0,0,0,0
1653519750984,ECE 284,A00,091095,Kang; Mingu,0,0,0,0
1653519750984,ECE 284,B00,091096,Wang; Edward Jay,0,0,0,0
1653519751506,ECE 285,A00,094334,Touri; Behrouz,0,0,0,0
1653519752043,ECE 289,A00,091097,Whelan; David Arthur,0,0,0,0
1653519752566,MATH 200A,A00,087414,Salehi Golsefidy; Alireza,7,0,8,1
1653519753114,MATH 202A,A00,087415,Gill; Philip E.,3,0,8,5
1653519753641,MATH 203A,A00,087416,Oprea; Dragos N.,6,0,8,2
1653519754170,MATH 204A,A00,087417,Kedlaya; Kiran S.,6,0,8,2
1653519754697,MATH 205,A00,087418,Sorensen; Claus M,6,0,8,2
1653519755234,MATH 206A,A00,087419,Izadi; Elham,7,0,8,1
1653519755768,MATH 207A,A00,087420,Mohammadi; Amir,5,0,8,3
1653519756297,MATH 208,A00,087421,Staff,9,0,10,1
1653519756824,MATH 209,A00,087422,Staff,10,0,10,0
1653519757347,MATH 218,A00,087423,Staff,10,0,10,0
1653519757888,MATH 220A,A00,087424,Novak; Jonathan I,7,0,8,1
1653519758411,MATH 231A,A00,087425,Bejenaru; Ioan,3,0,8,5
1653519758935,MATH 240A,A00,087426,Ebenfelt; Peter F,5,0,8,3
1653519759472,MATH 243,A00,087427,Staff,9,0,10,1
1653519760069,MATH 248,A00,087429,Staff,10,0,10,0
1653519760593,MATH 250A,A00,087430,Spolaor; Luca,4,0,8,4
1653519761131,MATH 257A,A00,087431,Spolaor; Luca,7,0,8,1
1653519761668,MATH 258,A00,087432,Staff,9,0,10,1
1653519762190,MATH 264A,A00,087433,Warnke; Lutz Peter,5,0,8,3
1653519762713,MATH 268,A00,087434,Staff,15,0,15,0
1653519763243,MATH 269,A00,087435,Staff,14,0,15,1
1653519763775,MATH 270A,A00,087436,Nie; Jiawang,0,0,8,8
1653519764301,MATH 272A,A00,087437,Tian; Xiaochuan,1,0,8,7
1653519764835,MATH 274,A01,087439,Cheng; Li-Tien,9,0,10,1
1653519764835,MATH 274,A02,087440,Cheng; Li-Tien,10,0,10,0
1653519765369,MATH 278A,A00,087441,Staff,8,0,10,2
1653519765893,MATH 278B,A00,087442,Staff,8,0,10,2
1653519766424,MATH 278C,A00,087443,Staff,8,0,10,2
1653519766947,MATH 280A,A00,087444,Zheng; Tianyi,0,0,8,8
1653519767470,MATH 281A,A00,087445,Bradic; Jelena,0,0,8,8
1653519767992,MATH 282A,A00,087446,Zhang; Danna,0,0,8,8
1653519768525,MATH 283,A00,087447,Tesler; Glenn,0,0,0,15
1653519769051,MATH 286,A00,087448,Kemp; Todd Aahron,5,0,8,3
1653519769589,MATH 287D,A00,087449,Bradic; Jelena,8,0,8,0
1653519770118,MATH 288,A00,087450,Staff,14,0,15,1
1653519770118,MATH 288,B00,087451,Staff,15,0,15,0
1653519770118,MATH 288,C00,087452,Staff,15,0,15,0
1653519770640,MATH 290A,A00,087453,Xu; Zhouli,6,0,8,2
1653519771164,MATH 291A,A00,087454,Xu; Zhouli,7,0,8,1
1653519771697,MATH 292,A00,087455,Staff,10,0,10,0
1653519772219,MATH 295,A00,087456,Staff,50,0,50,0
1653519772749,MATH 297,001,087457,Staff,998,0,999,1
1653520334438,COGS 200,A01,087991,Staff,47,0,50,3
1653520334964,COGS 201,A01,094504,Rangel; Lara M,17,0,25,8
1653520335490,COGS 203,A00,087992,Coulson; Seana M,18,0,20,2
1653520336016,COGS 210A,001,087993,Greene; Deanna Jacquelyn,9998,0,9999,1
1653520336016,COGS 210A,002,087994,Saygin; Ayse P,9999,0,9999,0
1653520336016,COGS 210A,003,087995,Xia; Haijun,9999,0,9999,0
1653520336016,COGS 210A,004,087996,Nitz; Douglas A.,9999,0,9999,0
1653520336016,COGS 210A,005,087997,Hollan; James D.,9999,0,9999,0
1653520336016,COGS 210A,006,087998,Deak; Gedeon O.,9998,0,9999,1
1653520336016,COGS 210A,007,087999,Rossano; Federico,9999,0,9999,0
1653520336539,COGS 211A,A00,088000,Coulson; Seana M,9997,0,9999,2
1653520337062,COGS 229,A00,088002,Staff,23,0,25,2
1653520337598,COGS 260,B00,094231,Staff,17,0,20,3
1653520337598,COGS 260,A00,088004,Nitz; Douglas A.,9998,0,9999,1
1653520338132,CSE 202,A00,090110,Paturi; Ramamohan,0,0,0,0
1653520338132,CSE 202,B00,090111,Paturi; Ramamohan,0,0,0,0
1653520338660,CSE 207B,A00,090112,Heninger; Nadia A,0,0,0,0
1653520339183,CSE 208,A00,094858,Micciancio; Daniele,0,0,0,0
1653520339714,CSE 210,A00,090113,Powell; Thomas Allan,0,0,0,0
1653520340239,CSE 219,A00,090898,Staff,0,0,0,0
1653520340762,CSE 221,A00,090114,Zhou; Yuan-Yuan,0,0,0,0
1653520341284,CSE 229A,A00,090115,Porter; George M,0,0,0,0
1653520341809,CSE 229C,A00,090116,Savage; Stefan,0,0,0,0
1653520342347,CSE 230,A00,090117,Jhala; Ranjit,0,0,0,0
1653520342869,CSE 232,A00,090118,Papakonstantinou; Yannis,0,0,0,0
1653520343393,CSE 239A,A00,090121,Kumar; Arun Kumar,0,0,0,0
1653520343926,CSE 239B,A00,090122,Jhala; Ranjit,0,0,0,0
1653520344456,CSE 240A,A00,090123,Zhao; Jishen,0,0,189,189
1653520344991,CSE 243A,A00,090124,Orailoglu; Alex,0,0,15,15
1653520345518,CSE 249B,A00,090125,Kahng; Andrew Byun,13,0,20,7
1653520346044,CSE 250A,A00,090126,Berg-Kirkpatrick; Taylor D,0,0,0,0
1653520346575,CSE 252A,A00,090127,Ochoa; Benjamin Lawrence,0,0,0,0
1653520347101,CSE 258,A01,090129,McAuley; Julian John,0,0,0,0
1653520347623,CSE 258R,A01,090131,McAuley; Julian John,0,0,0,0
1653520348150,CSE 274,A00,090132,Ramamoorthi; Ravi,0,0,0,0
1653520348683,CSE 276A,A00,090133,Christensen; Henrik I,0,0,0,0
1653520349299,CSE 276C,A00,090134,Christensen; Henrik I,0,0,0,0
1653520349820,CSE 290,A00,090135,Bafna; Vineet,0,0,0,0
1653520349820,CSE 290,B00,090136,Ramamoorthi; Ravi,0,0,0,0
1653520349820,CSE 290,C00,090137,Li; Tzumao,8,0,10,2
1653520349820,CSE 290,D00,090138,Zhou; Yuan-Yuan,9,0,10,1
1653520349820,CSE 290,E00,090139,Christensen; Henrik I,9,0,10,1
1653520349820,CSE 290,F00,094053,Shalev; Aaron D,0,0,0,0
1653520350345,CSE 291,A00,090140,Munyaka; Imani N. S.,0,0,0,0
1653520350345,CSE 291,B00,094880,Yu; Qi,0,0,0,0
1653520350345,CSE 291,C00,090142,Pannuto; Patrick William,0,0,0,0
1653520350345,CSE 291,D00,094881,Zhang; Yiying,0,0,0,0
1653520350345,CSE 291,E00,095118,Su; Hao,0,0,0,0
1653520350884,CSE 293,001,094905,Bafna; Vineet,9999,0,9999,0
1653520350884,CSE 293,002,094906,Bellare; Mihir,9999,0,9999,0
1653520350884,CSE 293,003,094907,Berg-Kirkpatrick; Taylor D,9999,0,9999,0
1653520350884,CSE 293,004,094908,Christensen; Henrik I,9999,0,9999,0
1653520350884,CSE 293,005,094909,Cottrell; Garrison W,9999,0,9999,0
1653520350884,CSE 293,006,094910,Deutsch; Alin Bernard,9999,0,9999,0
1653520350884,CSE 293,007,094911,Esmaeilzadeh; Hadi,9999,0,9999,0
1653520350884,CSE 293,008,094912,Freund; Yoav,9999,0,9999,0
1653520350884,CSE 293,009,094913,Griswold; William G.,9999,0,9999,0
1653520350884,CSE 293,010,094914,Gymrek; Melissa Ann,9999,0,9999,0
1653520350884,CSE 293,011,094915,Heninger; Nadia A,9999,0,9999,0
1653520350884,CSE 293,012,094916,Impagliazzo; Russell,9999,0,9999,0
1653520350884,CSE 293,013,094917,Jhala; Ranjit,9999,0,9999,0
1653520350884,CSE 293,014,094918,Kahng; Andrew Byun,9999,0,9999,0
1653520350884,CSE 293,015,094919,Kane; Daniel Mertz,9999,0,9999,0
1653520350884,CSE 293,016,094920,Kriegman; David J,9999,0,9999,0
1653520350884,CSE 293,017,094921,Kumar; Arun Kumar,9999,0,9999,0
1653520350884,CSE 293,018,094922,Lerner; Sorin,9999,0,9999,0
1653520350884,CSE 293,019,094923,Lovett; Shachar,9999,0,9999,0
1653520350884,CSE 293,020,094924,McAuley; Julian John,9999,0,9999,0
1653520350884,CSE 293,021,094925,Micciancio; Daniele,9999,0,9999,0
1653520350884,CSE 293,022,094926,Orailoglu; Alex,9999,0,9999,0
1653520350884,CSE 293,023,094927,Paturi; Ramamohan,9999,0,9999,0
1653520350884,CSE 293,024,094928,Polikarpova; Nadezhda,9999,0,9999,0
1653520350884,CSE 293,025,094929,Politz; Joseph Gibbs,9999,0,9999,0
1653520350884,CSE 293,026,094930,Porter; George M,9999,0,9999,0
1653520350884,CSE 293,027,094931,Porter; Leonard Emerson,9999,0,9999,0
1653520350884,CSE 293,028,094932,Ramamoorthi; Ravi,9999,0,9999,0
1653520350884,CSE 293,029,094933,Sahoo; Debashis,9999,0,9999,0
1653520350884,CSE 293,030,094934,Saul; Lawrence,9999,0,9999,0
1653520350884,CSE 293,031,094935,Savage; Stefan,9999,0,9999,0
1653520350884,CSE 293,032,094936,Schulze; Jurgen P.,9999,0,9999,0
1653520350884,CSE 293,033,094937,Snoeren; Alex C.,9999,0,9999,0
1653520350884,CSE 293,034,094938,Shang; Jingbo,9999,0,9999,0
1653520350884,CSE 293,035,094939,Stefan; Deian,9999,0,9999,0
1653520350884,CSE 293,036,094940,Su; Hao,9999,0,9999,0
1653520350884,CSE 293,037,094941,Swanson; Steven James,9999,0,9999,0
1653520350884,CSE 293,038,094942,Tullsen; Dean Michael,9999,0,9999,0
1653520350884,CSE 293,039,094943,Voelker; Geoffrey M.,9999,0,9999,0
1653520350884,CSE 293,040,094944,Zhao; Jishen,9999,0,9999,0
1653520350884,CSE 293,041,094945,Zhou; Yuan-Yuan,9999,0,9999,0
1653520350884,CSE 293,042,094946,Gao; Sicun,9998,0,9999,1
1653520350884,CSE 293,043,094947,Weibel; Nadir,9999,0,9999,0
1653520350884,CSE 293,044,094948,Gupta; Rajesh K.,9999,0,9999,0
1653520351417,CSE 294,A00,090143,Porter; George M,8,0,10,2
1653520351941,DSE 200,A00,091799,Staff,50,0,50,0
1653520352466,DSE 203,A00,091800,Gupta; Amarnath,30,0,30,0
1653520352989,DSE 250,A00,091801,Deutsch; Alin Bernard,30,0,30,0
1653520353512,DSE 290,A00,091802,Altintas De Callaf; Ilkay,50,0,50,0
1653520354059,ECE 200,001,091003,Antipa; Nicholas A,9999,0,9999,0
1653520354059,ECE 200,002,091004,Atanasov; Nikolay A.,9999,0,9999,0
1653520354059,ECE 200,003,091005,Bharadia; Dinesh,9999,0,9999,0
1653520354059,ECE 200,004,091006,Cheng; Chung Kuan,9999,0,9999,0
1653520354059,ECE 200,005,091007,Cosman; Pamela C.,9999,0,9999,0
1653520354059,ECE 200,006,091008,Staff,9999,0,9999,0
1653520354059,ECE 200,007,091009,Dayeh; Shadi Ahmad,9999,0,9999,0
1653520354059,ECE 200,008,091010,Fainman; Yeshaiahu,9999,0,9999,0
1653520354059,ECE 200,009,091011,Ford; Joseph Earl,9999,0,9999,0
1653520354059,ECE 200,010,091012,Franceschetti; Massimo,9999,0,9999,0
1653520354059,ECE 200,011,091013,Fullerton; Eric E,9999,0,9999,0
1653520354059,ECE 200,012,091014,Galton; Ian A,9999,0,9999,0
1653520354059,ECE 200,013,091015,Gilja; Vikash,9999,0,9999,0
1653520354059,ECE 200,014,091016,Hall; Drew A.,9999,0,9999,0
1653520354059,ECE 200,015,091017,Hsueh; Tzu-Chien,9999,0,9999,0
1653520354059,ECE 200,016,091018,Javidi; Tara,9999,0,9999,0
1653520354059,ECE 200,017,091019,Kahng; Andrew Byun,9999,0,9999,0
1653520354059,ECE 200,018,091020,Kim; Young-Han,9999,0,9999,0
1653520354059,ECE 200,019,091021,Koushanfar; Farinaz,9999,0,9999,0
1653520354059,ECE 200,020,091022,Kuzum; Duygu,9999,0,9999,0
1653520354059,ECE 200,021,091023,Le; Hanh-Phuc,9999,0,9999,0
1653520354059,ECE 200,022,091024,Lin; Bill,9999,0,9999,0
1653520354059,ECE 200,023,091025,Liu; Zhaowei,9999,0,9999,0
1653520354059,ECE 200,024,091026,Lo; Yu-Hwa,9999,0,9999,0
1653520354059,ECE 200,025,091027,Lomakin; Vitaliy,9999,0,9999,0
1653520354059,ECE 200,026,091028,Mercier; Patrick Philip,9999,0,9999,0
1653520354059,ECE 200,027,091029,Meyer; Florian,9999,0,9999,0
1653520354059,ECE 200,028,091030,Milstein; Laurence B.,9999,0,9999,0
1653520354059,ECE 200,029,091031,Mir Arabbaygi; Siavash,9999,0,9999,0
1653520354059,ECE 200,030,091032,Mookherjea; Shayan,9999,0,9999,0
1653520354059,ECE 200,031,091033,Morris; Karcher William,9999,0,9999,0
1653520354059,ECE 200,032,091034,Ng; Tse Nga,9999,0,9999,0
1653520354059,ECE 200,033,091035,Nguyen; Truong Quang,9999,0,9999,0
1653520354059,ECE 200,034,091036,Nomura; Kenji,9999,0,9999,0
1653520354059,ECE 200,035,091037,Orlitsky; Alon,9999,0,9999,0
1653520354059,ECE 200,036,091038,Pal; Piya,9999,0,9999,0
1653520354059,ECE 200,037,091039,Papen; George C.,9999,0,9999,0
1653520354059,ECE 200,038,091040,Radic; Stojan,9999,0,9999,0
1653520354059,ECE 200,039,091041,Rao; Bhaskar D.,9999,0,9999,0
1653520354059,ECE 200,040,091042,Rao; Ramesh R,9999,0,9999,0
1653520354059,ECE 200,041,091043,Rebeiz; Gabriel,9999,0,9999,0
1653520354059,ECE 200,042,091044,Sanford; John R,9999,0,9999,0
1653520354059,ECE 200,043,091045,Siegel; Paul H.,9999,0,9999,0
1653520354059,ECE 200,044,091046,Sievenpiper; Daniel F.,9999,0,9999,0
1653520354059,ECE 200,045,091047,Sworder; David D.,9999,0,9999,0
1653520354059,ECE 200,046,091048,Taur; Yuan,9999,0,9999,0
1653520354059,ECE 200,047,091049,Touri; Behrouz,9999,0,9999,0
1653520354059,ECE 200,048,091050,Trivedi; Mohan M.,9999,0,9999,0
1653520354059,ECE 200,049,091051,Vardy; Alexander,9999,0,9999,0
1653520354059,ECE 200,050,091052,Vasconcelos; Nuno,9999,0,9999,0
1653520354059,ECE 200,051,091053,Wang; Xiaolong,9999,0,9999,0
1653520354059,ECE 200,052,091054,Xie; Pengtao,9999,0,9999,0
1653520354059,ECE 200,053,091055,Yip; Michael,9999,0,9999,0
1653520354059,ECE 200,054,091056,Zeger; Kenneth A.,9999,0,9999,0
1653520354059,ECE 200,055,091057,Zhang; Xinyu,9999,0,9999,0
1653520354059,ECE 200,056,091058,Turakhia; Yatish Girish,9999,0,9999,0
1653520354059,ECE 200,057,091059,Kang; Mingu,9999,0,9999,0
1653520354059,ECE 200,058,091060,Shi; Yuanyuan,9999,0,9999,0
1653520354059,ECE 200,059,091061,Wang; Edward Jay,9999,0,9999,0
1653520354059,ECE 200,060,091062,Zheng; Yang,9999,0,9999,0
1653520354587,ECE 201,A00,095526,Lo; Yu-Hwa,0,0,0,0
1653520355119,ECE 203,A00,091065,Mercier; Patrick Philip,0,0,0,0
1653520355641,ECE 207A,A00,091605,Liu; Thomas Tao-Ming,0,0,0,0
1653520356168,ECE 212AN,A00,091068,Nomura; Kenji,0,0,0,0
1653520356691,ECE 222A,A00,091069,Rebeiz; Gabriel,0,0,0,0
1653520357213,ECE 225A,A00,091070,Orlitsky; Alon,0,0,0,0
1653520357736,ECE 230A,A00,091071,Nomura; Kenji,0,0,0,0
1653520358261,ECE 236A,A00,091072,Dayeh; Shadi Ahmad,0,0,0,0
1653520358787,ECE 238A,A00,091073,Luo; Jian,0,0,0,0
1653520358787,ECE 238A,B00,091074,Luo; Jian,0,0,0,0
1653520359310,ECE 240A,A00,091075,Radic; Stojan,0,0,0,0
1653520359835,ECE 247A,A00,091592,Shi; Lingyan,0,0,0,0
1653520360362,ECE 250,A00,091076,Touri; Behrouz,0,0,0,0
1653520360888,ECE 251C,A00,091078,Nguyen; Truong Quang,0,0,0,0
1653520361413,ECE 253,A00,091079,Cosman; Pamela C.,0,0,0,0
1653520361939,ECE 255A,A00,091080,Orlitsky; Alon,0,0,0,0
1653520362467,ECE 257A,A00,091081,Zhang; Xinyu,0,0,0,0
1653520362992,ECE 260A,A01,091084,Eldon; John,0,0,0,0
1653520363530,ECE 264C,A00,091085,Galton; Ian A,0,0,0,0
1653520364054,ECE 265C,A00,094889,Presti; Calogero Davide,0,0,0,9
1653520364580,ECE 266,A01,091087,Hall; Drew A.,0,0,0,0
1653520365632,ECE 271A,A00,091090,Vasconcelos; Nuno,0,0,0,0
1653520366158,ECE 272B,A00,091091,Sworder; David D.,0,0,0,0
1653520366680,ECE 275A,A00,091092,Meyer; Florian,0,0,0,0
1653520367208,ECE 277,A00,091093,An; Cheolhong,0,0,0,0
1653520367734,ECE 283,A00,091094,Le; Hanh-Phuc,0,0,0,0
1653520368266,ECE 284,A00,091095,Kang; Mingu,0,0,0,0
1653520368266,ECE 284,B00,091096,Wang; Edward Jay,0,0,0,0
1653520368792,ECE 285,A00,094334,Touri; Behrouz,0,0,0,0
1653520369315,ECE 289,A00,091097,Whelan; David Arthur,0,0,0,0
1653520369840,MATH 200A,A00,087414,Salehi Golsefidy; Alireza,7,0,8,1
1653520370363,MATH 202A,A00,087415,Gill; Philip E.,3,0,8,5
1653520370896,MATH 203A,A00,087416,Oprea; Dragos N.,6,0,8,2
1653520371424,MATH 204A,A00,087417,Kedlaya; Kiran S.,6,0,8,2
1653520371954,MATH 205,A00,087418,Sorensen; Claus M,6,0,8,2
1653520372480,MATH 206A,A00,087419,Izadi; Elham,7,0,8,1
1653520373005,MATH 207A,A00,087420,Mohammadi; Amir,5,0,8,3
1653520373530,MATH 208,A00,087421,Staff,9,0,10,1
1653520374054,MATH 209,A00,087422,Staff,10,0,10,0
1653520374576,MATH 218,A00,087423,Staff,10,0,10,0
1653520375100,MATH 220A,A00,087424,Novak; Jonathan I,7,0,8,1
1653520375631,MATH 231A,A00,087425,Bejenaru; Ioan,3,0,8,5
1653520376157,MATH 240A,A00,087426,Ebenfelt; Peter F,5,0,8,3
1653520376682,MATH 243,A00,087427,Staff,9,0,10,1
1653520377212,MATH 248,A00,087429,Staff,10,0,10,0
1653520377741,MATH 250A,A00,087430,Spolaor; Luca,4,0,8,4
1653520378264,MATH 257A,A00,087431,Spolaor; Luca,7,0,8,1
1653520378788,MATH 258,A00,087432,Staff,9,0,10,1
1653520379316,MATH 264A,A00,087433,Warnke; Lutz Peter,5,0,8,3
1653520379848,MATH 268,A00,087434,Staff,15,0,15,0
1653520380374,MATH 269,A00,087435,Staff,14,0,15,1
1653520380896,MATH 270A,A00,087436,Nie; Jiawang,0,0,8,8
1653520381423,MATH 272A,A00,087437,Tian; Xiaochuan,1,0,8,7
1653520381946,MATH 274,A01,087439,Cheng; Li-Tien,9,0,10,1
1653520381946,MATH 274,A02,087440,Cheng; Li-Tien,10,0,10,0
1653520382472,MATH 278A,A00,087441,Staff,8,0,10,2
1653520383005,MATH 278B,A00,087442,Staff,8,0,10,2
1653520383537,MATH 278C,A00,087443,Staff,8,0,10,2
1653520384066,MATH 280A,A00,087444,Zheng; Tianyi,0,0,8,8
1653520384600,MATH 281A,A00,087445,Bradic; Jelena,0,0,8,8
1653520385124,MATH 282A,A00,087446,Zhang; Danna,0,0,8,8
1653520385647,MATH 283,A00,087447,Tesler; Glenn,0,0,0,15
1653520386175,MATH 286,A00,087448,Kemp; Todd Aahron,5,0,8,3
1653520386699,MATH 287D,A00,087449,Bradic; Jelena,8,0,8,0
1653520387224,MATH 288,A00,087450,Staff,14,0,15,1
1653520387224,MATH 288,B00,087451,Staff,15,0,15,0
1653520387224,MATH 288,C00,087452,Staff,15,0,15,0
1653520387753,MATH 290A,A00,087453,Xu; Zhouli,6,0,8,2
1653520388276,MATH 291A,A00,087454,Xu; Zhouli,7,0,8,1
1653520388806,MATH 292,A00,087455,Staff,10,0,10,0
1653520389330,MATH 295,A00,087456,Staff,50,0,50,0
1653520389853,MATH 297,001,087457,Staff,998,0,999,1
1653520951275,COGS 200,A01,087991,Staff,47,0,50,3
1653520951800,COGS 201,A01,094504,Rangel; Lara M,17,0,25,8
1653520952323,COGS 203,A00,087992,Coulson; Seana M,18,0,20,2
1653520952851,COGS 210A,001,087993,Greene; Deanna Jacquelyn,9998,0,9999,1
1653520952851,COGS 210A,002,087994,Saygin; Ayse P,9999,0,9999,0
1653520952851,COGS 210A,003,087995,Xia; Haijun,9999,0,9999,0
1653520952851,COGS 210A,004,087996,Nitz; Douglas A.,9999,0,9999,0
1653520952851,COGS 210A,005,087997,Hollan; James D.,9999,0,9999,0
1653520952851,COGS 210A,006,087998,Deak; Gedeon O.,9998,0,9999,1
1653520952851,COGS 210A,007,087999,Rossano; Federico,9999,0,9999,0
1653520953387,COGS 211A,A00,088000,Coulson; Seana M,9997,0,9999,2
1653520953911,COGS 229,A00,088002,Staff,23,0,25,2
1653520954438,COGS 260,B00,094231,Staff,17,0,20,3
1653520954438,COGS 260,A00,088004,Nitz; Douglas A.,9998,0,9999,1
1653520954964,CSE 202,A00,090110,Paturi; Ramamohan,0,0,0,0
1653520954964,CSE 202,B00,090111,Paturi; Ramamohan,0,0,0,0
1653520955489,CSE 207B,A00,090112,Heninger; Nadia A,0,0,0,0
1653520956013,CSE 208,A00,094858,Micciancio; Daniele,0,0,0,0
1653520956541,CSE 210,A00,090113,Powell; Thomas Allan,0,0,0,0
1653520957064,CSE 219,A00,090898,Staff,0,0,0,0
1653520957591,CSE 221,A00,090114,Zhou; Yuan-Yuan,0,0,0,0
1653520958116,CSE 229A,A00,090115,Porter; George M,0,0,0,0
1653520958639,CSE 229C,A00,090116,Savage; Stefan,0,0,0,0
1653520959161,CSE 230,A00,090117,Jhala; Ranjit,0,0,0,0
1653520959683,CSE 232,A00,090118,Papakonstantinou; Yannis,0,0,0,0
1653520960211,CSE 239A,A00,090121,Kumar; Arun Kumar,0,0,0,0
1653520960741,CSE 239B,A00,090122,Jhala; Ranjit,0,0,0,0
1653520961268,CSE 240A,A00,090123,Zhao; Jishen,0,0,189,189
1653520961796,CSE 243A,A00,090124,Orailoglu; Alex,0,0,15,15
1653520962323,CSE 249B,A00,090125,Kahng; Andrew Byun,13,0,20,7
1653520962852,CSE 250A,A00,090126,Berg-Kirkpatrick; Taylor D,0,0,0,0
1653520963376,CSE 252A,A00,090127,Ochoa; Benjamin Lawrence,0,0,0,0
1653520963897,CSE 258,A01,090129,McAuley; Julian John,0,0,0,0
1653520964425,CSE 258R,A01,090131,McAuley; Julian John,0,0,0,0
1653520964946,CSE 274,A00,090132,Ramamoorthi; Ravi,0,0,0,0
1653520965470,CSE 276A,A00,090133,Christensen; Henrik I,0,0,0,0
1653520965995,CSE 276C,A00,090134,Christensen; Henrik I,0,0,0,0
1653520966521,CSE 290,A00,090135,Bafna; Vineet,0,0,0,0
1653520966521,CSE 290,B00,090136,Ramamoorthi; Ravi,0,0,0,0
1653520966521,CSE 290,C00,090137,Li; Tzumao,8,0,10,2
1653520966521,CSE 290,D00,090138,Zhou; Yuan-Yuan,9,0,10,1
1653520966521,CSE 290,E00,090139,Christensen; Henrik I,9,0,10,1
1653520966521,CSE 290,F00,094053,Shalev; Aaron D,0,0,0,0
1653520967055,CSE 291,A00,090140,Munyaka; Imani N. S.,0,0,0,0
1653520967055,CSE 291,B00,094880,Yu; Qi,0,0,0,0
1653520967055,CSE 291,C00,090142,Pannuto; Patrick William,0,0,0,0
1653520967055,CSE 291,D00,094881,Zhang; Yiying,0,0,0,0
1653520967055,CSE 291,E00,095118,Su; Hao,0,0,0,0
1653520967582,CSE 293,001,094905,Bafna; Vineet,9999,0,9999,0
1653520967582,CSE 293,002,094906,Bellare; Mihir,9999,0,9999,0
1653520967582,CSE 293,003,094907,Berg-Kirkpatrick; Taylor D,9999,0,9999,0
1653520967582,CSE 293,004,094908,Christensen; Henrik I,9999,0,9999,0
1653520967582,CSE 293,005,094909,Cottrell; Garrison W,9999,0,9999,0
1653520967582,CSE 293,006,094910,Deutsch; Alin Bernard,9999,0,9999,0
1653520967582,CSE 293,007,094911,Esmaeilzadeh; Hadi,9999,0,9999,0
1653520967582,CSE 293,008,094912,Freund; Yoav,9999,0,9999,0
1653520967582,CSE 293,009,094913,Griswold; William G.,9999,0,9999,0
1653520967582,CSE 293,010,094914,Gymrek; Melissa Ann,9999,0,9999,0
1653520967582,CSE 293,011,094915,Heninger; Nadia A,9999,0,9999,0
1653520967582,CSE 293,012,094916,Impagliazzo; Russell,9999,0,9999,0
1653520967582,CSE 293,013,094917,Jhala; Ranjit,9999,0,9999,0
1653520967582,CSE 293,014,094918,Kahng; Andrew Byun,9999,0,9999,0
1653520967582,CSE 293,015,094919,Kane; Daniel Mertz,9999,0,9999,0
1653520967582,CSE 293,016,094920,Kriegman; David J,9999,0,9999,0
1653520967582,CSE 293,017,094921,Kumar; Arun Kumar,9999,0,9999,0
1653520967582,CSE 293,018,094922,Lerner; Sorin,9999,0,9999,0
1653520967582,CSE 293,019,094923,Lovett; Shachar,9999,0,9999,0
1653520967582,CSE 293,020,094924,McAuley; Julian John,9999,0,9999,0
1653520967582,CSE 293,021,094925,Micciancio; Daniele,9999,0,9999,0
1653520967582,CSE 293,022,094926,Orailoglu; Alex,9999,0,9999,0
1653520967582,CSE 293,023,094927,Paturi; Ramamohan,9999,0,9999,0
1653520967582,CSE 293,024,094928,Polikarpova; Nadezhda,9999,0,9999,0
1653520967582,CSE 293,025,094929,Politz; Joseph Gibbs,9999,0,9999,0
1653520967582,CSE 293,026,094930,Porter; George M,9999,0,9999,0
1653520967582,CSE 293,027,094931,Porter; Leonard Emerson,9999,0,9999,0
1653520967582,CSE 293,028,094932,Ramamoorthi; Ravi,9999,0,9999,0
1653520967582,CSE 293,029,094933,Sahoo; Debashis,9999,0,9999,0
1653520967582,CSE 293,030,094934,Saul; Lawrence,9999,0,9999,0
1653520967582,CSE 293,031,094935,Savage; Stefan,9999,0,9999,0
1653520967582,CSE 293,032,094936,Schulze; Jurgen P.,9999,0,9999,0
1653520967582,CSE 293,033,094937,Snoeren; Alex C.,9999,0,9999,0
1653520967582,CSE 293,034,094938,Shang; Jingbo,9999,0,9999,0
1653520967582,CSE 293,035,094939,Stefan; Deian,9999,0,9999,0
1653520967582,CSE 293,036,094940,Su; Hao,9999,0,9999,0
1653520967582,CSE 293,037,094941,Swanson; Steven James,9999,0,9999,0
1653520967582,CSE 293,038,094942,Tullsen; Dean Michael,9999,0,9999,0
1653520967582,CSE 293,039,094943,Voelker; Geoffrey M.,9999,0,9999,0
1653520967582,CSE 293,040,094944,Zhao; Jishen,9999,0,9999,0
1653520967582,CSE 293,041,094945,Zhou; Yuan-Yuan,9999,0,9999,0
1653520967582,CSE 293,042,094946,Gao; Sicun,9998,0,9999,1
1653520967582,CSE 293,043,094947,Weibel; Nadir,9999,0,9999,0
1653520967582,CSE 293,044,094948,Gupta; Rajesh K.,9999,0,9999,0
1653520968107,CSE 294,A00,090143,Porter; George M,8,0,10,2
1653520968631,DSE 200,A00,091799,Staff,50,0,50,0
1653520969153,DSE 203,A00,091800,Gupta; Amarnath,30,0,30,0
1653520969679,DSE 250,A00,091801,Deutsch; Alin Bernard,30,0,30,0
1653520970203,DSE 290,A00,091802,Altintas De Callaf; Ilkay,50,0,50,0
1653520970734,ECE 200,001,091003,Antipa; Nicholas A,9999,0,9999,0
1653520970734,ECE 200,002,091004,Atanasov; Nikolay A.,9999,0,9999,0
1653520970734,ECE 200,003,091005,Bharadia; Dinesh,9999,0,9999,0
1653520970734,ECE 200,004,091006,Cheng; Chung Kuan,9999,0,9999,0
1653520970734,ECE 200,005,091007,Cosman; Pamela C.,9999,0,9999,0
1653520970734,ECE 200,006,091008,Staff,9999,0,9999,0
1653520970734,ECE 200,007,091009,Dayeh; Shadi Ahmad,9999,0,9999,0
1653520970734,ECE 200,008,091010,Fainman; Yeshaiahu,9999,0,9999,0
1653520970734,ECE 200,009,091011,Ford; Joseph Earl,9999,0,9999,0
1653520970734,ECE 200,010,091012,Franceschetti; Massimo,9999,0,9999,0
1653520970734,ECE 200,011,091013,Fullerton; Eric E,9999,0,9999,0
1653520970734,ECE 200,012,091014,Galton; Ian A,9999,0,9999,0
1653520970734,ECE 200,013,091015,Gilja; Vikash,9999,0,9999,0
1653520970734,ECE 200,014,091016,Hall; Drew A.,9999,0,9999,0
1653520970734,ECE 200,015,091017,Hsueh; Tzu-Chien,9999,0,9999,0
1653520970734,ECE 200,016,091018,Javidi; Tara,9999,0,9999,0
1653520970734,ECE 200,017,091019,Kahng; Andrew Byun,9999,0,9999,0
1653520970734,ECE 200,018,091020,Kim; Young-Han,9999,0,9999,0
1653520970734,ECE 200,019,091021,Koushanfar; Farinaz,9999,0,9999,0
1653520970734,ECE 200,020,091022,Kuzum; Duygu,9999,0,9999,0
1653520970734,ECE 200,021,091023,Le; Hanh-Phuc,9999,0,9999,0
1653520970734,ECE 200,022,091024,Lin; Bill,9999,0,9999,0
1653520970734,ECE 200,023,091025,Liu; Zhaowei,9999,0,9999,0
1653520970734,ECE 200,024,091026,Lo; Yu-Hwa,9999,0,9999,0
1653520970734,ECE 200,025,091027,Lomakin; Vitaliy,9999,0,9999,0
1653520970734,ECE 200,026,091028,Mercier; Patrick Philip,9999,0,9999,0
1653520970734,ECE 200,027,091029,Meyer; Florian,9999,0,9999,0
1653520970734,ECE 200,028,091030,Milstein; Laurence B.,9999,0,9999,0
1653520970734,ECE 200,029,091031,Mir Arabbaygi; Siavash,9999,0,9999,0
1653520970734,ECE 200,030,091032,Mookherjea; Shayan,9999,0,9999,0
1653520970734,ECE 200,031,091033,Morris; Karcher William,9999,0,9999,0
1653520970734,ECE 200,032,091034,Ng; Tse Nga,9999,0,9999,0
1653520970734,ECE 200,033,091035,Nguyen; Truong Quang,9999,0,9999,0
1653520970734,ECE 200,034,091036,Nomura; Kenji,9999,0,9999,0
1653520970734,ECE 200,035,091037,Orlitsky; Alon,9999,0,9999,0
1653520970734,ECE 200,036,091038,Pal; Piya,9999,0,9999,0
1653520970734,ECE 200,037,091039,Papen; George C.,9999,0,9999,0
1653520970734,ECE 200,038,091040,Radic; Stojan,9999,0,9999,0
1653520970734,ECE 200,039,091041,Rao; Bhaskar D.,9999,0,9999,0
1653520970734,ECE 200,040,091042,Rao; Ramesh R,9999,0,9999,0
1653520970734,ECE 200,041,091043,Rebeiz; Gabriel,9999,0,9999,0
1653520970734,ECE 200,042,091044,Sanford; John R,9999,0,9999,0
1653520970734,ECE 200,043,091045,Siegel; Paul H.,9999,0,9999,0
1653520970734,ECE 200,044,091046,Sievenpiper; Daniel F.,9999,0,9999,0
1653520970734,ECE 200,045,091047,Sworder; David D.,9999,0,9999,0
1653520970734,ECE 200,046,091048,Taur; Yuan,9999,0,9999,0
1653520970734,ECE 200,047,091049,Touri; Behrouz,9999,0,9999,0
1653520970734,ECE 200,048,091050,Trivedi; Mohan M.,9999,0,9999,0
1653520970734,ECE 200,049,091051,Vardy; Alexander,9999,0,9999,0
1653520970734,ECE 200,050,091052,Vasconcelos; Nuno,9999,0,9999,0
1653520970734,ECE 200,051,091053,Wang; Xiaolong,9999,0,9999,0
1653520970734,ECE 200,052,091054,Xie; Pengtao,9999,0,9999,0
1653520970734,ECE 200,053,091055,Yip; Michael,9999,0,9999,0
1653520970734,ECE 200,054,091056,Zeger; Kenneth A.,9999,0,9999,0
1653520970734,ECE 200,055,091057,Zhang; Xinyu,9999,0,9999,0
1653520970734,ECE 200,056,091058,Turakhia; Yatish Girish,9999,0,9999,0
1653520970734,ECE 200,057,091059,Kang; Mingu,9999,0,9999,0
1653520970734,ECE 200,058,091060,Shi; Yuanyuan,9999,0,9999,0
1653520970734,ECE 200,059,091061,Wang; Edward Jay,9999,0,9999,0
1653520970734,ECE 200,060,091062,Zheng; Yang,9999,0,9999,0
1653520971260,ECE 201,A00,095526,Lo; Yu-Hwa,0,0,0,0
1653520971787,ECE 203,A00,091065,Mercier; Patrick Philip,0,0,0,0
1653520972314,ECE 207A,A00,091605,Liu; Thomas Tao-Ming,0,0,0,0
1653520972837,ECE 212AN,A00,091068,Nomura; Kenji,0,0,0,0
1653520973365,ECE 222A,A00,091069,Rebeiz; Gabriel,0,0,0,0
1653520973888,ECE 225A,A00,091070,Orlitsky; Alon,0,0,0,0
1653520974411,ECE 230A,A00,091071,Nomura; Kenji,0,0,0,0
1653520974933,ECE 236A,A00,091072,Dayeh; Shadi Ahmad,0,0,0,0
1653520975456,ECE 238A,A00,091073,Luo; Jian,0,0,0,0
1653520975456,ECE 238A,B00,091074,Luo; Jian,0,0,0,0
1653520975979,ECE 240A,A00,091075,Radic; Stojan,0,0,0,0
1653520976502,ECE 247A,A00,091592,Shi; Lingyan,0,0,0,0
1653520977025,ECE 250,A00,091076,Touri; Behrouz,0,0,0,0
1653520977551,ECE 251C,A00,091078,Nguyen; Truong Quang,0,0,0,0
1653520978081,ECE 253,A00,091079,Cosman; Pamela C.,0,0,0,0
1653520978603,ECE 255A,A00,091080,Orlitsky; Alon,0,0,0,0
1653520979126,ECE 257A,A00,091081,Zhang; Xinyu,0,0,0,0
1653520979657,ECE 260A,A01,091084,Eldon; John,0,0,0,0
1653520980182,ECE 264C,A00,091085,Galton; Ian A,0,0,0,0
1653520980707,ECE 265C,A00,094889,Presti; Calogero Davide,0,0,0,9
1653520981232,ECE 266,A01,091087,Hall; Drew A.,0,0,0,0
1653520982280,ECE 271A,A00,091090,Vasconcelos; Nuno,0,0,0,0
1653520982811,ECE 272B,A00,091091,Sworder; David D.,0,0,0,0
1653520983350,ECE 275A,A00,091092,Meyer; Florian,0,0,0,0
1653520983872,ECE 277,A00,091093,An; Cheolhong,0,0,0,0
1653520984400,ECE 283,A00,091094,Le; Hanh-Phuc,0,0,0,0
1653520984928,ECE 284,A00,091095,Kang; Mingu,0,0,0,0
1653520984928,ECE 284,B00,091096,Wang; Edward Jay,0,0,0,0
1653520985453,ECE 285,A00,094334,Touri; Behrouz,0,0,0,0
1653520985979,ECE 289,A00,091097,Whelan; David Arthur,0,0,0,0
1653520986508,MATH 200A,A00,087414,Salehi Golsefidy; Alireza,7,0,8,1
1653520987031,MATH 202A,A00,087415,Gill; Philip E.,3,0,8,5
1653520987558,MATH 203A,A00,087416,Oprea; Dragos N.,6,0,8,2
1653520988091,MATH 204A,A00,087417,Kedlaya; Kiran S.,6,0,8,2
1653520988621,MATH 205,A00,087418,Sorensen; Claus M,6,0,8,2
1653520989147,MATH 206A,A00,087419,Izadi; Elham,7,0,8,1
1653520989672,MATH 207A,A00,087420,Mohammadi; Amir,5,0,8,3
1653520990195,MATH 208,A00,087421,Staff,9,0,10,1
1653520990723,MATH 209,A00,087422,Staff,10,0,10,0
1653520991321,MATH 218,A00,087423,Staff,10,0,10,0
1653520991843,MATH 220A,A00,087424,Novak; Jonathan I,7,0,8,1
1653520992383,MATH 231A,A00,087425,Bejenaru; Ioan,3,0,8,5
1653520992905,MATH 240A,A00,087426,Ebenfelt; Peter F,5,0,8,3
1653520993428,MATH 243,A00,087427,Staff,9,0,10,1
1653520993957,MATH 248,A00,087429,Staff,10,0,10,0
1653520994499,MATH 250A,A00,087430,Spolaor; Luca,4,0,8,4
1653520995030,MATH 257A,A00,087431,Spolaor; Luca,7,0,8,1
1653520995557,MATH 258,A00,087432,Staff,9,0,10,1
1653520996082,MATH 264A,A00,087433,Warnke; Lutz Peter,5,0,8,3
1653520996609,MATH 268,A00,087434,Staff,15,0,15,0
1653520997142,MATH 269,A00,087435,Staff,14,0,15,1
1653520997666,MATH 270A,A00,087436,Nie; Jiawang,0,0,8,8
1653520998192,MATH 272A,A00,087437,Tian; Xiaochuan,1,0,8,7
1653520998715,MATH 274,A01,087439,Cheng; Li-Tien,9,0,10,1
1653520998715,MATH 274,A02,087440,Cheng; Li-Tien,10,0,10,0
1653520999238,MATH 278A,A00,087441,Staff,8,0,10,2
1653520999760,MATH 278B,A00,087442,Staff,8,0,10,2
1653521000293,MATH 278C,A00,087443,Staff,8,0,10,2
1653521000821,MATH 280A,A00,087444,Zheng; Tianyi,0,0,8,8
1653521001346,MATH 281A,A00,087445,Bradic; Jelena,0,0,8,8
1653521001868,MATH 282A,A00,087446,Zhang; Danna,0,0,8,8
1653521002391,MATH 283,A00,087447,Tesler; Glenn,0,0,0,15
1653521002927,MATH 286,A00,087448,Kemp; Todd Aahron,5,0,8,3
1653521003456,MATH 287D,A00,087449,Bradic; Jelena,0,0,0,0
1653521003978,MATH 288,A00,087450,Staff,14,0,15,1
1653521003978,MATH 288,B00,087451,Staff,15,0,15,0
1653521003978,MATH 288,C00,087452,Staff,15,0,15,0
1653521004501,MATH 290A,A00,087453,Xu; Zhouli,6,0,8,2
1653521005041,MATH 291A,A00,087454,Xu; Zhouli,7,0,8,1
1653521005582,MATH 292,A00,087455,Staff,10,0,10,0
1653521006104,MATH 295,A00,087456,Staff,50,0,50,0
1653521006627,MATH 297,001,087457,Staff,998,0,999,1
1653521577883,COGS 200,A01,087991,Staff,47,0,50,3
1653521578418,COGS 201,A01,094504,Rangel; Lara M,17,0,25,8
1653521578961,COGS 203,A00,087992,Coulson; Seana M,18,0,20,2
1653521579489,COGS 210A,001,087993,Greene; Deanna Jacquelyn,9998,0,9999,1
1653521579489,COGS 210A,002,087994,Saygin; Ayse P,9999,0,9999,0
1653521579489,COGS 210A,003,087995,Xia; Haijun,9999,0,9999,0
1653521579489,COGS 210A,004,087996,Nitz; Douglas A.,9999,0,9999,0
1653521579489,COGS 210A,005,087997,Hollan; James D.,9999,0,9999,0
1653521579489,COGS 210A,006,087998,Deak; Gedeon O.,9998,0,9999,1
1653521579489,COGS 210A,007,087999,Rossano; Federico,9999,0,9999,0
1653521580017,COGS 211A,A00,088000,Coulson; Seana M,9997,0,9999,2
1653521580546,COGS 229,A00,088002,Staff,23,0,25,2
1653521581075,COGS 260,B00,094231,Staff,17,0,20,3
1653521581075,COGS 260,A00,088004,Nitz; Douglas A.,9998,0,9999,1
1653521581609,CSE 202,A00,090110,Paturi; Ramamohan,0,0,0,0
1653521581609,CSE 202,B00,090111,Paturi; Ramamohan,0,0,0,0
1653521582131,CSE 207B,A00,090112,Heninger; Nadia A,0,0,0,0
1653521582654,CSE 208,A00,094858,Micciancio; Daniele,0,0,0,0
1653521583175,CSE 210,A00,090113,Powell; Thomas Allan,0,0,0,0
1653521583697,CSE 219,A00,090898,Staff,0,0,0,0
1653521584223,CSE 221,A00,090114,Zhou; Yuan-Yuan,0,0,0,0
1653521584746,CSE 229A,A00,090115,Porter; George M,0,0,0,0
1653521585277,CSE 229C,A00,090116,Savage; Stefan,0,0,0,0
1653521585805,CSE 230,A00,090117,Jhala; Ranjit,0,0,0,0
1653521586328,CSE 232,A00,090118,Papakonstantinou; Yannis,0,0,0,0
1653521586851,CSE 239A,A00,090121,Kumar; Arun Kumar,0,0,0,0
1653521587385,CSE 239B,A00,090122,Jhala; Ranjit,0,0,0,0
1653521587912,CSE 240A,A00,090123,Zhao; Jishen,0,0,189,189
1653521588436,CSE 243A,A00,090124,Orailoglu; Alex,0,0,15,15
1653521588958,CSE 249B,A00,090125,Kahng; Andrew Byun,13,0,20,7
1653521589482,CSE 250A,A00,090126,Berg-Kirkpatrick; Taylor D,0,0,0,0
1653521590087,CSE 252A,A00,090127,Ochoa; Benjamin Lawrence,0,0,0,0
1653521590613,CSE 258,A01,090129,McAuley; Julian John,0,0,0,0
1653521591140,CSE 258R,A01,090131,McAuley; Julian John,0,0,0,0
1653521591662,CSE 274,A00,090132,Ramamoorthi; Ravi,0,0,0,0
1653521592185,CSE 276A,A00,090133,Christensen; Henrik I,0,0,0,0
1653521592709,CSE 276C,A00,090134,Christensen; Henrik I,0,0,0,0
1653521593232,CSE 290,A00,090135,Bafna; Vineet,0,0,0,0
1653521593232,CSE 290,B00,090136,Ramamoorthi; Ravi,0,0,0,0
1653521593232,CSE 290,C00,090137,Li; Tzumao,8,0,10,2
1653521593232,CSE 290,D00,090138,Zhou; Yuan-Yuan,9,0,10,1
1653521593232,CSE 290,E00,090139,Christensen; Henrik I,9,0,10,1
1653521593232,CSE 290,F00,094053,Shalev; Aaron D,0,0,0,0
1653521593761,CSE 291,A00,090140,Munyaka; Imani N. S.,0,0,0,0
1653521593761,CSE 291,B00,094880,Yu; Qi,0,0,0,0
1653521593761,CSE 291,C00,090142,Pannuto; Patrick William,0,0,0,0
1653521593761,CSE 291,D00,094881,Zhang; Yiying,0,0,0,0
1653521593761,CSE 291,E00,095118,Su; Hao,0,0,0,0
1653521594287,CSE 293,001,094905,Bafna; Vineet,9999,0,9999,0
1653521594287,CSE 293,002,094906,Bellare; Mihir,9999,0,9999,0
1653521594287,CSE 293,003,094907,Berg-Kirkpatrick; Taylor D,9999,0,9999,0
1653521594287,CSE 293,004,094908,Christensen; Henrik I,9999,0,9999,0
1653521594287,CSE 293,005,094909,Cottrell; Garrison W,9999,0,9999,0
1653521594287,CSE 293,006,094910,Deutsch; Alin Bernard,9999,0,9999,0
1653521594287,CSE 293,007,094911,Esmaeilzadeh; Hadi,9999,0,9999,0
1653521594287,CSE 293,008,094912,Freund; Yoav,9999,0,9999,0
1653521594287,CSE 293,009,094913,Griswold; William G.,9999,0,9999,0
1653521594287,CSE 293,010,094914,Gymrek; Melissa Ann,9999,0,9999,0
1653521594287,CSE 293,011,094915,Heninger; Nadia A,9999,0,9999,0
1653521594287,CSE 293,012,094916,Impagliazzo; Russell,9999,0,9999,0
1653521594287,CSE 293,013,094917,Jhala; Ranjit,9999,0,9999,0
1653521594287,CSE 293,014,094918,Kahng; Andrew Byun,9999,0,9999,0
1653521594287,CSE 293,015,094919,Kane; Daniel Mertz,9999,0,9999,0
1653521594287,CSE 293,016,094920,Kriegman; David J,9999,0,9999,0
1653521594287,CSE 293,017,094921,Kumar; Arun Kumar,9999,0,9999,0
1653521594287,CSE 293,018,094922,Lerner; Sorin,9999,0,9999,0
1653521594287,CSE 293,019,094923,Lovett; Shachar,9999,0,9999,0
1653521594287,CSE 293,020,094924,McAuley; Julian John,9999,0,9999,0
1653521594287,CSE 293,021,094925,Micciancio; Daniele,9999,0,9999,0
1653521594287,CSE 293,022,094926,Orailoglu; Alex,9999,0,9999,0
1653521594287,CSE 293,023,094927,Paturi; Ramamohan,9999,0,9999,0
1653521594287,CSE 293,024,094928,Polikarpova; Nadezhda,9999,0,9999,0
1653521594287,CSE 293,025,094929,Politz; Joseph Gibbs,9999,0,9999,0
1653521594287,CSE 293,026,094930,Porter; George M,9999,0,9999,0
1653521594287,CSE 293,027,094931,Porter; Leonard Emerson,9999,0,9999,0
1653521594287,CSE 293,028,094932,Ramamoorthi; Ravi,9999,0,9999,0
1653521594287,CSE 293,029,094933,Sahoo; Debashis,9999,0,9999,0
1653521594287,CSE 293,030,094934,Saul; Lawrence,9999,0,9999,0
1653521594287,CSE 293,031,094935,Savage; Stefan,9999,0,9999,0
1653521594287,CSE 293,032,094936,Schulze; Jurgen P.,9999,0,9999,0
1653521594287,CSE 293,033,094937,Snoeren; Alex C.,9999,0,9999,0
1653521594287,CSE 293,034,094938,Shang; Jingbo,9999,0,9999,0
1653521594287,CSE 293,035,094939,Stefan; Deian,9999,0,9999,0
1653521594287,CSE 293,036,094940,Su; Hao,9999,0,9999,0
1653521594287,CSE 293,037,094941,Swanson; Steven James,9999,0,9999,0
1653521594287,CSE 293,038,094942,Tullsen; Dean Michael,9999,0,9999,0
1653521594287,CSE 293,039,094943,Voelker; Geoffrey M.,9999,0,9999,0
1653521594287,CSE 293,040,094944,Zhao; Jishen,9999,0,9999,0
1653521594287,CSE 293,041,094945,Zhou; Yuan-Yuan,9999,0,9999,0
1653521594287,CSE 293,042,094946,Gao; Sicun,9998,0,9999,1
1653521594287,CSE 293,043,094947,Weibel; Nadir,9999,0,9999,0
1653521594287,CSE 293,044,094948,Gupta; Rajesh K.,9999,0,9999,0
1653521594820,CSE 294,A00,090143,Porter; George M,8,0,10,2
1653521595361,DSE 200,A00,091799,Staff,50,0,50,0
1653521595884,DSE 203,A00,091800,Gupta; Amarnath,30,0,30,0
1653521596408,DSE 250,A00,091801,Deutsch; Alin Bernard,30,0,30,0
1653521596940,DSE 290,A00,091802,Altintas De Callaf; Ilkay,50,0,50,0
1653521597477,ECE 200,001,091003,Antipa; Nicholas A,9999,0,9999,0
1653521597477,ECE 200,002,091004,Atanasov; Nikolay A.,9999,0,9999,0
1653521597477,ECE 200,003,091005,Bharadia; Dinesh,9999,0,9999,0
1653521597477,ECE 200,004,091006,Cheng; Chung Kuan,9999,0,9999,0
1653521597477,ECE 200,005,091007,Cosman; Pamela C.,9999,0,9999,0
1653521597477,ECE 200,006,091008,Staff,9999,0,9999,0
1653521597477,ECE 200,007,091009,Dayeh; Shadi Ahmad,9999,0,9999,0
1653521597477,ECE 200,008,091010,Fainman; Yeshaiahu,9999,0,9999,0
1653521597477,ECE 200,009,091011,Ford; Joseph Earl,9999,0,9999,0
1653521597477,ECE 200,010,091012,Franceschetti; Massimo,9999,0,9999,0
1653521597477,ECE 200,011,091013,Fullerton; Eric E,9999,0,9999,0
1653521597477,ECE 200,012,091014,Galton; Ian A,9999,0,9999,0
1653521597477,ECE 200,013,091015,Gilja; Vikash,9999,0,9999,0
1653521597477,ECE 200,014,091016,Hall; Drew A.,9999,0,9999,0
1653521597477,ECE 200,015,091017,Hsueh; Tzu-Chien,9999,0,9999,0
1653521597477,ECE 200,016,091018,Javidi; Tara,9999,0,9999,0
1653521597477,ECE 200,017,091019,Kahng; Andrew Byun,9999,0,9999,0
1653521597477,ECE 200,018,091020,Kim; Young-Han,9999,0,9999,0
1653521597477,ECE 200,019,091021,Koushanfar; Farinaz,9999,0,9999,0
1653521597477,ECE 200,020,091022,Kuzum; Duygu,9999,0,9999,0
1653521597477,ECE 200,021,091023,Le; Hanh-Phuc,9999,0,9999,0
1653521597477,ECE 200,022,091024,Lin; Bill,9999,0,9999,0
1653521597477,ECE 200,023,091025,Liu; Zhaowei,9999,0,9999,0
1653521597477,ECE 200,024,091026,Lo; Yu-Hwa,9999,0,9999,0
1653521597477,ECE 200,025,091027,Lomakin; Vitaliy,9999,0,9999,0
1653521597477,ECE 200,026,091028,Mercier; Patrick Philip,9999,0,9999,0
1653521597477,ECE 200,027,091029,Meyer; Florian,9999,0,9999,0
1653521597477,ECE 200,028,091030,Milstein; Laurence B.,9999,0,9999,0
1653521597477,ECE 200,029,091031,Mir Arabbaygi; Siavash,9999,0,9999,0
1653521597477,ECE 200,030,091032,Mookherjea; Shayan,9999,0,9999,0
1653521597477,ECE 200,031,091033,Morris; Karcher William,9999,0,9999,0
1653521597477,ECE 200,032,091034,Ng; Tse Nga,9999,0,9999,0
1653521597477,ECE 200,033,091035,Nguyen; Truong Quang,9999,0,9999,0
1653521597477,ECE 200,034,091036,Nomura; Kenji,9999,0,9999,0
1653521597477,ECE 200,035,091037,Orlitsky; Alon,9999,0,9999,0
1653521597477,ECE 200,036,091038,Pal; Piya,9999,0,9999,0
1653521597477,ECE 200,037,091039,Papen; George C.,9999,0,9999,0
1653521597477,ECE 200,038,091040,Radic; Stojan,9999,0,9999,0
1653521597477,ECE 200,039,091041,Rao; Bhaskar D.,9999,0,9999,0
1653521597477,ECE 200,040,091042,Rao; Ramesh R,9999,0,9999,0
1653521597477,ECE 200,041,091043,Rebeiz; Gabriel,9999,0,9999,0
1653521597477,ECE 200,042,091044,Sanford; John R,9999,0,9999,0
1653521597477,ECE 200,043,091045,Siegel; Paul H.,9999,0,9999,0
1653521597477,ECE 200,044,091046,Sievenpiper; Daniel F.,9999,0,9999,0
1653521597477,ECE 200,045,091047,Sworder; David D.,9999,0,9999,0
1653521597477,ECE 200,046,091048,Taur; Yuan,9999,0,9999,0
1653521597477,ECE 200,047,091049,Touri; Behrouz,9999,0,9999,0
1653521597477,ECE 200,048,091050,Trivedi; Mohan M.,9999,0,9999,0
1653521597477,ECE 200,049,091051,Vardy; Alexander,9999,0,9999,0
1653521597477,ECE 200,050,091052,Vasconcelos; Nuno,9999,0,9999,0
1653521597477,ECE 200,051,091053,Wang; Xiaolong,9999,0,9999,0
1653521597477,ECE 200,052,091054,Xie; Pengtao,9999,0,9999,0
1653521597477,ECE 200,053,091055,Yip; Michael,9999,0,9999,0
1653521597477,ECE 200,054,091056,Zeger; Kenneth A.,9999,0,9999,0
1653521597477,ECE 200,055,091057,Zhang; Xinyu,9999,0,9999,0
1653521597477,ECE 200,056,091058,Turakhia; Yatish Girish,9999,0,9999,0
1653521597477,ECE 200,057,091059,Kang; Mingu,9999,0,9999,0
1653521597477,ECE 200,058,091060,Shi; Yuanyuan,9999,0,9999,0
1653521597477,ECE 200,059,091061,Wang; Edward Jay,9999,0,9999,0
1653521597477,ECE 200,060,091062,Zheng; Yang,9999,0,9999,0
1653521598005,ECE 201,A00,095526,Lo; Yu-Hwa,0,0,0,0
1653521598527,ECE 203,A00,091065,Mercier; Patrick Philip,0,0,0,0
1653521599051,ECE 207A,A00,091605,Liu; Thomas Tao-Ming,0,0,0,0
1653521599574,ECE 212AN,A00,091068,Nomura; Kenji,0,0,0,0
1653521600100,ECE 222A,A00,091069,Rebeiz; Gabriel,0,0,0,0
1653521600622,ECE 225A,A00,091070,Orlitsky; Alon,0,0,0,0
1653521601152,ECE 230A,A00,091071,Nomura; Kenji,0,0,0,0
1653521601674,ECE 236A,A00,091072,Dayeh; Shadi Ahmad,0,0,0,0
1653521602200,ECE 238A,A00,091073,Luo; Jian,0,0,0,0
1653521602200,ECE 238A,B00,091074,Luo; Jian,0,0,0,0
1653521602726,ECE 240A,A00,091075,Radic; Stojan,0,0,0,0
1653521603253,ECE 247A,A00,091592,Shi; Lingyan,0,0,0,0
1653521603777,ECE 250,A00,091076,Touri; Behrouz,0,0,0,0
1653521604299,ECE 251C,A00,091078,Nguyen; Truong Quang,0,0,0,0
1653521604831,ECE 253,A00,091079,Cosman; Pamela C.,0,0,0,0
1653521605366,ECE 255A,A00,091080,Orlitsky; Alon,0,0,0,0
1653521605889,ECE 257A,A00,091081,Zhang; Xinyu,0,0,0,0
1653521606424,ECE 260A,A01,091084,Eldon; John,0,0,0,0
1653521606957,ECE 264C,A00,091085,Galton; Ian A,0,0,0,0
1653521607480,ECE 265C,A00,094889,Presti; Calogero Davide,0,0,0,9
1653521608004,ECE 266,A01,091087,Hall; Drew A.,0,0,0,0
1653521609063,ECE 271A,A00,091090,Vasconcelos; Nuno,0,0,0,0
1653521609586,ECE 272B,A00,091091,Sworder; David D.,0,0,0,0
1653521610111,ECE 275A,A00,091092,Meyer; Florian,0,0,0,0
1653521610637,ECE 277,A00,091093,An; Cheolhong,0,0,0,0
1653521611177,ECE 283,A00,091094,Le; Hanh-Phuc,0,0,0,0
1653521611699,ECE 284,A00,091095,Kang; Mingu,0,0,0,0
1653521611699,ECE 284,B00,091096,Wang; Edward Jay,0,0,0,0
1653521612227,ECE 285,A00,094334,Touri; Behrouz,0,0,0,0
1653521612750,ECE 289,A00,091097,Whelan; David Arthur,0,0,0,0
1653521613284,MATH 200A,A00,087414,Salehi Golsefidy; Alireza,7,0,8,1
1653521613806,MATH 202A,A00,087415,Gill; Philip E.,3,0,8,5
1653521614329,MATH 203A,A00,087416,Oprea; Dragos N.,6,0,8,2
1653521614852,MATH 204A,A00,087417,Kedlaya; Kiran S.,6,0,8,2
1653521615375,MATH 205,A00,087418,Sorensen; Claus M,6,0,8,2
1653521615898,MATH 206A,A00,087419,Izadi; Elham,7,0,8,1
1653521616424,MATH 207A,A00,087420,Mohammadi; Amir,5,0,8,3
1653521616946,MATH 208,A00,087421,Staff,9,0,10,1
1653521617478,MATH 209,A00,087422,Staff,10,0,10,0
1653521618002,MATH 218,A00,087423,Staff,10,0,10,0
1653521618537,MATH 220A,A00,087424,Novak; Jonathan I,7,0,8,1
1653521619069,MATH 231A,A00,087425,Bejenaru; Ioan,3,0,8,5
1653521619609,MATH 240A,A00,087426,Ebenfelt; Peter F,5,0,8,3
1653521620133,MATH 243,A00,087427,Staff,9,0,10,1
1653521620667,MATH 248,A00,087429,Staff,10,0,10,0
1653521621191,MATH 250A,A00,087430,Spolaor; Luca,4,0,8,4
1653521621722,MATH 257A,A00,087431,Spolaor; Luca,7,0,8,1
1653521622252,MATH 258,A00,087432,Staff,9,0,10,1
1653521622776,MATH 264A,A00,087433,Warnke; Lutz Peter,5,0,8,3
1653521623302,MATH 268,A00,087434,Staff,15,0,15,0
1653521623829,MATH 269,A00,087435,Staff,14,0,15,1
1653521624352,MATH 270A,A00,087436,Nie; Jiawang,0,0,8,8
1653521624875,MATH 272A,A00,087437,Tian; Xiaochuan,1,0,8,7
1653521625398,MATH 274,A01,087439,Cheng; Li-Tien,9,0,10,1
1653521625398,MATH 274,A02,087440,Cheng; Li-Tien,10,0,10,0
1653521625922,MATH 278A,A00,087441,Staff,8,0,10,2
1653521626446,MATH 278B,A00,087442,Staff,8,0,10,2
1653521626970,MATH 278C,A00,087443,Staff,8,0,10,2
1653521627493,MATH 280A,A00,087444,Zheng; Tianyi,0,0,8,8
1653521628016,MATH 281A,A00,087445,Bradic; Jelena,0,0,8,8
1653521628551,MATH 282A,A00,087446,Zhang; Danna,0,0,8,8
1653521629074,MATH 283,A00,087447,Tesler; Glenn,0,0,0,15
1653521629603,MATH 286,A00,087448,Kemp; Todd Aahron,5,0,8,3
1653521630126,MATH 287D,A00,087449,Bradic; Jelena,0,0,0,0
1653521630650,MATH 288,A00,087450,Staff,14,0,15,1
1653521630650,MATH 288,B00,087451,Staff,15,0,15,0
1653521630650,MATH 288,C00,087452,Staff,15,0,15,0
1653521631171,MATH 290A,A00,087453,Xu; Zhouli,6,0,8,2
1653521631697,MATH 291A,A00,087454,Xu; Zhouli,7,0,8,1
1653521632225,MATH 292,A00,087455,Staff,10,0,10,0
1653521632748,MATH 295,A00,087456,Staff,50,0,50,0
1653521633276,MATH 297,001,087457,Staff,998,0,999,1
1653522193314,COGS 200,A01,087991,Staff,47,0,50,3
1653522193840,COGS 201,A01,094504,Rangel; Lara M,17,0,25,8
1653522194375,COGS 203,A00,087992,Coulson; Seana M,18,0,20,2
1653522194898,COGS 210A,001,087993,Greene; Deanna Jacquelyn,9998,0,9999,1
1653522194898,COGS 210A,002,087994,Saygin; Ayse P,9999,0,9999,0
1653522194898,COGS 210A,003,087995,Xia; Haijun,9999,0,9999,0
1653522194898,COGS 210A,004,087996,Nitz; Douglas A.,9999,0,9999,0
1653522194898,COGS 210A,005,087997,Hollan; James D.,9999,0,9999,0
1653522194898,COGS 210A,006,087998,Deak; Gedeon O.,9998,0,9999,1
1653522194898,COGS 210A,007,087999,Rossano; Federico,9999,0,9999,0
1653522195420,COGS 211A,A00,088000,Coulson; Seana M,9997,0,9999,2
1653522195943,COGS 229,A00,088002,Staff,23,0,25,2
1653522196473,COGS 260,B00,094231,Staff,17,0,20,3
1653522196473,COGS 260,A00,088004,Nitz; Douglas A.,9998,0,9999,1
1653522196999,CSE 202,A00,090110,Paturi; Ramamohan,0,0,0,0
1653522196999,CSE 202,B00,090111,Paturi; Ramamohan,0,0,0,0
1653522197521,CSE 207B,A00,090112,Heninger; Nadia A,0,0,0,0
1653522198061,CSE 208,A00,094858,Micciancio; Daniele,0,0,0,0
1653522198583,CSE 210,A00,090113,Powell; Thomas Allan,0,0,0,0
1653522199107,CSE 219,A00,090898,Staff,0,0,0,0
1653522199637,CSE 221,A00,090114,Zhou; Yuan-Yuan,0,0,0,0
1653522200170,CSE 229A,A00,090115,Porter; George M,0,0,0,0
1653522200693,CSE 229C,A00,090116,Savage; Stefan,0,0,0,0
1653522201229,CSE 230,A00,090117,Jhala; Ranjit,0,0,0,0
1653522201753,CSE 232,A00,090118,Papakonstantinou; Yannis,0,0,0,0
1653522202275,CSE 239A,A00,090121,Kumar; Arun Kumar,0,0,0,0
1653522202807,CSE 239B,A00,090122,Jhala; Ranjit,0,0,0,0
1653522203334,CSE 240A,A00,090123,Zhao; Jishen,0,0,189,189
1653522203861,CSE 243A,A00,090124,Orailoglu; Alex,0,0,15,15
1653522204382,CSE 249B,A00,090125,Kahng; Andrew Byun,13,0,20,7
1653522204904,CSE 250A,A00,090126,Berg-Kirkpatrick; Taylor D,0,0,0,0
1653522205434,CSE 252A,A00,090127,Ochoa; Benjamin Lawrence,0,0,0,0
1653522205963,CSE 258,A01,090129,McAuley; Julian John,0,0,0,0
1653522206485,CSE 258R,A01,090131,McAuley; Julian John,0,0,0,0
1653522207009,CSE 274,A00,090132,Ramamoorthi; Ravi,0,0,0,0
1653522207543,CSE 276A,A00,090133,Christensen; Henrik I,0,0,0,0
1653522208073,CSE 276C,A00,090134,Christensen; Henrik I,0,0,0,0
1653522208599,CSE 290,A00,090135,Bafna; Vineet,0,0,0,0
1653522208599,CSE 290,B00,090136,Ramamoorthi; Ravi,0,0,0,0
1653522208599,CSE 290,C00,090137,Li; Tzumao,8,0,10,2
1653522208599,CSE 290,D00,090138,Zhou; Yuan-Yuan,9,0,10,1
1653522208599,CSE 290,E00,090139,Christensen; Henrik I,9,0,10,1
1653522208599,CSE 290,F00,094053,Shalev; Aaron D,0,0,0,0
1653522209127,CSE 291,A00,090140,Munyaka; Imani N. S.,0,0,0,0
1653522209127,CSE 291,B00,094880,Yu; Qi,0,0,0,0
1653522209127,CSE 291,C00,090142,Pannuto; Patrick William,0,0,0,0
1653522209127,CSE 291,D00,094881,Zhang; Yiying,0,0,0,0
1653522209127,CSE 291,E00,095118,Su; Hao,0,0,0,0
1653522209661,CSE 293,001,094905,Bafna; Vineet,9999,0,9999,0
1653522209661,CSE 293,002,094906,Bellare; Mihir,9999,0,9999,0
1653522209661,CSE 293,003,094907,Berg-Kirkpatrick; Taylor D,9999,0,9999,0
1653522209661,CSE 293,004,094908,Christensen; Henrik I,9999,0,9999,0
1653522209661,CSE 293,005,094909,Cottrell; Garrison W,9999,0,9999,0
1653522209661,CSE 293,006,094910,Deutsch; Alin Bernard,9999,0,9999,0
1653522209661,CSE 293,007,094911,Esmaeilzadeh; Hadi,9999,0,9999,0
1653522209661,CSE 293,008,094912,Freund; Yoav,9999,0,9999,0
1653522209661,CSE 293,009,094913,Griswold; William G.,9999,0,9999,0
1653522209661,CSE 293,010,094914,Gymrek; Melissa Ann,9999,0,9999,0
1653522209661,CSE 293,011,094915,Heninger; Nadia A,9999,0,9999,0
1653522209661,CSE 293,012,094916,Impagliazzo; Russell,9999,0,9999,0
1653522209661,CSE 293,013,094917,Jhala; Ranjit,9999,0,9999,0
1653522209661,CSE 293,014,094918,Kahng; Andrew Byun,9999,0,9999,0
1653522209661,CSE 293,015,094919,Kane; Daniel Mertz,9999,0,9999,0
1653522209661,CSE 293,016,094920,Kriegman; David J,9999,0,9999,0
1653522209661,CSE 293,017,094921,Kumar; Arun Kumar,9999,0,9999,0
1653522209661,CSE 293,018,094922,Lerner; Sorin,9999,0,9999,0
1653522209661,CSE 293,019,094923,Lovett; Shachar,9999,0,9999,0
1653522209661,CSE 293,020,094924,McAuley; Julian John,9999,0,9999,0
1653522209661,CSE 293,021,094925,Micciancio; Daniele,9999,0,9999,0
1653522209661,CSE 293,022,094926,Orailoglu; Alex,9999,0,9999,0
1653522209661,CSE 293,023,094927,Paturi; Ramamohan,9999,0,9999,0
1653522209661,CSE 293,024,094928,Polikarpova; Nadezhda,9999,0,9999,0
1653522209661,CSE 293,025,094929,Politz; Joseph Gibbs,9999,0,9999,0
1653522209661,CSE 293,026,094930,Porter; George M,9999,0,9999,0
1653522209661,CSE 293,027,094931,Porter; Leonard Emerson,9999,0,9999,0
1653522209661,CSE 293,028,094932,Ramamoorthi; Ravi,9999,0,9999,0
1653522209661,CSE 293,029,094933,Sahoo; Debashis,9999,0,9999,0
1653522209661,CSE 293,030,094934,Saul; Lawrence,9999,0,9999,0
1653522209661,CSE 293,031,094935,Savage; Stefan,9999,0,9999,0
1653522209661,CSE 293,032,094936,Schulze; Jurgen P.,9999,0,9999,0
1653522209661,CSE 293,033,094937,Snoeren; Alex C.,9999,0,9999,0
1653522209661,CSE 293,034,094938,Shang; Jingbo,9999,0,9999,0
1653522209661,CSE 293,035,094939,Stefan; Deian,9999,0,9999,0
1653522209661,CSE 293,036,094940,Su; Hao,9999,0,9999,0
1653522209661,CSE 293,037,094941,Swanson; Steven James,9999,0,9999,0
1653522209661,CSE 293,038,094942,Tullsen; Dean Michael,9999,0,9999,0
1653522209661,CSE 293,039,094943,Voelker; Geoffrey M.,9999,0,9999,0
1653522209661,CSE 293,040,094944,Zhao; Jishen,9999,0,9999,0
1653522209661,CSE 293,041,094945,Zhou; Yuan-Yuan,9999,0,9999,0
1653522209661,CSE 293,042,094946,Gao; Sicun,9998,0,9999,1
1653522209661,CSE 293,043,094947,Weibel; Nadir,9999,0,9999,0
1653522209661,CSE 293,044,094948,Gupta; Rajesh K.,9999,0,9999,0
1653522210183,CSE 294,A00,090143,Porter; George M,8,0,10,2
1653522210709,DSE 200,A00,091799,Staff,50,0,50,0
1653522211235,DSE 203,A00,091800,Gupta; Amarnath,30,0,30,0
1653522211758,DSE 250,A00,091801,Deutsch; Alin Bernard,30,0,30,0
1653522212283,DSE 290,A00,091802,Altintas De Callaf; Ilkay,50,0,50,0
1653522212814,ECE 200,001,091003,Antipa; Nicholas A,9999,0,9999,0
1653522212814,ECE 200,002,091004,Atanasov; Nikolay A.,9999,0,9999,0
1653522212814,ECE 200,003,091005,Bharadia; Dinesh,9999,0,9999,0
1653522212814,ECE 200,004,091006,Cheng; Chung Kuan,9999,0,9999,0
1653522212814,ECE 200,005,091007,Cosman; Pamela C.,9999,0,9999,0
1653522212814,ECE 200,006,091008,Staff,9999,0,9999,0
1653522212814,ECE 200,007,091009,Dayeh; Shadi Ahmad,9999,0,9999,0
1653522212814,ECE 200,008,091010,Fainman; Yeshaiahu,9999,0,9999,0
1653522212814,ECE 200,009,091011,Ford; Joseph Earl,9999,0,9999,0
1653522212814,ECE 200,010,091012,Franceschetti; Massimo,9999,0,9999,0
1653522212814,ECE 200,011,091013,Fullerton; Eric E,9999,0,9999,0
1653522212814,ECE 200,012,091014,Galton; Ian A,9999,0,9999,0
1653522212814,ECE 200,013,091015,Gilja; Vikash,9999,0,9999,0
1653522212814,ECE 200,014,091016,Hall; Drew A.,9999,0,9999,0
1653522212814,ECE 200,015,091017,Hsueh; Tzu-Chien,9999,0,9999,0
1653522212814,ECE 200,016,091018,Javidi; Tara,9999,0,9999,0
1653522212814,ECE 200,017,091019,Kahng; Andrew Byun,9999,0,9999,0
1653522212814,ECE 200,018,091020,Kim; Young-Han,9999,0,9999,0
1653522212814,ECE 200,019,091021,Koushanfar; Farinaz,9999,0,9999,0
1653522212814,ECE 200,020,091022,Kuzum; Duygu,9999,0,9999,0
1653522212814,ECE 200,021,091023,Le; Hanh-Phuc,9999,0,9999,0
1653522212814,ECE 200,022,091024,Lin; Bill,9999,0,9999,0
1653522212814,ECE 200,023,091025,Liu; Zhaowei,9999,0,9999,0
1653522212814,ECE 200,024,091026,Lo; Yu-Hwa,9999,0,9999,0
1653522212814,ECE 200,025,091027,Lomakin; Vitaliy,9999,0,9999,0
1653522212814,ECE 200,026,091028,Mercier; Patrick Philip,9999,0,9999,0
1653522212814,ECE 200,027,091029,Meyer; Florian,9999,0,9999,0
1653522212814,ECE 200,028,091030,Milstein; Laurence B.,9999,0,9999,0
1653522212814,ECE 200,029,091031,Mir Arabbaygi; Siavash,9999,0,9999,0
1653522212814,ECE 200,030,091032,Mookherjea; Shayan,9999,0,9999,0
1653522212814,ECE 200,031,091033,Morris; Karcher William,9999,0,9999,0
1653522212814,ECE 200,032,091034,Ng; Tse Nga,9999,0,9999,0
1653522212814,ECE 200,033,091035,Nguyen; Truong Quang,9999,0,9999,0
1653522212814,ECE 200,034,091036,Nomura; Kenji,9999,0,9999,0
1653522212814,ECE 200,035,091037,Orlitsky; Alon,9999,0,9999,0
1653522212814,ECE 200,036,091038,Pal; Piya,9999,0,9999,0
1653522212814,ECE 200,037,091039,Papen; George C.,9999,0,9999,0
1653522212814,ECE 200,038,091040,Radic; Stojan,9999,0,9999,0
1653522212814,ECE 200,039,091041,Rao; Bhaskar D.,9999,0,9999,0
1653522212814,ECE 200,040,091042,Rao; Ramesh R,9999,0,9999,0
1653522212814,ECE 200,041,091043,Rebeiz; Gabriel,9999,0,9999,0
1653522212814,ECE 200,042,091044,Sanford; John R,9999,0,9999,0
1653522212814,ECE 200,043,091045,Siegel; Paul H.,9999,0,9999,0
1653522212814,ECE 200,044,091046,Sievenpiper; Daniel F.,9999,0,9999,0
1653522212814,ECE 200,045,091047,Sworder; David D.,9999,0,9999,0
1653522212814,ECE 200,046,091048,Taur; Yuan,9999,0,9999,0
1653522212814,ECE 200,047,091049,Touri; Behrouz,9999,0,9999,0
1653522212814,ECE 200,048,091050,Trivedi; Mohan M.,9999,0,9999,0
1653522212814,ECE 200,049,091051,Vardy; Alexander,9999,0,9999,0
1653522212814,ECE 200,050,091052,Vasconcelos; Nuno,9999,0,9999,0
1653522212814,ECE 200,051,091053,Wang; Xiaolong,9999,0,9999,0
1653522212814,ECE 200,052,091054,Xie; Pengtao,9999,0,9999,0
1653522212814,ECE 200,053,091055,Yip; Michael,9999,0,9999,0
1653522212814,ECE 200,054,091056,Zeger; Kenneth A.,9999,0,9999,0
1653522212814,ECE 200,055,091057,Zhang; Xinyu,9999,0,9999,0
1653522212814,ECE 200,056,091058,Turakhia; Yatish Girish,9999,0,9999,0
1653522212814,ECE 200,057,091059,Kang; Mingu,9999,0,9999,0
1653522212814,ECE 200,058,091060,Shi; Yuanyuan,9999,0,9999,0
1653522212814,ECE 200,059,091061,Wang; Edward Jay,9999,0,9999,0
1653522212814,ECE 200,060,091062,Zheng; Yang,9999,0,9999,0
1653522213344,ECE 201,A00,095526,Lo; Yu-Hwa,0,0,0,0
1653522213869,ECE 203,A00,091065,Mercier; Patrick Philip,0,0,0,0
1653522214393,ECE 207A,A00,091605,Liu; Thomas Tao-Ming,0,0,0,0
1653522214923,ECE 212AN,A00,091068,Nomura; Kenji,0,0,0,0
1653522215453,ECE 222A,A00,091069,Rebeiz; Gabriel,0,0,0,0
1653522216015,ECE 225A,A00,091070,Orlitsky; Alon,0,0,0,0
1653522216538,ECE 230A,A00,091071,Nomura; Kenji,0,0,0,0
1653522217064,ECE 236A,A00,091072,Dayeh; Shadi Ahmad,0,0,0,0
1653522217587,ECE 238A,A00,091073,Luo; Jian,0,0,0,0
1653522217587,ECE 238A,B00,091074,Luo; Jian,0,0,0,0
1653522218113,ECE 240A,A00,091075,Radic; Stojan,0,0,0,0
1653522218638,ECE 247A,A00,091592,Shi; Lingyan,0,0,0,0
1653522219161,ECE 250,A00,091076,Touri; Behrouz,0,0,0,0
1653522219683,ECE 251C,A00,091078,Nguyen; Truong Quang,0,0,0,0
1653522220212,ECE 253,A00,091079,Cosman; Pamela C.,0,0,0,0
1653522220735,ECE 255A,A00,091080,Orlitsky; Alon,0,0,0,0
1653522221257,ECE 257A,A00,091081,Zhang; Xinyu,0,0,0,0
1653522221792,ECE 260A,A01,091084,Eldon; John,0,0,0,0
1653522222324,ECE 264C,A00,091085,Galton; Ian A,0,0,0,0
1653522222849,ECE 265C,A00,094889,Presti; Calogero Davide,0,0,0,9
1653522223373,ECE 266,A01,091087,Hall; Drew A.,0,0,0,0
1653522224420,ECE 271A,A00,091090,Vasconcelos; Nuno,0,0,0,0
1653522224957,ECE 272B,A00,091091,Sworder; David D.,0,0,0,0
1653522225485,ECE 275A,A00,091092,Meyer; Florian,0,0,0,0
1653522226017,ECE 277,A00,091093,An; Cheolhong,0,0,0,0
1653522226539,ECE 283,A00,091094,Le; Hanh-Phuc,0,0,0,0
1653522227061,ECE 284,A00,091095,Kang; Mingu,0,0,0,0
1653522227061,ECE 284,B00,091096,Wang; Edward Jay,0,0,0,0
1653522227585,ECE 285,A00,094334,Touri; Behrouz,0,0,0,0
1653522228114,ECE 289,A00,091097,Whelan; David Arthur,0,0,0,0
1653522228637,MATH 200A,A00,087414,Salehi Golsefidy; Alireza,7,0,8,1
1653522229163,MATH 202A,A00,087415,Gill; Philip E.,2,0,8,6
1653522229685,MATH 203A,A00,087416,Oprea; Dragos N.,6,0,8,2
1653522230218,MATH 204A,A00,087417,Kedlaya; Kiran S.,6,0,8,2
1653522230828,MATH 205,A00,087418,Sorensen; Claus M,6,0,8,2
1653522231353,MATH 206A,A00,087419,Izadi; Elham,7,0,8,1
1653522231886,MATH 207A,A00,087420,Mohammadi; Amir,5,0,8,3
1653522232408,MATH 208,A00,087421,Staff,9,0,10,1
1653522232936,MATH 209,A00,087422,Staff,10,0,10,0
1653522233459,MATH 218,A00,087423,Staff,10,0,10,0
1653522233982,MATH 220A,A00,087424,Novak; Jonathan I,7,0,8,1
1653522234505,MATH 231A,A00,087425,Bejenaru; Ioan,3,0,8,5
1653522235030,MATH 240A,A00,087426,Ebenfelt; Peter F,5,0,8,3
1653522235553,MATH 243,A00,087427,Staff,9,0,10,1
1653522236079,MATH 248,A00,087429,Staff,10,0,10,0
1653522236608,MATH 250A,A00,087430,Spolaor; Luca,4,0,8,4
1653522237133,MATH 257A,A00,087431,Spolaor; Luca,7,0,8,1
1653522237669,MATH 258,A00,087432,Staff,9,0,10,1
1653522238195,MATH 264A,A00,087433,Warnke; Lutz Peter,5,0,8,3
1653522238717,MATH 268,A00,087434,Staff,15,0,15,0
1653522239245,MATH 269,A00,087435,Staff,14,0,15,1
1653522239769,MATH 270A,A00,087436,Nie; Jiawang,0,0,8,8
1653522240302,MATH 272A,A00,087437,Tian; Xiaochuan,1,0,8,7
1653522240824,MATH 274,A01,087439,Cheng; Li-Tien,9,0,10,1
1653522240824,MATH 274,A02,087440,Cheng; Li-Tien,10,0,10,0
1653522241346,MATH 278A,A00,087441,Staff,8,0,10,2
1653522241886,MATH 278B,A00,087442,Staff,8,0,10,2
1653522242420,MATH 278C,A00,087443,Staff,8,0,10,2
1653522242946,MATH 280A,A00,087444,Zheng; Tianyi,0,0,8,8
1653522243469,MATH 281A,A00,087445,Bradic; Jelena,0,0,8,8
1653522243991,MATH 282A,A00,087446,Zhang; Danna,0,0,8,8
1653522244518,MATH 283,A00,087447,Tesler; Glenn,0,0,0,15
1653522245045,MATH 286,A00,087448,Kemp; Todd Aahron,5,0,8,3
1653522245568,MATH 287D,A00,087449,Bradic; Jelena,0,0,0,0
1653522246090,MATH 288,A00,087450,Staff,14,0,15,1
1653522246090,MATH 288,B00,087451,Staff,15,0,15,0
1653522246090,MATH 288,C00,087452,Staff,15,0,15,0
1653522246613,MATH 290A,A00,087453,Xu; Zhouli,6,0,8,2
1653522247136,MATH 291A,A00,087454,Xu; Zhouli,7,0,8,1
1653522247660,MATH 292,A00,087455,Staff,10,0,10,0
1653522248185,MATH 295,A00,087456,Staff,50,0,50,0
1653522248718,MATH 297,001,087457,Staff,998,0,999,1
1653522809466,COGS 200,A01,087991,Staff,47,0,50,3
1653522809988,COGS 201,A01,094504,Rangel; Lara M,17,0,25,8
1653522810514,COGS 203,A00,087992,Coulson; Seana M,18,0,20,2
1653522811040,COGS 210A,001,087993,Greene; Deanna Jacquelyn,9998,0,9999,1
1653522811040,COGS 210A,002,087994,Saygin; Ayse P,9999,0,9999,0
1653522811040,COGS 210A,003,087995,Xia; Haijun,9999,0,9999,0
1653522811040,COGS 210A,004,087996,Nitz; Douglas A.,9999,0,9999,0
1653522811040,COGS 210A,005,087997,Hollan; James D.,9999,0,9999,0
1653522811040,COGS 210A,006,087998,Deak; Gedeon O.,9998,0,9999,1
1653522811040,COGS 210A,007,087999,Rossano; Federico,9999,0,9999,0
1653522811571,COGS 211A,A00,088000,Coulson; Seana M,9997,0,9999,2
1653522812094,COGS 229,A00,088002,Staff,23,0,25,2
1653522812626,COGS 260,B00,094231,Staff,17,0,20,3
1653522812626,COGS 260,A00,088004,Nitz; Douglas A.,9998,0,9999,1
1653522813154,CSE 202,A00,090110,Paturi; Ramamohan,0,0,0,0
1653522813154,CSE 202,B00,090111,Paturi; Ramamohan,0,0,0,0
1653522813682,CSE 207B,A00,090112,Heninger; Nadia A,0,0,0,0
1653522814204,CSE 208,A00,094858,Micciancio; Daniele,0,0,0,0
1653522814734,CSE 210,A00,090113,Powell; Thomas Allan,0,0,0,0
1653522815266,CSE 219,A00,090898,Staff,0,0,0,0
1653522815789,CSE 221,A00,090114,Zhou; Yuan-Yuan,0,0,0,0
1653522816324,CSE 229A,A00,090115,Porter; George M,0,0,0,0
1653522816849,CSE 229C,A00,090116,Savage; Stefan,0,0,0,0
1653522817394,CSE 230,A00,090117,Jhala; Ranjit,0,0,0,0
1653522817920,CSE 232,A00,090118,Papakonstantinou; Yannis,0,0,0,0
1653522818442,CSE 239A,A00,090121,Kumar; Arun Kumar,0,0,0,0
1653522819037,CSE 239B,A00,090122,Jhala; Ranjit,0,0,0,0
1653522819559,CSE 240A,A00,090123,Zhao; Jishen,0,0,189,189
1653522820093,CSE 243A,A00,090124,Orailoglu; Alex,0,0,15,15
1653522820615,CSE 249B,A00,090125,Kahng; Andrew Byun,13,0,20,7
1653522821150,CSE 250A,A00,090126,Berg-Kirkpatrick; Taylor D,0,0,0,0
1653522821673,CSE 252A,A00,090127,Ochoa; Benjamin Lawrence,0,0,0,0
1653522822199,CSE 258,A01,090129,McAuley; Julian John,0,0,0,0
1653522822725,CSE 258R,A01,090131,McAuley; Julian John,0,0,0,0
1653522823250,CSE 274,A00,090132,Ramamoorthi; Ravi,0,0,0,0
1653522823773,CSE 276A,A00,090133,Christensen; Henrik I,0,0,0,0
1653522824296,CSE 276C,A00,090134,Christensen; Henrik I,0,0,0,0
1653522824820,CSE 290,A00,090135,Bafna; Vineet,0,0,0,0
1653522824820,CSE 290,B00,090136,Ramamoorthi; Ravi,0,0,0,0
1653522824820,CSE 290,C00,090137,Li; Tzumao,8,0,10,2
1653522824820,CSE 290,D00,090138,Zhou; Yuan-Yuan,9,0,10,1
1653522824820,CSE 290,E00,090139,Christensen; Henrik I,9,0,10,1
1653522824820,CSE 290,F00,094053,Shalev; Aaron D,0,0,0,0
1653522825343,CSE 291,A00,090140,Munyaka; Imani N. S.,0,0,0,0
1653522825343,CSE 291,B00,094880,Yu; Qi,0,0,0,0
1653522825343,CSE 291,C00,090142,Pannuto; Patrick William,0,0,0,0
1653522825343,CSE 291,D00,094881,Zhang; Yiying,0,0,0,0
1653522825343,CSE 291,E00,095118,Su; Hao,0,0,0,0
1653522825878,CSE 293,001,094905,Bafna; Vineet,9999,0,9999,0
1653522825878,CSE 293,002,094906,Bellare; Mihir,9999,0,9999,0
1653522825878,CSE 293,003,094907,Berg-Kirkpatrick; Taylor D,9999,0,9999,0
1653522825878,CSE 293,004,094908,Christensen; Henrik I,9999,0,9999,0
1653522825878,CSE 293,005,094909,Cottrell; Garrison W,9999,0,9999,0
1653522825878,CSE 293,006,094910,Deutsch; Alin Bernard,9999,0,9999,0
1653522825878,CSE 293,007,094911,Esmaeilzadeh; Hadi,9999,0,9999,0
1653522825878,CSE 293,008,094912,Freund; Yoav,9999,0,9999,0
1653522825878,CSE 293,009,094913,Griswold; William G.,9999,0,9999,0
1653522825878,CSE 293,010,094914,Gymrek; Melissa Ann,9999,0,9999,0
1653522825878,CSE 293,011,094915,Heninger; Nadia A,9999,0,9999,0
1653522825878,CSE 293,012,094916,Impagliazzo; Russell,9999,0,9999,0
1653522825878,CSE 293,013,094917,Jhala; Ranjit,9999,0,9999,0
1653522825878,CSE 293,014,094918,Kahng; Andrew Byun,9999,0,9999,0
1653522825878,CSE 293,015,094919,Kane; Daniel Mertz,9999,0,9999,0
1653522825878,CSE 293,016,094920,Kriegman; David J,9999,0,9999,0
1653522825878,CSE 293,017,094921,Kumar; Arun Kumar,9999,0,9999,0
1653522825878,CSE 293,018,094922,Lerner; Sorin,9999,0,9999,0
1653522825878,CSE 293,019,094923,Lovett; Shachar,9999,0,9999,0
1653522825878,CSE 293,020,094924,McAuley; Julian John,9999,0,9999,0
1653522825878,CSE 293,021,094925,Micciancio; Daniele,9999,0,9999,0
1653522825878,CSE 293,022,094926,Orailoglu; Alex,9999,0,9999,0
1653522825878,CSE 293,023,094927,Paturi; Ramamohan,9999,0,9999,0
1653522825878,CSE 293,024,094928,Polikarpova; Nadezhda,9999,0,9999,0
1653522825878,CSE 293,025,094929,Politz; Joseph Gibbs,9999,0,9999,0
1653522825878,CSE 293,026,094930,Porter; George M,9999,0,9999,0
1653522825878,CSE 293,027,094931,Porter; Leonard Emerson,9999,0,9999,0
1653522825878,CSE 293,028,094932,Ramamoorthi; Ravi,9999,0,9999,0
1653522825878,CSE 293,029,094933,Sahoo; Debashis,9999,0,9999,0
1653522825878,CSE 293,030,094934,Saul; Lawrence,9999,0,9999,0
1653522825878,CSE 293,031,094935,Savage; Stefan,9999,0,9999,0
1653522825878,CSE 293,032,094936,Schulze; Jurgen P.,9999,0,9999,0
1653522825878,CSE 293,033,094937,Snoeren; Alex C.,9999,0,9999,0
1653522825878,CSE 293,034,094938,Shang; Jingbo,9999,0,9999,0
1653522825878,CSE 293,035,094939,Stefan; Deian,9999,0,9999,0
1653522825878,CSE 293,036,094940,Su; Hao,9999,0,9999,0
1653522825878,CSE 293,037,094941,Swanson; Steven James,9999,0,9999,0
1653522825878,CSE 293,038,094942,Tullsen; Dean Michael,9999,0,9999,0
1653522825878,CSE 293,039,094943,Voelker; Geoffrey M.,9999,0,9999,0
1653522825878,CSE 293,040,094944,Zhao; Jishen,9999,0,9999,0
1653522825878,CSE 293,041,094945,Zhou; Yuan-Yuan,9999,0,9999,0
1653522825878,CSE 293,042,094946,Gao; Sicun,9998,0,9999,1
1653522825878,CSE 293,043,094947,Weibel; Nadir,9999,0,9999,0
1653522825878,CSE 293,044,094948,Gupta; Rajesh K.,9999,0,9999,0
1653522826412,CSE 294,A00,090143,Porter; George M,8,0,10,2
1653522826937,DSE 200,A00,091799,Staff,50,0,50,0
1653522827461,DSE 203,A00,091800,Gupta; Amarnath,30,0,30,0
1653522827991,DSE 250,A00,091801,Deutsch; Alin Bernard,30,0,30,0
1653522828522,DSE 290,A00,091802,Altintas De Callaf; Ilkay,50,0,50,0
1653522829069,ECE 200,001,091003,Antipa; Nicholas A,9999,0,9999,0
1653522829069,ECE 200,002,091004,Atanasov; Nikolay A.,9999,0,9999,0
1653522829069,ECE 200,003,091005,Bharadia; Dinesh,9999,0,9999,0
1653522829069,ECE 200,004,091006,Cheng; Chung Kuan,9999,0,9999,0
1653522829069,ECE 200,005,091007,Cosman; Pamela C.,9999,0,9999,0
1653522829069,ECE 200,006,091008,Staff,9999,0,9999,0
1653522829069,ECE 200,007,091009,Dayeh; Shadi Ahmad,9999,0,9999,0
1653522829069,ECE 200,008,091010,Fainman; Yeshaiahu,9999,0,9999,0
1653522829069,ECE 200,009,091011,Ford; Joseph Earl,9999,0,9999,0
1653522829069,ECE 200,010,091012,Franceschetti; Massimo,9999,0,9999,0
1653522829069,ECE 200,011,091013,Fullerton; Eric E,9999,0,9999,0
1653522829069,ECE 200,012,091014,Galton; Ian A,9999,0,9999,0
1653522829069,ECE 200,013,091015,Gilja; Vikash,9999,0,9999,0
1653522829069,ECE 200,014,091016,Hall; Drew A.,9999,0,9999,0
1653522829069,ECE 200,015,091017,Hsueh; Tzu-Chien,9999,0,9999,0
1653522829069,ECE 200,016,091018,Javidi; Tara,9999,0,9999,0
1653522829069,ECE 200,017,091019,Kahng; Andrew Byun,9999,0,9999,0
1653522829069,ECE 200,018,091020,Kim; Young-Han,9999,0,9999,0
1653522829069,ECE 200,019,091021,Koushanfar; Farinaz,9999,0,9999,0
1653522829069,ECE 200,020,091022,Kuzum; Duygu,9999,0,9999,0
1653522829069,ECE 200,021,091023,Le; Hanh-Phuc,9999,0,9999,0
1653522829069,ECE 200,022,091024,Lin; Bill,9999,0,9999,0
1653522829069,ECE 200,023,091025,Liu; Zhaowei,9999,0,9999,0
1653522829069,ECE 200,024,091026,Lo; Yu-Hwa,9999,0,9999,0
1653522829069,ECE 200,025,091027,Lomakin; Vitaliy,9999,0,9999,0
1653522829069,ECE 200,026,091028,Mercier; Patrick Philip,9999,0,9999,0
1653522829069,ECE 200,027,091029,Meyer; Florian,9999,0,9999,0
1653522829069,ECE 200,028,091030,Milstein; Laurence B.,9999,0,9999,0
1653522829069,ECE 200,029,091031,Mir Arabbaygi; Siavash,9999,0,9999,0
1653522829069,ECE 200,030,091032,Mookherjea; Shayan,9999,0,9999,0
1653522829069,ECE 200,031,091033,Morris; Karcher William,9999,0,9999,0
1653522829069,ECE 200,032,091034,Ng; Tse Nga,9999,0,9999,0
1653522829069,ECE 200,033,091035,Nguyen; Truong Quang,9999,0,9999,0
1653522829069,ECE 200,034,091036,Nomura; Kenji,9999,0,9999,0
1653522829069,ECE 200,035,091037,Orlitsky; Alon,9999,0,9999,0
1653522829069,ECE 200,036,091038,Pal; Piya,9999,0,9999,0
1653522829069,ECE 200,037,091039,Papen; George C.,9999,0,9999,0
1653522829069,ECE 200,038,091040,Radic; Stojan,9999,0,9999,0
1653522829069,ECE 200,039,091041,Rao; Bhaskar D.,9999,0,9999,0
1653522829069,ECE 200,040,091042,Rao; Ramesh R,9999,0,9999,0
1653522829069,ECE 200,041,091043,Rebeiz; Gabriel,9999,0,9999,0
1653522829069,ECE 200,042,091044,Sanford; John R,9999,0,9999,0
1653522829069,ECE 200,043,091045,Siegel; Paul H.,9999,0,9999,0
1653522829069,ECE 200,044,091046,Sievenpiper; Daniel F.,9999,0,9999,0
1653522829069,ECE 200,045,091047,Sworder; David D.,9999,0,9999,0
1653522829069,ECE 200,046,091048,Taur; Yuan,9999,0,9999,0
1653522829069,ECE 200,047,091049,Touri; Behrouz,9999,0,9999,0
1653522829069,ECE 200,048,091050,Trivedi; Mohan M.,9999,0,9999,0
1653522829069,ECE 200,049,091051,Vardy; Alexander,9999,0,9999,0
1653522829069,ECE 200,050,091052,Vasconcelos; Nuno,9999,0,9999,0
1653522829069,ECE 200,051,091053,Wang; Xiaolong,9999,0,9999,0
1653522829069,ECE 200,052,091054,Xie; Pengtao,9999,0,9999,0
1653522829069,ECE 200,053,091055,Yip; Michael,9999,0,9999,0
1653522829069,ECE 200,054,091056,Zeger; Kenneth A.,9999,0,9999,0
1653522829069,ECE 200,055,091057,Zhang; Xinyu,9999,0,9999,0
1653522829069,ECE 200,056,091058,Turakhia; Yatish Girish,9999,0,9999,0
1653522829069,ECE 200,057,091059,Kang; Mingu,9999,0,9999,0
1653522829069,ECE 200,058,091060,Shi; Yuanyuan,9999,0,9999,0
1653522829069,ECE 200,059,091061,Wang; Edward Jay,9999,0,9999,0
1653522829069,ECE 200,060,091062,Zheng; Yang,9999,0,9999,0
1653522829591,ECE 201,A00,095526,Lo; Yu-Hwa,0,0,0,0
1653522830127,ECE 203,A00,091065,Mercier; Patrick Philip,0,0,0,0
1653522830650,ECE 207A,A00,091605,Liu; Thomas Tao-Ming,0,0,0,0
1653522831177,ECE 212AN,A00,091068,Nomura; Kenji,0,0,0,0
1653522831701,ECE 222A,A00,091069,Rebeiz; Gabriel,0,0,0,0
1653522832224,ECE 225A,A00,091070,Orlitsky; Alon,0,0,0,0
1653522832753,ECE 230A,A00,091071,Nomura; Kenji,0,0,0,0
1653522833278,ECE 236A,A00,091072,Dayeh; Shadi Ahmad,0,0,0,0
1653522833812,ECE 238A,A00,091073,Luo; Jian,0,0,0,0
1653522833812,ECE 238A,B00,091074,Luo; Jian,0,0,0,0
1653522834346,ECE 240A,A00,091075,Radic; Stojan,0,0,0,0
1653522834869,ECE 247A,A00,091592,Shi; Lingyan,0,0,0,0
1653522835392,ECE 250,A00,091076,Touri; Behrouz,0,0,0,0
1653522835917,ECE 251C,A00,091078,Nguyen; Truong Quang,0,0,0,0
1653522836441,ECE 253,A00,091079,Cosman; Pamela C.,0,0,0,0
1653522836964,ECE 255A,A00,091080,Orlitsky; Alon,0,0,0,0
1653522837486,ECE 257A,A00,091081,Zhang; Xinyu,0,0,0,0
1653522838009,ECE 260A,A01,091084,Eldon; John,0,0,0,0
1653522838536,ECE 264C,A00,091085,Galton; Ian A,0,0,0,0
1653522839058,ECE 265C,A00,094889,Presti; Calogero Davide,0,0,0,9
1653522839594,ECE 266,A01,091087,Hall; Drew A.,0,0,0,0
1653522840645,ECE 271A,A00,091090,Vasconcelos; Nuno,0,0,0,0
1653522841169,ECE 272B,A00,091091,Sworder; David D.,0,0,0,0
1653522841700,ECE 275A,A00,091092,Meyer; Florian,0,0,0,0
1653522842223,ECE 277,A00,091093,An; Cheolhong,0,0,0,0
1653522842746,ECE 283,A00,091094,Le; Hanh-Phuc,0,0,0,0
1653522843269,ECE 284,A00,091095,Kang; Mingu,0,0,0,0
1653522843269,ECE 284,B00,091096,Wang; Edward Jay,0,0,0,0
1653522843791,ECE 285,A00,094334,Touri; Behrouz,0,0,0,0
1653522844323,ECE 289,A00,091097,Whelan; David Arthur,0,0,0,0
1653522844859,MATH 200A,A00,087414,Salehi Golsefidy; Alireza,7,0,8,1
1653522845382,MATH 202A,A00,087415,Gill; Philip E.,2,0,8,6
1653522845904,MATH 203A,A00,087416,Oprea; Dragos N.,6,0,8,2
1653522846427,MATH 204A,A00,087417,Kedlaya; Kiran S.,6,0,8,2
1653522846953,MATH 205,A00,087418,Sorensen; Claus M,6,0,8,2
1653522847482,MATH 206A,A00,087419,Izadi; Elham,7,0,8,1
1653522848004,MATH 207A,A00,087420,Mohammadi; Amir,5,0,8,3
1653522848525,MATH 208,A00,087421,Staff,9,0,10,1
1653522849047,MATH 209,A00,087422,Staff,10,0,10,0
1653522849578,MATH 218,A00,087423,Staff,10,0,10,0
1653522850101,MATH 220A,A00,087424,Novak; Jonathan I,7,0,8,1
1653522850627,MATH 231A,A00,087425,Bejenaru; Ioan,3,0,8,5
1653522851159,MATH 240A,A00,087426,Ebenfelt; Peter F,5,0,8,3
1653522851682,MATH 243,A00,087427,Staff,9,0,10,1
1653522852206,MATH 248,A00,087429,Staff,10,0,10,0
1653522852732,MATH 250A,A00,087430,Spolaor; Luca,4,0,8,4
1653522853258,MATH 257A,A00,087431,Spolaor; Luca,7,0,8,1
1653522853794,MATH 258,A00,087432,Staff,9,0,10,1
1653522854322,MATH 264A,A00,087433,Warnke; Lutz Peter,5,0,8,3
1653522854844,MATH 268,A00,087434,Staff,15,0,15,0
1653522855366,MATH 269,A00,087435,Staff,14,0,15,1
1653522855896,MATH 270A,A00,087436,Nie; Jiawang,0,0,8,8
1653522856418,MATH 272A,A00,087437,Tian; Xiaochuan,1,0,8,7
1653522856946,MATH 274,A01,087439,Cheng; Li-Tien,9,0,10,1
1653522856946,MATH 274,A02,087440,Cheng; Li-Tien,10,0,10,0
1653522857469,MATH 278A,A00,087441,Staff,8,0,10,2
1653522857994,MATH 278B,A00,087442,Staff,8,0,10,2
1653522858516,MATH 278C,A00,087443,Staff,8,0,10,2
1653522859039,MATH 280A,A00,087444,Zheng; Tianyi,0,0,8,8
1653522859564,MATH 281A,A00,087445,Bradic; Jelena,0,0,8,8
1653522860090,MATH 282A,A00,087446,Zhang; Danna,0,0,8,8
1653522860618,MATH 283,A00,087447,Tesler; Glenn,0,0,0,15
1653522861147,MATH 286,A00,087448,Kemp; Todd Aahron,5,0,8,3
1653522861672,MATH 287D,A00,087449,Bradic; Jelena,0,0,0,0
1653522862197,MATH 288,A00,087450,Staff,14,0,15,1
1653522862197,MATH 288,B00,087451,Staff,15,0,15,0
1653522862197,MATH 288,C00,087452,Staff,15,0,15,0
1653522862720,MATH 290A,A00,087453,Xu; Zhouli,6,0,8,2
1653522863247,MATH 291A,A00,087454,Xu; Zhouli,7,0,8,1
1653522863796,MATH 292,A00,087455,Staff,10,0,10,0
1653522864319,MATH 295,A00,087456,Staff,50,0,50,0
1653522864844,MATH 297,001,087457,Staff,998,0,999,1
1653523424968,COGS 200,A01,087991,Staff,47,0,50,3
1653523425494,COGS 201,A01,094504,Rangel; Lara M,17,0,25,8
1653523426020,COGS 203,A00,087992,Coulson; Seana M,18,0,20,2
1653523426544,COGS 210A,001,087993,Greene; Deanna Jacquelyn,9998,0,9999,1
1653523426544,COGS 210A,002,087994,Saygin; Ayse P,9999,0,9999,0
1653523426544,COGS 210A,003,087995,Xia; Haijun,9999,0,9999,0
1653523426544,COGS 210A,004,087996,Nitz; Douglas A.,9999,0,9999,0
1653523426544,COGS 210A,005,087997,Hollan; James D.,9999,0,9999,0
1653523426544,COGS 210A,006,087998,Deak; Gedeon O.,9998,0,9999,1
1653523426544,COGS 210A,007,087999,Rossano; Federico,9999,0,9999,0
1653523427071,COGS 211A,A00,088000,Coulson; Seana M,9997,0,9999,2
1653523427599,COGS 229,A00,088002,Staff,23,0,25,2
1653523428126,COGS 260,B00,094231,Staff,17,0,20,3
1653523428126,COGS 260,A00,088004,Nitz; Douglas A.,9998,0,9999,1
1653523428652,CSE 202,A00,090110,Paturi; Ramamohan,0,0,0,0
1653523428652,CSE 202,B00,090111,Paturi; Ramamohan,0,0,0,0
1653523429174,CSE 207B,A00,090112,Heninger; Nadia A,0,0,0,0
1653523429697,CSE 208,A00,094858,Micciancio; Daniele,0,0,0,0
1653523430228,CSE 210,A00,090113,Powell; Thomas Allan,0,0,0,0
1653523430751,CSE 219,A00,090898,Staff,0,0,0,0
1653523431282,CSE 221,A00,090114,Zhou; Yuan-Yuan,0,0,0,0
1653523431808,CSE 229A,A00,090115,Porter; George M,0,0,0,0
1653523432331,CSE 229C,A00,090116,Savage; Stefan,0,0,0,0
1653523432855,CSE 230,A00,090117,Jhala; Ranjit,0,0,0,0
1653523433379,CSE 232,A00,090118,Papakonstantinou; Yannis,0,0,0,0
1653523433901,CSE 239A,A00,090121,Kumar; Arun Kumar,0,0,0,0
1653523434426,CSE 239B,A00,090122,Jhala; Ranjit,0,0,0,0
1653523434950,CSE 240A,A00,090123,Zhao; Jishen,0,0,189,189
1653523435474,CSE 243A,A00,090124,Orailoglu; Alex,0,0,15,15
1653523435999,CSE 249B,A00,090125,Kahng; Andrew Byun,13,0,20,7
1653523436523,CSE 250A,A00,090126,Berg-Kirkpatrick; Taylor D,0,0,0,0
1653523437047,CSE 252A,A00,090127,Ochoa; Benjamin Lawrence,0,0,0,0
1653523437571,CSE 258,A01,090129,McAuley; Julian John,0,0,0,0
1653523438098,CSE 258R,A01,090131,McAuley; Julian John,0,0,0,0
1653523438621,CSE 274,A00,090132,Ramamoorthi; Ravi,0,0,0,0
1653523439147,CSE 276A,A00,090133,Christensen; Henrik I,0,0,0,0
1653523439673,CSE 276C,A00,090134,Christensen; Henrik I,0,0,0,0
1653523440196,CSE 290,A00,090135,Bafna; Vineet,0,0,0,0
1653523440196,CSE 290,B00,090136,Ramamoorthi; Ravi,0,0,0,0
1653523440196,CSE 290,C00,090137,Li; Tzumao,8,0,10,2
1653523440196,CSE 290,D00,090138,Zhou; Yuan-Yuan,9,0,10,1
1653523440196,CSE 290,E00,090139,Christensen; Henrik I,9,0,10,1
1653523440196,CSE 290,F00,094053,Shalev; Aaron D,0,0,0,0
1653523440725,CSE 291,A00,090140,Munyaka; Imani N. S.,0,0,0,0
1653523440725,CSE 291,B00,094880,Yu; Qi,0,0,0,0
1653523440725,CSE 291,C00,090142,Pannuto; Patrick William,0,0,0,0
1653523440725,CSE 291,D00,094881,Zhang; Yiying,0,0,0,0
1653523440725,CSE 291,E00,095118,Su; Hao,0,0,0,0
1653523441270,CSE 293,001,094905,Bafna; Vineet,9999,0,9999,0
1653523441270,CSE 293,002,094906,Bellare; Mihir,9999,0,9999,0
1653523441270,CSE 293,003,094907,Berg-Kirkpatrick; Taylor D,9999,0,9999,0
1653523441270,CSE 293,004,094908,Christensen; Henrik I,9999,0,9999,0
1653523441270,CSE 293,005,094909,Cottrell; Garrison W,9999,0,9999,0
1653523441270,CSE 293,006,094910,Deutsch; Alin Bernard,9999,0,9999,0
1653523441270,CSE 293,007,094911,Esmaeilzadeh; Hadi,9999,0,9999,0
1653523441270,CSE 293,008,094912,Freund; Yoav,9999,0,9999,0
1653523441270,CSE 293,009,094913,Griswold; William G.,9999,0,9999,0
1653523441270,CSE 293,010,094914,Gymrek; Melissa Ann,9999,0,9999,0
1653523441270,CSE 293,011,094915,Heninger; Nadia A,9999,0,9999,0
1653523441270,CSE 293,012,094916,Impagliazzo; Russell,9999,0,9999,0
1653523441270,CSE 293,013,094917,Jhala; Ranjit,9999,0,9999,0
1653523441270,CSE 293,014,094918,Kahng; Andrew Byun,9999,0,9999,0
1653523441270,CSE 293,015,094919,Kane; Daniel Mertz,9999,0,9999,0
1653523441270,CSE 293,016,094920,Kriegman; David J,9999,0,9999,0
1653523441270,CSE 293,017,094921,Kumar; Arun Kumar,9999,0,9999,0
1653523441270,CSE 293,018,094922,Lerner; Sorin,9999,0,9999,0
1653523441270,CSE 293,019,094923,Lovett; Shachar,9999,0,9999,0
1653523441270,CSE 293,020,094924,McAuley; Julian John,9999,0,9999,0
1653523441270,CSE 293,021,094925,Micciancio; Daniele,9999,0,9999,0
1653523441270,CSE 293,022,094926,Orailoglu; Alex,9999,0,9999,0
1653523441270,CSE 293,023,094927,Paturi; Ramamohan,9999,0,9999,0
1653523441270,CSE 293,024,094928,Polikarpova; Nadezhda,9999,0,9999,0
1653523441270,CSE 293,025,094929,Politz; Joseph Gibbs,9999,0,9999,0
1653523441270,CSE 293,026,094930,Porter; George M,9999,0,9999,0
1653523441270,CSE 293,027,094931,Porter; Leonard Emerson,9999,0,9999,0
1653523441270,CSE 293,028,094932,Ramamoorthi; Ravi,9999,0,9999,0
1653523441270,CSE 293,029,094933,Sahoo; Debashis,9999,0,9999,0
1653523441270,CSE 293,030,094934,Saul; Lawrence,9999,0,9999,0
1653523441270,CSE 293,031,094935,Savage; Stefan,9999,0,9999,0
1653523441270,CSE 293,032,094936,Schulze; Jurgen P.,9999,0,9999,0
1653523441270,CSE 293,033,094937,Snoeren; Alex C.,9999,0,9999,0
1653523441270,CSE 293,034,094938,Shang; Jingbo,9999,0,9999,0
1653523441270,CSE 293,035,094939,Stefan; Deian,9999,0,9999,0
1653523441270,CSE 293,036,094940,Su; Hao,9999,0,9999,0
1653523441270,CSE 293,037,094941,Swanson; Steven James,9999,0,9999,0
1653523441270,CSE 293,038,094942,Tullsen; Dean Michael,9999,0,9999,0
1653523441270,CSE 293,039,094943,Voelker; Geoffrey M.,9999,0,9999,0
1653523441270,CSE 293,040,094944,Zhao; Jishen,9999,0,9999,0
1653523441270,CSE 293,041,094945,Zhou; Yuan-Yuan,9999,0,9999,0
1653523441270,CSE 293,042,094946,Gao; Sicun,9998,0,9999,1
1653523441270,CSE 293,043,094947,Weibel; Nadir,9999,0,9999,0
1653523441270,CSE 293,044,094948,Gupta; Rajesh K.,9999,0,9999,0
1653523441795,CSE 294,A00,090143,Porter; George M,8,0,10,2
1653523442322,DSE 200,A00,091799,Staff,50,0,50,0
1653523442846,DSE 203,A00,091800,Gupta; Amarnath,30,0,30,0
1653523443369,DSE 250,A00,091801,Deutsch; Alin Bernard,30,0,30,0
1653523443893,DSE 290,A00,091802,Altintas De Callaf; Ilkay,50,0,50,0
1653523444451,ECE 200,001,091003,Antipa; Nicholas A,9999,0,9999,0
1653523444451,ECE 200,002,091004,Atanasov; Nikolay A.,9999,0,9999,0
1653523444451,ECE 200,003,091005,Bharadia; Dinesh,9999,0,9999,0
1653523444451,ECE 200,004,091006,Cheng; Chung Kuan,9999,0,9999,0
1653523444451,ECE 200,005,091007,Cosman; Pamela C.,9999,0,9999,0
1653523444451,ECE 200,006,091008,Staff,9999,0,9999,0
1653523444451,ECE 200,007,091009,Dayeh; Shadi Ahmad,9999,0,9999,0
1653523444451,ECE 200,008,091010,Fainman; Yeshaiahu,9999,0,9999,0
1653523444451,ECE 200,009,091011,Ford; Joseph Earl,9999,0,9999,0
1653523444451,ECE 200,010,091012,Franceschetti; Massimo,9999,0,9999,0
1653523444451,ECE 200,011,091013,Fullerton; Eric E,9999,0,9999,0
1653523444451,ECE 200,012,091014,Galton; Ian A,9999,0,9999,0
1653523444451,ECE 200,013,091015,Gilja; Vikash,9999,0,9999,0
1653523444451,ECE 200,014,091016,Hall; Drew A.,9999,0,9999,0
1653523444451,ECE 200,015,091017,Hsueh; Tzu-Chien,9999,0,9999,0
1653523444451,ECE 200,016,091018,Javidi; Tara,9999,0,9999,0
1653523444451,ECE 200,017,091019,Kahng; Andrew Byun,9999,0,9999,0
1653523444451,ECE 200,018,091020,Kim; Young-Han,9999,0,9999,0
1653523444451,ECE 200,019,091021,Koushanfar; Farinaz,9999,0,9999,0
1653523444451,ECE 200,020,091022,Kuzum; Duygu,9999,0,9999,0
1653523444451,ECE 200,021,091023,Le; Hanh-Phuc,9999,0,9999,0
1653523444451,ECE 200,022,091024,Lin; Bill,9999,0,9999,0
1653523444451,ECE 200,023,091025,Liu; Zhaowei,9999,0,9999,0
1653523444451,ECE 200,024,091026,Lo; Yu-Hwa,9999,0,9999,0
1653523444451,ECE 200,025,091027,Lomakin; Vitaliy,9999,0,9999,0
1653523444451,ECE 200,026,091028,Mercier; Patrick Philip,9999,0,9999,0
1653523444451,ECE 200,027,091029,Meyer; Florian,9999,0,9999,0
1653523444451,ECE 200,028,091030,Milstein; Laurence B.,9999,0,9999,0
1653523444451,ECE 200,029,091031,Mir Arabbaygi; Siavash,9999,0,9999,0
1653523444451,ECE 200,030,091032,Mookherjea; Shayan,9999,0,9999,0
1653523444451,ECE 200,031,091033,Morris; Karcher William,9999,0,9999,0
1653523444451,ECE 200,032,091034,Ng; Tse Nga,9999,0,9999,0
1653523444451,ECE 200,033,091035,Nguyen; Truong Quang,9999,0,9999,0
1653523444451,ECE 200,034,091036,Nomura; Kenji,9999,0,9999,0
1653523444451,ECE 200,035,091037,Orlitsky; Alon,9999,0,9999,0
1653523444451,ECE 200,036,091038,Pal; Piya,9999,0,9999,0
1653523444451,ECE 200,037,091039,Papen; George C.,9999,0,9999,0
1653523444451,ECE 200,038,091040,Radic; Stojan,9999,0,9999,0
1653523444451,ECE 200,039,091041,Rao; Bhaskar D.,9999,0,9999,0
1653523444451,ECE 200,040,091042,Rao; Ramesh R,9999,0,9999,0
1653523444451,ECE 200,041,091043,Rebeiz; Gabriel,9999,0,9999,0
1653523444451,ECE 200,042,091044,Sanford; John R,9999,0,9999,0
1653523444451,ECE 200,043,091045,Siegel; Paul H.,9999,0,9999,0
1653523444451,ECE 200,044,091046,Sievenpiper; Daniel F.,9999,0,9999,0
1653523444451,ECE 200,045,091047,Sworder; David D.,9999,0,9999,0
1653523444451,ECE 200,046,091048,Taur; Yuan,9999,0,9999,0
1653523444451,ECE 200,047,091049,Touri; Behrouz,9999,0,9999,0
1653523444451,ECE 200,048,091050,Trivedi; Mohan M.,9999,0,9999,0
1653523444451,ECE 200,049,091051,Vardy; Alexander,9999,0,9999,0
1653523444451,ECE 200,050,091052,Vasconcelos; Nuno,9999,0,9999,0
1653523444451,ECE 200,051,091053,Wang; Xiaolong,9999,0,9999,0
1653523444451,ECE 200,052,091054,Xie; Pengtao,9999,0,9999,0
1653523444451,ECE 200,053,091055,Yip; Michael,9999,0,9999,0
1653523444451,ECE 200,054,091056,Zeger; Kenneth A.,9999,0,9999,0
1653523444451,ECE 200,055,091057,Zhang; Xinyu,9999,0,9999,0
1653523444451,ECE 200,056,091058,Turakhia; Yatish Girish,9999,0,9999,0
1653523444451,ECE 200,057,091059,Kang; Mingu,9999,0,9999,0
1653523444451,ECE 200,058,091060,Shi; Yuanyuan,9999,0,9999,0
1653523444451,ECE 200,059,091061,Wang; Edward Jay,9999,0,9999,0
1653523444451,ECE 200,060,091062,Zheng; Yang,9999,0,9999,0
1653523444979,ECE 201,A00,095526,Lo; Yu-Hwa,0,0,0,0
1653523445502,ECE 203,A00,091065,Mercier; Patrick Philip,0,0,0,0
1653523446039,ECE 207A,A00,091605,Liu; Thomas Tao-Ming,0,0,0,0
1653523446565,ECE 212AN,A00,091068,Nomura; Kenji,0,0,0,0
1653523447091,ECE 222A,A00,091069,Rebeiz; Gabriel,0,0,0,0
1653523447618,ECE 225A,A00,091070,Orlitsky; Alon,0,0,0,0
1653523448143,ECE 230A,A00,091071,Nomura; Kenji,0,0,0,0
1653523448670,ECE 236A,A00,091072,Dayeh; Shadi Ahmad,0,0,0,0
1653523449201,ECE 238A,A00,091073,Luo; Jian,0,0,0,0
1653523449201,ECE 238A,B00,091074,Luo; Jian,0,0,0,0
1653523449727,ECE 240A,A00,091075,Radic; Stojan,0,0,0,0
1653523450252,ECE 247A,A00,091592,Shi; Lingyan,0,0,0,0
1653523450779,ECE 250,A00,091076,Touri; Behrouz,0,0,0,0
1653523451300,ECE 251C,A00,091078,Nguyen; Truong Quang,0,0,0,0
1653523451831,ECE 253,A00,091079,Cosman; Pamela C.,0,0,0,0
1653523452363,ECE 255A,A00,091080,Orlitsky; Alon,0,0,0,0
1653523452890,ECE 257A,A00,091081,Zhang; Xinyu,0,0,0,0
1653523453417,ECE 260A,A01,091084,Eldon; John,0,0,0,0
1653523453945,ECE 264C,A00,091085,Galton; Ian A,0,0,0,0
1653523454469,ECE 265C,A00,094889,Presti; Calogero Davide,0,0,0,9
1653523454993,ECE 266,A01,091087,Hall; Drew A.,0,0,0,0
1653523456043,ECE 271A,A00,091090,Vasconcelos; Nuno,0,0,0,0
1653523456580,ECE 272B,A00,091091,Sworder; David D.,0,0,0,0
1653523457115,ECE 275A,A00,091092,Meyer; Florian,0,0,0,0
1653523457640,ECE 277,A00,091093,An; Cheolhong,0,0,0,0
1653523458167,ECE 283,A00,091094,Le; Hanh-Phuc,0,0,0,0
1653523458689,ECE 284,A00,091095,Kang; Mingu,0,0,0,0
1653523458689,ECE 284,B00,091096,Wang; Edward Jay,0,0,0,0
1653523459219,ECE 285,A00,094334,Touri; Behrouz,0,0,0,0
1653523459829,ECE 289,A00,091097,Whelan; David Arthur,0,0,0,0
1653523460353,MATH 200A,A00,087414,Salehi Golsefidy; Alireza,7,0,8,1
1653523460889,MATH 202A,A00,087415,Gill; Philip E.,2,0,8,6
1653523461419,MATH 203A,A00,087416,Oprea; Dragos N.,6,0,8,2
1653523461943,MATH 204A,A00,087417,Kedlaya; Kiran S.,6,0,8,2
1653523462473,MATH 205,A00,087418,Sorensen; Claus M,6,0,8,2
1653523462996,MATH 206A,A00,087419,Izadi; Elham,7,0,8,1
1653523463519,MATH 207A,A00,087420,Mohammadi; Amir,5,0,8,3
1653523464045,MATH 208,A00,087421,Staff,9,0,10,1
1653523464567,MATH 209,A00,087422,Staff,10,0,10,0
1653523465098,MATH 218,A00,087423,Staff,10,0,10,0
1653523465623,MATH 220A,A00,087424,Novak; Jonathan I,7,0,8,1
1653523466151,MATH 231A,A00,087425,Bejenaru; Ioan,3,0,8,5
1653523466675,MATH 240A,A00,087426,Ebenfelt; Peter F,5,0,8,3
1653523467198,MATH 243,A00,087427,Staff,9,0,10,1
1653523467723,MATH 248,A00,087429,Staff,10,0,10,0
1653523468247,MATH 250A,A00,087430,Spolaor; Luca,4,0,8,4
1653523468781,MATH 257A,A00,087431,Spolaor; Luca,7,0,8,1
1653523469304,MATH 258,A00,087432,Staff,9,0,10,1
1653523469845,MATH 264A,A00,087433,Warnke; Lutz Peter,5,0,8,3
1653523470368,MATH 268,A00,087434,Staff,15,0,15,0
1653523470891,MATH 269,A00,087435,Staff,14,0,15,1
1653523471415,MATH 270A,A00,087436,Nie; Jiawang,0,0,8,8
1653523471944,MATH 272A,A00,087437,Tian; Xiaochuan,1,0,8,7
1653523472469,MATH 274,A01,087439,Cheng; Li-Tien,9,0,10,1
1653523472469,MATH 274,A02,087440,Cheng; Li-Tien,10,0,10,0
1653523472997,MATH 278A,A00,087441,Staff,8,0,10,2
1653523473519,MATH 278B,A00,087442,Staff,8,0,10,2
1653523474045,MATH 278C,A00,087443,Staff,8,0,10,2
1653523474571,MATH 280A,A00,087444,Zheng; Tianyi,0,0,8,8
1653523475093,MATH 281A,A00,087445,Bradic; Jelena,0,0,8,8
1653523475617,MATH 282A,A00,087446,Zhang; Danna,0,0,8,8
1653523476141,MATH 283,A00,087447,Tesler; Glenn,0,0,0,15
1653523476665,MATH 286,A00,087448,Kemp; Todd Aahron,5,0,8,3
1653523477191,MATH 287D,A00,087449,Bradic; Jelena,0,0,0,0
1653523477726,MATH 288,A00,087450,Staff,14,0,15,1
1653523477726,MATH 288,B00,087451,Staff,15,0,15,0
1653523477726,MATH 288,C00,087452,Staff,15,0,15,0
1653523478256,MATH 290A,A00,087453,Xu; Zhouli,6,0,8,2
1653523478783,MATH 291A,A00,087454,Xu; Zhouli,7,0,8,1
1653523479313,MATH 292,A00,087455,Staff,10,0,10,0
1653523479837,MATH 295,A00,087456,Staff,50,0,50,0
1653523480362,MATH 297,001,087457,Staff,998,0,999,1
1653524042003,COGS 200,A01,087991,Staff,47,0,50,3
1653524042535,COGS 201,A01,094504,Rangel; Lara M,17,0,25,8
1653524043059,COGS 203,A00,087992,Coulson; Seana M,18,0,20,2
1653524043589,COGS 210A,001,087993,Greene; Deanna Jacquelyn,9998,0,9999,1
1653524043589,COGS 210A,002,087994,Saygin; Ayse P,9999,0,9999,0
1653524043589,COGS 210A,003,087995,Xia; Haijun,9999,0,9999,0
1653524043589,COGS 210A,004,087996,Nitz; Douglas A.,9999,0,9999,0
1653524043589,COGS 210A,005,087997,Hollan; James D.,9999,0,9999,0
1653524043589,COGS 210A,006,087998,Deak; Gedeon O.,9998,0,9999,1
1653524043589,COGS 210A,007,087999,Rossano; Federico,9999,0,9999,0
1653524044120,COGS 211A,A00,088000,Coulson; Seana M,9997,0,9999,2
1653524044650,COGS 229,A00,088002,Staff,23,0,25,2
1653524045173,COGS 260,B00,094231,Staff,17,0,20,3
1653524045173,COGS 260,A00,088004,Nitz; Douglas A.,9998,0,9999,1
1653524045712,CSE 202,A00,090110,Paturi; Ramamohan,0,0,0,0
1653524045712,CSE 202,B00,090111,Paturi; Ramamohan,0,0,0,0
1653524046238,CSE 207B,A00,090112,Heninger; Nadia A,0,0,0,0
1653524046773,CSE 208,A00,094858,Micciancio; Daniele,0,0,0,0
1653524047299,CSE 210,A00,090113,Powell; Thomas Allan,0,0,0,0
1653524047823,CSE 219,A00,090898,Staff,0,0,0,0
1653524048359,CSE 221,A00,090114,Zhou; Yuan-Yuan,0,0,0,0
1653524048968,CSE 229A,A00,090115,Porter; George M,0,0,0,0
1653524049491,CSE 229C,A00,090116,Savage; Stefan,0,0,0,0
1653524050030,CSE 230,A00,090117,Jhala; Ranjit,0,0,0,0
1653524050552,CSE 232,A00,090118,Papakonstantinou; Yannis,0,0,0,0
1653524051075,CSE 239A,A00,090121,Kumar; Arun Kumar,0,0,0,0
1653524051597,CSE 239B,A00,090122,Jhala; Ranjit,0,0,0,0
1653524052121,CSE 240A,A00,090123,Zhao; Jishen,0,0,189,189
1653524052648,CSE 243A,A00,090124,Orailoglu; Alex,0,0,15,15
1653524053175,CSE 249B,A00,090125,Kahng; Andrew Byun,13,0,20,7
1653524053706,CSE 250A,A00,090126,Berg-Kirkpatrick; Taylor D,0,0,0,0
1653524054232,CSE 252A,A00,090127,Ochoa; Benjamin Lawrence,0,0,0,0
1653524054757,CSE 258,A01,090129,McAuley; Julian John,0,0,0,0
1653524055282,CSE 258R,A01,090131,McAuley; Julian John,0,0,0,0
1653524055807,CSE 274,A00,090132,Ramamoorthi; Ravi,0,0,0,0
1653524056334,CSE 276A,A00,090133,Christensen; Henrik I,0,0,0,0
1653524056858,CSE 276C,A00,090134,Christensen; Henrik I,0,0,0,0
1653524057386,CSE 290,A00,090135,Bafna; Vineet,0,0,0,0
1653524057386,CSE 290,B00,090136,Ramamoorthi; Ravi,0,0,0,0
1653524057386,CSE 290,C00,090137,Li; Tzumao,8,0,10,2
1653524057386,CSE 290,D00,090138,Zhou; Yuan-Yuan,9,0,10,1
1653524057386,CSE 290,E00,090139,Christensen; Henrik I,9,0,10,1
1653524057386,CSE 290,F00,094053,Shalev; Aaron D,0,0,0,0
1653524057910,CSE 291,A00,090140,Munyaka; Imani N. S.,0,0,0,0
1653524057910,CSE 291,B00,094880,Yu; Qi,0,0,0,0
1653524057910,CSE 291,C00,090142,Pannuto; Patrick William,0,0,0,0
1653524057910,CSE 291,D00,094881,Zhang; Yiying,0,0,0,0
1653524057910,CSE 291,E00,095118,Su; Hao,0,0,0,0
1653524058437,CSE 293,001,094905,Bafna; Vineet,9999,0,9999,0
1653524058437,CSE 293,002,094906,Bellare; Mihir,9999,0,9999,0
1653524058437,CSE 293,003,094907,Berg-Kirkpatrick; Taylor D,9999,0,9999,0
1653524058437,CSE 293,004,094908,Christensen; Henrik I,9999,0,9999,0
1653524058437,CSE 293,005,094909,Cottrell; Garrison W,9999,0,9999,0
1653524058437,CSE 293,006,094910,Deutsch; Alin Bernard,9999,0,9999,0
1653524058437,CSE 293,007,094911,Esmaeilzadeh; Hadi,9999,0,9999,0
1653524058437,CSE 293,008,094912,Freund; Yoav,9999,0,9999,0
1653524058437,CSE 293,009,094913,Griswold; William G.,9999,0,9999,0
1653524058437,CSE 293,010,094914,Gymrek; Melissa Ann,9999,0,9999,0
1653524058437,CSE 293,011,094915,Heninger; Nadia A,9999,0,9999,0
1653524058437,CSE 293,012,094916,Impagliazzo; Russell,9999,0,9999,0
1653524058437,CSE 293,013,094917,Jhala; Ranjit,9999,0,9999,0
1653524058437,CSE 293,014,094918,Kahng; Andrew Byun,9999,0,9999,0
1653524058437,CSE 293,015,094919,Kane; Daniel Mertz,9999,0,9999,0
1653524058437,CSE 293,016,094920,Kriegman; David J,9999,0,9999,0
1653524058437,CSE 293,017,094921,Kumar; Arun Kumar,9999,0,9999,0
1653524058437,CSE 293,018,094922,Lerner; Sorin,9999,0,9999,0
1653524058437,CSE 293,019,094923,Lovett; Shachar,9999,0,9999,0
1653524058437,CSE 293,020,094924,McAuley; Julian John,9999,0,9999,0
1653524058437,CSE 293,021,094925,Micciancio; Daniele,9999,0,9999,0
1653524058437,CSE 293,022,094926,Orailoglu; Alex,9999,0,9999,0
1653524058437,CSE 293,023,094927,Paturi; Ramamohan,9999,0,9999,0
1653524058437,CSE 293,024,094928,Polikarpova; Nadezhda,9999,0,9999,0
1653524058437,CSE 293,025,094929,Politz; Joseph Gibbs,9999,0,9999,0
1653524058437,CSE 293,026,094930,Porter; George M,9999,0,9999,0
1653524058437,CSE 293,027,094931,Porter; Leonard Emerson,9999,0,9999,0
1653524058437,CSE 293,028,094932,Ramamoorthi; Ravi,9999,0,9999,0
1653524058437,CSE 293,029,094933,Sahoo; Debashis,9999,0,9999,0
1653524058437,CSE 293,030,094934,Saul; Lawrence,9999,0,9999,0
1653524058437,CSE 293,031,094935,Savage; Stefan,9999,0,9999,0
1653524058437,CSE 293,032,094936,Schulze; Jurgen P.,9999,0,9999,0
1653524058437,CSE 293,033,094937,Snoeren; Alex C.,9999,0,9999,0
1653524058437,CSE 293,034,094938,Shang; Jingbo,9999,0,9999,0
1653524058437,CSE 293,035,094939,Stefan; Deian,9999,0,9999,0
1653524058437,CSE 293,036,094940,Su; Hao,9999,0,9999,0
1653524058437,CSE 293,037,094941,Swanson; Steven James,9999,0,9999,0
1653524058437,CSE 293,038,094942,Tullsen; Dean Michael,9999,0,9999,0
1653524058437,CSE 293,039,094943,Voelker; Geoffrey M.,9999,0,9999,0
1653524058437,CSE 293,040,094944,Zhao; Jishen,9999,0,9999,0
1653524058437,CSE 293,041,094945,Zhou; Yuan-Yuan,9999,0,9999,0
1653524058437,CSE 293,042,094946,Gao; Sicun,9998,0,9999,1
1653524058437,CSE 293,043,094947,Weibel; Nadir,9999,0,9999,0
1653524058437,CSE 293,044,094948,Gupta; Rajesh K.,9999,0,9999,0
1653524058959,CSE 294,A00,090143,Porter; George M,8,0,10,2
1653524059481,DSE 200,A00,091799,Staff,50,0,50,0
1653524060003,DSE 203,A00,091800,Gupta; Amarnath,30,0,30,0
1653524060525,DSE 250,A00,091801,Deutsch; Alin Bernard,30,0,30,0
1653524061051,DSE 290,A00,091802,Altintas De Callaf; Ilkay,50,0,50,0
1653524061580,ECE 200,001,091003,Antipa; Nicholas A,9999,0,9999,0
1653524061580,ECE 200,002,091004,Atanasov; Nikolay A.,9999,0,9999,0
1653524061580,ECE 200,003,091005,Bharadia; Dinesh,9999,0,9999,0
1653524061580,ECE 200,004,091006,Cheng; Chung Kuan,9999,0,9999,0
1653524061580,ECE 200,005,091007,Cosman; Pamela C.,9999,0,9999,0
1653524061580,ECE 200,006,091008,Staff,9999,0,9999,0
1653524061580,ECE 200,007,091009,Dayeh; Shadi Ahmad,9999,0,9999,0
1653524061580,ECE 200,008,091010,Fainman; Yeshaiahu,9999,0,9999,0
1653524061580,ECE 200,009,091011,Ford; Joseph Earl,9999,0,9999,0
1653524061580,ECE 200,010,091012,Franceschetti; Massimo,9999,0,9999,0
1653524061580,ECE 200,011,091013,Fullerton; Eric E,9999,0,9999,0
1653524061580,ECE 200,012,091014,Galton; Ian A,9999,0,9999,0
1653524061580,ECE 200,013,091015,Gilja; Vikash,9999,0,9999,0
1653524061580,ECE 200,014,091016,Hall; Drew A.,9999,0,9999,0
1653524061580,ECE 200,015,091017,Hsueh; Tzu-Chien,9999,0,9999,0
1653524061580,ECE 200,016,091018,Javidi; Tara,9999,0,9999,0
1653524061580,ECE 200,017,091019,Kahng; Andrew Byun,9999,0,9999,0
1653524061580,ECE 200,018,091020,Kim; Young-Han,9999,0,9999,0
1653524061580,ECE 200,019,091021,Koushanfar; Farinaz,9999,0,9999,0
1653524061580,ECE 200,020,091022,Kuzum; Duygu,9999,0,9999,0
1653524061580,ECE 200,021,091023,Le; Hanh-Phuc,9999,0,9999,0
1653524061580,ECE 200,022,091024,Lin; Bill,9999,0,9999,0
1653524061580,ECE 200,023,091025,Liu; Zhaowei,9999,0,9999,0
1653524061580,ECE 200,024,091026,Lo; Yu-Hwa,9999,0,9999,0
1653524061580,ECE 200,025,091027,Lomakin; Vitaliy,9999,0,9999,0
1653524061580,ECE 200,026,091028,Mercier; Patrick Philip,9999,0,9999,0
1653524061580,ECE 200,027,091029,Meyer; Florian,9999,0,9999,0
1653524061580,ECE 200,028,091030,Milstein; Laurence B.,9999,0,9999,0
1653524061580,ECE 200,029,091031,Mir Arabbaygi; Siavash,9999,0,9999,0
1653524061580,ECE 200,030,091032,Mookherjea; Shayan,9999,0,9999,0
1653524061580,ECE 200,031,091033,Morris; Karcher William,9999,0,9999,0
1653524061580,ECE 200,032,091034,Ng; Tse Nga,9999,0,9999,0
1653524061580,ECE 200,033,091035,Nguyen; Truong Quang,9999,0,9999,0
1653524061580,ECE 200,034,091036,Nomura; Kenji,9999,0,9999,0
1653524061580,ECE 200,035,091037,Orlitsky; Alon,9999,0,9999,0
1653524061580,ECE 200,036,091038,Pal; Piya,9999,0,9999,0
1653524061580,ECE 200,037,091039,Papen; George C.,9999,0,9999,0
1653524061580,ECE 200,038,091040,Radic; Stojan,9999,0,9999,0
1653524061580,ECE 200,039,091041,Rao; Bhaskar D.,9999,0,9999,0
1653524061580,ECE 200,040,091042,Rao; Ramesh R,9999,0,9999,0
1653524061580,ECE 200,041,091043,Rebeiz; Gabriel,9999,0,9999,0
1653524061580,ECE 200,042,091044,Sanford; John R,9999,0,9999,0
1653524061580,ECE 200,043,091045,Siegel; Paul H.,9999,0,9999,0
1653524061580,ECE 200,044,091046,Sievenpiper; Daniel F.,9999,0,9999,0
1653524061580,ECE 200,045,091047,Sworder; David D.,9999,0,9999,0
1653524061580,ECE 200,046,091048,Taur; Yuan,9999,0,9999,0
1653524061580,ECE 200,047,091049,Touri; Behrouz,9999,0,9999,0
1653524061580,ECE 200,048,091050,Trivedi; Mohan M.,9999,0,9999,0
1653524061580,ECE 200,049,091051,Vardy; Alexander,9999,0,9999,0
1653524061580,ECE 200,050,091052,Vasconcelos; Nuno,9999,0,9999,0
1653524061580,ECE 200,051,091053,Wang; Xiaolong,9999,0,9999,0
1653524061580,ECE 200,052,091054,Xie; Pengtao,9999,0,9999,0
1653524061580,ECE 200,053,091055,Yip; Michael,9999,0,9999,0
1653524061580,ECE 200,054,091056,Zeger; Kenneth A.,9999,0,9999,0
1653524061580,ECE 200,055,091057,Zhang; Xinyu,9999,0,9999,0
1653524061580,ECE 200,056,091058,Turakhia; Yatish Girish,9999,0,9999,0
1653524061580,ECE 200,057,091059,Kang; Mingu,9999,0,9999,0
1653524061580,ECE 200,058,091060,Shi; Yuanyuan,9999,0,9999,0
1653524061580,ECE 200,059,091061,Wang; Edward Jay,9999,0,9999,0
1653524061580,ECE 200,060,091062,Zheng; Yang,9999,0,9999,0
1653524062105,ECE 201,A00,095526,Lo; Yu-Hwa,0,0,0,0
1653524062632,ECE 203,A00,091065,Mercier; Patrick Philip,0,0,0,0
1653524063156,ECE 207A,A00,091605,Liu; Thomas Tao-Ming,0,0,0,0
1653524063680,ECE 212AN,A00,091068,Nomura; Kenji,0,0,0,0
1653524064206,ECE 222A,A00,091069,Rebeiz; Gabriel,0,0,0,0
1653524064731,ECE 225A,A00,091070,Orlitsky; Alon,0,0,0,0
1653524065261,ECE 230A,A00,091071,Nomura; Kenji,0,0,0,0
1653524065794,ECE 236A,A00,091072,Dayeh; Shadi Ahmad,0,0,0,0
1653524066316,ECE 238A,A00,091073,Luo; Jian,0,0,0,0
1653524066316,ECE 238A,B00,091074,Luo; Jian,0,0,0,0
1653524066844,ECE 240A,A00,091075,Radic; Stojan,0,0,0,0
1653524067370,ECE 247A,A00,091592,Shi; Lingyan,0,0,0,0
1653524067901,ECE 250,A00,091076,Touri; Behrouz,0,0,0,0
1653524068426,ECE 251C,A00,091078,Nguyen; Truong Quang,0,0,0,0
1653524068957,ECE 253,A00,091079,Cosman; Pamela C.,0,0,0,0
1653524069485,ECE 255A,A00,091080,Orlitsky; Alon,0,0,0,0
1653524070008,ECE 257A,A00,091081,Zhang; Xinyu,0,0,0,0
1653524070535,ECE 260A,A01,091084,Eldon; John,0,0,0,0
1653524071062,ECE 264C,A00,091085,Galton; Ian A,0,0,0,0
1653524071594,ECE 265C,A00,094889,Presti; Calogero Davide,0,0,0,9
1653524072116,ECE 266,A01,091087,Hall; Drew A.,0,0,0,0
1653524073165,ECE 271A,A00,091090,Vasconcelos; Nuno,0,0,0,0
1653524073689,ECE 272B,A00,091091,Sworder; David D.,0,0,0,0
1653524074214,ECE 275A,A00,091092,Meyer; Florian,0,0,0,0
1653524074742,ECE 277,A00,091093,An; Cheolhong,0,0,0,0
1653524075275,ECE 283,A00,091094,Le; Hanh-Phuc,0,0,0,0
1653524075801,ECE 284,A00,091095,Kang; Mingu,0,0,0,0
1653524075801,ECE 284,B00,091096,Wang; Edward Jay,0,0,0,0
1653524076324,ECE 285,A00,094334,Touri; Behrouz,0,0,0,0
1653524076851,ECE 289,A00,091097,Whelan; David Arthur,0,0,0,0
1653524077379,MATH 200A,A00,087414,Salehi Golsefidy; Alireza,7,0,8,1
1653524077905,MATH 202A,A00,087415,Gill; Philip E.,2,0,8,6
1653524078431,MATH 203A,A00,087416,Oprea; Dragos N.,6,0,8,2
1653524078954,MATH 204A,A00,087417,Kedlaya; Kiran S.,6,0,8,2
1653524079481,MATH 205,A00,087418,Sorensen; Claus M,6,0,8,2
1653524080004,MATH 206A,A00,087419,Izadi; Elham,7,0,8,1
1653524080536,MATH 207A,A00,087420,Mohammadi; Amir,5,0,8,3
1653524081064,MATH 208,A00,087421,Staff,9,0,10,1
1653524081591,MATH 209,A00,087422,Staff,10,0,10,0
1653524082114,MATH 218,A00,087423,Staff,10,0,10,0
1653524082640,MATH 220A,A00,087424,Novak; Jonathan I,7,0,8,1
1653524083166,MATH 231A,A00,087425,Bejenaru; Ioan,3,0,8,5
1653524083688,MATH 240A,A00,087426,Ebenfelt; Peter F,5,0,8,3
1653524084211,MATH 243,A00,087427,Staff,9,0,10,1
1653524084732,MATH 248,A00,087429,Staff,10,0,10,0
1653524085256,MATH 250A,A00,087430,Spolaor; Luca,4,0,8,4
1653524085786,MATH 257A,A00,087431,Spolaor; Luca,7,0,8,1
1653524086309,MATH 258,A00,087432,Staff,9,0,10,1
1653524086845,MATH 264A,A00,087433,Warnke; Lutz Peter,5,0,8,3
1653524087370,MATH 268,A00,087434,Staff,15,0,15,0
1653524087893,MATH 269,A00,087435,Staff,14,0,15,1
1653524088417,MATH 270A,A00,087436,Nie; Jiawang,0,0,8,8
1653524088947,MATH 272A,A00,087437,Tian; Xiaochuan,1,0,8,7
1653524089470,MATH 274,A01,087439,Cheng; Li-Tien,9,0,10,1
1653524089470,MATH 274,A02,087440,Cheng; Li-Tien,10,0,10,0
1653524089993,MATH 278A,A00,087441,Staff,8,0,10,2
1653524090518,MATH 278B,A00,087442,Staff,8,0,10,2
1653524091044,MATH 278C,A00,087443,Staff,8,0,10,2
1653524091569,MATH 280A,A00,087444,Zheng; Tianyi,0,0,8,8
1653524092099,MATH 281A,A00,087445,Bradic; Jelena,0,0,8,8
1653524092626,MATH 282A,A00,087446,Zhang; Danna,0,0,8,8
1653524093151,MATH 283,A00,087447,Tesler; Glenn,0,0,0,15
1653524093678,MATH 286,A00,087448,Kemp; Todd Aahron,5,0,8,3
1653524094211,MATH 287D,A00,087449,Bradic; Jelena,0,0,0,0
1653524094740,MATH 288,A00,087450,Staff,14,0,15,1
1653524094740,MATH 288,B00,087451,Staff,15,0,15,0
1653524094740,MATH 288,C00,087452,Staff,15,0,15,0
1653524095267,MATH 290A,A00,087453,Xu; Zhouli,6,0,8,2
1653524095793,MATH 291A,A00,087454,Xu; Zhouli,7,0,8,1
1653524096316,MATH 292,A00,087455,Staff,10,0,10,0
1653524096839,MATH 295,A00,087456,Staff,50,0,50,0
1653524097364,MATH 297,001,087457,Staff,998,0,999,1
1653524657653,COGS 200,A01,087991,Staff,47,0,50,3
1653524658180,COGS 201,A01,094504,Rangel; Lara M,17,0,25,8
1653524658703,COGS 203,A00,087992,Coulson; Seana M,18,0,20,2
1653524659227,COGS 210A,001,087993,Greene; Deanna Jacquelyn,9998,0,9999,1
1653524659227,COGS 210A,002,087994,Saygin; Ayse P,9999,0,9999,0
1653524659227,COGS 210A,003,087995,Xia; Haijun,9999,0,9999,0
1653524659227,COGS 210A,004,087996,Nitz; Douglas A.,9999,0,9999,0
1653524659227,COGS 210A,005,087997,Hollan; James D.,9999,0,9999,0
1653524659227,COGS 210A,006,087998,Deak; Gedeon O.,9998,0,9999,1
1653524659227,COGS 210A,007,087999,Rossano; Federico,9999,0,9999,0
1653524659759,COGS 211A,A00,088000,Coulson; Seana M,9997,0,9999,2
1653524660282,COGS 229,A00,088002,Staff,23,0,25,2
1653524660805,COGS 260,B00,094231,Staff,17,0,20,3
1653524660805,COGS 260,A00,088004,Nitz; Douglas A.,9998,0,9999,1
1653524661333,CSE 202,A00,090110,Paturi; Ramamohan,0,0,0,0
1653524661333,CSE 202,B00,090111,Paturi; Ramamohan,0,0,0,0
1653524661860,CSE 207B,A00,090112,Heninger; Nadia A,0,0,0,0
1653524662382,CSE 208,A00,094858,Micciancio; Daniele,0,0,0,0
1653524662904,CSE 210,A00,090113,Powell; Thomas Allan,0,0,0,0
1653524663439,CSE 219,A00,090898,Staff,0,0,0,0
1653524663966,CSE 221,A00,090114,Zhou; Yuan-Yuan,0,0,0,0
1653524664489,CSE 229A,A00,090115,Porter; George M,0,0,0,0
1653524665018,CSE 229C,A00,090116,Savage; Stefan,0,0,0,0
1653524665544,CSE 230,A00,090117,Jhala; Ranjit,0,0,0,0
1653524666075,CSE 232,A00,090118,Papakonstantinou; Yannis,0,0,0,0
1653524666600,CSE 239A,A00,090121,Kumar; Arun Kumar,0,0,0,0
1653524667122,CSE 239B,A00,090122,Jhala; Ranjit,0,0,0,0
1653524667645,CSE 240A,A00,090123,Zhao; Jishen,0,0,189,189
1653524668170,CSE 243A,A00,090124,Orailoglu; Alex,0,0,15,15
1653524668696,CSE 249B,A00,090125,Kahng; Andrew Byun,13,0,20,7
1653524669218,CSE 250A,A00,090126,Berg-Kirkpatrick; Taylor D,0,0,0,0
1653524669743,CSE 252A,A00,090127,Ochoa; Benjamin Lawrence,0,0,0,0
1653524670268,CSE 258,A01,090129,McAuley; Julian John,0,0,0,0
1653524670790,CSE 258R,A01,090131,McAuley; Julian John,0,0,0,0
1653524671326,CSE 274,A00,090132,Ramamoorthi; Ravi,0,0,0,0
1653524671848,CSE 276A,A00,090133,Christensen; Henrik I,0,0,0,0
1653524672370,CSE 276C,A00,090134,Christensen; Henrik I,0,0,0,0
1653524672894,CSE 290,A00,090135,Bafna; Vineet,0,0,0,0
1653524672894,CSE 290,B00,090136,Ramamoorthi; Ravi,0,0,0,0
1653524672894,CSE 290,C00,090137,Li; Tzumao,8,0,10,2
1653524672894,CSE 290,D00,090138,Zhou; Yuan-Yuan,9,0,10,1
1653524672894,CSE 290,E00,090139,Christensen; Henrik I,9,0,10,1
1653524672894,CSE 290,F00,094053,Shalev; Aaron D,0,0,0,0
1653524673415,CSE 291,A00,090140,Munyaka; Imani N. S.,0,0,0,0
1653524673415,CSE 291,B00,094880,Yu; Qi,0,0,0,0
1653524673415,CSE 291,C00,090142,Pannuto; Patrick William,0,0,0,0
1653524673415,CSE 291,D00,094881,Zhang; Yiying,0,0,0,0
1653524673415,CSE 291,E00,095118,Su; Hao,0,0,0,0
1653524673942,CSE 293,001,094905,Bafna; Vineet,9999,0,9999,0
1653524673942,CSE 293,002,094906,Bellare; Mihir,9999,0,9999,0
1653524673942,CSE 293,003,094907,Berg-Kirkpatrick; Taylor D,9999,0,9999,0
1653524673942,CSE 293,004,094908,Christensen; Henrik I,9999,0,9999,0
1653524673942,CSE 293,005,094909,Cottrell; Garrison W,9999,0,9999,0
1653524673942,CSE 293,006,094910,Deutsch; Alin Bernard,9999,0,9999,0
1653524673942,CSE 293,007,094911,Esmaeilzadeh; Hadi,9999,0,9999,0
1653524673942,CSE 293,008,094912,Freund; Yoav,9999,0,9999,0
1653524673942,CSE 293,009,094913,Griswold; William G.,9999,0,9999,0
1653524673942,CSE 293,010,094914,Gymrek; Melissa Ann,9999,0,9999,0
1653524673942,CSE 293,011,094915,Heninger; Nadia A,9999,0,9999,0
1653524673942,CSE 293,012,094916,Impagliazzo; Russell,9999,0,9999,0
1653524673942,CSE 293,013,094917,Jhala; Ranjit,9999,0,9999,0
1653524673942,CSE 293,014,094918,Kahng; Andrew Byun,9999,0,9999,0
1653524673942,CSE 293,015,094919,Kane; Daniel Mertz,9999,0,9999,0
1653524673942,CSE 293,016,094920,Kriegman; David J,9999,0,9999,0
1653524673942,CSE 293,017,094921,Kumar; Arun Kumar,9999,0,9999,0
1653524673942,CSE 293,018,094922,Lerner; Sorin,9999,0,9999,0
1653524673942,CSE 293,019,094923,Lovett; Shachar,9999,0,9999,0
1653524673942,CSE 293,020,094924,McAuley; Julian John,9999,0,9999,0
1653524673942,CSE 293,021,094925,Micciancio; Daniele,9999,0,9999,0
1653524673942,CSE 293,022,094926,Orailoglu; Alex,9999,0,9999,0
1653524673942,CSE 293,023,094927,Paturi; Ramamohan,9999,0,9999,0
1653524673942,CSE 293,024,094928,Polikarpova; Nadezhda,9999,0,9999,0
1653524673942,CSE 293,025,094929,Politz; Joseph Gibbs,9999,0,9999,0
1653524673942,CSE 293,026,094930,Porter; George M,9999,0,9999,0
1653524673942,CSE 293,027,094931,Porter; Leonard Emerson,9999,0,9999,0
1653524673942,CSE 293,028,094932,Ramamoorthi; Ravi,9999,0,9999,0
1653524673942,CSE 293,029,094933,Sahoo; Debashis,9999,0,9999,0
1653524673942,CSE 293,030,094934,Saul; Lawrence,9999,0,9999,0
1653524673942,CSE 293,031,094935,Savage; Stefan,9999,0,9999,0
1653524673942,CSE 293,032,094936,Schulze; Jurgen P.,9999,0,9999,0
1653524673942,CSE 293,033,094937,Snoeren; Alex C.,9999,0,9999,0
1653524673942,CSE 293,034,094938,Shang; Jingbo,9999,0,9999,0
1653524673942,CSE 293,035,094939,Stefan; Deian,9999,0,9999,0
1653524673942,CSE 293,036,094940,Su; Hao,9999,0,9999,0
1653524673942,CSE 293,037,094941,Swanson; Steven James,9999,0,9999,0
1653524673942,CSE 293,038,094942,Tullsen; Dean Michael,9999,0,9999,0
1653524673942,CSE 293,039,094943,Voelker; Geoffrey M.,9999,0,9999,0
1653524673942,CSE 293,040,094944,Zhao; Jishen,9999,0,9999,0
1653524673942,CSE 293,041,094945,Zhou; Yuan-Yuan,9999,0,9999,0
1653524673942,CSE 293,042,094946,Gao; Sicun,9998,0,9999,1
1653524673942,CSE 293,043,094947,Weibel; Nadir,9999,0,9999,0
1653524673942,CSE 293,044,094948,Gupta; Rajesh K.,9999,0,9999,0
1653524674468,CSE 294,A00,090143,Porter; George M,8,0,10,2
1653524674997,DSE 200,A00,091799,Staff,50,0,50,0
1653524675520,DSE 203,A00,091800,Gupta; Amarnath,30,0,30,0
1653524676043,DSE 250,A00,091801,Deutsch; Alin Bernard,30,0,30,0
1653524676583,DSE 290,A00,091802,Altintas De Callaf; Ilkay,50,0,50,0
1653524677121,ECE 200,001,091003,Antipa; Nicholas A,9999,0,9999,0
1653524677121,ECE 200,002,091004,Atanasov; Nikolay A.,9999,0,9999,0
1653524677121,ECE 200,003,091005,Bharadia; Dinesh,9999,0,9999,0
1653524677121,ECE 200,004,091006,Cheng; Chung Kuan,9999,0,9999,0
1653524677121,ECE 200,005,091007,Cosman; Pamela C.,9999,0,9999,0
1653524677121,ECE 200,006,091008,Staff,9999,0,9999,0
1653524677121,ECE 200,007,091009,Dayeh; Shadi Ahmad,9999,0,9999,0
1653524677121,ECE 200,008,091010,Fainman; Yeshaiahu,9999,0,9999,0
1653524677121,ECE 200,009,091011,Ford; Joseph Earl,9999,0,9999,0
1653524677121,ECE 200,010,091012,Franceschetti; Massimo,9999,0,9999,0
1653524677121,ECE 200,011,091013,Fullerton; Eric E,9999,0,9999,0
1653524677121,ECE 200,012,091014,Galton; Ian A,9999,0,9999,0
1653524677121,ECE 200,013,091015,Gilja; Vikash,9999,0,9999,0
1653524677121,ECE 200,014,091016,Hall; Drew A.,9999,0,9999,0
1653524677121,ECE 200,015,091017,Hsueh; Tzu-Chien,9999,0,9999,0
1653524677121,ECE 200,016,091018,Javidi; Tara,9999,0,9999,0
1653524677121,ECE 200,017,091019,Kahng; Andrew Byun,9999,0,9999,0
1653524677121,ECE 200,018,091020,Kim; Young-Han,9999,0,9999,0
1653524677121,ECE 200,019,091021,Koushanfar; Farinaz,9999,0,9999,0
1653524677121,ECE 200,020,091022,Kuzum; Duygu,9999,0,9999,0
1653524677121,ECE 200,021,091023,Le; Hanh-Phuc,9999,0,9999,0
1653524677121,ECE 200,022,091024,Lin; Bill,9999,0,9999,0
1653524677121,ECE 200,023,091025,Liu; Zhaowei,9999,0,9999,0
1653524677121,ECE 200,024,091026,Lo; Yu-Hwa,9999,0,9999,0
1653524677121,ECE 200,025,091027,Lomakin; Vitaliy,9999,0,9999,0
1653524677121,ECE 200,026,091028,Mercier; Patrick Philip,9999,0,9999,0
1653524677121,ECE 200,027,091029,Meyer; Florian,9999,0,9999,0
1653524677121,ECE 200,028,091030,Milstein; Laurence B.,9999,0,9999,0
1653524677121,ECE 200,029,091031,Mir Arabbaygi; Siavash,9999,0,9999,0
1653524677121,ECE 200,030,091032,Mookherjea; Shayan,9999,0,9999,0
1653524677121,ECE 200,031,091033,Morris; Karcher William,9999,0,9999,0
1653524677121,ECE 200,032,091034,Ng; Tse Nga,9999,0,9999,0
1653524677121,ECE 200,033,091035,Nguyen; Truong Quang,9999,0,9999,0
1653524677121,ECE 200,034,091036,Nomura; Kenji,9999,0,9999,0
1653524677121,ECE 200,035,091037,Orlitsky; Alon,9999,0,9999,0
1653524677121,ECE 200,036,091038,Pal; Piya,9999,0,9999,0
1653524677121,ECE 200,037,091039,Papen; George C.,9999,0,9999,0
1653524677121,ECE 200,038,091040,Radic; Stojan,9999,0,9999,0
1653524677121,ECE 200,039,091041,Rao; Bhaskar D.,9999,0,9999,0
1653524677121,ECE 200,040,091042,Rao; Ramesh R,9999,0,9999,0
1653524677121,ECE 200,041,091043,Rebeiz; Gabriel,9999,0,9999,0
1653524677121,ECE 200,042,091044,Sanford; John R,9999,0,9999,0
1653524677121,ECE 200,043,091045,Siegel; Paul H.,9999,0,9999,0
1653524677121,ECE 200,044,091046,Sievenpiper; Daniel F.,9999,0,9999,0
1653524677121,ECE 200,045,091047,Sworder; David D.,9999,0,9999,0
1653524677121,ECE 200,046,091048,Taur; Yuan,9999,0,9999,0
1653524677121,ECE 200,047,091049,Touri; Behrouz,9999,0,9999,0
1653524677121,ECE 200,048,091050,Trivedi; Mohan M.,9999,0,9999,0
1653524677121,ECE 200,049,091051,Vardy; Alexander,9999,0,9999,0
1653524677121,ECE 200,050,091052,Vasconcelos; Nuno,9999,0,9999,0
1653524677121,ECE 200,051,091053,Wang; Xiaolong,9999,0,9999,0
1653524677121,ECE 200,052,091054,Xie; Pengtao,9999,0,9999,0
1653524677121,ECE 200,053,091055,Yip; Michael,9999,0,9999,0
1653524677121,ECE 200,054,091056,Zeger; Kenneth A.,9999,0,9999,0
1653524677121,ECE 200,055,091057,Zhang; Xinyu,9999,0,9999,0
1653524677121,ECE 200,056,091058,Turakhia; Yatish Girish,9999,0,9999,0
1653524677121,ECE 200,057,091059,Kang; Mingu,9999,0,9999,0
1653524677121,ECE 200,058,091060,Shi; Yuanyuan,9999,0,9999,0
1653524677121,ECE 200,059,091061,Wang; Edward Jay,9999,0,9999,0
1653524677121,ECE 200,060,091062,Zheng; Yang,9999,0,9999,0
1653524677647,ECE 201,A00,095526,Lo; Yu-Hwa,0,0,0,0
1653524678179,ECE 203,A00,091065,Mercier; Patrick Philip,0,0,0,0
1653524678701,ECE 207A,A00,091605,Liu; Thomas Tao-Ming,0,0,0,0
1653524679230,ECE 212AN,A00,091068,Nomura; Kenji,0,0,0,0
1653524679757,ECE 222A,A00,091069,Rebeiz; Gabriel,0,0,0,0
1653524680279,ECE 225A,A00,091070,Orlitsky; Alon,0,0,0,0
1653524680801,ECE 230A,A00,091071,Nomura; Kenji,0,0,0,0
1653524681326,ECE 236A,A00,091072,Dayeh; Shadi Ahmad,0,0,0,0
1653524681850,ECE 238A,A00,091073,Luo; Jian,0,0,0,0
1653524681850,ECE 238A,B00,091074,Luo; Jian,0,0,0,0
1653524682373,ECE 240A,A00,091075,Radic; Stojan,0,0,0,0
1653524682898,ECE 247A,A00,091592,Shi; Lingyan,0,0,0,0
1653524683421,ECE 250,A00,091076,Touri; Behrouz,0,0,0,0
1653524683947,ECE 251C,A00,091078,Nguyen; Truong Quang,0,0,0,0
1653524684474,ECE 253,A00,091079,Cosman; Pamela C.,0,0,0,0
1653524684996,ECE 255A,A00,091080,Orlitsky; Alon,0,0,0,0
1653524685519,ECE 257A,A00,091081,Zhang; Xinyu,0,0,0,0
1653524686043,ECE 260A,A01,091084,Eldon; John,0,0,0,0
1653524686572,ECE 264C,A00,091085,Galton; Ian A,0,0,0,0
1653524687094,ECE 265C,A00,094889,Presti; Calogero Davide,0,0,0,9
1653524687616,ECE 266,A01,091087,Hall; Drew A.,0,0,0,0
1653524688668,ECE 271A,A00,091090,Vasconcelos; Nuno,0,0,0,0
1653524689191,ECE 272B,A00,091091,Sworder; David D.,0,0,0,0
1653524689811,ECE 275A,A00,091092,Meyer; Florian,0,0,0,0
1653524690334,ECE 277,A00,091093,An; Cheolhong,0,0,0,0
1653524690872,ECE 283,A00,091094,Le; Hanh-Phuc,0,0,0,0
1653524691398,ECE 284,A00,091095,Kang; Mingu,0,0,0,0
1653524691398,ECE 284,B00,091096,Wang; Edward Jay,0,0,0,0
1653524691932,ECE 285,A00,094334,Touri; Behrouz,0,0,0,0
1653524692455,ECE 289,A00,091097,Whelan; David Arthur,0,0,0,0
1653524692983,MATH 200A,A00,087414,Salehi Golsefidy; Alireza,7,0,8,1
1653524693505,MATH 202A,A00,087415,Gill; Philip E.,2,0,8,6
1653524694030,MATH 203A,A00,087416,Oprea; Dragos N.,6,0,8,2
1653524694556,MATH 204A,A00,087417,Kedlaya; Kiran S.,6,0,8,2
1653524695083,MATH 205,A00,087418,Sorensen; Claus M,6,0,8,2
1653524695606,MATH 206A,A00,087419,Izadi; Elham,7,0,8,1
1653524696131,MATH 207A,A00,087420,Mohammadi; Amir,5,0,8,3
1653524696664,MATH 208,A00,087421,Staff,9,0,10,1
1653524697186,MATH 209,A00,087422,Staff,10,0,10,0
1653524697711,MATH 218,A00,087423,Staff,10,0,10,0
1653524698237,MATH 220A,A00,087424,Novak; Jonathan I,7,0,8,1
1653524698762,MATH 231A,A00,087425,Bejenaru; Ioan,3,0,8,5
1653524699286,MATH 240A,A00,087426,Ebenfelt; Peter F,5,0,8,3
1653524699808,MATH 243,A00,087427,Staff,9,0,10,1
1653524700339,MATH 248,A00,087429,Staff,10,0,10,0
1653524700864,MATH 250A,A00,087430,Spolaor; Luca,4,0,8,4
1653524701388,MATH 257A,A00,087431,Spolaor; Luca,7,0,8,1
1653524701922,MATH 258,A00,087432,Staff,9,0,10,1
1653524702452,MATH 264A,A00,087433,Warnke; Lutz Peter,5,0,8,3
1653524702979,MATH 268,A00,087434,Staff,15,0,15,0
1653524703566,MATH 269,A00,087435,Staff,14,0,15,1
1653524704093,MATH 270A,A00,087436,Nie; Jiawang,0,0,8,8
1653524704626,MATH 272A,A00,087437,Tian; Xiaochuan,1,0,8,7
1653524705154,MATH 274,A01,087439,Cheng; Li-Tien,9,0,10,1
1653524705154,MATH 274,A02,087440,Cheng; Li-Tien,10,0,10,0
1653524705677,MATH 278A,A00,087441,Staff,8,0,10,2
1653524706199,MATH 278B,A00,087442,Staff,8,0,10,2
1653524706730,MATH 278C,A00,087443,Staff,8,0,10,2
1653524707254,MATH 280A,A00,087444,Zheng; Tianyi,0,0,8,8
1653524707786,MATH 281A,A00,087445,Bradic; Jelena,0,0,8,8
1653524708308,MATH 282A,A00,087446,Zhang; Danna,0,0,8,8
1653524708838,MATH 283,A00,087447,Tesler; Glenn,0,0,0,15
1653524709373,MATH 286,A00,087448,Kemp; Todd Aahron,5,0,8,3
1653524709895,MATH 287D,A00,087449,Bradic; Jelena,0,0,0,0
1653524710423,MATH 288,A00,087450,Staff,14,0,15,1
1653524710423,MATH 288,B00,087451,Staff,15,0,15,0
1653524710423,MATH 288,C00,087452,Staff,15,0,15,0
1653524710952,MATH 290A,A00,087453,Xu; Zhouli,6,0,8,2
1653524711477,MATH 291A,A00,087454,Xu; Zhouli,7,0,8,1
1653524712002,MATH 292,A00,087455,Staff,10,0,10,0
1653524712526,MATH 295,A00,087456,Staff,50,0,50,0
1653524713057,MATH 297,001,087457,Staff,998,0,999,1
1653525272834,COGS 200,A01,087991,Staff,47,0,50,3
1653525273358,COGS 201,A01,094504,Rangel; Lara M,17,0,25,8
1653525273882,COGS 203,A00,087992,Coulson; Seana M,18,0,20,2
1653525274410,COGS 210A,001,087993,Greene; Deanna Jacquelyn,9998,0,9999,1
1653525274410,COGS 210A,002,087994,Saygin; Ayse P,9999,0,9999,0
1653525274410,COGS 210A,003,087995,Xia; Haijun,9999,0,9999,0
1653525274410,COGS 210A,004,087996,Nitz; Douglas A.,9999,0,9999,0
1653525274410,COGS 210A,005,087997,Hollan; James D.,9999,0,9999,0
1653525274410,COGS 210A,006,087998,Deak; Gedeon O.,9998,0,9999,1
1653525274410,COGS 210A,007,087999,Rossano; Federico,9999,0,9999,0
1653525274933,COGS 211A,A00,088000,Coulson; Seana M,9997,0,9999,2
1653525275457,COGS 229,A00,088002,Staff,23,0,25,2
1653525275979,COGS 260,B00,094231,Staff,17,0,20,3
1653525275979,COGS 260,A00,088004,Nitz; Douglas A.,9998,0,9999,1
1653525276504,CSE 202,A00,090110,Paturi; Ramamohan,0,0,0,0
1653525276504,CSE 202,B00,090111,Paturi; Ramamohan,0,0,0,0
1653525277098,CSE 207B,A00,090112,Heninger; Nadia A,0,0,0,0
1653525277624,CSE 208,A00,094858,Micciancio; Daniele,0,0,0,0
1653525278147,CSE 210,A00,090113,Powell; Thomas Allan,0,0,0,0
1653525278669,CSE 219,A00,090898,Staff,0,0,0,0
1653525279194,CSE 221,A00,090114,Zhou; Yuan-Yuan,0,0,0,0
1653525279717,CSE 229A,A00,090115,Porter; George M,0,0,0,0
1653525280253,CSE 229C,A00,090116,Savage; Stefan,0,0,0,0
1653525280779,CSE 230,A00,090117,Jhala; Ranjit,0,0,0,0
1653525281301,CSE 232,A00,090118,Papakonstantinou; Yannis,0,0,0,0
1653525281824,CSE 239A,A00,090121,Kumar; Arun Kumar,0,0,0,0
1653525282347,CSE 239B,A00,090122,Jhala; Ranjit,0,0,0,0
1653525282879,CSE 240A,A00,090123,Zhao; Jishen,0,0,189,189
1653525283402,CSE 243A,A00,090124,Orailoglu; Alex,0,0,15,15
1653525283926,CSE 249B,A00,090125,Kahng; Andrew Byun,13,0,20,7
1653525284451,CSE 250A,A00,090126,Berg-Kirkpatrick; Taylor D,0,0,0,0
1653525284974,CSE 252A,A00,090127,Ochoa; Benjamin Lawrence,0,0,0,0
1653525285500,CSE 258,A01,090129,McAuley; Julian John,0,0,0,0
1653525286023,CSE 258R,A01,090131,McAuley; Julian John,0,0,0,0
1653525286545,CSE 274,A00,090132,Ramamoorthi; Ravi,0,0,0,0
1653525287075,CSE 276A,A00,090133,Christensen; Henrik I,0,0,0,0
1653525287597,CSE 276C,A00,090134,Christensen; Henrik I,0,0,0,0
1653525288120,CSE 290,A00,090135,Bafna; Vineet,0,0,0,0
1653525288120,CSE 290,B00,090136,Ramamoorthi; Ravi,0,0,0,0
1653525288120,CSE 290,C00,090137,Li; Tzumao,8,0,10,2
1653525288120,CSE 290,D00,090138,Zhou; Yuan-Yuan,9,0,10,1
1653525288120,CSE 290,E00,090139,Christensen; Henrik I,9,0,10,1
1653525288120,CSE 290,F00,094053,Shalev; Aaron D,0,0,0,0
1653525288643,CSE 291,A00,090140,Munyaka; Imani N. S.,0,0,0,0
1653525288643,CSE 291,B00,094880,Yu; Qi,0,0,0,0
1653525288643,CSE 291,C00,090142,Pannuto; Patrick William,0,0,0,0
1653525288643,CSE 291,D00,094881,Zhang; Yiying,0,0,0,0
1653525288643,CSE 291,E00,095118,Su; Hao,0,0,0,0
1653525289170,CSE 293,001,094905,Bafna; Vineet,9999,0,9999,0
1653525289170,CSE 293,002,094906,Bellare; Mihir,9999,0,9999,0
1653525289170,CSE 293,003,094907,Berg-Kirkpatrick; Taylor D,9999,0,9999,0
1653525289170,CSE 293,004,094908,Christensen; Henrik I,9999,0,9999,0
1653525289170,CSE 293,005,094909,Cottrell; Garrison W,9999,0,9999,0
1653525289170,CSE 293,006,094910,Deutsch; Alin Bernard,9999,0,9999,0
1653525289170,CSE 293,007,094911,Esmaeilzadeh; Hadi,9999,0,9999,0
1653525289170,CSE 293,008,094912,Freund; Yoav,9999,0,9999,0
1653525289170,CSE 293,009,094913,Griswold; William G.,9999,0,9999,0
1653525289170,CSE 293,010,094914,Gymrek; Melissa Ann,9999,0,9999,0
1653525289170,CSE 293,011,094915,Heninger; Nadia A,9999,0,9999,0
1653525289170,CSE 293,012,094916,Impagliazzo; Russell,9999,0,9999,0
1653525289170,CSE 293,013,094917,Jhala; Ranjit,9999,0,9999,0
1653525289170,CSE 293,014,094918,Kahng; Andrew Byun,9999,0,9999,0
1653525289170,CSE 293,015,094919,Kane; Daniel Mertz,9999,0,9999,0
1653525289170,CSE 293,016,094920,Kriegman; David J,9999,0,9999,0
1653525289170,CSE 293,017,094921,Kumar; Arun Kumar,9999,0,9999,0
1653525289170,CSE 293,018,094922,Lerner; Sorin,9999,0,9999,0
1653525289170,CSE 293,019,094923,Lovett; Shachar,9999,0,9999,0
1653525289170,CSE 293,020,094924,McAuley; Julian John,9999,0,9999,0
1653525289170,CSE 293,021,094925,Micciancio; Daniele,9999,0,9999,0
1653525289170,CSE 293,022,094926,Orailoglu; Alex,9999,0,9999,0
1653525289170,CSE 293,023,094927,Paturi; Ramamohan,9999,0,9999,0
1653525289170,CSE 293,024,094928,Polikarpova; Nadezhda,9999,0,9999,0
1653525289170,CSE 293,025,094929,Politz; Joseph Gibbs,9999,0,9999,0
1653525289170,CSE 293,026,094930,Porter; George M,9999,0,9999,0
1653525289170,CSE 293,027,094931,Porter; Leonard Emerson,9999,0,9999,0
1653525289170,CSE 293,028,094932,Ramamoorthi; Ravi,9999,0,9999,0
1653525289170,CSE 293,029,094933,Sahoo; Debashis,9999,0,9999,0
1653525289170,CSE 293,030,094934,Saul; Lawrence,9999,0,9999,0
1653525289170,CSE 293,031,094935,Savage; Stefan,9999,0,9999,0
1653525289170,CSE 293,032,094936,Schulze; Jurgen P.,9999,0,9999,0
1653525289170,CSE 293,033,094937,Snoeren; Alex C.,9999,0,9999,0
1653525289170,CSE 293,034,094938,Shang; Jingbo,9999,0,9999,0
1653525289170,CSE 293,035,094939,Stefan; Deian,9999,0,9999,0
1653525289170,CSE 293,036,094940,Su; Hao,9999,0,9999,0
1653525289170,CSE 293,037,094941,Swanson; Steven James,9999,0,9999,0
1653525289170,CSE 293,038,094942,Tullsen; Dean Michael,9999,0,9999,0
1653525289170,CSE 293,039,094943,Voelker; Geoffrey M.,9999,0,9999,0
1653525289170,CSE 293,040,094944,Zhao; Jishen,9999,0,9999,0
1653525289170,CSE 293,041,094945,Zhou; Yuan-Yuan,9999,0,9999,0
1653525289170,CSE 293,042,094946,Gao; Sicun,9998,0,9999,1
1653525289170,CSE 293,043,094947,Weibel; Nadir,9999,0,9999,0
1653525289170,CSE 293,044,094948,Gupta; Rajesh K.,9999,0,9999,0
1653525289692,CSE 294,A00,090143,Porter; George M,8,0,10,2
1653525290215,DSE 200,A00,091799,Staff,50,0,50,0
1653525290738,DSE 203,A00,091800,Gupta; Amarnath,30,0,30,0
1653525291262,DSE 250,A00,091801,Deutsch; Alin Bernard,30,0,30,0
1653525291789,DSE 290,A00,091802,Altintas De Callaf; Ilkay,50,0,50,0
1653525292321,ECE 200,001,091003,Antipa; Nicholas A,9999,0,9999,0
1653525292321,ECE 200,002,091004,Atanasov; Nikolay A.,9999,0,9999,0
1653525292321,ECE 200,003,091005,Bharadia; Dinesh,9999,0,9999,0
1653525292321,ECE 200,004,091006,Cheng; Chung Kuan,9999,0,9999,0
1653525292321,ECE 200,005,091007,Cosman; Pamela C.,9999,0,9999,0
1653525292321,ECE 200,006,091008,Staff,9999,0,9999,0
1653525292321,ECE 200,007,091009,Dayeh; Shadi Ahmad,9999,0,9999,0
1653525292321,ECE 200,008,091010,Fainman; Yeshaiahu,9999,0,9999,0
1653525292321,ECE 200,009,091011,Ford; Joseph Earl,9999,0,9999,0
1653525292321,ECE 200,010,091012,Franceschetti; Massimo,9999,0,9999,0
1653525292321,ECE 200,011,091013,Fullerton; Eric E,9999,0,9999,0
1653525292321,ECE 200,012,091014,Galton; Ian A,9999,0,9999,0
1653525292321,ECE 200,013,091015,Gilja; Vikash,9999,0,9999,0
1653525292321,ECE 200,014,091016,Hall; Drew A.,9999,0,9999,0
1653525292321,ECE 200,015,091017,Hsueh; Tzu-Chien,9999,0,9999,0
1653525292321,ECE 200,016,091018,Javidi; Tara,9999,0,9999,0
1653525292321,ECE 200,017,091019,Kahng; Andrew Byun,9999,0,9999,0
1653525292321,ECE 200,018,091020,Kim; Young-Han,9999,0,9999,0
1653525292321,ECE 200,019,091021,Koushanfar; Farinaz,9999,0,9999,0
1653525292321,ECE 200,020,091022,Kuzum; Duygu,9999,0,9999,0
1653525292321,ECE 200,021,091023,Le; Hanh-Phuc,9999,0,9999,0
1653525292321,ECE 200,022,091024,Lin; Bill,9999,0,9999,0
1653525292321,ECE 200,023,091025,Liu; Zhaowei,9999,0,9999,0
1653525292321,ECE 200,024,091026,Lo; Yu-Hwa,9999,0,9999,0
1653525292321,ECE 200,025,091027,Lomakin; Vitaliy,9999,0,9999,0
1653525292321,ECE 200,026,091028,Mercier; Patrick Philip,9999,0,9999,0
1653525292321,ECE 200,027,091029,Meyer; Florian,9999,0,9999,0
1653525292321,ECE 200,028,091030,Milstein; Laurence B.,9999,0,9999,0
1653525292321,ECE 200,029,091031,Mir Arabbaygi; Siavash,9999,0,9999,0
1653525292321,ECE 200,030,091032,Mookherjea; Shayan,9999,0,9999,0
1653525292321,ECE 200,031,091033,Morris; Karcher William,9999,0,9999,0
1653525292321,ECE 200,032,091034,Ng; Tse Nga,9999,0,9999,0
1653525292321,ECE 200,033,091035,Nguyen; Truong Quang,9999,0,9999,0
1653525292321,ECE 200,034,091036,Nomura; Kenji,9999,0,9999,0
1653525292321,ECE 200,035,091037,Orlitsky; Alon,9999,0,9999,0
1653525292321,ECE 200,036,091038,Pal; Piya,9999,0,9999,0
1653525292321,ECE 200,037,091039,Papen; George C.,9999,0,9999,0
1653525292321,ECE 200,038,091040,Radic; Stojan,9999,0,9999,0
1653525292321,ECE 200,039,091041,Rao; Bhaskar D.,9999,0,9999,0
1653525292321,ECE 200,040,091042,Rao; Ramesh R,9999,0,9999,0
1653525292321,ECE 200,041,091043,Rebeiz; Gabriel,9999,0,9999,0
1653525292321,ECE 200,042,091044,Sanford; John R,9999,0,9999,0
1653525292321,ECE 200,043,091045,Siegel; Paul H.,9999,0,9999,0
1653525292321,ECE 200,044,091046,Sievenpiper; Daniel F.,9999,0,9999,0
1653525292321,ECE 200,045,091047,Sworder; David D.,9999,0,9999,0
1653525292321,ECE 200,046,091048,Taur; Yuan,9999,0,9999,0
1653525292321,ECE 200,047,091049,Touri; Behrouz,9999,0,9999,0
1653525292321,ECE 200,048,091050,Trivedi; Mohan M.,9999,0,9999,0
1653525292321,ECE 200,049,091051,Vardy; Alexander,9999,0,9999,0
1653525292321,ECE 200,050,091052,Vasconcelos; Nuno,9999,0,9999,0
1653525292321,ECE 200,051,091053,Wang; Xiaolong,9999,0,9999,0
1653525292321,ECE 200,052,091054,Xie; Pengtao,9999,0,9999,0
1653525292321,ECE 200,053,091055,Yip; Michael,9999,0,9999,0
1653525292321,ECE 200,054,091056,Zeger; Kenneth A.,9999,0,9999,0
1653525292321,ECE 200,055,091057,Zhang; Xinyu,9999,0,9999,0
1653525292321,ECE 200,056,091058,Turakhia; Yatish Girish,9999,0,9999,0
1653525292321,ECE 200,057,091059,Kang; Mingu,9999,0,9999,0
1653525292321,ECE 200,058,091060,Shi; Yuanyuan,9999,0,9999,0
1653525292321,ECE 200,059,091061,Wang; Edward Jay,9999,0,9999,0
1653525292321,ECE 200,060,091062,Zheng; Yang,9999,0,9999,0
1653525292846,ECE 201,A00,095526,Lo; Yu-Hwa,0,0,0,0
1653525293377,ECE 203,A00,091065,Mercier; Patrick Philip,0,0,0,0
1653525293900,ECE 207A,A00,091605,Liu; Thomas Tao-Ming,0,0,0,0
1653525294423,ECE 212AN,A00,091068,Nomura; Kenji,0,0,0,0
1653525294949,ECE 222A,A00,091069,Rebeiz; Gabriel,0,0,0,0
1653525295472,ECE 225A,A00,091070,Orlitsky; Alon,0,0,0,0
1653525295995,ECE 230A,A00,091071,Nomura; Kenji,0,0,0,0
1653525296525,ECE 236A,A00,091072,Dayeh; Shadi Ahmad,0,0,0,0
1653525297054,ECE 238A,A00,091073,Luo; Jian,0,0,0,0
1653525297054,ECE 238A,B00,091074,Luo; Jian,0,0,0,0
1653525297578,ECE 240A,A00,091075,Radic; Stojan,0,0,0,0
1653525298108,ECE 247A,A00,091592,Shi; Lingyan,0,0,0,0
1653525298630,ECE 250,A00,091076,Touri; Behrouz,0,0,0,0
1653525299153,ECE 251C,A00,091078,Nguyen; Truong Quang,0,0,0,0
1653525299680,ECE 253,A00,091079,Cosman; Pamela C.,0,0,0,0
1653525300205,ECE 255A,A00,091080,Orlitsky; Alon,0,0,0,0
1653525300732,ECE 257A,A00,091081,Zhang; Xinyu,0,0,0,0
1653525301257,ECE 260A,A01,091084,Eldon; John,0,0,0,0
1653525301786,ECE 264C,A00,091085,Galton; Ian A,0,0,0,0
1653525302310,ECE 265C,A00,094889,Presti; Calogero Davide,0,0,0,9
1653525302843,ECE 266,A01,091087,Hall; Drew A.,0,0,0,0
1653525303889,ECE 271A,A00,091090,Vasconcelos; Nuno,0,0,0,0
1653525304414,ECE 272B,A00,091091,Sworder; David D.,0,0,0,0
1653525304937,ECE 275A,A00,091092,Meyer; Florian,0,0,0,0
1653525305466,ECE 277,A00,091093,An; Cheolhong,0,0,0,0
1653525306004,ECE 283,A00,091094,Le; Hanh-Phuc,0,0,0,0
1653525306527,ECE 284,A00,091095,Kang; Mingu,0,0,0,0
1653525306527,ECE 284,B00,091096,Wang; Edward Jay,0,0,0,0
1653525307050,ECE 285,A00,094334,Touri; Behrouz,0,0,0,0
1653525307573,ECE 289,A00,091097,Whelan; David Arthur,0,0,0,0
1653525308097,MATH 200A,A00,087414,Salehi Golsefidy; Alireza,7,0,8,1
1653525308623,MATH 202A,A00,087415,Gill; Philip E.,2,0,8,6
1653525309146,MATH 203A,A00,087416,Oprea; Dragos N.,6,0,8,2
1653525309669,MATH 204A,A00,087417,Kedlaya; Kiran S.,6,0,8,2
1653525310192,MATH 205,A00,087418,Sorensen; Claus M,6,0,8,2
1653525310714,MATH 206A,A00,087419,Izadi; Elham,7,0,8,1
1653525311237,MATH 207A,A00,087420,Mohammadi; Amir,5,0,8,3
1653525311759,MATH 208,A00,087421,Staff,9,0,10,1
1653525312291,MATH 209,A00,087422,Staff,10,0,10,0
1653525312813,MATH 218,A00,087423,Staff,10,0,10,0
1653525313337,MATH 220A,A00,087424,Novak; Jonathan I,7,0,8,1
1653525313863,MATH 231A,A00,087425,Bejenaru; Ioan,3,0,8,5
1653525314392,MATH 240A,A00,087426,Ebenfelt; Peter F,5,0,8,3
1653525314915,MATH 243,A00,087427,Staff,9,0,10,1
1653525315437,MATH 248,A00,087429,Staff,10,0,10,0
1653525315965,MATH 250A,A00,087430,Spolaor; Luca,4,0,8,4
1653525316491,MATH 257A,A00,087431,Spolaor; Luca,7,0,8,1
1653525317027,MATH 258,A00,087432,Staff,9,0,10,1
1653525317554,MATH 264A,A00,087433,Warnke; Lutz Peter,5,0,8,3
1653525318084,MATH 268,A00,087434,Staff,15,0,15,0
1653525318611,MATH 269,A00,087435,Staff,14,0,15,1
1653525319146,MATH 270A,A00,087436,Nie; Jiawang,0,0,8,8
1653525319669,MATH 272A,A00,087437,Tian; Xiaochuan,1,0,8,7
1653525320194,MATH 274,A01,087439,Cheng; Li-Tien,9,0,10,1
1653525320194,MATH 274,A02,087440,Cheng; Li-Tien,10,0,10,0
1653525320717,MATH 278A,A00,087441,Staff,8,0,10,2
1653525321241,MATH 278B,A00,087442,Staff,8,0,10,2
1653525321766,MATH 278C,A00,087443,Staff,8,0,10,2
1653525322289,MATH 280A,A00,087444,Zheng; Tianyi,0,0,8,8
1653525322813,MATH 281A,A00,087445,Bradic; Jelena,0,0,8,8
1653525323336,MATH 282A,A00,087446,Zhang; Danna,0,0,8,8
1653525323870,MATH 283,A00,087447,Tesler; Glenn,0,0,0,15
1653525324391,MATH 286,A00,087448,Kemp; Todd Aahron,5,0,8,3
1653525324917,MATH 287D,A00,087449,Bradic; Jelena,0,0,0,0
1653525325441,MATH 288,A00,087450,Staff,14,0,15,1
1653525325441,MATH 288,B00,087451,Staff,15,0,15,0
1653525325441,MATH 288,C00,087452,Staff,15,0,15,0
1653525325966,MATH 290A,A00,087453,Xu; Zhouli,6,0,8,2
1653525326491,MATH 291A,A00,087454,Xu; Zhouli,7,0,8,1
1653525327021,MATH 292,A00,087455,Staff,10,0,10,0
1653525327550,MATH 295,A00,087456,Staff,50,0,50,0
1653525328076,MATH 297,001,087457,Staff,998,0,999,1
1653525898496,COGS 200,A01,087991,Staff,47,0,50,3
1653525899021,COGS 201,A01,094504,Rangel; Lara M,17,0,25,8
1653525899544,COGS 203,A00,087992,Coulson; Seana M,18,0,20,2
1653525900068,COGS 210A,001,087993,Greene; Deanna Jacquelyn,9998,0,9999,1
1653525900068,COGS 210A,002,087994,Saygin; Ayse P,9999,0,9999,0
1653525900068,COGS 210A,003,087995,Xia; Haijun,9999,0,9999,0
1653525900068,COGS 210A,004,087996,Nitz; Douglas A.,9999,0,9999,0
1653525900068,COGS 210A,005,087997,Hollan; James D.,9999,0,9999,0
1653525900068,COGS 210A,006,087998,Deak; Gedeon O.,9998,0,9999,1
1653525900068,COGS 210A,007,087999,Rossano; Federico,9999,0,9999,0
1653525900591,COGS 211A,A00,088000,Coulson; Seana M,9997,0,9999,2
1653525901117,COGS 229,A00,088002,Staff,23,0,25,2
1653525901641,COGS 260,B00,094231,Staff,17,0,20,3
1653525901641,COGS 260,A00,088004,Nitz; Douglas A.,9998,0,9999,1
1653525902167,CSE 202,A00,090110,Paturi; Ramamohan,0,0,0,0
1653525902167,CSE 202,B00,090111,Paturi; Ramamohan,0,0,0,0
1653525902700,CSE 207B,A00,090112,Heninger; Nadia A,0,0,0,0
1653525903224,CSE 208,A00,094858,Micciancio; Daniele,0,0,0,0
1653525903749,CSE 210,A00,090113,Powell; Thomas Allan,0,0,0,0
1653525904274,CSE 219,A00,090898,Staff,0,0,0,0
1653525904803,CSE 221,A00,090114,Zhou; Yuan-Yuan,0,0,0,0
1653525905328,CSE 229A,A00,090115,Porter; George M,0,0,0,0
1653525905850,CSE 229C,A00,090116,Savage; Stefan,0,0,0,0
1653525906374,CSE 230,A00,090117,Jhala; Ranjit,0,0,0,0
1653525906897,CSE 232,A00,090118,Papakonstantinou; Yannis,0,0,0,0
1653525907419,CSE 239A,A00,090121,Kumar; Arun Kumar,0,0,0,0
1653525907943,CSE 239B,A00,090122,Jhala; Ranjit,0,0,0,0
1653525908466,CSE 240A,A00,090123,Zhao; Jishen,0,0,189,189
1653525908989,CSE 243A,A00,090124,Orailoglu; Alex,0,0,15,15
1653525909514,CSE 249B,A00,090125,Kahng; Andrew Byun,13,0,20,7
1653525910039,CSE 250A,A00,090126,Berg-Kirkpatrick; Taylor D,0,0,0,0
1653525910562,CSE 252A,A00,090127,Ochoa; Benjamin Lawrence,0,0,0,0
1653525911085,CSE 258,A01,090129,McAuley; Julian John,0,0,0,0
1653525911610,CSE 258R,A01,090131,McAuley; Julian John,0,0,0,0
1653525912137,CSE 274,A00,090132,Ramamoorthi; Ravi,0,0,0,0
1653525912662,CSE 276A,A00,090133,Christensen; Henrik I,0,0,0,0
1653525913189,CSE 276C,A00,090134,Christensen; Henrik I,0,0,0,0
1653525913712,CSE 290,A00,090135,Bafna; Vineet,0,0,0,0
1653525913712,CSE 290,B00,090136,Ramamoorthi; Ravi,0,0,0,0
1653525913712,CSE 290,C00,090137,Li; Tzumao,8,0,10,2
1653525913712,CSE 290,D00,090138,Zhou; Yuan-Yuan,9,0,10,1
1653525913712,CSE 290,E00,090139,Christensen; Henrik I,9,0,10,1
1653525913712,CSE 290,F00,094053,Shalev; Aaron D,0,0,0,0
1653525914240,CSE 291,A00,090140,Munyaka; Imani N. S.,0,0,0,0
1653525914240,CSE 291,B00,094880,Yu; Qi,0,0,0,0
1653525914240,CSE 291,C00,090142,Pannuto; Patrick William,0,0,0,0
1653525914240,CSE 291,D00,094881,Zhang; Yiying,0,0,0,0
1653525914240,CSE 291,E00,095118,Su; Hao,0,0,0,0
1653525914799,CSE 293,001,094905,Bafna; Vineet,9999,0,9999,0
1653525914799,CSE 293,002,094906,Bellare; Mihir,9999,0,9999,0
1653525914799,CSE 293,003,094907,Berg-Kirkpatrick; Taylor D,9999,0,9999,0
1653525914799,CSE 293,004,094908,Christensen; Henrik I,9999,0,9999,0
1653525914799,CSE 293,005,094909,Cottrell; Garrison W,9999,0,9999,0
1653525914799,CSE 293,006,094910,Deutsch; Alin Bernard,9999,0,9999,0
1653525914799,CSE 293,007,094911,Esmaeilzadeh; Hadi,9999,0,9999,0
1653525914799,CSE 293,008,094912,Freund; Yoav,9999,0,9999,0
1653525914799,CSE 293,009,094913,Griswold; William G.,9999,0,9999,0
1653525914799,CSE 293,010,094914,Gymrek; Melissa Ann,9999,0,9999,0
1653525914799,CSE 293,011,094915,Heninger; Nadia A,9999,0,9999,0
1653525914799,CSE 293,012,094916,Impagliazzo; Russell,9999,0,9999,0
1653525914799,CSE 293,013,094917,Jhala; Ranjit,9999,0,9999,0
1653525914799,CSE 293,014,094918,Kahng; Andrew Byun,9999,0,9999,0
1653525914799,CSE 293,015,094919,Kane; Daniel Mertz,9999,0,9999,0
1653525914799,CSE 293,016,094920,Kriegman; David J,9999,0,9999,0
1653525914799,CSE 293,017,094921,Kumar; Arun Kumar,9999,0,9999,0
1653525914799,CSE 293,018,094922,Lerner; Sorin,9999,0,9999,0
1653525914799,CSE 293,019,094923,Lovett; Shachar,9999,0,9999,0
1653525914799,CSE 293,020,094924,McAuley; Julian John,9999,0,9999,0
1653525914799,CSE 293,021,094925,Micciancio; Daniele,9999,0,9999,0
1653525914799,CSE 293,022,094926,Orailoglu; Alex,9999,0,9999,0
1653525914799,CSE 293,023,094927,Paturi; Ramamohan,9999,0,9999,0
1653525914799,CSE 293,024,094928,Polikarpova; Nadezhda,9999,0,9999,0
1653525914799,CSE 293,025,094929,Politz; Joseph Gibbs,9999,0,9999,0
1653525914799,CSE 293,026,094930,Porter; George M,9999,0,9999,0
1653525914799,CSE 293,027,094931,Porter; Leonard Emerson,9999,0,9999,0
1653525914799,CSE 293,028,094932,Ramamoorthi; Ravi,9999,0,9999,0
1653525914799,CSE 293,029,094933,Sahoo; Debashis,9999,0,9999,0
1653525914799,CSE 293,030,094934,Saul; Lawrence,9999,0,9999,0
1653525914799,CSE 293,031,094935,Savage; Stefan,9999,0,9999,0
1653525914799,CSE 293,032,094936,Schulze; Jurgen P.,9999,0,9999,0
1653525914799,CSE 293,033,094937,Snoeren; Alex C.,9999,0,9999,0
1653525914799,CSE 293,034,094938,Shang; Jingbo,9999,0,9999,0
1653525914799,CSE 293,035,094939,Stefan; Deian,9999,0,9999,0
1653525914799,CSE 293,036,094940,Su; Hao,9999,0,9999,0
1653525914799,CSE 293,037,094941,Swanson; Steven James,9999,0,9999,0
1653525914799,CSE 293,038,094942,Tullsen; Dean Michael,9999,0,9999,0
1653525914799,CSE 293,039,094943,Voelker; Geoffrey M.,9999,0,9999,0
1653525914799,CSE 293,040,094944,Zhao; Jishen,9999,0,9999,0
1653525914799,CSE 293,041,094945,Zhou; Yuan-Yuan,9999,0,9999,0
1653525914799,CSE 293,042,094946,Gao; Sicun,9998,0,9999,1
1653525914799,CSE 293,043,094947,Weibel; Nadir,9999,0,9999,0
1653525914799,CSE 293,044,094948,Gupta; Rajesh K.,9999,0,9999,0
1653525915325,CSE 294,A00,090143,Porter; George M,8,0,10,2
1653525915848,DSE 200,A00,091799,Staff,50,0,50,0
1653525916376,DSE 203,A00,091800,Gupta; Amarnath,30,0,30,0
1653525916902,DSE 250,A00,091801,Deutsch; Alin Bernard,30,0,30,0
1653525917435,DSE 290,A00,091802,Altintas De Callaf; Ilkay,50,0,50,0
1653525917982,ECE 200,001,091003,Antipa; Nicholas A,9999,0,9999,0
1653525917982,ECE 200,002,091004,Atanasov; Nikolay A.,9999,0,9999,0
1653525917982,ECE 200,003,091005,Bharadia; Dinesh,9999,0,9999,0
1653525917982,ECE 200,004,091006,Cheng; Chung Kuan,9999,0,9999,0
1653525917982,ECE 200,005,091007,Cosman; Pamela C.,9999,0,9999,0
1653525917982,ECE 200,006,091008,Staff,9999,0,9999,0
1653525917982,ECE 200,007,091009,Dayeh; Shadi Ahmad,9999,0,9999,0
1653525917982,ECE 200,008,091010,Fainman; Yeshaiahu,9999,0,9999,0
1653525917982,ECE 200,009,091011,Ford; Joseph Earl,9999,0,9999,0
1653525917982,ECE 200,010,091012,Franceschetti; Massimo,9999,0,9999,0
1653525917982,ECE 200,011,091013,Fullerton; Eric E,9999,0,9999,0
1653525917982,ECE 200,012,091014,Galton; Ian A,9999,0,9999,0
1653525917982,ECE 200,013,091015,Gilja; Vikash,9999,0,9999,0
1653525917982,ECE 200,014,091016,Hall; Drew A.,9999,0,9999,0
1653525917982,ECE 200,015,091017,Hsueh; Tzu-Chien,9999,0,9999,0
1653525917982,ECE 200,016,091018,Javidi; Tara,9999,0,9999,0
1653525917982,ECE 200,017,091019,Kahng; Andrew Byun,9999,0,9999,0
1653525917982,ECE 200,018,091020,Kim; Young-Han,9999,0,9999,0
1653525917982,ECE 200,019,091021,Koushanfar; Farinaz,9999,0,9999,0
1653525917982,ECE 200,020,091022,Kuzum; Duygu,9999,0,9999,0
1653525917982,ECE 200,021,091023,Le; Hanh-Phuc,9999,0,9999,0
1653525917982,ECE 200,022,091024,Lin; Bill,9999,0,9999,0
1653525917982,ECE 200,023,091025,Liu; Zhaowei,9999,0,9999,0
1653525917982,ECE 200,024,091026,Lo; Yu-Hwa,9999,0,9999,0
1653525917982,ECE 200,025,091027,Lomakin; Vitaliy,9999,0,9999,0
1653525917982,ECE 200,026,091028,Mercier; Patrick Philip,9999,0,9999,0
1653525917982,ECE 200,027,091029,Meyer; Florian,9999,0,9999,0
1653525917982,ECE 200,028,091030,Milstein; Laurence B.,9999,0,9999,0
1653525917982,ECE 200,029,091031,Mir Arabbaygi; Siavash,9999,0,9999,0
1653525917982,ECE 200,030,091032,Mookherjea; Shayan,9999,0,9999,0
1653525917982,ECE 200,031,091033,Morris; Karcher William,9999,0,9999,0
1653525917982,ECE 200,032,091034,Ng; Tse Nga,9999,0,9999,0
1653525917982,ECE 200,033,091035,Nguyen; Truong Quang,9999,0,9999,0
1653525917982,ECE 200,034,091036,Nomura; Kenji,9999,0,9999,0
1653525917982,ECE 200,035,091037,Orlitsky; Alon,9999,0,9999,0
1653525917982,ECE 200,036,091038,Pal; Piya,9999,0,9999,0
1653525917982,ECE 200,037,091039,Papen; George C.,9999,0,9999,0
1653525917982,ECE 200,038,091040,Radic; Stojan,9999,0,9999,0
1653525917982,ECE 200,039,091041,Rao; Bhaskar D.,9999,0,9999,0
1653525917982,ECE 200,040,091042,Rao; Ramesh R,9999,0,9999,0
1653525917982,ECE 200,041,091043,Rebeiz; Gabriel,9999,0,9999,0
1653525917982,ECE 200,042,091044,Sanford; John R,9999,0,9999,0
1653525917982,ECE 200,043,091045,Siegel; Paul H.,9999,0,9999,0
1653525917982,ECE 200,044,091046,Sievenpiper; Daniel F.,9999,0,9999,0
1653525917982,ECE 200,045,091047,Sworder; David D.,9999,0,9999,0
1653525917982,ECE 200,046,091048,Taur; Yuan,9999,0,9999,0
1653525917982,ECE 200,047,091049,Touri; Behrouz,9999,0,9999,0
1653525917982,ECE 200,048,091050,Trivedi; Mohan M.,9999,0,9999,0
1653525917982,ECE 200,049,091051,Vardy; Alexander,9999,0,9999,0
1653525917982,ECE 200,050,091052,Vasconcelos; Nuno,9999,0,9999,0
1653525917982,ECE 200,051,091053,Wang; Xiaolong,9999,0,9999,0
1653525917982,ECE 200,052,091054,Xie; Pengtao,9999,0,9999,0
1653525917982,ECE 200,053,091055,Yip; Michael,9999,0,9999,0
1653525917982,ECE 200,054,091056,Zeger; Kenneth A.,9999,0,9999,0
1653525917982,ECE 200,055,091057,Zhang; Xinyu,9999,0,9999,0
1653525917982,ECE 200,056,091058,Turakhia; Yatish Girish,9999,0,9999,0
1653525917982,ECE 200,057,091059,Kang; Mingu,9999,0,9999,0
1653525917982,ECE 200,058,091060,Shi; Yuanyuan,9999,0,9999,0
1653525917982,ECE 200,059,091061,Wang; Edward Jay,9999,0,9999,0
1653525917982,ECE 200,060,091062,Zheng; Yang,9999,0,9999,0
1653525918505,ECE 201,A00,095526,Lo; Yu-Hwa,0,0,0,0
1653525919027,ECE 203,A00,091065,Mercier; Patrick Philip,0,0,0,0
1653525919550,ECE 207A,A00,091605,Liu; Thomas Tao-Ming,0,0,0,0
1653525920072,ECE 212AN,A00,091068,Nomura; Kenji,0,0,0,0
1653525920594,ECE 222A,A00,091069,Rebeiz; Gabriel,0,0,0,0
1653525921121,ECE 225A,A00,091070,Orlitsky; Alon,0,0,0,0
1653525921655,ECE 230A,A00,091071,Nomura; Kenji,0,0,0,0
1653525922191,ECE 236A,A00,091072,Dayeh; Shadi Ahmad,0,0,0,0
1653525922718,ECE 238A,A00,091073,Luo; Jian,0,0,0,0
1653525922718,ECE 238A,B00,091074,Luo; Jian,0,0,0,0
1653525923241,ECE 240A,A00,091075,Radic; Stojan,0,0,0,0
1653525923767,ECE 247A,A00,091592,Shi; Lingyan,0,0,0,0
1653525924350,ECE 250,A00,091076,Touri; Behrouz,0,0,0,0
1653525924874,ECE 251C,A00,091078,Nguyen; Truong Quang,0,0,0,0
1653525925400,ECE 253,A00,091079,Cosman; Pamela C.,0,0,0,0
1653525925923,ECE 255A,A00,091080,Orlitsky; Alon,0,0,0,0
1653525926446,ECE 257A,A00,091081,Zhang; Xinyu,0,0,0,0
1653525926979,ECE 260A,A01,091084,Eldon; John,0,0,0,0
1653525927501,ECE 264C,A00,091085,Galton; Ian A,0,0,0,0
1653525928101,ECE 265C,A00,094889,Presti; Calogero Davide,0,0,0,9
1653525928623,ECE 266,A01,091087,Hall; Drew A.,0,0,0,0
1653525929670,ECE 271A,A00,091090,Vasconcelos; Nuno,0,0,0,0
1653525930194,ECE 272B,A00,091091,Sworder; David D.,0,0,0,0
1653525930717,ECE 275A,A00,091092,Meyer; Florian,0,0,0,0
1653525931244,ECE 277,A00,091093,An; Cheolhong,0,0,0,0
1653525931767,ECE 283,A00,091094,Le; Hanh-Phuc,0,0,0,0
1653525932297,ECE 284,A00,091095,Kang; Mingu,0,0,0,0
1653525932297,ECE 284,B00,091096,Wang; Edward Jay,0,0,0,0
1653525932818,ECE 285,A00,094334,Touri; Behrouz,0,0,0,0
1653525933341,ECE 289,A00,091097,Whelan; David Arthur,0,0,0,0
1653525933864,MATH 200A,A00,087414,Salehi Golsefidy; Alireza,7,0,8,1
1653525934386,MATH 202A,A00,087415,Gill; Philip E.,2,0,8,6
1653525934913,MATH 203A,A00,087416,Oprea; Dragos N.,6,0,8,2
1653525935440,MATH 204A,A00,087417,Kedlaya; Kiran S.,6,0,8,2
1653525935963,MATH 205,A00,087418,Sorensen; Claus M,6,0,8,2
1653525936493,MATH 206A,A00,087419,Izadi; Elham,7,0,8,1
1653525937023,MATH 207A,A00,087420,Mohammadi; Amir,5,0,8,3
1653525937552,MATH 208,A00,087421,Staff,9,0,10,1
1653525938074,MATH 209,A00,087422,Staff,10,0,10,0
1653525938595,MATH 218,A00,087423,Staff,10,0,10,0
1653525939119,MATH 220A,A00,087424,Novak; Jonathan I,7,0,8,1
1653525939641,MATH 231A,A00,087425,Bejenaru; Ioan,3,0,8,5
1653525940165,MATH 240A,A00,087426,Ebenfelt; Peter F,5,0,8,3
1653525940690,MATH 243,A00,087427,Staff,9,0,10,1
1653525941214,MATH 248,A00,087429,Staff,10,0,10,0
1653525941739,MATH 250A,A00,087430,Spolaor; Luca,4,0,8,4
1653525942266,MATH 257A,A00,087431,Spolaor; Luca,7,0,8,1
1653525942790,MATH 258,A00,087432,Staff,9,0,10,1
1653525943320,MATH 264A,A00,087433,Warnke; Lutz Peter,5,0,8,3
1653525943846,MATH 268,A00,087434,Staff,15,0,15,0
1653525944371,MATH 269,A00,087435,Staff,14,0,15,1
1653525944895,MATH 270A,A00,087436,Nie; Jiawang,0,0,8,8
1653525945421,MATH 272A,A00,087437,Tian; Xiaochuan,1,0,8,7
1653525945944,MATH 274,A01,087439,Cheng; Li-Tien,9,0,10,1
1653525945944,MATH 274,A02,087440,Cheng; Li-Tien,10,0,10,0
1653525946470,MATH 278A,A00,087441,Staff,8,0,10,2
1653525946994,MATH 278B,A00,087442,Staff,8,0,10,2
1653525947518,MATH 278C,A00,087443,Staff,8,0,10,2
1653525948041,MATH 280A,A00,087444,Zheng; Tianyi,0,0,8,8
1653525948567,MATH 281A,A00,087445,Bradic; Jelena,0,0,8,8
1653525949091,MATH 282A,A00,087446,Zhang; Danna,0,0,8,8
1653525949617,MATH 283,A00,087447,Tesler; Glenn,0,0,0,15
1653525950140,MATH 286,A00,087448,Kemp; Todd Aahron,5,0,8,3
1653525950663,MATH 287D,A00,087449,Bradic; Jelena,0,0,0,0
1653525951184,MATH 288,A00,087450,Staff,14,0,15,1
1653525951184,MATH 288,B00,087451,Staff,15,0,15,0
1653525951184,MATH 288,C00,087452,Staff,15,0,15,0
1653525951712,MATH 290A,A00,087453,Xu; Zhouli,6,0,8,2
1653525952240,MATH 291A,A00,087454,Xu; Zhouli,7,0,8,1
1653525952774,MATH 292,A00,087455,Staff,10,0,10,0
1653525953297,MATH 295,A00,087456,Staff,50,0,50,0
1653525953828,MATH 297,001,087457,Staff,998,0,999,1
1653526514024,COGS 200,A01,087991,Staff,47,0,50,3
1653526514551,COGS 201,A01,094504,Rangel; Lara M,17,0,25,8
1653526515074,COGS 203,A00,087992,Coulson; Seana M,18,0,20,2
1653526515698,COGS 210A,001,087993,Greene; Deanna Jacquelyn,9998,0,9999,1
1653526515698,COGS 210A,002,087994,Saygin; Ayse P,9999,0,9999,0
1653526515698,COGS 210A,003,087995,Xia; Haijun,9999,0,9999,0
1653526515698,COGS 210A,004,087996,Nitz; Douglas A.,9999,0,9999,0
1653526515698,COGS 210A,005,087997,Hollan; James D.,9999,0,9999,0
1653526515698,COGS 210A,006,087998,Deak; Gedeon O.,9998,0,9999,1
1653526515698,COGS 210A,007,087999,Rossano; Federico,9999,0,9999,0
1653526516224,COGS 211A,A00,088000,Coulson; Seana M,9997,0,9999,2
1653526516748,COGS 229,A00,088002,Staff,23,0,25,2
1653526517276,COGS 260,B00,094231,Staff,17,0,20,3
1653526517276,COGS 260,A00,088004,Nitz; Douglas A.,9998,0,9999,1
1653526517802,CSE 202,A00,090110,Paturi; Ramamohan,0,0,0,0
1653526517802,CSE 202,B00,090111,Paturi; Ramamohan,0,0,0,0
1653526518325,CSE 207B,A00,090112,Heninger; Nadia A,0,0,0,0
1653526518848,CSE 208,A00,094858,Micciancio; Daniele,0,0,0,0
1653526519370,CSE 210,A00,090113,Powell; Thomas Allan,0,0,0,0
1653526519895,CSE 219,A00,090898,Staff,0,0,0,0
1653526520432,CSE 221,A00,090114,Zhou; Yuan-Yuan,0,0,0,0
1653526520954,CSE 229A,A00,090115,Porter; George M,0,0,0,0
1653526521478,CSE 229C,A00,090116,Savage; Stefan,0,0,0,0
1653526522001,CSE 230,A00,090117,Jhala; Ranjit,0,0,0,0
1653526522528,CSE 232,A00,090118,Papakonstantinou; Yannis,0,0,0,0
1653526523052,CSE 239A,A00,090121,Kumar; Arun Kumar,0,0,0,0
1653526523577,CSE 239B,A00,090122,Jhala; Ranjit,0,0,0,0
1653526524102,CSE 240A,A00,090123,Zhao; Jishen,0,0,189,189
1653526524629,CSE 243A,A00,090124,Orailoglu; Alex,0,0,15,15
1653526525151,CSE 249B,A00,090125,Kahng; Andrew Byun,13,0,20,7
1653526525676,CSE 250A,A00,090126,Berg-Kirkpatrick; Taylor D,0,0,0,0
1653526526203,CSE 252A,A00,090127,Ochoa; Benjamin Lawrence,0,0,0,0
1653526526729,CSE 258,A01,090129,McAuley; Julian John,0,0,0,0
1653526527252,CSE 258R,A01,090131,McAuley; Julian John,0,0,0,0
1653526527783,CSE 274,A00,090132,Ramamoorthi; Ravi,0,0,0,0
1653526528308,CSE 276A,A00,090133,Christensen; Henrik I,0,0,0,0
1653526528839,CSE 276C,A00,090134,Christensen; Henrik I,0,0,0,0
1653526529365,CSE 290,A00,090135,Bafna; Vineet,0,0,0,0
1653526529365,CSE 290,B00,090136,Ramamoorthi; Ravi,0,0,0,0
1653526529365,CSE 290,C00,090137,Li; Tzumao,8,0,10,2
1653526529365,CSE 290,D00,090138,Zhou; Yuan-Yuan,9,0,10,1
1653526529365,CSE 290,E00,090139,Christensen; Henrik I,9,0,10,1
1653526529365,CSE 290,F00,094053,Shalev; Aaron D,0,0,0,0
1653526529892,CSE 291,A00,090140,Munyaka; Imani N. S.,0,0,0,0
1653526529892,CSE 291,B00,094880,Yu; Qi,0,0,0,0
1653526529892,CSE 291,C00,090142,Pannuto; Patrick William,0,0,0,0
1653526529892,CSE 291,D00,094881,Zhang; Yiying,0,0,0,0
1653526529892,CSE 291,E00,095118,Su; Hao,0,0,0,0
1653526530416,CSE 293,001,094905,Bafna; Vineet,9999,0,9999,0
1653526530416,CSE 293,002,094906,Bellare; Mihir,9999,0,9999,0
1653526530416,CSE 293,003,094907,Berg-Kirkpatrick; Taylor D,9999,0,9999,0
1653526530416,CSE 293,004,094908,Christensen; Henrik I,9999,0,9999,0
1653526530416,CSE 293,005,094909,Cottrell; Garrison W,9999,0,9999,0
1653526530416,CSE 293,006,094910,Deutsch; Alin Bernard,9999,0,9999,0
1653526530416,CSE 293,007,094911,Esmaeilzadeh; Hadi,9999,0,9999,0
1653526530416,CSE 293,008,094912,Freund; Yoav,9999,0,9999,0
1653526530416,CSE 293,009,094913,Griswold; William G.,9999,0,9999,0
1653526530416,CSE 293,010,094914,Gymrek; Melissa Ann,9999,0,9999,0
1653526530416,CSE 293,011,094915,Heninger; Nadia A,9999,0,9999,0
1653526530416,CSE 293,012,094916,Impagliazzo; Russell,9999,0,9999,0
1653526530416,CSE 293,013,094917,Jhala; Ranjit,9999,0,9999,0
1653526530416,CSE 293,014,094918,Kahng; Andrew Byun,9999,0,9999,0
1653526530416,CSE 293,015,094919,Kane; Daniel Mertz,9999,0,9999,0
1653526530416,CSE 293,016,094920,Kriegman; David J,9999,0,9999,0
1653526530416,CSE 293,017,094921,Kumar; Arun Kumar,9999,0,9999,0
1653526530416,CSE 293,018,094922,Lerner; Sorin,9999,0,9999,0
1653526530416,CSE 293,019,094923,Lovett; Shachar,9999,0,9999,0
1653526530416,CSE 293,020,094924,McAuley; Julian John,9999,0,9999,0
1653526530416,CSE 293,021,094925,Micciancio; Daniele,9999,0,9999,0
1653526530416,CSE 293,022,094926,Orailoglu; Alex,9999,0,9999,0
1653526530416,CSE 293,023,094927,Paturi; Ramamohan,9999,0,9999,0
1653526530416,CSE 293,024,094928,Polikarpova; Nadezhda,9999,0,9999,0
1653526530416,CSE 293,025,094929,Politz; Joseph Gibbs,9999,0,9999,0
1653526530416,CSE 293,026,094930,Porter; George M,9999,0,9999,0
1653526530416,CSE 293,027,094931,Porter; Leonard Emerson,9999,0,9999,0
1653526530416,CSE 293,028,094932,Ramamoorthi; Ravi,9999,0,9999,0
1653526530416,CSE 293,029,094933,Sahoo; Debashis,9999,0,9999,0
1653526530416,CSE 293,030,094934,Saul; Lawrence,9999,0,9999,0
1653526530416,CSE 293,031,094935,Savage; Stefan,9999,0,9999,0
1653526530416,CSE 293,032,094936,Schulze; Jurgen P.,9999,0,9999,0
1653526530416,CSE 293,033,094937,Snoeren; Alex C.,9999,0,9999,0
1653526530416,CSE 293,034,094938,Shang; Jingbo,9999,0,9999,0
1653526530416,CSE 293,035,094939,Stefan; Deian,9999,0,9999,0
1653526530416,CSE 293,036,094940,Su; Hao,9999,0,9999,0
1653526530416,CSE 293,037,094941,Swanson; Steven James,9999,0,9999,0
1653526530416,CSE 293,038,094942,Tullsen; Dean Michael,9999,0,9999,0
1653526530416,CSE 293,039,094943,Voelker; Geoffrey M.,9999,0,9999,0
1653526530416,CSE 293,040,094944,Zhao; Jishen,9999,0,9999,0
1653526530416,CSE 293,041,094945,Zhou; Yuan-Yuan,9999,0,9999,0
1653526530416,CSE 293,042,094946,Gao; Sicun,9998,0,9999,1
1653526530416,CSE 293,043,094947,Weibel; Nadir,9999,0,9999,0
1653526530416,CSE 293,044,094948,Gupta; Rajesh K.,9999,0,9999,0
1653526530945,CSE 294,A00,090143,Porter; George M,8,0,10,2
1653526531470,DSE 200,A00,091799,Staff,50,0,50,0
1653526531995,DSE 203,A00,091800,Gupta; Amarnath,30,0,30,0
1653526532520,DSE 250,A00,091801,Deutsch; Alin Bernard,30,0,30,0
1653526533054,DSE 290,A00,091802,Altintas De Callaf; Ilkay,50,0,50,0
1653526533587,ECE 200,001,091003,Antipa; Nicholas A,9999,0,9999,0
1653526533587,ECE 200,002,091004,Atanasov; Nikolay A.,9999,0,9999,0
1653526533587,ECE 200,003,091005,Bharadia; Dinesh,9999,0,9999,0
1653526533587,ECE 200,004,091006,Cheng; Chung Kuan,9999,0,9999,0
1653526533587,ECE 200,005,091007,Cosman; Pamela C.,9999,0,9999,0
1653526533587,ECE 200,006,091008,Staff,9999,0,9999,0
1653526533587,ECE 200,007,091009,Dayeh; Shadi Ahmad,9999,0,9999,0
1653526533587,ECE 200,008,091010,Fainman; Yeshaiahu,9999,0,9999,0
1653526533587,ECE 200,009,091011,Ford; Joseph Earl,9999,0,9999,0
1653526533587,ECE 200,010,091012,Franceschetti; Massimo,9999,0,9999,0
1653526533587,ECE 200,011,091013,Fullerton; Eric E,9999,0,9999,0
1653526533587,ECE 200,012,091014,Galton; Ian A,9999,0,9999,0
1653526533587,ECE 200,013,091015,Gilja; Vikash,9999,0,9999,0
1653526533587,ECE 200,014,091016,Hall; Drew A.,9999,0,9999,0
1653526533587,ECE 200,015,091017,Hsueh; Tzu-Chien,9999,0,9999,0
1653526533587,ECE 200,016,091018,Javidi; Tara,9999,0,9999,0
1653526533587,ECE 200,017,091019,Kahng; Andrew Byun,9999,0,9999,0
1653526533587,ECE 200,018,091020,Kim; Young-Han,9999,0,9999,0
1653526533587,ECE 200,019,091021,Koushanfar; Farinaz,9999,0,9999,0
1653526533587,ECE 200,020,091022,Kuzum; Duygu,9999,0,9999,0
1653526533587,ECE 200,021,091023,Le; Hanh-Phuc,9999,0,9999,0
1653526533587,ECE 200,022,091024,Lin; Bill,9999,0,9999,0
1653526533587,ECE 200,023,091025,Liu; Zhaowei,9999,0,9999,0
1653526533587,ECE 200,024,091026,Lo; Yu-Hwa,9999,0,9999,0
1653526533587,ECE 200,025,091027,Lomakin; Vitaliy,9999,0,9999,0
1653526533587,ECE 200,026,091028,Mercier; Patrick Philip,9999,0,9999,0
1653526533587,ECE 200,027,091029,Meyer; Florian,9999,0,9999,0
1653526533587,ECE 200,028,091030,Milstein; Laurence B.,9999,0,9999,0
1653526533587,ECE 200,029,091031,Mir Arabbaygi; Siavash,9999,0,9999,0
1653526533587,ECE 200,030,091032,Mookherjea; Shayan,9999,0,9999,0
1653526533587,ECE 200,031,091033,Morris; Karcher William,9999,0,9999,0
1653526533587,ECE 200,032,091034,Ng; Tse Nga,9999,0,9999,0
1653526533587,ECE 200,033,091035,Nguyen; Truong Quang,9999,0,9999,0
1653526533587,ECE 200,034,091036,Nomura; Kenji,9999,0,9999,0
1653526533587,ECE 200,035,091037,Orlitsky; Alon,9999,0,9999,0
1653526533587,ECE 200,036,091038,Pal; Piya,9999,0,9999,0
1653526533587,ECE 200,037,091039,Papen; George C.,9999,0,9999,0
1653526533587,ECE 200,038,091040,Radic; Stojan,9999,0,9999,0
1653526533587,ECE 200,039,091041,Rao; Bhaskar D.,9999,0,9999,0
1653526533587,ECE 200,040,091042,Rao; Ramesh R,9999,0,9999,0
1653526533587,ECE 200,041,091043,Rebeiz; Gabriel,9999,0,9999,0
1653526533587,ECE 200,042,091044,Sanford; John R,9999,0,9999,0
1653526533587,ECE 200,043,091045,Siegel; Paul H.,9999,0,9999,0
1653526533587,ECE 200,044,091046,Sievenpiper; Daniel F.,9999,0,9999,0
1653526533587,ECE 200,045,091047,Sworder; David D.,9999,0,9999,0
1653526533587,ECE 200,046,091048,Taur; Yuan,9999,0,9999,0
1653526533587,ECE 200,047,091049,Touri; Behrouz,9999,0,9999,0
1653526533587,ECE 200,048,091050,Trivedi; Mohan M.,9999,0,9999,0
1653526533587,ECE 200,049,091051,Vardy; Alexander,9999,0,9999,0
1653526533587,ECE 200,050,091052,Vasconcelos; Nuno,9999,0,9999,0
1653526533587,ECE 200,051,091053,Wang; Xiaolong,9999,0,9999,0
1653526533587,ECE 200,052,091054,Xie; Pengtao,9999,0,9999,0
1653526533587,ECE 200,053,091055,Yip; Michael,9999,0,9999,0
1653526533587,ECE 200,054,091056,Zeger; Kenneth A.,9999,0,9999,0
1653526533587,ECE 200,055,091057,Zhang; Xinyu,9999,0,9999,0
1653526533587,ECE 200,056,091058,Turakhia; Yatish Girish,9999,0,9999,0
1653526533587,ECE 200,057,091059,Kang; Mingu,9999,0,9999,0
1653526533587,ECE 200,058,091060,Shi; Yuanyuan,9999,0,9999,0
1653526533587,ECE 200,059,091061,Wang; Edward Jay,9999,0,9999,0
1653526533587,ECE 200,060,091062,Zheng; Yang,9999,0,9999,0
1653526534117,ECE 201,A00,095526,Lo; Yu-Hwa,0,0,0,0
1653526534644,ECE 203,A00,091065,Mercier; Patrick Philip,0,0,0,0
1653526535165,ECE 207A,A00,091605,Liu; Thomas Tao-Ming,0,0,0,0
1653526535690,ECE 212AN,A00,091068,Nomura; Kenji,0,0,0,0
1653526536213,ECE 222A,A00,091069,Rebeiz; Gabriel,0,0,0,0
1653526536735,ECE 225A,A00,091070,Orlitsky; Alon,0,0,0,0
1653526537269,ECE 230A,A00,091071,Nomura; Kenji,0,0,0,0
1653526537792,ECE 236A,A00,091072,Dayeh; Shadi Ahmad,0,0,0,0
1653526538315,ECE 238A,A00,091073,Luo; Jian,0,0,0,0
1653526538315,ECE 238A,B00,091074,Luo; Jian,0,0,0,0
1653526538851,ECE 240A,A00,091075,Radic; Stojan,0,0,0,0
1653526539377,ECE 247A,A00,091592,Shi; Lingyan,0,0,0,0
1653526539900,ECE 250,A00,091076,Touri; Behrouz,0,0,0,0
1653526540423,ECE 251C,A00,091078,Nguyen; Truong Quang,0,0,0,0
1653526540946,ECE 253,A00,091079,Cosman; Pamela C.,0,0,0,0
1653526541471,ECE 255A,A00,091080,Orlitsky; Alon,0,0,0,0
1653526541993,ECE 257A,A00,091081,Zhang; Xinyu,0,0,0,0
1653526542516,ECE 260A,A01,091084,Eldon; John,0,0,0,0
1653526543041,ECE 264C,A00,091085,Galton; Ian A,0,0,0,0
1653526543571,ECE 265C,A00,094889,Presti; Calogero Davide,0,0,0,9
1653526544093,ECE 266,A01,091087,Hall; Drew A.,0,0,0,0
1653526545139,ECE 271A,A00,091090,Vasconcelos; Nuno,0,0,0,0
1653526545665,ECE 272B,A00,091091,Sworder; David D.,0,0,0,0
1653526546188,ECE 275A,A00,091092,Meyer; Florian,0,0,0,0
1653526546715,ECE 277,A00,091093,An; Cheolhong,0,0,0,0
1653526547239,ECE 283,A00,091094,Le; Hanh-Phuc,0,0,0,0
1653526547772,ECE 284,A00,091095,Kang; Mingu,0,0,0,0
1653526547772,ECE 284,B00,091096,Wang; Edward Jay,0,0,0,0
1653526548296,ECE 285,A00,094334,Touri; Behrouz,0,0,0,0
1653526548824,ECE 289,A00,091097,Whelan; David Arthur,0,0,0,0
1653526549358,MATH 200A,A00,087414,Salehi Golsefidy; Alireza,7,0,8,1
1653526549884,MATH 202A,A00,087415,Gill; Philip E.,2,0,8,6
1653526550410,MATH 203A,A00,087416,Oprea; Dragos N.,6,0,8,2
1653526550938,MATH 204A,A00,087417,Kedlaya; Kiran S.,6,0,8,2
1653526551470,MATH 205,A00,087418,Sorensen; Claus M,6,0,8,2
1653526551997,MATH 206A,A00,087419,Izadi; Elham,7,0,8,1
1653526552521,MATH 207A,A00,087420,Mohammadi; Amir,5,0,8,3
1653526553047,MATH 208,A00,087421,Staff,9,0,10,1
1653526553572,MATH 209,A00,087422,Staff,10,0,10,0
1653526554094,MATH 218,A00,087423,Staff,10,0,10,0
1653526554621,MATH 220A,A00,087424,Novak; Jonathan I,7,0,8,1
1653526555144,MATH 231A,A00,087425,Bejenaru; Ioan,3,0,8,5
1653526555667,MATH 240A,A00,087426,Ebenfelt; Peter F,5,0,8,3
1653526556190,MATH 243,A00,087427,Staff,9,0,10,1
1653526556722,MATH 248,A00,087429,Staff,10,0,10,0
1653526557255,MATH 250A,A00,087430,Spolaor; Luca,4,0,8,4
1653526557778,MATH 257A,A00,087431,Spolaor; Luca,7,0,8,1
1653526558303,MATH 258,A00,087432,Staff,9,0,10,1
1653526558826,MATH 264A,A00,087433,Warnke; Lutz Peter,5,0,8,3
1653526559353,MATH 268,A00,087434,Staff,15,0,15,0
1653526559878,MATH 269,A00,087435,Staff,14,0,15,1
1653526560403,MATH 270A,A00,087436,Nie; Jiawang,0,0,8,8
1653526560942,MATH 272A,A00,087437,Tian; Xiaochuan,1,0,8,7
1653526561465,MATH 274,A01,087439,Cheng; Li-Tien,9,0,10,1
1653526561465,MATH 274,A02,087440,Cheng; Li-Tien,10,0,10,0
1653526561990,MATH 278A,A00,087441,Staff,8,0,10,2
1653526562512,MATH 278B,A00,087442,Staff,8,0,10,2
1653526563036,MATH 278C,A00,087443,Staff,8,0,10,2
1653526563558,MATH 280A,A00,087444,Zheng; Tianyi,0,0,8,8
1653526564086,MATH 281A,A00,087445,Bradic; Jelena,0,0,8,8
1653526564609,MATH 282A,A00,087446,Zhang; Danna,0,0,8,8
1653526565131,MATH 283,A00,087447,Tesler; Glenn,0,0,0,15
1653526565660,MATH 286,A00,087448,Kemp; Todd Aahron,5,0,8,3
1653526566186,MATH 287D,A00,087449,Bradic; Jelena,0,0,0,0
1653526566710,MATH 288,A00,087450,Staff,14,0,15,1
1653526566710,MATH 288,B00,087451,Staff,15,0,15,0
1653526566710,MATH 288,C00,087452,Staff,15,0,15,0
1653526567235,MATH 290A,A00,087453,Xu; Zhouli,6,0,8,2
1653526567758,MATH 291A,A00,087454,Xu; Zhouli,7,0,8,1
1653526568283,MATH 292,A00,087455,Staff,10,0,10,0
1653526568879,MATH 295,A00,087456,Staff,50,0,50,0
1653526569401,MATH 297,001,087457,Staff,998,0,999,1
1653527129228,COGS 200,A01,087991,Staff,47,0,50,3
1653527129752,COGS 201,A01,094504,Rangel; Lara M,17,0,25,8
1653527130275,COGS 203,A00,087992,Coulson; Seana M,18,0,20,2
1653527130798,COGS 210A,001,087993,Greene; Deanna Jacquelyn,9998,0,9999,1
1653527130798,COGS 210A,002,087994,Saygin; Ayse P,9999,0,9999,0
1653527130798,COGS 210A,003,087995,Xia; Haijun,9999,0,9999,0
1653527130798,COGS 210A,004,087996,Nitz; Douglas A.,9999,0,9999,0
1653527130798,COGS 210A,005,087997,Hollan; James D.,9999,0,9999,0
1653527130798,COGS 210A,006,087998,Deak; Gedeon O.,9998,0,9999,1
1653527130798,COGS 210A,007,087999,Rossano; Federico,9999,0,9999,0
1653527131320,COGS 211A,A00,088000,Coulson; Seana M,9997,0,9999,2
1653527131845,COGS 229,A00,088002,Staff,23,0,25,2
1653527132372,COGS 260,B00,094231,Staff,17,0,20,3
1653527132372,COGS 260,A00,088004,Nitz; Douglas A.,9998,0,9999,1
1653527132897,CSE 202,A00,090110,Paturi; Ramamohan,0,0,0,0
1653527132897,CSE 202,B00,090111,Paturi; Ramamohan,0,0,0,0
1653527133422,CSE 207B,A00,090112,Heninger; Nadia A,0,0,0,0
1653527133947,CSE 208,A00,094858,Micciancio; Daniele,0,0,0,0
1653527134469,CSE 210,A00,090113,Powell; Thomas Allan,0,0,0,0
1653527134994,CSE 219,A00,090898,Staff,0,0,0,0
1653527135515,CSE 221,A00,090114,Zhou; Yuan-Yuan,0,0,0,0
1653527136041,CSE 229A,A00,090115,Porter; George M,0,0,0,0
1653527136573,CSE 229C,A00,090116,Savage; Stefan,0,0,0,0
1653527137095,CSE 230,A00,090117,Jhala; Ranjit,0,0,0,0
1653527137621,CSE 232,A00,090118,Papakonstantinou; Yannis,0,0,0,0
1653527138143,CSE 239A,A00,090121,Kumar; Arun Kumar,0,0,0,0
1653527138674,CSE 239B,A00,090122,Jhala; Ranjit,0,0,0,0
1653527139198,CSE 240A,A00,090123,Zhao; Jishen,0,0,189,189
1653527139723,CSE 243A,A00,090124,Orailoglu; Alex,0,0,15,15
1653527140248,CSE 249B,A00,090125,Kahng; Andrew Byun,13,0,20,7
1653527140772,CSE 250A,A00,090126,Berg-Kirkpatrick; Taylor D,0,0,0,0
1653527141295,CSE 252A,A00,090127,Ochoa; Benjamin Lawrence,0,0,0,0
1653527141817,CSE 258,A01,090129,McAuley; Julian John,0,0,0,0
1653527142339,CSE 258R,A01,090131,McAuley; Julian John,0,0,0,0
1653527142861,CSE 274,A00,090132,Ramamoorthi; Ravi,0,0,0,0
1653527143392,CSE 276A,A00,090133,Christensen; Henrik I,0,0,0,0
1653527143915,CSE 276C,A00,090134,Christensen; Henrik I,0,0,0,0
1653527144448,CSE 290,A00,090135,Bafna; Vineet,0,0,0,0
1653527144448,CSE 290,B00,090136,Ramamoorthi; Ravi,0,0,0,0
1653527144448,CSE 290,C00,090137,Li; Tzumao,8,0,10,2
1653527144448,CSE 290,D00,090138,Zhou; Yuan-Yuan,9,0,10,1
1653527144448,CSE 290,E00,090139,Christensen; Henrik I,9,0,10,1
1653527144448,CSE 290,F00,094053,Shalev; Aaron D,0,0,0,0
1653527144973,CSE 291,A00,090140,Munyaka; Imani N. S.,0,0,0,0
1653527144973,CSE 291,B00,094880,Yu; Qi,0,0,0,0
1653527144973,CSE 291,C00,090142,Pannuto; Patrick William,0,0,0,0
1653527144973,CSE 291,D00,094881,Zhang; Yiying,0,0,0,0
1653527144973,CSE 291,E00,095118,Su; Hao,0,0,0,0
1653527145499,CSE 293,001,094905,Bafna; Vineet,9999,0,9999,0
1653527145499,CSE 293,002,094906,Bellare; Mihir,9999,0,9999,0
1653527145499,CSE 293,003,094907,Berg-Kirkpatrick; Taylor D,9999,0,9999,0
1653527145499,CSE 293,004,094908,Christensen; Henrik I,9999,0,9999,0
1653527145499,CSE 293,005,094909,Cottrell; Garrison W,9999,0,9999,0
1653527145499,CSE 293,006,094910,Deutsch; Alin Bernard,9999,0,9999,0
1653527145499,CSE 293,007,094911,Esmaeilzadeh; Hadi,9999,0,9999,0
1653527145499,CSE 293,008,094912,Freund; Yoav,9999,0,9999,0
1653527145499,CSE 293,009,094913,Griswold; William G.,9999,0,9999,0
1653527145499,CSE 293,010,094914,Gymrek; Melissa Ann,9999,0,9999,0
1653527145499,CSE 293,011,094915,Heninger; Nadia A,9999,0,9999,0
1653527145499,CSE 293,012,094916,Impagliazzo; Russell,9999,0,9999,0
1653527145499,CSE 293,013,094917,Jhala; Ranjit,9999,0,9999,0
1653527145499,CSE 293,014,094918,Kahng; Andrew Byun,9999,0,9999,0
1653527145499,CSE 293,015,094919,Kane; Daniel Mertz,9999,0,9999,0
1653527145499,CSE 293,016,094920,Kriegman; David J,9999,0,9999,0
1653527145499,CSE 293,017,094921,Kumar; Arun Kumar,9999,0,9999,0
1653527145499,CSE 293,018,094922,Lerner; Sorin,9999,0,9999,0
1653527145499,CSE 293,019,094923,Lovett; Shachar,9999,0,9999,0
1653527145499,CSE 293,020,094924,McAuley; Julian John,9999,0,9999,0
1653527145499,CSE 293,021,094925,Micciancio; Daniele,9999,0,9999,0
1653527145499,CSE 293,022,094926,Orailoglu; Alex,9999,0,9999,0
1653527145499,CSE 293,023,094927,Paturi; Ramamohan,9999,0,9999,0
1653527145499,CSE 293,024,094928,Polikarpova; Nadezhda,9999,0,9999,0
1653527145499,CSE 293,025,094929,Politz; Joseph Gibbs,9999,0,9999,0
1653527145499,CSE 293,026,094930,Porter; George M,9999,0,9999,0
1653527145499,CSE 293,027,094931,Porter; Leonard Emerson,9999,0,9999,0
1653527145499,CSE 293,028,094932,Ramamoorthi; Ravi,9999,0,9999,0
1653527145499,CSE 293,029,094933,Sahoo; Debashis,9999,0,9999,0
1653527145499,CSE 293,030,094934,Saul; Lawrence,9999,0,9999,0
1653527145499,CSE 293,031,094935,Savage; Stefan,9999,0,9999,0
1653527145499,CSE 293,032,094936,Schulze; Jurgen P.,9999,0,9999,0
1653527145499,CSE 293,033,094937,Snoeren; Alex C.,9999,0,9999,0
1653527145499,CSE 293,034,094938,Shang; Jingbo,9999,0,9999,0
1653527145499,CSE 293,035,094939,Stefan; Deian,9999,0,9999,0
1653527145499,CSE 293,036,094940,Su; Hao,9999,0,9999,0
1653527145499,CSE 293,037,094941,Swanson; Steven James,9999,0,9999,0
1653527145499,CSE 293,038,094942,Tullsen; Dean Michael,9999,0,9999,0
1653527145499,CSE 293,039,094943,Voelker; Geoffrey M.,9999,0,9999,0
1653527145499,CSE 293,040,094944,Zhao; Jishen,9999,0,9999,0
1653527145499,CSE 293,041,094945,Zhou; Yuan-Yuan,9999,0,9999,0
1653527145499,CSE 293,042,094946,Gao; Sicun,9998,0,9999,1
1653527145499,CSE 293,043,094947,Weibel; Nadir,9999,0,9999,0
1653527145499,CSE 293,044,094948,Gupta; Rajesh K.,9999,0,9999,0
1653527146026,CSE 294,A00,090143,Porter; George M,8,0,10,2
1653527146558,DSE 200,A00,091799,Staff,50,0,50,0
1653527147087,DSE 203,A00,091800,Gupta; Amarnath,30,0,30,0
1653527147616,DSE 250,A00,091801,Deutsch; Alin Bernard,30,0,30,0
1653527148141,DSE 290,A00,091802,Altintas De Callaf; Ilkay,50,0,50,0
1653527148669,ECE 200,001,091003,Antipa; Nicholas A,9999,0,9999,0
1653527148669,ECE 200,002,091004,Atanasov; Nikolay A.,9999,0,9999,0
1653527148669,ECE 200,003,091005,Bharadia; Dinesh,9999,0,9999,0
1653527148669,ECE 200,004,091006,Cheng; Chung Kuan,9999,0,9999,0
1653527148669,ECE 200,005,091007,Cosman; Pamela C.,9999,0,9999,0
1653527148669,ECE 200,006,091008,Staff,9999,0,9999,0
1653527148669,ECE 200,007,091009,Dayeh; Shadi Ahmad,9999,0,9999,0
1653527148669,ECE 200,008,091010,Fainman; Yeshaiahu,9999,0,9999,0
1653527148669,ECE 200,009,091011,Ford; Joseph Earl,9999,0,9999,0
1653527148669,ECE 200,010,091012,Franceschetti; Massimo,9999,0,9999,0
1653527148669,ECE 200,011,091013,Fullerton; Eric E,9999,0,9999,0
1653527148669,ECE 200,012,091014,Galton; Ian A,9999,0,9999,0
1653527148669,ECE 200,013,091015,Gilja; Vikash,9999,0,9999,0
1653527148669,ECE 200,014,091016,Hall; Drew A.,9999,0,9999,0
1653527148669,ECE 200,015,091017,Hsueh; Tzu-Chien,9999,0,9999,0
1653527148669,ECE 200,016,091018,Javidi; Tara,9999,0,9999,0
1653527148669,ECE 200,017,091019,Kahng; Andrew Byun,9999,0,9999,0
1653527148669,ECE 200,018,091020,Kim; Young-Han,9999,0,9999,0
1653527148669,ECE 200,019,091021,Koushanfar; Farinaz,9999,0,9999,0
1653527148669,ECE 200,020,091022,Kuzum; Duygu,9999,0,9999,0
1653527148669,ECE 200,021,091023,Le; Hanh-Phuc,9999,0,9999,0
1653527148669,ECE 200,022,091024,Lin; Bill,9999,0,9999,0
1653527148669,ECE 200,023,091025,Liu; Zhaowei,9999,0,9999,0
1653527148669,ECE 200,024,091026,Lo; Yu-Hwa,9999,0,9999,0
1653527148669,ECE 200,025,091027,Lomakin; Vitaliy,9999,0,9999,0
1653527148669,ECE 200,026,091028,Mercier; Patrick Philip,9999,0,9999,0
1653527148669,ECE 200,027,091029,Meyer; Florian,9999,0,9999,0
1653527148669,ECE 200,028,091030,Milstein; Laurence B.,9999,0,9999,0
1653527148669,ECE 200,029,091031,Mir Arabbaygi; Siavash,9999,0,9999,0
1653527148669,ECE 200,030,091032,Mookherjea; Shayan,9999,0,9999,0
1653527148669,ECE 200,031,091033,Morris; Karcher William,9999,0,9999,0
1653527148669,ECE 200,032,091034,Ng; Tse Nga,9999,0,9999,0
1653527148669,ECE 200,033,091035,Nguyen; Truong Quang,9999,0,9999,0
1653527148669,ECE 200,034,091036,Nomura; Kenji,9999,0,9999,0
1653527148669,ECE 200,035,091037,Orlitsky; Alon,9999,0,9999,0
1653527148669,ECE 200,036,091038,Pal; Piya,9999,0,9999,0
1653527148669,ECE 200,037,091039,Papen; George C.,9999,0,9999,0
1653527148669,ECE 200,038,091040,Radic; Stojan,9999,0,9999,0
1653527148669,ECE 200,039,091041,Rao; Bhaskar D.,9999,0,9999,0
1653527148669,ECE 200,040,091042,Rao; Ramesh R,9999,0,9999,0
1653527148669,ECE 200,041,091043,Rebeiz; Gabriel,9999,0,9999,0
1653527148669,ECE 200,042,091044,Sanford; John R,9999,0,9999,0
1653527148669,ECE 200,043,091045,Siegel; Paul H.,9999,0,9999,0
1653527148669,ECE 200,044,091046,Sievenpiper; Daniel F.,9999,0,9999,0
1653527148669,ECE 200,045,091047,Sworder; David D.,9999,0,9999,0
1653527148669,ECE 200,046,091048,Taur; Yuan,9999,0,9999,0
1653527148669,ECE 200,047,091049,Touri; Behrouz,9999,0,9999,0
1653527148669,ECE 200,048,091050,Trivedi; Mohan M.,9999,0,9999,0
1653527148669,ECE 200,049,091051,Vardy; Alexander,9999,0,9999,0
1653527148669,ECE 200,050,091052,Vasconcelos; Nuno,9999,0,9999,0
1653527148669,ECE 200,051,091053,Wang; Xiaolong,9999,0,9999,0
1653527148669,ECE 200,052,091054,Xie; Pengtao,9999,0,9999,0
1653527148669,ECE 200,053,091055,Yip; Michael,9999,0,9999,0
1653527148669,ECE 200,054,091056,Zeger; Kenneth A.,9999,0,9999,0
1653527148669,ECE 200,055,091057,Zhang; Xinyu,9999,0,9999,0
1653527148669,ECE 200,056,091058,Turakhia; Yatish Girish,9999,0,9999,0
1653527148669,ECE 200,057,091059,Kang; Mingu,9999,0,9999,0
1653527148669,ECE 200,058,091060,Shi; Yuanyuan,9999,0,9999,0
1653527148669,ECE 200,059,091061,Wang; Edward Jay,9999,0,9999,0
1653527148669,ECE 200,060,091062,Zheng; Yang,9999,0,9999,0
1653527149191,ECE 201,A00,095526,Lo; Yu-Hwa,0,0,0,0
1653527149716,ECE 203,A00,091065,Mercier; Patrick Philip,0,0,0,0
1653527150243,ECE 207A,A00,091605,Liu; Thomas Tao-Ming,0,0,0,0
1653527150774,ECE 212AN,A00,091068,Nomura; Kenji,0,0,0,0
1653527151297,ECE 222A,A00,091069,Rebeiz; Gabriel,0,0,0,0
1653527151819,ECE 225A,A00,091070,Orlitsky; Alon,0,0,0,0
1653527152344,ECE 230A,A00,091071,Nomura; Kenji,0,0,0,0
1653527152867,ECE 236A,A00,091072,Dayeh; Shadi Ahmad,0,0,0,0
1653527153405,ECE 238A,A00,091073,Luo; Jian,0,0,0,0
1653527153405,ECE 238A,B00,091074,Luo; Jian,0,0,0,0
1653527153931,ECE 240A,A00,091075,Radic; Stojan,0,0,0,0
1653527154456,ECE 247A,A00,091592,Shi; Lingyan,0,0,0,0
1653527154985,ECE 250,A00,091076,Touri; Behrouz,0,0,0,0
1653527155508,ECE 251C,A00,091078,Nguyen; Truong Quang,0,0,0,0
1653527156125,ECE 253,A00,091079,Cosman; Pamela C.,0,0,0,0
1653527156650,ECE 255A,A00,091080,Orlitsky; Alon,0,0,0,0
1653527157171,ECE 257A,A00,091081,Zhang; Xinyu,0,0,0,0
1653527157696,ECE 260A,A01,091084,Eldon; John,0,0,0,0
1653527158221,ECE 264C,A00,091085,Galton; Ian A,0,0,0,0
1653527158755,ECE 265C,A00,094889,Presti; Calogero Davide,0,0,0,9
1653527159280,ECE 266,A01,091087,Hall; Drew A.,0,0,0,0
1653527160334,ECE 271A,A00,091090,Vasconcelos; Nuno,0,0,0,0
1653527160856,ECE 272B,A00,091091,Sworder; David D.,0,0,0,0
1653527161387,ECE 275A,A00,091092,Meyer; Florian,0,0,0,0
1653527161913,ECE 277,A00,091093,An; Cheolhong,0,0,0,0
1653527162442,ECE 283,A00,091094,Le; Hanh-Phuc,0,0,0,0
1653527162965,ECE 284,A00,091095,Kang; Mingu,0,0,0,0
1653527162965,ECE 284,B00,091096,Wang; Edward Jay,0,0,0,0
1653527163488,ECE 285,A00,094334,Touri; Behrouz,0,0,0,0
1653527164010,ECE 289,A00,091097,Whelan; David Arthur,0,0,0,0
1653527164543,MATH 200A,A00,087414,Salehi Golsefidy; Alireza,7,0,8,1
1653527165066,MATH 202A,A00,087415,Gill; Philip E.,2,0,8,6
1653527165596,MATH 203A,A00,087416,Oprea; Dragos N.,6,0,8,2
1653527166118,MATH 204A,A00,087417,Kedlaya; Kiran S.,6,0,8,2
1653527166657,MATH 205,A00,087418,Sorensen; Claus M,6,0,8,2
1653527167183,MATH 206A,A00,087419,Izadi; Elham,7,0,8,1
1653527167706,MATH 207A,A00,087420,Mohammadi; Amir,5,0,8,3
1653527168235,MATH 208,A00,087421,Staff,9,0,10,1
1653527168757,MATH 209,A00,087422,Staff,10,0,10,0
1653527169277,MATH 218,A00,087423,Staff,10,0,10,0
1653527169800,MATH 220A,A00,087424,Novak; Jonathan I,7,0,8,1
1653527170323,MATH 231A,A00,087425,Bejenaru; Ioan,3,0,8,5
1653527170850,MATH 240A,A00,087426,Ebenfelt; Peter F,5,0,8,3
1653527171375,MATH 243,A00,087427,Staff,9,0,10,1
1653527171900,MATH 248,A00,087429,Staff,10,0,10,0
1653527172422,MATH 250A,A00,087430,Spolaor; Luca,4,0,8,4
1653527172948,MATH 257A,A00,087431,Spolaor; Luca,7,0,8,1
1653527173472,MATH 258,A00,087432,Staff,9,0,10,1
1653527173997,MATH 264A,A00,087433,Warnke; Lutz Peter,5,0,8,3
1653527174519,MATH 268,A00,087434,Staff,15,0,15,0
1653527175049,MATH 269,A00,087435,Staff,14,0,15,1
1653527175574,MATH 270A,A00,087436,Nie; Jiawang,0,0,8,8
1653527176096,MATH 272A,A00,087437,Tian; Xiaochuan,1,0,8,7
1653527176620,MATH 274,A01,087439,Cheng; Li-Tien,9,0,10,1
1653527176620,MATH 274,A02,087440,Cheng; Li-Tien,10,0,10,0
1653527177144,MATH 278A,A00,087441,Staff,8,0,10,2
1653527177667,MATH 278B,A00,087442,Staff,8,0,10,2
1653527178191,MATH 278C,A00,087443,Staff,8,0,10,2
1653527178713,MATH 280A,A00,087444,Zheng; Tianyi,0,0,8,8
1653527179235,MATH 281A,A00,087445,Bradic; Jelena,0,0,8,8
1653527179762,MATH 282A,A00,087446,Zhang; Danna,0,0,8,8
1653527180288,MATH 283,A00,087447,Tesler; Glenn,0,0,0,15
1653527180814,MATH 286,A00,087448,Kemp; Todd Aahron,5,0,8,3
1653527181340,MATH 287D,A00,087449,Bradic; Jelena,0,0,0,0
1653527181865,MATH 288,A00,087450,Staff,14,0,15,1
1653527181865,MATH 288,B00,087451,Staff,15,0,15,0
1653527181865,MATH 288,C00,087452,Staff,15,0,15,0
1653527182388,MATH 290A,A00,087453,Xu; Zhouli,6,0,8,2
1653527182917,MATH 291A,A00,087454,Xu; Zhouli,7,0,8,1
1653527183439,MATH 292,A00,087455,Staff,10,0,10,0
1653527183965,MATH 295,A00,087456,Staff,50,0,50,0
1653527184497,MATH 297,001,087457,Staff,998,0,999,1
1653527744020,COGS 200,A01,087991,Staff,47,0,50,3
1653527744558,COGS 201,A01,094504,Rangel; Lara M,17,0,25,8
1653527745079,COGS 203,A00,087992,Coulson; Seana M,18,0,20,2
1653527745609,COGS 210A,001,087993,Greene; Deanna Jacquelyn,9998,0,9999,1
1653527745609,COGS 210A,002,087994,Saygin; Ayse P,9999,0,9999,0
1653527745609,COGS 210A,003,087995,Xia; Haijun,9999,0,9999,0
1653527745609,COGS 210A,004,087996,Nitz; Douglas A.,9999,0,9999,0
1653527745609,COGS 210A,005,087997,Hollan; James D.,9999,0,9999,0
1653527745609,COGS 210A,006,087998,Deak; Gedeon O.,9998,0,9999,1
1653527745609,COGS 210A,007,087999,Rossano; Federico,9999,0,9999,0
1653527746140,COGS 211A,A00,088000,Coulson; Seana M,9997,0,9999,2
1653527746668,COGS 229,A00,088002,Staff,23,0,25,2
1653527747195,COGS 260,B00,094231,Staff,17,0,20,3
1653527747195,COGS 260,A00,088004,Nitz; Douglas A.,9998,0,9999,1
1653527747721,CSE 202,A00,090110,Paturi; Ramamohan,0,0,0,0
1653527747721,CSE 202,B00,090111,Paturi; Ramamohan,0,0,0,0
1653527748245,CSE 207B,A00,090112,Heninger; Nadia A,0,0,0,0
1653527748770,CSE 208,A00,094858,Micciancio; Daniele,0,0,0,0
1653527749294,CSE 210,A00,090113,Powell; Thomas Allan,0,0,0,0
1653527749816,CSE 219,A00,090898,Staff,0,0,0,0
1653527750338,CSE 221,A00,090114,Zhou; Yuan-Yuan,0,0,0,0
1653527750859,CSE 229A,A00,090115,Porter; George M,0,0,0,0
1653527751386,CSE 229C,A00,090116,Savage; Stefan,0,0,0,0
1653527751920,CSE 230,A00,090117,Jhala; Ranjit,0,0,0,0
1653527752453,CSE 232,A00,090118,Papakonstantinou; Yannis,0,0,0,0
1653527752975,CSE 239A,A00,090121,Kumar; Arun Kumar,0,0,0,0
1653527753511,CSE 239B,A00,090122,Jhala; Ranjit,0,0,0,0
1653527754040,CSE 240A,A00,090123,Zhao; Jishen,0,0,189,189
1653527754566,CSE 243A,A00,090124,Orailoglu; Alex,0,0,15,15
1653527755091,CSE 249B,A00,090125,Kahng; Andrew Byun,13,0,20,7
1653527755624,CSE 250A,A00,090126,Berg-Kirkpatrick; Taylor D,0,0,0,0
1653527756162,CSE 252A,A00,090127,Ochoa; Benjamin Lawrence,0,0,0,0
1653527756689,CSE 258,A01,090129,McAuley; Julian John,0,0,0,0
1653527757214,CSE 258R,A01,090131,McAuley; Julian John,0,0,0,0
1653527757737,CSE 274,A00,090132,Ramamoorthi; Ravi,0,0,0,0
1653527758265,CSE 276A,A00,090133,Christensen; Henrik I,0,0,0,0
1653527758790,CSE 276C,A00,090134,Christensen; Henrik I,0,0,0,0
1653527759315,CSE 290,A00,090135,Bafna; Vineet,0,0,0,0
1653527759315,CSE 290,B00,090136,Ramamoorthi; Ravi,0,0,0,0
1653527759315,CSE 290,C00,090137,Li; Tzumao,8,0,10,2
1653527759315,CSE 290,D00,090138,Zhou; Yuan-Yuan,9,0,10,1
1653527759315,CSE 290,E00,090139,Christensen; Henrik I,9,0,10,1
1653527759315,CSE 290,F00,094053,Shalev; Aaron D,0,0,0,0
1653527759842,CSE 291,A00,090140,Munyaka; Imani N. S.,0,0,0,0
1653527759842,CSE 291,B00,094880,Yu; Qi,0,0,0,0
1653527759842,CSE 291,C00,090142,Pannuto; Patrick William,0,0,0,0
1653527759842,CSE 291,D00,094881,Zhang; Yiying,0,0,0,0
1653527759842,CSE 291,E00,095118,Su; Hao,0,0,0,0
1653527760383,CSE 293,001,094905,Bafna; Vineet,9999,0,9999,0
1653527760383,CSE 293,002,094906,Bellare; Mihir,9999,0,9999,0
1653527760383,CSE 293,003,094907,Berg-Kirkpatrick; Taylor D,9999,0,9999,0
1653527760383,CSE 293,004,094908,Christensen; Henrik I,9999,0,9999,0
1653527760383,CSE 293,005,094909,Cottrell; Garrison W,9999,0,9999,0
1653527760383,CSE 293,006,094910,Deutsch; Alin Bernard,9999,0,9999,0
1653527760383,CSE 293,007,094911,Esmaeilzadeh; Hadi,9999,0,9999,0
1653527760383,CSE 293,008,094912,Freund; Yoav,9999,0,9999,0
1653527760383,CSE 293,009,094913,Griswold; William G.,9999,0,9999,0
1653527760383,CSE 293,010,094914,Gymrek; Melissa Ann,9999,0,9999,0
1653527760383,CSE 293,011,094915,Heninger; Nadia A,9999,0,9999,0
1653527760383,CSE 293,012,094916,Impagliazzo; Russell,9999,0,9999,0
1653527760383,CSE 293,013,094917,Jhala; Ranjit,9999,0,9999,0
1653527760383,CSE 293,014,094918,Kahng; Andrew Byun,9999,0,9999,0
1653527760383,CSE 293,015,094919,Kane; Daniel Mertz,9999,0,9999,0
1653527760383,CSE 293,016,094920,Kriegman; David J,9999,0,9999,0
1653527760383,CSE 293,017,094921,Kumar; Arun Kumar,9999,0,9999,0
1653527760383,CSE 293,018,094922,Lerner; Sorin,9999,0,9999,0
1653527760383,CSE 293,019,094923,Lovett; Shachar,9999,0,9999,0
1653527760383,CSE 293,020,094924,McAuley; Julian John,9999,0,9999,0
1653527760383,CSE 293,021,094925,Micciancio; Daniele,9999,0,9999,0
1653527760383,CSE 293,022,094926,Orailoglu; Alex,9999,0,9999,0
1653527760383,CSE 293,023,094927,Paturi; Ramamohan,9999,0,9999,0
1653527760383,CSE 293,024,094928,Polikarpova; Nadezhda,9999,0,9999,0
1653527760383,CSE 293,025,094929,Politz; Joseph Gibbs,9999,0,9999,0
1653527760383,CSE 293,026,094930,Porter; George M,9999,0,9999,0
1653527760383,CSE 293,027,094931,Porter; Leonard Emerson,9999,0,9999,0
1653527760383,CSE 293,028,094932,Ramamoorthi; Ravi,9999,0,9999,0
1653527760383,CSE 293,029,094933,Sahoo; Debashis,9999,0,9999,0
1653527760383,CSE 293,030,094934,Saul; Lawrence,9999,0,9999,0
1653527760383,CSE 293,031,094935,Savage; Stefan,9999,0,9999,0
1653527760383,CSE 293,032,094936,Schulze; Jurgen P.,9999,0,9999,0
1653527760383,CSE 293,033,094937,Snoeren; Alex C.,9999,0,9999,0
1653527760383,CSE 293,034,094938,Shang; Jingbo,9999,0,9999,0
1653527760383,CSE 293,035,094939,Stefan; Deian,9999,0,9999,0
1653527760383,CSE 293,036,094940,Su; Hao,9999,0,9999,0
1653527760383,CSE 293,037,094941,Swanson; Steven James,9999,0,9999,0
1653527760383,CSE 293,038,094942,Tullsen; Dean Michael,9999,0,9999,0
1653527760383,CSE 293,039,094943,Voelker; Geoffrey M.,9999,0,9999,0
1653527760383,CSE 293,040,094944,Zhao; Jishen,9999,0,9999,0
1653527760383,CSE 293,041,094945,Zhou; Yuan-Yuan,9999,0,9999,0
1653527760383,CSE 293,042,094946,Gao; Sicun,9998,0,9999,1
1653527760383,CSE 293,043,094947,Weibel; Nadir,9999,0,9999,0
1653527760383,CSE 293,044,094948,Gupta; Rajesh K.,9999,0,9999,0
1653527760906,CSE 294,A00,090143,Porter; George M,8,0,10,2
1653527761430,DSE 200,A00,091799,Staff,50,0,50,0
1653527761958,DSE 203,A00,091800,Gupta; Amarnath,30,0,30,0
1653527762481,DSE 250,A00,091801,Deutsch; Alin Bernard,30,0,30,0
1653527763012,DSE 290,A00,091802,Altintas De Callaf; Ilkay,50,0,50,0
1653527763554,ECE 200,001,091003,Antipa; Nicholas A,9999,0,9999,0
1653527763554,ECE 200,002,091004,Atanasov; Nikolay A.,9999,0,9999,0
1653527763554,ECE 200,003,091005,Bharadia; Dinesh,9999,0,9999,0
1653527763554,ECE 200,004,091006,Cheng; Chung Kuan,9999,0,9999,0
1653527763554,ECE 200,005,091007,Cosman; Pamela C.,9999,0,9999,0
1653527763554,ECE 200,006,091008,Staff,9999,0,9999,0
1653527763554,ECE 200,007,091009,Dayeh; Shadi Ahmad,9999,0,9999,0
1653527763554,ECE 200,008,091010,Fainman; Yeshaiahu,9999,0,9999,0
1653527763554,ECE 200,009,091011,Ford; Joseph Earl,9999,0,9999,0
1653527763554,ECE 200,010,091012,Franceschetti; Massimo,9999,0,9999,0
1653527763554,ECE 200,011,091013,Fullerton; Eric E,9999,0,9999,0
1653527763554,ECE 200,012,091014,Galton; Ian A,9999,0,9999,0
1653527763554,ECE 200,013,091015,Gilja; Vikash,9999,0,9999,0
1653527763554,ECE 200,014,091016,Hall; Drew A.,9999,0,9999,0
1653527763554,ECE 200,015,091017,Hsueh; Tzu-Chien,9999,0,9999,0
1653527763554,ECE 200,016,091018,Javidi; Tara,9999,0,9999,0
1653527763554,ECE 200,017,091019,Kahng; Andrew Byun,9999,0,9999,0
1653527763554,ECE 200,018,091020,Kim; Young-Han,9999,0,9999,0
1653527763554,ECE 200,019,091021,Koushanfar; Farinaz,9999,0,9999,0
1653527763554,ECE 200,020,091022,Kuzum; Duygu,9999,0,9999,0
1653527763554,ECE 200,021,091023,Le; Hanh-Phuc,9999,0,9999,0
1653527763554,ECE 200,022,091024,Lin; Bill,9999,0,9999,0
1653527763554,ECE 200,023,091025,Liu; Zhaowei,9999,0,9999,0
1653527763554,ECE 200,024,091026,Lo; Yu-Hwa,9999,0,9999,0
1653527763554,ECE 200,025,091027,Lomakin; Vitaliy,9999,0,9999,0
1653527763554,ECE 200,026,091028,Mercier; Patrick Philip,9999,0,9999,0
1653527763554,ECE 200,027,091029,Meyer; Florian,9999,0,9999,0
1653527763554,ECE 200,028,091030,Milstein; Laurence B.,9999,0,9999,0
1653527763554,ECE 200,029,091031,Mir Arabbaygi; Siavash,9999,0,9999,0
1653527763554,ECE 200,030,091032,Mookherjea; Shayan,9999,0,9999,0
1653527763554,ECE 200,031,091033,Morris; Karcher William,9999,0,9999,0
1653527763554,ECE 200,032,091034,Ng; Tse Nga,9999,0,9999,0
1653527763554,ECE 200,033,091035,Nguyen; Truong Quang,9999,0,9999,0
1653527763554,ECE 200,034,091036,Nomura; Kenji,9999,0,9999,0
1653527763554,ECE 200,035,091037,Orlitsky; Alon,9999,0,9999,0
1653527763554,ECE 200,036,091038,Pal; Piya,9999,0,9999,0
1653527763554,ECE 200,037,091039,Papen; George C.,9999,0,9999,0
1653527763554,ECE 200,038,091040,Radic; Stojan,9999,0,9999,0
1653527763554,ECE 200,039,091041,Rao; Bhaskar D.,9999,0,9999,0
1653527763554,ECE 200,040,091042,Rao; Ramesh R,9999,0,9999,0
1653527763554,ECE 200,041,091043,Rebeiz; Gabriel,9999,0,9999,0
1653527763554,ECE 200,042,091044,Sanford; John R,9999,0,9999,0
1653527763554,ECE 200,043,091045,Siegel; Paul H.,9999,0,9999,0
1653527763554,ECE 200,044,091046,Sievenpiper; Daniel F.,9999,0,9999,0
1653527763554,ECE 200,045,091047,Sworder; David D.,9999,0,9999,0
1653527763554,ECE 200,046,091048,Taur; Yuan,9999,0,9999,0
1653527763554,ECE 200,047,091049,Touri; Behrouz,9999,0,9999,0
1653527763554,ECE 200,048,091050,Trivedi; Mohan M.,9999,0,9999,0
1653527763554,ECE 200,049,091051,Vardy; Alexander,9999,0,9999,0
1653527763554,ECE 200,050,091052,Vasconcelos; Nuno,9999,0,9999,0
1653527763554,ECE 200,051,091053,Wang; Xiaolong,9999,0,9999,0
1653527763554,ECE 200,052,091054,Xie; Pengtao,9999,0,9999,0
1653527763554,ECE 200,053,091055,Yip; Michael,9999,0,9999,0
1653527763554,ECE 200,054,091056,Zeger; Kenneth A.,9999,0,9999,0
1653527763554,ECE 200,055,091057,Zhang; Xinyu,9999,0,9999,0
1653527763554,ECE 200,056,091058,Turakhia; Yatish Girish,9999,0,9999,0
1653527763554,ECE 200,057,091059,Kang; Mingu,9999,0,9999,0
1653527763554,ECE 200,058,091060,Shi; Yuanyuan,9999,0,9999,0
1653527763554,ECE 200,059,091061,Wang; Edward Jay,9999,0,9999,0
1653527763554,ECE 200,060,091062,Zheng; Yang,9999,0,9999,0
1653527764076,ECE 201,A00,095526,Lo; Yu-Hwa,0,0,0,0
1653527764604,ECE 203,A00,091065,Mercier; Patrick Philip,0,0,0,0
1653527765127,ECE 207A,A00,091605,Liu; Thomas Tao-Ming,0,0,0,0
1653527765659,ECE 212AN,A00,091068,Nomura; Kenji,0,0,0,0
1653527766184,ECE 222A,A00,091069,Rebeiz; Gabriel,0,0,0,0
1653527766710,ECE 225A,A00,091070,Orlitsky; Alon,0,0,0,0
1653527767232,ECE 230A,A00,091071,Nomura; Kenji,0,0,0,0
1653527767756,ECE 236A,A00,091072,Dayeh; Shadi Ahmad,0,0,0,0
1653527768284,ECE 238A,A00,091073,Luo; Jian,0,0,0,0
1653527768284,ECE 238A,B00,091074,Luo; Jian,0,0,0,0
1653527768807,ECE 240A,A00,091075,Radic; Stojan,0,0,0,0
1653527769329,ECE 247A,A00,091592,Shi; Lingyan,0,0,0,0
1653527769852,ECE 250,A00,091076,Touri; Behrouz,0,0,0,0
1653527770379,ECE 251C,A00,091078,Nguyen; Truong Quang,0,0,0,0
1653527770906,ECE 253,A00,091079,Cosman; Pamela C.,0,0,0,0
1653527771434,ECE 255A,A00,091080,Orlitsky; Alon,0,0,0,0
1653527771973,ECE 257A,A00,091081,Zhang; Xinyu,0,0,0,0
1653527772506,ECE 260A,A01,091084,Eldon; John,0,0,0,0
1653527773029,ECE 264C,A00,091085,Galton; Ian A,0,0,0,0
1653527773559,ECE 265C,A00,094889,Presti; Calogero Davide,0,0,0,9
1653527774084,ECE 266,A01,091087,Hall; Drew A.,0,0,0,0
1653527775129,ECE 271A,A00,091090,Vasconcelos; Nuno,0,0,0,0
1653527775654,ECE 272B,A00,091091,Sworder; David D.,0,0,0,0
1653527776177,ECE 275A,A00,091092,Meyer; Florian,0,0,0,0
1653527776703,ECE 277,A00,091093,An; Cheolhong,0,0,0,0
1653527777229,ECE 283,A00,091094,Le; Hanh-Phuc,0,0,0,0
1653527777757,ECE 284,A00,091095,Kang; Mingu,0,0,0,0
1653527777757,ECE 284,B00,091096,Wang; Edward Jay,0,0,0,0
1653527778284,ECE 285,A00,094334,Touri; Behrouz,0,0,0,0
1653527778810,ECE 289,A00,091097,Whelan; David Arthur,0,0,0,0
1653527779337,MATH 200A,A00,087414,Salehi Golsefidy; Alireza,7,0,8,1
1653527779860,MATH 202A,A00,087415,Gill; Philip E.,2,0,8,6
1653527780382,MATH 203A,A00,087416,Oprea; Dragos N.,6,0,8,2
1653527780907,MATH 204A,A00,087417,Kedlaya; Kiran S.,6,0,8,2
1653527781434,MATH 205,A00,087418,Sorensen; Claus M,6,0,8,2
1653527781974,MATH 206A,A00,087419,Izadi; Elham,7,0,8,1
1653527782510,MATH 207A,A00,087420,Mohammadi; Amir,5,0,8,3
1653527783031,MATH 208,A00,087421,Staff,9,0,10,1
1653527783554,MATH 209,A00,087422,Staff,10,0,10,0
1653527784076,MATH 218,A00,087423,Staff,10,0,10,0
1653527784606,MATH 220A,A00,087424,Novak; Jonathan I,7,0,8,1
1653527785132,MATH 231A,A00,087425,Bejenaru; Ioan,3,0,8,5
1653527785660,MATH 240A,A00,087426,Ebenfelt; Peter F,5,0,8,3
1653527786192,MATH 243,A00,087427,Staff,9,0,10,1
1653527786725,MATH 248,A00,087429,Staff,10,0,10,0
1653527787310,MATH 250A,A00,087430,Spolaor; Luca,4,0,8,4
1653527787836,MATH 257A,A00,087431,Spolaor; Luca,7,0,8,1
1653527788357,MATH 258,A00,087432,Staff,9,0,10,1
1653527788878,MATH 264A,A00,087433,Warnke; Lutz Peter,5,0,8,3
1653527789406,MATH 268,A00,087434,Staff,15,0,15,0
1653527789938,MATH 269,A00,087435,Staff,14,0,15,1
1653527790467,MATH 270A,A00,087436,Nie; Jiawang,0,0,8,8
1653527791003,MATH 272A,A00,087437,Tian; Xiaochuan,1,0,8,7
1653527791535,MATH 274,A01,087439,Cheng; Li-Tien,9,0,10,1
1653527791535,MATH 274,A02,087440,Cheng; Li-Tien,10,0,10,0
1653527792058,MATH 278A,A00,087441,Staff,8,0,10,2
1653527792580,MATH 278B,A00,087442,Staff,8,0,10,2
1653527793104,MATH 278C,A00,087443,Staff,8,0,10,2
1653527793626,MATH 280A,A00,087444,Zheng; Tianyi,0,0,8,8
1653527794155,MATH 281A,A00,087445,Bradic; Jelena,0,0,8,8
1653527794679,MATH 282A,A00,087446,Zhang; Danna,0,0,8,8
1653527795202,MATH 283,A00,087447,Tesler; Glenn,0,0,0,15
1653527795724,MATH 286,A00,087448,Kemp; Todd Aahron,5,0,8,3
1653527796319,MATH 287D,A00,087449,Bradic; Jelena,0,0,0,0
1653527796843,MATH 288,A00,087450,Staff,14,0,15,1
1653527796843,MATH 288,B00,087451,Staff,15,0,15,0
1653527796843,MATH 288,C00,087452,Staff,15,0,15,0
1653527797376,MATH 290A,A00,087453,Xu; Zhouli,6,0,8,2
1653527797900,MATH 291A,A00,087454,Xu; Zhouli,7,0,8,1
1653527798429,MATH 292,A00,087455,Staff,10,0,10,0
1653527798952,MATH 295,A00,087456,Staff,50,0,50,0
1653527799474,MATH 297,001,087457,Staff,998,0,999,1
1653528358943,COGS 200,A01,087991,Staff,47,0,50,3
1653528359475,COGS 201,A01,094504,Rangel; Lara M,17,0,25,8
1653528359998,COGS 203,A00,087992,Coulson; Seana M,18,0,20,2
1653528360531,COGS 210A,001,087993,Greene; Deanna Jacquelyn,9998,0,9999,1
1653528360531,COGS 210A,002,087994,Saygin; Ayse P,9999,0,9999,0
1653528360531,COGS 210A,003,087995,Xia; Haijun,9999,0,9999,0
1653528360531,COGS 210A,004,087996,Nitz; Douglas A.,9999,0,9999,0
1653528360531,COGS 210A,005,087997,Hollan; James D.,9999,0,9999,0
1653528360531,COGS 210A,006,087998,Deak; Gedeon O.,9998,0,9999,1
1653528360531,COGS 210A,007,087999,Rossano; Federico,9999,0,9999,0
1653528361052,COGS 211A,A00,088000,Coulson; Seana M,9997,0,9999,2
1653528361575,COGS 229,A00,088002,Staff,23,0,25,2
1653528362100,COGS 260,B00,094231,Staff,17,0,20,3
1653528362100,COGS 260,A00,088004,Nitz; Douglas A.,9998,0,9999,1
1653528362631,CSE 202,A00,090110,Paturi; Ramamohan,0,0,0,0
1653528362631,CSE 202,B00,090111,Paturi; Ramamohan,0,0,0,0
1653528363163,CSE 207B,A00,090112,Heninger; Nadia A,0,0,0,0
1653528363687,CSE 208,A00,094858,Micciancio; Daniele,0,0,0,0
1653528364209,CSE 210,A00,090113,Powell; Thomas Allan,0,0,0,0
1653528364746,CSE 219,A00,090898,Staff,0,0,0,0
1653528365269,CSE 221,A00,090114,Zhou; Yuan-Yuan,0,0,0,0
1653528365792,CSE 229A,A00,090115,Porter; George M,0,0,0,0
1653528366321,CSE 229C,A00,090116,Savage; Stefan,0,0,0,0
1653528366845,CSE 230,A00,090117,Jhala; Ranjit,0,0,0,0
1653528367367,CSE 232,A00,090118,Papakonstantinou; Yannis,0,0,0,0
1653528367900,CSE 239A,A00,090121,Kumar; Arun Kumar,0,0,0,0
1653528368422,CSE 239B,A00,090122,Jhala; Ranjit,0,0,0,0
1653528368944,CSE 240A,A00,090123,Zhao; Jishen,0,0,189,189
1653528369472,CSE 243A,A00,090124,Orailoglu; Alex,0,0,15,15
1653528369998,CSE 249B,A00,090125,Kahng; Andrew Byun,13,0,20,7
1653528370520,CSE 250A,A00,090126,Berg-Kirkpatrick; Taylor D,0,0,0,0
1653528371047,CSE 252A,A00,090127,Ochoa; Benjamin Lawrence,0,0,0,0
1653528371570,CSE 258,A01,090129,McAuley; Julian John,0,0,0,0
1653528372092,CSE 258R,A01,090131,McAuley; Julian John,0,0,0,0
1653528372618,CSE 274,A00,090132,Ramamoorthi; Ravi,0,0,0,0
1653528373141,CSE 276A,A00,090133,Christensen; Henrik I,0,0,0,0
1653528373664,CSE 276C,A00,090134,Christensen; Henrik I,0,0,0,0
1653528374189,CSE 290,A00,090135,Bafna; Vineet,0,0,0,0
1653528374189,CSE 290,B00,090136,Ramamoorthi; Ravi,0,0,0,0
1653528374189,CSE 290,C00,090137,Li; Tzumao,8,0,10,2
1653528374189,CSE 290,D00,090138,Zhou; Yuan-Yuan,9,0,10,1
1653528374189,CSE 290,E00,090139,Christensen; Henrik I,9,0,10,1
1653528374189,CSE 290,F00,094053,Shalev; Aaron D,0,0,0,0
1653528374713,CSE 291,A00,090140,Munyaka; Imani N. S.,0,0,0,0
1653528374713,CSE 291,B00,094880,Yu; Qi,0,0,0,0
1653528374713,CSE 291,C00,090142,Pannuto; Patrick William,0,0,0,0
1653528374713,CSE 291,D00,094881,Zhang; Yiying,0,0,0,0
1653528374713,CSE 291,E00,095118,Su; Hao,0,0,0,0
1653528375237,CSE 293,001,094905,Bafna; Vineet,9999,0,9999,0
1653528375237,CSE 293,002,094906,Bellare; Mihir,9999,0,9999,0
1653528375237,CSE 293,003,094907,Berg-Kirkpatrick; Taylor D,9999,0,9999,0
1653528375237,CSE 293,004,094908,Christensen; Henrik I,9999,0,9999,0
1653528375237,CSE 293,005,094909,Cottrell; Garrison W,9999,0,9999,0
1653528375237,CSE 293,006,094910,Deutsch; Alin Bernard,9999,0,9999,0
1653528375237,CSE 293,007,094911,Esmaeilzadeh; Hadi,9999,0,9999,0
1653528375237,CSE 293,008,094912,Freund; Yoav,9999,0,9999,0
1653528375237,CSE 293,009,094913,Griswold; William G.,9999,0,9999,0
1653528375237,CSE 293,010,094914,Gymrek; Melissa Ann,9999,0,9999,0
1653528375237,CSE 293,011,094915,Heninger; Nadia A,9999,0,9999,0
1653528375237,CSE 293,012,094916,Impagliazzo; Russell,9999,0,9999,0
1653528375237,CSE 293,013,094917,Jhala; Ranjit,9999,0,9999,0
1653528375237,CSE 293,014,094918,Kahng; Andrew Byun,9999,0,9999,0
1653528375237,CSE 293,015,094919,Kane; Daniel Mertz,9999,0,9999,0
1653528375237,CSE 293,016,094920,Kriegman; David J,9999,0,9999,0
1653528375237,CSE 293,017,094921,Kumar; Arun Kumar,9999,0,9999,0
1653528375237,CSE 293,018,094922,Lerner; Sorin,9999,0,9999,0
1653528375237,CSE 293,019,094923,Lovett; Shachar,9999,0,9999,0
1653528375237,CSE 293,020,094924,McAuley; Julian John,9999,0,9999,0
1653528375237,CSE 293,021,094925,Micciancio; Daniele,9999,0,9999,0
1653528375237,CSE 293,022,094926,Orailoglu; Alex,9999,0,9999,0
1653528375237,CSE 293,023,094927,Paturi; Ramamohan,9999,0,9999,0
1653528375237,CSE 293,024,094928,Polikarpova; Nadezhda,9999,0,9999,0
1653528375237,CSE 293,025,094929,Politz; Joseph Gibbs,9999,0,9999,0
1653528375237,CSE 293,026,094930,Porter; George M,9999,0,9999,0
1653528375237,CSE 293,027,094931,Porter; Leonard Emerson,9999,0,9999,0
1653528375237,CSE 293,028,094932,Ramamoorthi; Ravi,9999,0,9999,0
1653528375237,CSE 293,029,094933,Sahoo; Debashis,9999,0,9999,0
1653528375237,CSE 293,030,094934,Saul; Lawrence,9999,0,9999,0
1653528375237,CSE 293,031,094935,Savage; Stefan,9999,0,9999,0
1653528375237,CSE 293,032,094936,Schulze; Jurgen P.,9999,0,9999,0
1653528375237,CSE 293,033,094937,Snoeren; Alex C.,9999,0,9999,0
1653528375237,CSE 293,034,094938,Shang; Jingbo,9999,0,9999,0
1653528375237,CSE 293,035,094939,Stefan; Deian,9999,0,9999,0
1653528375237,CSE 293,036,094940,Su; Hao,9999,0,9999,0
1653528375237,CSE 293,037,094941,Swanson; Steven James,9999,0,9999,0
1653528375237,CSE 293,038,094942,Tullsen; Dean Michael,9999,0,9999,0
1653528375237,CSE 293,039,094943,Voelker; Geoffrey M.,9999,0,9999,0
1653528375237,CSE 293,040,094944,Zhao; Jishen,9999,0,9999,0
1653528375237,CSE 293,041,094945,Zhou; Yuan-Yuan,9999,0,9999,0
1653528375237,CSE 293,042,094946,Gao; Sicun,9998,0,9999,1
1653528375237,CSE 293,043,094947,Weibel; Nadir,9999,0,9999,0
1653528375237,CSE 293,044,094948,Gupta; Rajesh K.,9999,0,9999,0
1653528375772,CSE 294,A00,090143,Porter; George M,8,0,10,2
1653528376294,DSE 200,A00,091799,Staff,50,0,50,0
1653528376818,DSE 203,A00,091800,Gupta; Amarnath,30,0,30,0
1653528377340,DSE 250,A00,091801,Deutsch; Alin Bernard,30,0,30,0
1653528377863,DSE 290,A00,091802,Altintas De Callaf; Ilkay,50,0,50,0
1653528378426,ECE 200,001,091003,Antipa; Nicholas A,9999,0,9999,0
1653528378426,ECE 200,002,091004,Atanasov; Nikolay A.,9999,0,9999,0
1653528378426,ECE 200,003,091005,Bharadia; Dinesh,9999,0,9999,0
1653528378426,ECE 200,004,091006,Cheng; Chung Kuan,9999,0,9999,0
1653528378426,ECE 200,005,091007,Cosman; Pamela C.,9999,0,9999,0
1653528378426,ECE 200,006,091008,Staff,9999,0,9999,0
1653528378426,ECE 200,007,091009,Dayeh; Shadi Ahmad,9999,0,9999,0
1653528378426,ECE 200,008,091010,Fainman; Yeshaiahu,9999,0,9999,0
1653528378426,ECE 200,009,091011,Ford; Joseph Earl,9999,0,9999,0
1653528378426,ECE 200,010,091012,Franceschetti; Massimo,9999,0,9999,0
1653528378426,ECE 200,011,091013,Fullerton; Eric E,9999,0,9999,0
1653528378426,ECE 200,012,091014,Galton; Ian A,9999,0,9999,0
1653528378426,ECE 200,013,091015,Gilja; Vikash,9999,0,9999,0
1653528378426,ECE 200,014,091016,Hall; Drew A.,9999,0,9999,0
1653528378426,ECE 200,015,091017,Hsueh; Tzu-Chien,9999,0,9999,0
1653528378426,ECE 200,016,091018,Javidi; Tara,9999,0,9999,0
1653528378426,ECE 200,017,091019,Kahng; Andrew Byun,9999,0,9999,0
1653528378426,ECE 200,018,091020,Kim; Young-Han,9999,0,9999,0
1653528378426,ECE 200,019,091021,Koushanfar; Farinaz,9999,0,9999,0
1653528378426,ECE 200,020,091022,Kuzum; Duygu,9999,0,9999,0
1653528378426,ECE 200,021,091023,Le; Hanh-Phuc,9999,0,9999,0
1653528378426,ECE 200,022,091024,Lin; Bill,9999,0,9999,0
1653528378426,ECE 200,023,091025,Liu; Zhaowei,9999,0,9999,0
1653528378426,ECE 200,024,091026,Lo; Yu-Hwa,9999,0,9999,0
1653528378426,ECE 200,025,091027,Lomakin; Vitaliy,9999,0,9999,0
1653528378426,ECE 200,026,091028,Mercier; Patrick Philip,9999,0,9999,0
1653528378426,ECE 200,027,091029,Meyer; Florian,9999,0,9999,0
1653528378426,ECE 200,028,091030,Milstein; Laurence B.,9999,0,9999,0
1653528378426,ECE 200,029,091031,Mir Arabbaygi; Siavash,9999,0,9999,0
1653528378426,ECE 200,030,091032,Mookherjea; Shayan,9999,0,9999,0
1653528378426,ECE 200,031,091033,Morris; Karcher William,9999,0,9999,0
1653528378426,ECE 200,032,091034,Ng; Tse Nga,9999,0,9999,0
1653528378426,ECE 200,033,091035,Nguyen; Truong Quang,9999,0,9999,0
1653528378426,ECE 200,034,091036,Nomura; Kenji,9999,0,9999,0
1653528378426,ECE 200,035,091037,Orlitsky; Alon,9999,0,9999,0
1653528378426,ECE 200,036,091038,Pal; Piya,9999,0,9999,0
1653528378426,ECE 200,037,091039,Papen; George C.,9999,0,9999,0
1653528378426,ECE 200,038,091040,Radic; Stojan,9999,0,9999,0
1653528378426,ECE 200,039,091041,Rao; Bhaskar D.,9999,0,9999,0
1653528378426,ECE 200,040,091042,Rao; Ramesh R,9999,0,9999,0
1653528378426,ECE 200,041,091043,Rebeiz; Gabriel,9999,0,9999,0
1653528378426,ECE 200,042,091044,Sanford; John R,9999,0,9999,0
1653528378426,ECE 200,043,091045,Siegel; Paul H.,9999,0,9999,0
1653528378426,ECE 200,044,091046,Sievenpiper; Daniel F.,9999,0,9999,0
1653528378426,ECE 200,045,091047,Sworder; David D.,9999,0,9999,0
1653528378426,ECE 200,046,091048,Taur; Yuan,9999,0,9999,0
1653528378426,ECE 200,047,091049,Touri; Behrouz,9999,0,9999,0
1653528378426,ECE 200,048,091050,Trivedi; Mohan M.,9999,0,9999,0
1653528378426,ECE 200,049,091051,Vardy; Alexander,9999,0,9999,0
1653528378426,ECE 200,050,091052,Vasconcelos; Nuno,9999,0,9999,0
1653528378426,ECE 200,051,091053,Wang; Xiaolong,9999,0,9999,0
1653528378426,ECE 200,052,091054,Xie; Pengtao,9999,0,9999,0
1653528378426,ECE 200,053,091055,Yip; Michael,9999,0,9999,0
1653528378426,ECE 200,054,091056,Zeger; Kenneth A.,9999,0,9999,0
1653528378426,ECE 200,055,091057,Zhang; Xinyu,9999,0,9999,0
1653528378426,ECE 200,056,091058,Turakhia; Yatish Girish,9999,0,9999,0
1653528378426,ECE 200,057,091059,Kang; Mingu,9999,0,9999,0
1653528378426,ECE 200,058,091060,Shi; Yuanyuan,9999,0,9999,0
1653528378426,ECE 200,059,091061,Wang; Edward Jay,9999,0,9999,0
1653528378426,ECE 200,060,091062,Zheng; Yang,9999,0,9999,0
1653528378959,ECE 201,A00,095526,Lo; Yu-Hwa,0,0,0,0
1653528379482,ECE 203,A00,091065,Mercier; Patrick Philip,0,0,0,0
1653528380004,ECE 207A,A00,091605,Liu; Thomas Tao-Ming,0,0,0,0
1653528380529,ECE 212AN,A00,091068,Nomura; Kenji,0,0,0,0
1653528381057,ECE 222A,A00,091069,Rebeiz; Gabriel,0,0,0,0
1653528381579,ECE 225A,A00,091070,Orlitsky; Alon,0,0,0,0
1653528382100,ECE 230A,A00,091071,Nomura; Kenji,0,0,0,0
1653528382626,ECE 236A,A00,091072,Dayeh; Shadi Ahmad,0,0,0,0
1653528383260,ECE 238A,A00,091073,Luo; Jian,0,0,0,0
1653528383260,ECE 238A,B00,091074,Luo; Jian,0,0,0,0
1653528383785,ECE 240A,A00,091075,Radic; Stojan,0,0,0,0
1653528384308,ECE 247A,A00,091592,Shi; Lingyan,0,0,0,0
1653528384841,ECE 250,A00,091076,Touri; Behrouz,0,0,0,0
1653528385370,ECE 251C,A00,091078,Nguyen; Truong Quang,0,0,0,0
1653528385892,ECE 253,A00,091079,Cosman; Pamela C.,0,0,0,0
1653528386417,ECE 255A,A00,091080,Orlitsky; Alon,0,0,0,0
1653528386945,ECE 257A,A00,091081,Zhang; Xinyu,0,0,0,0
1653528387469,ECE 260A,A01,091084,Eldon; John,0,0,0,0
1653528387991,ECE 264C,A00,091085,Galton; Ian A,0,0,0,0
1653528388513,ECE 265C,A00,094889,Presti; Calogero Davide,0,0,0,9
1653528389043,ECE 266,A01,091087,Hall; Drew A.,0,0,0,0
1653528390159,ECE 271A,A00,091090,Vasconcelos; Nuno,0,0,0,0
1653528390682,ECE 272B,A00,091091,Sworder; David D.,0,0,0,0
1653528391208,ECE 275A,A00,091092,Meyer; Florian,0,0,0,0
1653528391749,ECE 277,A00,091093,An; Cheolhong,0,0,0,0
1653528392271,ECE 283,A00,091094,Le; Hanh-Phuc,0,0,0,0
1653528392800,ECE 284,A00,091095,Kang; Mingu,0,0,0,0
1653528392800,ECE 284,B00,091096,Wang; Edward Jay,0,0,0,0
1653528393330,ECE 285,A00,094334,Touri; Behrouz,0,0,0,0
1653528393854,ECE 289,A00,091097,Whelan; David Arthur,0,0,0,0
1653528394384,MATH 200A,A00,087414,Salehi Golsefidy; Alireza,7,0,8,1
1653528394916,MATH 202A,A00,087415,Gill; Philip E.,2,0,8,6
1653528395445,MATH 203A,A00,087416,Oprea; Dragos N.,6,0,8,2
1653528395968,MATH 204A,A00,087417,Kedlaya; Kiran S.,6,0,8,2
1653528396492,MATH 205,A00,087418,Sorensen; Claus M,6,0,8,2
1653528397015,MATH 206A,A00,087419,Izadi; Elham,7,0,8,1
1653528397546,MATH 207A,A00,087420,Mohammadi; Amir,5,0,8,3
1653528398068,MATH 208,A00,087421,Staff,9,0,10,1
1653528398594,MATH 209,A00,087422,Staff,10,0,10,0
1653528399116,MATH 218,A00,087423,Staff,10,0,10,0
1653528399646,MATH 220A,A00,087424,Novak; Jonathan I,7,0,8,1
1653528400173,MATH 231A,A00,087425,Bejenaru; Ioan,3,0,8,5
1653528400698,MATH 240A,A00,087426,Ebenfelt; Peter F,5,0,8,3
1653528401224,MATH 243,A00,087427,Staff,9,0,10,1
1653528401747,MATH 248,A00,087429,Staff,10,0,10,0
1653528402271,MATH 250A,A00,087430,Spolaor; Luca,4,0,8,4
1653528402794,MATH 257A,A00,087431,Spolaor; Luca,7,0,8,1
1653528403327,MATH 258,A00,087432,Staff,9,0,10,1
1653528403850,MATH 264A,A00,087433,Warnke; Lutz Peter,5,0,8,3
1653528404372,MATH 268,A00,087434,Staff,15,0,15,0
1653528404901,MATH 269,A00,087435,Staff,14,0,15,1
1653528405424,MATH 270A,A00,087436,Nie; Jiawang,0,0,8,8
1653528405946,MATH 272A,A00,087437,Tian; Xiaochuan,1,0,8,7
1653528406469,MATH 274,A01,087439,Cheng; Li-Tien,9,0,10,1
1653528406469,MATH 274,A02,087440,Cheng; Li-Tien,10,0,10,0
1653528406992,MATH 278A,A00,087441,Staff,8,0,10,2
1653528407516,MATH 278B,A00,087442,Staff,8,0,10,2
1653528408039,MATH 278C,A00,087443,Staff,8,0,10,2
1653528408562,MATH 280A,A00,087444,Zheng; Tianyi,0,0,8,8
1653528409085,MATH 281A,A00,087445,Bradic; Jelena,0,0,8,8
1653528409611,MATH 282A,A00,087446,Zhang; Danna,0,0,8,8
1653528410134,MATH 283,A00,087447,Tesler; Glenn,0,0,0,15
1653528410658,MATH 286,A00,087448,Kemp; Todd Aahron,5,0,8,3
1653528411184,MATH 287D,A00,087449,Bradic; Jelena,0,0,0,0
1653528411709,MATH 288,A00,087450,Staff,14,0,15,1
1653528411709,MATH 288,B00,087451,Staff,15,0,15,0
1653528411709,MATH 288,C00,087452,Staff,15,0,15,0
1653528412235,MATH 290A,A00,087453,Xu; Zhouli,6,0,8,2
1653528412758,MATH 291A,A00,087454,Xu; Zhouli,7,0,8,1
1653528413285,MATH 292,A00,087455,Staff,10,0,10,0
1653528413813,MATH 295,A00,087456,Staff,50,0,50,0
1653528414336,MATH 297,001,087457,Staff,998,0,999,1
1653528973706,COGS 200,A01,087991,Staff,47,0,50,3
1653528974235,COGS 201,A01,094504,Rangel; Lara M,17,0,25,8
1653528974761,COGS 203,A00,087992,Coulson; Seana M,18,0,20,2
1653528975287,COGS 210A,001,087993,Greene; Deanna Jacquelyn,9998,0,9999,1
1653528975287,COGS 210A,002,087994,Saygin; Ayse P,9999,0,9999,0
1653528975287,COGS 210A,003,087995,Xia; Haijun,9999,0,9999,0
1653528975287,COGS 210A,004,087996,Nitz; Douglas A.,9999,0,9999,0
1653528975287,COGS 210A,005,087997,Hollan; James D.,9999,0,9999,0
1653528975287,COGS 210A,006,087998,Deak; Gedeon O.,9998,0,9999,1
1653528975287,COGS 210A,007,087999,Rossano; Federico,9999,0,9999,0
1653528975814,COGS 211A,A00,088000,Coulson; Seana M,9997,0,9999,2
1653528976339,COGS 229,A00,088002,Staff,23,0,25,2
1653528976864,COGS 260,B00,094231,Staff,17,0,20,3
1653528976864,COGS 260,A00,088004,Nitz; Douglas A.,9998,0,9999,1
1653528977391,CSE 202,A00,090110,Paturi; Ramamohan,0,0,0,0
1653528977391,CSE 202,B00,090111,Paturi; Ramamohan,0,0,0,0
1653528977914,CSE 207B,A00,090112,Heninger; Nadia A,0,0,0,0
1653528978442,CSE 208,A00,094858,Micciancio; Daniele,0,0,0,0
1653528978965,CSE 210,A00,090113,Powell; Thomas Allan,0,0,0,0
1653528979488,CSE 219,A00,090898,Staff,0,0,0,0
1653528980012,CSE 221,A00,090114,Zhou; Yuan-Yuan,0,0,0,0
1653528980536,CSE 229A,A00,090115,Porter; George M,0,0,0,0
1653528981061,CSE 229C,A00,090116,Savage; Stefan,0,0,0,0
1653528981583,CSE 230,A00,090117,Jhala; Ranjit,0,0,0,0
1653528982108,CSE 232,A00,090118,Papakonstantinou; Yannis,0,0,0,0
1653528982638,CSE 239A,A00,090121,Kumar; Arun Kumar,0,0,0,0
1653528983170,CSE 239B,A00,090122,Jhala; Ranjit,0,0,0,0
1653528983694,CSE 240A,A00,090123,Zhao; Jishen,0,0,189,189
1653528984215,CSE 243A,A00,090124,Orailoglu; Alex,0,0,15,15
1653528984801,CSE 249B,A00,090125,Kahng; Andrew Byun,13,0,20,7
1653528985326,CSE 250A,A00,090126,Berg-Kirkpatrick; Taylor D,0,0,0,0
1653528985849,CSE 252A,A00,090127,Ochoa; Benjamin Lawrence,0,0,0,0
1653528986372,CSE 258,A01,090129,McAuley; Julian John,0,0,0,0
1653528986894,CSE 258R,A01,090131,McAuley; Julian John,0,0,0,0
1653528987419,CSE 274,A00,090132,Ramamoorthi; Ravi,0,0,0,0
1653528987945,CSE 276A,A00,090133,Christensen; Henrik I,0,0,0,0
1653528988467,CSE 276C,A00,090134,Christensen; Henrik I,0,0,0,0
1653528988994,CSE 290,A00,090135,Bafna; Vineet,0,0,0,0
1653528988994,CSE 290,B00,090136,Ramamoorthi; Ravi,0,0,0,0
1653528988994,CSE 290,C00,090137,Li; Tzumao,8,0,10,2
1653528988994,CSE 290,D00,090138,Zhou; Yuan-Yuan,9,0,10,1
1653528988994,CSE 290,E00,090139,Christensen; Henrik I,9,0,10,1
1653528988994,CSE 290,F00,094053,Shalev; Aaron D,0,0,0,0
1653528989517,CSE 291,A00,090140,Munyaka; Imani N. S.,0,0,0,0
1653528989517,CSE 291,B00,094880,Yu; Qi,0,0,0,0
1653528989517,CSE 291,C00,090142,Pannuto; Patrick William,0,0,0,0
1653528989517,CSE 291,D00,094881,Zhang; Yiying,0,0,0,0
1653528989517,CSE 291,E00,095118,Su; Hao,0,0,0,0
1653528990043,CSE 293,001,094905,Bafna; Vineet,9999,0,9999,0
1653528990043,CSE 293,002,094906,Bellare; Mihir,9999,0,9999,0
1653528990043,CSE 293,003,094907,Berg-Kirkpatrick; Taylor D,9999,0,9999,0
1653528990043,CSE 293,004,094908,Christensen; Henrik I,9999,0,9999,0
1653528990043,CSE 293,005,094909,Cottrell; Garrison W,9999,0,9999,0
1653528990043,CSE 293,006,094910,Deutsch; Alin Bernard,9999,0,9999,0
1653528990043,CSE 293,007,094911,Esmaeilzadeh; Hadi,9999,0,9999,0
1653528990043,CSE 293,008,094912,Freund; Yoav,9999,0,9999,0
1653528990043,CSE 293,009,094913,Griswold; William G.,9999,0,9999,0
1653528990043,CSE 293,010,094914,Gymrek; Melissa Ann,9999,0,9999,0
1653528990043,CSE 293,011,094915,Heninger; Nadia A,9999,0,9999,0
1653528990043,CSE 293,012,094916,Impagliazzo; Russell,9999,0,9999,0
1653528990043,CSE 293,013,094917,Jhala; Ranjit,9999,0,9999,0
1653528990043,CSE 293,014,094918,Kahng; Andrew Byun,9999,0,9999,0
1653528990043,CSE 293,015,094919,Kane; Daniel Mertz,9999,0,9999,0
1653528990043,CSE 293,016,094920,Kriegman; David J,9999,0,9999,0
1653528990043,CSE 293,017,094921,Kumar; Arun Kumar,9999,0,9999,0
1653528990043,CSE 293,018,094922,Lerner; Sorin,9999,0,9999,0
1653528990043,CSE 293,019,094923,Lovett; Shachar,9999,0,9999,0
1653528990043,CSE 293,020,094924,McAuley; Julian John,9999,0,9999,0
1653528990043,CSE 293,021,094925,Micciancio; Daniele,9999,0,9999,0
1653528990043,CSE 293,022,094926,Orailoglu; Alex,9999,0,9999,0
1653528990043,CSE 293,023,094927,Paturi; Ramamohan,9999,0,9999,0
1653528990043,CSE 293,024,094928,Polikarpova; Nadezhda,9999,0,9999,0
1653528990043,CSE 293,025,094929,Politz; Joseph Gibbs,9999,0,9999,0
1653528990043,CSE 293,026,094930,Porter; George M,9999,0,9999,0
1653528990043,CSE 293,027,094931,Porter; Leonard Emerson,9999,0,9999,0
1653528990043,CSE 293,028,094932,Ramamoorthi; Ravi,9999,0,9999,0
1653528990043,CSE 293,029,094933,Sahoo; Debashis,9999,0,9999,0
1653528990043,CSE 293,030,094934,Saul; Lawrence,9999,0,9999,0
1653528990043,CSE 293,031,094935,Savage; Stefan,9999,0,9999,0
1653528990043,CSE 293,032,094936,Schulze; Jurgen P.,9999,0,9999,0
1653528990043,CSE 293,033,094937,Snoeren; Alex C.,9999,0,9999,0
1653528990043,CSE 293,034,094938,Shang; Jingbo,9999,0,9999,0
1653528990043,CSE 293,035,094939,Stefan; Deian,9999,0,9999,0
1653528990043,CSE 293,036,094940,Su; Hao,9999,0,9999,0
1653528990043,CSE 293,037,094941,Swanson; Steven James,9999,0,9999,0
1653528990043,CSE 293,038,094942,Tullsen; Dean Michael,9999,0,9999,0
1653528990043,CSE 293,039,094943,Voelker; Geoffrey M.,9999,0,9999,0
1653528990043,CSE 293,040,094944,Zhao; Jishen,9999,0,9999,0
1653528990043,CSE 293,041,094945,Zhou; Yuan-Yuan,9999,0,9999,0
1653528990043,CSE 293,042,094946,Gao; Sicun,9998,0,9999,1
1653528990043,CSE 293,043,094947,Weibel; Nadir,9999,0,9999,0
1653528990043,CSE 293,044,094948,Gupta; Rajesh K.,9999,0,9999,0
1653528990567,CSE 294,A00,090143,Porter; George M,8,0,10,2
1653528991091,DSE 200,A00,091799,Staff,50,0,50,0
1653528991615,DSE 203,A00,091800,Gupta; Amarnath,30,0,30,0
1653528992139,DSE 250,A00,091801,Deutsch; Alin Bernard,30,0,30,0
1653528992679,DSE 290,A00,091802,Altintas De Callaf; Ilkay,50,0,50,0
1653528993216,ECE 200,001,091003,Antipa; Nicholas A,9999,0,9999,0
1653528993216,ECE 200,002,091004,Atanasov; Nikolay A.,9999,0,9999,0
1653528993216,ECE 200,003,091005,Bharadia; Dinesh,9999,0,9999,0
1653528993216,ECE 200,004,091006,Cheng; Chung Kuan,9999,0,9999,0
1653528993216,ECE 200,005,091007,Cosman; Pamela C.,9999,0,9999,0
1653528993216,ECE 200,006,091008,Staff,9999,0,9999,0
1653528993216,ECE 200,007,091009,Dayeh; Shadi Ahmad,9999,0,9999,0
1653528993216,ECE 200,008,091010,Fainman; Yeshaiahu,9999,0,9999,0
1653528993216,ECE 200,009,091011,Ford; Joseph Earl,9999,0,9999,0
1653528993216,ECE 200,010,091012,Franceschetti; Massimo,9999,0,9999,0
1653528993216,ECE 200,011,091013,Fullerton; Eric E,9999,0,9999,0
1653528993216,ECE 200,012,091014,Galton; Ian A,9999,0,9999,0
1653528993216,ECE 200,013,091015,Gilja; Vikash,9999,0,9999,0
1653528993216,ECE 200,014,091016,Hall; Drew A.,9999,0,9999,0
1653528993216,ECE 200,015,091017,Hsueh; Tzu-Chien,9999,0,9999,0
1653528993216,ECE 200,016,091018,Javidi; Tara,9999,0,9999,0
1653528993216,ECE 200,017,091019,Kahng; Andrew Byun,9999,0,9999,0
1653528993216,ECE 200,018,091020,Kim; Young-Han,9999,0,9999,0
1653528993216,ECE 200,019,091021,Koushanfar; Farinaz,9999,0,9999,0
1653528993216,ECE 200,020,091022,Kuzum; Duygu,9999,0,9999,0
1653528993216,ECE 200,021,091023,Le; Hanh-Phuc,9999,0,9999,0
1653528993216,ECE 200,022,091024,Lin; Bill,9999,0,9999,0
1653528993216,ECE 200,023,091025,Liu; Zhaowei,9999,0,9999,0
1653528993216,ECE 200,024,091026,Lo; Yu-Hwa,9999,0,9999,0
1653528993216,ECE 200,025,091027,Lomakin; Vitaliy,9999,0,9999,0
1653528993216,ECE 200,026,091028,Mercier; Patrick Philip,9999,0,9999,0
1653528993216,ECE 200,027,091029,Meyer; Florian,9999,0,9999,0
1653528993216,ECE 200,028,091030,Milstein; Laurence B.,9999,0,9999,0
1653528993216,ECE 200,029,091031,Mir Arabbaygi; Siavash,9999,0,9999,0
1653528993216,ECE 200,030,091032,Mookherjea; Shayan,9999,0,9999,0
1653528993216,ECE 200,031,091033,Morris; Karcher William,9999,0,9999,0
1653528993216,ECE 200,032,091034,Ng; Tse Nga,9999,0,9999,0
1653528993216,ECE 200,033,091035,Nguyen; Truong Quang,9999,0,9999,0
1653528993216,ECE 200,034,091036,Nomura; Kenji,9999,0,9999,0
1653528993216,ECE 200,035,091037,Orlitsky; Alon,9999,0,9999,0
1653528993216,ECE 200,036,091038,Pal; Piya,9999,0,9999,0
1653528993216,ECE 200,037,091039,Papen; George C.,9999,0,9999,0
1653528993216,ECE 200,038,091040,Radic; Stojan,9999,0,9999,0
1653528993216,ECE 200,039,091041,Rao; Bhaskar D.,9999,0,9999,0
1653528993216,ECE 200,040,091042,Rao; Ramesh R,9999,0,9999,0
1653528993216,ECE 200,041,091043,Rebeiz; Gabriel,9999,0,9999,0
1653528993216,ECE 200,042,091044,Sanford; John R,9999,0,9999,0
1653528993216,ECE 200,043,091045,Siegel; Paul H.,9999,0,9999,0
1653528993216,ECE 200,044,091046,Sievenpiper; Daniel F.,9999,0,9999,0
1653528993216,ECE 200,045,091047,Sworder; David D.,9999,0,9999,0
1653528993216,ECE 200,046,091048,Taur; Yuan,9999,0,9999,0
1653528993216,ECE 200,047,091049,Touri; Behrouz,9999,0,9999,0
1653528993216,ECE 200,048,091050,Trivedi; Mohan M.,9999,0,9999,0
1653528993216,ECE 200,049,091051,Vardy; Alexander,9999,0,9999,0
1653528993216,ECE 200,050,091052,Vasconcelos; Nuno,9999,0,9999,0
1653528993216,ECE 200,051,091053,Wang; Xiaolong,9999,0,9999,0
1653528993216,ECE 200,052,091054,Xie; Pengtao,9999,0,9999,0
1653528993216,ECE 200,053,091055,Yip; Michael,9999,0,9999,0
1653528993216,ECE 200,054,091056,Zeger; Kenneth A.,9999,0,9999,0
1653528993216,ECE 200,055,091057,Zhang; Xinyu,9999,0,9999,0
1653528993216,ECE 200,056,091058,Turakhia; Yatish Girish,9999,0,9999,0
1653528993216,ECE 200,057,091059,Kang; Mingu,9999,0,9999,0
1653528993216,ECE 200,058,091060,Shi; Yuanyuan,9999,0,9999,0
1653528993216,ECE 200,059,091061,Wang; Edward Jay,9999,0,9999,0
1653528993216,ECE 200,060,091062,Zheng; Yang,9999,0,9999,0
1653528993739,ECE 201,A00,095526,Lo; Yu-Hwa,0,0,0,0
1653528994265,ECE 203,A00,091065,Mercier; Patrick Philip,0,0,0,0
1653528994788,ECE 207A,A00,091605,Liu; Thomas Tao-Ming,0,0,0,0
1653528995310,ECE 212AN,A00,091068,Nomura; Kenji,0,0,0,0
1653528995835,ECE 222A,A00,091069,Rebeiz; Gabriel,0,0,0,0
1653528996358,ECE 225A,A00,091070,Orlitsky; Alon,0,0,0,0
1653528996880,ECE 230A,A00,091071,Nomura; Kenji,0,0,0,0
1653528997402,ECE 236A,A00,091072,Dayeh; Shadi Ahmad,0,0,0,0
1653528997924,ECE 238A,A00,091073,Luo; Jian,0,0,0,0
1653528997924,ECE 238A,B00,091074,Luo; Jian,0,0,0,0
1653528998449,ECE 240A,A00,091075,Radic; Stojan,0,0,0,0
1653528998974,ECE 247A,A00,091592,Shi; Lingyan,0,0,0,0
1653528999500,ECE 250,A00,091076,Touri; Behrouz,0,0,0,0
1653529000021,ECE 251C,A00,091078,Nguyen; Truong Quang,0,0,0,0
1653529000550,ECE 253,A00,091079,Cosman; Pamela C.,0,0,0,0
1653529001076,ECE 255A,A00,091080,Orlitsky; Alon,0,0,0,0
1653529001598,ECE 257A,A00,091081,Zhang; Xinyu,0,0,0,0
1653529002129,ECE 260A,A01,091084,Eldon; John,0,0,0,0
1653529002654,ECE 264C,A00,091085,Galton; Ian A,0,0,0,0
1653529003176,ECE 265C,A00,094889,Presti; Calogero Davide,0,0,0,9
1653529003699,ECE 266,A01,091087,Hall; Drew A.,0,0,0,0
1653529004745,ECE 271A,A00,091090,Vasconcelos; Nuno,0,0,0,0
1653529005272,ECE 272B,A00,091091,Sworder; David D.,0,0,0,0
1653529005797,ECE 275A,A00,091092,Meyer; Florian,0,0,0,0
1653529006330,ECE 277,A00,091093,An; Cheolhong,0,0,0,0
1653529006851,ECE 283,A00,091094,Le; Hanh-Phuc,0,0,0,0
1653529007377,ECE 284,A00,091095,Kang; Mingu,0,0,0,0
1653529007377,ECE 284,B00,091096,Wang; Edward Jay,0,0,0,0
1653529007900,ECE 285,A00,094334,Touri; Behrouz,0,0,0,0
1653529008423,ECE 289,A00,091097,Whelan; David Arthur,0,0,0,0
1653529008949,MATH 200A,A00,087414,Salehi Golsefidy; Alireza,7,0,8,1
1653529009473,MATH 202A,A00,087415,Gill; Philip E.,2,0,8,6
1653529009996,MATH 203A,A00,087416,Oprea; Dragos N.,6,0,8,2
1653529010518,MATH 204A,A00,087417,Kedlaya; Kiran S.,6,0,8,2
1653529011045,MATH 205,A00,087418,Sorensen; Claus M,6,0,8,2
1653529011567,MATH 206A,A00,087419,Izadi; Elham,7,0,8,1
1653529012092,MATH 207A,A00,087420,Mohammadi; Amir,5,0,8,3
1653529012614,MATH 208,A00,087421,Staff,9,0,10,1
1653529013143,MATH 209,A00,087422,Staff,10,0,10,0
1653529013671,MATH 218,A00,087423,Staff,10,0,10,0
1653529014193,MATH 220A,A00,087424,Novak; Jonathan I,7,0,8,1
1653529014721,MATH 231A,A00,087425,Bejenaru; Ioan,3,0,8,5
1653529015247,MATH 240A,A00,087426,Ebenfelt; Peter F,5,0,8,3
1653529015775,MATH 243,A00,087427,Staff,9,0,10,1
1653529016317,MATH 248,A00,087429,Staff,10,0,10,0
1653529016843,MATH 250A,A00,087430,Spolaor; Luca,4,0,8,4
1653529017371,MATH 257A,A00,087431,Spolaor; Luca,7,0,8,1
1653529017892,MATH 258,A00,087432,Staff,9,0,10,1
1653529018415,MATH 264A,A00,087433,Warnke; Lutz Peter,5,0,8,3
1653529018942,MATH 268,A00,087434,Staff,15,0,15,0
1653529019465,MATH 269,A00,087435,Staff,14,0,15,1
1653529019991,MATH 270A,A00,087436,Nie; Jiawang,0,0,8,8
1653529020514,MATH 272A,A00,087437,Tian; Xiaochuan,1,0,8,7
1653529021040,MATH 274,A01,087439,Cheng; Li-Tien,9,0,10,1
1653529021040,MATH 274,A02,087440,Cheng; Li-Tien,10,0,10,0
1653529021566,MATH 278A,A00,087441,Staff,8,0,10,2
1653529022090,MATH 278B,A00,087442,Staff,8,0,10,2
1653529022628,MATH 278C,A00,087443,Staff,8,0,10,2
1653529023240,MATH 280A,A00,087444,Zheng; Tianyi,0,0,8,8
1653529023763,MATH 281A,A00,087445,Bradic; Jelena,0,0,8,8
1653529024289,MATH 282A,A00,087446,Zhang; Danna,0,0,8,8
1653529024812,MATH 283,A00,087447,Tesler; Glenn,0,0,0,15
1653529025342,MATH 286,A00,087448,Kemp; Todd Aahron,5,0,8,3
1653529025865,MATH 287D,A00,087449,Bradic; Jelena,0,0,0,0
1653529026387,MATH 288,A00,087450,Staff,14,0,15,1
1653529026387,MATH 288,B00,087451,Staff,15,0,15,0
1653529026387,MATH 288,C00,087452,Staff,15,0,15,0
1653529026912,MATH 290A,A00,087453,Xu; Zhouli,6,0,8,2
1653529027439,MATH 291A,A00,087454,Xu; Zhouli,7,0,8,1
1653529027964,MATH 292,A00,087455,Staff,10,0,10,0
1653529028487,MATH 295,A00,087456,Staff,50,0,50,0
1653529029009,MATH 297,001,087457,Staff,998,0,999,1
1653529588450,COGS 200,A01,087991,Staff,47,0,50,3
1653529588983,COGS 201,A01,094504,Rangel; Lara M,17,0,25,8
1653529589506,COGS 203,A00,087992,Coulson; Seana M,18,0,20,2
1653529590044,COGS 210A,001,087993,Greene; Deanna Jacquelyn,9998,0,9999,1
1653529590044,COGS 210A,002,087994,Saygin; Ayse P,9999,0,9999,0
1653529590044,COGS 210A,003,087995,Xia; Haijun,9999,0,9999,0
1653529590044,COGS 210A,004,087996,Nitz; Douglas A.,9999,0,9999,0
1653529590044,COGS 210A,005,087997,Hollan; James D.,9999,0,9999,0
1653529590044,COGS 210A,006,087998,Deak; Gedeon O.,9998,0,9999,1
1653529590044,COGS 210A,007,087999,Rossano; Federico,9999,0,9999,0
1653529590569,COGS 211A,A00,088000,Coulson; Seana M,9997,0,9999,2
1653529591094,COGS 229,A00,088002,Staff,23,0,25,2
1653529591620,COGS 260,B00,094231,Staff,17,0,20,3
1653529591620,COGS 260,A00,088004,Nitz; Douglas A.,9998,0,9999,1
1653529592155,CSE 202,A00,090110,Paturi; Ramamohan,0,0,0,0
1653529592155,CSE 202,B00,090111,Paturi; Ramamohan,0,0,0,0
1653529592679,CSE 207B,A00,090112,Heninger; Nadia A,0,0,0,0
1653529593205,CSE 208,A00,094858,Micciancio; Daniele,0,0,0,0
1653529593731,CSE 210,A00,090113,Powell; Thomas Allan,0,0,0,0
1653529594254,CSE 219,A00,090898,Staff,0,0,0,0
1653529594779,CSE 221,A00,090114,Zhou; Yuan-Yuan,0,0,0,0
1653529595313,CSE 229A,A00,090115,Porter; George M,0,0,0,0
1653529595836,CSE 229C,A00,090116,Savage; Stefan,0,0,0,0
1653529596369,CSE 230,A00,090117,Jhala; Ranjit,0,0,0,0
1653529596895,CSE 232,A00,090118,Papakonstantinou; Yannis,0,0,0,0
1653529597424,CSE 239A,A00,090121,Kumar; Arun Kumar,0,0,0,0
1653529597967,CSE 239B,A00,090122,Jhala; Ranjit,0,0,0,0
1653529598489,CSE 240A,A00,090123,Zhao; Jishen,0,0,189,189
1653529599014,CSE 243A,A00,090124,Orailoglu; Alex,0,0,15,15
1653529599536,CSE 249B,A00,090125,Kahng; Andrew Byun,13,0,20,7
1653529600058,CSE 250A,A00,090126,Berg-Kirkpatrick; Taylor D,0,0,0,0
1653529600590,CSE 252A,A00,090127,Ochoa; Benjamin Lawrence,0,0,0,0
1653529601130,CSE 258,A01,090129,McAuley; Julian John,0,0,0,0
1653529601656,CSE 258R,A01,090131,McAuley; Julian John,0,0,0,0
1653529602178,CSE 274,A00,090132,Ramamoorthi; Ravi,0,0,0,0
1653529602707,CSE 276A,A00,090133,Christensen; Henrik I,0,0,0,0
1653529603230,CSE 276C,A00,090134,Christensen; Henrik I,0,0,0,0
1653529603752,CSE 290,A00,090135,Bafna; Vineet,0,0,0,0
1653529603752,CSE 290,B00,090136,Ramamoorthi; Ravi,0,0,0,0
1653529603752,CSE 290,C00,090137,Li; Tzumao,8,0,10,2
1653529603752,CSE 290,D00,090138,Zhou; Yuan-Yuan,9,0,10,1
1653529603752,CSE 290,E00,090139,Christensen; Henrik I,9,0,10,1
1653529603752,CSE 290,F00,094053,Shalev; Aaron D,0,0,0,0
1653529604280,CSE 291,A00,090140,Munyaka; Imani N. S.,0,0,0,0
1653529604280,CSE 291,B00,094880,Yu; Qi,0,0,0,0
1653529604280,CSE 291,C00,090142,Pannuto; Patrick William,0,0,0,0
1653529604280,CSE 291,D00,094881,Zhang; Yiying,0,0,0,0
1653529604280,CSE 291,E00,095118,Su; Hao,0,0,0,0
1653529604814,CSE 293,001,094905,Bafna; Vineet,9999,0,9999,0
1653529604814,CSE 293,002,094906,Bellare; Mihir,9999,0,9999,0
1653529604814,CSE 293,003,094907,Berg-Kirkpatrick; Taylor D,9999,0,9999,0
1653529604814,CSE 293,004,094908,Christensen; Henrik I,9999,0,9999,0
1653529604814,CSE 293,005,094909,Cottrell; Garrison W,9999,0,9999,0
1653529604814,CSE 293,006,094910,Deutsch; Alin Bernard,9999,0,9999,0
1653529604814,CSE 293,007,094911,Esmaeilzadeh; Hadi,9999,0,9999,0
1653529604814,CSE 293,008,094912,Freund; Yoav,9999,0,9999,0
1653529604814,CSE 293,009,094913,Griswold; William G.,9999,0,9999,0
1653529604814,CSE 293,010,094914,Gymrek; Melissa Ann,9999,0,9999,0
1653529604814,CSE 293,011,094915,Heninger; Nadia A,9999,0,9999,0
1653529604814,CSE 293,012,094916,Impagliazzo; Russell,9999,0,9999,0
1653529604814,CSE 293,013,094917,Jhala; Ranjit,9999,0,9999,0
1653529604814,CSE 293,014,094918,Kahng; Andrew Byun,9999,0,9999,0
1653529604814,CSE 293,015,094919,Kane; Daniel Mertz,9999,0,9999,0
1653529604814,CSE 293,016,094920,Kriegman; David J,9999,0,9999,0
1653529604814,CSE 293,017,094921,Kumar; Arun Kumar,9999,0,9999,0
1653529604814,CSE 293,018,094922,Lerner; Sorin,9999,0,9999,0
1653529604814,CSE 293,019,094923,Lovett; Shachar,9999,0,9999,0
1653529604814,CSE 293,020,094924,McAuley; Julian John,9999,0,9999,0
1653529604814,CSE 293,021,094925,Micciancio; Daniele,9999,0,9999,0
1653529604814,CSE 293,022,094926,Orailoglu; Alex,9999,0,9999,0
1653529604814,CSE 293,023,094927,Paturi; Ramamohan,9999,0,9999,0
1653529604814,CSE 293,024,094928,Polikarpova; Nadezhda,9999,0,9999,0
1653529604814,CSE 293,025,094929,Politz; Joseph Gibbs,9999,0,9999,0
1653529604814,CSE 293,026,094930,Porter; George M,9999,0,9999,0
1653529604814,CSE 293,027,094931,Porter; Leonard Emerson,9999,0,9999,0
1653529604814,CSE 293,028,094932,Ramamoorthi; Ravi,9999,0,9999,0
1653529604814,CSE 293,029,094933,Sahoo; Debashis,9999,0,9999,0
1653529604814,CSE 293,030,094934,Saul; Lawrence,9999,0,9999,0
1653529604814,CSE 293,031,094935,Savage; Stefan,9999,0,9999,0
1653529604814,CSE 293,032,094936,Schulze; Jurgen P.,9999,0,9999,0
1653529604814,CSE 293,033,094937,Snoeren; Alex C.,9999,0,9999,0
1653529604814,CSE 293,034,094938,Shang; Jingbo,9999,0,9999,0
1653529604814,CSE 293,035,094939,Stefan; Deian,9999,0,9999,0
1653529604814,CSE 293,036,094940,Su; Hao,9999,0,9999,0
1653529604814,CSE 293,037,094941,Swanson; Steven James,9999,0,9999,0
1653529604814,CSE 293,038,094942,Tullsen; Dean Michael,9999,0,9999,0
1653529604814,CSE 293,039,094943,Voelker; Geoffrey M.,9999,0,9999,0
1653529604814,CSE 293,040,094944,Zhao; Jishen,9999,0,9999,0
1653529604814,CSE 293,041,094945,Zhou; Yuan-Yuan,9999,0,9999,0
1653529604814,CSE 293,042,094946,Gao; Sicun,9998,0,9999,1
1653529604814,CSE 293,043,094947,Weibel; Nadir,9999,0,9999,0
1653529604814,CSE 293,044,094948,Gupta; Rajesh K.,9999,0,9999,0
1653529605338,CSE 294,A00,090143,Porter; George M,8,0,10,2
1653529605872,DSE 200,A00,091799,Staff,50,0,50,0
1653529606397,DSE 203,A00,091800,Gupta; Amarnath,30,0,30,0
1653529606924,DSE 250,A00,091801,Deutsch; Alin Bernard,30,0,30,0
1653529607446,DSE 290,A00,091802,Altintas De Callaf; Ilkay,50,0,50,0
1653529607984,ECE 200,001,091003,Antipa; Nicholas A,9999,0,9999,0
1653529607984,ECE 200,002,091004,Atanasov; Nikolay A.,9999,0,9999,0
1653529607984,ECE 200,003,091005,Bharadia; Dinesh,9999,0,9999,0
1653529607984,ECE 200,004,091006,Cheng; Chung Kuan,9999,0,9999,0
1653529607984,ECE 200,005,091007,Cosman; Pamela C.,9999,0,9999,0
1653529607984,ECE 200,006,091008,Staff,9999,0,9999,0
1653529607984,ECE 200,007,091009,Dayeh; Shadi Ahmad,9999,0,9999,0
1653529607984,ECE 200,008,091010,Fainman; Yeshaiahu,9999,0,9999,0
1653529607984,ECE 200,009,091011,Ford; Joseph Earl,9999,0,9999,0
1653529607984,ECE 200,010,091012,Franceschetti; Massimo,9999,0,9999,0
1653529607984,ECE 200,011,091013,Fullerton; Eric E,9999,0,9999,0
1653529607984,ECE 200,012,091014,Galton; Ian A,9999,0,9999,0
1653529607984,ECE 200,013,091015,Gilja; Vikash,9999,0,9999,0
1653529607984,ECE 200,014,091016,Hall; Drew A.,9999,0,9999,0
1653529607984,ECE 200,015,091017,Hsueh; Tzu-Chien,9999,0,9999,0
1653529607984,ECE 200,016,091018,Javidi; Tara,9999,0,9999,0
1653529607984,ECE 200,017,091019,Kahng; Andrew Byun,9999,0,9999,0
1653529607984,ECE 200,018,091020,Kim; Young-Han,9999,0,9999,0
1653529607984,ECE 200,019,091021,Koushanfar; Farinaz,9999,0,9999,0
1653529607984,ECE 200,020,091022,Kuzum; Duygu,9999,0,9999,0
1653529607984,ECE 200,021,091023,Le; Hanh-Phuc,9999,0,9999,0
1653529607984,ECE 200,022,091024,Lin; Bill,9999,0,9999,0
1653529607984,ECE 200,023,091025,Liu; Zhaowei,9999,0,9999,0
1653529607984,ECE 200,024,091026,Lo; Yu-Hwa,9999,0,9999,0
1653529607984,ECE 200,025,091027,Lomakin; Vitaliy,9999,0,9999,0
1653529607984,ECE 200,026,091028,Mercier; Patrick Philip,9999,0,9999,0
1653529607984,ECE 200,027,091029,Meyer; Florian,9999,0,9999,0
1653529607984,ECE 200,028,091030,Milstein; Laurence B.,9999,0,9999,0
1653529607984,ECE 200,029,091031,Mir Arabbaygi; Siavash,9999,0,9999,0
1653529607984,ECE 200,030,091032,Mookherjea; Shayan,9999,0,9999,0
1653529607984,ECE 200,031,091033,Morris; Karcher William,9999,0,9999,0
1653529607984,ECE 200,032,091034,Ng; Tse Nga,9999,0,9999,0
1653529607984,ECE 200,033,091035,Nguyen; Truong Quang,9999,0,9999,0
1653529607984,ECE 200,034,091036,Nomura; Kenji,9999,0,9999,0
1653529607984,ECE 200,035,091037,Orlitsky; Alon,9999,0,9999,0
1653529607984,ECE 200,036,091038,Pal; Piya,9999,0,9999,0
1653529607984,ECE 200,037,091039,Papen; George C.,9999,0,9999,0
1653529607984,ECE 200,038,091040,Radic; Stojan,9999,0,9999,0
1653529607984,ECE 200,039,091041,Rao; Bhaskar D.,9999,0,9999,0
1653529607984,ECE 200,040,091042,Rao; Ramesh R,9999,0,9999,0
1653529607984,ECE 200,041,091043,Rebeiz; Gabriel,9999,0,9999,0
1653529607984,ECE 200,042,091044,Sanford; John R,9999,0,9999,0
1653529607984,ECE 200,043,091045,Siegel; Paul H.,9999,0,9999,0
1653529607984,ECE 200,044,091046,Sievenpiper; Daniel F.,9999,0,9999,0
1653529607984,ECE 200,045,091047,Sworder; David D.,9999,0,9999,0
1653529607984,ECE 200,046,091048,Taur; Yuan,9999,0,9999,0
1653529607984,ECE 200,047,091049,Touri; Behrouz,9999,0,9999,0
1653529607984,ECE 200,048,091050,Trivedi; Mohan M.,9999,0,9999,0
1653529607984,ECE 200,049,091051,Vardy; Alexander,9999,0,9999,0
1653529607984,ECE 200,050,091052,Vasconcelos; Nuno,9999,0,9999,0
1653529607984,ECE 200,051,091053,Wang; Xiaolong,9999,0,9999,0
1653529607984,ECE 200,052,091054,Xie; Pengtao,9999,0,9999,0
1653529607984,ECE 200,053,091055,Yip; Michael,9999,0,9999,0
1653529607984,ECE 200,054,091056,Zeger; Kenneth A.,9999,0,9999,0
1653529607984,ECE 200,055,091057,Zhang; Xinyu,9999,0,9999,0
1653529607984,ECE 200,056,091058,Turakhia; Yatish Girish,9999,0,9999,0
1653529607984,ECE 200,057,091059,Kang; Mingu,9999,0,9999,0
1653529607984,ECE 200,058,091060,Shi; Yuanyuan,9999,0,9999,0
1653529607984,ECE 200,059,091061,Wang; Edward Jay,9999,0,9999,0
1653529607984,ECE 200,060,091062,Zheng; Yang,9999,0,9999,0
1653529608518,ECE 201,A00,095526,Lo; Yu-Hwa,0,0,0,0
1653529609043,ECE 203,A00,091065,Mercier; Patrick Philip,0,0,0,0
1653529609579,ECE 207A,A00,091605,Liu; Thomas Tao-Ming,0,0,0,0
1653529610174,ECE 212AN,A00,091068,Nomura; Kenji,0,0,0,0
1653529610698,ECE 222A,A00,091069,Rebeiz; Gabriel,0,0,0,0
1653529611226,ECE 225A,A00,091070,Orlitsky; Alon,0,0,0,0
1653529611748,ECE 230A,A00,091071,Nomura; Kenji,0,0,0,0
1653529612275,ECE 236A,A00,091072,Dayeh; Shadi Ahmad,0,0,0,0
1653529612798,ECE 238A,A00,091073,Luo; Jian,0,0,0,0
1653529612798,ECE 238A,B00,091074,Luo; Jian,0,0,0,0
1653529613336,ECE 240A,A00,091075,Radic; Stojan,0,0,0,0
1653529613860,ECE 247A,A00,091592,Shi; Lingyan,0,0,0,0
1653529614399,ECE 250,A00,091076,Touri; Behrouz,0,0,0,0
1653529614923,ECE 251C,A00,091078,Nguyen; Truong Quang,0,0,0,0
1653529615448,ECE 253,A00,091079,Cosman; Pamela C.,0,0,0,0
1653529615977,ECE 255A,A00,091080,Orlitsky; Alon,0,0,0,0
1653529616517,ECE 257A,A00,091081,Zhang; Xinyu,0,0,0,0
1653529617045,ECE 260A,A01,091084,Eldon; John,0,0,0,0
1653529617577,ECE 264C,A00,091085,Galton; Ian A,0,0,0,0
1653529618108,ECE 265C,A00,094889,Presti; Calogero Davide,0,0,0,9
1653529618636,ECE 266,A01,091087,Hall; Drew A.,0,0,0,0
1653529619685,ECE 271A,A00,091090,Vasconcelos; Nuno,0,0,0,0
1653529620206,ECE 272B,A00,091091,Sworder; David D.,0,0,0,0
1653529620731,ECE 275A,A00,091092,Meyer; Florian,0,0,0,0
1653529621266,ECE 277,A00,091093,An; Cheolhong,0,0,0,0
1653529621800,ECE 283,A00,091094,Le; Hanh-Phuc,0,0,0,0
1653529622326,ECE 284,A00,091095,Kang; Mingu,0,0,0,0
1653529622326,ECE 284,B00,091096,Wang; Edward Jay,0,0,0,0
1653529622848,ECE 285,A00,094334,Touri; Behrouz,0,0,0,0
1653529623375,ECE 289,A00,091097,Whelan; David Arthur,0,0,0,0
1653529623897,MATH 200A,A00,087414,Salehi Golsefidy; Alireza,7,0,8,1
1653529624421,MATH 202A,A00,087415,Gill; Philip E.,2,0,8,6
1653529624947,MATH 203A,A00,087416,Oprea; Dragos N.,6,0,8,2
1653529625476,MATH 204A,A00,087417,Kedlaya; Kiran S.,6,0,8,2
1653529625999,MATH 205,A00,087418,Sorensen; Claus M,6,0,8,2
1653529626532,MATH 206A,A00,087419,Izadi; Elham,7,0,8,1
1653529627063,MATH 207A,A00,087420,Mohammadi; Amir,5,0,8,3
1653529627585,MATH 208,A00,087421,Staff,9,0,10,1
1653529628108,MATH 209,A00,087422,Staff,10,0,10,0
1653529628636,MATH 218,A00,087423,Staff,10,0,10,0
1653529629179,MATH 220A,A00,087424,Novak; Jonathan I,7,0,8,1
1653529629702,MATH 231A,A00,087425,Bejenaru; Ioan,3,0,8,5
1653529630227,MATH 240A,A00,087426,Ebenfelt; Peter F,5,0,8,3
1653529630753,MATH 243,A00,087427,Staff,9,0,10,1
1653529631278,MATH 248,A00,087429,Staff,10,0,10,0
1653529631807,MATH 250A,A00,087430,Spolaor; Luca,4,0,8,4
1653529632333,MATH 257A,A00,087431,Spolaor; Luca,7,0,8,1
1653529632856,MATH 258,A00,087432,Staff,9,0,10,1
1653529633385,MATH 264A,A00,087433,Warnke; Lutz Peter,5,0,8,3
1653529633908,MATH 268,A00,087434,Staff,15,0,15,0
1653529634443,MATH 269,A00,087435,Staff,14,0,15,1
1653529634965,MATH 270A,A00,087436,Nie; Jiawang,0,0,8,8
1653529635497,MATH 272A,A00,087437,Tian; Xiaochuan,1,0,8,7
1653529636020,MATH 274,A01,087439,Cheng; Li-Tien,9,0,10,1
1653529636020,MATH 274,A02,087440,Cheng; Li-Tien,10,0,10,0
1653529636544,MATH 278A,A00,087441,Staff,8,0,10,2
1653529637100,MATH 278B,A00,087442,Staff,8,0,10,2
1653529637625,MATH 278C,A00,087443,Staff,8,0,10,2
1653529638148,MATH 280A,A00,087444,Zheng; Tianyi,0,0,8,8
1653529638672,MATH 281A,A00,087445,Bradic; Jelena,0,0,8,8
1653529639196,MATH 282A,A00,087446,Zhang; Danna,0,0,8,8
1653529639722,MATH 283,A00,087447,Tesler; Glenn,0,0,0,15
1653529640244,MATH 286,A00,087448,Kemp; Todd Aahron,5,0,8,3
1653529640769,MATH 287D,A00,087449,Bradic; Jelena,0,0,0,0
1653529641300,MATH 288,A00,087450,Staff,14,0,15,1
1653529641300,MATH 288,B00,087451,Staff,15,0,15,0
1653529641300,MATH 288,C00,087452,Staff,15,0,15,0
1653529641827,MATH 290A,A00,087453,Xu; Zhouli,6,0,8,2
1653529642354,MATH 291A,A00,087454,Xu; Zhouli,7,0,8,1
1653529642892,MATH 292,A00,087455,Staff,10,0,10,0
1653529643420,MATH 295,A00,087456,Staff,50,0,50,0
1653529643943,MATH 297,001,087457,Staff,998,0,999,1
1653530203737,COGS 200,A01,087991,Staff,47,0,50,3
1653530204262,COGS 201,A01,094504,Rangel; Lara M,17,0,25,8
1653530204788,COGS 203,A00,087992,Coulson; Seana M,18,0,20,2
1653530205320,COGS 210A,001,087993,Greene; Deanna Jacquelyn,9998,0,9999,1
1653530205320,COGS 210A,002,087994,Saygin; Ayse P,9999,0,9999,0
1653530205320,COGS 210A,003,087995,Xia; Haijun,9999,0,9999,0
1653530205320,COGS 210A,004,087996,Nitz; Douglas A.,9999,0,9999,0
1653530205320,COGS 210A,005,087997,Hollan; James D.,9999,0,9999,0
1653530205320,COGS 210A,006,087998,Deak; Gedeon O.,9998,0,9999,1
1653530205320,COGS 210A,007,087999,Rossano; Federico,9999,0,9999,0
1653530205842,COGS 211A,A00,088000,Coulson; Seana M,9997,0,9999,2
1653530206366,COGS 229,A00,088002,Staff,23,0,25,2
1653530206896,COGS 260,B00,094231,Staff,17,0,20,3
1653530206896,COGS 260,A00,088004,Nitz; Douglas A.,9998,0,9999,1
1653530207419,CSE 202,A00,090110,Paturi; Ramamohan,0,0,0,0
1653530207419,CSE 202,B00,090111,Paturi; Ramamohan,0,0,0,0
1653530207944,CSE 207B,A00,090112,Heninger; Nadia A,0,0,0,0
1653530208467,CSE 208,A00,094858,Micciancio; Daniele,0,0,0,0
1653530208994,CSE 210,A00,090113,Powell; Thomas Allan,0,0,0,0
1653530209528,CSE 219,A00,090898,Staff,0,0,0,0
1653530210049,CSE 221,A00,090114,Zhou; Yuan-Yuan,0,0,0,0
1653530210571,CSE 229A,A00,090115,Porter; George M,0,0,0,0
1653530211093,CSE 229C,A00,090116,Savage; Stefan,0,0,0,0
1653530211615,CSE 230,A00,090117,Jhala; Ranjit,0,0,0,0
1653530212152,CSE 232,A00,090118,Papakonstantinou; Yannis,0,0,0,0
1653530212689,CSE 239A,A00,090121,Kumar; Arun Kumar,0,0,0,0
1653530213220,CSE 239B,A00,090122,Jhala; Ranjit,0,0,0,0
1653530213742,CSE 240A,A00,090123,Zhao; Jishen,0,0,189,189
1653530214265,CSE 243A,A00,090124,Orailoglu; Alex,0,0,15,15
1653530214787,CSE 249B,A00,090125,Kahng; Andrew Byun,13,0,20,7
1653530215313,CSE 250A,A00,090126,Berg-Kirkpatrick; Taylor D,0,0,0,0
1653530215835,CSE 252A,A00,090127,Ochoa; Benjamin Lawrence,0,0,0,0
1653530216361,CSE 258,A01,090129,McAuley; Julian John,0,0,0,0
1653530216895,CSE 258R,A01,090131,McAuley; Julian John,0,0,0,0
1653530217418,CSE 274,A00,090132,Ramamoorthi; Ravi,0,0,0,0
1653530217941,CSE 276A,A00,090133,Christensen; Henrik I,0,0,0,0
1653530218463,CSE 276C,A00,090134,Christensen; Henrik I,0,0,0,0
1653530219005,CSE 290,A00,090135,Bafna; Vineet,0,0,0,0
1653530219005,CSE 290,B00,090136,Ramamoorthi; Ravi,0,0,0,0
1653530219005,CSE 290,C00,090137,Li; Tzumao,8,0,10,2
1653530219005,CSE 290,D00,090138,Zhou; Yuan-Yuan,9,0,10,1
1653530219005,CSE 290,E00,090139,Christensen; Henrik I,9,0,10,1
1653530219005,CSE 290,F00,094053,Shalev; Aaron D,0,0,0,0
1653530219531,CSE 291,A00,090140,Munyaka; Imani N. S.,0,0,0,0
1653530219531,CSE 291,B00,094880,Yu; Qi,0,0,0,0
1653530219531,CSE 291,C00,090142,Pannuto; Patrick William,0,0,0,0
1653530219531,CSE 291,D00,094881,Zhang; Yiying,0,0,0,0
1653530219531,CSE 291,E00,095118,Su; Hao,0,0,0,0
1653530220059,CSE 293,001,094905,Bafna; Vineet,9999,0,9999,0
1653530220059,CSE 293,002,094906,Bellare; Mihir,9999,0,9999,0
1653530220059,CSE 293,003,094907,Berg-Kirkpatrick; Taylor D,9999,0,9999,0
1653530220059,CSE 293,004,094908,Christensen; Henrik I,9999,0,9999,0
1653530220059,CSE 293,005,094909,Cottrell; Garrison W,9999,0,9999,0
1653530220059,CSE 293,006,094910,Deutsch; Alin Bernard,9999,0,9999,0
1653530220059,CSE 293,007,094911,Esmaeilzadeh; Hadi,9999,0,9999,0
1653530220059,CSE 293,008,094912,Freund; Yoav,9999,0,9999,0
1653530220059,CSE 293,009,094913,Griswold; William G.,9999,0,9999,0
1653530220059,CSE 293,010,094914,Gymrek; Melissa Ann,9999,0,9999,0
1653530220059,CSE 293,011,094915,Heninger; Nadia A,9999,0,9999,0
1653530220059,CSE 293,012,094916,Impagliazzo; Russell,9999,0,9999,0
1653530220059,CSE 293,013,094917,Jhala; Ranjit,9999,0,9999,0
1653530220059,CSE 293,014,094918,Kahng; Andrew Byun,9999,0,9999,0
1653530220059,CSE 293,015,094919,Kane; Daniel Mertz,9999,0,9999,0
1653530220059,CSE 293,016,094920,Kriegman; David J,9999,0,9999,0
1653530220059,CSE 293,017,094921,Kumar; Arun Kumar,9999,0,9999,0
1653530220059,CSE 293,018,094922,Lerner; Sorin,9999,0,9999,0
1653530220059,CSE 293,019,094923,Lovett; Shachar,9999,0,9999,0
1653530220059,CSE 293,020,094924,McAuley; Julian John,9999,0,9999,0
1653530220059,CSE 293,021,094925,Micciancio; Daniele,9999,0,9999,0
1653530220059,CSE 293,022,094926,Orailoglu; Alex,9999,0,9999,0
1653530220059,CSE 293,023,094927,Paturi; Ramamohan,9999,0,9999,0
1653530220059,CSE 293,024,094928,Polikarpova; Nadezhda,9999,0,9999,0
1653530220059,CSE 293,025,094929,Politz; Joseph Gibbs,9999,0,9999,0
1653530220059,CSE 293,026,094930,Porter; George M,9999,0,9999,0
1653530220059,CSE 293,027,094931,Porter; Leonard Emerson,9999,0,9999,0
1653530220059,CSE 293,028,094932,Ramamoorthi; Ravi,9999,0,9999,0
1653530220059,CSE 293,029,094933,Sahoo; Debashis,9999,0,9999,0
1653530220059,CSE 293,030,094934,Saul; Lawrence,9999,0,9999,0
1653530220059,CSE 293,031,094935,Savage; Stefan,9999,0,9999,0
1653530220059,CSE 293,032,094936,Schulze; Jurgen P.,9999,0,9999,0
1653530220059,CSE 293,033,094937,Snoeren; Alex C.,9999,0,9999,0
1653530220059,CSE 293,034,094938,Shang; Jingbo,9999,0,9999,0
1653530220059,CSE 293,035,094939,Stefan; Deian,9999,0,9999,0
1653530220059,CSE 293,036,094940,Su; Hao,9999,0,9999,0
1653530220059,CSE 293,037,094941,Swanson; Steven James,9999,0,9999,0
1653530220059,CSE 293,038,094942,Tullsen; Dean Michael,9999,0,9999,0
1653530220059,CSE 293,039,094943,Voelker; Geoffrey M.,9999,0,9999,0
1653530220059,CSE 293,040,094944,Zhao; Jishen,9999,0,9999,0
1653530220059,CSE 293,041,094945,Zhou; Yuan-Yuan,9999,0,9999,0
1653530220059,CSE 293,042,094946,Gao; Sicun,9998,0,9999,1
1653530220059,CSE 293,043,094947,Weibel; Nadir,9999,0,9999,0
1653530220059,CSE 293,044,094948,Gupta; Rajesh K.,9999,0,9999,0
1653530220581,CSE 294,A00,090143,Porter; George M,8,0,10,2
1653530221109,DSE 200,A00,091799,Staff,50,0,50,0
1653530221632,DSE 203,A00,091800,Gupta; Amarnath,30,0,30,0
1653530222161,DSE 250,A00,091801,Deutsch; Alin Bernard,30,0,30,0
1653530222690,DSE 290,A00,091802,Altintas De Callaf; Ilkay,50,0,50,0
1653530223226,ECE 200,001,091003,Antipa; Nicholas A,9999,0,9999,0
1653530223226,ECE 200,002,091004,Atanasov; Nikolay A.,9999,0,9999,0
1653530223226,ECE 200,003,091005,Bharadia; Dinesh,9999,0,9999,0
1653530223226,ECE 200,004,091006,Cheng; Chung Kuan,9999,0,9999,0
1653530223226,ECE 200,005,091007,Cosman; Pamela C.,9999,0,9999,0
1653530223226,ECE 200,006,091008,Staff,9999,0,9999,0
1653530223226,ECE 200,007,091009,Dayeh; Shadi Ahmad,9999,0,9999,0
1653530223226,ECE 200,008,091010,Fainman; Yeshaiahu,9999,0,9999,0
1653530223226,ECE 200,009,091011,Ford; Joseph Earl,9999,0,9999,0
1653530223226,ECE 200,010,091012,Franceschetti; Massimo,9999,0,9999,0
1653530223226,ECE 200,011,091013,Fullerton; Eric E,9999,0,9999,0
1653530223226,ECE 200,012,091014,Galton; Ian A,9999,0,9999,0
1653530223226,ECE 200,013,091015,Gilja; Vikash,9999,0,9999,0
1653530223226,ECE 200,014,091016,Hall; Drew A.,9999,0,9999,0
1653530223226,ECE 200,015,091017,Hsueh; Tzu-Chien,9999,0,9999,0
1653530223226,ECE 200,016,091018,Javidi; Tara,9999,0,9999,0
1653530223226,ECE 200,017,091019,Kahng; Andrew Byun,9999,0,9999,0
1653530223226,ECE 200,018,091020,Kim; Young-Han,9999,0,9999,0
1653530223226,ECE 200,019,091021,Koushanfar; Farinaz,9999,0,9999,0
1653530223226,ECE 200,020,091022,Kuzum; Duygu,9999,0,9999,0
1653530223226,ECE 200,021,091023,Le; Hanh-Phuc,9999,0,9999,0
1653530223226,ECE 200,022,091024,Lin; Bill,9999,0,9999,0
1653530223226,ECE 200,023,091025,Liu; Zhaowei,9999,0,9999,0
1653530223226,ECE 200,024,091026,Lo; Yu-Hwa,9999,0,9999,0
1653530223226,ECE 200,025,091027,Lomakin; Vitaliy,9999,0,9999,0
1653530223226,ECE 200,026,091028,Mercier; Patrick Philip,9999,0,9999,0
1653530223226,ECE 200,027,091029,Meyer; Florian,9999,0,9999,0
1653530223226,ECE 200,028,091030,Milstein; Laurence B.,9999,0,9999,0
1653530223226,ECE 200,029,091031,Mir Arabbaygi; Siavash,9999,0,9999,0
1653530223226,ECE 200,030,091032,Mookherjea; Shayan,9999,0,9999,0
1653530223226,ECE 200,031,091033,Morris; Karcher William,9999,0,9999,0
1653530223226,ECE 200,032,091034,Ng; Tse Nga,9999,0,9999,0
1653530223226,ECE 200,033,091035,Nguyen; Truong Quang,9999,0,9999,0
1653530223226,ECE 200,034,091036,Nomura; Kenji,9999,0,9999,0
1653530223226,ECE 200,035,091037,Orlitsky; Alon,9999,0,9999,0
1653530223226,ECE 200,036,091038,Pal; Piya,9999,0,9999,0
1653530223226,ECE 200,037,091039,Papen; George C.,9999,0,9999,0
1653530223226,ECE 200,038,091040,Radic; Stojan,9999,0,9999,0
1653530223226,ECE 200,039,091041,Rao; Bhaskar D.,9999,0,9999,0
1653530223226,ECE 200,040,091042,Rao; Ramesh R,9999,0,9999,0
1653530223226,ECE 200,041,091043,Rebeiz; Gabriel,9999,0,9999,0
1653530223226,ECE 200,042,091044,Sanford; John R,9999,0,9999,0
1653530223226,ECE 200,043,091045,Siegel; Paul H.,9999,0,9999,0
1653530223226,ECE 200,044,091046,Sievenpiper; Daniel F.,9999,0,9999,0
1653530223226,ECE 200,045,091047,Sworder; David D.,9999,0,9999,0
1653530223226,ECE 200,046,091048,Taur; Yuan,9999,0,9999,0
1653530223226,ECE 200,047,091049,Touri; Behrouz,9999,0,9999,0
1653530223226,ECE 200,048,091050,Trivedi; Mohan M.,9999,0,9999,0
1653530223226,ECE 200,049,091051,Vardy; Alexander,9999,0,9999,0
1653530223226,ECE 200,050,091052,Vasconcelos; Nuno,9999,0,9999,0
1653530223226,ECE 200,051,091053,Wang; Xiaolong,9999,0,9999,0
1653530223226,ECE 200,052,091054,Xie; Pengtao,9999,0,9999,0
1653530223226,ECE 200,053,091055,Yip; Michael,9999,0,9999,0
1653530223226,ECE 200,054,091056,Zeger; Kenneth A.,9999,0,9999,0
1653530223226,ECE 200,055,091057,Zhang; Xinyu,9999,0,9999,0
1653530223226,ECE 200,056,091058,Turakhia; Yatish Girish,9999,0,9999,0
1653530223226,ECE 200,057,091059,Kang; Mingu,9999,0,9999,0
1653530223226,ECE 200,058,091060,Shi; Yuanyuan,9999,0,9999,0
1653530223226,ECE 200,059,091061,Wang; Edward Jay,9999,0,9999,0
1653530223226,ECE 200,060,091062,Zheng; Yang,9999,0,9999,0
1653530223749,ECE 201,A00,095526,Lo; Yu-Hwa,0,0,0,0
1653530224271,ECE 203,A00,091065,Mercier; Patrick Philip,0,0,0,0
1653530224801,ECE 207A,A00,091605,Liu; Thomas Tao-Ming,0,0,0,0
1653530225328,ECE 212AN,A00,091068,Nomura; Kenji,0,0,0,0
1653530225855,ECE 222A,A00,091069,Rebeiz; Gabriel,0,0,0,0
1653530226397,ECE 225A,A00,091070,Orlitsky; Alon,0,0,0,0
1653530226920,ECE 230A,A00,091071,Nomura; Kenji,0,0,0,0
1653530227453,ECE 236A,A00,091072,Dayeh; Shadi Ahmad,0,0,0,0
1653530227980,ECE 238A,A00,091073,Luo; Jian,0,0,0,0
1653530227980,ECE 238A,B00,091074,Luo; Jian,0,0,0,0
1653530228507,ECE 240A,A00,091075,Radic; Stojan,0,0,0,0
1653530229029,ECE 247A,A00,091592,Shi; Lingyan,0,0,0,0
1653530229561,ECE 250,A00,091076,Touri; Behrouz,0,0,0,0
1653530230083,ECE 251C,A00,091078,Nguyen; Truong Quang,0,0,0,0
1653530230614,ECE 253,A00,091079,Cosman; Pamela C.,0,0,0,0
1653530231135,ECE 255A,A00,091080,Orlitsky; Alon,0,0,0,0
1653530231675,ECE 257A,A00,091081,Zhang; Xinyu,0,0,0,0
1653530232202,ECE 260A,A01,091084,Eldon; John,0,0,0,0
1653530232728,ECE 264C,A00,091085,Galton; Ian A,0,0,0,0
1653530233250,ECE 265C,A00,094889,Presti; Calogero Davide,0,0,0,9
1653530233772,ECE 266,A01,091087,Hall; Drew A.,0,0,0,0
1653530234823,ECE 271A,A00,091090,Vasconcelos; Nuno,0,0,0,0
1653530235347,ECE 272B,A00,091091,Sworder; David D.,0,0,0,0
1653530235881,ECE 275A,A00,091092,Meyer; Florian,0,0,0,0
1653530236403,ECE 277,A00,091093,An; Cheolhong,0,0,0,0
1653530236925,ECE 283,A00,091094,Le; Hanh-Phuc,0,0,0,0
1653530237447,ECE 284,A00,091095,Kang; Mingu,0,0,0,0
1653530237447,ECE 284,B00,091096,Wang; Edward Jay,0,0,0,0
1653530237972,ECE 285,A00,094334,Touri; Behrouz,0,0,0,0
1653530238496,ECE 289,A00,091097,Whelan; David Arthur,0,0,0,0
1653530239019,MATH 200A,A00,087414,Salehi Golsefidy; Alireza,7,0,8,1
1653530239547,MATH 202A,A00,087415,Gill; Philip E.,2,0,8,6
1653530240070,MATH 203A,A00,087416,Oprea; Dragos N.,6,0,8,2
1653530240592,MATH 204A,A00,087417,Kedlaya; Kiran S.,6,0,8,2
1653530241113,MATH 205,A00,087418,Sorensen; Claus M,6,0,8,2
1653530241640,MATH 206A,A00,087419,Izadi; Elham,7,0,8,1
1653530242166,MATH 207A,A00,087420,Mohammadi; Amir,5,0,8,3
1653530242692,MATH 208,A00,087421,Staff,9,0,10,1
1653530243220,MATH 209,A00,087422,Staff,10,0,10,0
1653530243743,MATH 218,A00,087423,Staff,10,0,10,0
1653530244269,MATH 220A,A00,087424,Novak; Jonathan I,7,0,8,1
1653530244792,MATH 231A,A00,087425,Bejenaru; Ioan,3,0,8,5
1653530245314,MATH 240A,A00,087426,Ebenfelt; Peter F,5,0,8,3
1653530245836,MATH 243,A00,087427,Staff,9,0,10,1
1653530246359,MATH 248,A00,087429,Staff,10,0,10,0
1653530246880,MATH 250A,A00,087430,Spolaor; Luca,4,0,8,4
1653530247403,MATH 257A,A00,087431,Spolaor; Luca,7,0,8,1
1653530247930,MATH 258,A00,087432,Staff,9,0,10,1
1653530248456,MATH 264A,A00,087433,Warnke; Lutz Peter,5,0,8,3
1653530248985,MATH 268,A00,087434,Staff,15,0,15,0
1653530249524,MATH 269,A00,087435,Staff,14,0,15,1
1653530250045,MATH 270A,A00,087436,Nie; Jiawang,0,0,8,8
1653530250658,MATH 272A,A00,087437,Tian; Xiaochuan,1,0,8,7
1653530251181,MATH 274,A01,087439,Cheng; Li-Tien,9,0,10,1
1653530251181,MATH 274,A02,087440,Cheng; Li-Tien,10,0,10,0
1653530251703,MATH 278A,A00,087441,Staff,8,0,10,2
1653530252227,MATH 278B,A00,087442,Staff,8,0,10,2
1653530252749,MATH 278C,A00,087443,Staff,8,0,10,2
1653530253284,MATH 280A,A00,087444,Zheng; Tianyi,0,0,8,8
1653530253815,MATH 281A,A00,087445,Bradic; Jelena,0,0,8,8
1653530254337,MATH 282A,A00,087446,Zhang; Danna,0,0,8,8
1653530254860,MATH 283,A00,087447,Tesler; Glenn,0,0,0,15
1653530255385,MATH 286,A00,087448,Kemp; Todd Aahron,5,0,8,3
1653530255914,MATH 287D,A00,087449,Bradic; Jelena,0,0,0,0
1653530256446,MATH 288,A00,087450,Staff,14,0,15,1
1653530256446,MATH 288,B00,087451,Staff,15,0,15,0
1653530256446,MATH 288,C00,087452,Staff,15,0,15,0
1653530256971,MATH 290A,A00,087453,Xu; Zhouli,6,0,8,2
1653530257503,MATH 291A,A00,087454,Xu; Zhouli,7,0,8,1
1653530258028,MATH 292,A00,087455,Staff,10,0,10,0
1653530258550,MATH 295,A00,087456,Staff,50,0,50,0
1653530259073,MATH 297,001,087457,Staff,998,0,999,1
1653530819071,COGS 200,A01,087991,Staff,47,0,50,3
1653530819595,COGS 201,A01,094504,Rangel; Lara M,17,0,25,8
1653530820120,COGS 203,A00,087992,Coulson; Seana M,18,0,20,2
1653530820649,COGS 210A,001,087993,Greene; Deanna Jacquelyn,9998,0,9999,1
1653530820649,COGS 210A,002,087994,Saygin; Ayse P,9999,0,9999,0
1653530820649,COGS 210A,003,087995,Xia; Haijun,9999,0,9999,0
1653530820649,COGS 210A,004,087996,Nitz; Douglas A.,9999,0,9999,0
1653530820649,COGS 210A,005,087997,Hollan; James D.,9999,0,9999,0
1653530820649,COGS 210A,006,087998,Deak; Gedeon O.,9998,0,9999,1
1653530820649,COGS 210A,007,087999,Rossano; Federico,9999,0,9999,0
1653530821176,COGS 211A,A00,088000,Coulson; Seana M,9997,0,9999,2
1653530821701,COGS 229,A00,088002,Staff,23,0,25,2
1653530822226,COGS 260,B00,094231,Staff,17,0,20,3
1653530822226,COGS 260,A00,088004,Nitz; Douglas A.,9998,0,9999,1
1653530822749,CSE 202,A00,090110,Paturi; Ramamohan,0,0,0,0
1653530822749,CSE 202,B00,090111,Paturi; Ramamohan,0,0,0,0
1653530823272,CSE 207B,A00,090112,Heninger; Nadia A,0,0,0,0
1653530823795,CSE 208,A00,094858,Micciancio; Daniele,0,0,0,0
1653530824316,CSE 210,A00,090113,Powell; Thomas Allan,0,0,0,0
1653530824838,CSE 219,A00,090898,Staff,0,0,0,0
1653530825363,CSE 221,A00,090114,Zhou; Yuan-Yuan,0,0,0,0
1653530825886,CSE 229A,A00,090115,Porter; George M,0,0,0,0
1653530826422,CSE 229C,A00,090116,Savage; Stefan,0,0,0,0
1653530826950,CSE 230,A00,090117,Jhala; Ranjit,0,0,0,0
1653530827472,CSE 232,A00,090118,Papakonstantinou; Yannis,0,0,0,0
1653530827996,CSE 239A,A00,090121,Kumar; Arun Kumar,0,0,0,0
1653530828518,CSE 239B,A00,090122,Jhala; Ranjit,0,0,0,0
1653530829041,CSE 240A,A00,090123,Zhao; Jishen,0,0,189,189
1653530829569,CSE 243A,A00,090124,Orailoglu; Alex,0,0,15,15
1653530830092,CSE 249B,A00,090125,Kahng; Andrew Byun,13,0,20,7
1653530830623,CSE 250A,A00,090126,Berg-Kirkpatrick; Taylor D,0,0,0,0
1653530831162,CSE 252A,A00,090127,Ochoa; Benjamin Lawrence,0,0,0,0
1653530831696,CSE 258,A01,090129,McAuley; Julian John,0,0,0,0
1653530832218,CSE 258R,A01,090131,McAuley; Julian John,0,0,0,0
1653530832741,CSE 274,A00,090132,Ramamoorthi; Ravi,0,0,0,0
1653530833266,CSE 276A,A00,090133,Christensen; Henrik I,0,0,0,0
1653530833793,CSE 276C,A00,090134,Christensen; Henrik I,0,0,0,0
1653530834337,CSE 290,A00,090135,Bafna; Vineet,0,0,0,0
1653530834337,CSE 290,B00,090136,Ramamoorthi; Ravi,0,0,0,0
1653530834337,CSE 290,C00,090137,Li; Tzumao,8,0,10,2
1653530834337,CSE 290,D00,090138,Zhou; Yuan-Yuan,9,0,10,1
1653530834337,CSE 290,E00,090139,Christensen; Henrik I,9,0,10,1
1653530834337,CSE 290,F00,094053,Shalev; Aaron D,0,0,0,0
1653530834859,CSE 291,A00,090140,Munyaka; Imani N. S.,0,0,0,0
1653530834859,CSE 291,B00,094880,Yu; Qi,0,0,0,0
1653530834859,CSE 291,C00,090142,Pannuto; Patrick William,0,0,0,0
1653530834859,CSE 291,D00,094881,Zhang; Yiying,0,0,0,0
1653530834859,CSE 291,E00,095118,Su; Hao,0,0,0,0
1653530835407,CSE 293,001,094905,Bafna; Vineet,9999,0,9999,0
1653530835407,CSE 293,002,094906,Bellare; Mihir,9999,0,9999,0
1653530835407,CSE 293,003,094907,Berg-Kirkpatrick; Taylor D,9999,0,9999,0
1653530835407,CSE 293,004,094908,Christensen; Henrik I,9999,0,9999,0
1653530835407,CSE 293,005,094909,Cottrell; Garrison W,9999,0,9999,0
1653530835407,CSE 293,006,094910,Deutsch; Alin Bernard,9999,0,9999,0
1653530835407,CSE 293,007,094911,Esmaeilzadeh; Hadi,9999,0,9999,0
1653530835407,CSE 293,008,094912,Freund; Yoav,9999,0,9999,0
1653530835407,CSE 293,009,094913,Griswold; William G.,9999,0,9999,0
1653530835407,CSE 293,010,094914,Gymrek; Melissa Ann,9999,0,9999,0
1653530835407,CSE 293,011,094915,Heninger; Nadia A,9999,0,9999,0
1653530835407,CSE 293,012,094916,Impagliazzo; Russell,9999,0,9999,0
1653530835407,CSE 293,013,094917,Jhala; Ranjit,9999,0,9999,0
1653530835407,CSE 293,014,094918,Kahng; Andrew Byun,9999,0,9999,0
1653530835407,CSE 293,015,094919,Kane; Daniel Mertz,9999,0,9999,0
1653530835407,CSE 293,016,094920,Kriegman; David J,9999,0,9999,0
1653530835407,CSE 293,017,094921,Kumar; Arun Kumar,9999,0,9999,0
1653530835407,CSE 293,018,094922,Lerner; Sorin,9999,0,9999,0
1653530835407,CSE 293,019,094923,Lovett; Shachar,9999,0,9999,0
1653530835407,CSE 293,020,094924,McAuley; Julian John,9999,0,9999,0
1653530835407,CSE 293,021,094925,Micciancio; Daniele,9999,0,9999,0
1653530835407,CSE 293,022,094926,Orailoglu; Alex,9999,0,9999,0
1653530835407,CSE 293,023,094927,Paturi; Ramamohan,9999,0,9999,0
1653530835407,CSE 293,024,094928,Polikarpova; Nadezhda,9999,0,9999,0
1653530835407,CSE 293,025,094929,Politz; Joseph Gibbs,9999,0,9999,0
1653530835407,CSE 293,026,094930,Porter; George M,9999,0,9999,0
1653530835407,CSE 293,027,094931,Porter; Leonard Emerson,9999,0,9999,0
1653530835407,CSE 293,028,094932,Ramamoorthi; Ravi,9999,0,9999,0
1653530835407,CSE 293,029,094933,Sahoo; Debashis,9999,0,9999,0
1653530835407,CSE 293,030,094934,Saul; Lawrence,9999,0,9999,0
1653530835407,CSE 293,031,094935,Savage; Stefan,9999,0,9999,0
1653530835407,CSE 293,032,094936,Schulze; Jurgen P.,9999,0,9999,0
1653530835407,CSE 293,033,094937,Snoeren; Alex C.,9999,0,9999,0
1653530835407,CSE 293,034,094938,Shang; Jingbo,9999,0,9999,0
1653530835407,CSE 293,035,094939,Stefan; Deian,9999,0,9999,0
1653530835407,CSE 293,036,094940,Su; Hao,9999,0,9999,0
1653530835407,CSE 293,037,094941,Swanson; Steven James,9999,0,9999,0
1653530835407,CSE 293,038,094942,Tullsen; Dean Michael,9999,0,9999,0
1653530835407,CSE 293,039,094943,Voelker; Geoffrey M.,9999,0,9999,0
1653530835407,CSE 293,040,094944,Zhao; Jishen,9999,0,9999,0
1653530835407,CSE 293,041,094945,Zhou; Yuan-Yuan,9999,0,9999,0
1653530835407,CSE 293,042,094946,Gao; Sicun,9998,0,9999,1
1653530835407,CSE 293,043,094947,Weibel; Nadir,9999,0,9999,0
1653530835407,CSE 293,044,094948,Gupta; Rajesh K.,9999,0,9999,0
1653530835931,CSE 294,A00,090143,Porter; George M,8,0,10,2
1653530836454,DSE 200,A00,091799,Staff,50,0,50,0
1653530836983,DSE 203,A00,091800,Gupta; Amarnath,30,0,30,0
1653530837505,DSE 250,A00,091801,Deutsch; Alin Bernard,30,0,30,0
1653530838105,DSE 290,A00,091802,Altintas De Callaf; Ilkay,50,0,50,0
1653530838660,ECE 200,001,091003,Antipa; Nicholas A,9999,0,9999,0
1653530838660,ECE 200,002,091004,Atanasov; Nikolay A.,9999,0,9999,0
1653530838660,ECE 200,003,091005,Bharadia; Dinesh,9999,0,9999,0
1653530838660,ECE 200,004,091006,Cheng; Chung Kuan,9999,0,9999,0
1653530838660,ECE 200,005,091007,Cosman; Pamela C.,9999,0,9999,0
1653530838660,ECE 200,006,091008,Staff,9999,0,9999,0
1653530838660,ECE 200,007,091009,Dayeh; Shadi Ahmad,9999,0,9999,0
1653530838660,ECE 200,008,091010,Fainman; Yeshaiahu,9999,0,9999,0
1653530838660,ECE 200,009,091011,Ford; Joseph Earl,9999,0,9999,0
1653530838660,ECE 200,010,091012,Franceschetti; Massimo,9999,0,9999,0
1653530838660,ECE 200,011,091013,Fullerton; Eric E,9999,0,9999,0
1653530838660,ECE 200,012,091014,Galton; Ian A,9999,0,9999,0
1653530838660,ECE 200,013,091015,Gilja; Vikash,9999,0,9999,0
1653530838660,ECE 200,014,091016,Hall; Drew A.,9999,0,9999,0
1653530838660,ECE 200,015,091017,Hsueh; Tzu-Chien,9999,0,9999,0
1653530838660,ECE 200,016,091018,Javidi; Tara,9999,0,9999,0
1653530838660,ECE 200,017,091019,Kahng; Andrew Byun,9999,0,9999,0
1653530838660,ECE 200,018,091020,Kim; Young-Han,9999,0,9999,0
1653530838660,ECE 200,019,091021,Koushanfar; Farinaz,9999,0,9999,0
1653530838660,ECE 200,020,091022,Kuzum; Duygu,9999,0,9999,0
1653530838660,ECE 200,021,091023,Le; Hanh-Phuc,9999,0,9999,0
1653530838660,ECE 200,022,091024,Lin; Bill,9999,0,9999,0
1653530838660,ECE 200,023,091025,Liu; Zhaowei,9999,0,9999,0
1653530838660,ECE 200,024,091026,Lo; Yu-Hwa,9999,0,9999,0
1653530838660,ECE 200,025,091027,Lomakin; Vitaliy,9999,0,9999,0
1653530838660,ECE 200,026,091028,Mercier; Patrick Philip,9999,0,9999,0
1653530838660,ECE 200,027,091029,Meyer; Florian,9999,0,9999,0
1653530838660,ECE 200,028,091030,Milstein; Laurence B.,9999,0,9999,0
1653530838660,ECE 200,029,091031,Mir Arabbaygi; Siavash,9999,0,9999,0
1653530838660,ECE 200,030,091032,Mookherjea; Shayan,9999,0,9999,0
1653530838660,ECE 200,031,091033,Morris; Karcher William,9999,0,9999,0
1653530838660,ECE 200,032,091034,Ng; Tse Nga,9999,0,9999,0
1653530838660,ECE 200,033,091035,Nguyen; Truong Quang,9999,0,9999,0
1653530838660,ECE 200,034,091036,Nomura; Kenji,9999,0,9999,0
1653530838660,ECE 200,035,091037,Orlitsky; Alon,9999,0,9999,0
1653530838660,ECE 200,036,091038,Pal; Piya,9999,0,9999,0
1653530838660,ECE 200,037,091039,Papen; George C.,9999,0,9999,0
1653530838660,ECE 200,038,091040,Radic; Stojan,9999,0,9999,0
1653530838660,ECE 200,039,091041,Rao; Bhaskar D.,9999,0,9999,0
1653530838660,ECE 200,040,091042,Rao; Ramesh R,9999,0,9999,0
1653530838660,ECE 200,041,091043,Rebeiz; Gabriel,9999,0,9999,0
1653530838660,ECE 200,042,091044,Sanford; John R,9999,0,9999,0
1653530838660,ECE 200,043,091045,Siegel; Paul H.,9999,0,9999,0
1653530838660,ECE 200,044,091046,Sievenpiper; Daniel F.,9999,0,9999,0
1653530838660,ECE 200,045,091047,Sworder; David D.,9999,0,9999,0
1653530838660,ECE 200,046,091048,Taur; Yuan,9999,0,9999,0
1653530838660,ECE 200,047,091049,Touri; Behrouz,9999,0,9999,0
1653530838660,ECE 200,048,091050,Trivedi; Mohan M.,9999,0,9999,0
1653530838660,ECE 200,049,091051,Vardy; Alexander,9999,0,9999,0
1653530838660,ECE 200,050,091052,Vasconcelos; Nuno,9999,0,9999,0
1653530838660,ECE 200,051,091053,Wang; Xiaolong,9999,0,9999,0
1653530838660,ECE 200,052,091054,Xie; Pengtao,9999,0,9999,0
1653530838660,ECE 200,053,091055,Yip; Michael,9999,0,9999,0
1653530838660,ECE 200,054,091056,Zeger; Kenneth A.,9999,0,9999,0
1653530838660,ECE 200,055,091057,Zhang; Xinyu,9999,0,9999,0
1653530838660,ECE 200,056,091058,Turakhia; Yatish Girish,9999,0,9999,0
1653530838660,ECE 200,057,091059,Kang; Mingu,9999,0,9999,0
1653530838660,ECE 200,058,091060,Shi; Yuanyuan,9999,0,9999,0
1653530838660,ECE 200,059,091061,Wang; Edward Jay,9999,0,9999,0
1653530838660,ECE 200,060,091062,Zheng; Yang,9999,0,9999,0
1653530839184,ECE 201,A00,095526,Lo; Yu-Hwa,0,0,0,0
1653530839711,ECE 203,A00,091065,Mercier; Patrick Philip,0,0,0,0
1653530840240,ECE 207A,A00,091605,Liu; Thomas Tao-Ming,0,0,0,0
1653530840766,ECE 212AN,A00,091068,Nomura; Kenji,0,0,0,0
1653530841296,ECE 222A,A00,091069,Rebeiz; Gabriel,0,0,0,0
1653530841819,ECE 225A,A00,091070,Orlitsky; Alon,0,0,0,0
1653530842341,ECE 230A,A00,091071,Nomura; Kenji,0,0,0,0
1653530842868,ECE 236A,A00,091072,Dayeh; Shadi Ahmad,0,0,0,0
1653530843395,ECE 238A,A00,091073,Luo; Jian,0,0,0,0
1653530843395,ECE 238A,B00,091074,Luo; Jian,0,0,0,0
1653530843921,ECE 240A,A00,091075,Radic; Stojan,0,0,0,0
1653530844447,ECE 247A,A00,091592,Shi; Lingyan,0,0,0,0
1653530844974,ECE 250,A00,091076,Touri; Behrouz,0,0,0,0
1653530845498,ECE 251C,A00,091078,Nguyen; Truong Quang,0,0,0,0
1653530846023,ECE 253,A00,091079,Cosman; Pamela C.,0,0,0,0
1653530846549,ECE 255A,A00,091080,Orlitsky; Alon,0,0,0,0
1653530847077,ECE 257A,A00,091081,Zhang; Xinyu,0,0,0,0
1653530847600,ECE 260A,A01,091084,Eldon; John,0,0,0,0
1653530848130,ECE 264C,A00,091085,Galton; Ian A,0,0,0,0
1653530848662,ECE 265C,A00,094889,Presti; Calogero Davide,0,0,0,9
1653530849191,ECE 266,A01,091087,Hall; Drew A.,0,0,0,0
1653530850271,ECE 271A,A00,091090,Vasconcelos; Nuno,0,0,0,0
1653530850795,ECE 272B,A00,091091,Sworder; David D.,0,0,0,0
1653530851320,ECE 275A,A00,091092,Meyer; Florian,0,0,0,0
1653530851842,ECE 277,A00,091093,An; Cheolhong,0,0,0,0
1653530852374,ECE 283,A00,091094,Le; Hanh-Phuc,0,0,0,0
1653530852901,ECE 284,A00,091095,Kang; Mingu,0,0,0,0
1653530852901,ECE 284,B00,091096,Wang; Edward Jay,0,0,0,0
1653530853424,ECE 285,A00,094334,Touri; Behrouz,0,0,0,0
1653530853966,ECE 289,A00,091097,Whelan; David Arthur,0,0,0,0
1653530854502,MATH 200A,A00,087414,Salehi Golsefidy; Alireza,7,0,8,1
1653530855025,MATH 202A,A00,087415,Gill; Philip E.,2,0,8,6
1653530855550,MATH 203A,A00,087416,Oprea; Dragos N.,6,0,8,2
1653530856073,MATH 204A,A00,087417,Kedlaya; Kiran S.,6,0,8,2
1653530856608,MATH 205,A00,087418,Sorensen; Claus M,6,0,8,2
1653530857137,MATH 206A,A00,087419,Izadi; Elham,7,0,8,1
1653530857660,MATH 207A,A00,087420,Mohammadi; Amir,5,0,8,3
1653530858183,MATH 208,A00,087421,Staff,9,0,10,1
1653530858727,MATH 209,A00,087422,Staff,10,0,10,0
1653530859250,MATH 218,A00,087423,Staff,10,0,10,0
1653530859776,MATH 220A,A00,087424,Novak; Jonathan I,7,0,8,1
1653530860299,MATH 231A,A00,087425,Bejenaru; Ioan,3,0,8,5
1653530860824,MATH 240A,A00,087426,Ebenfelt; Peter F,5,0,8,3
1653530861348,MATH 243,A00,087427,Staff,9,0,10,1
1653530861872,MATH 248,A00,087429,Staff,10,0,10,0
1653530862398,MATH 250A,A00,087430,Spolaor; Luca,4,0,8,4
1653530862925,MATH 257A,A00,087431,Spolaor; Luca,7,0,8,1
1653530863448,MATH 258,A00,087432,Staff,9,0,10,1
1653530863971,MATH 264A,A00,087433,Warnke; Lutz Peter,5,0,8,3
1653530864496,MATH 268,A00,087434,Staff,15,0,15,0
1653530865028,MATH 269,A00,087435,Staff,14,0,15,1
1653530865553,MATH 270A,A00,087436,Nie; Jiawang,0,0,8,8
1653530866078,MATH 272A,A00,087437,Tian; Xiaochuan,1,0,8,7
1653530866601,MATH 274,A01,087439,Cheng; Li-Tien,9,0,10,1
1653530866601,MATH 274,A02,087440,Cheng; Li-Tien,10,0,10,0
1653530867122,MATH 278A,A00,087441,Staff,8,0,10,2
1653530867643,MATH 278B,A00,087442,Staff,8,0,10,2
1653530868166,MATH 278C,A00,087443,Staff,8,0,10,2
1653530868693,MATH 280A,A00,087444,Zheng; Tianyi,0,0,8,8
1653530869218,MATH 281A,A00,087445,Bradic; Jelena,0,0,8,8
1653530869740,MATH 282A,A00,087446,Zhang; Danna,0,0,8,8
1653530870278,MATH 283,A00,087447,Tesler; Glenn,0,0,0,15
1653530870803,MATH 286,A00,087448,Kemp; Todd Aahron,5,0,8,3
1653530871327,MATH 287D,A00,087449,Bradic; Jelena,0,0,0,0
1653530871852,MATH 288,A00,087450,Staff,14,0,15,1
1653530871852,MATH 288,B00,087451,Staff,15,0,15,0
1653530871852,MATH 288,C00,087452,Staff,15,0,15,0
1653530872377,MATH 290A,A00,087453,Xu; Zhouli,6,0,8,2
1653530872899,MATH 291A,A00,087454,Xu; Zhouli,7,0,8,1
1653530873423,MATH 292,A00,087455,Staff,10,0,10,0
1653530873945,MATH 295,A00,087456,Staff,50,0,50,0
1653530874468,MATH 297,001,087457,Staff,998,0,999,1
1653531445539,COGS 200,A01,087991,Staff,47,0,50,3
1653531446062,COGS 201,A01,094504,Rangel; Lara M,17,0,25,8
1653531446585,COGS 203,A00,087992,Coulson; Seana M,18,0,20,2
1653531447111,COGS 210A,001,087993,Greene; Deanna Jacquelyn,9998,0,9999,1
1653531447111,COGS 210A,002,087994,Saygin; Ayse P,9999,0,9999,0
1653531447111,COGS 210A,003,087995,Xia; Haijun,9999,0,9999,0
1653531447111,COGS 210A,004,087996,Nitz; Douglas A.,9999,0,9999,0
1653531447111,COGS 210A,005,087997,Hollan; James D.,9999,0,9999,0
1653531447111,COGS 210A,006,087998,Deak; Gedeon O.,9998,0,9999,1
1653531447111,COGS 210A,007,087999,Rossano; Federico,9999,0,9999,0
1653531447644,COGS 211A,A00,088000,Coulson; Seana M,9997,0,9999,2
1653531448166,COGS 229,A00,088002,Staff,23,0,25,2
1653531448689,COGS 260,B00,094231,Staff,17,0,20,3
1653531448689,COGS 260,A00,088004,Nitz; Douglas A.,9998,0,9999,1
1653531449215,CSE 202,A00,090110,Paturi; Ramamohan,0,0,0,0
1653531449215,CSE 202,B00,090111,Paturi; Ramamohan,0,0,0,0
1653531449739,CSE 207B,A00,090112,Heninger; Nadia A,0,0,0,0
1653531450265,CSE 208,A00,094858,Micciancio; Daniele,0,0,0,0
1653531450801,CSE 210,A00,090113,Powell; Thomas Allan,0,0,0,0
1653531451323,CSE 219,A00,090898,Staff,0,0,0,0
1653531451850,CSE 221,A00,090114,Zhou; Yuan-Yuan,0,0,0,0
1653531452381,CSE 229A,A00,090115,Porter; George M,0,0,0,0
1653531452921,CSE 229C,A00,090116,Savage; Stefan,0,0,0,0
1653531453454,CSE 230,A00,090117,Jhala; Ranjit,0,0,0,0
1653531453986,CSE 232,A00,090118,Papakonstantinou; Yannis,0,0,0,0
1653531454508,CSE 239A,A00,090121,Kumar; Arun Kumar,0,0,0,0
1653531455034,CSE 239B,A00,090122,Jhala; Ranjit,0,0,0,0
1653531455557,CSE 240A,A00,090123,Zhao; Jishen,0,0,189,189
1653531456080,CSE 243A,A00,090124,Orailoglu; Alex,0,0,15,15
1653531456603,CSE 249B,A00,090125,Kahng; Andrew Byun,13,0,20,7
1653531457128,CSE 250A,A00,090126,Berg-Kirkpatrick; Taylor D,0,0,0,0
1653531457653,CSE 252A,A00,090127,Ochoa; Benjamin Lawrence,0,0,0,0
1653531458176,CSE 258,A01,090129,McAuley; Julian John,0,0,0,0
1653531458703,CSE 258R,A01,090131,McAuley; Julian John,0,0,0,0
1653531459226,CSE 274,A00,090132,Ramamoorthi; Ravi,0,0,0,0
1653531459761,CSE 276A,A00,090133,Christensen; Henrik I,0,0,0,0
1653531460290,CSE 276C,A00,090134,Christensen; Henrik I,0,0,0,0
1653531460816,CSE 290,A00,090135,Bafna; Vineet,0,0,0,0
1653531460816,CSE 290,B00,090136,Ramamoorthi; Ravi,0,0,0,0
1653531460816,CSE 290,C00,090137,Li; Tzumao,8,0,10,2
1653531460816,CSE 290,D00,090138,Zhou; Yuan-Yuan,9,0,10,1
1653531460816,CSE 290,E00,090139,Christensen; Henrik I,9,0,10,1
1653531460816,CSE 290,F00,094053,Shalev; Aaron D,0,0,0,0
1653531461343,CSE 291,A00,090140,Munyaka; Imani N. S.,0,0,0,0
1653531461343,CSE 291,B00,094880,Yu; Qi,0,0,0,0
1653531461343,CSE 291,C00,090142,Pannuto; Patrick William,0,0,0,0
1653531461343,CSE 291,D00,094881,Zhang; Yiying,0,0,0,0
1653531461343,CSE 291,E00,095118,Su; Hao,0,0,0,0
1653531461877,CSE 293,001,094905,Bafna; Vineet,9999,0,9999,0
1653531461877,CSE 293,002,094906,Bellare; Mihir,9999,0,9999,0
1653531461877,CSE 293,003,094907,Berg-Kirkpatrick; Taylor D,9999,0,9999,0
1653531461877,CSE 293,004,094908,Christensen; Henrik I,9999,0,9999,0
1653531461877,CSE 293,005,094909,Cottrell; Garrison W,9999,0,9999,0
1653531461877,CSE 293,006,094910,Deutsch; Alin Bernard,9999,0,9999,0
1653531461877,CSE 293,007,094911,Esmaeilzadeh; Hadi,9999,0,9999,0
1653531461877,CSE 293,008,094912,Freund; Yoav,9999,0,9999,0
1653531461877,CSE 293,009,094913,Griswold; William G.,9999,0,9999,0
1653531461877,CSE 293,010,094914,Gymrek; Melissa Ann,9999,0,9999,0
1653531461877,CSE 293,011,094915,Heninger; Nadia A,9999,0,9999,0
1653531461877,CSE 293,012,094916,Impagliazzo; Russell,9999,0,9999,0
1653531461877,CSE 293,013,094917,Jhala; Ranjit,9999,0,9999,0
1653531461877,CSE 293,014,094918,Kahng; Andrew Byun,9999,0,9999,0
1653531461877,CSE 293,015,094919,Kane; Daniel Mertz,9999,0,9999,0
1653531461877,CSE 293,016,094920,Kriegman; David J,9999,0,9999,0
1653531461877,CSE 293,017,094921,Kumar; Arun Kumar,9999,0,9999,0
1653531461877,CSE 293,018,094922,Lerner; Sorin,9999,0,9999,0
1653531461877,CSE 293,019,094923,Lovett; Shachar,9999,0,9999,0
1653531461877,CSE 293,020,094924,McAuley; Julian John,9999,0,9999,0
1653531461877,CSE 293,021,094925,Micciancio; Daniele,9999,0,9999,0
1653531461877,CSE 293,022,094926,Orailoglu; Alex,9999,0,9999,0
1653531461877,CSE 293,023,094927,Paturi; Ramamohan,9999,0,9999,0
1653531461877,CSE 293,024,094928,Polikarpova; Nadezhda,9999,0,9999,0
1653531461877,CSE 293,025,094929,Politz; Joseph Gibbs,9999,0,9999,0
1653531461877,CSE 293,026,094930,Porter; George M,9999,0,9999,0
1653531461877,CSE 293,027,094931,Porter; Leonard Emerson,9999,0,9999,0
1653531461877,CSE 293,028,094932,Ramamoorthi; Ravi,9999,0,9999,0
1653531461877,CSE 293,029,094933,Sahoo; Debashis,9999,0,9999,0
1653531461877,CSE 293,030,094934,Saul; Lawrence,9999,0,9999,0
1653531461877,CSE 293,031,094935,Savage; Stefan,9999,0,9999,0
1653531461877,CSE 293,032,094936,Schulze; Jurgen P.,9999,0,9999,0
1653531461877,CSE 293,033,094937,Snoeren; Alex C.,9999,0,9999,0
1653531461877,CSE 293,034,094938,Shang; Jingbo,9999,0,9999,0
1653531461877,CSE 293,035,094939,Stefan; Deian,9999,0,9999,0
1653531461877,CSE 293,036,094940,Su; Hao,9999,0,9999,0
1653531461877,CSE 293,037,094941,Swanson; Steven James,9999,0,9999,0
1653531461877,CSE 293,038,094942,Tullsen; Dean Michael,9999,0,9999,0
1653531461877,CSE 293,039,094943,Voelker; Geoffrey M.,9999,0,9999,0
1653531461877,CSE 293,040,094944,Zhao; Jishen,9999,0,9999,0
1653531461877,CSE 293,041,094945,Zhou; Yuan-Yuan,9999,0,9999,0
1653531461877,CSE 293,042,094946,Gao; Sicun,9998,0,9999,1
1653531461877,CSE 293,043,094947,Weibel; Nadir,9999,0,9999,0
1653531461877,CSE 293,044,094948,Gupta; Rajesh K.,9999,0,9999,0
1653531462399,CSE 294,A00,090143,Porter; George M,8,0,10,2
1653531462931,DSE 200,A00,091799,Staff,50,0,50,0
1653531463454,DSE 203,A00,091800,Gupta; Amarnath,30,0,30,0
1653531463979,DSE 250,A00,091801,Deutsch; Alin Bernard,30,0,30,0
1653531464507,DSE 290,A00,091802,Altintas De Callaf; Ilkay,50,0,50,0
1653531465054,ECE 200,001,091003,Antipa; Nicholas A,9999,0,9999,0
1653531465054,ECE 200,002,091004,Atanasov; Nikolay A.,9999,0,9999,0
1653531465054,ECE 200,003,091005,Bharadia; Dinesh,9999,0,9999,0
1653531465054,ECE 200,004,091006,Cheng; Chung Kuan,9999,0,9999,0
1653531465054,ECE 200,005,091007,Cosman; Pamela C.,9999,0,9999,0
1653531465054,ECE 200,006,091008,Staff,9999,0,9999,0
1653531465054,ECE 200,007,091009,Dayeh; Shadi Ahmad,9999,0,9999,0
1653531465054,ECE 200,008,091010,Fainman; Yeshaiahu,9999,0,9999,0
1653531465054,ECE 200,009,091011,Ford; Joseph Earl,9999,0,9999,0
1653531465054,ECE 200,010,091012,Franceschetti; Massimo,9999,0,9999,0
1653531465054,ECE 200,011,091013,Fullerton; Eric E,9999,0,9999,0
1653531465054,ECE 200,012,091014,Galton; Ian A,9999,0,9999,0
1653531465054,ECE 200,013,091015,Gilja; Vikash,9999,0,9999,0
1653531465054,ECE 200,014,091016,Hall; Drew A.,9999,0,9999,0
1653531465054,ECE 200,015,091017,Hsueh; Tzu-Chien,9999,0,9999,0
1653531465054,ECE 200,016,091018,Javidi; Tara,9999,0,9999,0
1653531465054,ECE 200,017,091019,Kahng; Andrew Byun,9999,0,9999,0
1653531465054,ECE 200,018,091020,Kim; Young-Han,9999,0,9999,0
1653531465054,ECE 200,019,091021,Koushanfar; Farinaz,9999,0,9999,0
1653531465054,ECE 200,020,091022,Kuzum; Duygu,9999,0,9999,0
1653531465054,ECE 200,021,091023,Le; Hanh-Phuc,9999,0,9999,0
1653531465054,ECE 200,022,091024,Lin; Bill,9999,0,9999,0
1653531465054,ECE 200,023,091025,Liu; Zhaowei,9999,0,9999,0
1653531465054,ECE 200,024,091026,Lo; Yu-Hwa,9999,0,9999,0
1653531465054,ECE 200,025,091027,Lomakin; Vitaliy,9999,0,9999,0
1653531465054,ECE 200,026,091028,Mercier; Patrick Philip,9999,0,9999,0
1653531465054,ECE 200,027,091029,Meyer; Florian,9999,0,9999,0
1653531465054,ECE 200,028,091030,Milstein; Laurence B.,9999,0,9999,0
1653531465054,ECE 200,029,091031,Mir Arabbaygi; Siavash,9999,0,9999,0
1653531465054,ECE 200,030,091032,Mookherjea; Shayan,9999,0,9999,0
1653531465054,ECE 200,031,091033,Morris; Karcher William,9999,0,9999,0
1653531465054,ECE 200,032,091034,Ng; Tse Nga,9999,0,9999,0
1653531465054,ECE 200,033,091035,Nguyen; Truong Quang,9999,0,9999,0
1653531465054,ECE 200,034,091036,Nomura; Kenji,9999,0,9999,0
1653531465054,ECE 200,035,091037,Orlitsky; Alon,9999,0,9999,0
1653531465054,ECE 200,036,091038,Pal; Piya,9999,0,9999,0
1653531465054,ECE 200,037,091039,Papen; George C.,9999,0,9999,0
1653531465054,ECE 200,038,091040,Radic; Stojan,9999,0,9999,0
1653531465054,ECE 200,039,091041,Rao; Bhaskar D.,9999,0,9999,0
1653531465054,ECE 200,040,091042,Rao; Ramesh R,9999,0,9999,0
1653531465054,ECE 200,041,091043,Rebeiz; Gabriel,9999,0,9999,0
1653531465054,ECE 200,042,091044,Sanford; John R,9999,0,9999,0
1653531465054,ECE 200,043,091045,Siegel; Paul H.,9999,0,9999,0
1653531465054,ECE 200,044,091046,Sievenpiper; Daniel F.,9999,0,9999,0
1653531465054,ECE 200,045,091047,Sworder; David D.,9999,0,9999,0
1653531465054,ECE 200,046,091048,Taur; Yuan,9999,0,9999,0
1653531465054,ECE 200,047,091049,Touri; Behrouz,9999,0,9999,0
1653531465054,ECE 200,048,091050,Trivedi; Mohan M.,9999,0,9999,0
1653531465054,ECE 200,049,091051,Vardy; Alexander,9999,0,9999,0
1653531465054,ECE 200,050,091052,Vasconcelos; Nuno,9999,0,9999,0
1653531465054,ECE 200,051,091053,Wang; Xiaolong,9999,0,9999,0
1653531465054,ECE 200,052,091054,Xie; Pengtao,9999,0,9999,0
1653531465054,ECE 200,053,091055,Yip; Michael,9999,0,9999,0
1653531465054,ECE 200,054,091056,Zeger; Kenneth A.,9999,0,9999,0
1653531465054,ECE 200,055,091057,Zhang; Xinyu,9999,0,9999,0
1653531465054,ECE 200,056,091058,Turakhia; Yatish Girish,9999,0,9999,0
1653531465054,ECE 200,057,091059,Kang; Mingu,9999,0,9999,0
1653531465054,ECE 200,058,091060,Shi; Yuanyuan,9999,0,9999,0
1653531465054,ECE 200,059,091061,Wang; Edward Jay,9999,0,9999,0
1653531465054,ECE 200,060,091062,Zheng; Yang,9999,0,9999,0
1653531465579,ECE 201,A00,095526,Lo; Yu-Hwa,0,0,0,0
1653531466109,ECE 203,A00,091065,Mercier; Patrick Philip,0,0,0,0
1653531466638,ECE 207A,A00,091605,Liu; Thomas Tao-Ming,0,0,0,0
1653531467163,ECE 212AN,A00,091068,Nomura; Kenji,0,0,0,0
1653531467689,ECE 222A,A00,091069,Rebeiz; Gabriel,0,0,0,0
1653531468216,ECE 225A,A00,091070,Orlitsky; Alon,0,0,0,0
1653531468739,ECE 230A,A00,091071,Nomura; Kenji,0,0,0,0
1653531469265,ECE 236A,A00,091072,Dayeh; Shadi Ahmad,0,0,0,0
1653531469788,ECE 238A,A00,091073,Luo; Jian,0,0,0,0
1653531469788,ECE 238A,B00,091074,Luo; Jian,0,0,0,0
1653531470310,ECE 240A,A00,091075,Radic; Stojan,0,0,0,0
1653531470831,ECE 247A,A00,091592,Shi; Lingyan,0,0,0,0
1653531471358,ECE 250,A00,091076,Touri; Behrouz,0,0,0,0
1653531471891,ECE 251C,A00,091078,Nguyen; Truong Quang,0,0,0,0
1653531472416,ECE 253,A00,091079,Cosman; Pamela C.,0,0,0,0
1653531472940,ECE 255A,A00,091080,Orlitsky; Alon,0,0,0,0
1653531473464,ECE 257A,A00,091081,Zhang; Xinyu,0,0,0,0
1653531473988,ECE 260A,A01,091084,Eldon; John,0,0,0,0
1653531474524,ECE 264C,A00,091085,Galton; Ian A,0,0,0,0
1653531475046,ECE 265C,A00,094889,Presti; Calogero Davide,0,0,0,9
1653531475569,ECE 266,A01,091087,Hall; Drew A.,0,0,0,0
1653531476624,ECE 271A,A00,091090,Vasconcelos; Nuno,0,0,0,0
1653531477154,ECE 272B,A00,091091,Sworder; David D.,0,0,0,0
1653531477682,ECE 275A,A00,091092,Meyer; Florian,0,0,0,0
1653531478210,ECE 277,A00,091093,An; Cheolhong,0,0,0,0
1653531478733,ECE 283,A00,091094,Le; Hanh-Phuc,0,0,0,0
1653531479271,ECE 284,A00,091095,Kang; Mingu,0,0,0,0
1653531479271,ECE 284,B00,091096,Wang; Edward Jay,0,0,0,0
1653531479796,ECE 285,A00,094334,Touri; Behrouz,0,0,0,0
1653531480329,ECE 289,A00,091097,Whelan; David Arthur,0,0,0,0
1653531480857,MATH 200A,A00,087414,Salehi Golsefidy; Alireza,7,0,8,1
1653531481383,MATH 202A,A00,087415,Gill; Philip E.,2,0,8,6
1653531481911,MATH 203A,A00,087416,Oprea; Dragos N.,6,0,8,2
1653531482433,MATH 204A,A00,087417,Kedlaya; Kiran S.,6,0,8,2
1653531482956,MATH 205,A00,087418,Sorensen; Claus M,6,0,8,2
1653531483480,MATH 206A,A00,087419,Izadi; Elham,7,0,8,1
1653531484017,MATH 207A,A00,087420,Mohammadi; Amir,5,0,8,3
1653531484546,MATH 208,A00,087421,Staff,9,0,10,1
1653531485072,MATH 209,A00,087422,Staff,10,0,10,0
1653531485593,MATH 218,A00,087423,Staff,10,0,10,0
1653531486115,MATH 220A,A00,087424,Novak; Jonathan I,7,0,8,1
1653531486639,MATH 231A,A00,087425,Bejenaru; Ioan,3,0,8,5
1653531487161,MATH 240A,A00,087426,Ebenfelt; Peter F,5,0,8,3
1653531487682,MATH 243,A00,087427,Staff,9,0,10,1
1653531488212,MATH 248,A00,087429,Staff,10,0,10,0
1653531488748,MATH 250A,A00,087430,Spolaor; Luca,4,0,8,4
1653531489270,MATH 257A,A00,087431,Spolaor; Luca,7,0,8,1
1653531489865,MATH 258,A00,087432,Staff,9,0,10,1
1653531490399,MATH 264A,A00,087433,Warnke; Lutz Peter,5,0,8,3
1653531490924,MATH 268,A00,087434,Staff,15,0,15,0
1653531491446,MATH 269,A00,087435,Staff,14,0,15,1
1653531491969,MATH 270A,A00,087436,Nie; Jiawang,0,0,8,8
1653531492497,MATH 272A,A00,087437,Tian; Xiaochuan,1,0,8,7
1653531493021,MATH 274,A01,087439,Cheng; Li-Tien,9,0,10,1
1653531493021,MATH 274,A02,087440,Cheng; Li-Tien,10,0,10,0
1653531493548,MATH 278A,A00,087441,Staff,8,0,10,2
1653531494074,MATH 278B,A00,087442,Staff,8,0,10,2
1653531494597,MATH 278C,A00,087443,Staff,8,0,10,2
1653531495122,MATH 280A,A00,087444,Zheng; Tianyi,0,0,8,8
1653531495644,MATH 281A,A00,087445,Bradic; Jelena,0,0,8,8
1653531496169,MATH 282A,A00,087446,Zhang; Danna,0,0,8,8
1653531496696,MATH 283,A00,087447,Tesler; Glenn,0,0,0,15
1653531497218,MATH 286,A00,087448,Kemp; Todd Aahron,5,0,8,3
1653531497756,MATH 287D,A00,087449,Bradic; Jelena,0,0,0,0
1653531498279,MATH 288,A00,087450,Staff,14,0,15,1
1653531498279,MATH 288,B00,087451,Staff,15,0,15,0
1653531498279,MATH 288,C00,087452,Staff,15,0,15,0
1653531498814,MATH 290A,A00,087453,Xu; Zhouli,6,0,8,2
1653531499337,MATH 291A,A00,087454,Xu; Zhouli,7,0,8,1
1653531499863,MATH 292,A00,087455,Staff,10,0,10,0
1653531500388,MATH 295,A00,087456,Staff,50,0,50,0
1653531500913,MATH 297,001,087457,Staff,998,0,999,1
1653532060495,COGS 200,A01,087991,Staff,47,0,50,3
1653532061017,COGS 201,A01,094504,Rangel; Lara M,17,0,25,8
1653532061547,COGS 203,A00,087992,Coulson; Seana M,18,0,20,2
1653532062075,COGS 210A,001,087993,Greene; Deanna Jacquelyn,9998,0,9999,1
1653532062075,COGS 210A,002,087994,Saygin; Ayse P,9999,0,9999,0
1653532062075,COGS 210A,003,087995,Xia; Haijun,9999,0,9999,0
1653532062075,COGS 210A,004,087996,Nitz; Douglas A.,9999,0,9999,0
1653532062075,COGS 210A,005,087997,Hollan; James D.,9999,0,9999,0
1653532062075,COGS 210A,006,087998,Deak; Gedeon O.,9998,0,9999,1
1653532062075,COGS 210A,007,087999,Rossano; Federico,9999,0,9999,0
1653532062598,COGS 211A,A00,088000,Coulson; Seana M,9997,0,9999,2
1653532063120,COGS 229,A00,088002,Staff,23,0,25,2
1653532063648,COGS 260,B00,094231,Staff,17,0,20,3
1653532063648,COGS 260,A00,088004,Nitz; Douglas A.,9998,0,9999,1
1653532064172,CSE 202,A00,090110,Paturi; Ramamohan,0,0,0,0
1653532064172,CSE 202,B00,090111,Paturi; Ramamohan,0,0,0,0
1653532064698,CSE 207B,A00,090112,Heninger; Nadia A,0,0,0,0
1653532065220,CSE 208,A00,094858,Micciancio; Daniele,0,0,0,0
1653532065743,CSE 210,A00,090113,Powell; Thomas Allan,0,0,0,0
1653532066269,CSE 219,A00,090898,Staff,0,0,0,0
1653532066792,CSE 221,A00,090114,Zhou; Yuan-Yuan,0,0,0,0
1653532067315,CSE 229A,A00,090115,Porter; George M,0,0,0,0
1653532067836,CSE 229C,A00,090116,Savage; Stefan,0,0,0,0
1653532068359,CSE 230,A00,090117,Jhala; Ranjit,0,0,0,0
1653532068881,CSE 232,A00,090118,Papakonstantinou; Yannis,0,0,0,0
1653532069410,CSE 239A,A00,090121,Kumar; Arun Kumar,0,0,0,0
1653532069935,CSE 239B,A00,090122,Jhala; Ranjit,0,0,0,0
1653532070457,CSE 240A,A00,090123,Zhao; Jishen,0,0,189,189
1653532070983,CSE 243A,A00,090124,Orailoglu; Alex,0,0,15,15
1653532071516,CSE 249B,A00,090125,Kahng; Andrew Byun,13,0,20,7
1653532072039,CSE 250A,A00,090126,Berg-Kirkpatrick; Taylor D,0,0,0,0
1653532072568,CSE 252A,A00,090127,Ochoa; Benjamin Lawrence,0,0,0,0
1653532073092,CSE 258,A01,090129,McAuley; Julian John,0,0,0,0
1653532073615,CSE 258R,A01,090131,McAuley; Julian John,0,0,0,0
1653532074139,CSE 274,A00,090132,Ramamoorthi; Ravi,0,0,0,0
1653532074671,CSE 276A,A00,090133,Christensen; Henrik I,0,0,0,0
1653532075210,CSE 276C,A00,090134,Christensen; Henrik I,0,0,0,0
1653532075738,CSE 290,A00,090135,Bafna; Vineet,0,0,0,0
1653532075738,CSE 290,B00,090136,Ramamoorthi; Ravi,0,0,0,0
1653532075738,CSE 290,C00,090137,Li; Tzumao,8,0,10,2
1653532075738,CSE 290,D00,090138,Zhou; Yuan-Yuan,9,0,10,1
1653532075738,CSE 290,E00,090139,Christensen; Henrik I,9,0,10,1
1653532075738,CSE 290,F00,094053,Shalev; Aaron D,0,0,0,0
1653532076262,CSE 291,A00,090140,Munyaka; Imani N. S.,0,0,0,0
1653532076262,CSE 291,B00,094880,Yu; Qi,0,0,0,0
1653532076262,CSE 291,C00,090142,Pannuto; Patrick William,0,0,0,0
1653532076262,CSE 291,D00,094881,Zhang; Yiying,0,0,0,0
1653532076262,CSE 291,E00,095118,Su; Hao,0,0,0,0
1653532076897,CSE 293,001,094905,Bafna; Vineet,9999,0,9999,0
1653532076897,CSE 293,002,094906,Bellare; Mihir,9999,0,9999,0
1653532076897,CSE 293,003,094907,Berg-Kirkpatrick; Taylor D,9999,0,9999,0
1653532076897,CSE 293,004,094908,Christensen; Henrik I,9999,0,9999,0
1653532076897,CSE 293,005,094909,Cottrell; Garrison W,9999,0,9999,0
1653532076897,CSE 293,006,094910,Deutsch; Alin Bernard,9999,0,9999,0
1653532076897,CSE 293,007,094911,Esmaeilzadeh; Hadi,9999,0,9999,0
1653532076897,CSE 293,008,094912,Freund; Yoav,9999,0,9999,0
1653532076897,CSE 293,009,094913,Griswold; William G.,9999,0,9999,0
1653532076897,CSE 293,010,094914,Gymrek; Melissa Ann,9999,0,9999,0
1653532076897,CSE 293,011,094915,Heninger; Nadia A,9999,0,9999,0
1653532076897,CSE 293,012,094916,Impagliazzo; Russell,9999,0,9999,0
1653532076897,CSE 293,013,094917,Jhala; Ranjit,9999,0,9999,0
1653532076897,CSE 293,014,094918,Kahng; Andrew Byun,9999,0,9999,0
1653532076897,CSE 293,015,094919,Kane; Daniel Mertz,9999,0,9999,0
1653532076897,CSE 293,016,094920,Kriegman; David J,9999,0,9999,0
1653532076897,CSE 293,017,094921,Kumar; Arun Kumar,9999,0,9999,0
1653532076897,CSE 293,018,094922,Lerner; Sorin,9999,0,9999,0
1653532076897,CSE 293,019,094923,Lovett; Shachar,9999,0,9999,0
1653532076897,CSE 293,020,094924,McAuley; Julian John,9999,0,9999,0
1653532076897,CSE 293,021,094925,Micciancio; Daniele,9999,0,9999,0
1653532076897,CSE 293,022,094926,Orailoglu; Alex,9999,0,9999,0
1653532076897,CSE 293,023,094927,Paturi; Ramamohan,9999,0,9999,0
1653532076897,CSE 293,024,094928,Polikarpova; Nadezhda,9999,0,9999,0
1653532076897,CSE 293,025,094929,Politz; Joseph Gibbs,9999,0,9999,0
1653532076897,CSE 293,026,094930,Porter; George M,9999,0,9999,0
1653532076897,CSE 293,027,094931,Porter; Leonard Emerson,9999,0,9999,0
1653532076897,CSE 293,028,094932,Ramamoorthi; Ravi,9999,0,9999,0
1653532076897,CSE 293,029,094933,Sahoo; Debashis,9999,0,9999,0
1653532076897,CSE 293,030,094934,Saul; Lawrence,9999,0,9999,0
1653532076897,CSE 293,031,094935,Savage; Stefan,9999,0,9999,0
1653532076897,CSE 293,032,094936,Schulze; Jurgen P.,9999,0,9999,0
1653532076897,CSE 293,033,094937,Snoeren; Alex C.,9999,0,9999,0
1653532076897,CSE 293,034,094938,Shang; Jingbo,9999,0,9999,0
1653532076897,CSE 293,035,094939,Stefan; Deian,9999,0,9999,0
1653532076897,CSE 293,036,094940,Su; Hao,9999,0,9999,0
1653532076897,CSE 293,037,094941,Swanson; Steven James,9999,0,9999,0
1653532076897,CSE 293,038,094942,Tullsen; Dean Michael,9999,0,9999,0
1653532076897,CSE 293,039,094943,Voelker; Geoffrey M.,9999,0,9999,0
1653532076897,CSE 293,040,094944,Zhao; Jishen,9999,0,9999,0
1653532076897,CSE 293,041,094945,Zhou; Yuan-Yuan,9999,0,9999,0
1653532076897,CSE 293,042,094946,Gao; Sicun,9998,0,9999,1
1653532076897,CSE 293,043,094947,Weibel; Nadir,9999,0,9999,0
1653532076897,CSE 293,044,094948,Gupta; Rajesh K.,9999,0,9999,0
1653532077424,CSE 294,A00,090143,Porter; George M,8,0,10,2
1653532077947,DSE 200,A00,091799,Staff,50,0,50,0
1653532078470,DSE 203,A00,091800,Gupta; Amarnath,30,0,30,0
1653532078992,DSE 250,A00,091801,Deutsch; Alin Bernard,30,0,30,0
1653532079515,DSE 290,A00,091802,Altintas De Callaf; Ilkay,50,0,50,0
1653532080048,ECE 200,001,091003,Antipa; Nicholas A,9999,0,9999,0
1653532080048,ECE 200,002,091004,Atanasov; Nikolay A.,9999,0,9999,0
1653532080048,ECE 200,003,091005,Bharadia; Dinesh,9999,0,9999,0
1653532080048,ECE 200,004,091006,Cheng; Chung Kuan,9999,0,9999,0
1653532080048,ECE 200,005,091007,Cosman; Pamela C.,9999,0,9999,0
1653532080048,ECE 200,006,091008,Staff,9999,0,9999,0
1653532080048,ECE 200,007,091009,Dayeh; Shadi Ahmad,9999,0,9999,0
1653532080048,ECE 200,008,091010,Fainman; Yeshaiahu,9999,0,9999,0
1653532080048,ECE 200,009,091011,Ford; Joseph Earl,9999,0,9999,0
1653532080048,ECE 200,010,091012,Franceschetti; Massimo,9999,0,9999,0
1653532080048,ECE 200,011,091013,Fullerton; Eric E,9999,0,9999,0
1653532080048,ECE 200,012,091014,Galton; Ian A,9999,0,9999,0
1653532080048,ECE 200,013,091015,Gilja; Vikash,9999,0,9999,0
1653532080048,ECE 200,014,091016,Hall; Drew A.,9999,0,9999,0
1653532080048,ECE 200,015,091017,Hsueh; Tzu-Chien,9999,0,9999,0
1653532080048,ECE 200,016,091018,Javidi; Tara,9999,0,9999,0
1653532080048,ECE 200,017,091019,Kahng; Andrew Byun,9999,0,9999,0
1653532080048,ECE 200,018,091020,Kim; Young-Han,9999,0,9999,0
1653532080048,ECE 200,019,091021,Koushanfar; Farinaz,9999,0,9999,0
1653532080048,ECE 200,020,091022,Kuzum; Duygu,9999,0,9999,0
1653532080048,ECE 200,021,091023,Le; Hanh-Phuc,9999,0,9999,0
1653532080048,ECE 200,022,091024,Lin; Bill,9999,0,9999,0
1653532080048,ECE 200,023,091025,Liu; Zhaowei,9999,0,9999,0
1653532080048,ECE 200,024,091026,Lo; Yu-Hwa,9999,0,9999,0
1653532080048,ECE 200,025,091027,Lomakin; Vitaliy,9999,0,9999,0
1653532080048,ECE 200,026,091028,Mercier; Patrick Philip,9999,0,9999,0
1653532080048,ECE 200,027,091029,Meyer; Florian,9999,0,9999,0
1653532080048,ECE 200,028,091030,Milstein; Laurence B.,9999,0,9999,0
1653532080048,ECE 200,029,091031,Mir Arabbaygi; Siavash,9999,0,9999,0
1653532080048,ECE 200,030,091032,Mookherjea; Shayan,9999,0,9999,0
1653532080048,ECE 200,031,091033,Morris; Karcher William,9999,0,9999,0
1653532080048,ECE 200,032,091034,Ng; Tse Nga,9999,0,9999,0
1653532080048,ECE 200,033,091035,Nguyen; Truong Quang,9999,0,9999,0
1653532080048,ECE 200,034,091036,Nomura; Kenji,9999,0,9999,0
1653532080048,ECE 200,035,091037,Orlitsky; Alon,9999,0,9999,0
1653532080048,ECE 200,036,091038,Pal; Piya,9999,0,9999,0
1653532080048,ECE 200,037,091039,Papen; George C.,9999,0,9999,0
1653532080048,ECE 200,038,091040,Radic; Stojan,9999,0,9999,0
1653532080048,ECE 200,039,091041,Rao; Bhaskar D.,9999,0,9999,0
1653532080048,ECE 200,040,091042,Rao; Ramesh R,9999,0,9999,0
1653532080048,ECE 200,041,091043,Rebeiz; Gabriel,9999,0,9999,0
1653532080048,ECE 200,042,091044,Sanford; John R,9999,0,9999,0
1653532080048,ECE 200,043,091045,Siegel; Paul H.,9999,0,9999,0
1653532080048,ECE 200,044,091046,Sievenpiper; Daniel F.,9999,0,9999,0
1653532080048,ECE 200,045,091047,Sworder; David D.,9999,0,9999,0
1653532080048,ECE 200,046,091048,Taur; Yuan,9999,0,9999,0
1653532080048,ECE 200,047,091049,Touri; Behrouz,9999,0,9999,0
1653532080048,ECE 200,048,091050,Trivedi; Mohan M.,9999,0,9999,0
1653532080048,ECE 200,049,091051,Vardy; Alexander,9999,0,9999,0
1653532080048,ECE 200,050,091052,Vasconcelos; Nuno,9999,0,9999,0
1653532080048,ECE 200,051,091053,Wang; Xiaolong,9999,0,9999,0
1653532080048,ECE 200,052,091054,Xie; Pengtao,9999,0,9999,0
1653532080048,ECE 200,053,091055,Yip; Michael,9999,0,9999,0
1653532080048,ECE 200,054,091056,Zeger; Kenneth A.,9999,0,9999,0
1653532080048,ECE 200,055,091057,Zhang; Xinyu,9999,0,9999,0
1653532080048,ECE 200,056,091058,Turakhia; Yatish Girish,9999,0,9999,0
1653532080048,ECE 200,057,091059,Kang; Mingu,9999,0,9999,0
1653532080048,ECE 200,058,091060,Shi; Yuanyuan,9999,0,9999,0
1653532080048,ECE 200,059,091061,Wang; Edward Jay,9999,0,9999,0
1653532080048,ECE 200,060,091062,Zheng; Yang,9999,0,9999,0
1653532080580,ECE 201,A00,095526,Lo; Yu-Hwa,0,0,0,0
1653532081105,ECE 203,A00,091065,Mercier; Patrick Philip,0,0,0,0
1653532081627,ECE 207A,A00,091605,Liu; Thomas Tao-Ming,0,0,0,0
1653532082148,ECE 212AN,A00,091068,Nomura; Kenji,0,0,0,0
1653532082671,ECE 222A,A00,091069,Rebeiz; Gabriel,0,0,0,0
1653532083196,ECE 225A,A00,091070,Orlitsky; Alon,0,0,0,0
1653532083721,ECE 230A,A00,091071,Nomura; Kenji,0,0,0,0
1653532084269,ECE 236A,A00,091072,Dayeh; Shadi Ahmad,0,0,0,0
1653532084795,ECE 238A,A00,091073,Luo; Jian,0,0,0,0
1653532084795,ECE 238A,B00,091074,Luo; Jian,0,0,0,0
1653532085319,ECE 240A,A00,091075,Radic; Stojan,0,0,0,0
1653532085843,ECE 247A,A00,091592,Shi; Lingyan,0,0,0,0
1653532086368,ECE 250,A00,091076,Touri; Behrouz,0,0,0,0
1653532086892,ECE 251C,A00,091078,Nguyen; Truong Quang,0,0,0,0
1653532087416,ECE 253,A00,091079,Cosman; Pamela C.,0,0,0,0
1653532087942,ECE 255A,A00,091080,Orlitsky; Alon,0,0,0,0
1653532088464,ECE 257A,A00,091081,Zhang; Xinyu,0,0,0,0
1653532088987,ECE 260A,A01,091084,Eldon; John,0,0,0,0
1653532089514,ECE 264C,A00,091085,Galton; Ian A,0,0,0,0
1653532090039,ECE 265C,A00,094889,Presti; Calogero Davide,0,0,0,9
1653532090566,ECE 266,A01,091087,Hall; Drew A.,0,0,0,0
1653532091618,ECE 271A,A00,091090,Vasconcelos; Nuno,0,0,0,0
1653532092139,ECE 272B,A00,091091,Sworder; David D.,0,0,0,0
1653532092663,ECE 275A,A00,091092,Meyer; Florian,0,0,0,0
1653532093189,ECE 277,A00,091093,An; Cheolhong,0,0,0,0
1653532093713,ECE 283,A00,091094,Le; Hanh-Phuc,0,0,0,0
1653532094242,ECE 284,A00,091095,Kang; Mingu,0,0,0,0
1653532094242,ECE 284,B00,091096,Wang; Edward Jay,0,0,0,0
1653532094771,ECE 285,A00,094334,Touri; Behrouz,0,0,0,0
1653532095294,ECE 289,A00,091097,Whelan; David Arthur,0,0,0,0
1653532095817,MATH 200A,A00,087414,Salehi Golsefidy; Alireza,7,0,8,1
1653532096343,MATH 202A,A00,087415,Gill; Philip E.,2,0,8,6
1653532096866,MATH 203A,A00,087416,Oprea; Dragos N.,6,0,8,2
1653532097388,MATH 204A,A00,087417,Kedlaya; Kiran S.,6,0,8,2
1653532097911,MATH 205,A00,087418,Sorensen; Claus M,6,0,8,2
1653532098434,MATH 206A,A00,087419,Izadi; Elham,7,0,8,1
1653532098957,MATH 207A,A00,087420,Mohammadi; Amir,5,0,8,3
1653532099485,MATH 208,A00,087421,Staff,9,0,10,1
1653532100008,MATH 209,A00,087422,Staff,10,0,10,0
1653532100533,MATH 218,A00,087423,Staff,10,0,10,0
1653532101055,MATH 220A,A00,087424,Novak; Jonathan I,7,0,8,1
1653532101579,MATH 231A,A00,087425,Bejenaru; Ioan,3,0,8,5
1653532102106,MATH 240A,A00,087426,Ebenfelt; Peter F,5,0,8,3
1653532102630,MATH 243,A00,087427,Staff,9,0,10,1
1653532103156,MATH 248,A00,087429,Staff,10,0,10,0
1653532103678,MATH 250A,A00,087430,Spolaor; Luca,4,0,8,4
1653532104199,MATH 257A,A00,087431,Spolaor; Luca,7,0,8,1
1653532104725,MATH 258,A00,087432,Staff,9,0,10,1
1653532105251,MATH 264A,A00,087433,Warnke; Lutz Peter,5,0,8,3
1653532105775,MATH 268,A00,087434,Staff,15,0,15,0
1653532106301,MATH 269,A00,087435,Staff,14,0,15,1
1653532106827,MATH 270A,A00,087436,Nie; Jiawang,0,0,8,8
1653532107352,MATH 272A,A00,087437,Tian; Xiaochuan,1,0,8,7
1653532107880,MATH 274,A01,087439,Cheng; Li-Tien,9,0,10,1
1653532107880,MATH 274,A02,087440,Cheng; Li-Tien,10,0,10,0
1653532108409,MATH 278A,A00,087441,Staff,8,0,10,2
1653532108934,MATH 278B,A00,087442,Staff,8,0,10,2
1653532109460,MATH 278C,A00,087443,Staff,8,0,10,2
1653532109995,MATH 280A,A00,087444,Zheng; Tianyi,0,0,8,8
1653532110529,MATH 281A,A00,087445,Bradic; Jelena,0,0,8,8
1653532111063,MATH 282A,A00,087446,Zhang; Danna,0,0,8,8
1653532111586,MATH 283,A00,087447,Tesler; Glenn,0,0,0,15
1653532112109,MATH 286,A00,087448,Kemp; Todd Aahron,5,0,8,3
1653532112634,MATH 287D,A00,087449,Bradic; Jelena,0,0,0,0
1653532113156,MATH 288,A00,087450,Staff,14,0,15,1
1653532113156,MATH 288,B00,087451,Staff,15,0,15,0
1653532113156,MATH 288,C00,087452,Staff,15,0,15,0
1653532113681,MATH 290A,A00,087453,Xu; Zhouli,6,0,8,2
1653532114203,MATH 291A,A00,087454,Xu; Zhouli,7,0,8,1
1653532114733,MATH 292,A00,087455,Staff,10,0,10,0
1653532115255,MATH 295,A00,087456,Staff,50,0,50,0
1653532115776,MATH 297,001,087457,Staff,998,0,999,1
1653532675232,COGS 200,A01,087991,Staff,47,0,50,3
1653532675761,COGS 201,A01,094504,Rangel; Lara M,17,0,25,8
1653532676284,COGS 203,A00,087992,Coulson; Seana M,18,0,20,2
1653532676816,COGS 210A,001,087993,Greene; Deanna Jacquelyn,9998,0,9999,1
1653532676816,COGS 210A,002,087994,Saygin; Ayse P,9999,0,9999,0
1653532676816,COGS 210A,003,087995,Xia; Haijun,9999,0,9999,0
1653532676816,COGS 210A,004,087996,Nitz; Douglas A.,9999,0,9999,0
1653532676816,COGS 210A,005,087997,Hollan; James D.,9999,0,9999,0
1653532676816,COGS 210A,006,087998,Deak; Gedeon O.,9998,0,9999,1
1653532676816,COGS 210A,007,087999,Rossano; Federico,9999,0,9999,0
1653532677338,COGS 211A,A00,088000,Coulson; Seana M,9997,0,9999,2
1653532677860,COGS 229,A00,088002,Staff,23,0,25,2
1653532678383,COGS 260,B00,094231,Staff,17,0,20,3
1653532678383,COGS 260,A00,088004,Nitz; Douglas A.,9998,0,9999,1
1653532678909,CSE 202,A00,090110,Paturi; Ramamohan,0,0,0,0
1653532678909,CSE 202,B00,090111,Paturi; Ramamohan,0,0,0,0
1653532679440,CSE 207B,A00,090112,Heninger; Nadia A,0,0,0,0
1653532679964,CSE 208,A00,094858,Micciancio; Daniele,0,0,0,0
1653532680488,CSE 210,A00,090113,Powell; Thomas Allan,0,0,0,0
1653532681013,CSE 219,A00,090898,Staff,0,0,0,0
1653532681539,CSE 221,A00,090114,Zhou; Yuan-Yuan,0,0,0,0
1653532682063,CSE 229A,A00,090115,Porter; George M,0,0,0,0
1653532682602,CSE 229C,A00,090116,Savage; Stefan,0,0,0,0
1653532683133,CSE 230,A00,090117,Jhala; Ranjit,0,0,0,0
1653532683656,CSE 232,A00,090118,Papakonstantinou; Yannis,0,0,0,0
1653532684178,CSE 239A,A00,090121,Kumar; Arun Kumar,0,0,0,0
1653532684700,CSE 239B,A00,090122,Jhala; Ranjit,0,0,0,0
1653532685223,CSE 240A,A00,090123,Zhao; Jishen,0,0,189,189
1653532685745,CSE 243A,A00,090124,Orailoglu; Alex,0,0,15,15
1653532686268,CSE 249B,A00,090125,Kahng; Andrew Byun,13,0,20,7
1653532686798,CSE 250A,A00,090126,Berg-Kirkpatrick; Taylor D,0,0,0,0
1653532687324,CSE 252A,A00,090127,Ochoa; Benjamin Lawrence,0,0,0,0
1653532687853,CSE 258,A01,090129,McAuley; Julian John,0,0,0,0
1653532688376,CSE 258R,A01,090131,McAuley; Julian John,0,0,0,0
1653532688902,CSE 274,A00,090132,Ramamoorthi; Ravi,0,0,0,0
1653532689427,CSE 276A,A00,090133,Christensen; Henrik I,0,0,0,0
1653532689951,CSE 276C,A00,090134,Christensen; Henrik I,0,0,0,0
1653532690474,CSE 290,A00,090135,Bafna; Vineet,0,0,0,0
1653532690474,CSE 290,B00,090136,Ramamoorthi; Ravi,0,0,0,0
1653532690474,CSE 290,C00,090137,Li; Tzumao,8,0,10,2
1653532690474,CSE 290,D00,090138,Zhou; Yuan-Yuan,9,0,10,1
1653532690474,CSE 290,E00,090139,Christensen; Henrik I,8,0,10,2
1653532690474,CSE 290,F00,094053,Shalev; Aaron D,0,0,0,0
1653532691012,CSE 291,A00,090140,Munyaka; Imani N. S.,0,0,0,0
1653532691012,CSE 291,B00,094880,Yu; Qi,0,0,0,0
1653532691012,CSE 291,C00,090142,Pannuto; Patrick William,0,0,0,0
1653532691012,CSE 291,D00,094881,Zhang; Yiying,0,0,0,0
1653532691012,CSE 291,E00,095118,Su; Hao,0,0,0,0
1653532691598,CSE 293,001,094905,Bafna; Vineet,9999,0,9999,0
1653532691598,CSE 293,002,094906,Bellare; Mihir,9999,0,9999,0
1653532691598,CSE 293,003,094907,Berg-Kirkpatrick; Taylor D,9999,0,9999,0
1653532691598,CSE 293,004,094908,Christensen; Henrik I,9999,0,9999,0
1653532691598,CSE 293,005,094909,Cottrell; Garrison W,9999,0,9999,0
1653532691598,CSE 293,006,094910,Deutsch; Alin Bernard,9999,0,9999,0
1653532691598,CSE 293,007,094911,Esmaeilzadeh; Hadi,9999,0,9999,0
1653532691598,CSE 293,008,094912,Freund; Yoav,9999,0,9999,0
1653532691598,CSE 293,009,094913,Griswold; William G.,9999,0,9999,0
1653532691598,CSE 293,010,094914,Gymrek; Melissa Ann,9999,0,9999,0
1653532691598,CSE 293,011,094915,Heninger; Nadia A,9999,0,9999,0
1653532691598,CSE 293,012,094916,Impagliazzo; Russell,9999,0,9999,0
1653532691598,CSE 293,013,094917,Jhala; Ranjit,9999,0,9999,0
1653532691598,CSE 293,014,094918,Kahng; Andrew Byun,9999,0,9999,0
1653532691598,CSE 293,015,094919,Kane; Daniel Mertz,9999,0,9999,0
1653532691598,CSE 293,016,094920,Kriegman; David J,9999,0,9999,0
1653532691598,CSE 293,017,094921,Kumar; Arun Kumar,9999,0,9999,0
1653532691598,CSE 293,018,094922,Lerner; Sorin,9999,0,9999,0
1653532691598,CSE 293,019,094923,Lovett; Shachar,9999,0,9999,0
1653532691598,CSE 293,020,094924,McAuley; Julian John,9999,0,9999,0
1653532691598,CSE 293,021,094925,Micciancio; Daniele,9999,0,9999,0
1653532691598,CSE 293,022,094926,Orailoglu; Alex,9999,0,9999,0
1653532691598,CSE 293,023,094927,Paturi; Ramamohan,9999,0,9999,0
1653532691598,CSE 293,024,094928,Polikarpova; Nadezhda,9999,0,9999,0
1653532691598,CSE 293,025,094929,Politz; Joseph Gibbs,9999,0,9999,0
1653532691598,CSE 293,026,094930,Porter; George M,9999,0,9999,0
1653532691598,CSE 293,027,094931,Porter; Leonard Emerson,9999,0,9999,0
1653532691598,CSE 293,028,094932,Ramamoorthi; Ravi,9999,0,9999,0
1653532691598,CSE 293,029,094933,Sahoo; Debashis,9999,0,9999,0
1653532691598,CSE 293,030,094934,Saul; Lawrence,9999,0,9999,0
1653532691598,CSE 293,031,094935,Savage; Stefan,9999,0,9999,0
1653532691598,CSE 293,032,094936,Schulze; Jurgen P.,9999,0,9999,0
1653532691598,CSE 293,033,094937,Snoeren; Alex C.,9999,0,9999,0
1653532691598,CSE 293,034,094938,Shang; Jingbo,9999,0,9999,0
1653532691598,CSE 293,035,094939,Stefan; Deian,9999,0,9999,0
1653532691598,CSE 293,036,094940,Su; Hao,9999,0,9999,0
1653532691598,CSE 293,037,094941,Swanson; Steven James,9999,0,9999,0
1653532691598,CSE 293,038,094942,Tullsen; Dean Michael,9999,0,9999,0
1653532691598,CSE 293,039,094943,Voelker; Geoffrey M.,9999,0,9999,0
1653532691598,CSE 293,040,094944,Zhao; Jishen,9999,0,9999,0
1653532691598,CSE 293,041,094945,Zhou; Yuan-Yuan,9999,0,9999,0
1653532691598,CSE 293,042,094946,Gao; Sicun,9998,0,9999,1
1653532691598,CSE 293,043,094947,Weibel; Nadir,9999,0,9999,0
1653532691598,CSE 293,044,094948,Gupta; Rajesh K.,9999,0,9999,0
1653532692121,CSE 294,A00,090143,Porter; George M,8,0,10,2
1653532692649,DSE 200,A00,091799,Staff,50,0,50,0
1653532693175,DSE 203,A00,091800,Gupta; Amarnath,30,0,30,0
1653532693710,DSE 250,A00,091801,Deutsch; Alin Bernard,30,0,30,0
1653532694242,DSE 290,A00,091802,Altintas De Callaf; Ilkay,50,0,50,0
1653532694777,ECE 200,001,091003,Antipa; Nicholas A,9999,0,9999,0
1653532694777,ECE 200,002,091004,Atanasov; Nikolay A.,9999,0,9999,0
1653532694777,ECE 200,003,091005,Bharadia; Dinesh,9999,0,9999,0
1653532694777,ECE 200,004,091006,Cheng; Chung Kuan,9999,0,9999,0
1653532694777,ECE 200,005,091007,Cosman; Pamela C.,9999,0,9999,0
1653532694777,ECE 200,006,091008,Staff,9999,0,9999,0
1653532694777,ECE 200,007,091009,Dayeh; Shadi Ahmad,9999,0,9999,0
1653532694777,ECE 200,008,091010,Fainman; Yeshaiahu,9999,0,9999,0
1653532694777,ECE 200,009,091011,Ford; Joseph Earl,9999,0,9999,0
1653532694777,ECE 200,010,091012,Franceschetti; Massimo,9999,0,9999,0
1653532694777,ECE 200,011,091013,Fullerton; Eric E,9999,0,9999,0
1653532694777,ECE 200,012,091014,Galton; Ian A,9999,0,9999,0
1653532694777,ECE 200,013,091015,Gilja; Vikash,9999,0,9999,0
1653532694777,ECE 200,014,091016,Hall; Drew A.,9999,0,9999,0
1653532694777,ECE 200,015,091017,Hsueh; Tzu-Chien,9999,0,9999,0
1653532694777,ECE 200,016,091018,Javidi; Tara,9999,0,9999,0
1653532694777,ECE 200,017,091019,Kahng; Andrew Byun,9999,0,9999,0
1653532694777,ECE 200,018,091020,Kim; Young-Han,9999,0,9999,0
1653532694777,ECE 200,019,091021,Koushanfar; Farinaz,9999,0,9999,0
1653532694777,ECE 200,020,091022,Kuzum; Duygu,9999,0,9999,0
1653532694777,ECE 200,021,091023,Le; Hanh-Phuc,9999,0,9999,0
1653532694777,ECE 200,022,091024,Lin; Bill,9999,0,9999,0
1653532694777,ECE 200,023,091025,Liu; Zhaowei,9999,0,9999,0
1653532694777,ECE 200,024,091026,Lo; Yu-Hwa,9999,0,9999,0
1653532694777,ECE 200,025,091027,Lomakin; Vitaliy,9999,0,9999,0
1653532694777,ECE 200,026,091028,Mercier; Patrick Philip,9999,0,9999,0
1653532694777,ECE 200,027,091029,Meyer; Florian,9999,0,9999,0
1653532694777,ECE 200,028,091030,Milstein; Laurence B.,9999,0,9999,0
1653532694777,ECE 200,029,091031,Mir Arabbaygi; Siavash,9999,0,9999,0
1653532694777,ECE 200,030,091032,Mookherjea; Shayan,9999,0,9999,0
1653532694777,ECE 200,031,091033,Morris; Karcher William,9999,0,9999,0
1653532694777,ECE 200,032,091034,Ng; Tse Nga,9999,0,9999,0
1653532694777,ECE 200,033,091035,Nguyen; Truong Quang,9999,0,9999,0
1653532694777,ECE 200,034,091036,Nomura; Kenji,9999,0,9999,0
1653532694777,ECE 200,035,091037,Orlitsky; Alon,9999,0,9999,0
1653532694777,ECE 200,036,091038,Pal; Piya,9999,0,9999,0
1653532694777,ECE 200,037,091039,Papen; George C.,9999,0,9999,0
1653532694777,ECE 200,038,091040,Radic; Stojan,9999,0,9999,0
1653532694777,ECE 200,039,091041,Rao; Bhaskar D.,9999,0,9999,0
1653532694777,ECE 200,040,091042,Rao; Ramesh R,9999,0,9999,0
1653532694777,ECE 200,041,091043,Rebeiz; Gabriel,9999,0,9999,0
1653532694777,ECE 200,042,091044,Sanford; John R,9999,0,9999,0
1653532694777,ECE 200,043,091045,Siegel; Paul H.,9999,0,9999,0
1653532694777,ECE 200,044,091046,Sievenpiper; Daniel F.,9999,0,9999,0
1653532694777,ECE 200,045,091047,Sworder; David D.,9999,0,9999,0
1653532694777,ECE 200,046,091048,Taur; Yuan,9999,0,9999,0
1653532694777,ECE 200,047,091049,Touri; Behrouz,9999,0,9999,0
1653532694777,ECE 200,048,091050,Trivedi; Mohan M.,9999,0,9999,0
1653532694777,ECE 200,049,091051,Vardy; Alexander,9999,0,9999,0
1653532694777,ECE 200,050,091052,Vasconcelos; Nuno,9999,0,9999,0
1653532694777,ECE 200,051,091053,Wang; Xiaolong,9999,0,9999,0
1653532694777,ECE 200,052,091054,Xie; Pengtao,9999,0,9999,0
1653532694777,ECE 200,053,091055,Yip; Michael,9999,0,9999,0
1653532694777,ECE 200,054,091056,Zeger; Kenneth A.,9999,0,9999,0
1653532694777,ECE 200,055,091057,Zhang; Xinyu,9999,0,9999,0
1653532694777,ECE 200,056,091058,Turakhia; Yatish Girish,9999,0,9999,0
1653532694777,ECE 200,057,091059,Kang; Mingu,9999,0,9999,0
1653532694777,ECE 200,058,091060,Shi; Yuanyuan,9999,0,9999,0
1653532694777,ECE 200,059,091061,Wang; Edward Jay,9999,0,9999,0
1653532694777,ECE 200,060,091062,Zheng; Yang,9999,0,9999,0
1653532695300,ECE 201,A00,095526,Lo; Yu-Hwa,0,0,0,0
1653532695827,ECE 203,A00,091065,Mercier; Patrick Philip,0,0,0,0
1653532696366,ECE 207A,A00,091605,Liu; Thomas Tao-Ming,0,0,0,0
1653532696888,ECE 212AN,A00,091068,Nomura; Kenji,0,0,0,0
1653532697410,ECE 222A,A00,091069,Rebeiz; Gabriel,0,0,0,0
1653532697941,ECE 225A,A00,091070,Orlitsky; Alon,0,0,0,0
1653532698472,ECE 230A,A00,091071,Nomura; Kenji,0,0,0,0
1653532698998,ECE 236A,A00,091072,Dayeh; Shadi Ahmad,0,0,0,0
1653532699526,ECE 238A,A00,091073,Luo; Jian,0,0,0,0
1653532699526,ECE 238A,B00,091074,Luo; Jian,0,0,0,0
1653532700051,ECE 240A,A00,091075,Radic; Stojan,0,0,0,0
1653532700577,ECE 247A,A00,091592,Shi; Lingyan,0,0,0,0
1653532701098,ECE 250,A00,091076,Touri; Behrouz,0,0,0,0
1653532701619,ECE 251C,A00,091078,Nguyen; Truong Quang,0,0,0,0
1653532702152,ECE 253,A00,091079,Cosman; Pamela C.,0,0,0,0
1653532702691,ECE 255A,A00,091080,Orlitsky; Alon,0,0,0,0
1653532703212,ECE 257A,A00,091081,Zhang; Xinyu,0,0,0,0
1653532703739,ECE 260A,A01,091084,Eldon; John,0,0,0,0
1653532704263,ECE 264C,A00,091085,Galton; Ian A,0,0,0,0
1653532704798,ECE 265C,A00,094889,Presti; Calogero Davide,0,0,0,9
1653532705326,ECE 266,A01,091087,Hall; Drew A.,0,0,0,0
1653532706381,ECE 271A,A00,091090,Vasconcelos; Nuno,0,0,0,0
1653532706906,ECE 272B,A00,091091,Sworder; David D.,0,0,0,0
1653532707431,ECE 275A,A00,091092,Meyer; Florian,0,0,0,0
1653532707958,ECE 277,A00,091093,An; Cheolhong,0,0,0,0
1653532708481,ECE 283,A00,091094,Le; Hanh-Phuc,0,0,0,0
1653532709009,ECE 284,A00,091095,Kang; Mingu,0,0,0,0
1653532709009,ECE 284,B00,091096,Wang; Edward Jay,0,0,0,0
1653532709543,ECE 285,A00,094334,Touri; Behrouz,0,0,0,0
1653532710066,ECE 289,A00,091097,Whelan; David Arthur,0,0,0,0
1653532710592,MATH 200A,A00,087414,Salehi Golsefidy; Alireza,7,0,8,1
1653532711115,MATH 202A,A00,087415,Gill; Philip E.,2,0,8,6
1653532711641,MATH 203A,A00,087416,Oprea; Dragos N.,6,0,8,2
1653532712165,MATH 204A,A00,087417,Kedlaya; Kiran S.,6,0,8,2
1653532712688,MATH 205,A00,087418,Sorensen; Claus M,6,0,8,2
1653532713213,MATH 206A,A00,087419,Izadi; Elham,7,0,8,1
1653532713753,MATH 207A,A00,087420,Mohammadi; Amir,5,0,8,3
1653532714276,MATH 208,A00,087421,Staff,9,0,10,1
1653532714802,MATH 209,A00,087422,Staff,10,0,10,0
1653532715325,MATH 218,A00,087423,Staff,10,0,10,0
1653532715851,MATH 220A,A00,087424,Novak; Jonathan I,7,0,8,1
1653532716381,MATH 231A,A00,087425,Bejenaru; Ioan,3,0,8,5
1653532717011,MATH 240A,A00,087426,Ebenfelt; Peter F,5,0,8,3
1653532717537,MATH 243,A00,087427,Staff,9,0,10,1
1653532718060,MATH 248,A00,087429,Staff,10,0,10,0
1653532718587,MATH 250A,A00,087430,Spolaor; Luca,4,0,8,4
1653532719112,MATH 257A,A00,087431,Spolaor; Luca,7,0,8,1
1653532719636,MATH 258,A00,087432,Staff,9,0,10,1
1653532720159,MATH 264A,A00,087433,Warnke; Lutz Peter,5,0,8,3
1653532720690,MATH 268,A00,087434,Staff,15,0,15,0
1653532721215,MATH 269,A00,087435,Staff,14,0,15,1
1653532721741,MATH 270A,A00,087436,Nie; Jiawang,0,0,8,8
1653532722269,MATH 272A,A00,087437,Tian; Xiaochuan,1,0,8,7
1653532722797,MATH 274,A01,087439,Cheng; Li-Tien,9,0,10,1
1653532722797,MATH 274,A02,087440,Cheng; Li-Tien,10,0,10,0
1653532723322,MATH 278A,A00,087441,Staff,8,0,10,2
1653532723846,MATH 278B,A00,087442,Staff,8,0,10,2
1653532724369,MATH 278C,A00,087443,Staff,8,0,10,2
1653532724900,MATH 280A,A00,087444,Zheng; Tianyi,0,0,8,8
1653532725431,MATH 281A,A00,087445,Bradic; Jelena,0,0,8,8
1653532725962,MATH 282A,A00,087446,Zhang; Danna,0,0,8,8
1653532726485,MATH 283,A00,087447,Tesler; Glenn,0,0,0,15
1653532727007,MATH 286,A00,087448,Kemp; Todd Aahron,5,0,8,3
1653532727538,MATH 287D,A00,087449,Bradic; Jelena,0,0,0,0
1653532728076,MATH 288,A00,087450,Staff,14,0,15,1
1653532728076,MATH 288,B00,087451,Staff,15,0,15,0
1653532728076,MATH 288,C00,087452,Staff,15,0,15,0
1653532728609,MATH 290A,A00,087453,Xu; Zhouli,6,0,8,2
1653532729146,MATH 291A,A00,087454,Xu; Zhouli,7,0,8,1
1653532729693,MATH 292,A00,087455,Staff,10,0,10,0
1653532730215,MATH 295,A00,087456,Staff,50,0,50,0
1653532730743,MATH 297,001,087457,Staff,998,0,999,1
1653533289993,COGS 200,A01,087991,Staff,47,0,50,3
1653533290519,COGS 201,A01,094504,Rangel; Lara M,17,0,25,8
1653533291045,COGS 203,A00,087992,Coulson; Seana M,18,0,20,2
1653533291569,COGS 210A,001,087993,Greene; Deanna Jacquelyn,9998,0,9999,1
1653533291569,COGS 210A,002,087994,Saygin; Ayse P,9999,0,9999,0
1653533291569,COGS 210A,003,087995,Xia; Haijun,9999,0,9999,0
1653533291569,COGS 210A,004,087996,Nitz; Douglas A.,9999,0,9999,0
1653533291569,COGS 210A,005,087997,Hollan; James D.,9999,0,9999,0
1653533291569,COGS 210A,006,087998,Deak; Gedeon O.,9998,0,9999,1
1653533291569,COGS 210A,007,087999,Rossano; Federico,9999,0,9999,0
1653533292090,COGS 211A,A00,088000,Coulson; Seana M,9997,0,9999,2
1653533292613,COGS 229,A00,088002,Staff,23,0,25,2
1653533293137,COGS 260,B00,094231,Staff,17,0,20,3
1653533293137,COGS 260,A00,088004,Nitz; Douglas A.,9998,0,9999,1
1653533293664,CSE 202,A00,090110,Paturi; Ramamohan,0,0,0,0
1653533293664,CSE 202,B00,090111,Paturi; Ramamohan,0,0,0,0
1653533294190,CSE 207B,A00,090112,Heninger; Nadia A,0,0,0,0
1653533294712,CSE 208,A00,094858,Micciancio; Daniele,0,0,0,0
1653533295238,CSE 210,A00,090113,Powell; Thomas Allan,0,0,0,0
1653533295768,CSE 219,A00,090898,Staff,0,0,0,0
1653533296295,CSE 221,A00,090114,Zhou; Yuan-Yuan,0,0,0,0
1653533296820,CSE 229A,A00,090115,Porter; George M,0,0,0,0
1653533297345,CSE 229C,A00,090116,Savage; Stefan,0,0,0,0
1653533297867,CSE 230,A00,090117,Jhala; Ranjit,0,0,0,0
1653533298394,CSE 232,A00,090118,Papakonstantinou; Yannis,0,0,0,0
1653533298919,CSE 239A,A00,090121,Kumar; Arun Kumar,0,0,0,0
1653533299443,CSE 239B,A00,090122,Jhala; Ranjit,0,0,0,0
1653533299965,CSE 240A,A00,090123,Zhao; Jishen,0,0,189,189
1653533300487,CSE 243A,A00,090124,Orailoglu; Alex,0,0,15,15
1653533301009,CSE 249B,A00,090125,Kahng; Andrew Byun,13,0,20,7
1653533301532,CSE 250A,A00,090126,Berg-Kirkpatrick; Taylor D,0,0,0,0
1653533302054,CSE 252A,A00,090127,Ochoa; Benjamin Lawrence,0,0,0,0
1653533302580,CSE 258,A01,090129,McAuley; Julian John,0,0,0,0
1653533303102,CSE 258R,A01,090131,McAuley; Julian John,0,0,0,0
1653533303721,CSE 274,A00,090132,Ramamoorthi; Ravi,0,0,0,0
1653533304244,CSE 276A,A00,090133,Christensen; Henrik I,0,0,0,0
1653533304769,CSE 276C,A00,090134,Christensen; Henrik I,0,0,0,0
1653533305309,CSE 290,A00,090135,Bafna; Vineet,0,0,0,0
1653533305309,CSE 290,B00,090136,Ramamoorthi; Ravi,0,0,0,0
1653533305309,CSE 290,C00,090137,Li; Tzumao,8,0,10,2
1653533305309,CSE 290,D00,090138,Zhou; Yuan-Yuan,9,0,10,1
1653533305309,CSE 290,E00,090139,Christensen; Henrik I,8,0,10,2
1653533305309,CSE 290,F00,094053,Shalev; Aaron D,0,0,0,0
1653533305835,CSE 291,A00,090140,Munyaka; Imani N. S.,0,0,0,0
1653533305835,CSE 291,B00,094880,Yu; Qi,0,0,0,0
1653533305835,CSE 291,C00,090142,Pannuto; Patrick William,0,0,0,0
1653533305835,CSE 291,D00,094881,Zhang; Yiying,0,0,0,0
1653533305835,CSE 291,E00,095118,Su; Hao,0,0,0,0
1653533306379,CSE 293,001,094905,Bafna; Vineet,9999,0,9999,0
1653533306379,CSE 293,002,094906,Bellare; Mihir,9999,0,9999,0
1653533306379,CSE 293,003,094907,Berg-Kirkpatrick; Taylor D,9999,0,9999,0
1653533306379,CSE 293,004,094908,Christensen; Henrik I,9999,0,9999,0
1653533306379,CSE 293,005,094909,Cottrell; Garrison W,9999,0,9999,0
1653533306379,CSE 293,006,094910,Deutsch; Alin Bernard,9999,0,9999,0
1653533306379,CSE 293,007,094911,Esmaeilzadeh; Hadi,9999,0,9999,0
1653533306379,CSE 293,008,094912,Freund; Yoav,9999,0,9999,0
1653533306379,CSE 293,009,094913,Griswold; William G.,9999,0,9999,0
1653533306379,CSE 293,010,094914,Gymrek; Melissa Ann,9999,0,9999,0
1653533306379,CSE 293,011,094915,Heninger; Nadia A,9999,0,9999,0
1653533306379,CSE 293,012,094916,Impagliazzo; Russell,9999,0,9999,0
1653533306379,CSE 293,013,094917,Jhala; Ranjit,9999,0,9999,0
1653533306379,CSE 293,014,094918,Kahng; Andrew Byun,9999,0,9999,0
1653533306379,CSE 293,015,094919,Kane; Daniel Mertz,9999,0,9999,0
1653533306379,CSE 293,016,094920,Kriegman; David J,9999,0,9999,0
1653533306379,CSE 293,017,094921,Kumar; Arun Kumar,9999,0,9999,0
1653533306379,CSE 293,018,094922,Lerner; Sorin,9999,0,9999,0
1653533306379,CSE 293,019,094923,Lovett; Shachar,9999,0,9999,0
1653533306379,CSE 293,020,094924,McAuley; Julian John,9999,0,9999,0
1653533306379,CSE 293,021,094925,Micciancio; Daniele,9999,0,9999,0
1653533306379,CSE 293,022,094926,Orailoglu; Alex,9999,0,9999,0
1653533306379,CSE 293,023,094927,Paturi; Ramamohan,9999,0,9999,0
1653533306379,CSE 293,024,094928,Polikarpova; Nadezhda,9999,0,9999,0
1653533306379,CSE 293,025,094929,Politz; Joseph Gibbs,9999,0,9999,0
1653533306379,CSE 293,026,094930,Porter; George M,9999,0,9999,0
1653533306379,CSE 293,027,094931,Porter; Leonard Emerson,9999,0,9999,0
1653533306379,CSE 293,028,094932,Ramamoorthi; Ravi,9999,0,9999,0
1653533306379,CSE 293,029,094933,Sahoo; Debashis,9999,0,9999,0
1653533306379,CSE 293,030,094934,Saul; Lawrence,9999,0,9999,0
1653533306379,CSE 293,031,094935,Savage; Stefan,9999,0,9999,0
1653533306379,CSE 293,032,094936,Schulze; Jurgen P.,9999,0,9999,0
1653533306379,CSE 293,033,094937,Snoeren; Alex C.,9999,0,9999,0
1653533306379,CSE 293,034,094938,Shang; Jingbo,9999,0,9999,0
1653533306379,CSE 293,035,094939,Stefan; Deian,9999,0,9999,0
1653533306379,CSE 293,036,094940,Su; Hao,9999,0,9999,0
1653533306379,CSE 293,037,094941,Swanson; Steven James,9999,0,9999,0
1653533306379,CSE 293,038,094942,Tullsen; Dean Michael,9999,0,9999,0
1653533306379,CSE 293,039,094943,Voelker; Geoffrey M.,9999,0,9999,0
1653533306379,CSE 293,040,094944,Zhao; Jishen,9999,0,9999,0
1653533306379,CSE 293,041,094945,Zhou; Yuan-Yuan,9999,0,9999,0
1653533306379,CSE 293,042,094946,Gao; Sicun,9998,0,9999,1
1653533306379,CSE 293,043,094947,Weibel; Nadir,9999,0,9999,0
1653533306379,CSE 293,044,094948,Gupta; Rajesh K.,9999,0,9999,0
1653533306902,CSE 294,A00,090143,Porter; George M,8,0,10,2
1653533307425,DSE 200,A00,091799,Staff,50,0,50,0
1653533307950,DSE 203,A00,091800,Gupta; Amarnath,30,0,30,0
1653533308473,DSE 250,A00,091801,Deutsch; Alin Bernard,30,0,30,0
1653533308997,DSE 290,A00,091802,Altintas De Callaf; Ilkay,50,0,50,0
1653533309535,ECE 200,001,091003,Antipa; Nicholas A,9999,0,9999,0
1653533309535,ECE 200,002,091004,Atanasov; Nikolay A.,9999,0,9999,0
1653533309535,ECE 200,003,091005,Bharadia; Dinesh,9999,0,9999,0
1653533309535,ECE 200,004,091006,Cheng; Chung Kuan,9999,0,9999,0
1653533309535,ECE 200,005,091007,Cosman; Pamela C.,9999,0,9999,0
1653533309535,ECE 200,006,091008,Staff,9999,0,9999,0
1653533309535,ECE 200,007,091009,Dayeh; Shadi Ahmad,9999,0,9999,0
1653533309535,ECE 200,008,091010,Fainman; Yeshaiahu,9999,0,9999,0
1653533309535,ECE 200,009,091011,Ford; Joseph Earl,9999,0,9999,0
1653533309535,ECE 200,010,091012,Franceschetti; Massimo,9999,0,9999,0
1653533309535,ECE 200,011,091013,Fullerton; Eric E,9999,0,9999,0
1653533309535,ECE 200,012,091014,Galton; Ian A,9999,0,9999,0
1653533309535,ECE 200,013,091015,Gilja; Vikash,9999,0,9999,0
1653533309535,ECE 200,014,091016,Hall; Drew A.,9999,0,9999,0
1653533309535,ECE 200,015,091017,Hsueh; Tzu-Chien,9999,0,9999,0
1653533309535,ECE 200,016,091018,Javidi; Tara,9999,0,9999,0
1653533309535,ECE 200,017,091019,Kahng; Andrew Byun,9999,0,9999,0
1653533309535,ECE 200,018,091020,Kim; Young-Han,9999,0,9999,0
1653533309535,ECE 200,019,091021,Koushanfar; Farinaz,9999,0,9999,0
1653533309535,ECE 200,020,091022,Kuzum; Duygu,9999,0,9999,0
1653533309535,ECE 200,021,091023,Le; Hanh-Phuc,9999,0,9999,0
1653533309535,ECE 200,022,091024,Lin; Bill,9999,0,9999,0
1653533309535,ECE 200,023,091025,Liu; Zhaowei,9999,0,9999,0
1653533309535,ECE 200,024,091026,Lo; Yu-Hwa,9999,0,9999,0
1653533309535,ECE 200,025,091027,Lomakin; Vitaliy,9999,0,9999,0
1653533309535,ECE 200,026,091028,Mercier; Patrick Philip,9999,0,9999,0
1653533309535,ECE 200,027,091029,Meyer; Florian,9999,0,9999,0
1653533309535,ECE 200,028,091030,Milstein; Laurence B.,9999,0,9999,0
1653533309535,ECE 200,029,091031,Mir Arabbaygi; Siavash,9999,0,9999,0
1653533309535,ECE 200,030,091032,Mookherjea; Shayan,9999,0,9999,0
1653533309535,ECE 200,031,091033,Morris; Karcher William,9999,0,9999,0
1653533309535,ECE 200,032,091034,Ng; Tse Nga,9999,0,9999,0
1653533309535,ECE 200,033,091035,Nguyen; Truong Quang,9999,0,9999,0
1653533309535,ECE 200,034,091036,Nomura; Kenji,9999,0,9999,0
1653533309535,ECE 200,035,091037,Orlitsky; Alon,9999,0,9999,0
1653533309535,ECE 200,036,091038,Pal; Piya,9999,0,9999,0
1653533309535,ECE 200,037,091039,Papen; George C.,9999,0,9999,0
1653533309535,ECE 200,038,091040,Radic; Stojan,9999,0,9999,0
1653533309535,ECE 200,039,091041,Rao; Bhaskar D.,9999,0,9999,0
1653533309535,ECE 200,040,091042,Rao; Ramesh R,9999,0,9999,0
1653533309535,ECE 200,041,091043,Rebeiz; Gabriel,9999,0,9999,0
1653533309535,ECE 200,042,091044,Sanford; John R,9999,0,9999,0
1653533309535,ECE 200,043,091045,Siegel; Paul H.,9999,0,9999,0
1653533309535,ECE 200,044,091046,Sievenpiper; Daniel F.,9999,0,9999,0
1653533309535,ECE 200,045,091047,Sworder; David D.,9999,0,9999,0
1653533309535,ECE 200,046,091048,Taur; Yuan,9999,0,9999,0
1653533309535,ECE 200,047,091049,Touri; Behrouz,9999,0,9999,0
1653533309535,ECE 200,048,091050,Trivedi; Mohan M.,9999,0,9999,0
1653533309535,ECE 200,049,091051,Vardy; Alexander,9999,0,9999,0
1653533309535,ECE 200,050,091052,Vasconcelos; Nuno,9999,0,9999,0
1653533309535,ECE 200,051,091053,Wang; Xiaolong,9999,0,9999,0
1653533309535,ECE 200,052,091054,Xie; Pengtao,9999,0,9999,0
1653533309535,ECE 200,053,091055,Yip; Michael,9999,0,9999,0
1653533309535,ECE 200,054,091056,Zeger; Kenneth A.,9999,0,9999,0
1653533309535,ECE 200,055,091057,Zhang; Xinyu,9999,0,9999,0
1653533309535,ECE 200,056,091058,Turakhia; Yatish Girish,9999,0,9999,0
1653533309535,ECE 200,057,091059,Kang; Mingu,9999,0,9999,0
1653533309535,ECE 200,058,091060,Shi; Yuanyuan,9999,0,9999,0
1653533309535,ECE 200,059,091061,Wang; Edward Jay,9999,0,9999,0
1653533309535,ECE 200,060,091062,Zheng; Yang,9999,0,9999,0
1653533310058,ECE 201,A00,095526,Lo; Yu-Hwa,0,0,0,0
1653533310591,ECE 203,A00,091065,Mercier; Patrick Philip,0,0,0,0
1653533311114,ECE 207A,A00,091605,Liu; Thomas Tao-Ming,0,0,0,0
1653533311637,ECE 212AN,A00,091068,Nomura; Kenji,0,0,0,0
1653533312165,ECE 222A,A00,091069,Rebeiz; Gabriel,0,0,0,0
1653533312687,ECE 225A,A00,091070,Orlitsky; Alon,0,0,0,0
1653533313210,ECE 230A,A00,091071,Nomura; Kenji,0,0,0,0
1653533313734,ECE 236A,A00,091072,Dayeh; Shadi Ahmad,0,0,0,0
1653533314258,ECE 238A,A00,091073,Luo; Jian,0,0,0,0
1653533314258,ECE 238A,B00,091074,Luo; Jian,0,0,0,0
1653533314781,ECE 240A,A00,091075,Radic; Stojan,0,0,0,0
1653533315307,ECE 247A,A00,091592,Shi; Lingyan,0,0,0,0
1653533315844,ECE 250,A00,091076,Touri; Behrouz,0,0,0,0
1653533316371,ECE 251C,A00,091078,Nguyen; Truong Quang,0,0,0,0
1653533316897,ECE 253,A00,091079,Cosman; Pamela C.,0,0,0,0
1653533317420,ECE 255A,A00,091080,Orlitsky; Alon,0,0,0,0
1653533317943,ECE 257A,A00,091081,Zhang; Xinyu,0,0,0,0
1653533318466,ECE 260A,A01,091084,Eldon; John,0,0,0,0
1653533318989,ECE 264C,A00,091085,Galton; Ian A,0,0,0,0
1653533319516,ECE 265C,A00,094889,Presti; Calogero Davide,0,0,0,9
1653533320044,ECE 266,A01,091087,Hall; Drew A.,0,0,0,0
1653533321095,ECE 271A,A00,091090,Vasconcelos; Nuno,0,0,0,0
1653533321618,ECE 272B,A00,091091,Sworder; David D.,0,0,0,0
1653533322143,ECE 275A,A00,091092,Meyer; Florian,0,0,0,0
1653533322668,ECE 277,A00,091093,An; Cheolhong,0,0,0,0
1653533323197,ECE 283,A00,091094,Le; Hanh-Phuc,0,0,0,0
1653533323723,ECE 284,A00,091095,Kang; Mingu,0,0,0,0
1653533323723,ECE 284,B00,091096,Wang; Edward Jay,0,0,0,0
1653533324248,ECE 285,A00,094334,Touri; Behrouz,0,0,0,0
1653533324770,ECE 289,A00,091097,Whelan; David Arthur,0,0,0,0
1653533325299,MATH 200A,A00,087414,Salehi Golsefidy; Alireza,7,0,8,1
1653533325822,MATH 202A,A00,087415,Gill; Philip E.,2,0,8,6
1653533326345,MATH 203A,A00,087416,Oprea; Dragos N.,6,0,8,2
1653533326878,MATH 204A,A00,087417,Kedlaya; Kiran S.,6,0,8,2
1653533327401,MATH 205,A00,087418,Sorensen; Claus M,6,0,8,2
1653533327923,MATH 206A,A00,087419,Izadi; Elham,7,0,8,1
1653533328449,MATH 207A,A00,087420,Mohammadi; Amir,5,0,8,3
1653533328971,MATH 208,A00,087421,Staff,9,0,10,1
1653533329497,MATH 209,A00,087422,Staff,10,0,10,0
1653533330020,MATH 218,A00,087423,Staff,10,0,10,0
1653533330542,MATH 220A,A00,087424,Novak; Jonathan I,7,0,8,1
1653533331066,MATH 231A,A00,087425,Bejenaru; Ioan,3,0,8,5
1653533331592,MATH 240A,A00,087426,Ebenfelt; Peter F,5,0,8,3
1653533332114,MATH 243,A00,087427,Staff,9,0,10,1
1653533332650,MATH 248,A00,087429,Staff,10,0,10,0
1653533333173,MATH 250A,A00,087430,Spolaor; Luca,4,0,8,4
1653533333708,MATH 257A,A00,087431,Spolaor; Luca,7,0,8,1
1653533334231,MATH 258,A00,087432,Staff,9,0,10,1
1653533334753,MATH 264A,A00,087433,Warnke; Lutz Peter,5,0,8,3
1653533335275,MATH 268,A00,087434,Staff,15,0,15,0
1653533335798,MATH 269,A00,087435,Staff,14,0,15,1
1653533336322,MATH 270A,A00,087436,Nie; Jiawang,0,0,8,8
1653533336844,MATH 272A,A00,087437,Tian; Xiaochuan,1,0,8,7
1653533337370,MATH 274,A01,087439,Cheng; Li-Tien,9,0,10,1
1653533337370,MATH 274,A02,087440,Cheng; Li-Tien,10,0,10,0
1653533337893,MATH 278A,A00,087441,Staff,8,0,10,2
1653533338418,MATH 278B,A00,087442,Staff,8,0,10,2
1653533338942,MATH 278C,A00,087443,Staff,8,0,10,2
1653533339465,MATH 280A,A00,087444,Zheng; Tianyi,0,0,8,8
1653533339990,MATH 281A,A00,087445,Bradic; Jelena,0,0,8,8
1653533340516,MATH 282A,A00,087446,Zhang; Danna,0,0,8,8
1653533341041,MATH 283,A00,087447,Tesler; Glenn,0,0,0,15
1653533341567,MATH 286,A00,087448,Kemp; Todd Aahron,5,0,8,3
1653533342090,MATH 287D,A00,087449,Bradic; Jelena,0,0,0,0
1653533342621,MATH 288,A00,087450,Staff,14,0,15,1
1653533342621,MATH 288,B00,087451,Staff,15,0,15,0
1653533342621,MATH 288,C00,087452,Staff,15,0,15,0
1653533343142,MATH 290A,A00,087453,Xu; Zhouli,6,0,8,2
1653533343666,MATH 291A,A00,087454,Xu; Zhouli,7,0,8,1
1653533344192,MATH 292,A00,087455,Staff,10,0,10,0
1653533344727,MATH 295,A00,087456,Staff,50,0,50,0
1653533345249,MATH 297,001,087457,Staff,998,0,999,1
1653533904387,COGS 200,A01,087991,Staff,47,0,50,3
1653533904910,COGS 201,A01,094504,Rangel; Lara M,17,0,25,8
1653533905432,COGS 203,A00,087992,Coulson; Seana M,18,0,20,2
1653533905956,COGS 210A,001,087993,Greene; Deanna Jacquelyn,9998,0,9999,1
1653533905956,COGS 210A,002,087994,Saygin; Ayse P,9999,0,9999,0
1653533905956,COGS 210A,003,087995,Xia; Haijun,9999,0,9999,0
1653533905956,COGS 210A,004,087996,Nitz; Douglas A.,9999,0,9999,0
1653533905956,COGS 210A,005,087997,Hollan; James D.,9999,0,9999,0
1653533905956,COGS 210A,006,087998,Deak; Gedeon O.,9998,0,9999,1
1653533905956,COGS 210A,007,087999,Rossano; Federico,9999,0,9999,0
1653533906482,COGS 211A,A00,088000,Coulson; Seana M,9997,0,9999,2
1653533907007,COGS 229,A00,088002,Staff,23,0,25,2
1653533907530,COGS 260,B00,094231,Staff,17,0,20,3
1653533907530,COGS 260,A00,088004,Nitz; Douglas A.,9998,0,9999,1
1653533908058,CSE 202,A00,090110,Paturi; Ramamohan,0,0,0,0
1653533908058,CSE 202,B00,090111,Paturi; Ramamohan,0,0,0,0
1653533908581,CSE 207B,A00,090112,Heninger; Nadia A,0,0,0,0
1653533909104,CSE 208,A00,094858,Micciancio; Daniele,0,0,0,0
1653533909630,CSE 210,A00,090113,Powell; Thomas Allan,0,0,0,0
1653533910155,CSE 219,A00,090898,Staff,0,0,0,0
1653533910681,CSE 221,A00,090114,Zhou; Yuan-Yuan,0,0,0,0
1653533911204,CSE 229A,A00,090115,Porter; George M,0,0,0,0
1653533911727,CSE 229C,A00,090116,Savage; Stefan,0,0,0,0
1653533912251,CSE 230,A00,090117,Jhala; Ranjit,0,0,0,0
1653533912775,CSE 232,A00,090118,Papakonstantinou; Yannis,0,0,0,0
1653533913298,CSE 239A,A00,090121,Kumar; Arun Kumar,0,0,0,0
1653533913821,CSE 239B,A00,090122,Jhala; Ranjit,0,0,0,0
1653533914344,CSE 240A,A00,090123,Zhao; Jishen,0,0,189,189
1653533914867,CSE 243A,A00,090124,Orailoglu; Alex,0,0,15,15
1653533915394,CSE 249B,A00,090125,Kahng; Andrew Byun,13,0,20,7
1653533915918,CSE 250A,A00,090126,Berg-Kirkpatrick; Taylor D,0,0,0,0
1653533916442,CSE 252A,A00,090127,Ochoa; Benjamin Lawrence,0,0,0,0
1653533916965,CSE 258,A01,090129,McAuley; Julian John,0,0,0,0
1653533917488,CSE 258R,A01,090131,McAuley; Julian John,0,0,0,0
1653533918013,CSE 274,A00,090132,Ramamoorthi; Ravi,0,0,0,0
1653533918538,CSE 276A,A00,090133,Christensen; Henrik I,0,0,0,0
1653533919061,CSE 276C,A00,090134,Christensen; Henrik I,0,0,0,0
1653533919585,CSE 290,A00,090135,Bafna; Vineet,0,0,0,0
1653533919585,CSE 290,B00,090136,Ramamoorthi; Ravi,0,0,0,0
1653533919585,CSE 290,C00,090137,Li; Tzumao,8,0,10,2
1653533919585,CSE 290,D00,090138,Zhou; Yuan-Yuan,9,0,10,1
1653533919585,CSE 290,E00,090139,Christensen; Henrik I,8,0,10,2
1653533919585,CSE 290,F00,094053,Shalev; Aaron D,0,0,0,0
1653533920109,CSE 291,A00,090140,Munyaka; Imani N. S.,0,0,0,0
1653533920109,CSE 291,B00,094880,Yu; Qi,0,0,0,0
1653533920109,CSE 291,C00,090142,Pannuto; Patrick William,0,0,0,0
1653533920109,CSE 291,D00,094881,Zhang; Yiying,0,0,0,0
1653533920109,CSE 291,E00,095118,Su; Hao,0,0,0,0
1653533920635,CSE 293,001,094905,Bafna; Vineet,9999,0,9999,0
1653533920635,CSE 293,002,094906,Bellare; Mihir,9999,0,9999,0
1653533920635,CSE 293,003,094907,Berg-Kirkpatrick; Taylor D,9999,0,9999,0
1653533920635,CSE 293,004,094908,Christensen; Henrik I,9999,0,9999,0
1653533920635,CSE 293,005,094909,Cottrell; Garrison W,9999,0,9999,0
1653533920635,CSE 293,006,094910,Deutsch; Alin Bernard,9999,0,9999,0
1653533920635,CSE 293,007,094911,Esmaeilzadeh; Hadi,9999,0,9999,0
1653533920635,CSE 293,008,094912,Freund; Yoav,9999,0,9999,0
1653533920635,CSE 293,009,094913,Griswold; William G.,9999,0,9999,0
1653533920635,CSE 293,010,094914,Gymrek; Melissa Ann,9999,0,9999,0
1653533920635,CSE 293,011,094915,Heninger; Nadia A,9999,0,9999,0
1653533920635,CSE 293,012,094916,Impagliazzo; Russell,9999,0,9999,0
1653533920635,CSE 293,013,094917,Jhala; Ranjit,9999,0,9999,0
1653533920635,CSE 293,014,094918,Kahng; Andrew Byun,9999,0,9999,0
1653533920635,CSE 293,015,094919,Kane; Daniel Mertz,9999,0,9999,0
1653533920635,CSE 293,016,094920,Kriegman; David J,9999,0,9999,0
1653533920635,CSE 293,017,094921,Kumar; Arun Kumar,9999,0,9999,0
1653533920635,CSE 293,018,094922,Lerner; Sorin,9999,0,9999,0
1653533920635,CSE 293,019,094923,Lovett; Shachar,9999,0,9999,0
1653533920635,CSE 293,020,094924,McAuley; Julian John,9999,0,9999,0
1653533920635,CSE 293,021,094925,Micciancio; Daniele,9999,0,9999,0
1653533920635,CSE 293,022,094926,Orailoglu; Alex,9999,0,9999,0
1653533920635,CSE 293,023,094927,Paturi; Ramamohan,9999,0,9999,0
1653533920635,CSE 293,024,094928,Polikarpova; Nadezhda,9999,0,9999,0
1653533920635,CSE 293,025,094929,Politz; Joseph Gibbs,9999,0,9999,0
1653533920635,CSE 293,026,094930,Porter; George M,9999,0,9999,0
1653533920635,CSE 293,027,094931,Porter; Leonard Emerson,9999,0,9999,0
1653533920635,CSE 293,028,094932,Ramamoorthi; Ravi,9999,0,9999,0
1653533920635,CSE 293,029,094933,Sahoo; Debashis,9999,0,9999,0
1653533920635,CSE 293,030,094934,Saul; Lawrence,9999,0,9999,0
1653533920635,CSE 293,031,094935,Savage; Stefan,9999,0,9999,0
1653533920635,CSE 293,032,094936,Schulze; Jurgen P.,9999,0,9999,0
1653533920635,CSE 293,033,094937,Snoeren; Alex C.,9999,0,9999,0
1653533920635,CSE 293,034,094938,Shang; Jingbo,9999,0,9999,0
1653533920635,CSE 293,035,094939,Stefan; Deian,9999,0,9999,0
1653533920635,CSE 293,036,094940,Su; Hao,9999,0,9999,0
1653533920635,CSE 293,037,094941,Swanson; Steven James,9999,0,9999,0
1653533920635,CSE 293,038,094942,Tullsen; Dean Michael,9999,0,9999,0
1653533920635,CSE 293,039,094943,Voelker; Geoffrey M.,9999,0,9999,0
1653533920635,CSE 293,040,094944,Zhao; Jishen,9999,0,9999,0
1653533920635,CSE 293,041,094945,Zhou; Yuan-Yuan,9999,0,9999,0
1653533920635,CSE 293,042,094946,Gao; Sicun,9998,0,9999,1
1653533920635,CSE 293,043,094947,Weibel; Nadir,9999,0,9999,0
1653533920635,CSE 293,044,094948,Gupta; Rajesh K.,9999,0,9999,0
1653533921157,CSE 294,A00,090143,Porter; George M,8,0,10,2
1653533921678,DSE 200,A00,091799,Staff,50,0,50,0
1653533922203,DSE 203,A00,091800,Gupta; Amarnath,30,0,30,0
1653533922732,DSE 250,A00,091801,Deutsch; Alin Bernard,30,0,30,0
1653533923258,DSE 290,A00,091802,Altintas De Callaf; Ilkay,50,0,50,0
1653533923820,ECE 200,001,091003,Antipa; Nicholas A,9999,0,9999,0
1653533923820,ECE 200,002,091004,Atanasov; Nikolay A.,9999,0,9999,0
1653533923820,ECE 200,003,091005,Bharadia; Dinesh,9999,0,9999,0
1653533923820,ECE 200,004,091006,Cheng; Chung Kuan,9999,0,9999,0
1653533923820,ECE 200,005,091007,Cosman; Pamela C.,9999,0,9999,0
1653533923820,ECE 200,006,091008,Staff,9999,0,9999,0
1653533923820,ECE 200,007,091009,Dayeh; Shadi Ahmad,9999,0,9999,0
1653533923820,ECE 200,008,091010,Fainman; Yeshaiahu,9999,0,9999,0
1653533923820,ECE 200,009,091011,Ford; Joseph Earl,9999,0,9999,0
1653533923820,ECE 200,010,091012,Franceschetti; Massimo,9999,0,9999,0
1653533923820,ECE 200,011,091013,Fullerton; Eric E,9999,0,9999,0
1653533923820,ECE 200,012,091014,Galton; Ian A,9999,0,9999,0
1653533923820,ECE 200,013,091015,Gilja; Vikash,9999,0,9999,0
1653533923820,ECE 200,014,091016,Hall; Drew A.,9999,0,9999,0
1653533923820,ECE 200,015,091017,Hsueh; Tzu-Chien,9999,0,9999,0
1653533923820,ECE 200,016,091018,Javidi; Tara,9999,0,9999,0
1653533923820,ECE 200,017,091019,Kahng; Andrew Byun,9999,0,9999,0
1653533923820,ECE 200,018,091020,Kim; Young-Han,9999,0,9999,0
1653533923820,ECE 200,019,091021,Koushanfar; Farinaz,9999,0,9999,0
1653533923820,ECE 200,020,091022,Kuzum; Duygu,9999,0,9999,0
1653533923820,ECE 200,021,091023,Le; Hanh-Phuc,9999,0,9999,0
1653533923820,ECE 200,022,091024,Lin; Bill,9999,0,9999,0
1653533923820,ECE 200,023,091025,Liu; Zhaowei,9999,0,9999,0
1653533923820,ECE 200,024,091026,Lo; Yu-Hwa,9999,0,9999,0
1653533923820,ECE 200,025,091027,Lomakin; Vitaliy,9999,0,9999,0
1653533923820,ECE 200,026,091028,Mercier; Patrick Philip,9999,0,9999,0
1653533923820,ECE 200,027,091029,Meyer; Florian,9999,0,9999,0
1653533923820,ECE 200,028,091030,Milstein; Laurence B.,9999,0,9999,0
1653533923820,ECE 200,029,091031,Mir Arabbaygi; Siavash,9999,0,9999,0
1653533923820,ECE 200,030,091032,Mookherjea; Shayan,9999,0,9999,0
1653533923820,ECE 200,031,091033,Morris; Karcher William,9999,0,9999,0
1653533923820,ECE 200,032,091034,Ng; Tse Nga,9999,0,9999,0
1653533923820,ECE 200,033,091035,Nguyen; Truong Quang,9999,0,9999,0
1653533923820,ECE 200,034,091036,Nomura; Kenji,9999,0,9999,0
1653533923820,ECE 200,035,091037,Orlitsky; Alon,9999,0,9999,0
1653533923820,ECE 200,036,091038,Pal; Piya,9999,0,9999,0
1653533923820,ECE 200,037,091039,Papen; George C.,9999,0,9999,0
1653533923820,ECE 200,038,091040,Radic; Stojan,9999,0,9999,0
1653533923820,ECE 200,039,091041,Rao; Bhaskar D.,9999,0,9999,0
1653533923820,ECE 200,040,091042,Rao; Ramesh R,9999,0,9999,0
1653533923820,ECE 200,041,091043,Rebeiz; Gabriel,9999,0,9999,0
1653533923820,ECE 200,042,091044,Sanford; John R,9999,0,9999,0
1653533923820,ECE 200,043,091045,Siegel; Paul H.,9999,0,9999,0
1653533923820,ECE 200,044,091046,Sievenpiper; Daniel F.,9999,0,9999,0
1653533923820,ECE 200,045,091047,Sworder; David D.,9999,0,9999,0
1653533923820,ECE 200,046,091048,Taur; Yuan,9999,0,9999,0
1653533923820,ECE 200,047,091049,Touri; Behrouz,9999,0,9999,0
1653533923820,ECE 200,048,091050,Trivedi; Mohan M.,9999,0,9999,0
1653533923820,ECE 200,049,091051,Vardy; Alexander,9999,0,9999,0
1653533923820,ECE 200,050,091052,Vasconcelos; Nuno,9999,0,9999,0
1653533923820,ECE 200,051,091053,Wang; Xiaolong,9999,0,9999,0
1653533923820,ECE 200,052,091054,Xie; Pengtao,9999,0,9999,0
1653533923820,ECE 200,053,091055,Yip; Michael,9999,0,9999,0
1653533923820,ECE 200,054,091056,Zeger; Kenneth A.,9999,0,9999,0
1653533923820,ECE 200,055,091057,Zhang; Xinyu,9999,0,9999,0
1653533923820,ECE 200,056,091058,Turakhia; Yatish Girish,9999,0,9999,0
1653533923820,ECE 200,057,091059,Kang; Mingu,9999,0,9999,0
1653533923820,ECE 200,058,091060,Shi; Yuanyuan,9999,0,9999,0
1653533923820,ECE 200,059,091061,Wang; Edward Jay,9999,0,9999,0
1653533923820,ECE 200,060,091062,Zheng; Yang,9999,0,9999,0
1653533924342,ECE 201,A00,095526,Lo; Yu-Hwa,0,0,0,0
1653533924868,ECE 203,A00,091065,Mercier; Patrick Philip,0,0,0,0
1653533925390,ECE 207A,A00,091605,Liu; Thomas Tao-Ming,0,0,0,0
1653533925917,ECE 212AN,A00,091068,Nomura; Kenji,0,0,0,0
1653533926442,ECE 222A,A00,091069,Rebeiz; Gabriel,0,0,0,0
1653533926965,ECE 225A,A00,091070,Orlitsky; Alon,0,0,0,0
1653533927492,ECE 230A,A00,091071,Nomura; Kenji,0,0,0,0
1653533928014,ECE 236A,A00,091072,Dayeh; Shadi Ahmad,0,0,0,0
1653533928536,ECE 238A,A00,091073,Luo; Jian,0,0,0,0
1653533928536,ECE 238A,B00,091074,Luo; Jian,0,0,0,0
1653533929063,ECE 240A,A00,091075,Radic; Stojan,0,0,0,0
1653533929586,ECE 247A,A00,091592,Shi; Lingyan,0,0,0,0
1653533930111,ECE 250,A00,091076,Touri; Behrouz,0,0,0,0
1653533930634,ECE 251C,A00,091078,Nguyen; Truong Quang,0,0,0,0
1653533931155,ECE 253,A00,091079,Cosman; Pamela C.,0,0,0,0
1653533931691,ECE 255A,A00,091080,Orlitsky; Alon,0,0,0,0
1653533932215,ECE 257A,A00,091081,Zhang; Xinyu,0,0,0,0
1653533932745,ECE 260A,A01,091084,Eldon; John,0,0,0,0
1653533933274,ECE 264C,A00,091085,Galton; Ian A,0,0,0,0
1653533933797,ECE 265C,A00,094889,Presti; Calogero Davide,0,0,0,9
1653533934317,ECE 266,A01,091087,Hall; Drew A.,0,0,0,0
1653533935374,ECE 271A,A00,091090,Vasconcelos; Nuno,0,0,0,0
1653533935896,ECE 272B,A00,091091,Sworder; David D.,0,0,0,0
1653533936423,ECE 275A,A00,091092,Meyer; Florian,0,0,0,0
1653533936946,ECE 277,A00,091093,An; Cheolhong,0,0,0,0
1653533937469,ECE 283,A00,091094,Le; Hanh-Phuc,0,0,0,0
1653533937995,ECE 284,A00,091095,Kang; Mingu,0,0,0,0
1653533937995,ECE 284,B00,091096,Wang; Edward Jay,0,0,0,0
1653533938521,ECE 285,A00,094334,Touri; Behrouz,0,0,0,0
1653533939046,ECE 289,A00,091097,Whelan; David Arthur,0,0,0,0
1653533939578,MATH 200A,A00,087414,Salehi Golsefidy; Alireza,7,0,8,1
1653533940102,MATH 202A,A00,087415,Gill; Philip E.,2,0,8,6
1653533940638,MATH 203A,A00,087416,Oprea; Dragos N.,6,0,8,2
1653533941163,MATH 204A,A00,087417,Kedlaya; Kiran S.,6,0,8,2
1653533941689,MATH 205,A00,087418,Sorensen; Claus M,6,0,8,2
1653533942218,MATH 206A,A00,087419,Izadi; Elham,7,0,8,1
1653533942743,MATH 207A,A00,087420,Mohammadi; Amir,5,0,8,3
1653533943356,MATH 208,A00,087421,Staff,9,0,10,1
1653533943881,MATH 209,A00,087422,Staff,10,0,10,0
1653533944405,MATH 218,A00,087423,Staff,10,0,10,0
1653533944928,MATH 220A,A00,087424,Novak; Jonathan I,7,0,8,1
1653533945458,MATH 231A,A00,087425,Bejenaru; Ioan,3,0,8,5
1653533945981,MATH 240A,A00,087426,Ebenfelt; Peter F,5,0,8,3
1653533946504,MATH 243,A00,087427,Staff,9,0,10,1
1653533947033,MATH 248,A00,087429,Staff,10,0,10,0
1653533947559,MATH 250A,A00,087430,Spolaor; Luca,4,0,8,4
1653533948083,MATH 257A,A00,087431,Spolaor; Luca,7,0,8,1
1653533948607,MATH 258,A00,087432,Staff,9,0,10,1
1653533949134,MATH 264A,A00,087433,Warnke; Lutz Peter,5,0,8,3
1653533949718,MATH 268,A00,087434,Staff,15,0,15,0
1653533950244,MATH 269,A00,087435,Staff,14,0,15,1
1653533950778,MATH 270A,A00,087436,Nie; Jiawang,0,0,8,8
1653533951300,MATH 272A,A00,087437,Tian; Xiaochuan,1,0,8,7
1653533951821,MATH 274,A01,087439,Cheng; Li-Tien,9,0,10,1
1653533951821,MATH 274,A02,087440,Cheng; Li-Tien,10,0,10,0
1653533952346,MATH 278A,A00,087441,Staff,8,0,10,2
1653533952869,MATH 278B,A00,087442,Staff,8,0,10,2
1653533953392,MATH 278C,A00,087443,Staff,8,0,10,2
1653533953915,MATH 280A,A00,087444,Zheng; Tianyi,0,0,8,8
1653533954438,MATH 281A,A00,087445,Bradic; Jelena,0,0,8,8
1653533954963,MATH 282A,A00,087446,Zhang; Danna,0,0,8,8
1653533955490,MATH 283,A00,087447,Tesler; Glenn,0,0,0,15
1653533956017,MATH 286,A00,087448,Kemp; Todd Aahron,5,0,8,3
1653533956540,MATH 287D,A00,087449,Bradic; Jelena,0,0,0,0
1653533957076,MATH 288,A00,087450,Staff,14,0,15,1
1653533957076,MATH 288,B00,087451,Staff,15,0,15,0
1653533957076,MATH 288,C00,087452,Staff,15,0,15,0
1653533957599,MATH 290A,A00,087453,Xu; Zhouli,6,0,8,2
1653533958125,MATH 291A,A00,087454,Xu; Zhouli,7,0,8,1
1653533958648,MATH 292,A00,087455,Staff,10,0,10,0
1653533959179,MATH 295,A00,087456,Staff,50,0,50,0
1653533959705,MATH 297,001,087457,Staff,998,0,999,1
1653534519676,COGS 200,A01,087991,Staff,47,0,50,3
1653534520200,COGS 201,A01,094504,Rangel; Lara M,17,0,25,8
1653534520722,COGS 203,A00,087992,Coulson; Seana M,18,0,20,2
1653534521248,COGS 210A,001,087993,Greene; Deanna Jacquelyn,9998,0,9999,1
1653534521248,COGS 210A,002,087994,Saygin; Ayse P,9999,0,9999,0
1653534521248,COGS 210A,003,087995,Xia; Haijun,9999,0,9999,0
1653534521248,COGS 210A,004,087996,Nitz; Douglas A.,9999,0,9999,0
1653534521248,COGS 210A,005,087997,Hollan; James D.,9999,0,9999,0
1653534521248,COGS 210A,006,087998,Deak; Gedeon O.,9998,0,9999,1
1653534521248,COGS 210A,007,087999,Rossano; Federico,9999,0,9999,0
1653534521770,COGS 211A,A00,088000,Coulson; Seana M,9997,0,9999,2
1653534522293,COGS 229,A00,088002,Staff,23,0,25,2
1653534522817,COGS 260,B00,094231,Staff,17,0,20,3
1653534522817,COGS 260,A00,088004,Nitz; Douglas A.,9998,0,9999,1
1653534523345,CSE 202,A00,090110,Paturi; Ramamohan,0,0,0,0
1653534523345,CSE 202,B00,090111,Paturi; Ramamohan,0,0,0,0
1653534523870,CSE 207B,A00,090112,Heninger; Nadia A,0,0,0,0
1653534524393,CSE 208,A00,094858,Micciancio; Daniele,0,0,0,0
1653534524916,CSE 210,A00,090113,Powell; Thomas Allan,0,0,0,0
1653534525440,CSE 219,A00,090898,Staff,0,0,0,0
1653534525963,CSE 221,A00,090114,Zhou; Yuan-Yuan,0,0,0,0
1653534526486,CSE 229A,A00,090115,Porter; George M,0,0,0,0
1653534527015,CSE 229C,A00,090116,Savage; Stefan,0,0,0,0
1653534527539,CSE 230,A00,090117,Jhala; Ranjit,0,0,0,0
1653534528064,CSE 232,A00,090118,Papakonstantinou; Yannis,0,0,0,0
1653534528599,CSE 239A,A00,090121,Kumar; Arun Kumar,0,0,0,0
1653534529123,CSE 239B,A00,090122,Jhala; Ranjit,0,0,0,0
1653534529652,CSE 240A,A00,090123,Zhao; Jishen,0,0,189,189
1653534530187,CSE 243A,A00,090124,Orailoglu; Alex,0,0,15,15
1653534530785,CSE 249B,A00,090125,Kahng; Andrew Byun,13,0,20,7
1653534531317,CSE 250A,A00,090126,Berg-Kirkpatrick; Taylor D,0,0,0,0
1653534531840,CSE 252A,A00,090127,Ochoa; Benjamin Lawrence,0,0,0,0
1653534532362,CSE 258,A01,090129,McAuley; Julian John,0,0,0,0
1653534532884,CSE 258R,A01,090131,McAuley; Julian John,0,0,0,0
1653534533410,CSE 274,A00,090132,Ramamoorthi; Ravi,0,0,0,0
1653534533933,CSE 276A,A00,090133,Christensen; Henrik I,0,0,0,0
1653534534457,CSE 276C,A00,090134,Christensen; Henrik I,0,0,0,0
1653534534987,CSE 290,A00,090135,Bafna; Vineet,0,0,0,0
1653534534987,CSE 290,B00,090136,Ramamoorthi; Ravi,0,0,0,0
1653534534987,CSE 290,C00,090137,Li; Tzumao,8,0,10,2
1653534534987,CSE 290,D00,090138,Zhou; Yuan-Yuan,9,0,10,1
1653534534987,CSE 290,E00,090139,Christensen; Henrik I,8,0,10,2
1653534534987,CSE 290,F00,094053,Shalev; Aaron D,0,0,0,0
1653534535510,CSE 291,A00,090140,Munyaka; Imani N. S.,0,0,0,0
1653534535510,CSE 291,B00,094880,Yu; Qi,0,0,0,0
1653534535510,CSE 291,C00,090142,Pannuto; Patrick William,0,0,0,0
1653534535510,CSE 291,D00,094881,Zhang; Yiying,0,0,0,0
1653534535510,CSE 291,E00,095118,Su; Hao,0,0,0,0
1653534536044,CSE 293,001,094905,Bafna; Vineet,9999,0,9999,0
1653534536044,CSE 293,002,094906,Bellare; Mihir,9999,0,9999,0
1653534536044,CSE 293,003,094907,Berg-Kirkpatrick; Taylor D,9999,0,9999,0
1653534536044,CSE 293,004,094908,Christensen; Henrik I,9999,0,9999,0
1653534536044,CSE 293,005,094909,Cottrell; Garrison W,9999,0,9999,0
1653534536044,CSE 293,006,094910,Deutsch; Alin Bernard,9999,0,9999,0
1653534536044,CSE 293,007,094911,Esmaeilzadeh; Hadi,9999,0,9999,0
1653534536044,CSE 293,008,094912,Freund; Yoav,9999,0,9999,0
1653534536044,CSE 293,009,094913,Griswold; William G.,9999,0,9999,0
1653534536044,CSE 293,010,094914,Gymrek; Melissa Ann,9999,0,9999,0
1653534536044,CSE 293,011,094915,Heninger; Nadia A,9999,0,9999,0
1653534536044,CSE 293,012,094916,Impagliazzo; Russell,9999,0,9999,0
1653534536044,CSE 293,013,094917,Jhala; Ranjit,9999,0,9999,0
1653534536044,CSE 293,014,094918,Kahng; Andrew Byun,9999,0,9999,0
1653534536044,CSE 293,015,094919,Kane; Daniel Mertz,9999,0,9999,0
1653534536044,CSE 293,016,094920,Kriegman; David J,9999,0,9999,0
1653534536044,CSE 293,017,094921,Kumar; Arun Kumar,9999,0,9999,0
1653534536044,CSE 293,018,094922,Lerner; Sorin,9999,0,9999,0
1653534536044,CSE 293,019,094923,Lovett; Shachar,9999,0,9999,0
1653534536044,CSE 293,020,094924,McAuley; Julian John,9999,0,9999,0
1653534536044,CSE 293,021,094925,Micciancio; Daniele,9999,0,9999,0
1653534536044,CSE 293,022,094926,Orailoglu; Alex,9999,0,9999,0
1653534536044,CSE 293,023,094927,Paturi; Ramamohan,9999,0,9999,0
1653534536044,CSE 293,024,094928,Polikarpova; Nadezhda,9999,0,9999,0
1653534536044,CSE 293,025,094929,Politz; Joseph Gibbs,9999,0,9999,0
1653534536044,CSE 293,026,094930,Porter; George M,9999,0,9999,0
1653534536044,CSE 293,027,094931,Porter; Leonard Emerson,9999,0,9999,0
1653534536044,CSE 293,028,094932,Ramamoorthi; Ravi,9999,0,9999,0
1653534536044,CSE 293,029,094933,Sahoo; Debashis,9999,0,9999,0
1653534536044,CSE 293,030,094934,Saul; Lawrence,9999,0,9999,0
1653534536044,CSE 293,031,094935,Savage; Stefan,9999,0,9999,0
1653534536044,CSE 293,032,094936,Schulze; Jurgen P.,9999,0,9999,0
1653534536044,CSE 293,033,094937,Snoeren; Alex C.,9999,0,9999,0
1653534536044,CSE 293,034,094938,Shang; Jingbo,9999,0,9999,0
1653534536044,CSE 293,035,094939,Stefan; Deian,9999,0,9999,0
1653534536044,CSE 293,036,094940,Su; Hao,9999,0,9999,0
1653534536044,CSE 293,037,094941,Swanson; Steven James,9999,0,9999,0
1653534536044,CSE 293,038,094942,Tullsen; Dean Michael,9999,0,9999,0
1653534536044,CSE 293,039,094943,Voelker; Geoffrey M.,9999,0,9999,0
1653534536044,CSE 293,040,094944,Zhao; Jishen,9999,0,9999,0
1653534536044,CSE 293,041,094945,Zhou; Yuan-Yuan,9999,0,9999,0
1653534536044,CSE 293,042,094946,Gao; Sicun,9998,0,9999,1
1653534536044,CSE 293,043,094947,Weibel; Nadir,9999,0,9999,0
1653534536044,CSE 293,044,094948,Gupta; Rajesh K.,9999,0,9999,0
1653534536570,CSE 294,A00,090143,Porter; George M,8,0,10,2
1653534537095,DSE 200,A00,091799,Staff,50,0,50,0
1653534537618,DSE 203,A00,091800,Gupta; Amarnath,30,0,30,0
1653534538141,DSE 250,A00,091801,Deutsch; Alin Bernard,30,0,30,0
1653534538664,DSE 290,A00,091802,Altintas De Callaf; Ilkay,50,0,50,0
1653534539202,ECE 200,001,091003,Antipa; Nicholas A,9999,0,9999,0
1653534539202,ECE 200,002,091004,Atanasov; Nikolay A.,9999,0,9999,0
1653534539202,ECE 200,003,091005,Bharadia; Dinesh,9999,0,9999,0
1653534539202,ECE 200,004,091006,Cheng; Chung Kuan,9999,0,9999,0
1653534539202,ECE 200,005,091007,Cosman; Pamela C.,9999,0,9999,0
1653534539202,ECE 200,006,091008,Staff,9999,0,9999,0
1653534539202,ECE 200,007,091009,Dayeh; Shadi Ahmad,9999,0,9999,0
1653534539202,ECE 200,008,091010,Fainman; Yeshaiahu,9999,0,9999,0
1653534539202,ECE 200,009,091011,Ford; Joseph Earl,9999,0,9999,0
1653534539202,ECE 200,010,091012,Franceschetti; Massimo,9999,0,9999,0
1653534539202,ECE 200,011,091013,Fullerton; Eric E,9999,0,9999,0
1653534539202,ECE 200,012,091014,Galton; Ian A,9999,0,9999,0
1653534539202,ECE 200,013,091015,Gilja; Vikash,9999,0,9999,0
1653534539202,ECE 200,014,091016,Hall; Drew A.,9999,0,9999,0
1653534539202,ECE 200,015,091017,Hsueh; Tzu-Chien,9999,0,9999,0
1653534539202,ECE 200,016,091018,Javidi; Tara,9999,0,9999,0
1653534539202,ECE 200,017,091019,Kahng; Andrew Byun,9999,0,9999,0
1653534539202,ECE 200,018,091020,Kim; Young-Han,9999,0,9999,0
1653534539202,ECE 200,019,091021,Koushanfar; Farinaz,9999,0,9999,0
1653534539202,ECE 200,020,091022,Kuzum; Duygu,9999,0,9999,0
1653534539202,ECE 200,021,091023,Le; Hanh-Phuc,9999,0,9999,0
1653534539202,ECE 200,022,091024,Lin; Bill,9999,0,9999,0
1653534539202,ECE 200,023,091025,Liu; Zhaowei,9999,0,9999,0
1653534539202,ECE 200,024,091026,Lo; Yu-Hwa,9999,0,9999,0
1653534539202,ECE 200,025,091027,Lomakin; Vitaliy,9999,0,9999,0
1653534539202,ECE 200,026,091028,Mercier; Patrick Philip,9999,0,9999,0
1653534539202,ECE 200,027,091029,Meyer; Florian,9999,0,9999,0
1653534539202,ECE 200,028,091030,Milstein; Laurence B.,9999,0,9999,0
1653534539202,ECE 200,029,091031,Mir Arabbaygi; Siavash,9999,0,9999,0
1653534539202,ECE 200,030,091032,Mookherjea; Shayan,9999,0,9999,0
1653534539202,ECE 200,031,091033,Morris; Karcher William,9999,0,9999,0
1653534539202,ECE 200,032,091034,Ng; Tse Nga,9999,0,9999,0
1653534539202,ECE 200,033,091035,Nguyen; Truong Quang,9999,0,9999,0
1653534539202,ECE 200,034,091036,Nomura; Kenji,9999,0,9999,0
1653534539202,ECE 200,035,091037,Orlitsky; Alon,9999,0,9999,0
1653534539202,ECE 200,036,091038,Pal; Piya,9999,0,9999,0
1653534539202,ECE 200,037,091039,Papen; George C.,9999,0,9999,0
1653534539202,ECE 200,038,091040,Radic; Stojan,9999,0,9999,0
1653534539202,ECE 200,039,091041,Rao; Bhaskar D.,9999,0,9999,0
1653534539202,ECE 200,040,091042,Rao; Ramesh R,9999,0,9999,0
1653534539202,ECE 200,041,091043,Rebeiz; Gabriel,9999,0,9999,0
1653534539202,ECE 200,042,091044,Sanford; John R,9999,0,9999,0
1653534539202,ECE 200,043,091045,Siegel; Paul H.,9999,0,9999,0
1653534539202,ECE 200,044,091046,Sievenpiper; Daniel F.,9999,0,9999,0
1653534539202,ECE 200,045,091047,Sworder; David D.,9999,0,9999,0
1653534539202,ECE 200,046,091048,Taur; Yuan,9999,0,9999,0
1653534539202,ECE 200,047,091049,Touri; Behrouz,9999,0,9999,0
1653534539202,ECE 200,048,091050,Trivedi; Mohan M.,9999,0,9999,0
1653534539202,ECE 200,049,091051,Vardy; Alexander,9999,0,9999,0
1653534539202,ECE 200,050,091052,Vasconcelos; Nuno,9999,0,9999,0
1653534539202,ECE 200,051,091053,Wang; Xiaolong,9999,0,9999,0
1653534539202,ECE 200,052,091054,Xie; Pengtao,9999,0,9999,0
1653534539202,ECE 200,053,091055,Yip; Michael,9999,0,9999,0
1653534539202,ECE 200,054,091056,Zeger; Kenneth A.,9999,0,9999,0
1653534539202,ECE 200,055,091057,Zhang; Xinyu,9999,0,9999,0
1653534539202,ECE 200,056,091058,Turakhia; Yatish Girish,9999,0,9999,0
1653534539202,ECE 200,057,091059,Kang; Mingu,9999,0,9999,0
1653534539202,ECE 200,058,091060,Shi; Yuanyuan,9999,0,9999,0
1653534539202,ECE 200,059,091061,Wang; Edward Jay,9999,0,9999,0
1653534539202,ECE 200,060,091062,Zheng; Yang,9999,0,9999,0
1653534539727,ECE 201,A00,095526,Lo; Yu-Hwa,0,0,0,0
1653534540266,ECE 203,A00,091065,Mercier; Patrick Philip,0,0,0,0
1653534540800,ECE 207A,A00,091605,Liu; Thomas Tao-Ming,0,0,0,0
1653534541323,ECE 212AN,A00,091068,Nomura; Kenji,0,0,0,0
1653534541846,ECE 222A,A00,091069,Rebeiz; Gabriel,0,0,0,0
1653534542374,ECE 225A,A00,091070,Orlitsky; Alon,0,0,0,0
1653534542910,ECE 230A,A00,091071,Nomura; Kenji,0,0,0,0
1653534543435,ECE 236A,A00,091072,Dayeh; Shadi Ahmad,0,0,0,0
1653534543971,ECE 238A,A00,091073,Luo; Jian,0,0,0,0
1653534543971,ECE 238A,B00,091074,Luo; Jian,0,0,0,0
1653534544497,ECE 240A,A00,091075,Radic; Stojan,0,0,0,0
1653534545022,ECE 247A,A00,091592,Shi; Lingyan,0,0,0,0
1653534545560,ECE 250,A00,091076,Touri; Behrouz,0,0,0,0
1653534546087,ECE 251C,A00,091078,Nguyen; Truong Quang,0,0,0,0
1653534546609,ECE 253,A00,091079,Cosman; Pamela C.,0,0,0,0
1653534547136,ECE 255A,A00,091080,Orlitsky; Alon,0,0,0,0
1653534547662,ECE 257A,A00,091081,Zhang; Xinyu,0,0,0,0
1653534548185,ECE 260A,A01,091084,Eldon; John,0,0,0,0
1653534548709,ECE 264C,A00,091085,Galton; Ian A,0,0,0,0
1653534549234,ECE 265C,A00,094889,Presti; Calogero Davide,0,0,0,9
1653534549756,ECE 266,A01,091087,Hall; Drew A.,0,0,0,0
1653534550805,ECE 271A,A00,091090,Vasconcelos; Nuno,0,0,0,0
1653534551332,ECE 272B,A00,091091,Sworder; David D.,0,0,0,0
1653534551855,ECE 275A,A00,091092,Meyer; Florian,0,0,0,0
1653534552379,ECE 277,A00,091093,An; Cheolhong,0,0,0,0
1653534552904,ECE 283,A00,091094,Le; Hanh-Phuc,0,0,0,0
1653534553429,ECE 284,A00,091095,Kang; Mingu,0,0,0,0
1653534553429,ECE 284,B00,091096,Wang; Edward Jay,0,0,0,0
1653534553956,ECE 285,A00,094334,Touri; Behrouz,0,0,0,0
1653534554483,ECE 289,A00,091097,Whelan; David Arthur,0,0,0,0
1653534555005,MATH 200A,A00,087414,Salehi Golsefidy; Alireza,7,0,8,1
1653534555531,MATH 202A,A00,087415,Gill; Philip E.,2,0,8,6
1653534556067,MATH 203A,A00,087416,Oprea; Dragos N.,6,0,8,2
1653534556594,MATH 204A,A00,087417,Kedlaya; Kiran S.,6,0,8,2
1653534557120,MATH 205,A00,087418,Sorensen; Claus M,6,0,8,2
1653534557648,MATH 206A,A00,087419,Izadi; Elham,7,0,8,1
1653534558172,MATH 207A,A00,087420,Mohammadi; Amir,5,0,8,3
1653534558696,MATH 208,A00,087421,Staff,9,0,10,1
1653534559221,MATH 209,A00,087422,Staff,10,0,10,0
1653534559750,MATH 218,A00,087423,Staff,10,0,10,0
1653534560278,MATH 220A,A00,087424,Novak; Jonathan I,7,0,8,1
1653534560808,MATH 231A,A00,087425,Bejenaru; Ioan,3,0,8,5
1653534561331,MATH 240A,A00,087426,Ebenfelt; Peter F,5,0,8,3
1653534561865,MATH 243,A00,087427,Staff,9,0,10,1
1653534562387,MATH 248,A00,087429,Staff,10,0,10,0
1653534562915,MATH 250A,A00,087430,Spolaor; Luca,4,0,8,4
1653534563440,MATH 257A,A00,087431,Spolaor; Luca,7,0,8,1
1653534563965,MATH 258,A00,087432,Staff,9,0,10,1
1653534564492,MATH 264A,A00,087433,Warnke; Lutz Peter,5,0,8,3
1653534565018,MATH 268,A00,087434,Staff,15,0,15,0
1653534565541,MATH 269,A00,087435,Staff,14,0,15,1
1653534566072,MATH 270A,A00,087436,Nie; Jiawang,0,0,8,8
1653534566598,MATH 272A,A00,087437,Tian; Xiaochuan,1,0,8,7
1653534567121,MATH 274,A01,087439,Cheng; Li-Tien,9,0,10,1
1653534567121,MATH 274,A02,087440,Cheng; Li-Tien,10,0,10,0
1653534567643,MATH 278A,A00,087441,Staff,8,0,10,2
1653534568165,MATH 278B,A00,087442,Staff,8,0,10,2
1653534568687,MATH 278C,A00,087443,Staff,8,0,10,2
1653534569213,MATH 280A,A00,087444,Zheng; Tianyi,0,0,8,8
1653534569737,MATH 281A,A00,087445,Bradic; Jelena,0,0,8,8
1653534570259,MATH 282A,A00,087446,Zhang; Danna,0,0,8,8
1653534570782,MATH 283,A00,087447,Tesler; Glenn,0,0,0,15
1653534571308,MATH 286,A00,087448,Kemp; Todd Aahron,5,0,8,3
1653534571834,MATH 287D,A00,087449,Bradic; Jelena,0,0,0,0
1653534572357,MATH 288,A00,087450,Staff,14,0,15,1
1653534572357,MATH 288,B00,087451,Staff,15,0,15,0
1653534572357,MATH 288,C00,087452,Staff,15,0,15,0
1653534572880,MATH 290A,A00,087453,Xu; Zhouli,6,0,8,2
1653534573402,MATH 291A,A00,087454,Xu; Zhouli,7,0,8,1
1653534573931,MATH 292,A00,087455,Staff,10,0,10,0
1653534574454,MATH 295,A00,087456,Staff,50,0,50,0
1653534574978,MATH 297,001,087457,Staff,998,0,999,1
1653535134761,COGS 200,A01,087991,Staff,47,0,50,3
1653535135293,COGS 201,A01,094504,Rangel; Lara M,17,0,25,8
1653535135816,COGS 203,A00,087992,Coulson; Seana M,18,0,20,2
1653535136338,COGS 210A,001,087993,Greene; Deanna Jacquelyn,9998,0,9999,1
1653535136338,COGS 210A,002,087994,Saygin; Ayse P,9999,0,9999,0
1653535136338,COGS 210A,003,087995,Xia; Haijun,9999,0,9999,0
1653535136338,COGS 210A,004,087996,Nitz; Douglas A.,9999,0,9999,0
1653535136338,COGS 210A,005,087997,Hollan; James D.,9999,0,9999,0
1653535136338,COGS 210A,006,087998,Deak; Gedeon O.,9998,0,9999,1
1653535136338,COGS 210A,007,087999,Rossano; Federico,9999,0,9999,0
1653535136865,COGS 211A,A00,088000,Coulson; Seana M,9997,0,9999,2
1653535137389,COGS 229,A00,088002,Staff,23,0,25,2
1653535137915,COGS 260,B00,094231,Staff,17,0,20,3
1653535137915,COGS 260,A00,088004,Nitz; Douglas A.,9998,0,9999,1
1653535138439,CSE 202,A00,090110,Paturi; Ramamohan,0,0,0,0
1653535138439,CSE 202,B00,090111,Paturi; Ramamohan,0,0,0,0
1653535138961,CSE 207B,A00,090112,Heninger; Nadia A,0,0,0,0
1653535139487,CSE 208,A00,094858,Micciancio; Daniele,0,0,0,0
1653535140009,CSE 210,A00,090113,Powell; Thomas Allan,0,0,0,0
1653535140533,CSE 219,A00,090898,Staff,0,0,0,0
1653535141059,CSE 221,A00,090114,Zhou; Yuan-Yuan,0,0,0,0
1653535141583,CSE 229A,A00,090115,Porter; George M,0,0,0,0
1653535142106,CSE 229C,A00,090116,Savage; Stefan,0,0,0,0
1653535142633,CSE 230,A00,090117,Jhala; Ranjit,0,0,0,0
1653535143157,CSE 232,A00,090118,Papakonstantinou; Yannis,0,0,0,0
1653535143679,CSE 239A,A00,090121,Kumar; Arun Kumar,0,0,0,0
1653535144201,CSE 239B,A00,090122,Jhala; Ranjit,0,0,0,0
1653535144725,CSE 240A,A00,090123,Zhao; Jishen,0,0,189,189
1653535145249,CSE 243A,A00,090124,Orailoglu; Alex,0,0,15,15
1653535145772,CSE 249B,A00,090125,Kahng; Andrew Byun,13,0,20,7
1653535146300,CSE 250A,A00,090126,Berg-Kirkpatrick; Taylor D,0,0,0,0
1653535146824,CSE 252A,A00,090127,Ochoa; Benjamin Lawrence,0,0,0,0
1653535147357,CSE 258,A01,090129,McAuley; Julian John,0,0,0,0
1653535147882,CSE 258R,A01,090131,McAuley; Julian John,0,0,0,0
1653535148412,CSE 274,A00,090132,Ramamoorthi; Ravi,0,0,0,0
1653535148939,CSE 276A,A00,090133,Christensen; Henrik I,0,0,0,0
1653535149461,CSE 276C,A00,090134,Christensen; Henrik I,0,0,0,0
1653535149991,CSE 290,A00,090135,Bafna; Vineet,0,0,0,0
1653535149991,CSE 290,B00,090136,Ramamoorthi; Ravi,0,0,0,0
1653535149991,CSE 290,C00,090137,Li; Tzumao,8,0,10,2
1653535149991,CSE 290,D00,090138,Zhou; Yuan-Yuan,9,0,10,1
1653535149991,CSE 290,E00,090139,Christensen; Henrik I,8,0,10,2
1653535149991,CSE 290,F00,094053,Shalev; Aaron D,0,0,0,0
1653535150521,CSE 291,A00,090140,Munyaka; Imani N. S.,0,0,0,0
1653535150521,CSE 291,B00,094880,Yu; Qi,0,0,0,0
1653535150521,CSE 291,C00,090142,Pannuto; Patrick William,0,0,0,0
1653535150521,CSE 291,D00,094881,Zhang; Yiying,0,0,0,0
1653535150521,CSE 291,E00,095118,Su; Hao,0,0,0,0
1653535151057,CSE 293,001,094905,Bafna; Vineet,9999,0,9999,0
1653535151057,CSE 293,002,094906,Bellare; Mihir,9999,0,9999,0
1653535151057,CSE 293,003,094907,Berg-Kirkpatrick; Taylor D,9999,0,9999,0
1653535151057,CSE 293,004,094908,Christensen; Henrik I,9999,0,9999,0
1653535151057,CSE 293,005,094909,Cottrell; Garrison W,9999,0,9999,0
1653535151057,CSE 293,006,094910,Deutsch; Alin Bernard,9999,0,9999,0
1653535151057,CSE 293,007,094911,Esmaeilzadeh; Hadi,9999,0,9999,0
1653535151057,CSE 293,008,094912,Freund; Yoav,9999,0,9999,0
1653535151057,CSE 293,009,094913,Griswold; William G.,9999,0,9999,0
1653535151057,CSE 293,010,094914,Gymrek; Melissa Ann,9999,0,9999,0
1653535151057,CSE 293,011,094915,Heninger; Nadia A,9999,0,9999,0
1653535151057,CSE 293,012,094916,Impagliazzo; Russell,9999,0,9999,0
1653535151057,CSE 293,013,094917,Jhala; Ranjit,9999,0,9999,0
1653535151057,CSE 293,014,094918,Kahng; Andrew Byun,9999,0,9999,0
1653535151057,CSE 293,015,094919,Kane; Daniel Mertz,9999,0,9999,0
1653535151057,CSE 293,016,094920,Kriegman; David J,9999,0,9999,0
1653535151057,CSE 293,017,094921,Kumar; Arun Kumar,9999,0,9999,0
1653535151057,CSE 293,018,094922,Lerner; Sorin,9999,0,9999,0
1653535151057,CSE 293,019,094923,Lovett; Shachar,9999,0,9999,0
1653535151057,CSE 293,020,094924,McAuley; Julian John,9999,0,9999,0
1653535151057,CSE 293,021,094925,Micciancio; Daniele,9999,0,9999,0
1653535151057,CSE 293,022,094926,Orailoglu; Alex,9999,0,9999,0
1653535151057,CSE 293,023,094927,Paturi; Ramamohan,9999,0,9999,0
1653535151057,CSE 293,024,094928,Polikarpova; Nadezhda,9999,0,9999,0
1653535151057,CSE 293,025,094929,Politz; Joseph Gibbs,9999,0,9999,0
1653535151057,CSE 293,026,094930,Porter; George M,9999,0,9999,0
1653535151057,CSE 293,027,094931,Porter; Leonard Emerson,9999,0,9999,0
1653535151057,CSE 293,028,094932,Ramamoorthi; Ravi,9999,0,9999,0
1653535151057,CSE 293,029,094933,Sahoo; Debashis,9999,0,9999,0
1653535151057,CSE 293,030,094934,Saul; Lawrence,9999,0,9999,0
1653535151057,CSE 293,031,094935,Savage; Stefan,9999,0,9999,0
1653535151057,CSE 293,032,094936,Schulze; Jurgen P.,9999,0,9999,0
1653535151057,CSE 293,033,094937,Snoeren; Alex C.,9999,0,9999,0
1653535151057,CSE 293,034,094938,Shang; Jingbo,9999,0,9999,0
1653535151057,CSE 293,035,094939,Stefan; Deian,9999,0,9999,0
1653535151057,CSE 293,036,094940,Su; Hao,9999,0,9999,0
1653535151057,CSE 293,037,094941,Swanson; Steven James,9999,0,9999,0
1653535151057,CSE 293,038,094942,Tullsen; Dean Michael,9999,0,9999,0
1653535151057,CSE 293,039,094943,Voelker; Geoffrey M.,9999,0,9999,0
1653535151057,CSE 293,040,094944,Zhao; Jishen,9999,0,9999,0
1653535151057,CSE 293,041,094945,Zhou; Yuan-Yuan,9999,0,9999,0
1653535151057,CSE 293,042,094946,Gao; Sicun,9998,0,9999,1
1653535151057,CSE 293,043,094947,Weibel; Nadir,9999,0,9999,0
1653535151057,CSE 293,044,094948,Gupta; Rajesh K.,9999,0,9999,0
1653535151580,CSE 294,A00,090143,Porter; George M,8,0,10,2
1653535152106,DSE 200,A00,091799,Staff,50,0,50,0
1653535152631,DSE 203,A00,091800,Gupta; Amarnath,30,0,30,0
1653535153158,DSE 250,A00,091801,Deutsch; Alin Bernard,30,0,30,0
1653535153686,DSE 290,A00,091802,Altintas De Callaf; Ilkay,50,0,50,0
1653535154214,ECE 200,001,091003,Antipa; Nicholas A,9999,0,9999,0
1653535154214,ECE 200,002,091004,Atanasov; Nikolay A.,9999,0,9999,0
1653535154214,ECE 200,003,091005,Bharadia; Dinesh,9999,0,9999,0
1653535154214,ECE 200,004,091006,Cheng; Chung Kuan,9999,0,9999,0
1653535154214,ECE 200,005,091007,Cosman; Pamela C.,9999,0,9999,0
1653535154214,ECE 200,006,091008,Staff,9999,0,9999,0
1653535154214,ECE 200,007,091009,Dayeh; Shadi Ahmad,9999,0,9999,0
1653535154214,ECE 200,008,091010,Fainman; Yeshaiahu,9999,0,9999,0
1653535154214,ECE 200,009,091011,Ford; Joseph Earl,9999,0,9999,0
1653535154214,ECE 200,010,091012,Franceschetti; Massimo,9999,0,9999,0
1653535154214,ECE 200,011,091013,Fullerton; Eric E,9999,0,9999,0
1653535154214,ECE 200,012,091014,Galton; Ian A,9999,0,9999,0
1653535154214,ECE 200,013,091015,Gilja; Vikash,9999,0,9999,0
1653535154214,ECE 200,014,091016,Hall; Drew A.,9999,0,9999,0
1653535154214,ECE 200,015,091017,Hsueh; Tzu-Chien,9999,0,9999,0
1653535154214,ECE 200,016,091018,Javidi; Tara,9999,0,9999,0
1653535154214,ECE 200,017,091019,Kahng; Andrew Byun,9999,0,9999,0
1653535154214,ECE 200,018,091020,Kim; Young-Han,9999,0,9999,0
1653535154214,ECE 200,019,091021,Koushanfar; Farinaz,9999,0,9999,0
1653535154214,ECE 200,020,091022,Kuzum; Duygu,9999,0,9999,0
1653535154214,ECE 200,021,091023,Le; Hanh-Phuc,9999,0,9999,0
1653535154214,ECE 200,022,091024,Lin; Bill,9999,0,9999,0
1653535154214,ECE 200,023,091025,Liu; Zhaowei,9999,0,9999,0
1653535154214,ECE 200,024,091026,Lo; Yu-Hwa,9999,0,9999,0
1653535154214,ECE 200,025,091027,Lomakin; Vitaliy,9999,0,9999,0
1653535154214,ECE 200,026,091028,Mercier; Patrick Philip,9999,0,9999,0
1653535154214,ECE 200,027,091029,Meyer; Florian,9999,0,9999,0
1653535154214,ECE 200,028,091030,Milstein; Laurence B.,9999,0,9999,0
1653535154214,ECE 200,029,091031,Mir Arabbaygi; Siavash,9999,0,9999,0
1653535154214,ECE 200,030,091032,Mookherjea; Shayan,9999,0,9999,0
1653535154214,ECE 200,031,091033,Morris; Karcher William,9999,0,9999,0
1653535154214,ECE 200,032,091034,Ng; Tse Nga,9999,0,9999,0
1653535154214,ECE 200,033,091035,Nguyen; Truong Quang,9999,0,9999,0
1653535154214,ECE 200,034,091036,Nomura; Kenji,9999,0,9999,0
1653535154214,ECE 200,035,091037,Orlitsky; Alon,9999,0,9999,0
1653535154214,ECE 200,036,091038,Pal; Piya,9999,0,9999,0
1653535154214,ECE 200,037,091039,Papen; George C.,9999,0,9999,0
1653535154214,ECE 200,038,091040,Radic; Stojan,9999,0,9999,0
1653535154214,ECE 200,039,091041,Rao; Bhaskar D.,9999,0,9999,0
1653535154214,ECE 200,040,091042,Rao; Ramesh R,9999,0,9999,0
1653535154214,ECE 200,041,091043,Rebeiz; Gabriel,9999,0,9999,0
1653535154214,ECE 200,042,091044,Sanford; John R,9999,0,9999,0
1653535154214,ECE 200,043,091045,Siegel; Paul H.,9999,0,9999,0
1653535154214,ECE 200,044,091046,Sievenpiper; Daniel F.,9999,0,9999,0
1653535154214,ECE 200,045,091047,Sworder; David D.,9999,0,9999,0
1653535154214,ECE 200,046,091048,Taur; Yuan,9999,0,9999,0
1653535154214,ECE 200,047,091049,Touri; Behrouz,9999,0,9999,0
1653535154214,ECE 200,048,091050,Trivedi; Mohan M.,9999,0,9999,0
1653535154214,ECE 200,049,091051,Vardy; Alexander,9999,0,9999,0
1653535154214,ECE 200,050,091052,Vasconcelos; Nuno,9999,0,9999,0
1653535154214,ECE 200,051,091053,Wang; Xiaolong,9999,0,9999,0
1653535154214,ECE 200,052,091054,Xie; Pengtao,9999,0,9999,0
1653535154214,ECE 200,053,091055,Yip; Michael,9999,0,9999,0
1653535154214,ECE 200,054,091056,Zeger; Kenneth A.,9999,0,9999,0
1653535154214,ECE 200,055,091057,Zhang; Xinyu,9999,0,9999,0
1653535154214,ECE 200,056,091058,Turakhia; Yatish Girish,9999,0,9999,0
1653535154214,ECE 200,057,091059,Kang; Mingu,9999,0,9999,0
1653535154214,ECE 200,058,091060,Shi; Yuanyuan,9999,0,9999,0
1653535154214,ECE 200,059,091061,Wang; Edward Jay,9999,0,9999,0
1653535154214,ECE 200,060,091062,Zheng; Yang,9999,0,9999,0
1653535154739,ECE 201,A00,095526,Lo; Yu-Hwa,0,0,0,0
1653535155262,ECE 203,A00,091065,Mercier; Patrick Philip,0,0,0,0
1653535155786,ECE 207A,A00,091605,Liu; Thomas Tao-Ming,0,0,0,0
1653535156310,ECE 212AN,A00,091068,Nomura; Kenji,0,0,0,0
1653535156832,ECE 222A,A00,091069,Rebeiz; Gabriel,0,0,0,0
1653535157360,ECE 225A,A00,091070,Orlitsky; Alon,0,0,0,0
1653535157883,ECE 230A,A00,091071,Nomura; Kenji,0,0,0,0
1653535158406,ECE 236A,A00,091072,Dayeh; Shadi Ahmad,0,0,0,0
1653535158929,ECE 238A,A00,091073,Luo; Jian,0,0,0,0
1653535158929,ECE 238A,B00,091074,Luo; Jian,0,0,0,0
1653535159452,ECE 240A,A00,091075,Radic; Stojan,0,0,0,0
1653535159975,ECE 247A,A00,091592,Shi; Lingyan,0,0,0,0
1653535160498,ECE 250,A00,091076,Touri; Behrouz,0,0,0,0
1653535161034,ECE 251C,A00,091078,Nguyen; Truong Quang,0,0,0,0
1653535161559,ECE 253,A00,091079,Cosman; Pamela C.,0,0,0,0
1653535162090,ECE 255A,A00,091080,Orlitsky; Alon,0,0,0,0
1653535162619,ECE 257A,A00,091081,Zhang; Xinyu,0,0,0,0
1653535163147,ECE 260A,A01,091084,Eldon; John,0,0,0,0
1653535163673,ECE 264C,A00,091085,Galton; Ian A,0,0,0,0
1653535164195,ECE 265C,A00,094889,Presti; Calogero Davide,0,0,0,9
1653535164726,ECE 266,A01,091087,Hall; Drew A.,0,0,0,0
1653535165771,ECE 271A,A00,091090,Vasconcelos; Nuno,0,0,0,0
1653535166303,ECE 272B,A00,091091,Sworder; David D.,0,0,0,0
1653535166826,ECE 275A,A00,091092,Meyer; Florian,0,0,0,0
1653535167349,ECE 277,A00,091093,An; Cheolhong,0,0,0,0
1653535167874,ECE 283,A00,091094,Le; Hanh-Phuc,0,0,0,0
1653535168396,ECE 284,A00,091095,Kang; Mingu,0,0,0,0
1653535168396,ECE 284,B00,091096,Wang; Edward Jay,0,0,0,0
1653535168922,ECE 285,A00,094334,Touri; Behrouz,0,0,0,0
1653535169448,ECE 289,A00,091097,Whelan; David Arthur,0,0,0,0
1653535169974,MATH 200A,A00,087414,Salehi Golsefidy; Alireza,7,0,8,1
1653535170497,MATH 202A,A00,087415,Gill; Philip E.,2,0,8,6
1653535171117,MATH 203A,A00,087416,Oprea; Dragos N.,6,0,8,2
1653535171642,MATH 204A,A00,087417,Kedlaya; Kiran S.,6,0,8,2
1653535172167,MATH 205,A00,087418,Sorensen; Claus M,6,0,8,2
1653535172688,MATH 206A,A00,087419,Izadi; Elham,7,0,8,1
1653535173213,MATH 207A,A00,087420,Mohammadi; Amir,5,0,8,3
1653535173736,MATH 208,A00,087421,Staff,9,0,10,1
1653535174258,MATH 209,A00,087422,Staff,10,0,10,0
1653535174780,MATH 218,A00,087423,Staff,10,0,10,0
1653535175305,MATH 220A,A00,087424,Novak; Jonathan I,7,0,8,1
1653535175828,MATH 231A,A00,087425,Bejenaru; Ioan,3,0,8,5
1653535176351,MATH 240A,A00,087426,Ebenfelt; Peter F,5,0,8,3
1653535176877,MATH 243,A00,087427,Staff,9,0,10,1
1653535177401,MATH 248,A00,087429,Staff,10,0,10,0
1653535177929,MATH 250A,A00,087430,Spolaor; Luca,4,0,8,4
1653535178453,MATH 257A,A00,087431,Spolaor; Luca,7,0,8,1
1653535178977,MATH 258,A00,087432,Staff,9,0,10,1
1653535179499,MATH 264A,A00,087433,Warnke; Lutz Peter,5,0,8,3
1653535180025,MATH 268,A00,087434,Staff,15,0,15,0
1653535180546,MATH 269,A00,087435,Staff,14,0,15,1
1653535181073,MATH 270A,A00,087436,Nie; Jiawang,0,0,8,8
1653535181600,MATH 272A,A00,087437,Tian; Xiaochuan,1,0,8,7
1653535182127,MATH 274,A01,087439,Cheng; Li-Tien,9,0,10,1
1653535182127,MATH 274,A02,087440,Cheng; Li-Tien,10,0,10,0
1653535182649,MATH 278A,A00,087441,Staff,8,0,10,2
1653535183171,MATH 278B,A00,087442,Staff,8,0,10,2
1653535183700,MATH 278C,A00,087443,Staff,8,0,10,2
1653535184223,MATH 280A,A00,087444,Zheng; Tianyi,0,0,8,8
1653535184748,MATH 281A,A00,087445,Bradic; Jelena,0,0,8,8
1653535185272,MATH 282A,A00,087446,Zhang; Danna,0,0,8,8
1653535185796,MATH 283,A00,087447,Tesler; Glenn,0,0,0,15
1653535186321,MATH 286,A00,087448,Kemp; Todd Aahron,5,0,8,3
1653535186844,MATH 287D,A00,087449,Bradic; Jelena,0,0,0,0
1653535187367,MATH 288,A00,087450,Staff,14,0,15,1
1653535187367,MATH 288,B00,087451,Staff,15,0,15,0
1653535187367,MATH 288,C00,087452,Staff,15,0,15,0
1653535187890,MATH 290A,A00,087453,Xu; Zhouli,6,0,8,2
1653535188416,MATH 291A,A00,087454,Xu; Zhouli,7,0,8,1
1653535188938,MATH 292,A00,087455,Staff,10,0,10,0
1653535189463,MATH 295,A00,087456,Staff,50,0,50,0
1653535189988,MATH 297,001,087457,Staff,998,0,999,1
1653535748785,COGS 200,A01,087991,Staff,47,0,50,3
1653535749305,COGS 201,A01,094504,Rangel; Lara M,17,0,25,8
1653535749831,COGS 203,A00,087992,Coulson; Seana M,18,0,20,2
1653535750353,COGS 210A,001,087993,Greene; Deanna Jacquelyn,9998,0,9999,1
1653535750353,COGS 210A,002,087994,Saygin; Ayse P,9999,0,9999,0
1653535750353,COGS 210A,003,087995,Xia; Haijun,9999,0,9999,0
1653535750353,COGS 210A,004,087996,Nitz; Douglas A.,9999,0,9999,0
1653535750353,COGS 210A,005,087997,Hollan; James D.,9999,0,9999,0
1653535750353,COGS 210A,006,087998,Deak; Gedeon O.,9998,0,9999,1
1653535750353,COGS 210A,007,087999,Rossano; Federico,9999,0,9999,0
1653535750875,COGS 211A,A00,088000,Coulson; Seana M,9997,0,9999,2
1653535751397,COGS 229,A00,088002,Staff,23,0,25,2
1653535751919,COGS 260,B00,094231,Staff,17,0,20,3
1653535751919,COGS 260,A00,088004,Nitz; Douglas A.,9998,0,9999,1
1653535752443,CSE 202,A00,090110,Paturi; Ramamohan,0,0,0,0
1653535752443,CSE 202,B00,090111,Paturi; Ramamohan,0,0,0,0
1653535752968,CSE 207B,A00,090112,Heninger; Nadia A,0,0,0,0
1653535753492,CSE 208,A00,094858,Micciancio; Daniele,0,0,0,0
1653535754016,CSE 210,A00,090113,Powell; Thomas Allan,0,0,0,0
1653535754541,CSE 219,A00,090898,Staff,0,0,0,0
1653535755073,CSE 221,A00,090114,Zhou; Yuan-Yuan,0,0,0,0
1653535755597,CSE 229A,A00,090115,Porter; George M,0,0,0,0
1653535756120,CSE 229C,A00,090116,Savage; Stefan,0,0,0,0
1653535756644,CSE 230,A00,090117,Jhala; Ranjit,0,0,0,0
1653535757241,CSE 232,A00,090118,Papakonstantinou; Yannis,0,0,0,0
1653535757764,CSE 239A,A00,090121,Kumar; Arun Kumar,0,0,0,0
1653535758290,CSE 239B,A00,090122,Jhala; Ranjit,0,0,0,0
1653535758815,CSE 240A,A00,090123,Zhao; Jishen,0,0,189,189
1653535759341,CSE 243A,A00,090124,Orailoglu; Alex,0,0,15,15
1653535759865,CSE 249B,A00,090125,Kahng; Andrew Byun,13,0,20,7
1653535760386,CSE 250A,A00,090126,Berg-Kirkpatrick; Taylor D,0,0,0,0
1653535760911,CSE 252A,A00,090127,Ochoa; Benjamin Lawrence,0,0,0,0
1653535761436,CSE 258,A01,090129,McAuley; Julian John,0,0,0,0
1653535761959,CSE 258R,A01,090131,McAuley; Julian John,0,0,0,0
1653535762483,CSE 274,A00,090132,Ramamoorthi; Ravi,0,0,0,0
1653535763006,CSE 276A,A00,090133,Christensen; Henrik I,0,0,0,0
1653535763532,CSE 276C,A00,090134,Christensen; Henrik I,0,0,0,0
1653535764055,CSE 290,A00,090135,Bafna; Vineet,0,0,0,0
1653535764055,CSE 290,B00,090136,Ramamoorthi; Ravi,0,0,0,0
1653535764055,CSE 290,C00,090137,Li; Tzumao,8,0,10,2
1653535764055,CSE 290,D00,090138,Zhou; Yuan-Yuan,9,0,10,1
1653535764055,CSE 290,E00,090139,Christensen; Henrik I,8,0,10,2
1653535764055,CSE 290,F00,094053,Shalev; Aaron D,0,0,0,0
1653535764578,CSE 291,A00,090140,Munyaka; Imani N. S.,0,0,0,0
1653535764578,CSE 291,B00,094880,Yu; Qi,0,0,0,0
1653535764578,CSE 291,C00,090142,Pannuto; Patrick William,0,0,0,0
1653535764578,CSE 291,D00,094881,Zhang; Yiying,0,0,0,0
1653535764578,CSE 291,E00,095118,Su; Hao,0,0,0,0
1653535765105,CSE 293,001,094905,Bafna; Vineet,9999,0,9999,0
1653535765105,CSE 293,002,094906,Bellare; Mihir,9999,0,9999,0
1653535765105,CSE 293,003,094907,Berg-Kirkpatrick; Taylor D,9999,0,9999,0
1653535765105,CSE 293,004,094908,Christensen; Henrik I,9999,0,9999,0
1653535765105,CSE 293,005,094909,Cottrell; Garrison W,9999,0,9999,0
1653535765105,CSE 293,006,094910,Deutsch; Alin Bernard,9999,0,9999,0
1653535765105,CSE 293,007,094911,Esmaeilzadeh; Hadi,9999,0,9999,0
1653535765105,CSE 293,008,094912,Freund; Yoav,9999,0,9999,0
1653535765105,CSE 293,009,094913,Griswold; William G.,9999,0,9999,0
1653535765105,CSE 293,010,094914,Gymrek; Melissa Ann,9999,0,9999,0
1653535765105,CSE 293,011,094915,Heninger; Nadia A,9999,0,9999,0
1653535765105,CSE 293,012,094916,Impagliazzo; Russell,9999,0,9999,0
1653535765105,CSE 293,013,094917,Jhala; Ranjit,9999,0,9999,0
1653535765105,CSE 293,014,094918,Kahng; Andrew Byun,9999,0,9999,0
1653535765105,CSE 293,015,094919,Kane; Daniel Mertz,9999,0,9999,0
1653535765105,CSE 293,016,094920,Kriegman; David J,9999,0,9999,0
1653535765105,CSE 293,017,094921,Kumar; Arun Kumar,9999,0,9999,0
1653535765105,CSE 293,018,094922,Lerner; Sorin,9999,0,9999,0
1653535765105,CSE 293,019,094923,Lovett; Shachar,9999,0,9999,0
1653535765105,CSE 293,020,094924,McAuley; Julian John,9999,0,9999,0
1653535765105,CSE 293,021,094925,Micciancio; Daniele,9999,0,9999,0
1653535765105,CSE 293,022,094926,Orailoglu; Alex,9999,0,9999,0
1653535765105,CSE 293,023,094927,Paturi; Ramamohan,9999,0,9999,0
1653535765105,CSE 293,024,094928,Polikarpova; Nadezhda,9999,0,9999,0
1653535765105,CSE 293,025,094929,Politz; Joseph Gibbs,9999,0,9999,0
1653535765105,CSE 293,026,094930,Porter; George M,9999,0,9999,0
1653535765105,CSE 293,027,094931,Porter; Leonard Emerson,9999,0,9999,0
1653535765105,CSE 293,028,094932,Ramamoorthi; Ravi,9999,0,9999,0
1653535765105,CSE 293,029,094933,Sahoo; Debashis,9999,0,9999,0
1653535765105,CSE 293,030,094934,Saul; Lawrence,9999,0,9999,0
1653535765105,CSE 293,031,094935,Savage; Stefan,9999,0,9999,0
1653535765105,CSE 293,032,094936,Schulze; Jurgen P.,9999,0,9999,0
1653535765105,CSE 293,033,094937,Snoeren; Alex C.,9999,0,9999,0
1653535765105,CSE 293,034,094938,Shang; Jingbo,9999,0,9999,0
1653535765105,CSE 293,035,094939,Stefan; Deian,9999,0,9999,0
1653535765105,CSE 293,036,094940,Su; Hao,9999,0,9999,0
1653535765105,CSE 293,037,094941,Swanson; Steven James,9999,0,9999,0
1653535765105,CSE 293,038,094942,Tullsen; Dean Michael,9999,0,9999,0
1653535765105,CSE 293,039,094943,Voelker; Geoffrey M.,9999,0,9999,0
1653535765105,CSE 293,040,094944,Zhao; Jishen,9999,0,9999,0
1653535765105,CSE 293,041,094945,Zhou; Yuan-Yuan,9999,0,9999,0
1653535765105,CSE 293,042,094946,Gao; Sicun,9998,0,9999,1
1653535765105,CSE 293,043,094947,Weibel; Nadir,9999,0,9999,0
1653535765105,CSE 293,044,094948,Gupta; Rajesh K.,9999,0,9999,0
1653535765630,CSE 294,A00,090143,Porter; George M,8,0,10,2
1653535766154,DSE 200,A00,091799,Staff,50,0,50,0
1653535766678,DSE 203,A00,091800,Gupta; Amarnath,30,0,30,0
1653535767202,DSE 250,A00,091801,Deutsch; Alin Bernard,30,0,30,0
1653535767726,DSE 290,A00,091802,Altintas De Callaf; Ilkay,50,0,50,0
1653535768256,ECE 200,001,091003,Antipa; Nicholas A,9999,0,9999,0
1653535768256,ECE 200,002,091004,Atanasov; Nikolay A.,9999,0,9999,0
1653535768256,ECE 200,003,091005,Bharadia; Dinesh,9999,0,9999,0
1653535768256,ECE 200,004,091006,Cheng; Chung Kuan,9999,0,9999,0
1653535768256,ECE 200,005,091007,Cosman; Pamela C.,9999,0,9999,0
1653535768256,ECE 200,006,091008,Staff,9999,0,9999,0
1653535768256,ECE 200,007,091009,Dayeh; Shadi Ahmad,9999,0,9999,0
1653535768256,ECE 200,008,091010,Fainman; Yeshaiahu,9999,0,9999,0
1653535768256,ECE 200,009,091011,Ford; Joseph Earl,9999,0,9999,0
1653535768256,ECE 200,010,091012,Franceschetti; Massimo,9999,0,9999,0
1653535768256,ECE 200,011,091013,Fullerton; Eric E,9999,0,9999,0
1653535768256,ECE 200,012,091014,Galton; Ian A,9999,0,9999,0
1653535768256,ECE 200,013,091015,Gilja; Vikash,9999,0,9999,0
1653535768256,ECE 200,014,091016,Hall; Drew A.,9999,0,9999,0
1653535768256,ECE 200,015,091017,Hsueh; Tzu-Chien,9999,0,9999,0
1653535768256,ECE 200,016,091018,Javidi; Tara,9999,0,9999,0
1653535768256,ECE 200,017,091019,Kahng; Andrew Byun,9999,0,9999,0
1653535768256,ECE 200,018,091020,Kim; Young-Han,9999,0,9999,0
1653535768256,ECE 200,019,091021,Koushanfar; Farinaz,9999,0,9999,0
1653535768256,ECE 200,020,091022,Kuzum; Duygu,9999,0,9999,0
1653535768256,ECE 200,021,091023,Le; Hanh-Phuc,9999,0,9999,0
1653535768256,ECE 200,022,091024,Lin; Bill,9999,0,9999,0
1653535768256,ECE 200,023,091025,Liu; Zhaowei,9999,0,9999,0
1653535768256,ECE 200,024,091026,Lo; Yu-Hwa,9999,0,9999,0
1653535768256,ECE 200,025,091027,Lomakin; Vitaliy,9999,0,9999,0
1653535768256,ECE 200,026,091028,Mercier; Patrick Philip,9999,0,9999,0
1653535768256,ECE 200,027,091029,Meyer; Florian,9999,0,9999,0
1653535768256,ECE 200,028,091030,Milstein; Laurence B.,9999,0,9999,0
1653535768256,ECE 200,029,091031,Mir Arabbaygi; Siavash,9999,0,9999,0
1653535768256,ECE 200,030,091032,Mookherjea; Shayan,9999,0,9999,0
1653535768256,ECE 200,031,091033,Morris; Karcher William,9999,0,9999,0
1653535768256,ECE 200,032,091034,Ng; Tse Nga,9999,0,9999,0
1653535768256,ECE 200,033,091035,Nguyen; Truong Quang,9999,0,9999,0
1653535768256,ECE 200,034,091036,Nomura; Kenji,9999,0,9999,0
1653535768256,ECE 200,035,091037,Orlitsky; Alon,9999,0,9999,0
1653535768256,ECE 200,036,091038,Pal; Piya,9999,0,9999,0
1653535768256,ECE 200,037,091039,Papen; George C.,9999,0,9999,0
1653535768256,ECE 200,038,091040,Radic; Stojan,9999,0,9999,0
1653535768256,ECE 200,039,091041,Rao; Bhaskar D.,9999,0,9999,0
1653535768256,ECE 200,040,091042,Rao; Ramesh R,9999,0,9999,0
1653535768256,ECE 200,041,091043,Rebeiz; Gabriel,9999,0,9999,0
1653535768256,ECE 200,042,091044,Sanford; John R,9999,0,9999,0
1653535768256,ECE 200,043,091045,Siegel; Paul H.,9999,0,9999,0
1653535768256,ECE 200,044,091046,Sievenpiper; Daniel F.,9999,0,9999,0
1653535768256,ECE 200,045,091047,Sworder; David D.,9999,0,9999,0
1653535768256,ECE 200,046,091048,Taur; Yuan,9999,0,9999,0
1653535768256,ECE 200,047,091049,Touri; Behrouz,9999,0,9999,0
1653535768256,ECE 200,048,091050,Trivedi; Mohan M.,9999,0,9999,0
1653535768256,ECE 200,049,091051,Vardy; Alexander,9999,0,9999,0
1653535768256,ECE 200,050,091052,Vasconcelos; Nuno,9999,0,9999,0
1653535768256,ECE 200,051,091053,Wang; Xiaolong,9999,0,9999,0
1653535768256,ECE 200,052,091054,Xie; Pengtao,9999,0,9999,0
1653535768256,ECE 200,053,091055,Yip; Michael,9999,0,9999,0
1653535768256,ECE 200,054,091056,Zeger; Kenneth A.,9999,0,9999,0
1653535768256,ECE 200,055,091057,Zhang; Xinyu,9999,0,9999,0
1653535768256,ECE 200,056,091058,Turakhia; Yatish Girish,9999,0,9999,0
1653535768256,ECE 200,057,091059,Kang; Mingu,9999,0,9999,0
1653535768256,ECE 200,058,091060,Shi; Yuanyuan,9999,0,9999,0
1653535768256,ECE 200,059,091061,Wang; Edward Jay,9999,0,9999,0
1653535768256,ECE 200,060,091062,Zheng; Yang,9999,0,9999,0
1653535768779,ECE 201,A00,095526,Lo; Yu-Hwa,0,0,0,0
1653535769314,ECE 203,A00,091065,Mercier; Patrick Philip,0,0,0,0
1653535769837,ECE 207A,A00,091605,Liu; Thomas Tao-Ming,0,0,0,0
1653535770358,ECE 212AN,A00,091068,Nomura; Kenji,0,0,0,0
1653535770881,ECE 222A,A00,091069,Rebeiz; Gabriel,0,0,0,0
1653535771404,ECE 225A,A00,091070,Orlitsky; Alon,0,0,0,0
1653535771927,ECE 230A,A00,091071,Nomura; Kenji,0,0,0,0
1653535772455,ECE 236A,A00,091072,Dayeh; Shadi Ahmad,0,0,0,0
1653535772977,ECE 238A,A00,091073,Luo; Jian,0,0,0,0
1653535772977,ECE 238A,B00,091074,Luo; Jian,0,0,0,0
1653535773502,ECE 240A,A00,091075,Radic; Stojan,0,0,0,0
1653535774039,ECE 247A,A00,091592,Shi; Lingyan,0,0,0,0
1653535774561,ECE 250,A00,091076,Touri; Behrouz,0,0,0,0
1653535775082,ECE 251C,A00,091078,Nguyen; Truong Quang,0,0,0,0
1653535775604,ECE 253,A00,091079,Cosman; Pamela C.,0,0,0,0
1653535776132,ECE 255A,A00,091080,Orlitsky; Alon,0,0,0,0
1653535776660,ECE 257A,A00,091081,Zhang; Xinyu,0,0,0,0
1653535777183,ECE 260A,A01,091084,Eldon; John,0,0,0,0
1653535777710,ECE 264C,A00,091085,Galton; Ian A,0,0,0,0
1653535778233,ECE 265C,A00,094889,Presti; Calogero Davide,0,0,0,9
1653535778759,ECE 266,A01,091087,Hall; Drew A.,0,0,0,0
1653535779800,ECE 271A,A00,091090,Vasconcelos; Nuno,0,0,0,0
1653535780336,ECE 272B,A00,091091,Sworder; David D.,0,0,0,0
1653535780862,ECE 275A,A00,091092,Meyer; Florian,0,0,0,0
1653535781383,ECE 277,A00,091093,An; Cheolhong,0,0,0,0
1653535781912,ECE 283,A00,091094,Le; Hanh-Phuc,0,0,0,0
1653535782435,ECE 284,A00,091095,Kang; Mingu,0,0,0,0
1653535782435,ECE 284,B00,091096,Wang; Edward Jay,0,0,0,0
1653535782960,ECE 285,A00,094334,Touri; Behrouz,0,0,0,0
1653535783482,ECE 289,A00,091097,Whelan; David Arthur,0,0,0,0
1653535784009,MATH 200A,A00,087414,Salehi Golsefidy; Alireza,7,0,8,1
1653535784532,MATH 202A,A00,087415,Gill; Philip E.,2,0,8,6
1653535785061,MATH 203A,A00,087416,Oprea; Dragos N.,6,0,8,2
1653535785597,MATH 204A,A00,087417,Kedlaya; Kiran S.,6,0,8,2
1653535786119,MATH 205,A00,087418,Sorensen; Claus M,6,0,8,2
1653535786643,MATH 206A,A00,087419,Izadi; Elham,7,0,8,1
1653535787166,MATH 207A,A00,087420,Mohammadi; Amir,5,0,8,3
1653535787692,MATH 208,A00,087421,Staff,9,0,10,1
1653535788214,MATH 209,A00,087422,Staff,10,0,10,0
1653535788736,MATH 218,A00,087423,Staff,10,0,10,0
1653535789259,MATH 220A,A00,087424,Novak; Jonathan I,7,0,8,1
1653535789782,MATH 231A,A00,087425,Bejenaru; Ioan,3,0,8,5
1653535790304,MATH 240A,A00,087426,Ebenfelt; Peter F,5,0,8,3
1653535790831,MATH 243,A00,087427,Staff,9,0,10,1
1653535791353,MATH 248,A00,087429,Staff,10,0,10,0
1653535791876,MATH 250A,A00,087430,Spolaor; Luca,4,0,8,4
1653535792399,MATH 257A,A00,087431,Spolaor; Luca,7,0,8,1
1653535792921,MATH 258,A00,087432,Staff,9,0,10,1
1653535793444,MATH 264A,A00,087433,Warnke; Lutz Peter,5,0,8,3
1653535793967,MATH 268,A00,087434,Staff,15,0,15,0
1653535794492,MATH 269,A00,087435,Staff,14,0,15,1
1653535795014,MATH 270A,A00,087436,Nie; Jiawang,0,0,8,8
1653535795538,MATH 272A,A00,087437,Tian; Xiaochuan,1,0,8,7
1653535796061,MATH 274,A01,087439,Cheng; Li-Tien,9,0,10,1
1653535796061,MATH 274,A02,087440,Cheng; Li-Tien,10,0,10,0
1653535796590,MATH 278A,A00,087441,Staff,8,0,10,2
1653535797114,MATH 278B,A00,087442,Staff,8,0,10,2
1653535797638,MATH 278C,A00,087443,Staff,8,0,10,2
1653535798163,MATH 280A,A00,087444,Zheng; Tianyi,0,0,8,8
1653535798689,MATH 281A,A00,087445,Bradic; Jelena,0,0,8,8
1653535799215,MATH 282A,A00,087446,Zhang; Danna,0,0,8,8
1653535799735,MATH 283,A00,087447,Tesler; Glenn,0,0,0,15
1653535800261,MATH 286,A00,087448,Kemp; Todd Aahron,5,0,8,3
1653535800788,MATH 287D,A00,087449,Bradic; Jelena,0,0,0,0
1653535801315,MATH 288,A00,087450,Staff,14,0,15,1
1653535801315,MATH 288,B00,087451,Staff,15,0,15,0
1653535801315,MATH 288,C00,087452,Staff,15,0,15,0
1653535801837,MATH 290A,A00,087453,Xu; Zhouli,6,0,8,2
1653535802358,MATH 291A,A00,087454,Xu; Zhouli,7,0,8,1
1653535802888,MATH 292,A00,087455,Staff,10,0,10,0
1653535803410,MATH 295,A00,087456,Staff,50,0,50,0
1653535803935,MATH 297,001,087457,Staff,998,0,999,1
1653536363032,COGS 200,A01,087991,Staff,47,0,50,3
1653536363567,COGS 201,A01,094504,Rangel; Lara M,17,0,25,8
1653536364090,COGS 203,A00,087992,Coulson; Seana M,18,0,20,2
1653536364617,COGS 210A,001,087993,Greene; Deanna Jacquelyn,9998,0,9999,1
1653536364617,COGS 210A,002,087994,Saygin; Ayse P,9999,0,9999,0
1653536364617,COGS 210A,003,087995,Xia; Haijun,9999,0,9999,0
1653536364617,COGS 210A,004,087996,Nitz; Douglas A.,9999,0,9999,0
1653536364617,COGS 210A,005,087997,Hollan; James D.,9999,0,9999,0
1653536364617,COGS 210A,006,087998,Deak; Gedeon O.,9998,0,9999,1
1653536364617,COGS 210A,007,087999,Rossano; Federico,9999,0,9999,0
1653536365139,COGS 211A,A00,088000,Coulson; Seana M,9997,0,9999,2
1653536365663,COGS 229,A00,088002,Staff,23,0,25,2
1653536366187,COGS 260,B00,094231,Staff,17,0,20,3
1653536366187,COGS 260,A00,088004,Nitz; Douglas A.,9998,0,9999,1
1653536366730,CSE 202,A00,090110,Paturi; Ramamohan,0,0,0,0
1653536366730,CSE 202,B00,090111,Paturi; Ramamohan,0,0,0,0
1653536367256,CSE 207B,A00,090112,Heninger; Nadia A,0,0,0,0
1653536367782,CSE 208,A00,094858,Micciancio; Daniele,0,0,0,0
1653536368305,CSE 210,A00,090113,Powell; Thomas Allan,0,0,0,0
1653536368831,CSE 219,A00,090898,Staff,0,0,0,0
1653536369353,CSE 221,A00,090114,Zhou; Yuan-Yuan,0,0,0,0
1653536369897,CSE 229A,A00,090115,Porter; George M,0,0,0,0
1653536370424,CSE 229C,A00,090116,Savage; Stefan,0,0,0,0
1653536370946,CSE 230,A00,090117,Jhala; Ranjit,0,0,0,0
1653536371473,CSE 232,A00,090118,Papakonstantinou; Yannis,0,0,0,0
1653536371998,CSE 239A,A00,090121,Kumar; Arun Kumar,0,0,0,0
1653536372536,CSE 239B,A00,090122,Jhala; Ranjit,0,0,0,0
1653536373068,CSE 240A,A00,090123,Zhao; Jishen,0,0,189,189
1653536373591,CSE 243A,A00,090124,Orailoglu; Alex,0,0,15,15
1653536374121,CSE 249B,A00,090125,Kahng; Andrew Byun,13,0,20,7
1653536374652,CSE 250A,A00,090126,Berg-Kirkpatrick; Taylor D,0,0,0,0
1653536375181,CSE 252A,A00,090127,Ochoa; Benjamin Lawrence,0,0,0,0
1653536375705,CSE 258,A01,090129,McAuley; Julian John,0,0,0,0
1653536376233,CSE 258R,A01,090131,McAuley; Julian John,0,0,0,0
1653536376757,CSE 274,A00,090132,Ramamoorthi; Ravi,0,0,0,0
1653536377279,CSE 276A,A00,090133,Christensen; Henrik I,0,0,0,0
1653536377812,CSE 276C,A00,090134,Christensen; Henrik I,0,0,0,0
1653536378335,CSE 290,A00,090135,Bafna; Vineet,0,0,0,0
1653536378335,CSE 290,B00,090136,Ramamoorthi; Ravi,0,0,0,0
1653536378335,CSE 290,C00,090137,Li; Tzumao,8,0,10,2
1653536378335,CSE 290,D00,090138,Zhou; Yuan-Yuan,9,0,10,1
1653536378335,CSE 290,E00,090139,Christensen; Henrik I,8,0,10,2
1653536378335,CSE 290,F00,094053,Shalev; Aaron D,0,0,0,0
1653536378874,CSE 291,A00,090140,Munyaka; Imani N. S.,0,0,0,0
1653536378874,CSE 291,B00,094880,Yu; Qi,0,0,0,0
1653536378874,CSE 291,C00,090142,Pannuto; Patrick William,0,0,0,0
1653536378874,CSE 291,D00,094881,Zhang; Yiying,0,0,0,0
1653536378874,CSE 291,E00,095118,Su; Hao,0,0,0,0
1653536379406,CSE 293,001,094905,Bafna; Vineet,9999,0,9999,0
1653536379406,CSE 293,002,094906,Bellare; Mihir,9999,0,9999,0
1653536379406,CSE 293,003,094907,Berg-Kirkpatrick; Taylor D,9999,0,9999,0
1653536379406,CSE 293,004,094908,Christensen; Henrik I,9999,0,9999,0
1653536379406,CSE 293,005,094909,Cottrell; Garrison W,9999,0,9999,0
1653536379406,CSE 293,006,094910,Deutsch; Alin Bernard,9999,0,9999,0
1653536379406,CSE 293,007,094911,Esmaeilzadeh; Hadi,9999,0,9999,0
1653536379406,CSE 293,008,094912,Freund; Yoav,9999,0,9999,0
1653536379406,CSE 293,009,094913,Griswold; William G.,9999,0,9999,0
1653536379406,CSE 293,010,094914,Gymrek; Melissa Ann,9999,0,9999,0
1653536379406,CSE 293,011,094915,Heninger; Nadia A,9999,0,9999,0
1653536379406,CSE 293,012,094916,Impagliazzo; Russell,9999,0,9999,0
1653536379406,CSE 293,013,094917,Jhala; Ranjit,9999,0,9999,0
1653536379406,CSE 293,014,094918,Kahng; Andrew Byun,9999,0,9999,0
1653536379406,CSE 293,015,094919,Kane; Daniel Mertz,9999,0,9999,0
1653536379406,CSE 293,016,094920,Kriegman; David J,9999,0,9999,0
1653536379406,CSE 293,017,094921,Kumar; Arun Kumar,9999,0,9999,0
1653536379406,CSE 293,018,094922,Lerner; Sorin,9999,0,9999,0
1653536379406,CSE 293,019,094923,Lovett; Shachar,9999,0,9999,0
1653536379406,CSE 293,020,094924,McAuley; Julian John,9999,0,9999,0
1653536379406,CSE 293,021,094925,Micciancio; Daniele,9999,0,9999,0
1653536379406,CSE 293,022,094926,Orailoglu; Alex,9999,0,9999,0
1653536379406,CSE 293,023,094927,Paturi; Ramamohan,9999,0,9999,0
1653536379406,CSE 293,024,094928,Polikarpova; Nadezhda,9999,0,9999,0
1653536379406,CSE 293,025,094929,Politz; Joseph Gibbs,9999,0,9999,0
1653536379406,CSE 293,026,094930,Porter; George M,9999,0,9999,0
1653536379406,CSE 293,027,094931,Porter; Leonard Emerson,9999,0,9999,0
1653536379406,CSE 293,028,094932,Ramamoorthi; Ravi,9999,0,9999,0
1653536379406,CSE 293,029,094933,Sahoo; Debashis,9999,0,9999,0
1653536379406,CSE 293,030,094934,Saul; Lawrence,9999,0,9999,0
1653536379406,CSE 293,031,094935,Savage; Stefan,9999,0,9999,0
1653536379406,CSE 293,032,094936,Schulze; Jurgen P.,9999,0,9999,0
1653536379406,CSE 293,033,094937,Snoeren; Alex C.,9999,0,9999,0
1653536379406,CSE 293,034,094938,Shang; Jingbo,9999,0,9999,0
1653536379406,CSE 293,035,094939,Stefan; Deian,9999,0,9999,0
1653536379406,CSE 293,036,094940,Su; Hao,9999,0,9999,0
1653536379406,CSE 293,037,094941,Swanson; Steven James,9999,0,9999,0
1653536379406,CSE 293,038,094942,Tullsen; Dean Michael,9999,0,9999,0
1653536379406,CSE 293,039,094943,Voelker; Geoffrey M.,9999,0,9999,0
1653536379406,CSE 293,040,094944,Zhao; Jishen,9999,0,9999,0
1653536379406,CSE 293,041,094945,Zhou; Yuan-Yuan,9999,0,9999,0
1653536379406,CSE 293,042,094946,Gao; Sicun,9998,0,9999,1
1653536379406,CSE 293,043,094947,Weibel; Nadir,9999,0,9999,0
1653536379406,CSE 293,044,094948,Gupta; Rajesh K.,9999,0,9999,0
1653536379931,CSE 294,A00,090143,Porter; George M,8,0,10,2
1653536380455,DSE 200,A00,091799,Staff,50,0,50,0
1653536380980,DSE 203,A00,091800,Gupta; Amarnath,30,0,30,0
1653536381504,DSE 250,A00,091801,Deutsch; Alin Bernard,30,0,30,0
1653536382026,DSE 290,A00,091802,Altintas De Callaf; Ilkay,50,0,50,0
1653536382553,ECE 200,001,091003,Antipa; Nicholas A,9999,0,9999,0
1653536382553,ECE 200,002,091004,Atanasov; Nikolay A.,9999,0,9999,0
1653536382553,ECE 200,003,091005,Bharadia; Dinesh,9999,0,9999,0
1653536382553,ECE 200,004,091006,Cheng; Chung Kuan,9999,0,9999,0
1653536382553,ECE 200,005,091007,Cosman; Pamela C.,9999,0,9999,0
1653536382553,ECE 200,006,091008,Staff,9999,0,9999,0
1653536382553,ECE 200,007,091009,Dayeh; Shadi Ahmad,9999,0,9999,0
1653536382553,ECE 200,008,091010,Fainman; Yeshaiahu,9999,0,9999,0
1653536382553,ECE 200,009,091011,Ford; Joseph Earl,9999,0,9999,0
1653536382553,ECE 200,010,091012,Franceschetti; Massimo,9999,0,9999,0
1653536382553,ECE 200,011,091013,Fullerton; Eric E,9999,0,9999,0
1653536382553,ECE 200,012,091014,Galton; Ian A,9999,0,9999,0
1653536382553,ECE 200,013,091015,Gilja; Vikash,9999,0,9999,0
1653536382553,ECE 200,014,091016,Hall; Drew A.,9999,0,9999,0
1653536382553,ECE 200,015,091017,Hsueh; Tzu-Chien,9999,0,9999,0
1653536382553,ECE 200,016,091018,Javidi; Tara,9999,0,9999,0
1653536382553,ECE 200,017,091019,Kahng; Andrew Byun,9999,0,9999,0
1653536382553,ECE 200,018,091020,Kim; Young-Han,9999,0,9999,0
1653536382553,ECE 200,019,091021,Koushanfar; Farinaz,9999,0,9999,0
1653536382553,ECE 200,020,091022,Kuzum; Duygu,9999,0,9999,0
1653536382553,ECE 200,021,091023,Le; Hanh-Phuc,9999,0,9999,0
1653536382553,ECE 200,022,091024,Lin; Bill,9999,0,9999,0
1653536382553,ECE 200,023,091025,Liu; Zhaowei,9999,0,9999,0
1653536382553,ECE 200,024,091026,Lo; Yu-Hwa,9999,0,9999,0
1653536382553,ECE 200,025,091027,Lomakin; Vitaliy,9999,0,9999,0
1653536382553,ECE 200,026,091028,Mercier; Patrick Philip,9999,0,9999,0
1653536382553,ECE 200,027,091029,Meyer; Florian,9999,0,9999,0
1653536382553,ECE 200,028,091030,Milstein; Laurence B.,9999,0,9999,0
1653536382553,ECE 200,029,091031,Mir Arabbaygi; Siavash,9999,0,9999,0
1653536382553,ECE 200,030,091032,Mookherjea; Shayan,9999,0,9999,0
1653536382553,ECE 200,031,091033,Morris; Karcher William,9999,0,9999,0
1653536382553,ECE 200,032,091034,Ng; Tse Nga,9999,0,9999,0
1653536382553,ECE 200,033,091035,Nguyen; Truong Quang,9999,0,9999,0
1653536382553,ECE 200,034,091036,Nomura; Kenji,9999,0,9999,0
1653536382553,ECE 200,035,091037,Orlitsky; Alon,9999,0,9999,0
1653536382553,ECE 200,036,091038,Pal; Piya,9999,0,9999,0
1653536382553,ECE 200,037,091039,Papen; George C.,9999,0,9999,0
1653536382553,ECE 200,038,091040,Radic; Stojan,9999,0,9999,0
1653536382553,ECE 200,039,091041,Rao; Bhaskar D.,9999,0,9999,0
1653536382553,ECE 200,040,091042,Rao; Ramesh R,9999,0,9999,0
1653536382553,ECE 200,041,091043,Rebeiz; Gabriel,9999,0,9999,0
1653536382553,ECE 200,042,091044,Sanford; John R,9999,0,9999,0
1653536382553,ECE 200,043,091045,Siegel; Paul H.,9999,0,9999,0
1653536382553,ECE 200,044,091046,Sievenpiper; Daniel F.,9999,0,9999,0
1653536382553,ECE 200,045,091047,Sworder; David D.,9999,0,9999,0
1653536382553,ECE 200,046,091048,Taur; Yuan,9999,0,9999,0
1653536382553,ECE 200,047,091049,Touri; Behrouz,9999,0,9999,0
1653536382553,ECE 200,048,091050,Trivedi; Mohan M.,9999,0,9999,0
1653536382553,ECE 200,049,091051,Vardy; Alexander,9999,0,9999,0
1653536382553,ECE 200,050,091052,Vasconcelos; Nuno,9999,0,9999,0
1653536382553,ECE 200,051,091053,Wang; Xiaolong,9999,0,9999,0
1653536382553,ECE 200,052,091054,Xie; Pengtao,9999,0,9999,0
1653536382553,ECE 200,053,091055,Yip; Michael,9999,0,9999,0
1653536382553,ECE 200,054,091056,Zeger; Kenneth A.,9999,0,9999,0
1653536382553,ECE 200,055,091057,Zhang; Xinyu,9999,0,9999,0
1653536382553,ECE 200,056,091058,Turakhia; Yatish Girish,9999,0,9999,0
1653536382553,ECE 200,057,091059,Kang; Mingu,9999,0,9999,0
1653536382553,ECE 200,058,091060,Shi; Yuanyuan,9999,0,9999,0
1653536382553,ECE 200,059,091061,Wang; Edward Jay,9999,0,9999,0
1653536382553,ECE 200,060,091062,Zheng; Yang,9999,0,9999,0
1653536383080,ECE 201,A00,095526,Lo; Yu-Hwa,0,0,0,0
1653536383603,ECE 203,A00,091065,Mercier; Patrick Philip,0,0,0,0
1653536384126,ECE 207A,A00,091605,Liu; Thomas Tao-Ming,0,0,0,0
1653536384647,ECE 212AN,A00,091068,Nomura; Kenji,0,0,0,0
1653536385169,ECE 222A,A00,091069,Rebeiz; Gabriel,0,0,0,0
1653536385694,ECE 225A,A00,091070,Orlitsky; Alon,0,0,0,0
1653536386219,ECE 230A,A00,091071,Nomura; Kenji,0,0,0,0
1653536386743,ECE 236A,A00,091072,Dayeh; Shadi Ahmad,0,0,0,0
1653536387270,ECE 238A,A00,091073,Luo; Jian,0,0,0,0
1653536387270,ECE 238A,B00,091074,Luo; Jian,0,0,0,0
1653536387793,ECE 240A,A00,091075,Radic; Stojan,0,0,0,0
1653536388319,ECE 247A,A00,091592,Shi; Lingyan,0,0,0,0
1653536388844,ECE 250,A00,091076,Touri; Behrouz,0,0,0,0
1653536389368,ECE 251C,A00,091078,Nguyen; Truong Quang,0,0,0,0
1653536389891,ECE 253,A00,091079,Cosman; Pamela C.,0,0,0,0
1653536390417,ECE 255A,A00,091080,Orlitsky; Alon,0,0,0,0
1653536390940,ECE 257A,A00,091081,Zhang; Xinyu,0,0,0,0
1653536391462,ECE 260A,A01,091084,Eldon; John,0,0,0,0
1653536391985,ECE 264C,A00,091085,Galton; Ian A,0,0,0,0
1653536392507,ECE 265C,A00,094889,Presti; Calogero Davide,0,0,0,9
1653536393033,ECE 266,A01,091087,Hall; Drew A.,0,0,0,0
1653536394082,ECE 271A,A00,091090,Vasconcelos; Nuno,0,0,0,0
1653536394605,ECE 272B,A00,091091,Sworder; David D.,0,0,0,0
1653536395128,ECE 275A,A00,091092,Meyer; Florian,0,0,0,0
1653536395651,ECE 277,A00,091093,An; Cheolhong,0,0,0,0
1653536396174,ECE 283,A00,091094,Le; Hanh-Phuc,0,0,0,0
1653536396784,ECE 284,A00,091095,Kang; Mingu,0,0,0,0
1653536396784,ECE 284,B00,091096,Wang; Edward Jay,0,0,0,0
1653536397307,ECE 285,A00,094334,Touri; Behrouz,0,0,0,0
1653536397839,ECE 289,A00,091097,Whelan; David Arthur,0,0,0,0
1653536398371,MATH 200A,A00,087414,Salehi Golsefidy; Alireza,7,0,8,1
1653536398897,MATH 202A,A00,087415,Gill; Philip E.,2,0,8,6
1653536399428,MATH 203A,A00,087416,Oprea; Dragos N.,6,0,8,2
1653536399951,MATH 204A,A00,087417,Kedlaya; Kiran S.,6,0,8,2
1653536400474,MATH 205,A00,087418,Sorensen; Claus M,6,0,8,2
1653536400998,MATH 206A,A00,087419,Izadi; Elham,7,0,8,1
1653536401525,MATH 207A,A00,087420,Mohammadi; Amir,5,0,8,3
1653536402055,MATH 208,A00,087421,Staff,9,0,10,1
1653536402578,MATH 209,A00,087422,Staff,10,0,10,0
1653536403102,MATH 218,A00,087423,Staff,10,0,10,0
1653536403625,MATH 220A,A00,087424,Novak; Jonathan I,6,0,8,2
1653536404150,MATH 231A,A00,087425,Bejenaru; Ioan,3,0,8,5
1653536404675,MATH 240A,A00,087426,Ebenfelt; Peter F,5,0,8,3
1653536405198,MATH 243,A00,087427,Staff,9,0,10,1
1653536405725,MATH 248,A00,087429,Staff,10,0,10,0
1653536406247,MATH 250A,A00,087430,Spolaor; Luca,4,0,8,4
1653536406775,MATH 257A,A00,087431,Spolaor; Luca,7,0,8,1
1653536407297,MATH 258,A00,087432,Staff,9,0,10,1
1653536407819,MATH 264A,A00,087433,Warnke; Lutz Peter,5,0,8,3
1653536408340,MATH 268,A00,087434,Staff,15,0,15,0
1653536408865,MATH 269,A00,087435,Staff,14,0,15,1
1653536409387,MATH 270A,A00,087436,Nie; Jiawang,0,0,8,8
1653536409910,MATH 272A,A00,087437,Tian; Xiaochuan,1,0,8,7
1653536410431,MATH 274,A01,087439,Cheng; Li-Tien,9,0,10,1
1653536410431,MATH 274,A02,087440,Cheng; Li-Tien,10,0,10,0
1653536410954,MATH 278A,A00,087441,Staff,8,0,10,2
1653536411501,MATH 278B,A00,087442,Staff,8,0,10,2
1653536412030,MATH 278C,A00,087443,Staff,8,0,10,2
1653536412561,MATH 280A,A00,087444,Zheng; Tianyi,0,0,8,8
1653536413087,MATH 281A,A00,087445,Bradic; Jelena,0,0,8,8
1653536413610,MATH 282A,A00,087446,Zhang; Danna,0,0,8,8
1653536414134,MATH 283,A00,087447,Tesler; Glenn,0,0,0,15
1653536414657,MATH 286,A00,087448,Kemp; Todd Aahron,5,0,8,3
1653536415185,MATH 287D,A00,087449,Bradic; Jelena,0,0,0,0
1653536415711,MATH 288,A00,087450,Staff,14,0,15,1
1653536415711,MATH 288,B00,087451,Staff,15,0,15,0
1653536415711,MATH 288,C00,087452,Staff,15,0,15,0
1653536416234,MATH 290A,A00,087453,Xu; Zhouli,6,0,8,2
1653536416759,MATH 291A,A00,087454,Xu; Zhouli,7,0,8,1
1653536417286,MATH 292,A00,087455,Staff,10,0,10,0
1653536417809,MATH 295,A00,087456,Staff,50,0,50,0
1653536418331,MATH 297,001,087457,Staff,998,0,999,1
1653536977663,COGS 200,A01,087991,Staff,47,0,50,3
1653536978188,COGS 201,A01,094504,Rangel; Lara M,17,0,25,8
1653536978712,COGS 203,A00,087992,Coulson; Seana M,18,0,20,2
1653536979237,COGS 210A,001,087993,Greene; Deanna Jacquelyn,9998,0,9999,1
1653536979237,COGS 210A,002,087994,Saygin; Ayse P,9999,0,9999,0
1653536979237,COGS 210A,003,087995,Xia; Haijun,9999,0,9999,0
1653536979237,COGS 210A,004,087996,Nitz; Douglas A.,9999,0,9999,0
1653536979237,COGS 210A,005,087997,Hollan; James D.,9999,0,9999,0
1653536979237,COGS 210A,006,087998,Deak; Gedeon O.,9998,0,9999,1
1653536979237,COGS 210A,007,087999,Rossano; Federico,9999,0,9999,0
1653536979764,COGS 211A,A00,088000,Coulson; Seana M,9997,0,9999,2
1653536980287,COGS 229,A00,088002,Staff,23,0,25,2
1653536980827,COGS 260,B00,094231,Staff,17,0,20,3
1653536980827,COGS 260,A00,088004,Nitz; Douglas A.,9998,0,9999,1
1653536981355,CSE 202,A00,090110,Paturi; Ramamohan,0,0,0,0
1653536981355,CSE 202,B00,090111,Paturi; Ramamohan,0,0,0,0
1653536981879,CSE 207B,A00,090112,Heninger; Nadia A,0,0,0,0
1653536982402,CSE 208,A00,094858,Micciancio; Daniele,0,0,0,0
1653536982929,CSE 210,A00,090113,Powell; Thomas Allan,0,0,0,0
1653536983539,CSE 219,A00,090898,Staff,0,0,0,0
1653536984062,CSE 221,A00,090114,Zhou; Yuan-Yuan,0,0,0,0
1653536984585,CSE 229A,A00,090115,Porter; George M,0,0,0,0
1653536985109,CSE 229C,A00,090116,Savage; Stefan,0,0,0,0
1653536985635,CSE 230,A00,090117,Jhala; Ranjit,0,0,0,0
1653536986158,CSE 232,A00,090118,Papakonstantinou; Yannis,0,0,0,0
1653536986686,CSE 239A,A00,090121,Kumar; Arun Kumar,0,0,0,0
1653536987209,CSE 239B,A00,090122,Jhala; Ranjit,0,0,0,0
1653536987733,CSE 240A,A00,090123,Zhao; Jishen,0,0,189,189
1653536988255,CSE 243A,A00,090124,Orailoglu; Alex,0,0,15,15
1653536988777,CSE 249B,A00,090125,Kahng; Andrew Byun,13,0,20,7
1653536989303,CSE 250A,A00,090126,Berg-Kirkpatrick; Taylor D,0,0,0,0
1653536989825,CSE 252A,A00,090127,Ochoa; Benjamin Lawrence,0,0,0,0
1653536990348,CSE 258,A01,090129,McAuley; Julian John,0,0,0,0
1653536990871,CSE 258R,A01,090131,McAuley; Julian John,0,0,0,0
1653536991396,CSE 274,A00,090132,Ramamoorthi; Ravi,0,0,0,0
1653536991921,CSE 276A,A00,090133,Christensen; Henrik I,0,0,0,0
1653536992443,CSE 276C,A00,090134,Christensen; Henrik I,0,0,0,0
1653536992965,CSE 290,A00,090135,Bafna; Vineet,0,0,0,0
1653536992965,CSE 290,B00,090136,Ramamoorthi; Ravi,0,0,0,0
1653536992965,CSE 290,C00,090137,Li; Tzumao,8,0,10,2
1653536992965,CSE 290,D00,090138,Zhou; Yuan-Yuan,9,0,10,1
1653536992965,CSE 290,E00,090139,Christensen; Henrik I,8,0,10,2
1653536992965,CSE 290,F00,094053,Shalev; Aaron D,0,0,0,0
1653536993489,CSE 291,A00,090140,Munyaka; Imani N. S.,0,0,0,0
1653536993489,CSE 291,B00,094880,Yu; Qi,0,0,0,0
1653536993489,CSE 291,C00,090142,Pannuto; Patrick William,0,0,0,0
1653536993489,CSE 291,D00,094881,Zhang; Yiying,0,0,0,0
1653536993489,CSE 291,E00,095118,Su; Hao,0,0,0,0
1653536994023,CSE 293,001,094905,Bafna; Vineet,9999,0,9999,0
1653536994023,CSE 293,002,094906,Bellare; Mihir,9999,0,9999,0
1653536994023,CSE 293,003,094907,Berg-Kirkpatrick; Taylor D,9999,0,9999,0
1653536994023,CSE 293,004,094908,Christensen; Henrik I,9999,0,9999,0
1653536994023,CSE 293,005,094909,Cottrell; Garrison W,9999,0,9999,0
1653536994023,CSE 293,006,094910,Deutsch; Alin Bernard,9999,0,9999,0
1653536994023,CSE 293,007,094911,Esmaeilzadeh; Hadi,9999,0,9999,0
1653536994023,CSE 293,008,094912,Freund; Yoav,9999,0,9999,0
1653536994023,CSE 293,009,094913,Griswold; William G.,9999,0,9999,0
1653536994023,CSE 293,010,094914,Gymrek; Melissa Ann,9999,0,9999,0
1653536994023,CSE 293,011,094915,Heninger; Nadia A,9999,0,9999,0
1653536994023,CSE 293,012,094916,Impagliazzo; Russell,9999,0,9999,0
1653536994023,CSE 293,013,094917,Jhala; Ranjit,9999,0,9999,0
1653536994023,CSE 293,014,094918,Kahng; Andrew Byun,9999,0,9999,0
1653536994023,CSE 293,015,094919,Kane; Daniel Mertz,9999,0,9999,0
1653536994023,CSE 293,016,094920,Kriegman; David J,9999,0,9999,0
1653536994023,CSE 293,017,094921,Kumar; Arun Kumar,9999,0,9999,0
1653536994023,CSE 293,018,094922,Lerner; Sorin,9999,0,9999,0
1653536994023,CSE 293,019,094923,Lovett; Shachar,9999,0,9999,0
1653536994023,CSE 293,020,094924,McAuley; Julian John,9999,0,9999,0
1653536994023,CSE 293,021,094925,Micciancio; Daniele,9999,0,9999,0
1653536994023,CSE 293,022,094926,Orailoglu; Alex,9999,0,9999,0
1653536994023,CSE 293,023,094927,Paturi; Ramamohan,9999,0,9999,0
1653536994023,CSE 293,024,094928,Polikarpova; Nadezhda,9999,0,9999,0
1653536994023,CSE 293,025,094929,Politz; Joseph Gibbs,9999,0,9999,0
1653536994023,CSE 293,026,094930,Porter; George M,9999,0,9999,0
1653536994023,CSE 293,027,094931,Porter; Leonard Emerson,9999,0,9999,0
1653536994023,CSE 293,028,094932,Ramamoorthi; Ravi,9999,0,9999,0
1653536994023,CSE 293,029,094933,Sahoo; Debashis,9999,0,9999,0
1653536994023,CSE 293,030,094934,Saul; Lawrence,9999,0,9999,0
1653536994023,CSE 293,031,094935,Savage; Stefan,9999,0,9999,0
1653536994023,CSE 293,032,094936,Schulze; Jurgen P.,9999,0,9999,0
1653536994023,CSE 293,033,094937,Snoeren; Alex C.,9999,0,9999,0
1653536994023,CSE 293,034,094938,Shang; Jingbo,9999,0,9999,0
1653536994023,CSE 293,035,094939,Stefan; Deian,9999,0,9999,0
1653536994023,CSE 293,036,094940,Su; Hao,9999,0,9999,0
1653536994023,CSE 293,037,094941,Swanson; Steven James,9999,0,9999,0
1653536994023,CSE 293,038,094942,Tullsen; Dean Michael,9999,0,9999,0
1653536994023,CSE 293,039,094943,Voelker; Geoffrey M.,9999,0,9999,0
1653536994023,CSE 293,040,094944,Zhao; Jishen,9999,0,9999,0
1653536994023,CSE 293,041,094945,Zhou; Yuan-Yuan,9999,0,9999,0
1653536994023,CSE 293,042,094946,Gao; Sicun,9998,0,9999,1
1653536994023,CSE 293,043,094947,Weibel; Nadir,9999,0,9999,0
1653536994023,CSE 293,044,094948,Gupta; Rajesh K.,9999,0,9999,0
1653536994547,CSE 294,A00,090143,Porter; George M,8,0,10,2
1653536995077,DSE 200,A00,091799,Staff,50,0,50,0
1653537006947,DSE 203,A00,091800,Gupta; Amarnath,30,0,30,0
1653537007483,DSE 250,A00,091801,Deutsch; Alin Bernard,30,0,30,0
1653537008005,DSE 290,A00,091802,Altintas De Callaf; Ilkay,50,0,50,0
1653537008542,ECE 200,001,091003,Antipa; Nicholas A,9999,0,9999,0
1653537008542,ECE 200,002,091004,Atanasov; Nikolay A.,9999,0,9999,0
1653537008542,ECE 200,003,091005,Bharadia; Dinesh,9999,0,9999,0
1653537008542,ECE 200,004,091006,Cheng; Chung Kuan,9999,0,9999,0
1653537008542,ECE 200,005,091007,Cosman; Pamela C.,9999,0,9999,0
1653537008542,ECE 200,006,091008,Staff,9999,0,9999,0
1653537008542,ECE 200,007,091009,Dayeh; Shadi Ahmad,9999,0,9999,0
1653537008542,ECE 200,008,091010,Fainman; Yeshaiahu,9999,0,9999,0
1653537008542,ECE 200,009,091011,Ford; Joseph Earl,9999,0,9999,0
1653537008542,ECE 200,010,091012,Franceschetti; Massimo,9999,0,9999,0
1653537008542,ECE 200,011,091013,Fullerton; Eric E,9999,0,9999,0
1653537008542,ECE 200,012,091014,Galton; Ian A,9999,0,9999,0
1653537008542,ECE 200,013,091015,Gilja; Vikash,9999,0,9999,0
1653537008542,ECE 200,014,091016,Hall; Drew A.,9999,0,9999,0
1653537008542,ECE 200,015,091017,Hsueh; Tzu-Chien,9999,0,9999,0
1653537008542,ECE 200,016,091018,Javidi; Tara,9999,0,9999,0
1653537008542,ECE 200,017,091019,Kahng; Andrew Byun,9999,0,9999,0
1653537008542,ECE 200,018,091020,Kim; Young-Han,9999,0,9999,0
1653537008542,ECE 200,019,091021,Koushanfar; Farinaz,9999,0,9999,0
1653537008542,ECE 200,020,091022,Kuzum; Duygu,9999,0,9999,0
1653537008542,ECE 200,021,091023,Le; Hanh-Phuc,9999,0,9999,0
1653537008542,ECE 200,022,091024,Lin; Bill,9999,0,9999,0
1653537008542,ECE 200,023,091025,Liu; Zhaowei,9999,0,9999,0
1653537008542,ECE 200,024,091026,Lo; Yu-Hwa,9999,0,9999,0
1653537008542,ECE 200,025,091027,Lomakin; Vitaliy,9999,0,9999,0
1653537008542,ECE 200,026,091028,Mercier; Patrick Philip,9999,0,9999,0
1653537008542,ECE 200,027,091029,Meyer; Florian,9999,0,9999,0
1653537008542,ECE 200,028,091030,Milstein; Laurence B.,9999,0,9999,0
1653537008542,ECE 200,029,091031,Mir Arabbaygi; Siavash,9999,0,9999,0
1653537008542,ECE 200,030,091032,Mookherjea; Shayan,9999,0,9999,0
1653537008542,ECE 200,031,091033,Morris; Karcher William,9999,0,9999,0
1653537008542,ECE 200,032,091034,Ng; Tse Nga,9999,0,9999,0
1653537008542,ECE 200,033,091035,Nguyen; Truong Quang,9999,0,9999,0
1653537008542,ECE 200,034,091036,Nomura; Kenji,9999,0,9999,0
1653537008542,ECE 200,035,091037,Orlitsky; Alon,9999,0,9999,0
1653537008542,ECE 200,036,091038,Pal; Piya,9999,0,9999,0
1653537008542,ECE 200,037,091039,Papen; George C.,9999,0,9999,0
1653537008542,ECE 200,038,091040,Radic; Stojan,9999,0,9999,0
1653537008542,ECE 200,039,091041,Rao; Bhaskar D.,9999,0,9999,0
1653537008542,ECE 200,040,091042,Rao; Ramesh R,9999,0,9999,0
1653537008542,ECE 200,041,091043,Rebeiz; Gabriel,9999,0,9999,0
1653537008542,ECE 200,042,091044,Sanford; John R,9999,0,9999,0
1653537008542,ECE 200,043,091045,Siegel; Paul H.,9999,0,9999,0
1653537008542,ECE 200,044,091046,Sievenpiper; Daniel F.,9999,0,9999,0
1653537008542,ECE 200,045,091047,Sworder; David D.,9999,0,9999,0
1653537008542,ECE 200,046,091048,Taur; Yuan,9999,0,9999,0
1653537008542,ECE 200,047,091049,Touri; Behrouz,9999,0,9999,0
1653537008542,ECE 200,048,091050,Trivedi; Mohan M.,9999,0,9999,0
1653537008542,ECE 200,049,091051,Vardy; Alexander,9999,0,9999,0
1653537008542,ECE 200,050,091052,Vasconcelos; Nuno,9999,0,9999,0
1653537008542,ECE 200,051,091053,Wang; Xiaolong,9999,0,9999,0
1653537008542,ECE 200,052,091054,Xie; Pengtao,9999,0,9999,0
1653537008542,ECE 200,053,091055,Yip; Michael,9999,0,9999,0
1653537008542,ECE 200,054,091056,Zeger; Kenneth A.,9999,0,9999,0
1653537008542,ECE 200,055,091057,Zhang; Xinyu,9999,0,9999,0
1653537008542,ECE 200,056,091058,Turakhia; Yatish Girish,9999,0,9999,0
1653537008542,ECE 200,057,091059,Kang; Mingu,9999,0,9999,0
1653537008542,ECE 200,058,091060,Shi; Yuanyuan,9999,0,9999,0
1653537008542,ECE 200,059,091061,Wang; Edward Jay,9999,0,9999,0
1653537008542,ECE 200,060,091062,Zheng; Yang,9999,0,9999,0
1653537009066,ECE 201,A00,095526,Lo; Yu-Hwa,0,0,0,0
1653537009591,ECE 203,A00,091065,Mercier; Patrick Philip,0,0,0,0
1653537010121,ECE 207A,A00,091605,Liu; Thomas Tao-Ming,0,0,0,0
1653537010657,ECE 212AN,A00,091068,Nomura; Kenji,0,0,0,0
1653537011180,ECE 222A,A00,091069,Rebeiz; Gabriel,0,0,0,0
1653537011705,ECE 225A,A00,091070,Orlitsky; Alon,0,0,0,0
1653537012228,ECE 230A,A00,091071,Nomura; Kenji,0,0,0,0
1653537012751,ECE 236A,A00,091072,Dayeh; Shadi Ahmad,0,0,0,0
1653537013273,ECE 238A,A00,091073,Luo; Jian,0,0,0,0
1653537013273,ECE 238A,B00,091074,Luo; Jian,0,0,0,0
1653537013798,ECE 240A,A00,091075,Radic; Stojan,0,0,0,0
1653537014324,ECE 247A,A00,091592,Shi; Lingyan,0,0,0,0
1653537014849,ECE 250,A00,091076,Touri; Behrouz,0,0,0,0
1653537015382,ECE 251C,A00,091078,Nguyen; Truong Quang,0,0,0,0
1653537015907,ECE 253,A00,091079,Cosman; Pamela C.,0,0,0,0
1653537016431,ECE 255A,A00,091080,Orlitsky; Alon,0,0,0,0
1653537016953,ECE 257A,A00,091081,Zhang; Xinyu,0,0,0,0
1653537017476,ECE 260A,A01,091084,Eldon; John,0,0,0,0
1653537017998,ECE 264C,A00,091085,Galton; Ian A,0,0,0,0
1653537018525,ECE 265C,A00,094889,Presti; Calogero Davide,0,0,0,9
1653537019051,ECE 266,A01,091087,Hall; Drew A.,0,0,0,0
1653537020101,ECE 271A,A00,091090,Vasconcelos; Nuno,0,0,0,0
1653537020627,ECE 272B,A00,091091,Sworder; David D.,0,0,0,0
1653537021151,ECE 275A,A00,091092,Meyer; Florian,0,0,0,0
1653537021675,ECE 277,A00,091093,An; Cheolhong,0,0,0,0
1653537022198,ECE 283,A00,091094,Le; Hanh-Phuc,0,0,0,0
1653537022720,ECE 284,A00,091095,Kang; Mingu,0,0,0,0
1653537022720,ECE 284,B00,091096,Wang; Edward Jay,0,0,0,0
1653537023244,ECE 285,A00,094334,Touri; Behrouz,0,0,0,0
1653537023769,ECE 289,A00,091097,Whelan; David Arthur,0,0,0,0
1653537024292,MATH 200A,A00,087414,Salehi Golsefidy; Alireza,7,0,8,1
1653537024818,MATH 202A,A00,087415,Gill; Philip E.,2,0,8,6
1653537025340,MATH 203A,A00,087416,Oprea; Dragos N.,6,0,8,2
1653537025864,MATH 204A,A00,087417,Kedlaya; Kiran S.,6,0,8,2
1653537026392,MATH 205,A00,087418,Sorensen; Claus M,6,0,8,2
1653537026915,MATH 206A,A00,087419,Izadi; Elham,7,0,8,1
1653537027440,MATH 207A,A00,087420,Mohammadi; Amir,5,0,8,3
1653537027972,MATH 208,A00,087421,Staff,9,0,10,1
1653537028494,MATH 209,A00,087422,Staff,10,0,10,0
1653537029017,MATH 218,A00,087423,Staff,10,0,10,0
1653537029539,MATH 220A,A00,087424,Novak; Jonathan I,6,0,8,2
1653537030075,MATH 231A,A00,087425,Bejenaru; Ioan,3,0,8,5
1653537030601,MATH 240A,A00,087426,Ebenfelt; Peter F,5,0,8,3
1653537031122,MATH 243,A00,087427,Staff,9,0,10,1
1653537031648,MATH 248,A00,087429,Staff,10,0,10,0
1653537032174,MATH 250A,A00,087430,Spolaor; Luca,4,0,8,4
1653537032697,MATH 257A,A00,087431,Spolaor; Luca,7,0,8,1
1653537033227,MATH 258,A00,087432,Staff,9,0,10,1
1653537033748,MATH 264A,A00,087433,Warnke; Lutz Peter,5,0,8,3
1653537034273,MATH 268,A00,087434,Staff,15,0,15,0
1653537034797,MATH 269,A00,087435,Staff,14,0,15,1
1653537035322,MATH 270A,A00,087436,Nie; Jiawang,0,0,8,8
1653537035847,MATH 272A,A00,087437,Tian; Xiaochuan,1,0,8,7
1653537036375,MATH 274,A01,087439,Cheng; Li-Tien,9,0,10,1
1653537036375,MATH 274,A02,087440,Cheng; Li-Tien,10,0,10,0
1653537036900,MATH 278A,A00,087441,Staff,8,0,10,2
1653537037428,MATH 278B,A00,087442,Staff,8,0,10,2
1653537037954,MATH 278C,A00,087443,Staff,8,0,10,2
1653537038478,MATH 280A,A00,087444,Zheng; Tianyi,0,0,8,8
1653537039009,MATH 281A,A00,087445,Bradic; Jelena,0,0,8,8
1653537039531,MATH 282A,A00,087446,Zhang; Danna,0,0,8,8
1653537040065,MATH 283,A00,087447,Tesler; Glenn,0,0,0,15
1653537040598,MATH 286,A00,087448,Kemp; Todd Aahron,5,0,8,3
1653537041130,MATH 287D,A00,087449,Bradic; Jelena,0,0,0,0
1653537041653,MATH 288,A00,087450,Staff,14,0,15,1
1653537041653,MATH 288,B00,087451,Staff,15,0,15,0
1653537041653,MATH 288,C00,087452,Staff,15,0,15,0
1653537042178,MATH 290A,A00,087453,Xu; Zhouli,6,0,8,2
1653537042699,MATH 291A,A00,087454,Xu; Zhouli,7,0,8,1
1653537043237,MATH 292,A00,087455,Staff,10,0,10,0
1653537043763,MATH 295,A00,087456,Staff,50,0,50,0
1653537044285,MATH 297,001,087457,Staff,998,0,999,1
1653537603313,COGS 200,A01,087991,Staff,47,0,50,3
1653537603835,COGS 201,A01,094504,Rangel; Lara M,17,0,25,8
1653537604364,COGS 203,A00,087992,Coulson; Seana M,18,0,20,2
1653537604886,COGS 210A,001,087993,Greene; Deanna Jacquelyn,9998,0,9999,1
1653537604886,COGS 210A,002,087994,Saygin; Ayse P,9999,0,9999,0
1653537604886,COGS 210A,003,087995,Xia; Haijun,9999,0,9999,0
1653537604886,COGS 210A,004,087996,Nitz; Douglas A.,9999,0,9999,0
1653537604886,COGS 210A,005,087997,Hollan; James D.,9999,0,9999,0
1653537604886,COGS 210A,006,087998,Deak; Gedeon O.,9998,0,9999,1
1653537604886,COGS 210A,007,087999,Rossano; Federico,9999,0,9999,0
1653537605410,COGS 211A,A00,088000,Coulson; Seana M,9997,0,9999,2
1653537605940,COGS 229,A00,088002,Staff,23,0,25,2
1653537606462,COGS 260,B00,094231,Staff,17,0,20,3
1653537606462,COGS 260,A00,088004,Nitz; Douglas A.,9998,0,9999,1
1653537606987,CSE 202,A00,090110,Paturi; Ramamohan,0,0,0,0
1653537606987,CSE 202,B00,090111,Paturi; Ramamohan,0,0,0,0
1653537607512,CSE 207B,A00,090112,Heninger; Nadia A,0,0,0,0
1653537608041,CSE 208,A00,094858,Micciancio; Daniele,0,0,0,0
1653537608580,CSE 210,A00,090113,Powell; Thomas Allan,0,0,0,0
1653537609106,CSE 219,A00,090898,Staff,0,0,0,0
1653537609628,CSE 221,A00,090114,Zhou; Yuan-Yuan,0,0,0,0
1653537610150,CSE 229A,A00,090115,Porter; George M,0,0,0,0
1653537610674,CSE 229C,A00,090116,Savage; Stefan,0,0,0,0
1653537611197,CSE 230,A00,090117,Jhala; Ranjit,0,0,0,0
1653537611725,CSE 232,A00,090118,Papakonstantinou; Yannis,0,0,0,0
1653537612247,CSE 239A,A00,090121,Kumar; Arun Kumar,0,0,0,0
1653537612772,CSE 239B,A00,090122,Jhala; Ranjit,0,0,0,0
1653537613297,CSE 240A,A00,090123,Zhao; Jishen,0,0,189,189
1653537613820,CSE 243A,A00,090124,Orailoglu; Alex,0,0,15,15
1653537614354,CSE 249B,A00,090125,Kahng; Andrew Byun,13,0,20,7
1653537614877,CSE 250A,A00,090126,Berg-Kirkpatrick; Taylor D,0,0,0,0
1653537615400,CSE 252A,A00,090127,Ochoa; Benjamin Lawrence,0,0,0,0
1653537615928,CSE 258,A01,090129,McAuley; Julian John,0,0,0,0
1653537616454,CSE 258R,A01,090131,McAuley; Julian John,0,0,0,0
1653537616976,CSE 274,A00,090132,Ramamoorthi; Ravi,0,0,0,0
1653537617509,CSE 276A,A00,090133,Christensen; Henrik I,0,0,0,0
1653537618035,CSE 276C,A00,090134,Christensen; Henrik I,0,0,0,0
1653537618561,CSE 290,A00,090135,Bafna; Vineet,0,0,0,0
1653537618561,CSE 290,B00,090136,Ramamoorthi; Ravi,0,0,0,0
1653537618561,CSE 290,C00,090137,Li; Tzumao,8,0,10,2
1653537618561,CSE 290,D00,090138,Zhou; Yuan-Yuan,9,0,10,1
1653537618561,CSE 290,E00,090139,Christensen; Henrik I,8,0,10,2
1653537618561,CSE 290,F00,094053,Shalev; Aaron D,0,0,0,0
1653537619093,CSE 291,A00,090140,Munyaka; Imani N. S.,0,0,0,0
1653537619093,CSE 291,B00,094880,Yu; Qi,0,0,0,0
1653537619093,CSE 291,C00,090142,Pannuto; Patrick William,0,0,0,0
1653537619093,CSE 291,D00,094881,Zhang; Yiying,0,0,0,0
1653537619093,CSE 291,E00,095118,Su; Hao,0,0,0,0
1653537619620,CSE 293,001,094905,Bafna; Vineet,9999,0,9999,0
1653537619620,CSE 293,002,094906,Bellare; Mihir,9999,0,9999,0
1653537619620,CSE 293,003,094907,Berg-Kirkpatrick; Taylor D,9999,0,9999,0
1653537619620,CSE 293,004,094908,Christensen; Henrik I,9999,0,9999,0
1653537619620,CSE 293,005,094909,Cottrell; Garrison W,9999,0,9999,0
1653537619620,CSE 293,006,094910,Deutsch; Alin Bernard,9999,0,9999,0
1653537619620,CSE 293,007,094911,Esmaeilzadeh; Hadi,9999,0,9999,0
1653537619620,CSE 293,008,094912,Freund; Yoav,9999,0,9999,0
1653537619620,CSE 293,009,094913,Griswold; William G.,9999,0,9999,0
1653537619620,CSE 293,010,094914,Gymrek; Melissa Ann,9999,0,9999,0
1653537619620,CSE 293,011,094915,Heninger; Nadia A,9999,0,9999,0
1653537619620,CSE 293,012,094916,Impagliazzo; Russell,9999,0,9999,0
1653537619620,CSE 293,013,094917,Jhala; Ranjit,9999,0,9999,0
1653537619620,CSE 293,014,094918,Kahng; Andrew Byun,9999,0,9999,0
1653537619620,CSE 293,015,094919,Kane; Daniel Mertz,9999,0,9999,0
1653537619620,CSE 293,016,094920,Kriegman; David J,9999,0,9999,0
1653537619620,CSE 293,017,094921,Kumar; Arun Kumar,9999,0,9999,0
1653537619620,CSE 293,018,094922,Lerner; Sorin,9999,0,9999,0
1653537619620,CSE 293,019,094923,Lovett; Shachar,9999,0,9999,0
1653537619620,CSE 293,020,094924,McAuley; Julian John,9999,0,9999,0
1653537619620,CSE 293,021,094925,Micciancio; Daniele,9999,0,9999,0
1653537619620,CSE 293,022,094926,Orailoglu; Alex,9999,0,9999,0
1653537619620,CSE 293,023,094927,Paturi; Ramamohan,9999,0,9999,0
1653537619620,CSE 293,024,094928,Polikarpova; Nadezhda,9999,0,9999,0
1653537619620,CSE 293,025,094929,Politz; Joseph Gibbs,9999,0,9999,0
1653537619620,CSE 293,026,094930,Porter; George M,9999,0,9999,0
1653537619620,CSE 293,027,094931,Porter; Leonard Emerson,9999,0,9999,0
1653537619620,CSE 293,028,094932,Ramamoorthi; Ravi,9999,0,9999,0
1653537619620,CSE 293,029,094933,Sahoo; Debashis,9999,0,9999,0
1653537619620,CSE 293,030,094934,Saul; Lawrence,9999,0,9999,0
1653537619620,CSE 293,031,094935,Savage; Stefan,9999,0,9999,0
1653537619620,CSE 293,032,094936,Schulze; Jurgen P.,9999,0,9999,0
1653537619620,CSE 293,033,094937,Snoeren; Alex C.,9999,0,9999,0
1653537619620,CSE 293,034,094938,Shang; Jingbo,9999,0,9999,0
1653537619620,CSE 293,035,094939,Stefan; Deian,9999,0,9999,0
1653537619620,CSE 293,036,094940,Su; Hao,9999,0,9999,0
1653537619620,CSE 293,037,094941,Swanson; Steven James,9999,0,9999,0
1653537619620,CSE 293,038,094942,Tullsen; Dean Michael,9999,0,9999,0
1653537619620,CSE 293,039,094943,Voelker; Geoffrey M.,9999,0,9999,0
1653537619620,CSE 293,040,094944,Zhao; Jishen,9999,0,9999,0
1653537619620,CSE 293,041,094945,Zhou; Yuan-Yuan,9999,0,9999,0
1653537619620,CSE 293,042,094946,Gao; Sicun,9998,0,9999,1
1653537619620,CSE 293,043,094947,Weibel; Nadir,9999,0,9999,0
1653537619620,CSE 293,044,094948,Gupta; Rajesh K.,9999,0,9999,0
1653537620145,CSE 294,A00,090143,Porter; George M,8,0,10,2
1653537620668,DSE 200,A00,091799,Staff,50,0,50,0
1653537621191,DSE 203,A00,091800,Gupta; Amarnath,30,0,30,0
1653537621728,DSE 250,A00,091801,Deutsch; Alin Bernard,30,0,30,0
1653537622274,DSE 290,A00,091802,Altintas De Callaf; Ilkay,50,0,50,0
1653537622825,ECE 200,001,091003,Antipa; Nicholas A,9999,0,9999,0
1653537622825,ECE 200,002,091004,Atanasov; Nikolay A.,9999,0,9999,0
1653537622825,ECE 200,003,091005,Bharadia; Dinesh,9999,0,9999,0
1653537622825,ECE 200,004,091006,Cheng; Chung Kuan,9999,0,9999,0
1653537622825,ECE 200,005,091007,Cosman; Pamela C.,9999,0,9999,0
1653537622825,ECE 200,006,091008,Staff,9999,0,9999,0
1653537622825,ECE 200,007,091009,Dayeh; Shadi Ahmad,9999,0,9999,0
1653537622825,ECE 200,008,091010,Fainman; Yeshaiahu,9999,0,9999,0
1653537622825,ECE 200,009,091011,Ford; Joseph Earl,9999,0,9999,0
1653537622825,ECE 200,010,091012,Franceschetti; Massimo,9999,0,9999,0
1653537622825,ECE 200,011,091013,Fullerton; Eric E,9999,0,9999,0
1653537622825,ECE 200,012,091014,Galton; Ian A,9999,0,9999,0
1653537622825,ECE 200,013,091015,Gilja; Vikash,9999,0,9999,0
1653537622825,ECE 200,014,091016,Hall; Drew A.,9999,0,9999,0
1653537622825,ECE 200,015,091017,Hsueh; Tzu-Chien,9999,0,9999,0
1653537622825,ECE 200,016,091018,Javidi; Tara,9999,0,9999,0
1653537622825,ECE 200,017,091019,Kahng; Andrew Byun,9999,0,9999,0
1653537622825,ECE 200,018,091020,Kim; Young-Han,9999,0,9999,0
1653537622825,ECE 200,019,091021,Koushanfar; Farinaz,9999,0,9999,0
1653537622825,ECE 200,020,091022,Kuzum; Duygu,9999,0,9999,0
1653537622825,ECE 200,021,091023,Le; Hanh-Phuc,9999,0,9999,0
1653537622825,ECE 200,022,091024,Lin; Bill,9999,0,9999,0
1653537622825,ECE 200,023,091025,Liu; Zhaowei,9999,0,9999,0
1653537622825,ECE 200,024,091026,Lo; Yu-Hwa,9999,0,9999,0
1653537622825,ECE 200,025,091027,Lomakin; Vitaliy,9999,0,9999,0
1653537622825,ECE 200,026,091028,Mercier; Patrick Philip,9999,0,9999,0
1653537622825,ECE 200,027,091029,Meyer; Florian,9999,0,9999,0
1653537622825,ECE 200,028,091030,Milstein; Laurence B.,9999,0,9999,0
1653537622825,ECE 200,029,091031,Mir Arabbaygi; Siavash,9999,0,9999,0
1653537622825,ECE 200,030,091032,Mookherjea; Shayan,9999,0,9999,0
1653537622825,ECE 200,031,091033,Morris; Karcher William,9999,0,9999,0
1653537622825,ECE 200,032,091034,Ng; Tse Nga,9999,0,9999,0
1653537622825,ECE 200,033,091035,Nguyen; Truong Quang,9999,0,9999,0
1653537622825,ECE 200,034,091036,Nomura; Kenji,9999,0,9999,0
1653537622825,ECE 200,035,091037,Orlitsky; Alon,9999,0,9999,0
1653537622825,ECE 200,036,091038,Pal; Piya,9999,0,9999,0
1653537622825,ECE 200,037,091039,Papen; George C.,9999,0,9999,0
1653537622825,ECE 200,038,091040,Radic; Stojan,9999,0,9999,0
1653537622825,ECE 200,039,091041,Rao; Bhaskar D.,9999,0,9999,0
1653537622825,ECE 200,040,091042,Rao; Ramesh R,9999,0,9999,0
1653537622825,ECE 200,041,091043,Rebeiz; Gabriel,9999,0,9999,0
1653537622825,ECE 200,042,091044,Sanford; John R,9999,0,9999,0
1653537622825,ECE 200,043,091045,Siegel; Paul H.,9999,0,9999,0
1653537622825,ECE 200,044,091046,Sievenpiper; Daniel F.,9999,0,9999,0
1653537622825,ECE 200,045,091047,Sworder; David D.,9999,0,9999,0
1653537622825,ECE 200,046,091048,Taur; Yuan,9999,0,9999,0
1653537622825,ECE 200,047,091049,Touri; Behrouz,9999,0,9999,0
1653537622825,ECE 200,048,091050,Trivedi; Mohan M.,9999,0,9999,0
1653537622825,ECE 200,049,091051,Vardy; Alexander,9999,0,9999,0
1653537622825,ECE 200,050,091052,Vasconcelos; Nuno,9999,0,9999,0
1653537622825,ECE 200,051,091053,Wang; Xiaolong,9999,0,9999,0
1653537622825,ECE 200,052,091054,Xie; Pengtao,9999,0,9999,0
1653537622825,ECE 200,053,091055,Yip; Michael,9999,0,9999,0
1653537622825,ECE 200,054,091056,Zeger; Kenneth A.,9999,0,9999,0
1653537622825,ECE 200,055,091057,Zhang; Xinyu,9999,0,9999,0
1653537622825,ECE 200,056,091058,Turakhia; Yatish Girish,9999,0,9999,0
1653537622825,ECE 200,057,091059,Kang; Mingu,9999,0,9999,0
1653537622825,ECE 200,058,091060,Shi; Yuanyuan,9999,0,9999,0
1653537622825,ECE 200,059,091061,Wang; Edward Jay,9999,0,9999,0
1653537622825,ECE 200,060,091062,Zheng; Yang,9999,0,9999,0
1653537623353,ECE 201,A00,095526,Lo; Yu-Hwa,0,0,0,0
1653537623875,ECE 203,A00,091065,Mercier; Patrick Philip,0,0,0,0
1653537624401,ECE 207A,A00,091605,Liu; Thomas Tao-Ming,0,0,0,0
1653537624923,ECE 212AN,A00,091068,Nomura; Kenji,0,0,0,0
1653537625447,ECE 222A,A00,091069,Rebeiz; Gabriel,0,0,0,0
1653537625978,ECE 225A,A00,091070,Orlitsky; Alon,0,0,0,0
1653537626504,ECE 230A,A00,091071,Nomura; Kenji,0,0,0,0
1653537627030,ECE 236A,A00,091072,Dayeh; Shadi Ahmad,0,0,0,0
1653537627562,ECE 238A,A00,091073,Luo; Jian,0,0,0,0
1653537627562,ECE 238A,B00,091074,Luo; Jian,0,0,0,0
1653537628086,ECE 240A,A00,091075,Radic; Stojan,0,0,0,0
1653537628608,ECE 247A,A00,091592,Shi; Lingyan,0,0,0,0
1653537629133,ECE 250,A00,091076,Touri; Behrouz,0,0,0,0
1653537629656,ECE 251C,A00,091078,Nguyen; Truong Quang,0,0,0,0
1653537630179,ECE 253,A00,091079,Cosman; Pamela C.,0,0,0,0
1653537630702,ECE 255A,A00,091080,Orlitsky; Alon,0,0,0,0
1653537631233,ECE 257A,A00,091081,Zhang; Xinyu,0,0,0,0
1653537631763,ECE 260A,A01,091084,Eldon; John,0,0,0,0
1653537632286,ECE 264C,A00,091085,Galton; Ian A,0,0,0,0
1653537632809,ECE 265C,A00,094889,Presti; Calogero Davide,0,0,0,9
1653537633348,ECE 266,A01,091087,Hall; Drew A.,0,0,0,0
1653537634492,ECE 271A,A00,091090,Vasconcelos; Nuno,0,0,0,0
1653537635016,ECE 272B,A00,091091,Sworder; David D.,0,0,0,0
1653537635542,ECE 275A,A00,091092,Meyer; Florian,0,0,0,0
1653537636066,ECE 277,A00,091093,An; Cheolhong,0,0,0,0
1653537636589,ECE 283,A00,091094,Le; Hanh-Phuc,0,0,0,0
1653537637116,ECE 284,A00,091095,Kang; Mingu,0,0,0,0
1653537637116,ECE 284,B00,091096,Wang; Edward Jay,0,0,0,0
1653537637642,ECE 285,A00,094334,Touri; Behrouz,0,0,0,0
1653537638168,ECE 289,A00,091097,Whelan; David Arthur,0,0,0,0
1653537638692,MATH 200A,A00,087414,Salehi Golsefidy; Alireza,7,0,8,1
1653537639218,MATH 202A,A00,087415,Gill; Philip E.,2,0,8,6
1653537639741,MATH 203A,A00,087416,Oprea; Dragos N.,6,0,8,2
1653537640271,MATH 204A,A00,087417,Kedlaya; Kiran S.,6,0,8,2
1653537640794,MATH 205,A00,087418,Sorensen; Claus M,6,0,8,2
1653537641317,MATH 206A,A00,087419,Izadi; Elham,7,0,8,1
1653537641842,MATH 207A,A00,087420,Mohammadi; Amir,5,0,8,3
1653537642375,MATH 208,A00,087421,Staff,9,0,10,1
1653537642900,MATH 209,A00,087422,Staff,10,0,10,0
1653537643423,MATH 218,A00,087423,Staff,10,0,10,0
1653537643955,MATH 220A,A00,087424,Novak; Jonathan I,6,0,8,2
1653537644488,MATH 231A,A00,087425,Bejenaru; Ioan,3,0,8,5
1653537645010,MATH 240A,A00,087426,Ebenfelt; Peter F,5,0,8,3
1653537645533,MATH 243,A00,087427,Staff,9,0,10,1
1653537646055,MATH 248,A00,087429,Staff,10,0,10,0
1653537646582,MATH 250A,A00,087430,Spolaor; Luca,4,0,8,4
1653537647118,MATH 257A,A00,087431,Spolaor; Luca,7,0,8,1
1653537647650,MATH 258,A00,087432,Staff,9,0,10,1
1653537648177,MATH 264A,A00,087433,Warnke; Lutz Peter,5,0,8,3
1653537648700,MATH 268,A00,087434,Staff,15,0,15,0
1653537649224,MATH 269,A00,087435,Staff,14,0,15,1
1653537649751,MATH 270A,A00,087436,Nie; Jiawang,0,0,8,8
1653537650282,MATH 272A,A00,087437,Tian; Xiaochuan,1,0,8,7
1653537650807,MATH 274,A01,087439,Cheng; Li-Tien,9,0,10,1
1653537650807,MATH 274,A02,087440,Cheng; Li-Tien,10,0,10,0
1653537651336,MATH 278A,A00,087441,Staff,8,0,10,2
1653537651858,MATH 278B,A00,087442,Staff,8,0,10,2
1653537652381,MATH 278C,A00,087443,Staff,8,0,10,2
1653537652903,MATH 280A,A00,087444,Zheng; Tianyi,0,0,8,8
1653537653426,MATH 281A,A00,087445,Bradic; Jelena,0,0,8,8
1653537653952,MATH 282A,A00,087446,Zhang; Danna,0,0,8,8
1653537654477,MATH 283,A00,087447,Tesler; Glenn,0,0,0,15
1653537654999,MATH 286,A00,087448,Kemp; Todd Aahron,5,0,8,3
1653537655522,MATH 287D,A00,087449,Bradic; Jelena,0,0,0,0
1653537656044,MATH 288,A00,087450,Staff,14,0,15,1
1653537656044,MATH 288,B00,087451,Staff,15,0,15,0
1653537656044,MATH 288,C00,087452,Staff,15,0,15,0
1653537656567,MATH 290A,A00,087453,Xu; Zhouli,6,0,8,2
1653537657092,MATH 291A,A00,087454,Xu; Zhouli,7,0,8,1
1653537657618,MATH 292,A00,087455,Staff,10,0,10,0
1653537658142,MATH 295,A00,087456,Staff,50,0,50,0
1653537658667,MATH 297,001,087457,Staff,998,0,999,1
1653538218212,COGS 200,A01,087991,Staff,47,0,50,3
1653538218738,COGS 201,A01,094504,Rangel; Lara M,17,0,25,8
1653538219266,COGS 203,A00,087992,Coulson; Seana M,18,0,20,2
1653538219795,COGS 210A,001,087993,Greene; Deanna Jacquelyn,9998,0,9999,1
1653538219795,COGS 210A,002,087994,Saygin; Ayse P,9999,0,9999,0
1653538219795,COGS 210A,003,087995,Xia; Haijun,9999,0,9999,0
1653538219795,COGS 210A,004,087996,Nitz; Douglas A.,9999,0,9999,0
1653538219795,COGS 210A,005,087997,Hollan; James D.,9999,0,9999,0
1653538219795,COGS 210A,006,087998,Deak; Gedeon O.,9998,0,9999,1
1653538219795,COGS 210A,007,087999,Rossano; Federico,9999,0,9999,0
1653538220317,COGS 211A,A00,088000,Coulson; Seana M,9997,0,9999,2
1653538220840,COGS 229,A00,088002,Staff,23,0,25,2
1653538221434,COGS 260,B00,094231,Staff,17,0,20,3
1653538221434,COGS 260,A00,088004,Nitz; Douglas A.,9998,0,9999,1
1653538221957,CSE 202,A00,090110,Paturi; Ramamohan,0,0,0,0
1653538221957,CSE 202,B00,090111,Paturi; Ramamohan,0,0,0,0
1653538222494,CSE 207B,A00,090112,Heninger; Nadia A,0,0,0,0
1653538223023,CSE 208,A00,094858,Micciancio; Daniele,0,0,0,0
1653538223556,CSE 210,A00,090113,Powell; Thomas Allan,0,0,0,0
1653538224095,CSE 219,A00,090898,Staff,0,0,0,0
1653538224621,CSE 221,A00,090114,Zhou; Yuan-Yuan,0,0,0,0
1653538225145,CSE 229A,A00,090115,Porter; George M,0,0,0,0
1653538225675,CSE 229C,A00,090116,Savage; Stefan,0,0,0,0
1653538226202,CSE 230,A00,090117,Jhala; Ranjit,0,0,0,0
1653538226735,CSE 232,A00,090118,Papakonstantinou; Yannis,0,0,0,0
1653538227257,CSE 239A,A00,090121,Kumar; Arun Kumar,0,0,0,0
1653538227779,CSE 239B,A00,090122,Jhala; Ranjit,0,0,0,0
1653538228315,CSE 240A,A00,090123,Zhao; Jishen,0,0,189,189
1653538228837,CSE 243A,A00,090124,Orailoglu; Alex,0,0,15,15
1653538229361,CSE 249B,A00,090125,Kahng; Andrew Byun,13,0,20,7
1653538229887,CSE 250A,A00,090126,Berg-Kirkpatrick; Taylor D,0,0,0,0
1653538230417,CSE 252A,A00,090127,Ochoa; Benjamin Lawrence,0,0,0,0
1653538230943,CSE 258,A01,090129,McAuley; Julian John,0,0,0,0
1653538231475,CSE 258R,A01,090131,McAuley; Julian John,0,0,0,0
1653538231997,CSE 274,A00,090132,Ramamoorthi; Ravi,0,0,0,0
1653538232519,CSE 276A,A00,090133,Christensen; Henrik I,0,0,0,0
1653538233043,CSE 276C,A00,090134,Christensen; Henrik I,0,0,0,0
1653538233569,CSE 290,A00,090135,Bafna; Vineet,0,0,0,0
1653538233569,CSE 290,B00,090136,Ramamoorthi; Ravi,0,0,0,0
1653538233569,CSE 290,C00,090137,Li; Tzumao,8,0,10,2
1653538233569,CSE 290,D00,090138,Zhou; Yuan-Yuan,9,0,10,1
1653538233569,CSE 290,E00,090139,Christensen; Henrik I,8,0,10,2
1653538233569,CSE 290,F00,094053,Shalev; Aaron D,0,0,0,0
1653538234097,CSE 291,A00,090140,Munyaka; Imani N. S.,0,0,0,0
1653538234097,CSE 291,B00,094880,Yu; Qi,0,0,0,0
1653538234097,CSE 291,C00,090142,Pannuto; Patrick William,0,0,0,0
1653538234097,CSE 291,D00,094881,Zhang; Yiying,0,0,0,0
1653538234097,CSE 291,E00,095118,Su; Hao,0,0,0,0
1653538234624,CSE 293,001,094905,Bafna; Vineet,9999,0,9999,0
1653538234624,CSE 293,002,094906,Bellare; Mihir,9999,0,9999,0
1653538234624,CSE 293,003,094907,Berg-Kirkpatrick; Taylor D,9999,0,9999,0
1653538234624,CSE 293,004,094908,Christensen; Henrik I,9999,0,9999,0
1653538234624,CSE 293,005,094909,Cottrell; Garrison W,9999,0,9999,0
1653538234624,CSE 293,006,094910,Deutsch; Alin Bernard,9999,0,9999,0
1653538234624,CSE 293,007,094911,Esmaeilzadeh; Hadi,9999,0,9999,0
1653538234624,CSE 293,008,094912,Freund; Yoav,9999,0,9999,0
1653538234624,CSE 293,009,094913,Griswold; William G.,9999,0,9999,0
1653538234624,CSE 293,010,094914,Gymrek; Melissa Ann,9999,0,9999,0
1653538234624,CSE 293,011,094915,Heninger; Nadia A,9999,0,9999,0
1653538234624,CSE 293,012,094916,Impagliazzo; Russell,9999,0,9999,0
1653538234624,CSE 293,013,094917,Jhala; Ranjit,9999,0,9999,0
1653538234624,CSE 293,014,094918,Kahng; Andrew Byun,9999,0,9999,0
1653538234624,CSE 293,015,094919,Kane; Daniel Mertz,9999,0,9999,0
1653538234624,CSE 293,016,094920,Kriegman; David J,9999,0,9999,0
1653538234624,CSE 293,017,094921,Kumar; Arun Kumar,9999,0,9999,0
1653538234624,CSE 293,018,094922,Lerner; Sorin,9999,0,9999,0
1653538234624,CSE 293,019,094923,Lovett; Shachar,9999,0,9999,0
1653538234624,CSE 293,020,094924,McAuley; Julian John,9999,0,9999,0
1653538234624,CSE 293,021,094925,Micciancio; Daniele,9999,0,9999,0
1653538234624,CSE 293,022,094926,Orailoglu; Alex,9999,0,9999,0
1653538234624,CSE 293,023,094927,Paturi; Ramamohan,9999,0,9999,0
1653538234624,CSE 293,024,094928,Polikarpova; Nadezhda,9999,0,9999,0
1653538234624,CSE 293,025,094929,Politz; Joseph Gibbs,9999,0,9999,0
1653538234624,CSE 293,026,094930,Porter; George M,9999,0,9999,0
1653538234624,CSE 293,027,094931,Porter; Leonard Emerson,9999,0,9999,0
1653538234624,CSE 293,028,094932,Ramamoorthi; Ravi,9999,0,9999,0
1653538234624,CSE 293,029,094933,Sahoo; Debashis,9999,0,9999,0
1653538234624,CSE 293,030,094934,Saul; Lawrence,9999,0,9999,0
1653538234624,CSE 293,031,094935,Savage; Stefan,9999,0,9999,0
1653538234624,CSE 293,032,094936,Schulze; Jurgen P.,9999,0,9999,0
1653538234624,CSE 293,033,094937,Snoeren; Alex C.,9999,0,9999,0
1653538234624,CSE 293,034,094938,Shang; Jingbo,9999,0,9999,0
1653538234624,CSE 293,035,094939,Stefan; Deian,9999,0,9999,0
1653538234624,CSE 293,036,094940,Su; Hao,9999,0,9999,0
1653538234624,CSE 293,037,094941,Swanson; Steven James,9999,0,9999,0
1653538234624,CSE 293,038,094942,Tullsen; Dean Michael,9999,0,9999,0
1653538234624,CSE 293,039,094943,Voelker; Geoffrey M.,9999,0,9999,0
1653538234624,CSE 293,040,094944,Zhao; Jishen,9999,0,9999,0
1653538234624,CSE 293,041,094945,Zhou; Yuan-Yuan,9999,0,9999,0
1653538234624,CSE 293,042,094946,Gao; Sicun,9998,0,9999,1
1653538234624,CSE 293,043,094947,Weibel; Nadir,9999,0,9999,0
1653538234624,CSE 293,044,094948,Gupta; Rajesh K.,9999,0,9999,0
1653538235151,CSE 294,A00,090143,Porter; George M,8,0,10,2
1653538235676,DSE 200,A00,091799,Staff,50,0,50,0
1653538236202,DSE 203,A00,091800,Gupta; Amarnath,30,0,30,0
1653538236729,DSE 250,A00,091801,Deutsch; Alin Bernard,30,0,30,0
1653538237252,DSE 290,A00,091802,Altintas De Callaf; Ilkay,50,0,50,0
1653538237797,ECE 200,001,091003,Antipa; Nicholas A,9999,0,9999,0
1653538237797,ECE 200,002,091004,Atanasov; Nikolay A.,9999,0,9999,0
1653538237797,ECE 200,003,091005,Bharadia; Dinesh,9999,0,9999,0
1653538237797,ECE 200,004,091006,Cheng; Chung Kuan,9999,0,9999,0
1653538237797,ECE 200,005,091007,Cosman; Pamela C.,9999,0,9999,0
1653538237797,ECE 200,006,091008,Staff,9999,0,9999,0
1653538237797,ECE 200,007,091009,Dayeh; Shadi Ahmad,9999,0,9999,0
1653538237797,ECE 200,008,091010,Fainman; Yeshaiahu,9999,0,9999,0
1653538237797,ECE 200,009,091011,Ford; Joseph Earl,9999,0,9999,0
1653538237797,ECE 200,010,091012,Franceschetti; Massimo,9999,0,9999,0
1653538237797,ECE 200,011,091013,Fullerton; Eric E,9999,0,9999,0
1653538237797,ECE 200,012,091014,Galton; Ian A,9999,0,9999,0
1653538237797,ECE 200,013,091015,Gilja; Vikash,9999,0,9999,0
1653538237797,ECE 200,014,091016,Hall; Drew A.,9999,0,9999,0
1653538237797,ECE 200,015,091017,Hsueh; Tzu-Chien,9999,0,9999,0
1653538237797,ECE 200,016,091018,Javidi; Tara,9999,0,9999,0
1653538237797,ECE 200,017,091019,Kahng; Andrew Byun,9999,0,9999,0
1653538237797,ECE 200,018,091020,Kim; Young-Han,9999,0,9999,0
1653538237797,ECE 200,019,091021,Koushanfar; Farinaz,9999,0,9999,0
1653538237797,ECE 200,020,091022,Kuzum; Duygu,9999,0,9999,0
1653538237797,ECE 200,021,091023,Le; Hanh-Phuc,9999,0,9999,0
1653538237797,ECE 200,022,091024,Lin; Bill,9999,0,9999,0
1653538237797,ECE 200,023,091025,Liu; Zhaowei,9999,0,9999,0
1653538237797,ECE 200,024,091026,Lo; Yu-Hwa,9999,0,9999,0
1653538237797,ECE 200,025,091027,Lomakin; Vitaliy,9999,0,9999,0
1653538237797,ECE 200,026,091028,Mercier; Patrick Philip,9999,0,9999,0
1653538237797,ECE 200,027,091029,Meyer; Florian,9999,0,9999,0
1653538237797,ECE 200,028,091030,Milstein; Laurence B.,9999,0,9999,0
1653538237797,ECE 200,029,091031,Mir Arabbaygi; Siavash,9999,0,9999,0
1653538237797,ECE 200,030,091032,Mookherjea; Shayan,9999,0,9999,0
1653538237797,ECE 200,031,091033,Morris; Karcher William,9999,0,9999,0
1653538237797,ECE 200,032,091034,Ng; Tse Nga,9999,0,9999,0
1653538237797,ECE 200,033,091035,Nguyen; Truong Quang,9999,0,9999,0
1653538237797,ECE 200,034,091036,Nomura; Kenji,9999,0,9999,0
1653538237797,ECE 200,035,091037,Orlitsky; Alon,9999,0,9999,0
1653538237797,ECE 200,036,091038,Pal; Piya,9999,0,9999,0
1653538237797,ECE 200,037,091039,Papen; George C.,9999,0,9999,0
1653538237797,ECE 200,038,091040,Radic; Stojan,9999,0,9999,0
1653538237797,ECE 200,039,091041,Rao; Bhaskar D.,9999,0,9999,0
1653538237797,ECE 200,040,091042,Rao; Ramesh R,9999,0,9999,0
1653538237797,ECE 200,041,091043,Rebeiz; Gabriel,9999,0,9999,0
1653538237797,ECE 200,042,091044,Sanford; John R,9999,0,9999,0
1653538237797,ECE 200,043,091045,Siegel; Paul H.,9999,0,9999,0
1653538237797,ECE 200,044,091046,Sievenpiper; Daniel F.,9999,0,9999,0
1653538237797,ECE 200,045,091047,Sworder; David D.,9999,0,9999,0
1653538237797,ECE 200,046,091048,Taur; Yuan,9999,0,9999,0
1653538237797,ECE 200,047,091049,Touri; Behrouz,9999,0,9999,0
1653538237797,ECE 200,048,091050,Trivedi; Mohan M.,9999,0,9999,0
1653538237797,ECE 200,049,091051,Vardy; Alexander,9999,0,9999,0
1653538237797,ECE 200,050,091052,Vasconcelos; Nuno,9999,0,9999,0
1653538237797,ECE 200,051,091053,Wang; Xiaolong,9999,0,9999,0
1653538237797,ECE 200,052,091054,Xie; Pengtao,9999,0,9999,0
1653538237797,ECE 200,053,091055,Yip; Michael,9999,0,9999,0
1653538237797,ECE 200,054,091056,Zeger; Kenneth A.,9999,0,9999,0
1653538237797,ECE 200,055,091057,Zhang; Xinyu,9999,0,9999,0
1653538237797,ECE 200,056,091058,Turakhia; Yatish Girish,9999,0,9999,0
1653538237797,ECE 200,057,091059,Kang; Mingu,9999,0,9999,0
1653538237797,ECE 200,058,091060,Shi; Yuanyuan,9999,0,9999,0
1653538237797,ECE 200,059,091061,Wang; Edward Jay,9999,0,9999,0
1653538237797,ECE 200,060,091062,Zheng; Yang,9999,0,9999,0
1653538238321,ECE 201,A00,095526,Lo; Yu-Hwa,0,0,0,0
1653538238846,ECE 203,A00,091065,Mercier; Patrick Philip,0,0,0,0
1653538239377,ECE 207A,A00,091605,Liu; Thomas Tao-Ming,0,0,0,0
1653538239902,ECE 212AN,A00,091068,Nomura; Kenji,0,0,0,0
1653538240426,ECE 222A,A00,091069,Rebeiz; Gabriel,0,0,0,0
1653538240952,ECE 225A,A00,091070,Orlitsky; Alon,0,0,0,0
1653538241476,ECE 230A,A00,091071,Nomura; Kenji,0,0,0,0
1653538242000,ECE 236A,A00,091072,Dayeh; Shadi Ahmad,0,0,0,0
1653538242524,ECE 238A,A00,091073,Luo; Jian,0,0,0,0
1653538242524,ECE 238A,B00,091074,Luo; Jian,0,0,0,0
1653538243045,ECE 240A,A00,091075,Radic; Stojan,0,0,0,0
1653538243571,ECE 247A,A00,091592,Shi; Lingyan,0,0,0,0
1653538244097,ECE 250,A00,091076,Touri; Behrouz,0,0,0,0
1653538244627,ECE 251C,A00,091078,Nguyen; Truong Quang,0,0,0,0
1653538245150,ECE 253,A00,091079,Cosman; Pamela C.,0,0,0,0
1653538245672,ECE 255A,A00,091080,Orlitsky; Alon,0,0,0,0
1653538246194,ECE 257A,A00,091081,Zhang; Xinyu,0,0,0,0
1653538246723,ECE 260A,A01,091084,Eldon; John,0,0,0,0
1653538247252,ECE 264C,A00,091085,Galton; Ian A,0,0,0,0
1653538247779,ECE 265C,A00,094889,Presti; Calogero Davide,0,0,0,9
1653538248302,ECE 266,A01,091087,Hall; Drew A.,0,0,0,0
1653538249350,ECE 271A,A00,091090,Vasconcelos; Nuno,0,0,0,0
1653538249877,ECE 272B,A00,091091,Sworder; David D.,0,0,0,0
1653538250400,ECE 275A,A00,091092,Meyer; Florian,0,0,0,0
1653538250922,ECE 277,A00,091093,An; Cheolhong,0,0,0,0
1653538251460,ECE 283,A00,091094,Le; Hanh-Phuc,0,0,0,0
1653538251992,ECE 284,A00,091095,Kang; Mingu,0,0,0,0
1653538251992,ECE 284,B00,091096,Wang; Edward Jay,0,0,0,0
1653538252515,ECE 285,A00,094334,Touri; Behrouz,0,0,0,0
1653538253038,ECE 289,A00,091097,Whelan; David Arthur,0,0,0,0
1653538253561,MATH 200A,A00,087414,Salehi Golsefidy; Alireza,7,0,8,1
1653538254084,MATH 202A,A00,087415,Gill; Philip E.,2,0,8,6
1653538254613,MATH 203A,A00,087416,Oprea; Dragos N.,6,0,8,2
1653538255137,MATH 204A,A00,087417,Kedlaya; Kiran S.,6,0,8,2
1653538255664,MATH 205,A00,087418,Sorensen; Claus M,6,0,8,2
1653538256190,MATH 206A,A00,087419,Izadi; Elham,7,0,8,1
1653538256713,MATH 207A,A00,087420,Mohammadi; Amir,5,0,8,3
1653538257237,MATH 208,A00,087421,Staff,9,0,10,1
1653538257763,MATH 209,A00,087422,Staff,10,0,10,0
1653538258285,MATH 218,A00,087423,Staff,10,0,10,0
1653538258810,MATH 220A,A00,087424,Novak; Jonathan I,6,0,8,2
1653538259336,MATH 231A,A00,087425,Bejenaru; Ioan,3,0,8,5
1653538259861,MATH 240A,A00,087426,Ebenfelt; Peter F,5,0,8,3
1653538260386,MATH 243,A00,087427,Staff,9,0,10,1
1653538260916,MATH 248,A00,087429,Staff,10,0,10,0
1653538261443,MATH 250A,A00,087430,Spolaor; Luca,4,0,8,4
1653538261977,MATH 257A,A00,087431,Spolaor; Luca,7,0,8,1
1653538262499,MATH 258,A00,087432,Staff,9,0,10,1
1653538263022,MATH 264A,A00,087433,Warnke; Lutz Peter,5,0,8,3
1653538263545,MATH 268,A00,087434,Staff,15,0,15,0
1653538264073,MATH 269,A00,087435,Staff,14,0,15,1
1653538264600,MATH 270A,A00,087436,Nie; Jiawang,0,0,8,8
1653538265127,MATH 272A,A00,087437,Tian; Xiaochuan,1,0,8,7
1653538265655,MATH 274,A01,087439,Cheng; Li-Tien,9,0,10,1
1653538265655,MATH 274,A02,087440,Cheng; Li-Tien,10,0,10,0
1653538266176,MATH 278A,A00,087441,Staff,8,0,10,2
1653538266701,MATH 278B,A00,087442,Staff,8,0,10,2
1653538267225,MATH 278C,A00,087443,Staff,8,0,10,2
1653538267753,MATH 280A,A00,087444,Zheng; Tianyi,0,0,8,8
1653538268276,MATH 281A,A00,087445,Bradic; Jelena,0,0,8,8
1653538268801,MATH 282A,A00,087446,Zhang; Danna,0,0,8,8
1653538269322,MATH 283,A00,087447,Tesler; Glenn,0,0,0,15
1653538269844,MATH 286,A00,087448,Kemp; Todd Aahron,5,0,8,3
1653538270369,MATH 287D,A00,087449,Bradic; Jelena,0,0,0,0
1653538270892,MATH 288,A00,087450,Staff,14,0,15,1
1653538270892,MATH 288,B00,087451,Staff,15,0,15,0
1653538270892,MATH 288,C00,087452,Staff,15,0,15,0
1653538271427,MATH 290A,A00,087453,Xu; Zhouli,6,0,8,2
1653538271949,MATH 291A,A00,087454,Xu; Zhouli,7,0,8,1
1653538272478,MATH 292,A00,087455,Staff,10,0,10,0
1653538272999,MATH 295,A00,087456,Staff,50,0,50,0
1653538273522,MATH 297,001,087457,Staff,998,0,999,1
1653538832859,COGS 200,A01,087991,Staff,47,0,50,3
1653538833381,COGS 201,A01,094504,Rangel; Lara M,17,0,25,8
1653538833905,COGS 203,A00,087992,Coulson; Seana M,18,0,20,2
1653538834429,COGS 210A,001,087993,Greene; Deanna Jacquelyn,9998,0,9999,1
1653538834429,COGS 210A,002,087994,Saygin; Ayse P,9999,0,9999,0
1653538834429,COGS 210A,003,087995,Xia; Haijun,9999,0,9999,0
1653538834429,COGS 210A,004,087996,Nitz; Douglas A.,9999,0,9999,0
1653538834429,COGS 210A,005,087997,Hollan; James D.,9999,0,9999,0
1653538834429,COGS 210A,006,087998,Deak; Gedeon O.,9998,0,9999,1
1653538834429,COGS 210A,007,087999,Rossano; Federico,9999,0,9999,0
1653538834955,COGS 211A,A00,088000,Coulson; Seana M,9997,0,9999,2
1653538835496,COGS 229,A00,088002,Staff,23,0,25,2
1653538836021,COGS 260,B00,094231,Staff,17,0,20,3
1653538836021,COGS 260,A00,088004,Nitz; Douglas A.,9998,0,9999,1
1653538836545,CSE 202,A00,090110,Paturi; Ramamohan,0,0,0,0
1653538836545,CSE 202,B00,090111,Paturi; Ramamohan,0,0,0,0
1653538837068,CSE 207B,A00,090112,Heninger; Nadia A,0,0,0,0
1653538837591,CSE 208,A00,094858,Micciancio; Daniele,0,0,0,0
1653538838120,CSE 210,A00,090113,Powell; Thomas Allan,0,0,0,0
1653538838643,CSE 219,A00,090898,Staff,0,0,0,0
1653538839171,CSE 221,A00,090114,Zhou; Yuan-Yuan,0,0,0,0
1653538839695,CSE 229A,A00,090115,Porter; George M,0,0,0,0
1653538840219,CSE 229C,A00,090116,Savage; Stefan,0,0,0,0
1653538840745,CSE 230,A00,090117,Jhala; Ranjit,0,0,0,0
1653538841272,CSE 232,A00,090118,Papakonstantinou; Yannis,0,0,0,0
1653538841796,CSE 239A,A00,090121,Kumar; Arun Kumar,0,0,0,0
1653538842319,CSE 239B,A00,090122,Jhala; Ranjit,0,0,0,0
1653538842845,CSE 240A,A00,090123,Zhao; Jishen,0,0,189,189
1653538843368,CSE 243A,A00,090124,Orailoglu; Alex,0,0,15,15
1653538843891,CSE 249B,A00,090125,Kahng; Andrew Byun,13,0,20,7
1653538844414,CSE 250A,A00,090126,Berg-Kirkpatrick; Taylor D,0,0,0,0
1653538844938,CSE 252A,A00,090127,Ochoa; Benjamin Lawrence,0,0,0,0
1653538845464,CSE 258,A01,090129,McAuley; Julian John,0,0,0,0
1653538845988,CSE 258R,A01,090131,McAuley; Julian John,0,0,0,0
1653538846522,CSE 274,A00,090132,Ramamoorthi; Ravi,0,0,0,0
1653538847049,CSE 276A,A00,090133,Christensen; Henrik I,0,0,0,0
1653538847572,CSE 276C,A00,090134,Christensen; Henrik I,0,0,0,0
1653538848099,CSE 290,A00,090135,Bafna; Vineet,0,0,0,0
1653538848099,CSE 290,B00,090136,Ramamoorthi; Ravi,0,0,0,0
1653538848099,CSE 290,C00,090137,Li; Tzumao,8,0,10,2
1653538848099,CSE 290,D00,090138,Zhou; Yuan-Yuan,9,0,10,1
1653538848099,CSE 290,E00,090139,Christensen; Henrik I,8,0,10,2
1653538848099,CSE 290,F00,094053,Shalev; Aaron D,0,0,0,0
1653538848624,CSE 291,A00,090140,Munyaka; Imani N. S.,0,0,0,0
1653538848624,CSE 291,B00,094880,Yu; Qi,0,0,0,0
1653538848624,CSE 291,C00,090142,Pannuto; Patrick William,0,0,0,0
1653538848624,CSE 291,D00,094881,Zhang; Yiying,0,0,0,0
1653538848624,CSE 291,E00,095118,Su; Hao,0,0,0,0
1653538849158,CSE 293,001,094905,Bafna; Vineet,9999,0,9999,0
1653538849158,CSE 293,002,094906,Bellare; Mihir,9999,0,9999,0
1653538849158,CSE 293,003,094907,Berg-Kirkpatrick; Taylor D,9999,0,9999,0
1653538849158,CSE 293,004,094908,Christensen; Henrik I,9999,0,9999,0
1653538849158,CSE 293,005,094909,Cottrell; Garrison W,9999,0,9999,0
1653538849158,CSE 293,006,094910,Deutsch; Alin Bernard,9999,0,9999,0
1653538849158,CSE 293,007,094911,Esmaeilzadeh; Hadi,9999,0,9999,0
1653538849158,CSE 293,008,094912,Freund; Yoav,9999,0,9999,0
1653538849158,CSE 293,009,094913,Griswold; William G.,9999,0,9999,0
1653538849158,CSE 293,010,094914,Gymrek; Melissa Ann,9999,0,9999,0
1653538849158,CSE 293,011,094915,Heninger; Nadia A,9999,0,9999,0
1653538849158,CSE 293,012,094916,Impagliazzo; Russell,9999,0,9999,0
1653538849158,CSE 293,013,094917,Jhala; Ranjit,9999,0,9999,0
1653538849158,CSE 293,014,094918,Kahng; Andrew Byun,9999,0,9999,0
1653538849158,CSE 293,015,094919,Kane; Daniel Mertz,9999,0,9999,0
1653538849158,CSE 293,016,094920,Kriegman; David J,9999,0,9999,0
1653538849158,CSE 293,017,094921,Kumar; Arun Kumar,9999,0,9999,0
1653538849158,CSE 293,018,094922,Lerner; Sorin,9999,0,9999,0
1653538849158,CSE 293,019,094923,Lovett; Shachar,9999,0,9999,0
1653538849158,CSE 293,020,094924,McAuley; Julian John,9999,0,9999,0
1653538849158,CSE 293,021,094925,Micciancio; Daniele,9999,0,9999,0
1653538849158,CSE 293,022,094926,Orailoglu; Alex,9999,0,9999,0
1653538849158,CSE 293,023,094927,Paturi; Ramamohan,9999,0,9999,0
1653538849158,CSE 293,024,094928,Polikarpova; Nadezhda,9999,0,9999,0
1653538849158,CSE 293,025,094929,Politz; Joseph Gibbs,9999,0,9999,0
1653538849158,CSE 293,026,094930,Porter; George M,9999,0,9999,0
1653538849158,CSE 293,027,094931,Porter; Leonard Emerson,9999,0,9999,0
1653538849158,CSE 293,028,094932,Ramamoorthi; Ravi,9999,0,9999,0
1653538849158,CSE 293,029,094933,Sahoo; Debashis,9999,0,9999,0
1653538849158,CSE 293,030,094934,Saul; Lawrence,9999,0,9999,0
1653538849158,CSE 293,031,094935,Savage; Stefan,9999,0,9999,0
1653538849158,CSE 293,032,094936,Schulze; Jurgen P.,9999,0,9999,0
1653538849158,CSE 293,033,094937,Snoeren; Alex C.,9999,0,9999,0
1653538849158,CSE 293,034,094938,Shang; Jingbo,9999,0,9999,0
1653538849158,CSE 293,035,094939,Stefan; Deian,9999,0,9999,0
1653538849158,CSE 293,036,094940,Su; Hao,9999,0,9999,0
1653538849158,CSE 293,037,094941,Swanson; Steven James,9999,0,9999,0
1653538849158,CSE 293,038,094942,Tullsen; Dean Michael,9999,0,9999,0
1653538849158,CSE 293,039,094943,Voelker; Geoffrey M.,9999,0,9999,0
1653538849158,CSE 293,040,094944,Zhao; Jishen,9999,0,9999,0
1653538849158,CSE 293,041,094945,Zhou; Yuan-Yuan,9999,0,9999,0
1653538849158,CSE 293,042,094946,Gao; Sicun,9998,0,9999,1
1653538849158,CSE 293,043,094947,Weibel; Nadir,9999,0,9999,0
1653538849158,CSE 293,044,094948,Gupta; Rajesh K.,9999,0,9999,0
1653538849681,CSE 294,A00,090143,Porter; George M,8,0,10,2
1653538850204,DSE 200,A00,091799,Staff,50,0,50,0
1653538850729,DSE 203,A00,091800,Gupta; Amarnath,30,0,30,0
1653538851266,DSE 250,A00,091801,Deutsch; Alin Bernard,30,0,30,0
1653538851794,DSE 290,A00,091802,Altintas De Callaf; Ilkay,50,0,50,0
1653538852323,ECE 200,001,091003,Antipa; Nicholas A,9999,0,9999,0
1653538852323,ECE 200,002,091004,Atanasov; Nikolay A.,9999,0,9999,0
1653538852323,ECE 200,003,091005,Bharadia; Dinesh,9999,0,9999,0
1653538852323,ECE 200,004,091006,Cheng; Chung Kuan,9999,0,9999,0
1653538852323,ECE 200,005,091007,Cosman; Pamela C.,9999,0,9999,0
1653538852323,ECE 200,006,091008,Staff,9999,0,9999,0
1653538852323,ECE 200,007,091009,Dayeh; Shadi Ahmad,9999,0,9999,0
1653538852323,ECE 200,008,091010,Fainman; Yeshaiahu,9999,0,9999,0
1653538852323,ECE 200,009,091011,Ford; Joseph Earl,9999,0,9999,0
1653538852323,ECE 200,010,091012,Franceschetti; Massimo,9999,0,9999,0
1653538852323,ECE 200,011,091013,Fullerton; Eric E,9999,0,9999,0
1653538852323,ECE 200,012,091014,Galton; Ian A,9999,0,9999,0
1653538852323,ECE 200,013,091015,Gilja; Vikash,9999,0,9999,0
1653538852323,ECE 200,014,091016,Hall; Drew A.,9999,0,9999,0
1653538852323,ECE 200,015,091017,Hsueh; Tzu-Chien,9999,0,9999,0
1653538852323,ECE 200,016,091018,Javidi; Tara,9999,0,9999,0
1653538852323,ECE 200,017,091019,Kahng; Andrew Byun,9999,0,9999,0
1653538852323,ECE 200,018,091020,Kim; Young-Han,9999,0,9999,0
1653538852323,ECE 200,019,091021,Koushanfar; Farinaz,9999,0,9999,0
1653538852323,ECE 200,020,091022,Kuzum; Duygu,9999,0,9999,0
1653538852323,ECE 200,021,091023,Le; Hanh-Phuc,9999,0,9999,0
1653538852323,ECE 200,022,091024,Lin; Bill,9999,0,9999,0
1653538852323,ECE 200,023,091025,Liu; Zhaowei,9999,0,9999,0
1653538852323,ECE 200,024,091026,Lo; Yu-Hwa,9999,0,9999,0
1653538852323,ECE 200,025,091027,Lomakin; Vitaliy,9999,0,9999,0
1653538852323,ECE 200,026,091028,Mercier; Patrick Philip,9999,0,9999,0
1653538852323,ECE 200,027,091029,Meyer; Florian,9999,0,9999,0
1653538852323,ECE 200,028,091030,Milstein; Laurence B.,9999,0,9999,0
1653538852323,ECE 200,029,091031,Mir Arabbaygi; Siavash,9999,0,9999,0
1653538852323,ECE 200,030,091032,Mookherjea; Shayan,9999,0,9999,0
1653538852323,ECE 200,031,091033,Morris; Karcher William,9999,0,9999,0
1653538852323,ECE 200,032,091034,Ng; Tse Nga,9999,0,9999,0
1653538852323,ECE 200,033,091035,Nguyen; Truong Quang,9999,0,9999,0
1653538852323,ECE 200,034,091036,Nomura; Kenji,9999,0,9999,0
1653538852323,ECE 200,035,091037,Orlitsky; Alon,9999,0,9999,0
1653538852323,ECE 200,036,091038,Pal; Piya,9999,0,9999,0
1653538852323,ECE 200,037,091039,Papen; George C.,9999,0,9999,0
1653538852323,ECE 200,038,091040,Radic; Stojan,9999,0,9999,0
1653538852323,ECE 200,039,091041,Rao; Bhaskar D.,9999,0,9999,0
1653538852323,ECE 200,040,091042,Rao; Ramesh R,9999,0,9999,0
1653538852323,ECE 200,041,091043,Rebeiz; Gabriel,9999,0,9999,0
1653538852323,ECE 200,042,091044,Sanford; John R,9999,0,9999,0
1653538852323,ECE 200,043,091045,Siegel; Paul H.,9999,0,9999,0
1653538852323,ECE 200,044,091046,Sievenpiper; Daniel F.,9999,0,9999,0
1653538852323,ECE 200,045,091047,Sworder; David D.,9999,0,9999,0
1653538852323,ECE 200,046,091048,Taur; Yuan,9999,0,9999,0
1653538852323,ECE 200,047,091049,Touri; Behrouz,9999,0,9999,0
1653538852323,ECE 200,048,091050,Trivedi; Mohan M.,9999,0,9999,0
1653538852323,ECE 200,049,091051,Vardy; Alexander,9999,0,9999,0
1653538852323,ECE 200,050,091052,Vasconcelos; Nuno,9999,0,9999,0
1653538852323,ECE 200,051,091053,Wang; Xiaolong,9999,0,9999,0
1653538852323,ECE 200,052,091054,Xie; Pengtao,9999,0,9999,0
1653538852323,ECE 200,053,091055,Yip; Michael,9999,0,9999,0
1653538852323,ECE 200,054,091056,Zeger; Kenneth A.,9999,0,9999,0
1653538852323,ECE 200,055,091057,Zhang; Xinyu,9999,0,9999,0
1653538852323,ECE 200,056,091058,Turakhia; Yatish Girish,9999,0,9999,0
1653538852323,ECE 200,057,091059,Kang; Mingu,9999,0,9999,0
1653538852323,ECE 200,058,091060,Shi; Yuanyuan,9999,0,9999,0
1653538852323,ECE 200,059,091061,Wang; Edward Jay,9999,0,9999,0
1653538852323,ECE 200,060,091062,Zheng; Yang,9999,0,9999,0
1653538852851,ECE 201,A00,095526,Lo; Yu-Hwa,0,0,0,0
1653538853374,ECE 203,A00,091065,Mercier; Patrick Philip,0,0,0,0
1653538853902,ECE 207A,A00,091605,Liu; Thomas Tao-Ming,0,0,0,0
1653538854425,ECE 212AN,A00,091068,Nomura; Kenji,0,0,0,0
1653538854951,ECE 222A,A00,091069,Rebeiz; Gabriel,0,0,0,0
1653538855480,ECE 225A,A00,091070,Orlitsky; Alon,0,0,0,0
1653538856003,ECE 230A,A00,091071,Nomura; Kenji,0,0,0,0
1653538856529,ECE 236A,A00,091072,Dayeh; Shadi Ahmad,0,0,0,0
1653538857054,ECE 238A,A00,091073,Luo; Jian,0,0,0,0
1653538857054,ECE 238A,B00,091074,Luo; Jian,0,0,0,0
1653538857593,ECE 240A,A00,091075,Radic; Stojan,0,0,0,0
1653538858118,ECE 247A,A00,091592,Shi; Lingyan,0,0,0,0
1653538858646,ECE 250,A00,091076,Touri; Behrouz,0,0,0,0
1653538859169,ECE 251C,A00,091078,Nguyen; Truong Quang,0,0,0,0
1653538859703,ECE 253,A00,091079,Cosman; Pamela C.,0,0,0,0
1653538860238,ECE 255A,A00,091080,Orlitsky; Alon,0,0,0,0
1653538860768,ECE 257A,A00,091081,Zhang; Xinyu,0,0,0,0
1653538861386,ECE 260A,A01,091084,Eldon; John,0,0,0,0
1653538861914,ECE 264C,A00,091085,Galton; Ian A,0,0,0,0
1653538862437,ECE 265C,A00,094889,Presti; Calogero Davide,0,0,0,9
1653538862962,ECE 266,A01,091087,Hall; Drew A.,0,0,0,0
1653538864010,ECE 271A,A00,091090,Vasconcelos; Nuno,0,0,0,0
1653538864532,ECE 272B,A00,091091,Sworder; David D.,0,0,0,0
1653538865059,ECE 275A,A00,091092,Meyer; Florian,0,0,0,0
1653538865595,ECE 277,A00,091093,An; Cheolhong,0,0,0,0
1653538866121,ECE 283,A00,091094,Le; Hanh-Phuc,0,0,0,0
1653538866643,ECE 284,A00,091095,Kang; Mingu,0,0,0,0
1653538866643,ECE 284,B00,091096,Wang; Edward Jay,0,0,0,0
1653538867166,ECE 285,A00,094334,Touri; Behrouz,0,0,0,0
1653538867688,ECE 289,A00,091097,Whelan; David Arthur,0,0,0,0
1653538868215,MATH 200A,A00,087414,Salehi Golsefidy; Alireza,7,0,8,1
1653538868737,MATH 202A,A00,087415,Gill; Philip E.,2,0,8,6
1653538869258,MATH 203A,A00,087416,Oprea; Dragos N.,6,0,8,2
1653538869781,MATH 204A,A00,087417,Kedlaya; Kiran S.,6,0,8,2
1653538870321,MATH 205,A00,087418,Sorensen; Claus M,6,0,8,2
1653538870848,MATH 206A,A00,087419,Izadi; Elham,7,0,8,1
1653538871378,MATH 207A,A00,087420,Mohammadi; Amir,5,0,8,3
1653538871900,MATH 208,A00,087421,Staff,9,0,10,1
1653538872425,MATH 209,A00,087422,Staff,10,0,10,0
1653538872950,MATH 218,A00,087423,Staff,10,0,10,0
1653538873474,MATH 220A,A00,087424,Novak; Jonathan I,6,0,8,2
1653538874000,MATH 231A,A00,087425,Bejenaru; Ioan,3,0,8,5
1653538874526,MATH 240A,A00,087426,Ebenfelt; Peter F,5,0,8,3
1653538875050,MATH 243,A00,087427,Staff,9,0,10,1
1653538875572,MATH 248,A00,087429,Staff,10,0,10,0
1653538876098,MATH 250A,A00,087430,Spolaor; Luca,4,0,8,4
1653538876621,MATH 257A,A00,087431,Spolaor; Luca,7,0,8,1
1653538877145,MATH 258,A00,087432,Staff,9,0,10,1
1653538877672,MATH 264A,A00,087433,Warnke; Lutz Peter,5,0,8,3
1653538878202,MATH 268,A00,087434,Staff,15,0,15,0
1653538878725,MATH 269,A00,087435,Staff,14,0,15,1
1653538879248,MATH 270A,A00,087436,Nie; Jiawang,0,0,8,8
1653538879775,MATH 272A,A00,087437,Tian; Xiaochuan,1,0,8,7
1653538880298,MATH 274,A01,087439,Cheng; Li-Tien,9,0,10,1
1653538880298,MATH 274,A02,087440,Cheng; Li-Tien,10,0,10,0
1653538880823,MATH 278A,A00,087441,Staff,8,0,10,2
1653538881350,MATH 278B,A00,087442,Staff,8,0,10,2
1653538881879,MATH 278C,A00,087443,Staff,8,0,10,2
1653538882405,MATH 280A,A00,087444,Zheng; Tianyi,0,0,8,8
1653538882932,MATH 281A,A00,087445,Bradic; Jelena,0,0,8,8
1653538883463,MATH 282A,A00,087446,Zhang; Danna,0,0,8,8
1653538883986,MATH 283,A00,087447,Tesler; Glenn,0,0,0,15
1653538884513,MATH 286,A00,087448,Kemp; Todd Aahron,5,0,8,3
1653538885036,MATH 287D,A00,087449,Bradic; Jelena,0,0,0,0
1653538885559,MATH 288,A00,087450,Staff,14,0,15,1
1653538885559,MATH 288,B00,087451,Staff,15,0,15,0
1653538885559,MATH 288,C00,087452,Staff,15,0,15,0
1653538886085,MATH 290A,A00,087453,Xu; Zhouli,6,0,8,2
1653538886621,MATH 291A,A00,087454,Xu; Zhouli,7,0,8,1
1653538887145,MATH 292,A00,087455,Staff,10,0,10,0
1653538887669,MATH 295,A00,087456,Staff,50,0,50,0
1653538888195,MATH 297,001,087457,Staff,998,0,999,1
1653539448177,COGS 200,A01,087991,Staff,47,0,50,3
1653539448781,COGS 201,A01,094504,Rangel; Lara M,17,0,25,8
1653539449304,COGS 203,A00,087992,Coulson; Seana M,18,0,20,2
1653539449831,COGS 210A,001,087993,Greene; Deanna Jacquelyn,9998,0,9999,1
1653539449831,COGS 210A,002,087994,Saygin; Ayse P,9999,0,9999,0
1653539449831,COGS 210A,003,087995,Xia; Haijun,9999,0,9999,0
1653539449831,COGS 210A,004,087996,Nitz; Douglas A.,9999,0,9999,0
1653539449831,COGS 210A,005,087997,Hollan; James D.,9999,0,9999,0
1653539449831,COGS 210A,006,087998,Deak; Gedeon O.,9998,0,9999,1
1653539449831,COGS 210A,007,087999,Rossano; Federico,9999,0,9999,0
1653539450354,COGS 211A,A00,088000,Coulson; Seana M,9997,0,9999,2
1653539450878,COGS 229,A00,088002,Staff,23,0,25,2
1653539451401,COGS 260,B00,094231,Staff,17,0,20,3
1653539451401,COGS 260,A00,088004,Nitz; Douglas A.,9998,0,9999,1
1653539451925,CSE 202,A00,090110,Paturi; Ramamohan,0,0,0,0
1653539451925,CSE 202,B00,090111,Paturi; Ramamohan,0,0,0,0
1653539452454,CSE 207B,A00,090112,Heninger; Nadia A,0,0,0,0
1653539452985,CSE 208,A00,094858,Micciancio; Daniele,0,0,0,0
1653539453508,CSE 210,A00,090113,Powell; Thomas Allan,0,0,0,0
1653539454033,CSE 219,A00,090898,Staff,0,0,0,0
1653539454560,CSE 221,A00,090114,Zhou; Yuan-Yuan,0,0,0,0
1653539455085,CSE 229A,A00,090115,Porter; George M,0,0,0,0
1653539455618,CSE 229C,A00,090116,Savage; Stefan,0,0,0,0
1653539456156,CSE 230,A00,090117,Jhala; Ranjit,0,0,0,0
1653539456680,CSE 232,A00,090118,Papakonstantinou; Yannis,0,0,0,0
1653539457201,CSE 239A,A00,090121,Kumar; Arun Kumar,0,0,0,0
1653539457729,CSE 239B,A00,090122,Jhala; Ranjit,0,0,0,0
1653539458272,CSE 240A,A00,090123,Zhao; Jishen,0,0,189,189
1653539458795,CSE 243A,A00,090124,Orailoglu; Alex,0,0,15,15
1653539459320,CSE 249B,A00,090125,Kahng; Andrew Byun,13,0,20,7
1653539459845,CSE 250A,A00,090126,Berg-Kirkpatrick; Taylor D,0,0,0,0
1653539460367,CSE 252A,A00,090127,Ochoa; Benjamin Lawrence,0,0,0,0
1653539460895,CSE 258,A01,090129,McAuley; Julian John,0,0,0,0
1653539461429,CSE 258R,A01,090131,McAuley; Julian John,0,0,0,0
1653539461953,CSE 274,A00,090132,Ramamoorthi; Ravi,0,0,0,0
1653539462477,CSE 276A,A00,090133,Christensen; Henrik I,0,0,0,0
1653539463003,CSE 276C,A00,090134,Christensen; Henrik I,0,0,0,0
1653539463529,CSE 290,A00,090135,Bafna; Vineet,0,0,0,0
1653539463529,CSE 290,B00,090136,Ramamoorthi; Ravi,0,0,0,0
1653539463529,CSE 290,C00,090137,Li; Tzumao,8,0,10,2
1653539463529,CSE 290,D00,090138,Zhou; Yuan-Yuan,9,0,10,1
1653539463529,CSE 290,E00,090139,Christensen; Henrik I,8,0,10,2
1653539463529,CSE 290,F00,094053,Shalev; Aaron D,0,0,0,0
1653539464057,CSE 291,A00,090140,Munyaka; Imani N. S.,0,0,0,0
1653539464057,CSE 291,B00,094880,Yu; Qi,0,0,0,0
1653539464057,CSE 291,C00,090142,Pannuto; Patrick William,0,0,0,0
1653539464057,CSE 291,D00,094881,Zhang; Yiying,0,0,0,0
1653539464057,CSE 291,E00,095118,Su; Hao,0,0,0,0
1653539464591,CSE 293,001,094905,Bafna; Vineet,9999,0,9999,0
1653539464591,CSE 293,002,094906,Bellare; Mihir,9999,0,9999,0
1653539464591,CSE 293,003,094907,Berg-Kirkpatrick; Taylor D,9999,0,9999,0
1653539464591,CSE 293,004,094908,Christensen; Henrik I,9999,0,9999,0
1653539464591,CSE 293,005,094909,Cottrell; Garrison W,9999,0,9999,0
1653539464591,CSE 293,006,094910,Deutsch; Alin Bernard,9999,0,9999,0
1653539464591,CSE 293,007,094911,Esmaeilzadeh; Hadi,9999,0,9999,0
1653539464591,CSE 293,008,094912,Freund; Yoav,9999,0,9999,0
1653539464591,CSE 293,009,094913,Griswold; William G.,9999,0,9999,0
1653539464591,CSE 293,010,094914,Gymrek; Melissa Ann,9999,0,9999,0
1653539464591,CSE 293,011,094915,Heninger; Nadia A,9999,0,9999,0
1653539464591,CSE 293,012,094916,Impagliazzo; Russell,9999,0,9999,0
1653539464591,CSE 293,013,094917,Jhala; Ranjit,9999,0,9999,0
1653539464591,CSE 293,014,094918,Kahng; Andrew Byun,9999,0,9999,0
1653539464591,CSE 293,015,094919,Kane; Daniel Mertz,9999,0,9999,0
1653539464591,CSE 293,016,094920,Kriegman; David J,9999,0,9999,0
1653539464591,CSE 293,017,094921,Kumar; Arun Kumar,9999,0,9999,0
1653539464591,CSE 293,018,094922,Lerner; Sorin,9999,0,9999,0
1653539464591,CSE 293,019,094923,Lovett; Shachar,9999,0,9999,0
1653539464591,CSE 293,020,094924,McAuley; Julian John,9999,0,9999,0
1653539464591,CSE 293,021,094925,Micciancio; Daniele,9999,0,9999,0
1653539464591,CSE 293,022,094926,Orailoglu; Alex,9999,0,9999,0
1653539464591,CSE 293,023,094927,Paturi; Ramamohan,9999,0,9999,0
1653539464591,CSE 293,024,094928,Polikarpova; Nadezhda,9999,0,9999,0
1653539464591,CSE 293,025,094929,Politz; Joseph Gibbs,9999,0,9999,0
1653539464591,CSE 293,026,094930,Porter; George M,9999,0,9999,0
1653539464591,CSE 293,027,094931,Porter; Leonard Emerson,9999,0,9999,0
1653539464591,CSE 293,028,094932,Ramamoorthi; Ravi,9999,0,9999,0
1653539464591,CSE 293,029,094933,Sahoo; Debashis,9999,0,9999,0
1653539464591,CSE 293,030,094934,Saul; Lawrence,9999,0,9999,0
1653539464591,CSE 293,031,094935,Savage; Stefan,9999,0,9999,0
1653539464591,CSE 293,032,094936,Schulze; Jurgen P.,9999,0,9999,0
1653539464591,CSE 293,033,094937,Snoeren; Alex C.,9999,0,9999,0
1653539464591,CSE 293,034,094938,Shang; Jingbo,9999,0,9999,0
1653539464591,CSE 293,035,094939,Stefan; Deian,9999,0,9999,0
1653539464591,CSE 293,036,094940,Su; Hao,9999,0,9999,0
1653539464591,CSE 293,037,094941,Swanson; Steven James,9999,0,9999,0
1653539464591,CSE 293,038,094942,Tullsen; Dean Michael,9999,0,9999,0
1653539464591,CSE 293,039,094943,Voelker; Geoffrey M.,9999,0,9999,0
1653539464591,CSE 293,040,094944,Zhao; Jishen,9999,0,9999,0
1653539464591,CSE 293,041,094945,Zhou; Yuan-Yuan,9999,0,9999,0
1653539464591,CSE 293,042,094946,Gao; Sicun,9998,0,9999,1
1653539464591,CSE 293,043,094947,Weibel; Nadir,9999,0,9999,0
1653539464591,CSE 293,044,094948,Gupta; Rajesh K.,9999,0,9999,0
1653539465114,CSE 294,A00,090143,Porter; George M,8,0,10,2
1653539465645,DSE 200,A00,091799,Staff,50,0,50,0
1653539466182,DSE 203,A00,091800,Gupta; Amarnath,30,0,30,0
1653539466711,DSE 250,A00,091801,Deutsch; Alin Bernard,30,0,30,0
1653539467242,DSE 290,A00,091802,Altintas De Callaf; Ilkay,50,0,50,0
1653539467783,ECE 200,001,091003,Antipa; Nicholas A,9999,0,9999,0
1653539467783,ECE 200,002,091004,Atanasov; Nikolay A.,9999,0,9999,0
1653539467783,ECE 200,003,091005,Bharadia; Dinesh,9999,0,9999,0
1653539467783,ECE 200,004,091006,Cheng; Chung Kuan,9999,0,9999,0
1653539467783,ECE 200,005,091007,Cosman; Pamela C.,9999,0,9999,0
1653539467783,ECE 200,006,091008,Staff,9999,0,9999,0
1653539467783,ECE 200,007,091009,Dayeh; Shadi Ahmad,9999,0,9999,0
1653539467783,ECE 200,008,091010,Fainman; Yeshaiahu,9999,0,9999,0
1653539467783,ECE 200,009,091011,Ford; Joseph Earl,9999,0,9999,0
1653539467783,ECE 200,010,091012,Franceschetti; Massimo,9999,0,9999,0
1653539467783,ECE 200,011,091013,Fullerton; Eric E,9999,0,9999,0
1653539467783,ECE 200,012,091014,Galton; Ian A,9999,0,9999,0
1653539467783,ECE 200,013,091015,Gilja; Vikash,9999,0,9999,0
1653539467783,ECE 200,014,091016,Hall; Drew A.,9999,0,9999,0
1653539467783,ECE 200,015,091017,Hsueh; Tzu-Chien,9999,0,9999,0
1653539467783,ECE 200,016,091018,Javidi; Tara,9999,0,9999,0
1653539467783,ECE 200,017,091019,Kahng; Andrew Byun,9999,0,9999,0
1653539467783,ECE 200,018,091020,Kim; Young-Han,9999,0,9999,0
1653539467783,ECE 200,019,091021,Koushanfar; Farinaz,9999,0,9999,0
1653539467783,ECE 200,020,091022,Kuzum; Duygu,9999,0,9999,0
1653539467783,ECE 200,021,091023,Le; Hanh-Phuc,9999,0,9999,0
1653539467783,ECE 200,022,091024,Lin; Bill,9999,0,9999,0
1653539467783,ECE 200,023,091025,Liu; Zhaowei,9999,0,9999,0
1653539467783,ECE 200,024,091026,Lo; Yu-Hwa,9999,0,9999,0
1653539467783,ECE 200,025,091027,Lomakin; Vitaliy,9999,0,9999,0
1653539467783,ECE 200,026,091028,Mercier; Patrick Philip,9999,0,9999,0
1653539467783,ECE 200,027,091029,Meyer; Florian,9999,0,9999,0
1653539467783,ECE 200,028,091030,Milstein; Laurence B.,9999,0,9999,0
1653539467783,ECE 200,029,091031,Mir Arabbaygi; Siavash,9999,0,9999,0
1653539467783,ECE 200,030,091032,Mookherjea; Shayan,9999,0,9999,0
1653539467783,ECE 200,031,091033,Morris; Karcher William,9999,0,9999,0
1653539467783,ECE 200,032,091034,Ng; Tse Nga,9999,0,9999,0
1653539467783,ECE 200,033,091035,Nguyen; Truong Quang,9999,0,9999,0
1653539467783,ECE 200,034,091036,Nomura; Kenji,9999,0,9999,0
1653539467783,ECE 200,035,091037,Orlitsky; Alon,9999,0,9999,0
1653539467783,ECE 200,036,091038,Pal; Piya,9999,0,9999,0
1653539467783,ECE 200,037,091039,Papen; George C.,9999,0,9999,0
1653539467783,ECE 200,038,091040,Radic; Stojan,9999,0,9999,0
1653539467783,ECE 200,039,091041,Rao; Bhaskar D.,9999,0,9999,0
1653539467783,ECE 200,040,091042,Rao; Ramesh R,9999,0,9999,0
1653539467783,ECE 200,041,091043,Rebeiz; Gabriel,9999,0,9999,0
1653539467783,ECE 200,042,091044,Sanford; John R,9999,0,9999,0
1653539467783,ECE 200,043,091045,Siegel; Paul H.,9999,0,9999,0
1653539467783,ECE 200,044,091046,Sievenpiper; Daniel F.,9999,0,9999,0
1653539467783,ECE 200,045,091047,Sworder; David D.,9999,0,9999,0
1653539467783,ECE 200,046,091048,Taur; Yuan,9999,0,9999,0
1653539467783,ECE 200,047,091049,Touri; Behrouz,9999,0,9999,0
1653539467783,ECE 200,048,091050,Trivedi; Mohan M.,9999,0,9999,0
1653539467783,ECE 200,049,091051,Vardy; Alexander,9999,0,9999,0
1653539467783,ECE 200,050,091052,Vasconcelos; Nuno,9999,0,9999,0
1653539467783,ECE 200,051,091053,Wang; Xiaolong,9999,0,9999,0
1653539467783,ECE 200,052,091054,Xie; Pengtao,9999,0,9999,0
1653539467783,ECE 200,053,091055,Yip; Michael,9999,0,9999,0
1653539467783,ECE 200,054,091056,Zeger; Kenneth A.,9999,0,9999,0
1653539467783,ECE 200,055,091057,Zhang; Xinyu,9999,0,9999,0
1653539467783,ECE 200,056,091058,Turakhia; Yatish Girish,9999,0,9999,0
1653539467783,ECE 200,057,091059,Kang; Mingu,9999,0,9999,0
1653539467783,ECE 200,058,091060,Shi; Yuanyuan,9999,0,9999,0
1653539467783,ECE 200,059,091061,Wang; Edward Jay,9999,0,9999,0
1653539467783,ECE 200,060,091062,Zheng; Yang,9999,0,9999,0
1653539468313,ECE 201,A00,095526,Lo; Yu-Hwa,0,0,0,0
1653539468840,ECE 203,A00,091065,Mercier; Patrick Philip,0,0,0,0
1653539469376,ECE 207A,A00,091605,Liu; Thomas Tao-Ming,0,0,0,0
1653539469899,ECE 212AN,A00,091068,Nomura; Kenji,0,0,0,0
1653539470423,ECE 222A,A00,091069,Rebeiz; Gabriel,0,0,0,0
1653539470947,ECE 225A,A00,091070,Orlitsky; Alon,0,0,0,0
1653539471473,ECE 230A,A00,091071,Nomura; Kenji,0,0,0,0
1653539471998,ECE 236A,A00,091072,Dayeh; Shadi Ahmad,0,0,0,0
1653539472522,ECE 238A,A00,091073,Luo; Jian,0,0,0,0
1653539472522,ECE 238A,B00,091074,Luo; Jian,0,0,0,0
1653539473049,ECE 240A,A00,091075,Radic; Stojan,0,0,0,0
1653539473573,ECE 247A,A00,091592,Shi; Lingyan,0,0,0,0
1653539474100,ECE 250,A00,091076,Touri; Behrouz,0,0,0,0
1653539474624,ECE 251C,A00,091078,Nguyen; Truong Quang,0,0,0,0
1653539475155,ECE 253,A00,091079,Cosman; Pamela C.,0,0,0,0
1653539475682,ECE 255A,A00,091080,Orlitsky; Alon,0,0,0,0
1653539476207,ECE 257A,A00,091081,Zhang; Xinyu,0,0,0,0
1653539476731,ECE 260A,A01,091084,Eldon; John,0,0,0,0
1653539477257,ECE 264C,A00,091085,Galton; Ian A,0,0,0,0
1653539477780,ECE 265C,A00,094889,Presti; Calogero Davide,0,0,0,9
1653539478306,ECE 266,A01,091087,Hall; Drew A.,0,0,0,0
1653539479357,ECE 271A,A00,091090,Vasconcelos; Nuno,0,0,0,0
1653539479893,ECE 272B,A00,091091,Sworder; David D.,0,0,0,0
1653539480419,ECE 275A,A00,091092,Meyer; Florian,0,0,0,0
1653539480942,ECE 277,A00,091093,An; Cheolhong,0,0,0,0
1653539481478,ECE 283,A00,091094,Le; Hanh-Phuc,0,0,0,0
1653539482010,ECE 284,A00,091095,Kang; Mingu,0,0,0,0
1653539482010,ECE 284,B00,091096,Wang; Edward Jay,0,0,0,0
1653539482533,ECE 285,A00,094334,Touri; Behrouz,0,0,0,0
1653539483059,ECE 289,A00,091097,Whelan; David Arthur,0,0,0,0
1653539483586,MATH 200A,A00,087414,Salehi Golsefidy; Alireza,7,0,8,1
1653539484115,MATH 202A,A00,087415,Gill; Philip E.,2,0,8,6
1653539484639,MATH 203A,A00,087416,Oprea; Dragos N.,6,0,8,2
1653539485169,MATH 204A,A00,087417,Kedlaya; Kiran S.,6,0,8,2
1653539485692,MATH 205,A00,087418,Sorensen; Claus M,6,0,8,2
1653539486214,MATH 206A,A00,087419,Izadi; Elham,7,0,8,1
1653539486741,MATH 207A,A00,087420,Mohammadi; Amir,5,0,8,3
1653539487263,MATH 208,A00,087421,Staff,9,0,10,1
1653539487786,MATH 209,A00,087422,Staff,10,0,10,0
1653539488312,MATH 218,A00,087423,Staff,10,0,10,0
1653539488835,MATH 220A,A00,087424,Novak; Jonathan I,6,0,8,2
1653539489361,MATH 231A,A00,087425,Bejenaru; Ioan,3,0,8,5
1653539489886,MATH 240A,A00,087426,Ebenfelt; Peter F,5,0,8,3
1653539490408,MATH 243,A00,087427,Staff,9,0,10,1
1653539490931,MATH 248,A00,087429,Staff,10,0,10,0
1653539491458,MATH 250A,A00,087430,Spolaor; Luca,4,0,8,4
1653539491982,MATH 257A,A00,087431,Spolaor; Luca,7,0,8,1
1653539492513,MATH 258,A00,087432,Staff,9,0,10,1
1653539493041,MATH 264A,A00,087433,Warnke; Lutz Peter,5,0,8,3
1653539493577,MATH 268,A00,087434,Staff,15,0,15,0
1653539494104,MATH 269,A00,087435,Staff,14,0,15,1
1653539494627,MATH 270A,A00,087436,Nie; Jiawang,0,0,8,8
1653539495153,MATH 272A,A00,087437,Tian; Xiaochuan,1,0,8,7
1653539495690,MATH 274,A01,087439,Cheng; Li-Tien,9,0,10,1
1653539495690,MATH 274,A02,087440,Cheng; Li-Tien,10,0,10,0
1653539496213,MATH 278A,A00,087441,Staff,8,0,10,2
1653539496736,MATH 278B,A00,087442,Staff,8,0,10,2
1653539497264,MATH 278C,A00,087443,Staff,8,0,10,2
1653539497793,MATH 280A,A00,087444,Zheng; Tianyi,0,0,8,8
1653539498316,MATH 281A,A00,087445,Bradic; Jelena,0,0,8,8
1653539498838,MATH 282A,A00,087446,Zhang; Danna,0,0,8,8
1653539499360,MATH 283,A00,087447,Tesler; Glenn,0,0,0,15
1653539499885,MATH 286,A00,087448,Kemp; Todd Aahron,5,0,8,3
1653539500411,MATH 287D,A00,087449,Bradic; Jelena,0,0,0,0
1653539500937,MATH 288,A00,087450,Staff,14,0,15,1
1653539500937,MATH 288,B00,087451,Staff,15,0,15,0
1653539500937,MATH 288,C00,087452,Staff,15,0,15,0
1653539501461,MATH 290A,A00,087453,Xu; Zhouli,6,0,8,2
1653539502086,MATH 291A,A00,087454,Xu; Zhouli,7,0,8,1
1653539502617,MATH 292,A00,087455,Staff,10,0,10,0
1653539503140,MATH 295,A00,087456,Staff,50,0,50,0
1653539503662,MATH 297,001,087457,Staff,998,0,999,1
1653540063016,COGS 200,A01,087991,Staff,47,0,50,3
1653540063540,COGS 201,A01,094504,Rangel; Lara M,17,0,25,8
1653540064074,COGS 203,A00,087992,Coulson; Seana M,18,0,20,2
1653540064602,COGS 210A,001,087993,Greene; Deanna Jacquelyn,9998,0,9999,1
1653540064602,COGS 210A,002,087994,Saygin; Ayse P,9999,0,9999,0
1653540064602,COGS 210A,003,087995,Xia; Haijun,9999,0,9999,0
1653540064602,COGS 210A,004,087996,Nitz; Douglas A.,9999,0,9999,0
1653540064602,COGS 210A,005,087997,Hollan; James D.,9999,0,9999,0
1653540064602,COGS 210A,006,087998,Deak; Gedeon O.,9998,0,9999,1
1653540064602,COGS 210A,007,087999,Rossano; Federico,9999,0,9999,0
1653540065124,COGS 211A,A00,088000,Coulson; Seana M,9997,0,9999,2
1653540065648,COGS 229,A00,088002,Staff,23,0,25,2
1653540066173,COGS 260,B00,094231,Staff,17,0,20,3
1653540066173,COGS 260,A00,088004,Nitz; Douglas A.,9998,0,9999,1
1653540066696,CSE 202,A00,090110,Paturi; Ramamohan,0,0,0,0
1653540066696,CSE 202,B00,090111,Paturi; Ramamohan,0,0,0,0
1653540067219,CSE 207B,A00,090112,Heninger; Nadia A,0,0,0,0
1653540067742,CSE 208,A00,094858,Micciancio; Daniele,0,0,0,0
1653540068270,CSE 210,A00,090113,Powell; Thomas Allan,0,0,0,0
1653540068807,CSE 219,A00,090898,Staff,0,0,0,0
1653540069329,CSE 221,A00,090114,Zhou; Yuan-Yuan,0,0,0,0
1653540069852,CSE 229A,A00,090115,Porter; George M,0,0,0,0
1653540070376,CSE 229C,A00,090116,Savage; Stefan,0,0,0,0
1653540070907,CSE 230,A00,090117,Jhala; Ranjit,0,0,0,0
1653540071430,CSE 232,A00,090118,Papakonstantinou; Yannis,0,0,0,0
1653540071951,CSE 239A,A00,090121,Kumar; Arun Kumar,0,0,0,0
1653540072476,CSE 239B,A00,090122,Jhala; Ranjit,0,0,0,0
1653540072999,CSE 240A,A00,090123,Zhao; Jishen,0,0,189,189
1653540073534,CSE 243A,A00,090124,Orailoglu; Alex,0,0,15,15
1653540074061,CSE 249B,A00,090125,Kahng; Andrew Byun,13,0,20,7
1653540074584,CSE 250A,A00,090126,Berg-Kirkpatrick; Taylor D,0,0,0,0
1653540075108,CSE 252A,A00,090127,Ochoa; Benjamin Lawrence,0,0,0,0
1653540075637,CSE 258,A01,090129,McAuley; Julian John,0,0,0,0
1653540076160,CSE 258R,A01,090131,McAuley; Julian John,0,0,0,0
1653540076686,CSE 274,A00,090132,Ramamoorthi; Ravi,0,0,0,0
1653540077211,CSE 276A,A00,090133,Christensen; Henrik I,0,0,0,0
1653540077734,CSE 276C,A00,090134,Christensen; Henrik I,0,0,0,0
1653540078261,CSE 290,A00,090135,Bafna; Vineet,0,0,0,0
1653540078261,CSE 290,B00,090136,Ramamoorthi; Ravi,0,0,0,0
1653540078261,CSE 290,C00,090137,Li; Tzumao,8,0,10,2
1653540078261,CSE 290,D00,090138,Zhou; Yuan-Yuan,9,0,10,1
1653540078261,CSE 290,E00,090139,Christensen; Henrik I,8,0,10,2
1653540078261,CSE 290,F00,094053,Shalev; Aaron D,0,0,0,0
1653540078785,CSE 291,A00,090140,Munyaka; Imani N. S.,0,0,0,0
1653540078785,CSE 291,B00,094880,Yu; Qi,0,0,0,0
1653540078785,CSE 291,C00,090142,Pannuto; Patrick William,0,0,0,0
1653540078785,CSE 291,D00,094881,Zhang; Yiying,0,0,0,0
1653540078785,CSE 291,E00,095118,Su; Hao,0,0,0,0
1653540079311,CSE 293,001,094905,Bafna; Vineet,9999,0,9999,0
1653540079311,CSE 293,002,094906,Bellare; Mihir,9999,0,9999,0
1653540079311,CSE 293,003,094907,Berg-Kirkpatrick; Taylor D,9999,0,9999,0
1653540079311,CSE 293,004,094908,Christensen; Henrik I,9999,0,9999,0
1653540079311,CSE 293,005,094909,Cottrell; Garrison W,9999,0,9999,0
1653540079311,CSE 293,006,094910,Deutsch; Alin Bernard,9999,0,9999,0
1653540079311,CSE 293,007,094911,Esmaeilzadeh; Hadi,9999,0,9999,0
1653540079311,CSE 293,008,094912,Freund; Yoav,9999,0,9999,0
1653540079311,CSE 293,009,094913,Griswold; William G.,9999,0,9999,0
1653540079311,CSE 293,010,094914,Gymrek; Melissa Ann,9999,0,9999,0
1653540079311,CSE 293,011,094915,Heninger; Nadia A,9999,0,9999,0
1653540079311,CSE 293,012,094916,Impagliazzo; Russell,9999,0,9999,0
1653540079311,CSE 293,013,094917,Jhala; Ranjit,9999,0,9999,0
1653540079311,CSE 293,014,094918,Kahng; Andrew Byun,9999,0,9999,0
1653540079311,CSE 293,015,094919,Kane; Daniel Mertz,9999,0,9999,0
1653540079311,CSE 293,016,094920,Kriegman; David J,9999,0,9999,0
1653540079311,CSE 293,017,094921,Kumar; Arun Kumar,9999,0,9999,0
1653540079311,CSE 293,018,094922,Lerner; Sorin,9999,0,9999,0
1653540079311,CSE 293,019,094923,Lovett; Shachar,9999,0,9999,0
1653540079311,CSE 293,020,094924,McAuley; Julian John,9999,0,9999,0
1653540079311,CSE 293,021,094925,Micciancio; Daniele,9999,0,9999,0
1653540079311,CSE 293,022,094926,Orailoglu; Alex,9999,0,9999,0
1653540079311,CSE 293,023,094927,Paturi; Ramamohan,9999,0,9999,0
1653540079311,CSE 293,024,094928,Polikarpova; Nadezhda,9999,0,9999,0
1653540079311,CSE 293,025,094929,Politz; Joseph Gibbs,9999,0,9999,0
1653540079311,CSE 293,026,094930,Porter; George M,9999,0,9999,0
1653540079311,CSE 293,027,094931,Porter; Leonard Emerson,9999,0,9999,0
1653540079311,CSE 293,028,094932,Ramamoorthi; Ravi,9999,0,9999,0
1653540079311,CSE 293,029,094933,Sahoo; Debashis,9999,0,9999,0
1653540079311,CSE 293,030,094934,Saul; Lawrence,9999,0,9999,0
1653540079311,CSE 293,031,094935,Savage; Stefan,9999,0,9999,0
1653540079311,CSE 293,032,094936,Schulze; Jurgen P.,9999,0,9999,0
1653540079311,CSE 293,033,094937,Snoeren; Alex C.,9999,0,9999,0
1653540079311,CSE 293,034,094938,Shang; Jingbo,9999,0,9999,0
1653540079311,CSE 293,035,094939,Stefan; Deian,9999,0,9999,0
1653540079311,CSE 293,036,094940,Su; Hao,9999,0,9999,0
1653540079311,CSE 293,037,094941,Swanson; Steven James,9999,0,9999,0
1653540079311,CSE 293,038,094942,Tullsen; Dean Michael,9999,0,9999,0
1653540079311,CSE 293,039,094943,Voelker; Geoffrey M.,9999,0,9999,0
1653540079311,CSE 293,040,094944,Zhao; Jishen,9999,0,9999,0
1653540079311,CSE 293,041,094945,Zhou; Yuan-Yuan,9999,0,9999,0
1653540079311,CSE 293,042,094946,Gao; Sicun,9998,0,9999,1
1653540079311,CSE 293,043,094947,Weibel; Nadir,9999,0,9999,0
1653540079311,CSE 293,044,094948,Gupta; Rajesh K.,9999,0,9999,0
1653540079839,CSE 294,A00,090143,Porter; George M,8,0,10,2
1653540080426,DSE 200,A00,091799,Staff,50,0,50,0
1653540080952,DSE 203,A00,091800,Gupta; Amarnath,30,0,30,0
1653540081482,DSE 250,A00,091801,Deutsch; Alin Bernard,30,0,30,0
1653540082007,DSE 290,A00,091802,Altintas De Callaf; Ilkay,50,0,50,0
1653540082551,ECE 200,001,091003,Antipa; Nicholas A,9999,0,9999,0
1653540082551,ECE 200,002,091004,Atanasov; Nikolay A.,9999,0,9999,0
1653540082551,ECE 200,003,091005,Bharadia; Dinesh,9999,0,9999,0
1653540082551,ECE 200,004,091006,Cheng; Chung Kuan,9999,0,9999,0
1653540082551,ECE 200,005,091007,Cosman; Pamela C.,9999,0,9999,0
1653540082551,ECE 200,006,091008,Staff,9999,0,9999,0
1653540082551,ECE 200,007,091009,Dayeh; Shadi Ahmad,9999,0,9999,0
1653540082551,ECE 200,008,091010,Fainman; Yeshaiahu,9999,0,9999,0
1653540082551,ECE 200,009,091011,Ford; Joseph Earl,9999,0,9999,0
1653540082551,ECE 200,010,091012,Franceschetti; Massimo,9999,0,9999,0
1653540082551,ECE 200,011,091013,Fullerton; Eric E,9999,0,9999,0
1653540082551,ECE 200,012,091014,Galton; Ian A,9999,0,9999,0
1653540082551,ECE 200,013,091015,Gilja; Vikash,9999,0,9999,0
1653540082551,ECE 200,014,091016,Hall; Drew A.,9999,0,9999,0
1653540082551,ECE 200,015,091017,Hsueh; Tzu-Chien,9999,0,9999,0
1653540082551,ECE 200,016,091018,Javidi; Tara,9999,0,9999,0
1653540082551,ECE 200,017,091019,Kahng; Andrew Byun,9999,0,9999,0
1653540082551,ECE 200,018,091020,Kim; Young-Han,9999,0,9999,0
1653540082551,ECE 200,019,091021,Koushanfar; Farinaz,9999,0,9999,0
1653540082551,ECE 200,020,091022,Kuzum; Duygu,9999,0,9999,0
1653540082551,ECE 200,021,091023,Le; Hanh-Phuc,9999,0,9999,0
1653540082551,ECE 200,022,091024,Lin; Bill,9999,0,9999,0
1653540082551,ECE 200,023,091025,Liu; Zhaowei,9999,0,9999,0
1653540082551,ECE 200,024,091026,Lo; Yu-Hwa,9999,0,9999,0
1653540082551,ECE 200,025,091027,Lomakin; Vitaliy,9999,0,9999,0
1653540082551,ECE 200,026,091028,Mercier; Patrick Philip,9999,0,9999,0
1653540082551,ECE 200,027,091029,Meyer; Florian,9999,0,9999,0
1653540082551,ECE 200,028,091030,Milstein; Laurence B.,9999,0,9999,0
1653540082551,ECE 200,029,091031,Mir Arabbaygi; Siavash,9999,0,9999,0
1653540082551,ECE 200,030,091032,Mookherjea; Shayan,9999,0,9999,0
1653540082551,ECE 200,031,091033,Morris; Karcher William,9999,0,9999,0
1653540082551,ECE 200,032,091034,Ng; Tse Nga,9999,0,9999,0
1653540082551,ECE 200,033,091035,Nguyen; Truong Quang,9999,0,9999,0
1653540082551,ECE 200,034,091036,Nomura; Kenji,9999,0,9999,0
1653540082551,ECE 200,035,091037,Orlitsky; Alon,9999,0,9999,0
1653540082551,ECE 200,036,091038,Pal; Piya,9999,0,9999,0
1653540082551,ECE 200,037,091039,Papen; George C.,9999,0,9999,0
1653540082551,ECE 200,038,091040,Radic; Stojan,9999,0,9999,0
1653540082551,ECE 200,039,091041,Rao; Bhaskar D.,9999,0,9999,0
1653540082551,ECE 200,040,091042,Rao; Ramesh R,9999,0,9999,0
1653540082551,ECE 200,041,091043,Rebeiz; Gabriel,9999,0,9999,0
1653540082551,ECE 200,042,091044,Sanford; John R,9999,0,9999,0
1653540082551,ECE 200,043,091045,Siegel; Paul H.,9999,0,9999,0
1653540082551,ECE 200,044,091046,Sievenpiper; Daniel F.,9999,0,9999,0
1653540082551,ECE 200,045,091047,Sworder; David D.,9999,0,9999,0
1653540082551,ECE 200,046,091048,Taur; Yuan,9999,0,9999,0
1653540082551,ECE 200,047,091049,Touri; Behrouz,9999,0,9999,0
1653540082551,ECE 200,048,091050,Trivedi; Mohan M.,9999,0,9999,0
1653540082551,ECE 200,049,091051,Vardy; Alexander,9999,0,9999,0
1653540082551,ECE 200,050,091052,Vasconcelos; Nuno,9999,0,9999,0
1653540082551,ECE 200,051,091053,Wang; Xiaolong,9999,0,9999,0
1653540082551,ECE 200,052,091054,Xie; Pengtao,9999,0,9999,0
1653540082551,ECE 200,053,091055,Yip; Michael,9999,0,9999,0
1653540082551,ECE 200,054,091056,Zeger; Kenneth A.,9999,0,9999,0
1653540082551,ECE 200,055,091057,Zhang; Xinyu,9999,0,9999,0
1653540082551,ECE 200,056,091058,Turakhia; Yatish Girish,9999,0,9999,0
1653540082551,ECE 200,057,091059,Kang; Mingu,9999,0,9999,0
1653540082551,ECE 200,058,091060,Shi; Yuanyuan,9999,0,9999,0
1653540082551,ECE 200,059,091061,Wang; Edward Jay,9999,0,9999,0
1653540082551,ECE 200,060,091062,Zheng; Yang,9999,0,9999,0
1653540083080,ECE 201,A00,095526,Lo; Yu-Hwa,0,0,0,0
1653540083607,ECE 203,A00,091065,Mercier; Patrick Philip,0,0,0,0
1653540084131,ECE 207A,A00,091605,Liu; Thomas Tao-Ming,0,0,0,0
1653540084653,ECE 212AN,A00,091068,Nomura; Kenji,0,0,0,0
1653540085177,ECE 222A,A00,091069,Rebeiz; Gabriel,0,0,0,0
1653540085700,ECE 225A,A00,091070,Orlitsky; Alon,0,0,0,0
1653540086225,ECE 230A,A00,091071,Nomura; Kenji,0,0,0,0
1653540086748,ECE 236A,A00,091072,Dayeh; Shadi Ahmad,0,0,0,0
1653540087269,ECE 238A,A00,091073,Luo; Jian,0,0,0,0
1653540087269,ECE 238A,B00,091074,Luo; Jian,0,0,0,0
1653540087795,ECE 240A,A00,091075,Radic; Stojan,0,0,0,0
1653540088319,ECE 247A,A00,091592,Shi; Lingyan,0,0,0,0
1653540088932,ECE 250,A00,091076,Touri; Behrouz,0,0,0,0
1653540089460,ECE 251C,A00,091078,Nguyen; Truong Quang,0,0,0,0
1653540090000,ECE 253,A00,091079,Cosman; Pamela C.,0,0,0,0
1653540090540,ECE 255A,A00,091080,Orlitsky; Alon,0,0,0,0
1653540091064,ECE 257A,A00,091081,Zhang; Xinyu,0,0,0,0
1653540091595,ECE 260A,A01,091084,Eldon; John,0,0,0,0
1653540092123,ECE 264C,A00,091085,Galton; Ian A,0,0,0,0
1653540092645,ECE 265C,A00,094889,Presti; Calogero Davide,0,0,0,9
1653540093168,ECE 266,A01,091087,Hall; Drew A.,0,0,0,0
1653540094215,ECE 271A,A00,091090,Vasconcelos; Nuno,0,0,0,0
1653540094739,ECE 272B,A00,091091,Sworder; David D.,0,0,0,0
1653540095262,ECE 275A,A00,091092,Meyer; Florian,0,0,0,0
1653540095788,ECE 277,A00,091093,An; Cheolhong,0,0,0,0
1653540096311,ECE 283,A00,091094,Le; Hanh-Phuc,0,0,0,0
1653540096836,ECE 284,A00,091095,Kang; Mingu,0,0,0,0
1653540096836,ECE 284,B00,091096,Wang; Edward Jay,0,0,0,0
1653540097363,ECE 285,A00,094334,Touri; Behrouz,0,0,0,0
1653540097886,ECE 289,A00,091097,Whelan; David Arthur,0,0,0,0
1653540098414,MATH 200A,A00,087414,Salehi Golsefidy; Alireza,7,0,8,1
1653540098945,MATH 202A,A00,087415,Gill; Philip E.,2,0,8,6
1653540099471,MATH 203A,A00,087416,Oprea; Dragos N.,6,0,8,2
1653540099995,MATH 204A,A00,087417,Kedlaya; Kiran S.,6,0,8,2
1653540100518,MATH 205,A00,087418,Sorensen; Claus M,6,0,8,2
1653540101048,MATH 206A,A00,087419,Izadi; Elham,7,0,8,1
1653540101571,MATH 207A,A00,087420,Mohammadi; Amir,5,0,8,3
1653540102092,MATH 208,A00,087421,Staff,9,0,10,1
1653540102616,MATH 209,A00,087422,Staff,10,0,10,0
1653540103138,MATH 218,A00,087423,Staff,10,0,10,0
1653540103661,MATH 220A,A00,087424,Novak; Jonathan I,6,0,8,2
1653540104185,MATH 231A,A00,087425,Bejenaru; Ioan,3,0,8,5
1653540104708,MATH 240A,A00,087426,Ebenfelt; Peter F,5,0,8,3
1653540105232,MATH 243,A00,087427,Staff,9,0,10,1
1653540105758,MATH 248,A00,087429,Staff,10,0,10,0
1653540106284,MATH 250A,A00,087430,Spolaor; Luca,4,0,8,4
1653540106813,MATH 257A,A00,087431,Spolaor; Luca,7,0,8,1
1653540107336,MATH 258,A00,087432,Staff,9,0,10,1
1653540107859,MATH 264A,A00,087433,Warnke; Lutz Peter,5,0,8,3
1653540108387,MATH 268,A00,087434,Staff,15,0,15,0
1653540108910,MATH 269,A00,087435,Staff,14,0,15,1
1653540109432,MATH 270A,A00,087436,Nie; Jiawang,0,0,8,8
1653540109954,MATH 272A,A00,087437,Tian; Xiaochuan,1,0,8,7
1653540110477,MATH 274,A01,087439,Cheng; Li-Tien,9,0,10,1
1653540110477,MATH 274,A02,087440,Cheng; Li-Tien,10,0,10,0
1653540111002,MATH 278A,A00,087441,Staff,8,0,10,2
1653540111527,MATH 278B,A00,087442,Staff,8,0,10,2
1653540112056,MATH 278C,A00,087443,Staff,8,0,10,2
1653540112581,MATH 280A,A00,087444,Zheng; Tianyi,0,0,8,8
1653540113103,MATH 281A,A00,087445,Bradic; Jelena,0,0,8,8
1653540113633,MATH 282A,A00,087446,Zhang; Danna,0,0,8,8
1653540114160,MATH 283,A00,087447,Tesler; Glenn,0,0,0,15
1653540114691,MATH 286,A00,087448,Kemp; Todd Aahron,5,0,8,3
1653540115213,MATH 287D,A00,087449,Bradic; Jelena,0,0,0,0
1653540115738,MATH 288,A00,087450,Staff,14,0,15,1
1653540115738,MATH 288,B00,087451,Staff,15,0,15,0
1653540115738,MATH 288,C00,087452,Staff,15,0,15,0
1653540116264,MATH 290A,A00,087453,Xu; Zhouli,6,0,8,2
1653540116790,MATH 291A,A00,087454,Xu; Zhouli,7,0,8,1
1653540117337,MATH 292,A00,087455,Staff,10,0,10,0
1653540117863,MATH 295,A00,087456,Staff,50,0,50,0
1653540118388,MATH 297,001,087457,Staff,998,0,999,1
1653540677813,COGS 200,A01,087991,Staff,47,0,50,3
1653540678337,COGS 201,A01,094504,Rangel; Lara M,17,0,25,8
1653540678873,COGS 203,A00,087992,Coulson; Seana M,18,0,20,2
1653540679397,COGS 210A,001,087993,Greene; Deanna Jacquelyn,9998,0,9999,1
1653540679397,COGS 210A,002,087994,Saygin; Ayse P,9999,0,9999,0
1653540679397,COGS 210A,003,087995,Xia; Haijun,9999,0,9999,0
1653540679397,COGS 210A,004,087996,Nitz; Douglas A.,9999,0,9999,0
1653540679397,COGS 210A,005,087997,Hollan; James D.,9999,0,9999,0
1653540679397,COGS 210A,006,087998,Deak; Gedeon O.,9998,0,9999,1
1653540679397,COGS 210A,007,087999,Rossano; Federico,9999,0,9999,0
1653540679927,COGS 211A,A00,088000,Coulson; Seana M,9997,0,9999,2
1653540680449,COGS 229,A00,088002,Staff,23,0,25,2
1653540680975,COGS 260,B00,094231,Staff,17,0,20,3
1653540680975,COGS 260,A00,088004,Nitz; Douglas A.,9998,0,9999,1
1653540681499,CSE 202,A00,090110,Paturi; Ramamohan,0,0,0,0
1653540681499,CSE 202,B00,090111,Paturi; Ramamohan,0,0,0,0
1653540682022,CSE 207B,A00,090112,Heninger; Nadia A,0,0,0,0
1653540682556,CSE 208,A00,094858,Micciancio; Daniele,0,0,0,0
1653540683085,CSE 210,A00,090113,Powell; Thomas Allan,0,0,0,0
1653540683608,CSE 219,A00,090898,Staff,0,0,0,0
1653540684133,CSE 221,A00,090114,Zhou; Yuan-Yuan,0,0,0,0
1653540684657,CSE 229A,A00,090115,Porter; George M,0,0,0,0
1653540685179,CSE 229C,A00,090116,Savage; Stefan,0,0,0,0
1653540685706,CSE 230,A00,090117,Jhala; Ranjit,0,0,0,0
1653540686233,CSE 232,A00,090118,Papakonstantinou; Yannis,0,0,0,0
1653540686757,CSE 239A,A00,090121,Kumar; Arun Kumar,0,0,0,0
1653540687287,CSE 239B,A00,090122,Jhala; Ranjit,0,0,0,0
1653540687811,CSE 240A,A00,090123,Zhao; Jishen,0,0,189,189
1653540688334,CSE 243A,A00,090124,Orailoglu; Alex,0,0,15,15
1653540688862,CSE 249B,A00,090125,Kahng; Andrew Byun,13,0,20,7
1653540689389,CSE 250A,A00,090126,Berg-Kirkpatrick; Taylor D,0,0,0,0
1653540689912,CSE 252A,A00,090127,Ochoa; Benjamin Lawrence,0,0,0,0
1653540690435,CSE 258,A01,090129,McAuley; Julian John,0,0,0,0
1653540690959,CSE 258R,A01,090131,McAuley; Julian John,0,0,0,0
1653540691482,CSE 274,A00,090132,Ramamoorthi; Ravi,0,0,0,0
1653540692009,CSE 276A,A00,090133,Christensen; Henrik I,0,0,0,0
1653540692533,CSE 276C,A00,090134,Christensen; Henrik I,0,0,0,0
1653540693057,CSE 290,A00,090135,Bafna; Vineet,0,0,0,0
1653540693057,CSE 290,B00,090136,Ramamoorthi; Ravi,0,0,0,0
1653540693057,CSE 290,C00,090137,Li; Tzumao,8,0,10,2
1653540693057,CSE 290,D00,090138,Zhou; Yuan-Yuan,9,0,10,1
1653540693057,CSE 290,E00,090139,Christensen; Henrik I,8,0,10,2
1653540693057,CSE 290,F00,094053,Shalev; Aaron D,0,0,0,0
1653540693583,CSE 291,A00,090140,Munyaka; Imani N. S.,0,0,0,0
1653540693583,CSE 291,B00,094880,Yu; Qi,0,0,0,0
1653540693583,CSE 291,C00,090142,Pannuto; Patrick William,0,0,0,0
1653540693583,CSE 291,D00,094881,Zhang; Yiying,0,0,0,0
1653540693583,CSE 291,E00,095118,Su; Hao,0,0,0,0
1653540694114,CSE 293,001,094905,Bafna; Vineet,9999,0,9999,0
1653540694114,CSE 293,002,094906,Bellare; Mihir,9999,0,9999,0
1653540694114,CSE 293,003,094907,Berg-Kirkpatrick; Taylor D,9999,0,9999,0
1653540694114,CSE 293,004,094908,Christensen; Henrik I,9999,0,9999,0
1653540694114,CSE 293,005,094909,Cottrell; Garrison W,9999,0,9999,0
1653540694114,CSE 293,006,094910,Deutsch; Alin Bernard,9999,0,9999,0
1653540694114,CSE 293,007,094911,Esmaeilzadeh; Hadi,9999,0,9999,0
1653540694114,CSE 293,008,094912,Freund; Yoav,9999,0,9999,0
1653540694114,CSE 293,009,094913,Griswold; William G.,9999,0,9999,0
1653540694114,CSE 293,010,094914,Gymrek; Melissa Ann,9999,0,9999,0
1653540694114,CSE 293,011,094915,Heninger; Nadia A,9999,0,9999,0
1653540694114,CSE 293,012,094916,Impagliazzo; Russell,9999,0,9999,0
1653540694114,CSE 293,013,094917,Jhala; Ranjit,9999,0,9999,0
1653540694114,CSE 293,014,094918,Kahng; Andrew Byun,9999,0,9999,0
1653540694114,CSE 293,015,094919,Kane; Daniel Mertz,9999,0,9999,0
1653540694114,CSE 293,016,094920,Kriegman; David J,9999,0,9999,0
1653540694114,CSE 293,017,094921,Kumar; Arun Kumar,9999,0,9999,0
1653540694114,CSE 293,018,094922,Lerner; Sorin,9999,0,9999,0
1653540694114,CSE 293,019,094923,Lovett; Shachar,9999,0,9999,0
1653540694114,CSE 293,020,094924,McAuley; Julian John,9999,0,9999,0
1653540694114,CSE 293,021,094925,Micciancio; Daniele,9999,0,9999,0
1653540694114,CSE 293,022,094926,Orailoglu; Alex,9999,0,9999,0
1653540694114,CSE 293,023,094927,Paturi; Ramamohan,9999,0,9999,0
1653540694114,CSE 293,024,094928,Polikarpova; Nadezhda,9999,0,9999,0
1653540694114,CSE 293,025,094929,Politz; Joseph Gibbs,9999,0,9999,0
1653540694114,CSE 293,026,094930,Porter; George M,9999,0,9999,0
1653540694114,CSE 293,027,094931,Porter; Leonard Emerson,9999,0,9999,0
1653540694114,CSE 293,028,094932,Ramamoorthi; Ravi,9999,0,9999,0
1653540694114,CSE 293,029,094933,Sahoo; Debashis,9999,0,9999,0
1653540694114,CSE 293,030,094934,Saul; Lawrence,9999,0,9999,0
1653540694114,CSE 293,031,094935,Savage; Stefan,9999,0,9999,0
1653540694114,CSE 293,032,094936,Schulze; Jurgen P.,9999,0,9999,0
1653540694114,CSE 293,033,094937,Snoeren; Alex C.,9999,0,9999,0
1653540694114,CSE 293,034,094938,Shang; Jingbo,9999,0,9999,0
1653540694114,CSE 293,035,094939,Stefan; Deian,9999,0,9999,0
1653540694114,CSE 293,036,094940,Su; Hao,9999,0,9999,0
1653540694114,CSE 293,037,094941,Swanson; Steven James,9999,0,9999,0
1653540694114,CSE 293,038,094942,Tullsen; Dean Michael,9999,0,9999,0
1653540694114,CSE 293,039,094943,Voelker; Geoffrey M.,9999,0,9999,0
1653540694114,CSE 293,040,094944,Zhao; Jishen,9999,0,9999,0
1653540694114,CSE 293,041,094945,Zhou; Yuan-Yuan,9999,0,9999,0
1653540694114,CSE 293,042,094946,Gao; Sicun,9998,0,9999,1
1653540694114,CSE 293,043,094947,Weibel; Nadir,9999,0,9999,0
1653540694114,CSE 293,044,094948,Gupta; Rajesh K.,9999,0,9999,0
1653540694637,CSE 294,A00,090143,Porter; George M,8,0,10,2
1653540695170,DSE 200,A00,091799,Staff,50,0,50,0
1653540695695,DSE 203,A00,091800,Gupta; Amarnath,30,0,30,0
1653540696217,DSE 250,A00,091801,Deutsch; Alin Bernard,30,0,30,0
1653540696743,DSE 290,A00,091802,Altintas De Callaf; Ilkay,50,0,50,0
1653540697277,ECE 200,001,091003,Antipa; Nicholas A,9999,0,9999,0
1653540697277,ECE 200,002,091004,Atanasov; Nikolay A.,9999,0,9999,0
1653540697277,ECE 200,003,091005,Bharadia; Dinesh,9999,0,9999,0
1653540697277,ECE 200,004,091006,Cheng; Chung Kuan,9999,0,9999,0
1653540697277,ECE 200,005,091007,Cosman; Pamela C.,9999,0,9999,0
1653540697277,ECE 200,006,091008,Staff,9999,0,9999,0
1653540697277,ECE 200,007,091009,Dayeh; Shadi Ahmad,9999,0,9999,0
1653540697277,ECE 200,008,091010,Fainman; Yeshaiahu,9999,0,9999,0
1653540697277,ECE 200,009,091011,Ford; Joseph Earl,9999,0,9999,0
1653540697277,ECE 200,010,091012,Franceschetti; Massimo,9999,0,9999,0
1653540697277,ECE 200,011,091013,Fullerton; Eric E,9999,0,9999,0
1653540697277,ECE 200,012,091014,Galton; Ian A,9999,0,9999,0
1653540697277,ECE 200,013,091015,Gilja; Vikash,9999,0,9999,0
1653540697277,ECE 200,014,091016,Hall; Drew A.,9999,0,9999,0
1653540697277,ECE 200,015,091017,Hsueh; Tzu-Chien,9999,0,9999,0
1653540697277,ECE 200,016,091018,Javidi; Tara,9999,0,9999,0
1653540697277,ECE 200,017,091019,Kahng; Andrew Byun,9999,0,9999,0
1653540697277,ECE 200,018,091020,Kim; Young-Han,9999,0,9999,0
1653540697277,ECE 200,019,091021,Koushanfar; Farinaz,9999,0,9999,0
1653540697277,ECE 200,020,091022,Kuzum; Duygu,9999,0,9999,0
1653540697277,ECE 200,021,091023,Le; Hanh-Phuc,9999,0,9999,0
1653540697277,ECE 200,022,091024,Lin; Bill,9999,0,9999,0
1653540697277,ECE 200,023,091025,Liu; Zhaowei,9999,0,9999,0
1653540697277,ECE 200,024,091026,Lo; Yu-Hwa,9999,0,9999,0
1653540697277,ECE 200,025,091027,Lomakin; Vitaliy,9999,0,9999,0
1653540697277,ECE 200,026,091028,Mercier; Patrick Philip,9999,0,9999,0
1653540697277,ECE 200,027,091029,Meyer; Florian,9999,0,9999,0
1653540697277,ECE 200,028,091030,Milstein; Laurence B.,9999,0,9999,0
1653540697277,ECE 200,029,091031,Mir Arabbaygi; Siavash,9999,0,9999,0
1653540697277,ECE 200,030,091032,Mookherjea; Shayan,9999,0,9999,0
1653540697277,ECE 200,031,091033,Morris; Karcher William,9999,0,9999,0
1653540697277,ECE 200,032,091034,Ng; Tse Nga,9999,0,9999,0
1653540697277,ECE 200,033,091035,Nguyen; Truong Quang,9999,0,9999,0
1653540697277,ECE 200,034,091036,Nomura; Kenji,9999,0,9999,0
1653540697277,ECE 200,035,091037,Orlitsky; Alon,9999,0,9999,0
1653540697277,ECE 200,036,091038,Pal; Piya,9999,0,9999,0
1653540697277,ECE 200,037,091039,Papen; George C.,9999,0,9999,0
1653540697277,ECE 200,038,091040,Radic; Stojan,9999,0,9999,0
1653540697277,ECE 200,039,091041,Rao; Bhaskar D.,9999,0,9999,0
1653540697277,ECE 200,040,091042,Rao; Ramesh R,9999,0,9999,0
1653540697277,ECE 200,041,091043,Rebeiz; Gabriel,9999,0,9999,0
1653540697277,ECE 200,042,091044,Sanford; John R,9999,0,9999,0
1653540697277,ECE 200,043,091045,Siegel; Paul H.,9999,0,9999,0
1653540697277,ECE 200,044,091046,Sievenpiper; Daniel F.,9999,0,9999,0
1653540697277,ECE 200,045,091047,Sworder; David D.,9999,0,9999,0
1653540697277,ECE 200,046,091048,Taur; Yuan,9999,0,9999,0
1653540697277,ECE 200,047,091049,Touri; Behrouz,9999,0,9999,0
1653540697277,ECE 200,048,091050,Trivedi; Mohan M.,9999,0,9999,0
1653540697277,ECE 200,049,091051,Vardy; Alexander,9999,0,9999,0
1653540697277,ECE 200,050,091052,Vasconcelos; Nuno,9999,0,9999,0
1653540697277,ECE 200,051,091053,Wang; Xiaolong,9999,0,9999,0
1653540697277,ECE 200,052,091054,Xie; Pengtao,9999,0,9999,0
1653540697277,ECE 200,053,091055,Yip; Michael,9999,0,9999,0
1653540697277,ECE 200,054,091056,Zeger; Kenneth A.,9999,0,9999,0
1653540697277,ECE 200,055,091057,Zhang; Xinyu,9999,0,9999,0
1653540697277,ECE 200,056,091058,Turakhia; Yatish Girish,9999,0,9999,0
1653540697277,ECE 200,057,091059,Kang; Mingu,9999,0,9999,0
1653540697277,ECE 200,058,091060,Shi; Yuanyuan,9999,0,9999,0
1653540697277,ECE 200,059,091061,Wang; Edward Jay,9999,0,9999,0
1653540697277,ECE 200,060,091062,Zheng; Yang,9999,0,9999,0
1653540697800,ECE 201,A00,095526,Lo; Yu-Hwa,0,0,0,0
1653540698322,ECE 203,A00,091065,Mercier; Patrick Philip,0,0,0,0
1653540698847,ECE 207A,A00,091605,Liu; Thomas Tao-Ming,0,0,0,0
1653540699371,ECE 212AN,A00,091068,Nomura; Kenji,0,0,0,0
1653540699898,ECE 222A,A00,091069,Rebeiz; Gabriel,0,0,0,0
1653540700422,ECE 225A,A00,091070,Orlitsky; Alon,0,0,0,0
1653540700956,ECE 230A,A00,091071,Nomura; Kenji,0,0,0,0
1653540701479,ECE 236A,A00,091072,Dayeh; Shadi Ahmad,0,0,0,0
1653540702006,ECE 238A,A00,091073,Luo; Jian,0,0,0,0
1653540702006,ECE 238A,B00,091074,Luo; Jian,0,0,0,0
1653540702529,ECE 240A,A00,091075,Radic; Stojan,0,0,0,0
1653540703055,ECE 247A,A00,091592,Shi; Lingyan,0,0,0,0
1653540703578,ECE 250,A00,091076,Touri; Behrouz,0,0,0,0
1653540704103,ECE 251C,A00,091078,Nguyen; Truong Quang,0,0,0,0
1653540704629,ECE 253,A00,091079,Cosman; Pamela C.,0,0,0,0
1653540705157,ECE 255A,A00,091080,Orlitsky; Alon,0,0,0,0
1653540705684,ECE 257A,A00,091081,Zhang; Xinyu,0,0,0,0
1653540706213,ECE 260A,A01,091084,Eldon; John,0,0,0,0
1653540706736,ECE 264C,A00,091085,Galton; Ian A,0,0,0,0
1653540707259,ECE 265C,A00,094889,Presti; Calogero Davide,0,0,0,9
1653540707805,ECE 266,A01,091087,Hall; Drew A.,0,0,0,0
1653540708859,ECE 271A,A00,091090,Vasconcelos; Nuno,0,0,0,0
1653540709382,ECE 272B,A00,091091,Sworder; David D.,0,0,0,0
1653540709919,ECE 275A,A00,091092,Meyer; Florian,0,0,0,0
1653540710444,ECE 277,A00,091093,An; Cheolhong,0,0,0,0
1653540710976,ECE 283,A00,091094,Le; Hanh-Phuc,0,0,0,0
1653540711502,ECE 284,A00,091095,Kang; Mingu,0,0,0,0
1653540711502,ECE 284,B00,091096,Wang; Edward Jay,0,0,0,0
1653540712024,ECE 285,A00,094334,Touri; Behrouz,0,0,0,0
1653540712548,ECE 289,A00,091097,Whelan; David Arthur,0,0,0,0
1653540713071,MATH 200A,A00,087414,Salehi Golsefidy; Alireza,7,0,8,1
1653540713594,MATH 202A,A00,087415,Gill; Philip E.,2,0,8,6
1653540714116,MATH 203A,A00,087416,Oprea; Dragos N.,6,0,8,2
1653540714641,MATH 204A,A00,087417,Kedlaya; Kiran S.,6,0,8,2
1653540715169,MATH 205,A00,087418,Sorensen; Claus M,6,0,8,2
1653540715695,MATH 206A,A00,087419,Izadi; Elham,7,0,8,1
1653540716219,MATH 207A,A00,087420,Mohammadi; Amir,5,0,8,3
1653540716752,MATH 208,A00,087421,Staff,9,0,10,1
1653540717278,MATH 209,A00,087422,Staff,10,0,10,0
1653540717823,MATH 218,A00,087423,Staff,10,0,10,0
1653540718356,MATH 220A,A00,087424,Novak; Jonathan I,6,0,8,2
1653540718881,MATH 231A,A00,087425,Bejenaru; Ioan,3,0,8,5
1653540719404,MATH 240A,A00,087426,Ebenfelt; Peter F,5,0,8,3
1653540719927,MATH 243,A00,087427,Staff,9,0,10,1
1653540720457,MATH 248,A00,087429,Staff,10,0,10,0
1653540720980,MATH 250A,A00,087430,Spolaor; Luca,4,0,8,4
1653540721502,MATH 257A,A00,087431,Spolaor; Luca,7,0,8,1
1653540722028,MATH 258,A00,087432,Staff,9,0,10,1
1653540722550,MATH 264A,A00,087433,Warnke; Lutz Peter,5,0,8,3
1653540723074,MATH 268,A00,087434,Staff,15,0,15,0
1653540723607,MATH 269,A00,087435,Staff,14,0,15,1
1653540724133,MATH 270A,A00,087436,Nie; Jiawang,0,0,8,8
1653540724658,MATH 272A,A00,087437,Tian; Xiaochuan,1,0,8,7
1653540725185,MATH 274,A01,087439,Cheng; Li-Tien,9,0,10,1
1653540725185,MATH 274,A02,087440,Cheng; Li-Tien,10,0,10,0
1653540725709,MATH 278A,A00,087441,Staff,8,0,10,2
1653540726230,MATH 278B,A00,087442,Staff,8,0,10,2
1653540726754,MATH 278C,A00,087443,Staff,8,0,10,2
1653540727277,MATH 280A,A00,087444,Zheng; Tianyi,0,0,8,8
1653540727802,MATH 281A,A00,087445,Bradic; Jelena,0,0,8,8
1653540728326,MATH 282A,A00,087446,Zhang; Danna,0,0,8,8
1653540728931,MATH 283,A00,087447,Tesler; Glenn,0,0,0,15
1653540729477,MATH 286,A00,087448,Kemp; Todd Aahron,5,0,8,3
1653540730000,MATH 287D,A00,087449,Bradic; Jelena,0,0,0,0
1653540730538,MATH 288,A00,087450,Staff,14,0,15,1
1653540730538,MATH 288,B00,087451,Staff,15,0,15,0
1653540730538,MATH 288,C00,087452,Staff,15,0,15,0
1653540731062,MATH 290A,A00,087453,Xu; Zhouli,6,0,8,2
1653540731595,MATH 291A,A00,087454,Xu; Zhouli,7,0,8,1
1653540732124,MATH 292,A00,087455,Staff,10,0,10,0
1653540732660,MATH 295,A00,087456,Staff,50,0,50,0
1653540733187,MATH 297,001,087457,Staff,998,0,999,1
1653541293721,COGS 200,A01,087991,Staff,47,0,50,3
1653541294252,COGS 201,A01,094504,Rangel; Lara M,17,0,25,8
1653541294788,COGS 203,A00,087992,Coulson; Seana M,18,0,20,2
1653541295311,COGS 210A,001,087993,Greene; Deanna Jacquelyn,9998,0,9999,1
1653541295311,COGS 210A,002,087994,Saygin; Ayse P,9999,0,9999,0
1653541295311,COGS 210A,003,087995,Xia; Haijun,9999,0,9999,0
1653541295311,COGS 210A,004,087996,Nitz; Douglas A.,9999,0,9999,0
1653541295311,COGS 210A,005,087997,Hollan; James D.,9999,0,9999,0
1653541295311,COGS 210A,006,087998,Deak; Gedeon O.,9998,0,9999,1
1653541295311,COGS 210A,007,087999,Rossano; Federico,9999,0,9999,0
1653541295850,COGS 211A,A00,088000,Coulson; Seana M,9997,0,9999,2
1653541296387,COGS 229,A00,088002,Staff,23,0,25,2
1653541296914,COGS 260,B00,094231,Staff,17,0,20,3
1653541296914,COGS 260,A00,088004,Nitz; Douglas A.,9998,0,9999,1
1653541297439,CSE 202,A00,090110,Paturi; Ramamohan,0,0,0,0
1653541297439,CSE 202,B00,090111,Paturi; Ramamohan,0,0,0,0
1653541297971,CSE 207B,A00,090112,Heninger; Nadia A,0,0,0,0
1653541298496,CSE 208,A00,094858,Micciancio; Daniele,0,0,0,0
1653541299018,CSE 210,A00,090113,Powell; Thomas Allan,0,0,0,0
1653541299540,CSE 219,A00,090898,Staff,0,0,0,0
1653541300063,CSE 221,A00,090114,Zhou; Yuan-Yuan,0,0,0,0
1653541300588,CSE 229A,A00,090115,Porter; George M,0,0,0,0
1653541301111,CSE 229C,A00,090116,Savage; Stefan,0,0,0,0
1653541301650,CSE 230,A00,090117,Jhala; Ranjit,0,0,0,0
1653541302173,CSE 232,A00,090118,Papakonstantinou; Yannis,0,0,0,0
1653541302704,CSE 239A,A00,090121,Kumar; Arun Kumar,0,0,0,0
1653541303227,CSE 239B,A00,090122,Jhala; Ranjit,0,0,0,0
1653541303759,CSE 240A,A00,090123,Zhao; Jishen,0,0,189,189
1653541304299,CSE 243A,A00,090124,Orailoglu; Alex,0,0,15,15
1653541304827,CSE 249B,A00,090125,Kahng; Andrew Byun,13,0,20,7
1653541305351,CSE 250A,A00,090126,Berg-Kirkpatrick; Taylor D,0,0,0,0
1653541305878,CSE 252A,A00,090127,Ochoa; Benjamin Lawrence,0,0,0,0
1653541306411,CSE 258,A01,090129,McAuley; Julian John,0,0,0,0
1653541306937,CSE 258R,A01,090131,McAuley; Julian John,0,0,0,0
1653541307466,CSE 274,A00,090132,Ramamoorthi; Ravi,0,0,0,0
1653541307990,CSE 276A,A00,090133,Christensen; Henrik I,0,0,0,0
1653541308521,CSE 276C,A00,090134,Christensen; Henrik I,0,0,0,0
1653541309052,CSE 290,A00,090135,Bafna; Vineet,0,0,0,0
1653541309052,CSE 290,B00,090136,Ramamoorthi; Ravi,0,0,0,0
1653541309052,CSE 290,C00,090137,Li; Tzumao,8,0,10,2
1653541309052,CSE 290,D00,090138,Zhou; Yuan-Yuan,9,0,10,1
1653541309052,CSE 290,E00,090139,Christensen; Henrik I,8,0,10,2
1653541309052,CSE 290,F00,094053,Shalev; Aaron D,0,0,0,0
1653541309584,CSE 291,A00,090140,Munyaka; Imani N. S.,0,0,0,0
1653541309584,CSE 291,B00,094880,Yu; Qi,0,0,0,0
1653541309584,CSE 291,C00,090142,Pannuto; Patrick William,0,0,0,0
1653541309584,CSE 291,D00,094881,Zhang; Yiying,0,0,0,0
1653541309584,CSE 291,E00,095118,Su; Hao,0,0,0,0
1653541310142,CSE 293,001,094905,Bafna; Vineet,9999,0,9999,0
1653541310142,CSE 293,002,094906,Bellare; Mihir,9999,0,9999,0
1653541310142,CSE 293,003,094907,Berg-Kirkpatrick; Taylor D,9999,0,9999,0
1653541310142,CSE 293,004,094908,Christensen; Henrik I,9999,0,9999,0
1653541310142,CSE 293,005,094909,Cottrell; Garrison W,9999,0,9999,0
1653541310142,CSE 293,006,094910,Deutsch; Alin Bernard,9999,0,9999,0
1653541310142,CSE 293,007,094911,Esmaeilzadeh; Hadi,9999,0,9999,0
1653541310142,CSE 293,008,094912,Freund; Yoav,9999,0,9999,0
1653541310142,CSE 293,009,094913,Griswold; William G.,9999,0,9999,0
1653541310142,CSE 293,010,094914,Gymrek; Melissa Ann,9999,0,9999,0
1653541310142,CSE 293,011,094915,Heninger; Nadia A,9999,0,9999,0
1653541310142,CSE 293,012,094916,Impagliazzo; Russell,9999,0,9999,0
1653541310142,CSE 293,013,094917,Jhala; Ranjit,9999,0,9999,0
1653541310142,CSE 293,014,094918,Kahng; Andrew Byun,9999,0,9999,0
1653541310142,CSE 293,015,094919,Kane; Daniel Mertz,9999,0,9999,0
1653541310142,CSE 293,016,094920,Kriegman; David J,9999,0,9999,0
1653541310142,CSE 293,017,094921,Kumar; Arun Kumar,9999,0,9999,0
1653541310142,CSE 293,018,094922,Lerner; Sorin,9999,0,9999,0
1653541310142,CSE 293,019,094923,Lovett; Shachar,9999,0,9999,0
1653541310142,CSE 293,020,094924,McAuley; Julian John,9999,0,9999,0
1653541310142,CSE 293,021,094925,Micciancio; Daniele,9999,0,9999,0
1653541310142,CSE 293,022,094926,Orailoglu; Alex,9999,0,9999,0
1653541310142,CSE 293,023,094927,Paturi; Ramamohan,9999,0,9999,0
1653541310142,CSE 293,024,094928,Polikarpova; Nadezhda,9999,0,9999,0
1653541310142,CSE 293,025,094929,Politz; Joseph Gibbs,9999,0,9999,0
1653541310142,CSE 293,026,094930,Porter; George M,9999,0,9999,0
1653541310142,CSE 293,027,094931,Porter; Leonard Emerson,9999,0,9999,0
1653541310142,CSE 293,028,094932,Ramamoorthi; Ravi,9999,0,9999,0
1653541310142,CSE 293,029,094933,Sahoo; Debashis,9999,0,9999,0
1653541310142,CSE 293,030,094934,Saul; Lawrence,9999,0,9999,0
1653541310142,CSE 293,031,094935,Savage; Stefan,9999,0,9999,0
1653541310142,CSE 293,032,094936,Schulze; Jurgen P.,9999,0,9999,0
1653541310142,CSE 293,033,094937,Snoeren; Alex C.,9999,0,9999,0
1653541310142,CSE 293,034,094938,Shang; Jingbo,9999,0,9999,0
1653541310142,CSE 293,035,094939,Stefan; Deian,9999,0,9999,0
1653541310142,CSE 293,036,094940,Su; Hao,9999,0,9999,0
1653541310142,CSE 293,037,094941,Swanson; Steven James,9999,0,9999,0
1653541310142,CSE 293,038,094942,Tullsen; Dean Michael,9999,0,9999,0
1653541310142,CSE 293,039,094943,Voelker; Geoffrey M.,9999,0,9999,0
1653541310142,CSE 293,040,094944,Zhao; Jishen,9999,0,9999,0
1653541310142,CSE 293,041,094945,Zhou; Yuan-Yuan,9999,0,9999,0
1653541310142,CSE 293,042,094946,Gao; Sicun,9998,0,9999,1
1653541310142,CSE 293,043,094947,Weibel; Nadir,9999,0,9999,0
1653541310142,CSE 293,044,094948,Gupta; Rajesh K.,9999,0,9999,0
1653541310675,CSE 294,A00,090143,Porter; George M,8,0,10,2
1653541311201,DSE 200,A00,091799,Staff,50,0,50,0
1653541311724,DSE 203,A00,091800,Gupta; Amarnath,30,0,30,0
1653541312257,DSE 250,A00,091801,Deutsch; Alin Bernard,30,0,30,0
1653541312780,DSE 290,A00,091802,Altintas De Callaf; Ilkay,50,0,50,0
1653541313320,ECE 200,001,091003,Antipa; Nicholas A,9999,0,9999,0
1653541313320,ECE 200,002,091004,Atanasov; Nikolay A.,9999,0,9999,0
1653541313320,ECE 200,003,091005,Bharadia; Dinesh,9999,0,9999,0
1653541313320,ECE 200,004,091006,Cheng; Chung Kuan,9999,0,9999,0
1653541313320,ECE 200,005,091007,Cosman; Pamela C.,9999,0,9999,0
1653541313320,ECE 200,006,091008,Staff,9999,0,9999,0
1653541313320,ECE 200,007,091009,Dayeh; Shadi Ahmad,9999,0,9999,0
1653541313320,ECE 200,008,091010,Fainman; Yeshaiahu,9999,0,9999,0
1653541313320,ECE 200,009,091011,Ford; Joseph Earl,9999,0,9999,0
1653541313320,ECE 200,010,091012,Franceschetti; Massimo,9999,0,9999,0
1653541313320,ECE 200,011,091013,Fullerton; Eric E,9999,0,9999,0
1653541313320,ECE 200,012,091014,Galton; Ian A,9999,0,9999,0
1653541313320,ECE 200,013,091015,Gilja; Vikash,9999,0,9999,0
1653541313320,ECE 200,014,091016,Hall; Drew A.,9999,0,9999,0
1653541313320,ECE 200,015,091017,Hsueh; Tzu-Chien,9999,0,9999,0
1653541313320,ECE 200,016,091018,Javidi; Tara,9999,0,9999,0
1653541313320,ECE 200,017,091019,Kahng; Andrew Byun,9999,0,9999,0
1653541313320,ECE 200,018,091020,Kim; Young-Han,9999,0,9999,0
1653541313320,ECE 200,019,091021,Koushanfar; Farinaz,9999,0,9999,0
1653541313320,ECE 200,020,091022,Kuzum; Duygu,9999,0,9999,0
1653541313320,ECE 200,021,091023,Le; Hanh-Phuc,9999,0,9999,0
1653541313320,ECE 200,022,091024,Lin; Bill,9999,0,9999,0
1653541313320,ECE 200,023,091025,Liu; Zhaowei,9999,0,9999,0
1653541313320,ECE 200,024,091026,Lo; Yu-Hwa,9999,0,9999,0
1653541313320,ECE 200,025,091027,Lomakin; Vitaliy,9999,0,9999,0
1653541313320,ECE 200,026,091028,Mercier; Patrick Philip,9999,0,9999,0
1653541313320,ECE 200,027,091029,Meyer; Florian,9999,0,9999,0
1653541313320,ECE 200,028,091030,Milstein; Laurence B.,9999,0,9999,0
1653541313320,ECE 200,029,091031,Mir Arabbaygi; Siavash,9999,0,9999,0
1653541313320,ECE 200,030,091032,Mookherjea; Shayan,9999,0,9999,0
1653541313320,ECE 200,031,091033,Morris; Karcher William,9999,0,9999,0
1653541313320,ECE 200,032,091034,Ng; Tse Nga,9999,0,9999,0
1653541313320,ECE 200,033,091035,Nguyen; Truong Quang,9999,0,9999,0
1653541313320,ECE 200,034,091036,Nomura; Kenji,9999,0,9999,0
1653541313320,ECE 200,035,091037,Orlitsky; Alon,9999,0,9999,0
1653541313320,ECE 200,036,091038,Pal; Piya,9999,0,9999,0
1653541313320,ECE 200,037,091039,Papen; George C.,9999,0,9999,0
1653541313320,ECE 200,038,091040,Radic; Stojan,9999,0,9999,0
1653541313320,ECE 200,039,091041,Rao; Bhaskar D.,9999,0,9999,0
1653541313320,ECE 200,040,091042,Rao; Ramesh R,9999,0,9999,0
1653541313320,ECE 200,041,091043,Rebeiz; Gabriel,9999,0,9999,0
1653541313320,ECE 200,042,091044,Sanford; John R,9999,0,9999,0
1653541313320,ECE 200,043,091045,Siegel; Paul H.,9999,0,9999,0
1653541313320,ECE 200,044,091046,Sievenpiper; Daniel F.,9999,0,9999,0
1653541313320,ECE 200,045,091047,Sworder; David D.,9999,0,9999,0
1653541313320,ECE 200,046,091048,Taur; Yuan,9999,0,9999,0
1653541313320,ECE 200,047,091049,Touri; Behrouz,9999,0,9999,0
1653541313320,ECE 200,048,091050,Trivedi; Mohan M.,9999,0,9999,0
1653541313320,ECE 200,049,091051,Vardy; Alexander,9999,0,9999,0
1653541313320,ECE 200,050,091052,Vasconcelos; Nuno,9999,0,9999,0
1653541313320,ECE 200,051,091053,Wang; Xiaolong,9999,0,9999,0
1653541313320,ECE 200,052,091054,Xie; Pengtao,9999,0,9999,0
1653541313320,ECE 200,053,091055,Yip; Michael,9999,0,9999,0
1653541313320,ECE 200,054,091056,Zeger; Kenneth A.,9999,0,9999,0
1653541313320,ECE 200,055,091057,Zhang; Xinyu,9999,0,9999,0
1653541313320,ECE 200,056,091058,Turakhia; Yatish Girish,9999,0,9999,0
1653541313320,ECE 200,057,091059,Kang; Mingu,9999,0,9999,0
1653541313320,ECE 200,058,091060,Shi; Yuanyuan,9999,0,9999,0
1653541313320,ECE 200,059,091061,Wang; Edward Jay,9999,0,9999,0
1653541313320,ECE 200,060,091062,Zheng; Yang,9999,0,9999,0
1653541313843,ECE 201,A00,095526,Lo; Yu-Hwa,0,0,0,0
1653541314368,ECE 203,A00,091065,Mercier; Patrick Philip,0,0,0,0
1653541314898,ECE 207A,A00,091605,Liu; Thomas Tao-Ming,0,0,0,0
1653541315431,ECE 212AN,A00,091068,Nomura; Kenji,0,0,0,0
1653541315953,ECE 222A,A00,091069,Rebeiz; Gabriel,0,0,0,0
1653541316487,ECE 225A,A00,091070,Orlitsky; Alon,0,0,0,0
1653541317104,ECE 230A,A00,091071,Nomura; Kenji,0,0,0,0
1653541317628,ECE 236A,A00,091072,Dayeh; Shadi Ahmad,0,0,0,0
1653541318162,ECE 238A,A00,091073,Luo; Jian,0,0,0,0
1653541318162,ECE 238A,B00,091074,Luo; Jian,0,0,0,0
1653541318684,ECE 240A,A00,091075,Radic; Stojan,0,0,0,0
1653541319223,ECE 247A,A00,091592,Shi; Lingyan,0,0,0,0
1653541319746,ECE 250,A00,091076,Touri; Behrouz,0,0,0,0
1653541320281,ECE 251C,A00,091078,Nguyen; Truong Quang,0,0,0,0
1653541320813,ECE 253,A00,091079,Cosman; Pamela C.,0,0,0,0
1653541321338,ECE 255A,A00,091080,Orlitsky; Alon,0,0,0,0
1653541321863,ECE 257A,A00,091081,Zhang; Xinyu,0,0,0,0
1653541322390,ECE 260A,A01,091084,Eldon; John,0,0,0,0
1653541322913,ECE 264C,A00,091085,Galton; Ian A,0,0,0,0
1653541323438,ECE 265C,A00,094889,Presti; Calogero Davide,0,0,0,9
1653541323961,ECE 266,A01,091087,Hall; Drew A.,0,0,0,0
1653541325014,ECE 271A,A00,091090,Vasconcelos; Nuno,0,0,0,0
1653541325543,ECE 272B,A00,091091,Sworder; David D.,0,0,0,0
1653541326068,ECE 275A,A00,091092,Meyer; Florian,0,0,0,0
1653541326591,ECE 277,A00,091093,An; Cheolhong,0,0,0,0
1653541327124,ECE 283,A00,091094,Le; Hanh-Phuc,0,0,0,0
1653541327651,ECE 284,A00,091095,Kang; Mingu,0,0,0,0
1653541327651,ECE 284,B00,091096,Wang; Edward Jay,0,0,0,0
1653541328174,ECE 285,A00,094334,Touri; Behrouz,0,0,0,0
1653541328707,ECE 289,A00,091097,Whelan; David Arthur,0,0,0,0
1653541329228,MATH 200A,A00,087414,Salehi Golsefidy; Alireza,7,0,8,1
1653541329751,MATH 202A,A00,087415,Gill; Philip E.,2,0,8,6
1653541330275,MATH 203A,A00,087416,Oprea; Dragos N.,6,0,8,2
1653541330799,MATH 204A,A00,087417,Kedlaya; Kiran S.,6,0,8,2
1653541331325,MATH 205,A00,087418,Sorensen; Claus M,6,0,8,2
1653541331851,MATH 206A,A00,087419,Izadi; Elham,7,0,8,1
1653541332375,MATH 207A,A00,087420,Mohammadi; Amir,5,0,8,3
1653541332900,MATH 208,A00,087421,Staff,9,0,10,1
1653541333430,MATH 209,A00,087422,Staff,10,0,10,0
1653541333965,MATH 218,A00,087423,Staff,10,0,10,0
1653541334489,MATH 220A,A00,087424,Novak; Jonathan I,6,0,8,2
1653541335018,MATH 231A,A00,087425,Bejenaru; Ioan,3,0,8,5
1653541335543,MATH 240A,A00,087426,Ebenfelt; Peter F,5,0,8,3
1653541336066,MATH 243,A00,087427,Staff,9,0,10,1
1653541336596,MATH 248,A00,087429,Staff,10,0,10,0
1653541337120,MATH 250A,A00,087430,Spolaor; Luca,4,0,8,4
1653541337650,MATH 257A,A00,087431,Spolaor; Luca,7,0,8,1
1653541338175,MATH 258,A00,087432,Staff,9,0,10,1
1653541338698,MATH 264A,A00,087433,Warnke; Lutz Peter,5,0,8,3
1653541339229,MATH 268,A00,087434,Staff,15,0,15,0
1653541339751,MATH 269,A00,087435,Staff,14,0,15,1
1653541340278,MATH 270A,A00,087436,Nie; Jiawang,0,0,8,8
1653541340806,MATH 272A,A00,087437,Tian; Xiaochuan,1,0,8,7
1653541341343,MATH 274,A01,087439,Cheng; Li-Tien,9,0,10,1
1653541341343,MATH 274,A02,087440,Cheng; Li-Tien,10,0,10,0
1653541341868,MATH 278A,A00,087441,Staff,8,0,10,2
1653541342392,MATH 278B,A00,087442,Staff,8,0,10,2
1653541342917,MATH 278C,A00,087443,Staff,8,0,10,2
1653541343440,MATH 280A,A00,087444,Zheng; Tianyi,0,0,8,8
1653541343963,MATH 281A,A00,087445,Bradic; Jelena,0,0,8,8
1653541344487,MATH 282A,A00,087446,Zhang; Danna,0,0,8,8
1653541345010,MATH 283,A00,087447,Tesler; Glenn,0,0,0,15
1653541345533,MATH 286,A00,087448,Kemp; Todd Aahron,5,0,8,3
1653541346061,MATH 287D,A00,087449,Bradic; Jelena,0,0,0,0
1653541346586,MATH 288,A00,087450,Staff,14,0,15,1
1653541346586,MATH 288,B00,087451,Staff,15,0,15,0
1653541346586,MATH 288,C00,087452,Staff,15,0,15,0
1653541347117,MATH 290A,A00,087453,Xu; Zhouli,6,0,8,2
1653541347647,MATH 291A,A00,087454,Xu; Zhouli,7,0,8,1
1653541348178,MATH 292,A00,087455,Staff,10,0,10,0
1653541348705,MATH 295,A00,087456,Staff,50,0,50,0
1653541349229,MATH 297,001,087457,Staff,998,0,999,1
1653541920010,COGS 200,A01,087991,Staff,47,0,50,3
1653541920533,COGS 201,A01,094504,Rangel; Lara M,17,0,25,8
1653541921059,COGS 203,A00,087992,Coulson; Seana M,18,0,20,2
1653541921586,COGS 210A,001,087993,Greene; Deanna Jacquelyn,9998,0,9999,1
1653541921586,COGS 210A,002,087994,Saygin; Ayse P,9999,0,9999,0
1653541921586,COGS 210A,003,087995,Xia; Haijun,9999,0,9999,0
1653541921586,COGS 210A,004,087996,Nitz; Douglas A.,9999,0,9999,0
1653541921586,COGS 210A,005,087997,Hollan; James D.,9999,0,9999,0
1653541921586,COGS 210A,006,087998,Deak; Gedeon O.,9998,0,9999,1
1653541921586,COGS 210A,007,087999,Rossano; Federico,9999,0,9999,0
1653541922107,COGS 211A,A00,088000,Coulson; Seana M,9997,0,9999,2
1653541922635,COGS 229,A00,088002,Staff,23,0,25,2
1653541923157,COGS 260,B00,094231,Staff,17,0,20,3
1653541923157,COGS 260,A00,088004,Nitz; Douglas A.,9998,0,9999,1
1653541923680,CSE 202,A00,090110,Paturi; Ramamohan,0,0,0,0
1653541923680,CSE 202,B00,090111,Paturi; Ramamohan,0,0,0,0
1653541924206,CSE 207B,A00,090112,Heninger; Nadia A,0,0,0,0
1653541924733,CSE 208,A00,094858,Micciancio; Daniele,0,0,0,0
1653541925256,CSE 210,A00,090113,Powell; Thomas Allan,0,0,0,0
1653541925780,CSE 219,A00,090898,Staff,0,0,0,0
1653541926302,CSE 221,A00,090114,Zhou; Yuan-Yuan,0,0,0,0
1653541926825,CSE 229A,A00,090115,Porter; George M,0,0,0,0
1653541927347,CSE 229C,A00,090116,Savage; Stefan,0,0,0,0
1653541927870,CSE 230,A00,090117,Jhala; Ranjit,0,0,0,0
1653541928397,CSE 232,A00,090118,Papakonstantinou; Yannis,0,0,0,0
1653541928930,CSE 239A,A00,090121,Kumar; Arun Kumar,0,0,0,0
1653541929454,CSE 239B,A00,090122,Jhala; Ranjit,0,0,0,0
1653541929987,CSE 240A,A00,090123,Zhao; Jishen,0,0,189,189
1653541930510,CSE 243A,A00,090124,Orailoglu; Alex,0,0,15,15
1653541931043,CSE 249B,A00,090125,Kahng; Andrew Byun,13,0,20,7
1653541931568,CSE 250A,A00,090126,Berg-Kirkpatrick; Taylor D,0,0,0,0
1653541932092,CSE 252A,A00,090127,Ochoa; Benjamin Lawrence,0,0,0,0
1653541932622,CSE 258,A01,090129,McAuley; Julian John,0,0,0,0
1653541933144,CSE 258R,A01,090131,McAuley; Julian John,0,0,0,0
1653541933669,CSE 274,A00,090132,Ramamoorthi; Ravi,0,0,0,0
1653541934195,CSE 276A,A00,090133,Christensen; Henrik I,0,0,0,0
1653541934719,CSE 276C,A00,090134,Christensen; Henrik I,0,0,0,0
1653541935242,CSE 290,A00,090135,Bafna; Vineet,0,0,0,0
1653541935242,CSE 290,B00,090136,Ramamoorthi; Ravi,0,0,0,0
1653541935242,CSE 290,C00,090137,Li; Tzumao,8,0,10,2
1653541935242,CSE 290,D00,090138,Zhou; Yuan-Yuan,9,0,10,1
1653541935242,CSE 290,E00,090139,Christensen; Henrik I,8,0,10,2
1653541935242,CSE 290,F00,094053,Shalev; Aaron D,0,0,0,0
1653541935765,CSE 291,A00,090140,Munyaka; Imani N. S.,0,0,0,0
1653541935765,CSE 291,B00,094880,Yu; Qi,0,0,0,0
1653541935765,CSE 291,C00,090142,Pannuto; Patrick William,0,0,0,0
1653541935765,CSE 291,D00,094881,Zhang; Yiying,0,0,0,0
1653541935765,CSE 291,E00,095118,Su; Hao,0,0,0,0
1653541936290,CSE 293,001,094905,Bafna; Vineet,9999,0,9999,0
1653541936290,CSE 293,002,094906,Bellare; Mihir,9999,0,9999,0
1653541936290,CSE 293,003,094907,Berg-Kirkpatrick; Taylor D,9999,0,9999,0
1653541936290,CSE 293,004,094908,Christensen; Henrik I,9999,0,9999,0
1653541936290,CSE 293,005,094909,Cottrell; Garrison W,9999,0,9999,0
1653541936290,CSE 293,006,094910,Deutsch; Alin Bernard,9999,0,9999,0
1653541936290,CSE 293,007,094911,Esmaeilzadeh; Hadi,9999,0,9999,0
1653541936290,CSE 293,008,094912,Freund; Yoav,9999,0,9999,0
1653541936290,CSE 293,009,094913,Griswold; William G.,9999,0,9999,0
1653541936290,CSE 293,010,094914,Gymrek; Melissa Ann,9999,0,9999,0
1653541936290,CSE 293,011,094915,Heninger; Nadia A,9999,0,9999,0
1653541936290,CSE 293,012,094916,Impagliazzo; Russell,9999,0,9999,0
1653541936290,CSE 293,013,094917,Jhala; Ranjit,9999,0,9999,0
1653541936290,CSE 293,014,094918,Kahng; Andrew Byun,9999,0,9999,0
1653541936290,CSE 293,015,094919,Kane; Daniel Mertz,9999,0,9999,0
1653541936290,CSE 293,016,094920,Kriegman; David J,9999,0,9999,0
1653541936290,CSE 293,017,094921,Kumar; Arun Kumar,9999,0,9999,0
1653541936290,CSE 293,018,094922,Lerner; Sorin,9999,0,9999,0
1653541936290,CSE 293,019,094923,Lovett; Shachar,9999,0,9999,0
1653541936290,CSE 293,020,094924,McAuley; Julian John,9999,0,9999,0
1653541936290,CSE 293,021,094925,Micciancio; Daniele,9999,0,9999,0
1653541936290,CSE 293,022,094926,Orailoglu; Alex,9999,0,9999,0
1653541936290,CSE 293,023,094927,Paturi; Ramamohan,9999,0,9999,0
1653541936290,CSE 293,024,094928,Polikarpova; Nadezhda,9999,0,9999,0
1653541936290,CSE 293,025,094929,Politz; Joseph Gibbs,9999,0,9999,0
1653541936290,CSE 293,026,094930,Porter; George M,9999,0,9999,0
1653541936290,CSE 293,027,094931,Porter; Leonard Emerson,9999,0,9999,0
1653541936290,CSE 293,028,094932,Ramamoorthi; Ravi,9999,0,9999,0
1653541936290,CSE 293,029,094933,Sahoo; Debashis,9999,0,9999,0
1653541936290,CSE 293,030,094934,Saul; Lawrence,9999,0,9999,0
1653541936290,CSE 293,031,094935,Savage; Stefan,9999,0,9999,0
1653541936290,CSE 293,032,094936,Schulze; Jurgen P.,9999,0,9999,0
1653541936290,CSE 293,033,094937,Snoeren; Alex C.,9999,0,9999,0
1653541936290,CSE 293,034,094938,Shang; Jingbo,9999,0,9999,0
1653541936290,CSE 293,035,094939,Stefan; Deian,9999,0,9999,0
1653541936290,CSE 293,036,094940,Su; Hao,9999,0,9999,0
1653541936290,CSE 293,037,094941,Swanson; Steven James,9999,0,9999,0
1653541936290,CSE 293,038,094942,Tullsen; Dean Michael,9999,0,9999,0
1653541936290,CSE 293,039,094943,Voelker; Geoffrey M.,9999,0,9999,0
1653541936290,CSE 293,040,094944,Zhao; Jishen,9999,0,9999,0
1653541936290,CSE 293,041,094945,Zhou; Yuan-Yuan,9999,0,9999,0
1653541936290,CSE 293,042,094946,Gao; Sicun,9998,0,9999,1
1653541936290,CSE 293,043,094947,Weibel; Nadir,9999,0,9999,0
1653541936290,CSE 293,044,094948,Gupta; Rajesh K.,9999,0,9999,0
1653541936813,CSE 294,A00,090143,Porter; George M,8,0,10,2
1653541937341,DSE 200,A00,091799,Staff,50,0,50,0
1653541937866,DSE 203,A00,091800,Gupta; Amarnath,30,0,30,0
1653541938390,DSE 250,A00,091801,Deutsch; Alin Bernard,30,0,30,0
1653541938916,DSE 290,A00,091802,Altintas De Callaf; Ilkay,50,0,50,0
1653541939459,ECE 200,001,091003,Antipa; Nicholas A,9999,0,9999,0
1653541939459,ECE 200,002,091004,Atanasov; Nikolay A.,9999,0,9999,0
1653541939459,ECE 200,003,091005,Bharadia; Dinesh,9999,0,9999,0
1653541939459,ECE 200,004,091006,Cheng; Chung Kuan,9999,0,9999,0
1653541939459,ECE 200,005,091007,Cosman; Pamela C.,9999,0,9999,0
1653541939459,ECE 200,006,091008,Staff,9999,0,9999,0
1653541939459,ECE 200,007,091009,Dayeh; Shadi Ahmad,9999,0,9999,0
1653541939459,ECE 200,008,091010,Fainman; Yeshaiahu,9999,0,9999,0
1653541939459,ECE 200,009,091011,Ford; Joseph Earl,9999,0,9999,0
1653541939459,ECE 200,010,091012,Franceschetti; Massimo,9999,0,9999,0
1653541939459,ECE 200,011,091013,Fullerton; Eric E,9999,0,9999,0
1653541939459,ECE 200,012,091014,Galton; Ian A,9999,0,9999,0
1653541939459,ECE 200,013,091015,Gilja; Vikash,9999,0,9999,0
1653541939459,ECE 200,014,091016,Hall; Drew A.,9999,0,9999,0
1653541939459,ECE 200,015,091017,Hsueh; Tzu-Chien,9999,0,9999,0
1653541939459,ECE 200,016,091018,Javidi; Tara,9999,0,9999,0
1653541939459,ECE 200,017,091019,Kahng; Andrew Byun,9999,0,9999,0
1653541939459,ECE 200,018,091020,Kim; Young-Han,9999,0,9999,0
1653541939459,ECE 200,019,091021,Koushanfar; Farinaz,9999,0,9999,0
1653541939459,ECE 200,020,091022,Kuzum; Duygu,9999,0,9999,0
1653541939459,ECE 200,021,091023,Le; Hanh-Phuc,9999,0,9999,0
1653541939459,ECE 200,022,091024,Lin; Bill,9999,0,9999,0
1653541939459,ECE 200,023,091025,Liu; Zhaowei,9999,0,9999,0
1653541939459,ECE 200,024,091026,Lo; Yu-Hwa,9999,0,9999,0
1653541939459,ECE 200,025,091027,Lomakin; Vitaliy,9999,0,9999,0
1653541939459,ECE 200,026,091028,Mercier; Patrick Philip,9999,0,9999,0
1653541939459,ECE 200,027,091029,Meyer; Florian,9999,0,9999,0
1653541939459,ECE 200,028,091030,Milstein; Laurence B.,9999,0,9999,0
1653541939459,ECE 200,029,091031,Mir Arabbaygi; Siavash,9999,0,9999,0
1653541939459,ECE 200,030,091032,Mookherjea; Shayan,9999,0,9999,0
1653541939459,ECE 200,031,091033,Morris; Karcher William,9999,0,9999,0
1653541939459,ECE 200,032,091034,Ng; Tse Nga,9999,0,9999,0
1653541939459,ECE 200,033,091035,Nguyen; Truong Quang,9999,0,9999,0
1653541939459,ECE 200,034,091036,Nomura; Kenji,9999,0,9999,0
1653541939459,ECE 200,035,091037,Orlitsky; Alon,9999,0,9999,0
1653541939459,ECE 200,036,091038,Pal; Piya,9999,0,9999,0
1653541939459,ECE 200,037,091039,Papen; George C.,9999,0,9999,0
1653541939459,ECE 200,038,091040,Radic; Stojan,9999,0,9999,0
1653541939459,ECE 200,039,091041,Rao; Bhaskar D.,9999,0,9999,0
1653541939459,ECE 200,040,091042,Rao; Ramesh R,9999,0,9999,0
1653541939459,ECE 200,041,091043,Rebeiz; Gabriel,9999,0,9999,0
1653541939459,ECE 200,042,091044,Sanford; John R,9999,0,9999,0
1653541939459,ECE 200,043,091045,Siegel; Paul H.,9999,0,9999,0
1653541939459,ECE 200,044,091046,Sievenpiper; Daniel F.,9999,0,9999,0
1653541939459,ECE 200,045,091047,Sworder; David D.,9999,0,9999,0
1653541939459,ECE 200,046,091048,Taur; Yuan,9999,0,9999,0
1653541939459,ECE 200,047,091049,Touri; Behrouz,9999,0,9999,0
1653541939459,ECE 200,048,091050,Trivedi; Mohan M.,9999,0,9999,0
1653541939459,ECE 200,049,091051,Vardy; Alexander,9999,0,9999,0
1653541939459,ECE 200,050,091052,Vasconcelos; Nuno,9999,0,9999,0
1653541939459,ECE 200,051,091053,Wang; Xiaolong,9999,0,9999,0
1653541939459,ECE 200,052,091054,Xie; Pengtao,9999,0,9999,0
1653541939459,ECE 200,053,091055,Yip; Michael,9999,0,9999,0
1653541939459,ECE 200,054,091056,Zeger; Kenneth A.,9999,0,9999,0
1653541939459,ECE 200,055,091057,Zhang; Xinyu,9999,0,9999,0
1653541939459,ECE 200,056,091058,Turakhia; Yatish Girish,9999,0,9999,0
1653541939459,ECE 200,057,091059,Kang; Mingu,9999,0,9999,0
1653541939459,ECE 200,058,091060,Shi; Yuanyuan,9999,0,9999,0
1653541939459,ECE 200,059,091061,Wang; Edward Jay,9999,0,9999,0
1653541939459,ECE 200,060,091062,Zheng; Yang,9999,0,9999,0
1653541939984,ECE 201,A00,095526,Lo; Yu-Hwa,0,0,0,0
1653541940508,ECE 203,A00,091065,Mercier; Patrick Philip,0,0,0,0
1653541941030,ECE 207A,A00,091605,Liu; Thomas Tao-Ming,0,0,0,0
1653541941554,ECE 212AN,A00,091068,Nomura; Kenji,0,0,0,0
1653541942078,ECE 222A,A00,091069,Rebeiz; Gabriel,0,0,0,0
1653541942613,ECE 225A,A00,091070,Orlitsky; Alon,0,0,0,0
1653541943136,ECE 230A,A00,091071,Nomura; Kenji,0,0,0,0
1653541943658,ECE 236A,A00,091072,Dayeh; Shadi Ahmad,0,0,0,0
1653541944186,ECE 238A,A00,091073,Luo; Jian,0,0,0,0
1653541944186,ECE 238A,B00,091074,Luo; Jian,0,0,0,0
1653541944715,ECE 240A,A00,091075,Radic; Stojan,0,0,0,0
1653541945250,ECE 247A,A00,091592,Shi; Lingyan,0,0,0,0
1653541945773,ECE 250,A00,091076,Touri; Behrouz,0,0,0,0
1653541946308,ECE 251C,A00,091078,Nguyen; Truong Quang,0,0,0,0
1653541946831,ECE 253,A00,091079,Cosman; Pamela C.,0,0,0,0
1653541947354,ECE 255A,A00,091080,Orlitsky; Alon,0,0,0,0
1653541947879,ECE 257A,A00,091081,Zhang; Xinyu,0,0,0,0
1653541948403,ECE 260A,A01,091084,Eldon; John,0,0,0,0
1653541948941,ECE 264C,A00,091085,Galton; Ian A,0,0,0,0
1653541949464,ECE 265C,A00,094889,Presti; Calogero Davide,0,0,0,9
1653541949988,ECE 266,A01,091087,Hall; Drew A.,0,0,0,0
1653541951038,ECE 271A,A00,091090,Vasconcelos; Nuno,0,0,0,0
1653541951565,ECE 272B,A00,091091,Sworder; David D.,0,0,0,0
1653541952088,ECE 275A,A00,091092,Meyer; Florian,0,0,0,0
1653541952613,ECE 277,A00,091093,An; Cheolhong,0,0,0,0
1653541953135,ECE 283,A00,091094,Le; Hanh-Phuc,0,0,0,0
1653541953660,ECE 284,A00,091095,Kang; Mingu,0,0,0,0
1653541953660,ECE 284,B00,091096,Wang; Edward Jay,0,0,0,0
1653541954185,ECE 285,A00,094334,Touri; Behrouz,0,0,0,0
1653541954710,ECE 289,A00,091097,Whelan; David Arthur,0,0,0,0
1653541955239,MATH 200A,A00,087414,Salehi Golsefidy; Alireza,7,0,8,1
1653541955762,MATH 202A,A00,087415,Gill; Philip E.,2,0,8,6
1653541956289,MATH 203A,A00,087416,Oprea; Dragos N.,6,0,8,2
1653541956820,MATH 204A,A00,087417,Kedlaya; Kiran S.,6,0,8,2
1653541957343,MATH 205,A00,087418,Sorensen; Claus M,6,0,8,2
1653541957865,MATH 206A,A00,087419,Izadi; Elham,7,0,8,1
1653541958395,MATH 207A,A00,087420,Mohammadi; Amir,5,0,8,3
1653541958916,MATH 208,A00,087421,Staff,9,0,10,1
1653541959439,MATH 209,A00,087422,Staff,10,0,10,0
1653541959964,MATH 218,A00,087423,Staff,10,0,10,0
1653541960492,MATH 220A,A00,087424,Novak; Jonathan I,6,0,8,2
1653541961014,MATH 231A,A00,087425,Bejenaru; Ioan,3,0,8,5
1653541961537,MATH 240A,A00,087426,Ebenfelt; Peter F,5,0,8,3
1653541962059,MATH 243,A00,087427,Staff,9,0,10,1
1653541962581,MATH 248,A00,087429,Staff,10,0,10,0
1653541963115,MATH 250A,A00,087430,Spolaor; Luca,4,0,8,4
1653541963639,MATH 257A,A00,087431,Spolaor; Luca,7,0,8,1
1653541964171,MATH 258,A00,087432,Staff,9,0,10,1
1653541964695,MATH 264A,A00,087433,Warnke; Lutz Peter,5,0,8,3
1653541965217,MATH 268,A00,087434,Staff,15,0,15,0
1653541965739,MATH 269,A00,087435,Staff,14,0,15,1
1653541966261,MATH 270A,A00,087436,Nie; Jiawang,0,0,8,8
1653541966784,MATH 272A,A00,087437,Tian; Xiaochuan,1,0,8,7
1653541967311,MATH 274,A01,087439,Cheng; Li-Tien,9,0,10,1
1653541967311,MATH 274,A02,087440,Cheng; Li-Tien,10,0,10,0
1653541967834,MATH 278A,A00,087441,Staff,8,0,10,2
1653541968447,MATH 278B,A00,087442,Staff,8,0,10,2
1653541968969,MATH 278C,A00,087443,Staff,8,0,10,2
1653541969492,MATH 280A,A00,087444,Zheng; Tianyi,0,0,8,8
1653541970015,MATH 281A,A00,087445,Bradic; Jelena,0,0,8,8
1653541970538,MATH 282A,A00,087446,Zhang; Danna,0,0,8,8
1653541971064,MATH 283,A00,087447,Tesler; Glenn,0,0,0,15
1653541971587,MATH 286,A00,087448,Kemp; Todd Aahron,5,0,8,3
1653541972114,MATH 287D,A00,087449,Bradic; Jelena,0,0,0,0
1653541972636,MATH 288,A00,087450,Staff,14,0,15,1
1653541972636,MATH 288,B00,087451,Staff,15,0,15,0
1653541972636,MATH 288,C00,087452,Staff,15,0,15,0
1653541973160,MATH 290A,A00,087453,Xu; Zhouli,6,0,8,2
1653541973683,MATH 291A,A00,087454,Xu; Zhouli,7,0,8,1
1653541974204,MATH 292,A00,087455,Staff,10,0,10,0
1653541974733,MATH 295,A00,087456,Staff,50,0,50,0
1653541975263,MATH 297,001,087457,Staff,998,0,999,1
1653542535688,COGS 200,A01,087991,Staff,47,0,50,3
1653542536211,COGS 201,A01,094504,Rangel; Lara M,17,0,25,8
1653542536733,COGS 203,A00,087992,Coulson; Seana M,18,0,20,2
1653542537257,COGS 210A,001,087993,Greene; Deanna Jacquelyn,9998,0,9999,1
1653542537257,COGS 210A,002,087994,Saygin; Ayse P,9999,0,9999,0
1653542537257,COGS 210A,003,087995,Xia; Haijun,9999,0,9999,0
1653542537257,COGS 210A,004,087996,Nitz; Douglas A.,9999,0,9999,0
1653542537257,COGS 210A,005,087997,Hollan; James D.,9999,0,9999,0
1653542537257,COGS 210A,006,087998,Deak; Gedeon O.,9998,0,9999,1
1653542537257,COGS 210A,007,087999,Rossano; Federico,9999,0,9999,0
1653542537780,COGS 211A,A00,088000,Coulson; Seana M,9997,0,9999,2
1653542538303,COGS 229,A00,088002,Staff,23,0,25,2
1653542538829,COGS 260,B00,094231,Staff,17,0,20,3
1653542538829,COGS 260,A00,088004,Nitz; Douglas A.,9998,0,9999,1
1653542539354,CSE 202,A00,090110,Paturi; Ramamohan,0,0,0,0
1653542539354,CSE 202,B00,090111,Paturi; Ramamohan,0,0,0,0
1653542539880,CSE 207B,A00,090112,Heninger; Nadia A,0,0,0,0
1653542540402,CSE 208,A00,094858,Micciancio; Daniele,0,0,0,0
1653542540929,CSE 210,A00,090113,Powell; Thomas Allan,0,0,0,0
1653542541459,CSE 219,A00,090898,Staff,0,0,0,0
1653542541982,CSE 221,A00,090114,Zhou; Yuan-Yuan,0,0,0,0
1653542542505,CSE 229A,A00,090115,Porter; George M,0,0,0,0
1653542543026,CSE 229C,A00,090116,Savage; Stefan,0,0,0,0
1653542543548,CSE 230,A00,090117,Jhala; Ranjit,0,0,0,0
1653542544075,CSE 232,A00,090118,Papakonstantinou; Yannis,0,0,0,0
1653542544599,CSE 239A,A00,090121,Kumar; Arun Kumar,0,0,0,0
1653542545147,CSE 239B,A00,090122,Jhala; Ranjit,0,0,0,0
1653542545672,CSE 240A,A00,090123,Zhao; Jishen,0,0,189,189
1653542546206,CSE 243A,A00,090124,Orailoglu; Alex,0,0,15,15
1653542546731,CSE 249B,A00,090125,Kahng; Andrew Byun,13,0,20,7
1653542547260,CSE 250A,A00,090126,Berg-Kirkpatrick; Taylor D,0,0,0,0
1653542547785,CSE 252A,A00,090127,Ochoa; Benjamin Lawrence,0,0,0,0
1653542548307,CSE 258,A01,090129,McAuley; Julian John,0,0,0,0
1653542548831,CSE 258R,A01,090131,McAuley; Julian John,0,0,0,0
1653542549357,CSE 274,A00,090132,Ramamoorthi; Ravi,0,0,0,0
1653542549880,CSE 276A,A00,090133,Christensen; Henrik I,0,0,0,0
1653542550402,CSE 276C,A00,090134,Christensen; Henrik I,0,0,0,0
1653542550926,CSE 290,A00,090135,Bafna; Vineet,0,0,0,0
1653542550926,CSE 290,B00,090136,Ramamoorthi; Ravi,0,0,0,0
1653542550926,CSE 290,C00,090137,Li; Tzumao,8,0,10,2
1653542550926,CSE 290,D00,090138,Zhou; Yuan-Yuan,9,0,10,1
1653542550926,CSE 290,E00,090139,Christensen; Henrik I,8,0,10,2
1653542550926,CSE 290,F00,094053,Shalev; Aaron D,0,0,0,0
1653542551455,CSE 291,A00,090140,Munyaka; Imani N. S.,0,0,0,0
1653542551455,CSE 291,B00,094880,Yu; Qi,0,0,0,0
1653542551455,CSE 291,C00,090142,Pannuto; Patrick William,0,0,0,0
1653542551455,CSE 291,D00,094881,Zhang; Yiying,0,0,0,0
1653542551455,CSE 291,E00,095118,Su; Hao,0,0,0,0
1653542551980,CSE 293,001,094905,Bafna; Vineet,9999,0,9999,0
1653542551980,CSE 293,002,094906,Bellare; Mihir,9999,0,9999,0
1653542551980,CSE 293,003,094907,Berg-Kirkpatrick; Taylor D,9999,0,9999,0
1653542551980,CSE 293,004,094908,Christensen; Henrik I,9999,0,9999,0
1653542551980,CSE 293,005,094909,Cottrell; Garrison W,9999,0,9999,0
1653542551980,CSE 293,006,094910,Deutsch; Alin Bernard,9999,0,9999,0
1653542551980,CSE 293,007,094911,Esmaeilzadeh; Hadi,9999,0,9999,0
1653542551980,CSE 293,008,094912,Freund; Yoav,9999,0,9999,0
1653542551980,CSE 293,009,094913,Griswold; William G.,9999,0,9999,0
1653542551980,CSE 293,010,094914,Gymrek; Melissa Ann,9999,0,9999,0
1653542551980,CSE 293,011,094915,Heninger; Nadia A,9999,0,9999,0
1653542551980,CSE 293,012,094916,Impagliazzo; Russell,9999,0,9999,0
1653542551980,CSE 293,013,094917,Jhala; Ranjit,9999,0,9999,0
1653542551980,CSE 293,014,094918,Kahng; Andrew Byun,9999,0,9999,0
1653542551980,CSE 293,015,094919,Kane; Daniel Mertz,9999,0,9999,0
1653542551980,CSE 293,016,094920,Kriegman; David J,9999,0,9999,0
1653542551980,CSE 293,017,094921,Kumar; Arun Kumar,9999,0,9999,0
1653542551980,CSE 293,018,094922,Lerner; Sorin,9999,0,9999,0
1653542551980,CSE 293,019,094923,Lovett; Shachar,9999,0,9999,0
1653542551980,CSE 293,020,094924,McAuley; Julian John,9999,0,9999,0
1653542551980,CSE 293,021,094925,Micciancio; Daniele,9999,0,9999,0
1653542551980,CSE 293,022,094926,Orailoglu; Alex,9999,0,9999,0
1653542551980,CSE 293,023,094927,Paturi; Ramamohan,9999,0,9999,0
1653542551980,CSE 293,024,094928,Polikarpova; Nadezhda,9999,0,9999,0
1653542551980,CSE 293,025,094929,Politz; Joseph Gibbs,9999,0,9999,0
1653542551980,CSE 293,026,094930,Porter; George M,9999,0,9999,0
1653542551980,CSE 293,027,094931,Porter; Leonard Emerson,9999,0,9999,0
1653542551980,CSE 293,028,094932,Ramamoorthi; Ravi,9999,0,9999,0
1653542551980,CSE 293,029,094933,Sahoo; Debashis,9999,0,9999,0
1653542551980,CSE 293,030,094934,Saul; Lawrence,9999,0,9999,0
1653542551980,CSE 293,031,094935,Savage; Stefan,9999,0,9999,0
1653542551980,CSE 293,032,094936,Schulze; Jurgen P.,9999,0,9999,0
1653542551980,CSE 293,033,094937,Snoeren; Alex C.,9999,0,9999,0
1653542551980,CSE 293,034,094938,Shang; Jingbo,9999,0,9999,0
1653542551980,CSE 293,035,094939,Stefan; Deian,9999,0,9999,0
1653542551980,CSE 293,036,094940,Su; Hao,9999,0,9999,0
1653542551980,CSE 293,037,094941,Swanson; Steven James,9999,0,9999,0
1653542551980,CSE 293,038,094942,Tullsen; Dean Michael,9999,0,9999,0
1653542551980,CSE 293,039,094943,Voelker; Geoffrey M.,9999,0,9999,0
1653542551980,CSE 293,040,094944,Zhao; Jishen,9999,0,9999,0
1653542551980,CSE 293,041,094945,Zhou; Yuan-Yuan,9999,0,9999,0
1653542551980,CSE 293,042,094946,Gao; Sicun,9998,0,9999,1
1653542551980,CSE 293,043,094947,Weibel; Nadir,9999,0,9999,0
1653542551980,CSE 293,044,094948,Gupta; Rajesh K.,9999,0,9999,0
1653542552506,CSE 294,A00,090143,Porter; George M,8,0,10,2
1653542553037,DSE 200,A00,091799,Staff,50,0,50,0
1653542553560,DSE 203,A00,091800,Gupta; Amarnath,30,0,30,0
1653542554085,DSE 250,A00,091801,Deutsch; Alin Bernard,30,0,30,0
1653542554607,DSE 290,A00,091802,Altintas De Callaf; Ilkay,50,0,50,0
1653542555168,ECE 200,001,091003,Antipa; Nicholas A,9999,0,9999,0
1653542555168,ECE 200,002,091004,Atanasov; Nikolay A.,9999,0,9999,0
1653542555168,ECE 200,003,091005,Bharadia; Dinesh,9999,0,9999,0
1653542555168,ECE 200,004,091006,Cheng; Chung Kuan,9999,0,9999,0
1653542555168,ECE 200,005,091007,Cosman; Pamela C.,9999,0,9999,0
1653542555168,ECE 200,006,091008,Staff,9999,0,9999,0
1653542555168,ECE 200,007,091009,Dayeh; Shadi Ahmad,9999,0,9999,0
1653542555168,ECE 200,008,091010,Fainman; Yeshaiahu,9999,0,9999,0
1653542555168,ECE 200,009,091011,Ford; Joseph Earl,9999,0,9999,0
1653542555168,ECE 200,010,091012,Franceschetti; Massimo,9999,0,9999,0
1653542555168,ECE 200,011,091013,Fullerton; Eric E,9999,0,9999,0
1653542555168,ECE 200,012,091014,Galton; Ian A,9999,0,9999,0
1653542555168,ECE 200,013,091015,Gilja; Vikash,9999,0,9999,0
1653542555168,ECE 200,014,091016,Hall; Drew A.,9999,0,9999,0
1653542555168,ECE 200,015,091017,Hsueh; Tzu-Chien,9999,0,9999,0
1653542555168,ECE 200,016,091018,Javidi; Tara,9999,0,9999,0
1653542555168,ECE 200,017,091019,Kahng; Andrew Byun,9999,0,9999,0
1653542555168,ECE 200,018,091020,Kim; Young-Han,9999,0,9999,0
1653542555168,ECE 200,019,091021,Koushanfar; Farinaz,9999,0,9999,0
1653542555168,ECE 200,020,091022,Kuzum; Duygu,9999,0,9999,0
1653542555168,ECE 200,021,091023,Le; Hanh-Phuc,9999,0,9999,0
1653542555168,ECE 200,022,091024,Lin; Bill,9999,0,9999,0
1653542555168,ECE 200,023,091025,Liu; Zhaowei,9999,0,9999,0
1653542555168,ECE 200,024,091026,Lo; Yu-Hwa,9999,0,9999,0
1653542555168,ECE 200,025,091027,Lomakin; Vitaliy,9999,0,9999,0
1653542555168,ECE 200,026,091028,Mercier; Patrick Philip,9999,0,9999,0
1653542555168,ECE 200,027,091029,Meyer; Florian,9999,0,9999,0
1653542555168,ECE 200,028,091030,Milstein; Laurence B.,9999,0,9999,0
1653542555168,ECE 200,029,091031,Mir Arabbaygi; Siavash,9999,0,9999,0
1653542555168,ECE 200,030,091032,Mookherjea; Shayan,9999,0,9999,0
1653542555168,ECE 200,031,091033,Morris; Karcher William,9999,0,9999,0
1653542555168,ECE 200,032,091034,Ng; Tse Nga,9999,0,9999,0
1653542555168,ECE 200,033,091035,Nguyen; Truong Quang,9999,0,9999,0
1653542555168,ECE 200,034,091036,Nomura; Kenji,9999,0,9999,0
1653542555168,ECE 200,035,091037,Orlitsky; Alon,9999,0,9999,0
1653542555168,ECE 200,036,091038,Pal; Piya,9999,0,9999,0
1653542555168,ECE 200,037,091039,Papen; George C.,9999,0,9999,0
1653542555168,ECE 200,038,091040,Radic; Stojan,9999,0,9999,0
1653542555168,ECE 200,039,091041,Rao; Bhaskar D.,9999,0,9999,0
1653542555168,ECE 200,040,091042,Rao; Ramesh R,9999,0,9999,0
1653542555168,ECE 200,041,091043,Rebeiz; Gabriel,9999,0,9999,0
1653542555168,ECE 200,042,091044,Sanford; John R,9999,0,9999,0
1653542555168,ECE 200,043,091045,Siegel; Paul H.,9999,0,9999,0
1653542555168,ECE 200,044,091046,Sievenpiper; Daniel F.,9999,0,9999,0
1653542555168,ECE 200,045,091047,Sworder; David D.,9999,0,9999,0
1653542555168,ECE 200,046,091048,Taur; Yuan,9999,0,9999,0
1653542555168,ECE 200,047,091049,Touri; Behrouz,9999,0,9999,0
1653542555168,ECE 200,048,091050,Trivedi; Mohan M.,9999,0,9999,0
1653542555168,ECE 200,049,091051,Vardy; Alexander,9999,0,9999,0
1653542555168,ECE 200,050,091052,Vasconcelos; Nuno,9999,0,9999,0
1653542555168,ECE 200,051,091053,Wang; Xiaolong,9999,0,9999,0
1653542555168,ECE 200,052,091054,Xie; Pengtao,9999,0,9999,0
1653542555168,ECE 200,053,091055,Yip; Michael,9999,0,9999,0
1653542555168,ECE 200,054,091056,Zeger; Kenneth A.,9999,0,9999,0
1653542555168,ECE 200,055,091057,Zhang; Xinyu,9999,0,9999,0
1653542555168,ECE 200,056,091058,Turakhia; Yatish Girish,9999,0,9999,0
1653542555168,ECE 200,057,091059,Kang; Mingu,9999,0,9999,0
1653542555168,ECE 200,058,091060,Shi; Yuanyuan,9999,0,9999,0
1653542555168,ECE 200,059,091061,Wang; Edward Jay,9999,0,9999,0
1653542555168,ECE 200,060,091062,Zheng; Yang,9999,0,9999,0
1653542555694,ECE 201,A00,095526,Lo; Yu-Hwa,0,0,0,0
1653542556291,ECE 203,A00,091065,Mercier; Patrick Philip,0,0,0,0
1653542556826,ECE 207A,A00,091605,Liu; Thomas Tao-Ming,0,0,0,0
1653542557348,ECE 212AN,A00,091068,Nomura; Kenji,0,0,0,0
1653542557871,ECE 222A,A00,091069,Rebeiz; Gabriel,0,0,0,0
1653542558394,ECE 225A,A00,091070,Orlitsky; Alon,0,0,0,0
1653542558926,ECE 230A,A00,091071,Nomura; Kenji,0,0,0,0
1653542559448,ECE 236A,A00,091072,Dayeh; Shadi Ahmad,0,0,0,0
1653542559979,ECE 238A,A00,091073,Luo; Jian,0,0,0,0
1653542559979,ECE 238A,B00,091074,Luo; Jian,0,0,0,0
1653542560502,ECE 240A,A00,091075,Radic; Stojan,0,0,0,0
1653542561024,ECE 247A,A00,091592,Shi; Lingyan,0,0,0,0
1653542561603,ECE 250,A00,091076,Touri; Behrouz,0,0,0,0
1653542562124,ECE 251C,A00,091078,Nguyen; Truong Quang,0,0,0,0
1653542562652,ECE 253,A00,091079,Cosman; Pamela C.,0,0,0,0
1653542563177,ECE 255A,A00,091080,Orlitsky; Alon,0,0,0,0
1653542563700,ECE 257A,A00,091081,Zhang; Xinyu,0,0,0,0
1653542564224,ECE 260A,A01,091084,Eldon; John,0,0,0,0
1653542564752,ECE 264C,A00,091085,Galton; Ian A,0,0,0,0
1653542565276,ECE 265C,A00,094889,Presti; Calogero Davide,0,0,0,9
1653542565804,ECE 266,A01,091087,Hall; Drew A.,0,0,0,0
1653542566849,ECE 271A,A00,091090,Vasconcelos; Nuno,0,0,0,0
1653542567380,ECE 272B,A00,091091,Sworder; David D.,0,0,0,0
1653542567906,ECE 275A,A00,091092,Meyer; Florian,0,0,0,0
1653542568429,ECE 277,A00,091093,An; Cheolhong,0,0,0,0
1653542568962,ECE 283,A00,091094,Le; Hanh-Phuc,0,0,0,0
1653542569484,ECE 284,A00,091095,Kang; Mingu,0,0,0,0
1653542569484,ECE 284,B00,091096,Wang; Edward Jay,0,0,0,0
1653542570006,ECE 285,A00,094334,Touri; Behrouz,0,0,0,0
1653542570528,ECE 289,A00,091097,Whelan; David Arthur,0,0,0,0
1653542571060,MATH 200A,A00,087414,Salehi Golsefidy; Alireza,7,0,8,1
1653542571582,MATH 202A,A00,087415,Gill; Philip E.,2,0,8,6
1653542572105,MATH 203A,A00,087416,Oprea; Dragos N.,6,0,8,2
1653542572629,MATH 204A,A00,087417,Kedlaya; Kiran S.,6,0,8,2
1653542573156,MATH 205,A00,087418,Sorensen; Claus M,6,0,8,2
1653542573680,MATH 206A,A00,087419,Izadi; Elham,7,0,8,1
1653542574203,MATH 207A,A00,087420,Mohammadi; Amir,5,0,8,3
1653542574726,MATH 208,A00,087421,Staff,9,0,10,1
1653542575257,MATH 209,A00,087422,Staff,10,0,10,0
1653542575784,MATH 218,A00,087423,Staff,10,0,10,0
1653542576307,MATH 220A,A00,087424,Novak; Jonathan I,6,0,8,2
1653542576830,MATH 231A,A00,087425,Bejenaru; Ioan,3,0,8,5
1653542577352,MATH 240A,A00,087426,Ebenfelt; Peter F,5,0,8,3
1653542577878,MATH 243,A00,087427,Staff,9,0,10,1
1653542578404,MATH 248,A00,087429,Staff,10,0,10,0
1653542578927,MATH 250A,A00,087430,Spolaor; Luca,4,0,8,4
1653542579454,MATH 257A,A00,087431,Spolaor; Luca,7,0,8,1
1653542579977,MATH 258,A00,087432,Staff,9,0,10,1
1653542580503,MATH 264A,A00,087433,Warnke; Lutz Peter,5,0,8,3
1653542581029,MATH 268,A00,087434,Staff,15,0,15,0
1653542581552,MATH 269,A00,087435,Staff,14,0,15,1
1653542582074,MATH 270A,A00,087436,Nie; Jiawang,0,0,8,8
1653542582597,MATH 272A,A00,087437,Tian; Xiaochuan,1,0,8,7
1653542583119,MATH 274,A01,087439,Cheng; Li-Tien,9,0,10,1
1653542583119,MATH 274,A02,087440,Cheng; Li-Tien,10,0,10,0
1653542583645,MATH 278A,A00,087441,Staff,8,0,10,2
1653542584171,MATH 278B,A00,087442,Staff,8,0,10,2
1653542584696,MATH 278C,A00,087443,Staff,8,0,10,2
1653542585220,MATH 280A,A00,087444,Zheng; Tianyi,0,0,8,8
1653542585751,MATH 281A,A00,087445,Bradic; Jelena,0,0,8,8
1653542586276,MATH 282A,A00,087446,Zhang; Danna,0,0,8,8
1653542586802,MATH 283,A00,087447,Tesler; Glenn,0,0,0,15
1653542587324,MATH 286,A00,087448,Kemp; Todd Aahron,5,0,8,3
1653542587849,MATH 287D,A00,087449,Bradic; Jelena,0,0,0,0
1653542588378,MATH 288,A00,087450,Staff,14,0,15,1
1653542588378,MATH 288,B00,087451,Staff,15,0,15,0
1653542588378,MATH 288,C00,087452,Staff,15,0,15,0
1653542588915,MATH 290A,A00,087453,Xu; Zhouli,6,0,8,2
1653542589438,MATH 291A,A00,087454,Xu; Zhouli,7,0,8,1
1653542589959,MATH 292,A00,087455,Staff,10,0,10,0
1653542590484,MATH 295,A00,087456,Staff,50,0,50,0
1653542591010,MATH 297,001,087457,Staff,998,0,999,1
1653543150799,COGS 200,A01,087991,Staff,47,0,50,3
1653543151322,COGS 201,A01,094504,Rangel; Lara M,17,0,25,8
1653543151844,COGS 203,A00,087992,Coulson; Seana M,18,0,20,2
1653543152369,COGS 210A,001,087993,Greene; Deanna Jacquelyn,9998,0,9999,1
1653543152369,COGS 210A,002,087994,Saygin; Ayse P,9999,0,9999,0
1653543152369,COGS 210A,003,087995,Xia; Haijun,9999,0,9999,0
1653543152369,COGS 210A,004,087996,Nitz; Douglas A.,9999,0,9999,0
1653543152369,COGS 210A,005,087997,Hollan; James D.,9999,0,9999,0
1653543152369,COGS 210A,006,087998,Deak; Gedeon O.,9998,0,9999,1
1653543152369,COGS 210A,007,087999,Rossano; Federico,9999,0,9999,0
1653543152892,COGS 211A,A00,088000,Coulson; Seana M,9997,0,9999,2
1653543153415,COGS 229,A00,088002,Staff,23,0,25,2
1653543153940,COGS 260,B00,094231,Staff,17,0,20,3
1653543153940,COGS 260,A00,088004,Nitz; Douglas A.,9998,0,9999,1
1653543154467,CSE 202,A00,090110,Paturi; Ramamohan,0,0,0,0
1653543154467,CSE 202,B00,090111,Paturi; Ramamohan,0,0,0,0
1653543154992,CSE 207B,A00,090112,Heninger; Nadia A,0,0,0,0
1653543155522,CSE 208,A00,094858,Micciancio; Daniele,0,0,0,0
1653543156045,CSE 210,A00,090113,Powell; Thomas Allan,0,0,0,0
1653543156570,CSE 219,A00,090898,Staff,0,0,0,0
1653543157097,CSE 221,A00,090114,Zhou; Yuan-Yuan,0,0,0,0
1653543157621,CSE 229A,A00,090115,Porter; George M,0,0,0,0
1653543158143,CSE 229C,A00,090116,Savage; Stefan,0,0,0,0
1653543158665,CSE 230,A00,090117,Jhala; Ranjit,0,0,0,0
1653543159186,CSE 232,A00,090118,Papakonstantinou; Yannis,0,0,0,0
1653543159710,CSE 239A,A00,090121,Kumar; Arun Kumar,0,0,0,0
1653543160236,CSE 239B,A00,090122,Jhala; Ranjit,0,0,0,0
1653543160761,CSE 240A,A00,090123,Zhao; Jishen,0,0,189,189
1653543161289,CSE 243A,A00,090124,Orailoglu; Alex,0,0,15,15
1653543161820,CSE 249B,A00,090125,Kahng; Andrew Byun,13,0,20,7
1653543162347,CSE 250A,A00,090126,Berg-Kirkpatrick; Taylor D,0,0,0,0
1653543162877,CSE 252A,A00,090127,Ochoa; Benjamin Lawrence,0,0,0,0
1653543163405,CSE 258,A01,090129,McAuley; Julian John,0,0,0,0
1653543163928,CSE 258R,A01,090131,McAuley; Julian John,0,0,0,0
1653543164452,CSE 274,A00,090132,Ramamoorthi; Ravi,0,0,0,0
1653543164974,CSE 276A,A00,090133,Christensen; Henrik I,0,0,0,0
1653543165500,CSE 276C,A00,090134,Christensen; Henrik I,0,0,0,0
1653543166035,CSE 290,A00,090135,Bafna; Vineet,0,0,0,0
1653543166035,CSE 290,B00,090136,Ramamoorthi; Ravi,0,0,0,0
1653543166035,CSE 290,C00,090137,Li; Tzumao,8,0,10,2
1653543166035,CSE 290,D00,090138,Zhou; Yuan-Yuan,9,0,10,1
1653543166035,CSE 290,E00,090139,Christensen; Henrik I,8,0,10,2
1653543166035,CSE 290,F00,094053,Shalev; Aaron D,0,0,0,0
1653543166559,CSE 291,A00,090140,Munyaka; Imani N. S.,0,0,0,0
1653543166559,CSE 291,B00,094880,Yu; Qi,0,0,0,0
1653543166559,CSE 291,C00,090142,Pannuto; Patrick William,0,0,0,0
1653543166559,CSE 291,D00,094881,Zhang; Yiying,0,0,0,0
1653543166559,CSE 291,E00,095118,Su; Hao,0,0,0,0
1653543167086,CSE 293,001,094905,Bafna; Vineet,9999,0,9999,0
1653543167086,CSE 293,002,094906,Bellare; Mihir,9999,0,9999,0
1653543167086,CSE 293,003,094907,Berg-Kirkpatrick; Taylor D,9999,0,9999,0
1653543167086,CSE 293,004,094908,Christensen; Henrik I,9999,0,9999,0
1653543167086,CSE 293,005,094909,Cottrell; Garrison W,9999,0,9999,0
1653543167086,CSE 293,006,094910,Deutsch; Alin Bernard,9999,0,9999,0
1653543167086,CSE 293,007,094911,Esmaeilzadeh; Hadi,9999,0,9999,0
1653543167086,CSE 293,008,094912,Freund; Yoav,9999,0,9999,0
1653543167086,CSE 293,009,094913,Griswold; William G.,9999,0,9999,0
1653543167086,CSE 293,010,094914,Gymrek; Melissa Ann,9999,0,9999,0
1653543167086,CSE 293,011,094915,Heninger; Nadia A,9999,0,9999,0
1653543167086,CSE 293,012,094916,Impagliazzo; Russell,9999,0,9999,0
1653543167086,CSE 293,013,094917,Jhala; Ranjit,9999,0,9999,0
1653543167086,CSE 293,014,094918,Kahng; Andrew Byun,9999,0,9999,0
1653543167086,CSE 293,015,094919,Kane; Daniel Mertz,9999,0,9999,0
1653543167086,CSE 293,016,094920,Kriegman; David J,9999,0,9999,0
1653543167086,CSE 293,017,094921,Kumar; Arun Kumar,9999,0,9999,0
1653543167086,CSE 293,018,094922,Lerner; Sorin,9999,0,9999,0
1653543167086,CSE 293,019,094923,Lovett; Shachar,9999,0,9999,0
1653543167086,CSE 293,020,094924,McAuley; Julian John,9999,0,9999,0
1653543167086,CSE 293,021,094925,Micciancio; Daniele,9999,0,9999,0
1653543167086,CSE 293,022,094926,Orailoglu; Alex,9999,0,9999,0
1653543167086,CSE 293,023,094927,Paturi; Ramamohan,9999,0,9999,0
1653543167086,CSE 293,024,094928,Polikarpova; Nadezhda,9999,0,9999,0
1653543167086,CSE 293,025,094929,Politz; Joseph Gibbs,9999,0,9999,0
1653543167086,CSE 293,026,094930,Porter; George M,9999,0,9999,0
1653543167086,CSE 293,027,094931,Porter; Leonard Emerson,9999,0,9999,0
1653543167086,CSE 293,028,094932,Ramamoorthi; Ravi,9999,0,9999,0
1653543167086,CSE 293,029,094933,Sahoo; Debashis,9999,0,9999,0
1653543167086,CSE 293,030,094934,Saul; Lawrence,9999,0,9999,0
1653543167086,CSE 293,031,094935,Savage; Stefan,9999,0,9999,0
1653543167086,CSE 293,032,094936,Schulze; Jurgen P.,9999,0,9999,0
1653543167086,CSE 293,033,094937,Snoeren; Alex C.,9999,0,9999,0
1653543167086,CSE 293,034,094938,Shang; Jingbo,9999,0,9999,0
1653543167086,CSE 293,035,094939,Stefan; Deian,9999,0,9999,0
1653543167086,CSE 293,036,094940,Su; Hao,9999,0,9999,0
1653543167086,CSE 293,037,094941,Swanson; Steven James,9999,0,9999,0
1653543167086,CSE 293,038,094942,Tullsen; Dean Michael,9999,0,9999,0
1653543167086,CSE 293,039,094943,Voelker; Geoffrey M.,9999,0,9999,0
1653543167086,CSE 293,040,094944,Zhao; Jishen,9999,0,9999,0
1653543167086,CSE 293,041,094945,Zhou; Yuan-Yuan,9999,0,9999,0
1653543167086,CSE 293,042,094946,Gao; Sicun,9998,0,9999,1
1653543167086,CSE 293,043,094947,Weibel; Nadir,9999,0,9999,0
1653543167086,CSE 293,044,094948,Gupta; Rajesh K.,9999,0,9999,0
1653543167607,CSE 294,A00,090143,Porter; George M,8,0,10,2
1653543168135,DSE 200,A00,091799,Staff,50,0,50,0
1653543168662,DSE 203,A00,091800,Gupta; Amarnath,30,0,30,0
1653543169186,DSE 250,A00,091801,Deutsch; Alin Bernard,30,0,30,0
1653543169711,DSE 290,A00,091802,Altintas De Callaf; Ilkay,50,0,50,0
1653543170245,ECE 200,001,091003,Antipa; Nicholas A,9999,0,9999,0
1653543170245,ECE 200,002,091004,Atanasov; Nikolay A.,9999,0,9999,0
1653543170245,ECE 200,003,091005,Bharadia; Dinesh,9999,0,9999,0
1653543170245,ECE 200,004,091006,Cheng; Chung Kuan,9999,0,9999,0
1653543170245,ECE 200,005,091007,Cosman; Pamela C.,9999,0,9999,0
1653543170245,ECE 200,006,091008,Staff,9999,0,9999,0
1653543170245,ECE 200,007,091009,Dayeh; Shadi Ahmad,9999,0,9999,0
1653543170245,ECE 200,008,091010,Fainman; Yeshaiahu,9999,0,9999,0
1653543170245,ECE 200,009,091011,Ford; Joseph Earl,9999,0,9999,0
1653543170245,ECE 200,010,091012,Franceschetti; Massimo,9999,0,9999,0
1653543170245,ECE 200,011,091013,Fullerton; Eric E,9999,0,9999,0
1653543170245,ECE 200,012,091014,Galton; Ian A,9999,0,9999,0
1653543170245,ECE 200,013,091015,Gilja; Vikash,9999,0,9999,0
1653543170245,ECE 200,014,091016,Hall; Drew A.,9999,0,9999,0
1653543170245,ECE 200,015,091017,Hsueh; Tzu-Chien,9999,0,9999,0
1653543170245,ECE 200,016,091018,Javidi; Tara,9999,0,9999,0
1653543170245,ECE 200,017,091019,Kahng; Andrew Byun,9999,0,9999,0
1653543170245,ECE 200,018,091020,Kim; Young-Han,9999,0,9999,0
1653543170245,ECE 200,019,091021,Koushanfar; Farinaz,9999,0,9999,0
1653543170245,ECE 200,020,091022,Kuzum; Duygu,9999,0,9999,0
1653543170245,ECE 200,021,091023,Le; Hanh-Phuc,9999,0,9999,0
1653543170245,ECE 200,022,091024,Lin; Bill,9999,0,9999,0
1653543170245,ECE 200,023,091025,Liu; Zhaowei,9999,0,9999,0
1653543170245,ECE 200,024,091026,Lo; Yu-Hwa,9999,0,9999,0
1653543170245,ECE 200,025,091027,Lomakin; Vitaliy,9999,0,9999,0
1653543170245,ECE 200,026,091028,Mercier; Patrick Philip,9999,0,9999,0
1653543170245,ECE 200,027,091029,Meyer; Florian,9999,0,9999,0
1653543170245,ECE 200,028,091030,Milstein; Laurence B.,9999,0,9999,0
1653543170245,ECE 200,029,091031,Mir Arabbaygi; Siavash,9999,0,9999,0
1653543170245,ECE 200,030,091032,Mookherjea; Shayan,9999,0,9999,0
1653543170245,ECE 200,031,091033,Morris; Karcher William,9999,0,9999,0
1653543170245,ECE 200,032,091034,Ng; Tse Nga,9999,0,9999,0
1653543170245,ECE 200,033,091035,Nguyen; Truong Quang,9999,0,9999,0
1653543170245,ECE 200,034,091036,Nomura; Kenji,9999,0,9999,0
1653543170245,ECE 200,035,091037,Orlitsky; Alon,9999,0,9999,0
1653543170245,ECE 200,036,091038,Pal; Piya,9999,0,9999,0
1653543170245,ECE 200,037,091039,Papen; George C.,9999,0,9999,0
1653543170245,ECE 200,038,091040,Radic; Stojan,9999,0,9999,0
1653543170245,ECE 200,039,091041,Rao; Bhaskar D.,9999,0,9999,0
1653543170245,ECE 200,040,091042,Rao; Ramesh R,9999,0,9999,0
1653543170245,ECE 200,041,091043,Rebeiz; Gabriel,9999,0,9999,0
1653543170245,ECE 200,042,091044,Sanford; John R,9999,0,9999,0
1653543170245,ECE 200,043,091045,Siegel; Paul H.,9999,0,9999,0
1653543170245,ECE 200,044,091046,Sievenpiper; Daniel F.,9999,0,9999,0
1653543170245,ECE 200,045,091047,Sworder; David D.,9999,0,9999,0
1653543170245,ECE 200,046,091048,Taur; Yuan,9999,0,9999,0
1653543170245,ECE 200,047,091049,Touri; Behrouz,9999,0,9999,0
1653543170245,ECE 200,048,091050,Trivedi; Mohan M.,9999,0,9999,0
1653543170245,ECE 200,049,091051,Vardy; Alexander,9999,0,9999,0
1653543170245,ECE 200,050,091052,Vasconcelos; Nuno,9999,0,9999,0
1653543170245,ECE 200,051,091053,Wang; Xiaolong,9999,0,9999,0
1653543170245,ECE 200,052,091054,Xie; Pengtao,9999,0,9999,0
1653543170245,ECE 200,053,091055,Yip; Michael,9999,0,9999,0
1653543170245,ECE 200,054,091056,Zeger; Kenneth A.,9999,0,9999,0
1653543170245,ECE 200,055,091057,Zhang; Xinyu,9999,0,9999,0
1653543170245,ECE 200,056,091058,Turakhia; Yatish Girish,9999,0,9999,0
1653543170245,ECE 200,057,091059,Kang; Mingu,9999,0,9999,0
1653543170245,ECE 200,058,091060,Shi; Yuanyuan,9999,0,9999,0
1653543170245,ECE 200,059,091061,Wang; Edward Jay,9999,0,9999,0
1653543170245,ECE 200,060,091062,Zheng; Yang,9999,0,9999,0
1653543170769,ECE 201,A00,095526,Lo; Yu-Hwa,0,0,0,0
1653543171297,ECE 203,A00,091065,Mercier; Patrick Philip,0,0,0,0
1653543171823,ECE 207A,A00,091605,Liu; Thomas Tao-Ming,0,0,0,0
1653543172345,ECE 212AN,A00,091068,Nomura; Kenji,0,0,0,0
1653543172868,ECE 222A,A00,091069,Rebeiz; Gabriel,0,0,0,0
1653543173389,ECE 225A,A00,091070,Orlitsky; Alon,0,0,0,0
1653543173911,ECE 230A,A00,091071,Nomura; Kenji,0,0,0,0
1653543174440,ECE 236A,A00,091072,Dayeh; Shadi Ahmad,0,0,0,0
1653543174970,ECE 238A,A00,091073,Luo; Jian,0,0,0,0
1653543174970,ECE 238A,B00,091074,Luo; Jian,0,0,0,0
1653543175494,ECE 240A,A00,091075,Radic; Stojan,0,0,0,0
1653543176024,ECE 247A,A00,091592,Shi; Lingyan,0,0,0,0
1653543176549,ECE 250,A00,091076,Touri; Behrouz,0,0,0,0
1653543177070,ECE 251C,A00,091078,Nguyen; Truong Quang,0,0,0,0
1653543177594,ECE 253,A00,091079,Cosman; Pamela C.,0,0,0,0
1653543178119,ECE 255A,A00,091080,Orlitsky; Alon,0,0,0,0
1653543178642,ECE 257A,A00,091081,Zhang; Xinyu,0,0,0,0
1653543179165,ECE 260A,A01,091084,Eldon; John,0,0,0,0
1653543179694,ECE 264C,A00,091085,Galton; Ian A,0,0,0,0
1653543180235,ECE 265C,A00,094889,Presti; Calogero Davide,0,0,0,9
1653543180760,ECE 266,A01,091087,Hall; Drew A.,0,0,0,0
1653543181805,ECE 271A,A00,091090,Vasconcelos; Nuno,0,0,0,0
1653543182332,ECE 272B,A00,091091,Sworder; David D.,0,0,0,0
1653543182854,ECE 275A,A00,091092,Meyer; Florian,0,0,0,0
1653543183380,ECE 277,A00,091093,An; Cheolhong,0,0,0,0
1653543183909,ECE 283,A00,091094,Le; Hanh-Phuc,0,0,0,0
1653543184435,ECE 284,A00,091095,Kang; Mingu,0,0,0,0
1653543184435,ECE 284,B00,091096,Wang; Edward Jay,0,0,0,0
1653543184958,ECE 285,A00,094334,Touri; Behrouz,0,0,0,0
1653543185482,ECE 289,A00,091097,Whelan; David Arthur,0,0,0,0
1653543186010,MATH 200A,A00,087414,Salehi Golsefidy; Alireza,7,0,8,1
1653543186542,MATH 202A,A00,087415,Gill; Philip E.,2,0,8,6
1653543187080,MATH 203A,A00,087416,Oprea; Dragos N.,6,0,8,2
1653543187602,MATH 204A,A00,087417,Kedlaya; Kiran S.,6,0,8,2
1653543188129,MATH 205,A00,087418,Sorensen; Claus M,6,0,8,2
1653543188655,MATH 206A,A00,087419,Izadi; Elham,7,0,8,1
1653543189180,MATH 207A,A00,087420,Mohammadi; Amir,5,0,8,3
1653543189708,MATH 208,A00,087421,Staff,9,0,10,1
1653543190241,MATH 209,A00,087422,Staff,10,0,10,0
1653543190767,MATH 218,A00,087423,Staff,10,0,10,0
1653543191299,MATH 220A,A00,087424,Novak; Jonathan I,6,0,8,2
1653543191824,MATH 231A,A00,087425,Bejenaru; Ioan,3,0,8,5
1653543192346,MATH 240A,A00,087426,Ebenfelt; Peter F,5,0,8,3
1653543192868,MATH 243,A00,087427,Staff,9,0,10,1
1653543193394,MATH 248,A00,087429,Staff,10,0,10,0
1653543193923,MATH 250A,A00,087430,Spolaor; Luca,4,0,8,4
1653543194445,MATH 257A,A00,087431,Spolaor; Luca,7,0,8,1
1653543194969,MATH 258,A00,087432,Staff,9,0,10,1
1653543195494,MATH 264A,A00,087433,Warnke; Lutz Peter,5,0,8,3
1653543196020,MATH 268,A00,087434,Staff,15,0,15,0
1653543196637,MATH 269,A00,087435,Staff,14,0,15,1
1653543197161,MATH 270A,A00,087436,Nie; Jiawang,0,0,8,8
1653543197692,MATH 272A,A00,087437,Tian; Xiaochuan,1,0,8,7
1653543198214,MATH 274,A01,087439,Cheng; Li-Tien,9,0,10,1
1653543198214,MATH 274,A02,087440,Cheng; Li-Tien,10,0,10,0
1653543198737,MATH 278A,A00,087441,Staff,8,0,10,2
1653543199260,MATH 278B,A00,087442,Staff,8,0,10,2
1653543199782,MATH 278C,A00,087443,Staff,8,0,10,2
1653543200306,MATH 280A,A00,087444,Zheng; Tianyi,0,0,8,8
1653543200837,MATH 281A,A00,087445,Bradic; Jelena,0,0,8,8
1653543201362,MATH 282A,A00,087446,Zhang; Danna,0,0,8,8
1653543201889,MATH 283,A00,087447,Tesler; Glenn,0,0,0,15
1653543202411,MATH 286,A00,087448,Kemp; Todd Aahron,5,0,8,3
1653543202943,MATH 287D,A00,087449,Bradic; Jelena,0,0,0,0
1653543203470,MATH 288,A00,087450,Staff,14,0,15,1
1653543203470,MATH 288,B00,087451,Staff,15,0,15,0
1653543203470,MATH 288,C00,087452,Staff,15,0,15,0
1653543203992,MATH 290A,A00,087453,Xu; Zhouli,6,0,8,2
1653543204516,MATH 291A,A00,087454,Xu; Zhouli,7,0,8,1
1653543205039,MATH 292,A00,087455,Staff,10,0,10,0
1653543205563,MATH 295,A00,087456,Staff,50,0,50,0
1653543206089,MATH 297,001,087457,Staff,998,0,999,1
1653543765116,COGS 200,A01,087991,Staff,47,0,50,3
1653543765640,COGS 201,A01,094504,Rangel; Lara M,17,0,25,8
1653543766163,COGS 203,A00,087992,Coulson; Seana M,18,0,20,2
1653543766690,COGS 210A,001,087993,Greene; Deanna Jacquelyn,9998,0,9999,1
1653543766690,COGS 210A,002,087994,Saygin; Ayse P,9999,0,9999,0
1653543766690,COGS 210A,003,087995,Xia; Haijun,9999,0,9999,0
1653543766690,COGS 210A,004,087996,Nitz; Douglas A.,9999,0,9999,0
1653543766690,COGS 210A,005,087997,Hollan; James D.,9999,0,9999,0
1653543766690,COGS 210A,006,087998,Deak; Gedeon O.,9998,0,9999,1
1653543766690,COGS 210A,007,087999,Rossano; Federico,9999,0,9999,0
1653543767213,COGS 211A,A00,088000,Coulson; Seana M,9997,0,9999,2
1653543767735,COGS 229,A00,088002,Staff,23,0,25,2
1653543768257,COGS 260,B00,094231,Staff,17,0,20,3
1653543768257,COGS 260,A00,088004,Nitz; Douglas A.,9998,0,9999,1
1653543768781,CSE 202,A00,090110,Paturi; Ramamohan,0,0,0,0
1653543768781,CSE 202,B00,090111,Paturi; Ramamohan,0,0,0,0
1653543769306,CSE 207B,A00,090112,Heninger; Nadia A,0,0,0,0
1653543769833,CSE 208,A00,094858,Micciancio; Daniele,0,0,0,0
1653543770356,CSE 210,A00,090113,Powell; Thomas Allan,0,0,0,0
1653543770878,CSE 219,A00,090898,Staff,0,0,0,0
1653543771405,CSE 221,A00,090114,Zhou; Yuan-Yuan,0,0,0,0
1653543771932,CSE 229A,A00,090115,Porter; George M,0,0,0,0
1653543772458,CSE 229C,A00,090116,Savage; Stefan,0,0,0,0
1653543772981,CSE 230,A00,090117,Jhala; Ranjit,0,0,0,0
1653543773502,CSE 232,A00,090118,Papakonstantinou; Yannis,0,0,0,0
1653543774024,CSE 239A,A00,090121,Kumar; Arun Kumar,0,0,0,0
1653543774546,CSE 239B,A00,090122,Jhala; Ranjit,0,0,0,0
1653543775071,CSE 240A,A00,090123,Zhao; Jishen,0,0,189,189
1653543775595,CSE 243A,A00,090124,Orailoglu; Alex,0,0,15,15
1653543776121,CSE 249B,A00,090125,Kahng; Andrew Byun,13,0,20,7
1653543776648,CSE 250A,A00,090126,Berg-Kirkpatrick; Taylor D,0,0,0,0
1653543777171,CSE 252A,A00,090127,Ochoa; Benjamin Lawrence,0,0,0,0
1653543777698,CSE 258,A01,090129,McAuley; Julian John,0,0,0,0
1653543778223,CSE 258R,A01,090131,McAuley; Julian John,0,0,0,0
1653543778744,CSE 274,A00,090132,Ramamoorthi; Ravi,0,0,0,0
1653543779270,CSE 276A,A00,090133,Christensen; Henrik I,0,0,0,0
1653543779798,CSE 276C,A00,090134,Christensen; Henrik I,0,0,0,0
1653543780321,CSE 290,A00,090135,Bafna; Vineet,0,0,0,0
1653543780321,CSE 290,B00,090136,Ramamoorthi; Ravi,0,0,0,0
1653543780321,CSE 290,C00,090137,Li; Tzumao,8,0,10,2
1653543780321,CSE 290,D00,090138,Zhou; Yuan-Yuan,9,0,10,1
1653543780321,CSE 290,E00,090139,Christensen; Henrik I,8,0,10,2
1653543780321,CSE 290,F00,094053,Shalev; Aaron D,0,0,0,0
1653543780846,CSE 291,A00,090140,Munyaka; Imani N. S.,0,0,0,0
1653543780846,CSE 291,B00,094880,Yu; Qi,0,0,0,0
1653543780846,CSE 291,C00,090142,Pannuto; Patrick William,0,0,0,0
1653543780846,CSE 291,D00,094881,Zhang; Yiying,0,0,0,0
1653543780846,CSE 291,E00,095118,Su; Hao,0,0,0,0
1653543781374,CSE 293,001,094905,Bafna; Vineet,9999,0,9999,0
1653543781374,CSE 293,002,094906,Bellare; Mihir,9999,0,9999,0
1653543781374,CSE 293,003,094907,Berg-Kirkpatrick; Taylor D,9999,0,9999,0
1653543781374,CSE 293,004,094908,Christensen; Henrik I,9999,0,9999,0
1653543781374,CSE 293,005,094909,Cottrell; Garrison W,9999,0,9999,0
1653543781374,CSE 293,006,094910,Deutsch; Alin Bernard,9999,0,9999,0
1653543781374,CSE 293,007,094911,Esmaeilzadeh; Hadi,9999,0,9999,0
1653543781374,CSE 293,008,094912,Freund; Yoav,9999,0,9999,0
1653543781374,CSE 293,009,094913,Griswold; William G.,9999,0,9999,0
1653543781374,CSE 293,010,094914,Gymrek; Melissa Ann,9999,0,9999,0
1653543781374,CSE 293,011,094915,Heninger; Nadia A,9999,0,9999,0
1653543781374,CSE 293,012,094916,Impagliazzo; Russell,9999,0,9999,0
1653543781374,CSE 293,013,094917,Jhala; Ranjit,9999,0,9999,0
1653543781374,CSE 293,014,094918,Kahng; Andrew Byun,9999,0,9999,0
1653543781374,CSE 293,015,094919,Kane; Daniel Mertz,9999,0,9999,0
1653543781374,CSE 293,016,094920,Kriegman; David J,9999,0,9999,0
1653543781374,CSE 293,017,094921,Kumar; Arun Kumar,9999,0,9999,0
1653543781374,CSE 293,018,094922,Lerner; Sorin,9999,0,9999,0
1653543781374,CSE 293,019,094923,Lovett; Shachar,9999,0,9999,0
1653543781374,CSE 293,020,094924,McAuley; Julian John,9999,0,9999,0
1653543781374,CSE 293,021,094925,Micciancio; Daniele,9999,0,9999,0
1653543781374,CSE 293,022,094926,Orailoglu; Alex,9999,0,9999,0
1653543781374,CSE 293,023,094927,Paturi; Ramamohan,9999,0,9999,0
1653543781374,CSE 293,024,094928,Polikarpova; Nadezhda,9999,0,9999,0
1653543781374,CSE 293,025,094929,Politz; Joseph Gibbs,9999,0,9999,0
1653543781374,CSE 293,026,094930,Porter; George M,9999,0,9999,0
1653543781374,CSE 293,027,094931,Porter; Leonard Emerson,9999,0,9999,0
1653543781374,CSE 293,028,094932,Ramamoorthi; Ravi,9999,0,9999,0
1653543781374,CSE 293,029,094933,Sahoo; Debashis,9999,0,9999,0
1653543781374,CSE 293,030,094934,Saul; Lawrence,9999,0,9999,0
1653543781374,CSE 293,031,094935,Savage; Stefan,9999,0,9999,0
1653543781374,CSE 293,032,094936,Schulze; Jurgen P.,9999,0,9999,0
1653543781374,CSE 293,033,094937,Snoeren; Alex C.,9999,0,9999,0
1653543781374,CSE 293,034,094938,Shang; Jingbo,9999,0,9999,0
1653543781374,CSE 293,035,094939,Stefan; Deian,9999,0,9999,0
1653543781374,CSE 293,036,094940,Su; Hao,9999,0,9999,0
1653543781374,CSE 293,037,094941,Swanson; Steven James,9999,0,9999,0
1653543781374,CSE 293,038,094942,Tullsen; Dean Michael,9999,0,9999,0
1653543781374,CSE 293,039,094943,Voelker; Geoffrey M.,9999,0,9999,0
1653543781374,CSE 293,040,094944,Zhao; Jishen,9999,0,9999,0
1653543781374,CSE 293,041,094945,Zhou; Yuan-Yuan,9999,0,9999,0
1653543781374,CSE 293,042,094946,Gao; Sicun,9998,0,9999,1
1653543781374,CSE 293,043,094947,Weibel; Nadir,9999,0,9999,0
1653543781374,CSE 293,044,094948,Gupta; Rajesh K.,9999,0,9999,0
1653543781897,CSE 294,A00,090143,Porter; George M,8,0,10,2
1653543782422,DSE 200,A00,091799,Staff,50,0,50,0
1653543783022,DSE 203,A00,091800,Gupta; Amarnath,30,0,30,0
1653543783546,DSE 250,A00,091801,Deutsch; Alin Bernard,30,0,30,0
1653543784069,DSE 290,A00,091802,Altintas De Callaf; Ilkay,50,0,50,0
1653543784616,ECE 200,001,091003,Antipa; Nicholas A,9999,0,9999,0
1653543784616,ECE 200,002,091004,Atanasov; Nikolay A.,9999,0,9999,0
1653543784616,ECE 200,003,091005,Bharadia; Dinesh,9999,0,9999,0
1653543784616,ECE 200,004,091006,Cheng; Chung Kuan,9999,0,9999,0
1653543784616,ECE 200,005,091007,Cosman; Pamela C.,9999,0,9999,0
1653543784616,ECE 200,006,091008,Staff,9999,0,9999,0
1653543784616,ECE 200,007,091009,Dayeh; Shadi Ahmad,9999,0,9999,0
1653543784616,ECE 200,008,091010,Fainman; Yeshaiahu,9999,0,9999,0
1653543784616,ECE 200,009,091011,Ford; Joseph Earl,9999,0,9999,0
1653543784616,ECE 200,010,091012,Franceschetti; Massimo,9999,0,9999,0
1653543784616,ECE 200,011,091013,Fullerton; Eric E,9999,0,9999,0
1653543784616,ECE 200,012,091014,Galton; Ian A,9999,0,9999,0
1653543784616,ECE 200,013,091015,Gilja; Vikash,9999,0,9999,0
1653543784616,ECE 200,014,091016,Hall; Drew A.,9999,0,9999,0
1653543784616,ECE 200,015,091017,Hsueh; Tzu-Chien,9999,0,9999,0
1653543784616,ECE 200,016,091018,Javidi; Tara,9999,0,9999,0
1653543784616,ECE 200,017,091019,Kahng; Andrew Byun,9999,0,9999,0
1653543784616,ECE 200,018,091020,Kim; Young-Han,9999,0,9999,0
1653543784616,ECE 200,019,091021,Koushanfar; Farinaz,9999,0,9999,0
1653543784616,ECE 200,020,091022,Kuzum; Duygu,9999,0,9999,0
1653543784616,ECE 200,021,091023,Le; Hanh-Phuc,9999,0,9999,0
1653543784616,ECE 200,022,091024,Lin; Bill,9999,0,9999,0
1653543784616,ECE 200,023,091025,Liu; Zhaowei,9999,0,9999,0
1653543784616,ECE 200,024,091026,Lo; Yu-Hwa,9999,0,9999,0
1653543784616,ECE 200,025,091027,Lomakin; Vitaliy,9999,0,9999,0
1653543784616,ECE 200,026,091028,Mercier; Patrick Philip,9999,0,9999,0
1653543784616,ECE 200,027,091029,Meyer; Florian,9999,0,9999,0
1653543784616,ECE 200,028,091030,Milstein; Laurence B.,9999,0,9999,0
1653543784616,ECE 200,029,091031,Mir Arabbaygi; Siavash,9999,0,9999,0
1653543784616,ECE 200,030,091032,Mookherjea; Shayan,9999,0,9999,0
1653543784616,ECE 200,031,091033,Morris; Karcher William,9999,0,9999,0
1653543784616,ECE 200,032,091034,Ng; Tse Nga,9999,0,9999,0
1653543784616,ECE 200,033,091035,Nguyen; Truong Quang,9999,0,9999,0
1653543784616,ECE 200,034,091036,Nomura; Kenji,9999,0,9999,0
1653543784616,ECE 200,035,091037,Orlitsky; Alon,9999,0,9999,0
1653543784616,ECE 200,036,091038,Pal; Piya,9999,0,9999,0
1653543784616,ECE 200,037,091039,Papen; George C.,9999,0,9999,0
1653543784616,ECE 200,038,091040,Radic; Stojan,9999,0,9999,0
1653543784616,ECE 200,039,091041,Rao; Bhaskar D.,9999,0,9999,0
1653543784616,ECE 200,040,091042,Rao; Ramesh R,9999,0,9999,0
1653543784616,ECE 200,041,091043,Rebeiz; Gabriel,9999,0,9999,0
1653543784616,ECE 200,042,091044,Sanford; John R,9999,0,9999,0
1653543784616,ECE 200,043,091045,Siegel; Paul H.,9999,0,9999,0
1653543784616,ECE 200,044,091046,Sievenpiper; Daniel F.,9999,0,9999,0
1653543784616,ECE 200,045,091047,Sworder; David D.,9999,0,9999,0
1653543784616,ECE 200,046,091048,Taur; Yuan,9999,0,9999,0
1653543784616,ECE 200,047,091049,Touri; Behrouz,9999,0,9999,0
1653543784616,ECE 200,048,091050,Trivedi; Mohan M.,9999,0,9999,0
1653543784616,ECE 200,049,091051,Vardy; Alexander,9999,0,9999,0
1653543784616,ECE 200,050,091052,Vasconcelos; Nuno,9999,0,9999,0
1653543784616,ECE 200,051,091053,Wang; Xiaolong,9999,0,9999,0
1653543784616,ECE 200,052,091054,Xie; Pengtao,9999,0,9999,0
1653543784616,ECE 200,053,091055,Yip; Michael,9999,0,9999,0
1653543784616,ECE 200,054,091056,Zeger; Kenneth A.,9999,0,9999,0
1653543784616,ECE 200,055,091057,Zhang; Xinyu,9999,0,9999,0
1653543784616,ECE 200,056,091058,Turakhia; Yatish Girish,9999,0,9999,0
1653543784616,ECE 200,057,091059,Kang; Mingu,9999,0,9999,0
1653543784616,ECE 200,058,091060,Shi; Yuanyuan,9999,0,9999,0
1653543784616,ECE 200,059,091061,Wang; Edward Jay,9999,0,9999,0
1653543784616,ECE 200,060,091062,Zheng; Yang,9999,0,9999,0
1653543785140,ECE 201,A00,095526,Lo; Yu-Hwa,0,0,0,0
1653543785667,ECE 203,A00,091065,Mercier; Patrick Philip,0,0,0,0
1653543786190,ECE 207A,A00,091605,Liu; Thomas Tao-Ming,0,0,0,0
1653543786724,ECE 212AN,A00,091068,Nomura; Kenji,0,0,0,0
1653543787254,ECE 222A,A00,091069,Rebeiz; Gabriel,0,0,0,0
1653543787787,ECE 225A,A00,091070,Orlitsky; Alon,0,0,0,0
1653543788309,ECE 230A,A00,091071,Nomura; Kenji,0,0,0,0
1653543788832,ECE 236A,A00,091072,Dayeh; Shadi Ahmad,0,0,0,0
1653543789355,ECE 238A,A00,091073,Luo; Jian,0,0,0,0
1653543789355,ECE 238A,B00,091074,Luo; Jian,0,0,0,0
1653543789881,ECE 240A,A00,091075,Radic; Stojan,0,0,0,0
1653543790404,ECE 247A,A00,091592,Shi; Lingyan,0,0,0,0
1653543790936,ECE 250,A00,091076,Touri; Behrouz,0,0,0,0
1653543791460,ECE 251C,A00,091078,Nguyen; Truong Quang,0,0,0,0
1653543791985,ECE 253,A00,091079,Cosman; Pamela C.,0,0,0,0
1653543792522,ECE 255A,A00,091080,Orlitsky; Alon,0,0,0,0
1653543793047,ECE 257A,A00,091081,Zhang; Xinyu,0,0,0,0
1653543793572,ECE 260A,A01,091084,Eldon; John,0,0,0,0
1653543794098,ECE 264C,A00,091085,Galton; Ian A,0,0,0,0
1653543794625,ECE 265C,A00,094889,Presti; Calogero Davide,0,0,0,9
1653543795146,ECE 266,A01,091087,Hall; Drew A.,0,0,0,0
1653543796198,ECE 271A,A00,091090,Vasconcelos; Nuno,0,0,0,0
1653543796724,ECE 272B,A00,091091,Sworder; David D.,0,0,0,0
1653543797253,ECE 275A,A00,091092,Meyer; Florian,0,0,0,0
1653543797776,ECE 277,A00,091093,An; Cheolhong,0,0,0,0
1653543798299,ECE 283,A00,091094,Le; Hanh-Phuc,0,0,0,0
1653543798825,ECE 284,A00,091095,Kang; Mingu,0,0,0,0
1653543798825,ECE 284,B00,091096,Wang; Edward Jay,0,0,0,0
1653543799347,ECE 285,A00,094334,Touri; Behrouz,0,0,0,0
1653543799874,ECE 289,A00,091097,Whelan; David Arthur,0,0,0,0
1653543800395,MATH 200A,A00,087414,Salehi Golsefidy; Alireza,7,0,8,1
1653543800918,MATH 202A,A00,087415,Gill; Philip E.,2,0,8,6
1653543801444,MATH 203A,A00,087416,Oprea; Dragos N.,6,0,8,2
1653543801970,MATH 204A,A00,087417,Kedlaya; Kiran S.,6,0,8,2
1653543802497,MATH 205,A00,087418,Sorensen; Claus M,6,0,8,2
1653543803020,MATH 206A,A00,087419,Izadi; Elham,7,0,8,1
1653543803546,MATH 207A,A00,087420,Mohammadi; Amir,5,0,8,3
1653543804073,MATH 208,A00,087421,Staff,9,0,10,1
1653543804596,MATH 209,A00,087422,Staff,10,0,10,0
1653543805119,MATH 218,A00,087423,Staff,10,0,10,0
1653543805643,MATH 220A,A00,087424,Novak; Jonathan I,6,0,8,2
1653543806167,MATH 231A,A00,087425,Bejenaru; Ioan,3,0,8,5
1653543806690,MATH 240A,A00,087426,Ebenfelt; Peter F,5,0,8,3
1653543807212,MATH 243,A00,087427,Staff,9,0,10,1
1653543807737,MATH 248,A00,087429,Staff,10,0,10,0
1653543808268,MATH 250A,A00,087430,Spolaor; Luca,4,0,8,4
1653543808799,MATH 257A,A00,087431,Spolaor; Luca,7,0,8,1
1653543809321,MATH 258,A00,087432,Staff,9,0,10,1
1653543809843,MATH 264A,A00,087433,Warnke; Lutz Peter,5,0,8,3
1653543810368,MATH 268,A00,087434,Staff,15,0,15,0
1653543810892,MATH 269,A00,087435,Staff,14,0,15,1
1653543811418,MATH 270A,A00,087436,Nie; Jiawang,0,0,8,8
1653543811945,MATH 272A,A00,087437,Tian; Xiaochuan,1,0,8,7
1653543812471,MATH 274,A01,087439,Cheng; Li-Tien,9,0,10,1
1653543812471,MATH 274,A02,087440,Cheng; Li-Tien,10,0,10,0
1653543812994,MATH 278A,A00,087441,Staff,8,0,10,2
1653543813520,MATH 278B,A00,087442,Staff,8,0,10,2
1653543814049,MATH 278C,A00,087443,Staff,8,0,10,2
1653543814572,MATH 280A,A00,087444,Zheng; Tianyi,0,0,8,8
1653543815095,MATH 281A,A00,087445,Bradic; Jelena,0,0,8,8
1653543815619,MATH 282A,A00,087446,Zhang; Danna,0,0,8,8
1653543816144,MATH 283,A00,087447,Tesler; Glenn,0,0,0,15
1653543816670,MATH 286,A00,087448,Kemp; Todd Aahron,5,0,8,3
1653543817194,MATH 287D,A00,087449,Bradic; Jelena,0,0,0,0
1653543817720,MATH 288,A00,087450,Staff,14,0,15,1
1653543817720,MATH 288,B00,087451,Staff,15,0,15,0
1653543817720,MATH 288,C00,087452,Staff,15,0,15,0
1653543818243,MATH 290A,A00,087453,Xu; Zhouli,6,0,8,2
1653543818767,MATH 291A,A00,087454,Xu; Zhouli,7,0,8,1
1653543819289,MATH 292,A00,087455,Staff,10,0,10,0
1653543819814,MATH 295,A00,087456,Staff,50,0,50,0
1653543820339,MATH 297,001,087457,Staff,998,0,999,1
1653544379800,COGS 200,A01,087991,Staff,47,0,50,3
1653544380322,COGS 201,A01,094504,Rangel; Lara M,17,0,25,8
1653544380851,COGS 203,A00,087992,Coulson; Seana M,18,0,20,2
1653544381375,COGS 210A,001,087993,Greene; Deanna Jacquelyn,9998,0,9999,1
1653544381375,COGS 210A,002,087994,Saygin; Ayse P,9999,0,9999,0
1653544381375,COGS 210A,003,087995,Xia; Haijun,9999,0,9999,0
1653544381375,COGS 210A,004,087996,Nitz; Douglas A.,9999,0,9999,0
1653544381375,COGS 210A,005,087997,Hollan; James D.,9999,0,9999,0
1653544381375,COGS 210A,006,087998,Deak; Gedeon O.,9998,0,9999,1
1653544381375,COGS 210A,007,087999,Rossano; Federico,9999,0,9999,0
1653544381898,COGS 211A,A00,088000,Coulson; Seana M,9997,0,9999,2
1653544382423,COGS 229,A00,088002,Staff,23,0,25,2
1653544382954,COGS 260,B00,094231,Staff,17,0,20,3
1653544382954,COGS 260,A00,088004,Nitz; Douglas A.,9998,0,9999,1
1653544383480,CSE 202,A00,090110,Paturi; Ramamohan,0,0,0,0
1653544383480,CSE 202,B00,090111,Paturi; Ramamohan,0,0,0,0
1653544384003,CSE 207B,A00,090112,Heninger; Nadia A,0,0,0,0
1653544384526,CSE 208,A00,094858,Micciancio; Daniele,0,0,0,0
1653544385048,CSE 210,A00,090113,Powell; Thomas Allan,0,0,0,0
1653544385571,CSE 219,A00,090898,Staff,0,0,0,0
1653544386095,CSE 221,A00,090114,Zhou; Yuan-Yuan,0,0,0,0
1653544386621,CSE 229A,A00,090115,Porter; George M,0,0,0,0
1653544387144,CSE 229C,A00,090116,Savage; Stefan,0,0,0,0
1653544387668,CSE 230,A00,090117,Jhala; Ranjit,0,0,0,0
1653544388190,CSE 232,A00,090118,Papakonstantinou; Yannis,0,0,0,0
1653544388721,CSE 239A,A00,090121,Kumar; Arun Kumar,0,0,0,0
1653544389246,CSE 239B,A00,090122,Jhala; Ranjit,0,0,0,0
1653544389768,CSE 240A,A00,090123,Zhao; Jishen,0,0,189,189
1653544390294,CSE 243A,A00,090124,Orailoglu; Alex,0,0,15,15
1653544390818,CSE 249B,A00,090125,Kahng; Andrew Byun,13,0,20,7
1653544391342,CSE 250A,A00,090126,Berg-Kirkpatrick; Taylor D,0,0,0,0
1653544391864,CSE 252A,A00,090127,Ochoa; Benjamin Lawrence,0,0,0,0
1653544392390,CSE 258,A01,090129,McAuley; Julian John,0,0,0,0
1653544392912,CSE 258R,A01,090131,McAuley; Julian John,0,0,0,0
1653544393438,CSE 274,A00,090132,Ramamoorthi; Ravi,0,0,0,0
1653544393972,CSE 276A,A00,090133,Christensen; Henrik I,0,0,0,0
1653544394497,CSE 276C,A00,090134,Christensen; Henrik I,0,0,0,0
1653544395026,CSE 290,A00,090135,Bafna; Vineet,0,0,0,0
1653544395026,CSE 290,B00,090136,Ramamoorthi; Ravi,0,0,0,0
1653544395026,CSE 290,C00,090137,Li; Tzumao,8,0,10,2
1653544395026,CSE 290,D00,090138,Zhou; Yuan-Yuan,9,0,10,1
1653544395026,CSE 290,E00,090139,Christensen; Henrik I,8,0,10,2
1653544395026,CSE 290,F00,094053,Shalev; Aaron D,0,0,0,0
1653544395563,CSE 291,A00,090140,Munyaka; Imani N. S.,0,0,0,0
1653544395563,CSE 291,B00,094880,Yu; Qi,0,0,0,0
1653544395563,CSE 291,C00,090142,Pannuto; Patrick William,0,0,0,0
1653544395563,CSE 291,D00,094881,Zhang; Yiying,0,0,0,0
1653544395563,CSE 291,E00,095118,Su; Hao,0,0,0,0
1653544396092,CSE 293,001,094905,Bafna; Vineet,9999,0,9999,0
1653544396092,CSE 293,002,094906,Bellare; Mihir,9999,0,9999,0
1653544396092,CSE 293,003,094907,Berg-Kirkpatrick; Taylor D,9999,0,9999,0
1653544396092,CSE 293,004,094908,Christensen; Henrik I,9999,0,9999,0
1653544396092,CSE 293,005,094909,Cottrell; Garrison W,9999,0,9999,0
1653544396092,CSE 293,006,094910,Deutsch; Alin Bernard,9999,0,9999,0
1653544396092,CSE 293,007,094911,Esmaeilzadeh; Hadi,9999,0,9999,0
1653544396092,CSE 293,008,094912,Freund; Yoav,9999,0,9999,0
1653544396092,CSE 293,009,094913,Griswold; William G.,9999,0,9999,0
1653544396092,CSE 293,010,094914,Gymrek; Melissa Ann,9999,0,9999,0
1653544396092,CSE 293,011,094915,Heninger; Nadia A,9999,0,9999,0
1653544396092,CSE 293,012,094916,Impagliazzo; Russell,9999,0,9999,0
1653544396092,CSE 293,013,094917,Jhala; Ranjit,9999,0,9999,0
1653544396092,CSE 293,014,094918,Kahng; Andrew Byun,9999,0,9999,0
1653544396092,CSE 293,015,094919,Kane; Daniel Mertz,9999,0,9999,0
1653544396092,CSE 293,016,094920,Kriegman; David J,9999,0,9999,0
1653544396092,CSE 293,017,094921,Kumar; Arun Kumar,9999,0,9999,0
1653544396092,CSE 293,018,094922,Lerner; Sorin,9999,0,9999,0
1653544396092,CSE 293,019,094923,Lovett; Shachar,9999,0,9999,0
1653544396092,CSE 293,020,094924,McAuley; Julian John,9999,0,9999,0
1653544396092,CSE 293,021,094925,Micciancio; Daniele,9999,0,9999,0
1653544396092,CSE 293,022,094926,Orailoglu; Alex,9999,0,9999,0
1653544396092,CSE 293,023,094927,Paturi; Ramamohan,9999,0,9999,0
1653544396092,CSE 293,024,094928,Polikarpova; Nadezhda,9999,0,9999,0
1653544396092,CSE 293,025,094929,Politz; Joseph Gibbs,9999,0,9999,0
1653544396092,CSE 293,026,094930,Porter; George M,9999,0,9999,0
1653544396092,CSE 293,027,094931,Porter; Leonard Emerson,9999,0,9999,0
1653544396092,CSE 293,028,094932,Ramamoorthi; Ravi,9999,0,9999,0
1653544396092,CSE 293,029,094933,Sahoo; Debashis,9999,0,9999,0
1653544396092,CSE 293,030,094934,Saul; Lawrence,9999,0,9999,0
1653544396092,CSE 293,031,094935,Savage; Stefan,9999,0,9999,0
1653544396092,CSE 293,032,094936,Schulze; Jurgen P.,9999,0,9999,0
1653544396092,CSE 293,033,094937,Snoeren; Alex C.,9999,0,9999,0
1653544396092,CSE 293,034,094938,Shang; Jingbo,9999,0,9999,0
1653544396092,CSE 293,035,094939,Stefan; Deian,9999,0,9999,0
1653544396092,CSE 293,036,094940,Su; Hao,9999,0,9999,0
1653544396092,CSE 293,037,094941,Swanson; Steven James,9999,0,9999,0
1653544396092,CSE 293,038,094942,Tullsen; Dean Michael,9999,0,9999,0
1653544396092,CSE 293,039,094943,Voelker; Geoffrey M.,9999,0,9999,0
1653544396092,CSE 293,040,094944,Zhao; Jishen,9999,0,9999,0
1653544396092,CSE 293,041,094945,Zhou; Yuan-Yuan,9999,0,9999,0
1653544396092,CSE 293,042,094946,Gao; Sicun,9998,0,9999,1
1653544396092,CSE 293,043,094947,Weibel; Nadir,9999,0,9999,0
1653544396092,CSE 293,044,094948,Gupta; Rajesh K.,9999,0,9999,0
1653544396617,CSE 294,A00,090143,Porter; George M,8,0,10,2
1653544397140,DSE 200,A00,091799,Staff,50,0,50,0
1653544397668,DSE 203,A00,091800,Gupta; Amarnath,30,0,30,0
1653544398189,DSE 250,A00,091801,Deutsch; Alin Bernard,30,0,30,0
1653544398715,DSE 290,A00,091802,Altintas De Callaf; Ilkay,50,0,50,0
1653544399246,ECE 200,001,091003,Antipa; Nicholas A,9999,0,9999,0
1653544399246,ECE 200,002,091004,Atanasov; Nikolay A.,9999,0,9999,0
1653544399246,ECE 200,003,091005,Bharadia; Dinesh,9999,0,9999,0
1653544399246,ECE 200,004,091006,Cheng; Chung Kuan,9999,0,9999,0
1653544399246,ECE 200,005,091007,Cosman; Pamela C.,9999,0,9999,0
1653544399246,ECE 200,006,091008,Staff,9999,0,9999,0
1653544399246,ECE 200,007,091009,Dayeh; Shadi Ahmad,9999,0,9999,0
1653544399246,ECE 200,008,091010,Fainman; Yeshaiahu,9999,0,9999,0
1653544399246,ECE 200,009,091011,Ford; Joseph Earl,9999,0,9999,0
1653544399246,ECE 200,010,091012,Franceschetti; Massimo,9999,0,9999,0
1653544399246,ECE 200,011,091013,Fullerton; Eric E,9999,0,9999,0
1653544399246,ECE 200,012,091014,Galton; Ian A,9999,0,9999,0
1653544399246,ECE 200,013,091015,Gilja; Vikash,9999,0,9999,0
1653544399246,ECE 200,014,091016,Hall; Drew A.,9999,0,9999,0
1653544399246,ECE 200,015,091017,Hsueh; Tzu-Chien,9999,0,9999,0
1653544399246,ECE 200,016,091018,Javidi; Tara,9999,0,9999,0
1653544399246,ECE 200,017,091019,Kahng; Andrew Byun,9999,0,9999,0
1653544399246,ECE 200,018,091020,Kim; Young-Han,9999,0,9999,0
1653544399246,ECE 200,019,091021,Koushanfar; Farinaz,9999,0,9999,0
1653544399246,ECE 200,020,091022,Kuzum; Duygu,9999,0,9999,0
1653544399246,ECE 200,021,091023,Le; Hanh-Phuc,9999,0,9999,0
1653544399246,ECE 200,022,091024,Lin; Bill,9999,0,9999,0
1653544399246,ECE 200,023,091025,Liu; Zhaowei,9999,0,9999,0
1653544399246,ECE 200,024,091026,Lo; Yu-Hwa,9999,0,9999,0
1653544399246,ECE 200,025,091027,Lomakin; Vitaliy,9999,0,9999,0
1653544399246,ECE 200,026,091028,Mercier; Patrick Philip,9999,0,9999,0
1653544399246,ECE 200,027,091029,Meyer; Florian,9999,0,9999,0
1653544399246,ECE 200,028,091030,Milstein; Laurence B.,9999,0,9999,0
1653544399246,ECE 200,029,091031,Mir Arabbaygi; Siavash,9999,0,9999,0
1653544399246,ECE 200,030,091032,Mookherjea; Shayan,9999,0,9999,0
1653544399246,ECE 200,031,091033,Morris; Karcher William,9999,0,9999,0
1653544399246,ECE 200,032,091034,Ng; Tse Nga,9999,0,9999,0
1653544399246,ECE 200,033,091035,Nguyen; Truong Quang,9999,0,9999,0
1653544399246,ECE 200,034,091036,Nomura; Kenji,9999,0,9999,0
1653544399246,ECE 200,035,091037,Orlitsky; Alon,9999,0,9999,0
1653544399246,ECE 200,036,091038,Pal; Piya,9999,0,9999,0
1653544399246,ECE 200,037,091039,Papen; George C.,9999,0,9999,0
1653544399246,ECE 200,038,091040,Radic; Stojan,9999,0,9999,0
1653544399246,ECE 200,039,091041,Rao; Bhaskar D.,9999,0,9999,0
1653544399246,ECE 200,040,091042,Rao; Ramesh R,9999,0,9999,0
1653544399246,ECE 200,041,091043,Rebeiz; Gabriel,9999,0,9999,0
1653544399246,ECE 200,042,091044,Sanford; John R,9999,0,9999,0
1653544399246,ECE 200,043,091045,Siegel; Paul H.,9999,0,9999,0
1653544399246,ECE 200,044,091046,Sievenpiper; Daniel F.,9999,0,9999,0
1653544399246,ECE 200,045,091047,Sworder; David D.,9999,0,9999,0
1653544399246,ECE 200,046,091048,Taur; Yuan,9999,0,9999,0
1653544399246,ECE 200,047,091049,Touri; Behrouz,9999,0,9999,0
1653544399246,ECE 200,048,091050,Trivedi; Mohan M.,9999,0,9999,0
1653544399246,ECE 200,049,091051,Vardy; Alexander,9999,0,9999,0
1653544399246,ECE 200,050,091052,Vasconcelos; Nuno,9999,0,9999,0
1653544399246,ECE 200,051,091053,Wang; Xiaolong,9999,0,9999,0
1653544399246,ECE 200,052,091054,Xie; Pengtao,9999,0,9999,0
1653544399246,ECE 200,053,091055,Yip; Michael,9999,0,9999,0
1653544399246,ECE 200,054,091056,Zeger; Kenneth A.,9999,0,9999,0
1653544399246,ECE 200,055,091057,Zhang; Xinyu,9999,0,9999,0
1653544399246,ECE 200,056,091058,Turakhia; Yatish Girish,9999,0,9999,0
1653544399246,ECE 200,057,091059,Kang; Mingu,9999,0,9999,0
1653544399246,ECE 200,058,091060,Shi; Yuanyuan,9999,0,9999,0
1653544399246,ECE 200,059,091061,Wang; Edward Jay,9999,0,9999,0
1653544399246,ECE 200,060,091062,Zheng; Yang,9999,0,9999,0
1653544399785,ECE 201,A00,095526,Lo; Yu-Hwa,0,0,0,0
1653544400308,ECE 203,A00,091065,Mercier; Patrick Philip,0,0,0,0
1653544400829,ECE 207A,A00,091605,Liu; Thomas Tao-Ming,0,0,0,0
1653544401352,ECE 212AN,A00,091068,Nomura; Kenji,0,0,0,0
1653544401878,ECE 222A,A00,091069,Rebeiz; Gabriel,0,0,0,0
1653544402401,ECE 225A,A00,091070,Orlitsky; Alon,0,0,0,0
1653544402932,ECE 230A,A00,091071,Nomura; Kenji,0,0,0,0
1653544403457,ECE 236A,A00,091072,Dayeh; Shadi Ahmad,0,0,0,0
1653544403988,ECE 238A,A00,091073,Luo; Jian,0,0,0,0
1653544403988,ECE 238A,B00,091074,Luo; Jian,0,0,0,0
1653544404521,ECE 240A,A00,091075,Radic; Stojan,0,0,0,0
1653544405054,ECE 247A,A00,091592,Shi; Lingyan,0,0,0,0
1653544405581,ECE 250,A00,091076,Touri; Behrouz,0,0,0,0
1653544406103,ECE 251C,A00,091078,Nguyen; Truong Quang,0,0,0,0
1653544406625,ECE 253,A00,091079,Cosman; Pamela C.,0,0,0,0
1653544407154,ECE 255A,A00,091080,Orlitsky; Alon,0,0,0,0
1653544407677,ECE 257A,A00,091081,Zhang; Xinyu,0,0,0,0
1653544408202,ECE 260A,A01,091084,Eldon; John,0,0,0,0
1653544408732,ECE 264C,A00,091085,Galton; Ian A,0,0,0,0
1653544409257,ECE 265C,A00,094889,Presti; Calogero Davide,0,0,0,9
1653544409784,ECE 266,A01,091087,Hall; Drew A.,0,0,0,0
1653544410832,ECE 271A,A00,091090,Vasconcelos; Nuno,0,0,0,0
1653544411359,ECE 272B,A00,091091,Sworder; David D.,0,0,0,0
1653544411882,ECE 275A,A00,091092,Meyer; Florian,0,0,0,0
1653544412406,ECE 277,A00,091093,An; Cheolhong,0,0,0,0
1653544412932,ECE 283,A00,091094,Le; Hanh-Phuc,0,0,0,0
1653544413458,ECE 284,A00,091095,Kang; Mingu,0,0,0,0
1653544413458,ECE 284,B00,091096,Wang; Edward Jay,0,0,0,0
1653544413980,ECE 285,A00,094334,Touri; Behrouz,0,0,0,0
1653544414503,ECE 289,A00,091097,Whelan; David Arthur,0,0,0,0
1653544415025,MATH 200A,A00,087414,Salehi Golsefidy; Alireza,7,0,8,1
1653544415552,MATH 202A,A00,087415,Gill; Philip E.,2,0,8,6
1653544416074,MATH 203A,A00,087416,Oprea; Dragos N.,6,0,8,2
1653544416598,MATH 204A,A00,087417,Kedlaya; Kiran S.,6,0,8,2
1653544417130,MATH 205,A00,087418,Sorensen; Claus M,6,0,8,2
1653544417654,MATH 206A,A00,087419,Izadi; Elham,7,0,8,1
1653544418177,MATH 207A,A00,087420,Mohammadi; Amir,5,0,8,3
1653544418700,MATH 208,A00,087421,Staff,9,0,10,1
1653544419223,MATH 209,A00,087422,Staff,10,0,10,0
1653544419746,MATH 218,A00,087423,Staff,10,0,10,0
1653544420275,MATH 220A,A00,087424,Novak; Jonathan I,6,0,8,2
1653544420798,MATH 231A,A00,087425,Bejenaru; Ioan,3,0,8,5
1653544421330,MATH 240A,A00,087426,Ebenfelt; Peter F,5,0,8,3
1653544421854,MATH 243,A00,087427,Staff,9,0,10,1
1653544422377,MATH 248,A00,087429,Staff,10,0,10,0
1653544422974,MATH 250A,A00,087430,Spolaor; Luca,4,0,8,4
1653544423497,MATH 257A,A00,087431,Spolaor; Luca,7,0,8,1
1653544424021,MATH 258,A00,087432,Staff,9,0,10,1
1653544424547,MATH 264A,A00,087433,Warnke; Lutz Peter,5,0,8,3
1653544425072,MATH 268,A00,087434,Staff,15,0,15,0
1653544425598,MATH 269,A00,087435,Staff,14,0,15,1
1653544426121,MATH 270A,A00,087436,Nie; Jiawang,0,0,8,8
1653544426647,MATH 272A,A00,087437,Tian; Xiaochuan,1,0,8,7
1653544427170,MATH 274,A01,087439,Cheng; Li-Tien,9,0,10,1
1653544427170,MATH 274,A02,087440,Cheng; Li-Tien,10,0,10,0
1653544427703,MATH 278A,A00,087441,Staff,8,0,10,2
1653544428224,MATH 278B,A00,087442,Staff,8,0,10,2
1653544428749,MATH 278C,A00,087443,Staff,8,0,10,2
1653544429271,MATH 280A,A00,087444,Zheng; Tianyi,0,0,8,8
1653544429803,MATH 281A,A00,087445,Bradic; Jelena,0,0,8,8
1653544430326,MATH 282A,A00,087446,Zhang; Danna,0,0,8,8
1653544430848,MATH 283,A00,087447,Tesler; Glenn,0,0,0,15
1653544431371,MATH 286,A00,087448,Kemp; Todd Aahron,5,0,8,3
1653544431904,MATH 287D,A00,087449,Bradic; Jelena,0,0,0,0
1653544432430,MATH 288,A00,087450,Staff,14,0,15,1
1653544432430,MATH 288,B00,087451,Staff,15,0,15,0
1653544432430,MATH 288,C00,087452,Staff,15,0,15,0
1653544432957,MATH 290A,A00,087453,Xu; Zhouli,6,0,8,2
1653544433480,MATH 291A,A00,087454,Xu; Zhouli,7,0,8,1
1653544434005,MATH 292,A00,087455,Staff,10,0,10,0
1653544434529,MATH 295,A00,087456,Staff,50,0,50,0
1653544435051,MATH 297,001,087457,Staff,998,0,999,1
1653544994898,COGS 200,A01,087991,Staff,47,0,50,3
1653544995432,COGS 201,A01,094504,Rangel; Lara M,17,0,25,8
1653544995966,COGS 203,A00,087992,Coulson; Seana M,18,0,20,2
1653544996494,COGS 210A,001,087993,Greene; Deanna Jacquelyn,9998,0,9999,1
1653544996494,COGS 210A,002,087994,Saygin; Ayse P,9999,0,9999,0
1653544996494,COGS 210A,003,087995,Xia; Haijun,9999,0,9999,0
1653544996494,COGS 210A,004,087996,Nitz; Douglas A.,9999,0,9999,0
1653544996494,COGS 210A,005,087997,Hollan; James D.,9999,0,9999,0
1653544996494,COGS 210A,006,087998,Deak; Gedeon O.,9998,0,9999,1
1653544996494,COGS 210A,007,087999,Rossano; Federico,9999,0,9999,0
1653544997025,COGS 211A,A00,088000,Coulson; Seana M,9997,0,9999,2
1653544997551,COGS 229,A00,088002,Staff,23,0,25,2
1653544998085,COGS 260,B00,094231,Staff,17,0,20,3
1653544998085,COGS 260,A00,088004,Nitz; Douglas A.,9998,0,9999,1
1653544998625,CSE 202,A00,090110,Paturi; Ramamohan,0,0,0,0
1653544998625,CSE 202,B00,090111,Paturi; Ramamohan,0,0,0,0
1653544999148,CSE 207B,A00,090112,Heninger; Nadia A,0,0,0,0
1653544999687,CSE 208,A00,094858,Micciancio; Daniele,0,0,0,0
1653545000212,CSE 210,A00,090113,Powell; Thomas Allan,0,0,0,0
1653545000738,CSE 219,A00,090898,Staff,0,0,0,0
1653545001260,CSE 221,A00,090114,Zhou; Yuan-Yuan,0,0,0,0
1653545001783,CSE 229A,A00,090115,Porter; George M,0,0,0,0
1653545002309,CSE 229C,A00,090116,Savage; Stefan,0,0,0,0
1653545002832,CSE 230,A00,090117,Jhala; Ranjit,0,0,0,0
1653545003359,CSE 232,A00,090118,Papakonstantinou; Yannis,0,0,0,0
1653545003884,CSE 239A,A00,090121,Kumar; Arun Kumar,0,0,0,0
1653545004409,CSE 239B,A00,090122,Jhala; Ranjit,0,0,0,0
1653545004936,CSE 240A,A00,090123,Zhao; Jishen,0,0,189,189
1653545005465,CSE 243A,A00,090124,Orailoglu; Alex,0,0,15,15
1653545006002,CSE 249B,A00,090125,Kahng; Andrew Byun,13,0,20,7
1653545006527,CSE 250A,A00,090126,Berg-Kirkpatrick; Taylor D,0,0,0,0
1653545007054,CSE 252A,A00,090127,Ochoa; Benjamin Lawrence,0,0,0,0
1653545007576,CSE 258,A01,090129,McAuley; Julian John,0,0,0,0
1653545008098,CSE 258R,A01,090131,McAuley; Julian John,0,0,0,0
1653545008622,CSE 274,A00,090132,Ramamoorthi; Ravi,0,0,0,0
1653545009159,CSE 276A,A00,090133,Christensen; Henrik I,0,0,0,0
1653545009681,CSE 276C,A00,090134,Christensen; Henrik I,0,0,0,0
1653545010284,CSE 290,A00,090135,Bafna; Vineet,0,0,0,0
1653545010284,CSE 290,B00,090136,Ramamoorthi; Ravi,0,0,0,0
1653545010284,CSE 290,C00,090137,Li; Tzumao,8,0,10,2
1653545010284,CSE 290,D00,090138,Zhou; Yuan-Yuan,9,0,10,1
1653545010284,CSE 290,E00,090139,Christensen; Henrik I,8,0,10,2
1653545010284,CSE 290,F00,094053,Shalev; Aaron D,0,0,0,0
1653545010810,CSE 291,A00,090140,Munyaka; Imani N. S.,0,0,0,0
1653545010810,CSE 291,B00,094880,Yu; Qi,0,0,0,0
1653545010810,CSE 291,C00,090142,Pannuto; Patrick William,0,0,0,0
1653545010810,CSE 291,D00,094881,Zhang; Yiying,0,0,0,0
1653545010810,CSE 291,E00,095118,Su; Hao,0,0,0,0
1653545011336,CSE 293,001,094905,Bafna; Vineet,9999,0,9999,0
1653545011336,CSE 293,002,094906,Bellare; Mihir,9999,0,9999,0
1653545011336,CSE 293,003,094907,Berg-Kirkpatrick; Taylor D,9999,0,9999,0
1653545011336,CSE 293,004,094908,Christensen; Henrik I,9999,0,9999,0
1653545011336,CSE 293,005,094909,Cottrell; Garrison W,9999,0,9999,0
1653545011336,CSE 293,006,094910,Deutsch; Alin Bernard,9999,0,9999,0
1653545011336,CSE 293,007,094911,Esmaeilzadeh; Hadi,9999,0,9999,0
1653545011336,CSE 293,008,094912,Freund; Yoav,9999,0,9999,0
1653545011336,CSE 293,009,094913,Griswold; William G.,9999,0,9999,0
1653545011336,CSE 293,010,094914,Gymrek; Melissa Ann,9999,0,9999,0
1653545011336,CSE 293,011,094915,Heninger; Nadia A,9999,0,9999,0
1653545011336,CSE 293,012,094916,Impagliazzo; Russell,9999,0,9999,0
1653545011336,CSE 293,013,094917,Jhala; Ranjit,9999,0,9999,0
1653545011336,CSE 293,014,094918,Kahng; Andrew Byun,9999,0,9999,0
1653545011336,CSE 293,015,094919,Kane; Daniel Mertz,9999,0,9999,0
1653545011336,CSE 293,016,094920,Kriegman; David J,9999,0,9999,0
1653545011336,CSE 293,017,094921,Kumar; Arun Kumar,9999,0,9999,0
1653545011336,CSE 293,018,094922,Lerner; Sorin,9999,0,9999,0
1653545011336,CSE 293,019,094923,Lovett; Shachar,9999,0,9999,0
1653545011336,CSE 293,020,094924,McAuley; Julian John,9999,0,9999,0
1653545011336,CSE 293,021,094925,Micciancio; Daniele,9999,0,9999,0
1653545011336,CSE 293,022,094926,Orailoglu; Alex,9999,0,9999,0
1653545011336,CSE 293,023,094927,Paturi; Ramamohan,9999,0,9999,0
1653545011336,CSE 293,024,094928,Polikarpova; Nadezhda,9999,0,9999,0
1653545011336,CSE 293,025,094929,Politz; Joseph Gibbs,9999,0,9999,0
1653545011336,CSE 293,026,094930,Porter; George M,9999,0,9999,0
1653545011336,CSE 293,027,094931,Porter; Leonard Emerson,9999,0,9999,0
1653545011336,CSE 293,028,094932,Ramamoorthi; Ravi,9999,0,9999,0
1653545011336,CSE 293,029,094933,Sahoo; Debashis,9999,0,9999,0
1653545011336,CSE 293,030,094934,Saul; Lawrence,9999,0,9999,0
1653545011336,CSE 293,031,094935,Savage; Stefan,9999,0,9999,0
1653545011336,CSE 293,032,094936,Schulze; Jurgen P.,9999,0,9999,0
1653545011336,CSE 293,033,094937,Snoeren; Alex C.,9999,0,9999,0
1653545011336,CSE 293,034,094938,Shang; Jingbo,9999,0,9999,0
1653545011336,CSE 293,035,094939,Stefan; Deian,9999,0,9999,0
1653545011336,CSE 293,036,094940,Su; Hao,9999,0,9999,0
1653545011336,CSE 293,037,094941,Swanson; Steven James,9999,0,9999,0
1653545011336,CSE 293,038,094942,Tullsen; Dean Michael,9999,0,9999,0
1653545011336,CSE 293,039,094943,Voelker; Geoffrey M.,9999,0,9999,0
1653545011336,CSE 293,040,094944,Zhao; Jishen,9999,0,9999,0
1653545011336,CSE 293,041,094945,Zhou; Yuan-Yuan,9999,0,9999,0
1653545011336,CSE 293,042,094946,Gao; Sicun,9998,0,9999,1
1653545011336,CSE 293,043,094947,Weibel; Nadir,9999,0,9999,0
1653545011336,CSE 293,044,094948,Gupta; Rajesh K.,9999,0,9999,0
1653545011859,CSE 294,A00,090143,Porter; George M,8,0,10,2
1653545012382,DSE 200,A00,091799,Staff,50,0,50,0
1653545012910,DSE 203,A00,091800,Gupta; Amarnath,30,0,30,0
1653545013434,DSE 250,A00,091801,Deutsch; Alin Bernard,30,0,30,0
1653545013962,DSE 290,A00,091802,Altintas De Callaf; Ilkay,50,0,50,0
1653545014520,ECE 200,001,091003,Antipa; Nicholas A,9999,0,9999,0
1653545014520,ECE 200,002,091004,Atanasov; Nikolay A.,9999,0,9999,0
1653545014520,ECE 200,003,091005,Bharadia; Dinesh,9999,0,9999,0
1653545014520,ECE 200,004,091006,Cheng; Chung Kuan,9999,0,9999,0
1653545014520,ECE 200,005,091007,Cosman; Pamela C.,9999,0,9999,0
1653545014520,ECE 200,006,091008,Staff,9999,0,9999,0
1653545014520,ECE 200,007,091009,Dayeh; Shadi Ahmad,9999,0,9999,0
1653545014520,ECE 200,008,091010,Fainman; Yeshaiahu,9999,0,9999,0
1653545014520,ECE 200,009,091011,Ford; Joseph Earl,9999,0,9999,0
1653545014520,ECE 200,010,091012,Franceschetti; Massimo,9999,0,9999,0
1653545014520,ECE 200,011,091013,Fullerton; Eric E,9999,0,9999,0
1653545014520,ECE 200,012,091014,Galton; Ian A,9999,0,9999,0
1653545014520,ECE 200,013,091015,Gilja; Vikash,9999,0,9999,0
1653545014520,ECE 200,014,091016,Hall; Drew A.,9999,0,9999,0
1653545014520,ECE 200,015,091017,Hsueh; Tzu-Chien,9999,0,9999,0
1653545014520,ECE 200,016,091018,Javidi; Tara,9999,0,9999,0
1653545014520,ECE 200,017,091019,Kahng; Andrew Byun,9999,0,9999,0
1653545014520,ECE 200,018,091020,Kim; Young-Han,9999,0,9999,0
1653545014520,ECE 200,019,091021,Koushanfar; Farinaz,9999,0,9999,0
1653545014520,ECE 200,020,091022,Kuzum; Duygu,9999,0,9999,0
1653545014520,ECE 200,021,091023,Le; Hanh-Phuc,9999,0,9999,0
1653545014520,ECE 200,022,091024,Lin; Bill,9999,0,9999,0
1653545014520,ECE 200,023,091025,Liu; Zhaowei,9999,0,9999,0
1653545014520,ECE 200,024,091026,Lo; Yu-Hwa,9999,0,9999,0
1653545014520,ECE 200,025,091027,Lomakin; Vitaliy,9999,0,9999,0
1653545014520,ECE 200,026,091028,Mercier; Patrick Philip,9999,0,9999,0
1653545014520,ECE 200,027,091029,Meyer; Florian,9999,0,9999,0
1653545014520,ECE 200,028,091030,Milstein; Laurence B.,9999,0,9999,0
1653545014520,ECE 200,029,091031,Mir Arabbaygi; Siavash,9999,0,9999,0
1653545014520,ECE 200,030,091032,Mookherjea; Shayan,9999,0,9999,0
1653545014520,ECE 200,031,091033,Morris; Karcher William,9999,0,9999,0
1653545014520,ECE 200,032,091034,Ng; Tse Nga,9999,0,9999,0
1653545014520,ECE 200,033,091035,Nguyen; Truong Quang,9999,0,9999,0
1653545014520,ECE 200,034,091036,Nomura; Kenji,9999,0,9999,0
1653545014520,ECE 200,035,091037,Orlitsky; Alon,9999,0,9999,0
1653545014520,ECE 200,036,091038,Pal; Piya,9999,0,9999,0
1653545014520,ECE 200,037,091039,Papen; George C.,9999,0,9999,0
1653545014520,ECE 200,038,091040,Radic; Stojan,9999,0,9999,0
1653545014520,ECE 200,039,091041,Rao; Bhaskar D.,9999,0,9999,0
1653545014520,ECE 200,040,091042,Rao; Ramesh R,9999,0,9999,0
1653545014520,ECE 200,041,091043,Rebeiz; Gabriel,9999,0,9999,0
1653545014520,ECE 200,042,091044,Sanford; John R,9999,0,9999,0
1653545014520,ECE 200,043,091045,Siegel; Paul H.,9999,0,9999,0
1653545014520,ECE 200,044,091046,Sievenpiper; Daniel F.,9999,0,9999,0
1653545014520,ECE 200,045,091047,Sworder; David D.,9999,0,9999,0
1653545014520,ECE 200,046,091048,Taur; Yuan,9999,0,9999,0
1653545014520,ECE 200,047,091049,Touri; Behrouz,9999,0,9999,0
1653545014520,ECE 200,048,091050,Trivedi; Mohan M.,9999,0,9999,0
1653545014520,ECE 200,049,091051,Vardy; Alexander,9999,0,9999,0
1653545014520,ECE 200,050,091052,Vasconcelos; Nuno,9999,0,9999,0
1653545014520,ECE 200,051,091053,Wang; Xiaolong,9999,0,9999,0
1653545014520,ECE 200,052,091054,Xie; Pengtao,9999,0,9999,0
1653545014520,ECE 200,053,091055,Yip; Michael,9999,0,9999,0
1653545014520,ECE 200,054,091056,Zeger; Kenneth A.,9999,0,9999,0
1653545014520,ECE 200,055,091057,Zhang; Xinyu,9999,0,9999,0
1653545014520,ECE 200,056,091058,Turakhia; Yatish Girish,9999,0,9999,0
1653545014520,ECE 200,057,091059,Kang; Mingu,9999,0,9999,0
1653545014520,ECE 200,058,091060,Shi; Yuanyuan,9999,0,9999,0
1653545014520,ECE 200,059,091061,Wang; Edward Jay,9999,0,9999,0
1653545014520,ECE 200,060,091062,Zheng; Yang,9999,0,9999,0
1653545015045,ECE 201,A00,095526,Lo; Yu-Hwa,0,0,0,0
1653545015572,ECE 203,A00,091065,Mercier; Patrick Philip,0,0,0,0
1653545016104,ECE 207A,A00,091605,Liu; Thomas Tao-Ming,0,0,0,0
1653545016642,ECE 212AN,A00,091068,Nomura; Kenji,0,0,0,0
1653545017178,ECE 222A,A00,091069,Rebeiz; Gabriel,0,0,0,0
1653545017711,ECE 225A,A00,091070,Orlitsky; Alon,0,0,0,0
1653545018235,ECE 230A,A00,091071,Nomura; Kenji,0,0,0,0
1653545018759,ECE 236A,A00,091072,Dayeh; Shadi Ahmad,0,0,0,0
1653545019295,ECE 238A,A00,091073,Luo; Jian,0,0,0,0
1653545019295,ECE 238A,B00,091074,Luo; Jian,0,0,0,0
1653545019839,ECE 240A,A00,091075,Radic; Stojan,0,0,0,0
1653545020368,ECE 247A,A00,091592,Shi; Lingyan,0,0,0,0
1653545020894,ECE 250,A00,091076,Touri; Behrouz,0,0,0,0
1653545021437,ECE 251C,A00,091078,Nguyen; Truong Quang,0,0,0,0
1653545021961,ECE 253,A00,091079,Cosman; Pamela C.,0,0,0,0
1653545022486,ECE 255A,A00,091080,Orlitsky; Alon,0,0,0,0
1653545023011,ECE 257A,A00,091081,Zhang; Xinyu,0,0,0,0
1653545023538,ECE 260A,A01,091084,Eldon; John,0,0,0,0
1653545024066,ECE 264C,A00,091085,Galton; Ian A,0,0,0,0
1653545024592,ECE 265C,A00,094889,Presti; Calogero Davide,0,0,0,9
1653545025114,ECE 266,A01,091087,Hall; Drew A.,0,0,0,0
1653545026166,ECE 271A,A00,091090,Vasconcelos; Nuno,0,0,0,0
1653545026689,ECE 272B,A00,091091,Sworder; David D.,0,0,0,0
1653545027216,ECE 275A,A00,091092,Meyer; Florian,0,0,0,0
1653545027740,ECE 277,A00,091093,An; Cheolhong,0,0,0,0
1653545028271,ECE 283,A00,091094,Le; Hanh-Phuc,0,0,0,0
1653545028820,ECE 284,A00,091095,Kang; Mingu,0,0,0,0
1653545028820,ECE 284,B00,091096,Wang; Edward Jay,0,0,0,0
1653545029350,ECE 285,A00,094334,Touri; Behrouz,0,0,0,0
1653545029874,ECE 289,A00,091097,Whelan; David Arthur,0,0,0,0
1653545030407,MATH 200A,A00,087414,Salehi Golsefidy; Alireza,7,0,8,1
1653545030948,MATH 202A,A00,087415,Gill; Philip E.,2,0,8,6
1653545031471,MATH 203A,A00,087416,Oprea; Dragos N.,6,0,8,2
1653545031996,MATH 204A,A00,087417,Kedlaya; Kiran S.,6,0,8,2
1653545032520,MATH 205,A00,087418,Sorensen; Claus M,6,0,8,2
1653545033043,MATH 206A,A00,087419,Izadi; Elham,7,0,8,1
1653545033572,MATH 207A,A00,087420,Mohammadi; Amir,5,0,8,3
1653545034106,MATH 208,A00,087421,Staff,9,0,10,1
1653545034634,MATH 209,A00,087422,Staff,10,0,10,0
1653545035173,MATH 218,A00,087423,Staff,10,0,10,0
1653545035699,MATH 220A,A00,087424,Novak; Jonathan I,6,0,8,2
1653545036231,MATH 231A,A00,087425,Bejenaru; Ioan,3,0,8,5
1653545036772,MATH 240A,A00,087426,Ebenfelt; Peter F,5,0,8,3
1653545037300,MATH 243,A00,087427,Staff,9,0,10,1
1653545037823,MATH 248,A00,087429,Staff,10,0,10,0
1653545038351,MATH 250A,A00,087430,Spolaor; Luca,4,0,8,4
1653545038887,MATH 257A,A00,087431,Spolaor; Luca,7,0,8,1
1653545039418,MATH 258,A00,087432,Staff,9,0,10,1
1653545039947,MATH 264A,A00,087433,Warnke; Lutz Peter,5,0,8,3
1653545040485,MATH 268,A00,087434,Staff,15,0,15,0
1653545041015,MATH 269,A00,087435,Staff,14,0,15,1
1653545041542,MATH 270A,A00,087436,Nie; Jiawang,0,0,8,8
1653545042076,MATH 272A,A00,087437,Tian; Xiaochuan,1,0,8,7
1653545042606,MATH 274,A01,087439,Cheng; Li-Tien,9,0,10,1
1653545042606,MATH 274,A02,087440,Cheng; Li-Tien,10,0,10,0
1653545043131,MATH 278A,A00,087441,Staff,8,0,10,2
1653545043655,MATH 278B,A00,087442,Staff,8,0,10,2
1653545044181,MATH 278C,A00,087443,Staff,8,0,10,2
1653545044710,MATH 280A,A00,087444,Zheng; Tianyi,0,0,8,8
1653545045238,MATH 281A,A00,087445,Bradic; Jelena,0,0,8,8
1653545045763,MATH 282A,A00,087446,Zhang; Danna,0,0,8,8
1653545046287,MATH 283,A00,087447,Tesler; Glenn,0,0,0,15
1653545046810,MATH 286,A00,087448,Kemp; Todd Aahron,5,0,8,3
1653545047334,MATH 287D,A00,087449,Bradic; Jelena,0,0,0,0
1653545047861,MATH 288,A00,087450,Staff,14,0,15,1
1653545047861,MATH 288,B00,087451,Staff,15,0,15,0
1653545047861,MATH 288,C00,087452,Staff,15,0,15,0
1653545048388,MATH 290A,A00,087453,Xu; Zhouli,6,0,8,2
1653545048918,MATH 291A,A00,087454,Xu; Zhouli,7,0,8,1
1653545049440,MATH 292,A00,087455,Staff,10,0,10,0
1653545049963,MATH 295,A00,087456,Staff,50,0,50,0
1653545050487,MATH 297,001,087457,Staff,998,0,999,1
1653545611084,COGS 200,A01,087991,Staff,47,0,50,3
1653545611610,COGS 201,A01,094504,Rangel; Lara M,17,0,25,8
1653545612136,COGS 203,A00,087992,Coulson; Seana M,18,0,20,2
1653545612673,COGS 210A,001,087993,Greene; Deanna Jacquelyn,9998,0,9999,1
1653545612673,COGS 210A,002,087994,Saygin; Ayse P,9999,0,9999,0
1653545612673,COGS 210A,003,087995,Xia; Haijun,9999,0,9999,0
1653545612673,COGS 210A,004,087996,Nitz; Douglas A.,9999,0,9999,0
1653545612673,COGS 210A,005,087997,Hollan; James D.,9999,0,9999,0
1653545612673,COGS 210A,006,087998,Deak; Gedeon O.,9998,0,9999,1
1653545612673,COGS 210A,007,087999,Rossano; Federico,9999,0,9999,0
1653545613197,COGS 211A,A00,088000,Coulson; Seana M,9997,0,9999,2
1653545613723,COGS 229,A00,088002,Staff,23,0,25,2
1653545614259,COGS 260,B00,094231,Staff,17,0,20,3
1653545614259,COGS 260,A00,088004,Nitz; Douglas A.,9998,0,9999,1
1653545614782,CSE 202,A00,090110,Paturi; Ramamohan,0,0,0,0
1653545614782,CSE 202,B00,090111,Paturi; Ramamohan,0,0,0,0
1653545615315,CSE 207B,A00,090112,Heninger; Nadia A,0,0,0,0
1653545615856,CSE 208,A00,094858,Micciancio; Daniele,0,0,0,0
1653545616377,CSE 210,A00,090113,Powell; Thomas Allan,0,0,0,0
1653545616904,CSE 219,A00,090898,Staff,0,0,0,0
1653545617427,CSE 221,A00,090114,Zhou; Yuan-Yuan,0,0,0,0
1653545617952,CSE 229A,A00,090115,Porter; George M,0,0,0,0
1653545618475,CSE 229C,A00,090116,Savage; Stefan,0,0,0,0
1653545619013,CSE 230,A00,090117,Jhala; Ranjit,0,0,0,0
1653545619548,CSE 232,A00,090118,Papakonstantinou; Yannis,0,0,0,0
1653545620072,CSE 239A,A00,090121,Kumar; Arun Kumar,0,0,0,0
1653545620598,CSE 239B,A00,090122,Jhala; Ranjit,0,0,0,0
1653545621132,CSE 240A,A00,090123,Zhao; Jishen,0,0,189,189
1653545621655,CSE 243A,A00,090124,Orailoglu; Alex,0,0,15,15
1653545622176,CSE 249B,A00,090125,Kahng; Andrew Byun,13,0,20,7
1653545622704,CSE 250A,A00,090126,Berg-Kirkpatrick; Taylor D,0,0,0,0
1653545623230,CSE 252A,A00,090127,Ochoa; Benjamin Lawrence,0,0,0,0
1653545623757,CSE 258,A01,090129,McAuley; Julian John,0,0,0,0
1653545624280,CSE 258R,A01,090131,McAuley; Julian John,0,0,0,0
1653545624806,CSE 274,A00,090132,Ramamoorthi; Ravi,0,0,0,0
1653545625329,CSE 276A,A00,090133,Christensen; Henrik I,0,0,0,0
1653545625864,CSE 276C,A00,090134,Christensen; Henrik I,0,0,0,0
1653545626387,CSE 290,A00,090135,Bafna; Vineet,0,0,0,0
1653545626387,CSE 290,B00,090136,Ramamoorthi; Ravi,0,0,0,0
1653545626387,CSE 290,C00,090137,Li; Tzumao,8,0,10,2
1653545626387,CSE 290,D00,090138,Zhou; Yuan-Yuan,9,0,10,1
1653545626387,CSE 290,E00,090139,Christensen; Henrik I,8,0,10,2
1653545626387,CSE 290,F00,094053,Shalev; Aaron D,0,0,0,0
1653545626911,CSE 291,A00,090140,Munyaka; Imani N. S.,0,0,0,0
1653545626911,CSE 291,B00,094880,Yu; Qi,0,0,0,0
1653545626911,CSE 291,C00,090142,Pannuto; Patrick William,0,0,0,0
1653545626911,CSE 291,D00,094881,Zhang; Yiying,0,0,0,0
1653545626911,CSE 291,E00,095118,Su; Hao,0,0,0,0
1653545627442,CSE 293,001,094905,Bafna; Vineet,9999,0,9999,0
1653545627442,CSE 293,002,094906,Bellare; Mihir,9999,0,9999,0
1653545627442,CSE 293,003,094907,Berg-Kirkpatrick; Taylor D,9999,0,9999,0
1653545627442,CSE 293,004,094908,Christensen; Henrik I,9999,0,9999,0
1653545627442,CSE 293,005,094909,Cottrell; Garrison W,9999,0,9999,0
1653545627442,CSE 293,006,094910,Deutsch; Alin Bernard,9999,0,9999,0
1653545627442,CSE 293,007,094911,Esmaeilzadeh; Hadi,9999,0,9999,0
1653545627442,CSE 293,008,094912,Freund; Yoav,9999,0,9999,0
1653545627442,CSE 293,009,094913,Griswold; William G.,9999,0,9999,0
1653545627442,CSE 293,010,094914,Gymrek; Melissa Ann,9999,0,9999,0
1653545627442,CSE 293,011,094915,Heninger; Nadia A,9999,0,9999,0
1653545627442,CSE 293,012,094916,Impagliazzo; Russell,9999,0,9999,0
1653545627442,CSE 293,013,094917,Jhala; Ranjit,9999,0,9999,0
1653545627442,CSE 293,014,094918,Kahng; Andrew Byun,9999,0,9999,0
1653545627442,CSE 293,015,094919,Kane; Daniel Mertz,9999,0,9999,0
1653545627442,CSE 293,016,094920,Kriegman; David J,9999,0,9999,0
1653545627442,CSE 293,017,094921,Kumar; Arun Kumar,9999,0,9999,0
1653545627442,CSE 293,018,094922,Lerner; Sorin,9999,0,9999,0
1653545627442,CSE 293,019,094923,Lovett; Shachar,9999,0,9999,0
1653545627442,CSE 293,020,094924,McAuley; Julian John,9999,0,9999,0
1653545627442,CSE 293,021,094925,Micciancio; Daniele,9999,0,9999,0
1653545627442,CSE 293,022,094926,Orailoglu; Alex,9999,0,9999,0
1653545627442,CSE 293,023,094927,Paturi; Ramamohan,9999,0,9999,0
1653545627442,CSE 293,024,094928,Polikarpova; Nadezhda,9999,0,9999,0
1653545627442,CSE 293,025,094929,Politz; Joseph Gibbs,9999,0,9999,0
1653545627442,CSE 293,026,094930,Porter; George M,9999,0,9999,0
1653545627442,CSE 293,027,094931,Porter; Leonard Emerson,9999,0,9999,0
1653545627442,CSE 293,028,094932,Ramamoorthi; Ravi,9999,0,9999,0
1653545627442,CSE 293,029,094933,Sahoo; Debashis,9999,0,9999,0
1653545627442,CSE 293,030,094934,Saul; Lawrence,9999,0,9999,0
1653545627442,CSE 293,031,094935,Savage; Stefan,9999,0,9999,0
1653545627442,CSE 293,032,094936,Schulze; Jurgen P.,9999,0,9999,0
1653545627442,CSE 293,033,094937,Snoeren; Alex C.,9999,0,9999,0
1653545627442,CSE 293,034,094938,Shang; Jingbo,9999,0,9999,0
1653545627442,CSE 293,035,094939,Stefan; Deian,9999,0,9999,0
1653545627442,CSE 293,036,094940,Su; Hao,9999,0,9999,0
1653545627442,CSE 293,037,094941,Swanson; Steven James,9999,0,9999,0
1653545627442,CSE 293,038,094942,Tullsen; Dean Michael,9999,0,9999,0
1653545627442,CSE 293,039,094943,Voelker; Geoffrey M.,9999,0,9999,0
1653545627442,CSE 293,040,094944,Zhao; Jishen,9999,0,9999,0
1653545627442,CSE 293,041,094945,Zhou; Yuan-Yuan,9999,0,9999,0
1653545627442,CSE 293,042,094946,Gao; Sicun,9998,0,9999,1
1653545627442,CSE 293,043,094947,Weibel; Nadir,9999,0,9999,0
1653545627442,CSE 293,044,094948,Gupta; Rajesh K.,9999,0,9999,0
1653545627963,CSE 294,A00,090143,Porter; George M,8,0,10,2
1653545628486,DSE 200,A00,091799,Staff,50,0,50,0
1653545629013,DSE 203,A00,091800,Gupta; Amarnath,30,0,30,0
1653545629538,DSE 250,A00,091801,Deutsch; Alin Bernard,30,0,30,0
1653545630062,DSE 290,A00,091802,Altintas De Callaf; Ilkay,50,0,50,0
1653545630614,ECE 200,001,091003,Antipa; Nicholas A,9999,0,9999,0
1653545630614,ECE 200,002,091004,Atanasov; Nikolay A.,9999,0,9999,0
1653545630614,ECE 200,003,091005,Bharadia; Dinesh,9999,0,9999,0
1653545630614,ECE 200,004,091006,Cheng; Chung Kuan,9999,0,9999,0
1653545630614,ECE 200,005,091007,Cosman; Pamela C.,9999,0,9999,0
1653545630614,ECE 200,006,091008,Staff,9999,0,9999,0
1653545630614,ECE 200,007,091009,Dayeh; Shadi Ahmad,9999,0,9999,0
1653545630614,ECE 200,008,091010,Fainman; Yeshaiahu,9999,0,9999,0
1653545630614,ECE 200,009,091011,Ford; Joseph Earl,9999,0,9999,0
1653545630614,ECE 200,010,091012,Franceschetti; Massimo,9999,0,9999,0
1653545630614,ECE 200,011,091013,Fullerton; Eric E,9999,0,9999,0
1653545630614,ECE 200,012,091014,Galton; Ian A,9999,0,9999,0
1653545630614,ECE 200,013,091015,Gilja; Vikash,9999,0,9999,0
1653545630614,ECE 200,014,091016,Hall; Drew A.,9999,0,9999,0
1653545630614,ECE 200,015,091017,Hsueh; Tzu-Chien,9999,0,9999,0
1653545630614,ECE 200,016,091018,Javidi; Tara,9999,0,9999,0
1653545630614,ECE 200,017,091019,Kahng; Andrew Byun,9999,0,9999,0
1653545630614,ECE 200,018,091020,Kim; Young-Han,9999,0,9999,0
1653545630614,ECE 200,019,091021,Koushanfar; Farinaz,9999,0,9999,0
1653545630614,ECE 200,020,091022,Kuzum; Duygu,9999,0,9999,0
1653545630614,ECE 200,021,091023,Le; Hanh-Phuc,9999,0,9999,0
1653545630614,ECE 200,022,091024,Lin; Bill,9999,0,9999,0
1653545630614,ECE 200,023,091025,Liu; Zhaowei,9999,0,9999,0
1653545630614,ECE 200,024,091026,Lo; Yu-Hwa,9999,0,9999,0
1653545630614,ECE 200,025,091027,Lomakin; Vitaliy,9999,0,9999,0
1653545630614,ECE 200,026,091028,Mercier; Patrick Philip,9999,0,9999,0
1653545630614,ECE 200,027,091029,Meyer; Florian,9999,0,9999,0
1653545630614,ECE 200,028,091030,Milstein; Laurence B.,9999,0,9999,0
1653545630614,ECE 200,029,091031,Mir Arabbaygi; Siavash,9999,0,9999,0
1653545630614,ECE 200,030,091032,Mookherjea; Shayan,9999,0,9999,0
1653545630614,ECE 200,031,091033,Morris; Karcher William,9999,0,9999,0
1653545630614,ECE 200,032,091034,Ng; Tse Nga,9999,0,9999,0
1653545630614,ECE 200,033,091035,Nguyen; Truong Quang,9999,0,9999,0
1653545630614,ECE 200,034,091036,Nomura; Kenji,9999,0,9999,0
1653545630614,ECE 200,035,091037,Orlitsky; Alon,9999,0,9999,0
1653545630614,ECE 200,036,091038,Pal; Piya,9999,0,9999,0
1653545630614,ECE 200,037,091039,Papen; George C.,9999,0,9999,0
1653545630614,ECE 200,038,091040,Radic; Stojan,9999,0,9999,0
1653545630614,ECE 200,039,091041,Rao; Bhaskar D.,9999,0,9999,0
1653545630614,ECE 200,040,091042,Rao; Ramesh R,9999,0,9999,0
1653545630614,ECE 200,041,091043,Rebeiz; Gabriel,9999,0,9999,0
1653545630614,ECE 200,042,091044,Sanford; John R,9999,0,9999,0
1653545630614,ECE 200,043,091045,Siegel; Paul H.,9999,0,9999,0
1653545630614,ECE 200,044,091046,Sievenpiper; Daniel F.,9999,0,9999,0
1653545630614,ECE 200,045,091047,Sworder; David D.,9999,0,9999,0
1653545630614,ECE 200,046,091048,Taur; Yuan,9999,0,9999,0
1653545630614,ECE 200,047,091049,Touri; Behrouz,9999,0,9999,0
1653545630614,ECE 200,048,091050,Trivedi; Mohan M.,9999,0,9999,0
1653545630614,ECE 200,049,091051,Vardy; Alexander,9999,0,9999,0
1653545630614,ECE 200,050,091052,Vasconcelos; Nuno,9999,0,9999,0
1653545630614,ECE 200,051,091053,Wang; Xiaolong,9999,0,9999,0
1653545630614,ECE 200,052,091054,Xie; Pengtao,9999,0,9999,0
1653545630614,ECE 200,053,091055,Yip; Michael,9999,0,9999,0
1653545630614,ECE 200,054,091056,Zeger; Kenneth A.,9999,0,9999,0
1653545630614,ECE 200,055,091057,Zhang; Xinyu,9999,0,9999,0
1653545630614,ECE 200,056,091058,Turakhia; Yatish Girish,9999,0,9999,0
1653545630614,ECE 200,057,091059,Kang; Mingu,9999,0,9999,0
1653545630614,ECE 200,058,091060,Shi; Yuanyuan,9999,0,9999,0
1653545630614,ECE 200,059,091061,Wang; Edward Jay,9999,0,9999,0
1653545630614,ECE 200,060,091062,Zheng; Yang,9999,0,9999,0
1653545631137,ECE 201,A00,095526,Lo; Yu-Hwa,0,0,0,0
1653545631661,ECE 203,A00,091065,Mercier; Patrick Philip,0,0,0,0
1653545632184,ECE 207A,A00,091605,Liu; Thomas Tao-Ming,0,0,0,0
1653545632724,ECE 212AN,A00,091068,Nomura; Kenji,0,0,0,0
1653545633247,ECE 222A,A00,091069,Rebeiz; Gabriel,0,0,0,0
1653545633771,ECE 225A,A00,091070,Orlitsky; Alon,0,0,0,0
1653545634294,ECE 230A,A00,091071,Nomura; Kenji,0,0,0,0
1653545634818,ECE 236A,A00,091072,Dayeh; Shadi Ahmad,0,0,0,0
1653545635342,ECE 238A,A00,091073,Luo; Jian,0,0,0,0
1653545635342,ECE 238A,B00,091074,Luo; Jian,0,0,0,0
1653545635867,ECE 240A,A00,091075,Radic; Stojan,0,0,0,0
1653545636394,ECE 247A,A00,091592,Shi; Lingyan,0,0,0,0
1653545636917,ECE 250,A00,091076,Touri; Behrouz,0,0,0,0
1653545637439,ECE 251C,A00,091078,Nguyen; Truong Quang,0,0,0,0
1653545637966,ECE 253,A00,091079,Cosman; Pamela C.,0,0,0,0
1653545638488,ECE 255A,A00,091080,Orlitsky; Alon,0,0,0,0
1653545639014,ECE 257A,A00,091081,Zhang; Xinyu,0,0,0,0
1653545639546,ECE 260A,A01,091084,Eldon; John,0,0,0,0
1653545640071,ECE 264C,A00,091085,Galton; Ian A,0,0,0,0
1653545640597,ECE 265C,A00,094889,Presti; Calogero Davide,0,0,0,9
1653545641128,ECE 266,A01,091087,Hall; Drew A.,0,0,0,0
1653545642180,ECE 271A,A00,091090,Vasconcelos; Nuno,0,0,0,0
1653545642703,ECE 272B,A00,091091,Sworder; David D.,0,0,0,0
1653545643224,ECE 275A,A00,091092,Meyer; Florian,0,0,0,0
1653545643752,ECE 277,A00,091093,An; Cheolhong,0,0,0,0
1653545644275,ECE 283,A00,091094,Le; Hanh-Phuc,0,0,0,0
1653545644803,ECE 284,A00,091095,Kang; Mingu,0,0,0,0
1653545644803,ECE 284,B00,091096,Wang; Edward Jay,0,0,0,0
1653545645330,ECE 285,A00,094334,Touri; Behrouz,0,0,0,0
1653545645852,ECE 289,A00,091097,Whelan; David Arthur,0,0,0,0
1653545646374,MATH 200A,A00,087414,Salehi Golsefidy; Alireza,7,0,8,1
1653545646902,MATH 202A,A00,087415,Gill; Philip E.,2,0,8,6
1653545647430,MATH 203A,A00,087416,Oprea; Dragos N.,6,0,8,2
1653545647959,MATH 204A,A00,087417,Kedlaya; Kiran S.,6,0,8,2
1653545648487,MATH 205,A00,087418,Sorensen; Claus M,6,0,8,2
1653545649009,MATH 206A,A00,087419,Izadi; Elham,7,0,8,1
1653545649533,MATH 207A,A00,087420,Mohammadi; Amir,5,0,8,3
1653545650064,MATH 208,A00,087421,Staff,9,0,10,1
1653545650595,MATH 209,A00,087422,Staff,10,0,10,0
1653545651129,MATH 218,A00,087423,Staff,10,0,10,0
1653545651725,MATH 220A,A00,087424,Novak; Jonathan I,6,0,8,2
1653545652247,MATH 231A,A00,087425,Bejenaru; Ioan,3,0,8,5
1653545652770,MATH 240A,A00,087426,Ebenfelt; Peter F,5,0,8,3
1653545653292,MATH 243,A00,087427,Staff,9,0,10,1
1653545653824,MATH 248,A00,087429,Staff,10,0,10,0
1653545654347,MATH 250A,A00,087430,Spolaor; Luca,4,0,8,4
1653545654874,MATH 257A,A00,087431,Spolaor; Luca,7,0,8,1
1653545655397,MATH 258,A00,087432,Staff,9,0,10,1
1653545655923,MATH 264A,A00,087433,Warnke; Lutz Peter,5,0,8,3
1653545656454,MATH 268,A00,087434,Staff,15,0,15,0
1653545656976,MATH 269,A00,087435,Staff,14,0,15,1
1653545657500,MATH 270A,A00,087436,Nie; Jiawang,0,0,8,8
1653545658030,MATH 272A,A00,087437,Tian; Xiaochuan,1,0,8,7
1653545658550,MATH 274,A01,087439,Cheng; Li-Tien,9,0,10,1
1653545658550,MATH 274,A02,087440,Cheng; Li-Tien,10,0,10,0
1653545659077,MATH 278A,A00,087441,Staff,8,0,10,2
1653545659602,MATH 278B,A00,087442,Staff,8,0,10,2
1653545660129,MATH 278C,A00,087443,Staff,8,0,10,2
1653545660663,MATH 280A,A00,087444,Zheng; Tianyi,0,0,8,8
1653545661190,MATH 281A,A00,087445,Bradic; Jelena,0,0,8,8
1653545661716,MATH 282A,A00,087446,Zhang; Danna,0,0,8,8
1653545662257,MATH 283,A00,087447,Tesler; Glenn,0,0,0,15
1653545662848,MATH 286,A00,087448,Kemp; Todd Aahron,5,0,8,3
1653545663375,MATH 287D,A00,087449,Bradic; Jelena,0,0,0,0
1653545663904,MATH 288,A00,087450,Staff,14,0,15,1
1653545663904,MATH 288,B00,087451,Staff,15,0,15,0
1653545663904,MATH 288,C00,087452,Staff,15,0,15,0
1653545664430,MATH 290A,A00,087453,Xu; Zhouli,6,0,8,2
1653545664952,MATH 291A,A00,087454,Xu; Zhouli,7,0,8,1
1653545665479,MATH 292,A00,087455,Staff,10,0,10,0
1653545666002,MATH 295,A00,087456,Staff,50,0,50,0
1653545666527,MATH 297,001,087457,Staff,998,0,999,1
1653546226605,COGS 200,A01,087991,Staff,47,0,50,3
1653546227128,COGS 201,A01,094504,Rangel; Lara M,17,0,25,8
1653546227655,COGS 203,A00,087992,Coulson; Seana M,18,0,20,2
1653546228186,COGS 210A,001,087993,Greene; Deanna Jacquelyn,9998,0,9999,1
1653546228186,COGS 210A,002,087994,Saygin; Ayse P,9999,0,9999,0
1653546228186,COGS 210A,003,087995,Xia; Haijun,9999,0,9999,0
1653546228186,COGS 210A,004,087996,Nitz; Douglas A.,9999,0,9999,0
1653546228186,COGS 210A,005,087997,Hollan; James D.,9999,0,9999,0
1653546228186,COGS 210A,006,087998,Deak; Gedeon O.,9998,0,9999,1
1653546228186,COGS 210A,007,087999,Rossano; Federico,9999,0,9999,0
1653546228710,COGS 211A,A00,088000,Coulson; Seana M,9997,0,9999,2
1653546229235,COGS 229,A00,088002,Staff,23,0,25,2
1653546229762,COGS 260,B00,094231,Staff,17,0,20,3
1653546229762,COGS 260,A00,088004,Nitz; Douglas A.,9998,0,9999,1
1653546230287,CSE 202,A00,090110,Paturi; Ramamohan,0,0,0,0
1653546230287,CSE 202,B00,090111,Paturi; Ramamohan,0,0,0,0
1653546230812,CSE 207B,A00,090112,Heninger; Nadia A,0,0,0,0
1653546231334,CSE 208,A00,094858,Micciancio; Daniele,0,0,0,0
1653546231860,CSE 210,A00,090113,Powell; Thomas Allan,0,0,0,0
1653546232389,CSE 219,A00,090898,Staff,0,0,0,0
1653546232920,CSE 221,A00,090114,Zhou; Yuan-Yuan,0,0,0,0
1653546233448,CSE 229A,A00,090115,Porter; George M,0,0,0,0
1653546233975,CSE 229C,A00,090116,Savage; Stefan,0,0,0,0
1653546234499,CSE 230,A00,090117,Jhala; Ranjit,0,0,0,0
1653546235022,CSE 232,A00,090118,Papakonstantinou; Yannis,0,0,0,0
1653546235546,CSE 239A,A00,090121,Kumar; Arun Kumar,0,0,0,0
1653546236073,CSE 239B,A00,090122,Jhala; Ranjit,0,0,0,0
1653546236596,CSE 240A,A00,090123,Zhao; Jishen,0,0,189,189
1653546237122,CSE 243A,A00,090124,Orailoglu; Alex,0,0,15,15
1653546237648,CSE 249B,A00,090125,Kahng; Andrew Byun,13,0,20,7
1653546238173,CSE 250A,A00,090126,Berg-Kirkpatrick; Taylor D,0,0,0,0
1653546238701,CSE 252A,A00,090127,Ochoa; Benjamin Lawrence,0,0,0,0
1653546239311,CSE 258,A01,090129,McAuley; Julian John,0,0,0,0
1653546239847,CSE 258R,A01,090131,McAuley; Julian John,0,0,0,0
1653546240371,CSE 274,A00,090132,Ramamoorthi; Ravi,0,0,0,0
1653546240906,CSE 276A,A00,090133,Christensen; Henrik I,0,0,0,0
1653546241433,CSE 276C,A00,090134,Christensen; Henrik I,0,0,0,0
1653546241960,CSE 290,A00,090135,Bafna; Vineet,0,0,0,0
1653546241960,CSE 290,B00,090136,Ramamoorthi; Ravi,0,0,0,0
1653546241960,CSE 290,C00,090137,Li; Tzumao,8,0,10,2
1653546241960,CSE 290,D00,090138,Zhou; Yuan-Yuan,9,0,10,1
1653546241960,CSE 290,E00,090139,Christensen; Henrik I,8,0,10,2
1653546241960,CSE 290,F00,094053,Shalev; Aaron D,0,0,0,0
1653546242488,CSE 291,A00,090140,Munyaka; Imani N. S.,0,0,0,0
1653546242488,CSE 291,B00,094880,Yu; Qi,0,0,0,0
1653546242488,CSE 291,C00,090142,Pannuto; Patrick William,0,0,0,0
1653546242488,CSE 291,D00,094881,Zhang; Yiying,0,0,0,0
1653546242488,CSE 291,E00,095118,Su; Hao,0,0,0,0
1653546243016,CSE 293,001,094905,Bafna; Vineet,9999,0,9999,0
1653546243016,CSE 293,002,094906,Bellare; Mihir,9999,0,9999,0
1653546243016,CSE 293,003,094907,Berg-Kirkpatrick; Taylor D,9999,0,9999,0
1653546243016,CSE 293,004,094908,Christensen; Henrik I,9999,0,9999,0
1653546243016,CSE 293,005,094909,Cottrell; Garrison W,9999,0,9999,0
1653546243016,CSE 293,006,094910,Deutsch; Alin Bernard,9999,0,9999,0
1653546243016,CSE 293,007,094911,Esmaeilzadeh; Hadi,9999,0,9999,0
1653546243016,CSE 293,008,094912,Freund; Yoav,9999,0,9999,0
1653546243016,CSE 293,009,094913,Griswold; William G.,9999,0,9999,0
1653546243016,CSE 293,010,094914,Gymrek; Melissa Ann,9999,0,9999,0
1653546243016,CSE 293,011,094915,Heninger; Nadia A,9999,0,9999,0
1653546243016,CSE 293,012,094916,Impagliazzo; Russell,9999,0,9999,0
1653546243016,CSE 293,013,094917,Jhala; Ranjit,9999,0,9999,0
1653546243016,CSE 293,014,094918,Kahng; Andrew Byun,9999,0,9999,0
1653546243016,CSE 293,015,094919,Kane; Daniel Mertz,9999,0,9999,0
1653546243016,CSE 293,016,094920,Kriegman; David J,9999,0,9999,0
1653546243016,CSE 293,017,094921,Kumar; Arun Kumar,9999,0,9999,0
1653546243016,CSE 293,018,094922,Lerner; Sorin,9999,0,9999,0
1653546243016,CSE 293,019,094923,Lovett; Shachar,9999,0,9999,0
1653546243016,CSE 293,020,094924,McAuley; Julian John,9999,0,9999,0
1653546243016,CSE 293,021,094925,Micciancio; Daniele,9999,0,9999,0
1653546243016,CSE 293,022,094926,Orailoglu; Alex,9999,0,9999,0
1653546243016,CSE 293,023,094927,Paturi; Ramamohan,9999,0,9999,0
1653546243016,CSE 293,024,094928,Polikarpova; Nadezhda,9999,0,9999,0
1653546243016,CSE 293,025,094929,Politz; Joseph Gibbs,9999,0,9999,0
1653546243016,CSE 293,026,094930,Porter; George M,9999,0,9999,0
1653546243016,CSE 293,027,094931,Porter; Leonard Emerson,9999,0,9999,0
1653546243016,CSE 293,028,094932,Ramamoorthi; Ravi,9999,0,9999,0
1653546243016,CSE 293,029,094933,Sahoo; Debashis,9999,0,9999,0
1653546243016,CSE 293,030,094934,Saul; Lawrence,9999,0,9999,0
1653546243016,CSE 293,031,094935,Savage; Stefan,9999,0,9999,0
1653546243016,CSE 293,032,094936,Schulze; Jurgen P.,9999,0,9999,0
1653546243016,CSE 293,033,094937,Snoeren; Alex C.,9999,0,9999,0
1653546243016,CSE 293,034,094938,Shang; Jingbo,9999,0,9999,0
1653546243016,CSE 293,035,094939,Stefan; Deian,9999,0,9999,0
1653546243016,CSE 293,036,094940,Su; Hao,9999,0,9999,0
1653546243016,CSE 293,037,094941,Swanson; Steven James,9999,0,9999,0
1653546243016,CSE 293,038,094942,Tullsen; Dean Michael,9999,0,9999,0
1653546243016,CSE 293,039,094943,Voelker; Geoffrey M.,9999,0,9999,0
1653546243016,CSE 293,040,094944,Zhao; Jishen,9999,0,9999,0
1653546243016,CSE 293,041,094945,Zhou; Yuan-Yuan,9999,0,9999,0
1653546243016,CSE 293,042,094946,Gao; Sicun,9998,0,9999,1
1653546243016,CSE 293,043,094947,Weibel; Nadir,9999,0,9999,0
1653546243016,CSE 293,044,094948,Gupta; Rajesh K.,9999,0,9999,0
1653546243541,CSE 294,A00,090143,Porter; George M,8,0,10,2
1653546244080,DSE 200,A00,091799,Staff,50,0,50,0
1653546244610,DSE 203,A00,091800,Gupta; Amarnath,30,0,30,0
1653546245136,DSE 250,A00,091801,Deutsch; Alin Bernard,30,0,30,0
1653546245677,DSE 290,A00,091802,Altintas De Callaf; Ilkay,50,0,50,0
1653546246204,ECE 200,001,091003,Antipa; Nicholas A,9999,0,9999,0
1653546246204,ECE 200,002,091004,Atanasov; Nikolay A.,9999,0,9999,0
1653546246204,ECE 200,003,091005,Bharadia; Dinesh,9999,0,9999,0
1653546246204,ECE 200,004,091006,Cheng; Chung Kuan,9999,0,9999,0
1653546246204,ECE 200,005,091007,Cosman; Pamela C.,9999,0,9999,0
1653546246204,ECE 200,006,091008,Staff,9999,0,9999,0
1653546246204,ECE 200,007,091009,Dayeh; Shadi Ahmad,9999,0,9999,0
1653546246204,ECE 200,008,091010,Fainman; Yeshaiahu,9999,0,9999,0
1653546246204,ECE 200,009,091011,Ford; Joseph Earl,9999,0,9999,0
1653546246204,ECE 200,010,091012,Franceschetti; Massimo,9999,0,9999,0
1653546246204,ECE 200,011,091013,Fullerton; Eric E,9999,0,9999,0
1653546246204,ECE 200,012,091014,Galton; Ian A,9999,0,9999,0
1653546246204,ECE 200,013,091015,Gilja; Vikash,9999,0,9999,0
1653546246204,ECE 200,014,091016,Hall; Drew A.,9999,0,9999,0
1653546246204,ECE 200,015,091017,Hsueh; Tzu-Chien,9999,0,9999,0
1653546246204,ECE 200,016,091018,Javidi; Tara,9999,0,9999,0
1653546246204,ECE 200,017,091019,Kahng; Andrew Byun,9999,0,9999,0
1653546246204,ECE 200,018,091020,Kim; Young-Han,9999,0,9999,0
1653546246204,ECE 200,019,091021,Koushanfar; Farinaz,9999,0,9999,0
1653546246204,ECE 200,020,091022,Kuzum; Duygu,9999,0,9999,0
1653546246204,ECE 200,021,091023,Le; Hanh-Phuc,9999,0,9999,0
1653546246204,ECE 200,022,091024,Lin; Bill,9999,0,9999,0
1653546246204,ECE 200,023,091025,Liu; Zhaowei,9999,0,9999,0
1653546246204,ECE 200,024,091026,Lo; Yu-Hwa,9999,0,9999,0
1653546246204,ECE 200,025,091027,Lomakin; Vitaliy,9999,0,9999,0
1653546246204,ECE 200,026,091028,Mercier; Patrick Philip,9999,0,9999,0
1653546246204,ECE 200,027,091029,Meyer; Florian,9999,0,9999,0
1653546246204,ECE 200,028,091030,Milstein; Laurence B.,9999,0,9999,0
1653546246204,ECE 200,029,091031,Mir Arabbaygi; Siavash,9999,0,9999,0
1653546246204,ECE 200,030,091032,Mookherjea; Shayan,9999,0,9999,0
1653546246204,ECE 200,031,091033,Morris; Karcher William,9999,0,9999,0
1653546246204,ECE 200,032,091034,Ng; Tse Nga,9999,0,9999,0
1653546246204,ECE 200,033,091035,Nguyen; Truong Quang,9999,0,9999,0
1653546246204,ECE 200,034,091036,Nomura; Kenji,9999,0,9999,0
1653546246204,ECE 200,035,091037,Orlitsky; Alon,9999,0,9999,0
1653546246204,ECE 200,036,091038,Pal; Piya,9999,0,9999,0
1653546246204,ECE 200,037,091039,Papen; George C.,9999,0,9999,0
1653546246204,ECE 200,038,091040,Radic; Stojan,9999,0,9999,0
1653546246204,ECE 200,039,091041,Rao; Bhaskar D.,9999,0,9999,0
1653546246204,ECE 200,040,091042,Rao; Ramesh R,9999,0,9999,0
1653546246204,ECE 200,041,091043,Rebeiz; Gabriel,9999,0,9999,0
1653546246204,ECE 200,042,091044,Sanford; John R,9999,0,9999,0
1653546246204,ECE 200,043,091045,Siegel; Paul H.,9999,0,9999,0
1653546246204,ECE 200,044,091046,Sievenpiper; Daniel F.,9999,0,9999,0
1653546246204,ECE 200,045,091047,Sworder; David D.,9999,0,9999,0
1653546246204,ECE 200,046,091048,Taur; Yuan,9999,0,9999,0
1653546246204,ECE 200,047,091049,Touri; Behrouz,9999,0,9999,0
1653546246204,ECE 200,048,091050,Trivedi; Mohan M.,9999,0,9999,0
1653546246204,ECE 200,049,091051,Vardy; Alexander,9999,0,9999,0
1653546246204,ECE 200,050,091052,Vasconcelos; Nuno,9999,0,9999,0
1653546246204,ECE 200,051,091053,Wang; Xiaolong,9999,0,9999,0
1653546246204,ECE 200,052,091054,Xie; Pengtao,9999,0,9999,0
1653546246204,ECE 200,053,091055,Yip; Michael,9999,0,9999,0
1653546246204,ECE 200,054,091056,Zeger; Kenneth A.,9999,0,9999,0
1653546246204,ECE 200,055,091057,Zhang; Xinyu,9999,0,9999,0
1653546246204,ECE 200,056,091058,Turakhia; Yatish Girish,9999,0,9999,0
1653546246204,ECE 200,057,091059,Kang; Mingu,9999,0,9999,0
1653546246204,ECE 200,058,091060,Shi; Yuanyuan,9999,0,9999,0
1653546246204,ECE 200,059,091061,Wang; Edward Jay,9999,0,9999,0
1653546246204,ECE 200,060,091062,Zheng; Yang,9999,0,9999,0
1653546246733,ECE 201,A00,095526,Lo; Yu-Hwa,0,0,0,0
1653546247258,ECE 203,A00,091065,Mercier; Patrick Philip,0,0,0,0
1653546247784,ECE 207A,A00,091605,Liu; Thomas Tao-Ming,0,0,0,0
1653546248311,ECE 212AN,A00,091068,Nomura; Kenji,0,0,0,0
1653546248843,ECE 222A,A00,091069,Rebeiz; Gabriel,0,0,0,0
1653546249366,ECE 225A,A00,091070,Orlitsky; Alon,0,0,0,0
1653546249895,ECE 230A,A00,091071,Nomura; Kenji,0,0,0,0
1653546250420,ECE 236A,A00,091072,Dayeh; Shadi Ahmad,0,0,0,0
1653546250944,ECE 238A,A00,091073,Luo; Jian,0,0,0,0
1653546250944,ECE 238A,B00,091074,Luo; Jian,0,0,0,0
1653546251468,ECE 240A,A00,091075,Radic; Stojan,0,0,0,0
1653546251999,ECE 247A,A00,091592,Shi; Lingyan,0,0,0,0
1653546252522,ECE 250,A00,091076,Touri; Behrouz,0,0,0,0
1653546253046,ECE 251C,A00,091078,Nguyen; Truong Quang,0,0,0,0
1653546253573,ECE 253,A00,091079,Cosman; Pamela C.,0,0,0,0
1653546254096,ECE 255A,A00,091080,Orlitsky; Alon,0,0,0,0
1653546254620,ECE 257A,A00,091081,Zhang; Xinyu,0,0,0,0
1653546255146,ECE 260A,A01,091084,Eldon; John,0,0,0,0
1653546255676,ECE 264C,A00,091085,Galton; Ian A,0,0,0,0
1653546256203,ECE 265C,A00,094889,Presti; Calogero Davide,0,0,0,9
1653546256727,ECE 266,A01,091087,Hall; Drew A.,0,0,0,0
1653546257778,ECE 271A,A00,091090,Vasconcelos; Nuno,0,0,0,0
1653546258308,ECE 272B,A00,091091,Sworder; David D.,0,0,0,0
1653546258833,ECE 275A,A00,091092,Meyer; Florian,0,0,0,0
1653546259369,ECE 277,A00,091093,An; Cheolhong,0,0,0,0
1653546259895,ECE 283,A00,091094,Le; Hanh-Phuc,0,0,0,0
1653546260419,ECE 284,A00,091095,Kang; Mingu,0,0,0,0
1653546260419,ECE 284,B00,091096,Wang; Edward Jay,0,0,0,0
1653546260946,ECE 285,A00,094334,Touri; Behrouz,0,0,0,0
1653546261471,ECE 289,A00,091097,Whelan; David Arthur,0,0,0,0
1653546261998,MATH 200A,A00,087414,Salehi Golsefidy; Alireza,7,0,8,1
1653546262526,MATH 202A,A00,087415,Gill; Philip E.,2,0,8,6
1653546263051,MATH 203A,A00,087416,Oprea; Dragos N.,6,0,8,2
1653546263576,MATH 204A,A00,087417,Kedlaya; Kiran S.,6,0,8,2
1653546264100,MATH 205,A00,087418,Sorensen; Claus M,6,0,8,2
1653546264626,MATH 206A,A00,087419,Izadi; Elham,7,0,8,1
1653546265149,MATH 207A,A00,087420,Mohammadi; Amir,5,0,8,3
1653546265677,MATH 208,A00,087421,Staff,9,0,10,1
1653546266200,MATH 209,A00,087422,Staff,10,0,10,0
1653546266724,MATH 218,A00,087423,Staff,10,0,10,0
1653546267249,MATH 220A,A00,087424,Novak; Jonathan I,6,0,8,2
1653546267777,MATH 231A,A00,087425,Bejenaru; Ioan,3,0,8,5
1653546268302,MATH 240A,A00,087426,Ebenfelt; Peter F,5,0,8,3
1653546268825,MATH 243,A00,087427,Staff,9,0,10,1
1653546269353,MATH 248,A00,087429,Staff,10,0,10,0
1653546269878,MATH 250A,A00,087430,Spolaor; Luca,4,0,8,4
1653546270402,MATH 257A,A00,087431,Spolaor; Luca,7,0,8,1
1653546270930,MATH 258,A00,087432,Staff,9,0,10,1
1653546271452,MATH 264A,A00,087433,Warnke; Lutz Peter,5,0,8,3
1653546271977,MATH 268,A00,087434,Staff,15,0,15,0
1653546272501,MATH 269,A00,087435,Staff,14,0,15,1
1653546273025,MATH 270A,A00,087436,Nie; Jiawang,0,0,8,8
1653546273550,MATH 272A,A00,087437,Tian; Xiaochuan,1,0,8,7
1653546274075,MATH 274,A01,087439,Cheng; Li-Tien,9,0,10,1
1653546274075,MATH 274,A02,087440,Cheng; Li-Tien,10,0,10,0
1653546274599,MATH 278A,A00,087441,Staff,8,0,10,2
1653546275124,MATH 278B,A00,087442,Staff,8,0,10,2
1653546275647,MATH 278C,A00,087443,Staff,8,0,10,2
1653546276174,MATH 280A,A00,087444,Zheng; Tianyi,0,0,8,8
1653546276700,MATH 281A,A00,087445,Bradic; Jelena,0,0,8,8
1653546277227,MATH 282A,A00,087446,Zhang; Danna,0,0,8,8
1653546277749,MATH 283,A00,087447,Tesler; Glenn,0,0,0,15
1653546278273,MATH 286,A00,087448,Kemp; Todd Aahron,5,0,8,3
1653546278796,MATH 287D,A00,087449,Bradic; Jelena,0,0,0,0
1653546279317,MATH 288,A00,087450,Staff,14,0,15,1
1653546279317,MATH 288,B00,087451,Staff,15,0,15,0
1653546279317,MATH 288,C00,087452,Staff,15,0,15,0
1653546279842,MATH 290A,A00,087453,Xu; Zhouli,6,0,8,2
1653546280365,MATH 291A,A00,087454,Xu; Zhouli,7,0,8,1
1653546280887,MATH 292,A00,087455,Staff,10,0,10,0
1653546281413,MATH 295,A00,087456,Staff,50,0,50,0
1653546281936,MATH 297,001,087457,Staff,998,0,999,1
1653546841507,COGS 200,A01,087991,Staff,47,0,50,3
1653546842031,COGS 201,A01,094504,Rangel; Lara M,17,0,25,8
1653546842558,COGS 203,A00,087992,Coulson; Seana M,18,0,20,2
1653546843080,COGS 210A,001,087993,Greene; Deanna Jacquelyn,9998,0,9999,1
1653546843080,COGS 210A,002,087994,Saygin; Ayse P,9999,0,9999,0
1653546843080,COGS 210A,003,087995,Xia; Haijun,9999,0,9999,0
1653546843080,COGS 210A,004,087996,Nitz; Douglas A.,9999,0,9999,0
1653546843080,COGS 210A,005,087997,Hollan; James D.,9999,0,9999,0
1653546843080,COGS 210A,006,087998,Deak; Gedeon O.,9998,0,9999,1
1653546843080,COGS 210A,007,087999,Rossano; Federico,9999,0,9999,0
1653546843610,COGS 211A,A00,088000,Coulson; Seana M,9997,0,9999,2
1653546844135,COGS 229,A00,088002,Staff,23,0,25,2
1653546844659,COGS 260,B00,094231,Staff,17,0,20,3
1653546844659,COGS 260,A00,088004,Nitz; Douglas A.,9998,0,9999,1
1653546845183,CSE 202,A00,090110,Paturi; Ramamohan,0,0,0,0
1653546845183,CSE 202,B00,090111,Paturi; Ramamohan,0,0,0,0
1653546845715,CSE 207B,A00,090112,Heninger; Nadia A,0,0,0,0
1653546846244,CSE 208,A00,094858,Micciancio; Daniele,0,0,0,0
1653546846767,CSE 210,A00,090113,Powell; Thomas Allan,0,0,0,0
1653546847292,CSE 219,A00,090898,Staff,0,0,0,0
1653546847816,CSE 221,A00,090114,Zhou; Yuan-Yuan,0,0,0,0
1653546848340,CSE 229A,A00,090115,Porter; George M,0,0,0,0
1653546848864,CSE 229C,A00,090116,Savage; Stefan,0,0,0,0
1653546849390,CSE 230,A00,090117,Jhala; Ranjit,0,0,0,0
1653546849914,CSE 232,A00,090118,Papakonstantinou; Yannis,0,0,0,0
1653546850440,CSE 239A,A00,090121,Kumar; Arun Kumar,0,0,0,0
1653546850970,CSE 239B,A00,090122,Jhala; Ranjit,0,0,0,0
1653546851494,CSE 240A,A00,090123,Zhao; Jishen,0,0,189,189
1653546852025,CSE 243A,A00,090124,Orailoglu; Alex,0,0,15,15
1653546852547,CSE 249B,A00,090125,Kahng; Andrew Byun,13,0,20,7
1653546853070,CSE 250A,A00,090126,Berg-Kirkpatrick; Taylor D,0,0,0,0
1653546853600,CSE 252A,A00,090127,Ochoa; Benjamin Lawrence,0,0,0,0
1653546854125,CSE 258,A01,090129,McAuley; Julian John,0,0,0,0
1653546854648,CSE 258R,A01,090131,McAuley; Julian John,0,0,0,0
1653546855175,CSE 274,A00,090132,Ramamoorthi; Ravi,0,0,0,0
1653546855707,CSE 276A,A00,090133,Christensen; Henrik I,0,0,0,0
1653546856239,CSE 276C,A00,090134,Christensen; Henrik I,0,0,0,0
1653546856771,CSE 290,A00,090135,Bafna; Vineet,0,0,0,0
1653546856771,CSE 290,B00,090136,Ramamoorthi; Ravi,0,0,0,0
1653546856771,CSE 290,C00,090137,Li; Tzumao,8,0,10,2
1653546856771,CSE 290,D00,090138,Zhou; Yuan-Yuan,9,0,10,1
1653546856771,CSE 290,E00,090139,Christensen; Henrik I,8,0,10,2
1653546856771,CSE 290,F00,094053,Shalev; Aaron D,0,0,0,0
1653546857295,CSE 291,A00,090140,Munyaka; Imani N. S.,0,0,0,0
1653546857295,CSE 291,B00,094880,Yu; Qi,0,0,0,0
1653546857295,CSE 291,C00,090142,Pannuto; Patrick William,0,0,0,0
1653546857295,CSE 291,D00,094881,Zhang; Yiying,0,0,0,0
1653546857295,CSE 291,E00,095118,Su; Hao,0,0,0,0
1653546857850,CSE 293,001,094905,Bafna; Vineet,9999,0,9999,0
1653546857850,CSE 293,002,094906,Bellare; Mihir,9999,0,9999,0
1653546857850,CSE 293,003,094907,Berg-Kirkpatrick; Taylor D,9999,0,9999,0
1653546857850,CSE 293,004,094908,Christensen; Henrik I,9999,0,9999,0
1653546857850,CSE 293,005,094909,Cottrell; Garrison W,9999,0,9999,0
1653546857850,CSE 293,006,094910,Deutsch; Alin Bernard,9999,0,9999,0
1653546857850,CSE 293,007,094911,Esmaeilzadeh; Hadi,9999,0,9999,0
1653546857850,CSE 293,008,094912,Freund; Yoav,9999,0,9999,0
1653546857850,CSE 293,009,094913,Griswold; William G.,9999,0,9999,0
1653546857850,CSE 293,010,094914,Gymrek; Melissa Ann,9999,0,9999,0
1653546857850,CSE 293,011,094915,Heninger; Nadia A,9999,0,9999,0
1653546857850,CSE 293,012,094916,Impagliazzo; Russell,9999,0,9999,0
1653546857850,CSE 293,013,094917,Jhala; Ranjit,9999,0,9999,0
1653546857850,CSE 293,014,094918,Kahng; Andrew Byun,9999,0,9999,0
1653546857850,CSE 293,015,094919,Kane; Daniel Mertz,9999,0,9999,0
1653546857850,CSE 293,016,094920,Kriegman; David J,9999,0,9999,0
1653546857850,CSE 293,017,094921,Kumar; Arun Kumar,9999,0,9999,0
1653546857850,CSE 293,018,094922,Lerner; Sorin,9999,0,9999,0
1653546857850,CSE 293,019,094923,Lovett; Shachar,9999,0,9999,0
1653546857850,CSE 293,020,094924,McAuley; Julian John,9999,0,9999,0
1653546857850,CSE 293,021,094925,Micciancio; Daniele,9999,0,9999,0
1653546857850,CSE 293,022,094926,Orailoglu; Alex,9999,0,9999,0
1653546857850,CSE 293,023,094927,Paturi; Ramamohan,9999,0,9999,0
1653546857850,CSE 293,024,094928,Polikarpova; Nadezhda,9999,0,9999,0
1653546857850,CSE 293,025,094929,Politz; Joseph Gibbs,9999,0,9999,0
1653546857850,CSE 293,026,094930,Porter; George M,9999,0,9999,0
1653546857850,CSE 293,027,094931,Porter; Leonard Emerson,9999,0,9999,0
1653546857850,CSE 293,028,094932,Ramamoorthi; Ravi,9999,0,9999,0
1653546857850,CSE 293,029,094933,Sahoo; Debashis,9999,0,9999,0
1653546857850,CSE 293,030,094934,Saul; Lawrence,9999,0,9999,0
1653546857850,CSE 293,031,094935,Savage; Stefan,9999,0,9999,0
1653546857850,CSE 293,032,094936,Schulze; Jurgen P.,9999,0,9999,0
1653546857850,CSE 293,033,094937,Snoeren; Alex C.,9999,0,9999,0
1653546857850,CSE 293,034,094938,Shang; Jingbo,9999,0,9999,0
1653546857850,CSE 293,035,094939,Stefan; Deian,9999,0,9999,0
1653546857850,CSE 293,036,094940,Su; Hao,9999,0,9999,0
1653546857850,CSE 293,037,094941,Swanson; Steven James,9999,0,9999,0
1653546857850,CSE 293,038,094942,Tullsen; Dean Michael,9999,0,9999,0
1653546857850,CSE 293,039,094943,Voelker; Geoffrey M.,9999,0,9999,0
1653546857850,CSE 293,040,094944,Zhao; Jishen,9999,0,9999,0
1653546857850,CSE 293,041,094945,Zhou; Yuan-Yuan,9999,0,9999,0
1653546857850,CSE 293,042,094946,Gao; Sicun,9998,0,9999,1
1653546857850,CSE 293,043,094947,Weibel; Nadir,9999,0,9999,0
1653546857850,CSE 293,044,094948,Gupta; Rajesh K.,9999,0,9999,0
1653546858374,CSE 294,A00,090143,Porter; George M,8,0,10,2
1653546858900,DSE 200,A00,091799,Staff,50,0,50,0
1653546859423,DSE 203,A00,091800,Gupta; Amarnath,30,0,30,0
1653546859949,DSE 250,A00,091801,Deutsch; Alin Bernard,30,0,30,0
1653546860475,DSE 290,A00,091802,Altintas De Callaf; Ilkay,50,0,50,0
1653546861006,ECE 200,001,091003,Antipa; Nicholas A,9999,0,9999,0
1653546861006,ECE 200,002,091004,Atanasov; Nikolay A.,9999,0,9999,0
1653546861006,ECE 200,003,091005,Bharadia; Dinesh,9999,0,9999,0
1653546861006,ECE 200,004,091006,Cheng; Chung Kuan,9999,0,9999,0
1653546861006,ECE 200,005,091007,Cosman; Pamela C.,9999,0,9999,0
1653546861006,ECE 200,006,091008,Staff,9999,0,9999,0
1653546861006,ECE 200,007,091009,Dayeh; Shadi Ahmad,9999,0,9999,0
1653546861006,ECE 200,008,091010,Fainman; Yeshaiahu,9999,0,9999,0
1653546861006,ECE 200,009,091011,Ford; Joseph Earl,9999,0,9999,0
1653546861006,ECE 200,010,091012,Franceschetti; Massimo,9999,0,9999,0
1653546861006,ECE 200,011,091013,Fullerton; Eric E,9999,0,9999,0
1653546861006,ECE 200,012,091014,Galton; Ian A,9999,0,9999,0
1653546861006,ECE 200,013,091015,Gilja; Vikash,9999,0,9999,0
1653546861006,ECE 200,014,091016,Hall; Drew A.,9999,0,9999,0
1653546861006,ECE 200,015,091017,Hsueh; Tzu-Chien,9999,0,9999,0
1653546861006,ECE 200,016,091018,Javidi; Tara,9999,0,9999,0
1653546861006,ECE 200,017,091019,Kahng; Andrew Byun,9999,0,9999,0
1653546861006,ECE 200,018,091020,Kim; Young-Han,9999,0,9999,0
1653546861006,ECE 200,019,091021,Koushanfar; Farinaz,9999,0,9999,0
1653546861006,ECE 200,020,091022,Kuzum; Duygu,9999,0,9999,0
1653546861006,ECE 200,021,091023,Le; Hanh-Phuc,9999,0,9999,0
1653546861006,ECE 200,022,091024,Lin; Bill,9999,0,9999,0
1653546861006,ECE 200,023,091025,Liu; Zhaowei,9999,0,9999,0
1653546861006,ECE 200,024,091026,Lo; Yu-Hwa,9999,0,9999,0
1653546861006,ECE 200,025,091027,Lomakin; Vitaliy,9999,0,9999,0
1653546861006,ECE 200,026,091028,Mercier; Patrick Philip,9999,0,9999,0
1653546861006,ECE 200,027,091029,Meyer; Florian,9999,0,9999,0
1653546861006,ECE 200,028,091030,Milstein; Laurence B.,9999,0,9999,0
1653546861006,ECE 200,029,091031,Mir Arabbaygi; Siavash,9999,0,9999,0
1653546861006,ECE 200,030,091032,Mookherjea; Shayan,9999,0,9999,0
1653546861006,ECE 200,031,091033,Morris; Karcher William,9999,0,9999,0
1653546861006,ECE 200,032,091034,Ng; Tse Nga,9999,0,9999,0
1653546861006,ECE 200,033,091035,Nguyen; Truong Quang,9999,0,9999,0
1653546861006,ECE 200,034,091036,Nomura; Kenji,9999,0,9999,0
1653546861006,ECE 200,035,091037,Orlitsky; Alon,9999,0,9999,0
1653546861006,ECE 200,036,091038,Pal; Piya,9999,0,9999,0
1653546861006,ECE 200,037,091039,Papen; George C.,9999,0,9999,0
1653546861006,ECE 200,038,091040,Radic; Stojan,9999,0,9999,0
1653546861006,ECE 200,039,091041,Rao; Bhaskar D.,9999,0,9999,0
1653546861006,ECE 200,040,091042,Rao; Ramesh R,9999,0,9999,0
1653546861006,ECE 200,041,091043,Rebeiz; Gabriel,9999,0,9999,0
1653546861006,ECE 200,042,091044,Sanford; John R,9999,0,9999,0
1653546861006,ECE 200,043,091045,Siegel; Paul H.,9999,0,9999,0
1653546861006,ECE 200,044,091046,Sievenpiper; Daniel F.,9999,0,9999,0
1653546861006,ECE 200,045,091047,Sworder; David D.,9999,0,9999,0
1653546861006,ECE 200,046,091048,Taur; Yuan,9999,0,9999,0
1653546861006,ECE 200,047,091049,Touri; Behrouz,9999,0,9999,0
1653546861006,ECE 200,048,091050,Trivedi; Mohan M.,9999,0,9999,0
1653546861006,ECE 200,049,091051,Vardy; Alexander,9999,0,9999,0
1653546861006,ECE 200,050,091052,Vasconcelos; Nuno,9999,0,9999,0
1653546861006,ECE 200,051,091053,Wang; Xiaolong,9999,0,9999,0
1653546861006,ECE 200,052,091054,Xie; Pengtao,9999,0,9999,0
1653546861006,ECE 200,053,091055,Yip; Michael,9999,0,9999,0
1653546861006,ECE 200,054,091056,Zeger; Kenneth A.,9999,0,9999,0
1653546861006,ECE 200,055,091057,Zhang; Xinyu,9999,0,9999,0
1653546861006,ECE 200,056,091058,Turakhia; Yatish Girish,9999,0,9999,0
1653546861006,ECE 200,057,091059,Kang; Mingu,9999,0,9999,0
1653546861006,ECE 200,058,091060,Shi; Yuanyuan,9999,0,9999,0
1653546861006,ECE 200,059,091061,Wang; Edward Jay,9999,0,9999,0
1653546861006,ECE 200,060,091062,Zheng; Yang,9999,0,9999,0
1653546861532,ECE 201,A00,095526,Lo; Yu-Hwa,0,0,0,0
1653546862059,ECE 203,A00,091065,Mercier; Patrick Philip,0,0,0,0
1653546862586,ECE 207A,A00,091605,Liu; Thomas Tao-Ming,0,0,0,0
1653546863116,ECE 212AN,A00,091068,Nomura; Kenji,0,0,0,0
1653546863640,ECE 222A,A00,091069,Rebeiz; Gabriel,0,0,0,0
1653546864164,ECE 225A,A00,091070,Orlitsky; Alon,0,0,0,0
1653546864691,ECE 230A,A00,091071,Nomura; Kenji,0,0,0,0
1653546865216,ECE 236A,A00,091072,Dayeh; Shadi Ahmad,0,0,0,0
1653546865740,ECE 238A,A00,091073,Luo; Jian,0,0,0,0
1653546865740,ECE 238A,B00,091074,Luo; Jian,0,0,0,0
1653546866270,ECE 240A,A00,091075,Radic; Stojan,0,0,0,0
1653546866795,ECE 247A,A00,091592,Shi; Lingyan,0,0,0,0
1653546867323,ECE 250,A00,091076,Touri; Behrouz,0,0,0,0
1653546867846,ECE 251C,A00,091078,Nguyen; Truong Quang,0,0,0,0
1653546868369,ECE 253,A00,091079,Cosman; Pamela C.,0,0,0,0
1653546868895,ECE 255A,A00,091080,Orlitsky; Alon,0,0,0,0
1653546869423,ECE 257A,A00,091081,Zhang; Xinyu,0,0,0,0
1653546869946,ECE 260A,A01,091084,Eldon; John,0,0,0,0
1653546870472,ECE 264C,A00,091085,Galton; Ian A,0,0,0,0
1653546870999,ECE 265C,A00,094889,Presti; Calogero Davide,0,0,0,9
1653546871523,ECE 266,A01,091087,Hall; Drew A.,0,0,0,0
1653546872576,ECE 271A,A00,091090,Vasconcelos; Nuno,0,0,0,0
1653546873099,ECE 272B,A00,091091,Sworder; David D.,0,0,0,0
1653546873623,ECE 275A,A00,091092,Meyer; Florian,0,0,0,0
1653546874147,ECE 277,A00,091093,An; Cheolhong,0,0,0,0
1653546874674,ECE 283,A00,091094,Le; Hanh-Phuc,0,0,0,0
1653546875209,ECE 284,A00,091095,Kang; Mingu,0,0,0,0
1653546875209,ECE 284,B00,091096,Wang; Edward Jay,0,0,0,0
1653546875736,ECE 285,A00,094334,Touri; Behrouz,0,0,0,0
1653546876260,ECE 289,A00,091097,Whelan; David Arthur,0,0,0,0
1653546876782,MATH 200A,A00,087414,Salehi Golsefidy; Alireza,7,0,8,1
1653546877310,MATH 202A,A00,087415,Gill; Philip E.,2,0,8,6
1653546877838,MATH 203A,A00,087416,Oprea; Dragos N.,6,0,8,2
1653546878363,MATH 204A,A00,087417,Kedlaya; Kiran S.,6,0,8,2
1653546878886,MATH 205,A00,087418,Sorensen; Claus M,6,0,8,2
1653546879485,MATH 206A,A00,087419,Izadi; Elham,7,0,8,1
1653546880008,MATH 207A,A00,087420,Mohammadi; Amir,5,0,8,3
1653546880532,MATH 208,A00,087421,Staff,9,0,10,1
1653546881068,MATH 209,A00,087422,Staff,10,0,10,0
1653546881596,MATH 218,A00,087423,Staff,10,0,10,0
1653546882120,MATH 220A,A00,087424,Novak; Jonathan I,6,0,8,2
1653546882646,MATH 231A,A00,087425,Bejenaru; Ioan,3,0,8,5
1653546883169,MATH 240A,A00,087426,Ebenfelt; Peter F,5,0,8,3
1653546883692,MATH 243,A00,087427,Staff,9,0,10,1
1653546884215,MATH 248,A00,087429,Staff,10,0,10,0
1653546884742,MATH 250A,A00,087430,Spolaor; Luca,4,0,8,4
1653546885265,MATH 257A,A00,087431,Spolaor; Luca,7,0,8,1
1653546885794,MATH 258,A00,087432,Staff,9,0,10,1
1653546886318,MATH 264A,A00,087433,Warnke; Lutz Peter,5,0,8,3
1653546886841,MATH 268,A00,087434,Staff,15,0,15,0
1653546887371,MATH 269,A00,087435,Staff,14,0,15,1
1653546887900,MATH 270A,A00,087436,Nie; Jiawang,0,0,8,8
1653546888424,MATH 272A,A00,087437,Tian; Xiaochuan,1,0,8,7
1653546888957,MATH 274,A01,087439,Cheng; Li-Tien,9,0,10,1
1653546888957,MATH 274,A02,087440,Cheng; Li-Tien,10,0,10,0
1653546889481,MATH 278A,A00,087441,Staff,8,0,10,2
1653546890015,MATH 278B,A00,087442,Staff,8,0,10,2
1653546890538,MATH 278C,A00,087443,Staff,8,0,10,2
1653546891065,MATH 280A,A00,087444,Zheng; Tianyi,0,0,8,8
1653546891592,MATH 281A,A00,087445,Bradic; Jelena,0,0,8,8
1653546892116,MATH 282A,A00,087446,Zhang; Danna,0,0,8,8
1653546892640,MATH 283,A00,087447,Tesler; Glenn,0,0,0,15
1653546893173,MATH 286,A00,087448,Kemp; Todd Aahron,5,0,8,3
1653546893699,MATH 287D,A00,087449,Bradic; Jelena,0,0,0,0
1653546894222,MATH 288,A00,087450,Staff,14,0,15,1
1653546894222,MATH 288,B00,087451,Staff,15,0,15,0
1653546894222,MATH 288,C00,087452,Staff,15,0,15,0
1653546894745,MATH 290A,A00,087453,Xu; Zhouli,6,0,8,2
1653546895273,MATH 291A,A00,087454,Xu; Zhouli,7,0,8,1
1653546895795,MATH 292,A00,087455,Staff,10,0,10,0
1653546896321,MATH 295,A00,087456,Staff,50,0,50,0
1653546896845,MATH 297,001,087457,Staff,998,0,999,1
1653547456375,COGS 200,A01,087991,Staff,47,0,50,3
1653547456901,COGS 201,A01,094504,Rangel; Lara M,17,0,25,8
1653547457430,COGS 203,A00,087992,Coulson; Seana M,18,0,20,2
1653547457954,COGS 210A,001,087993,Greene; Deanna Jacquelyn,9998,0,9999,1
1653547457954,COGS 210A,002,087994,Saygin; Ayse P,9999,0,9999,0
1653547457954,COGS 210A,003,087995,Xia; Haijun,9999,0,9999,0
1653547457954,COGS 210A,004,087996,Nitz; Douglas A.,9999,0,9999,0
1653547457954,COGS 210A,005,087997,Hollan; James D.,9999,0,9999,0
1653547457954,COGS 210A,006,087998,Deak; Gedeon O.,9998,0,9999,1
1653547457954,COGS 210A,007,087999,Rossano; Federico,9999,0,9999,0
1653547458476,COGS 211A,A00,088000,Coulson; Seana M,9997,0,9999,2
1653547459001,COGS 229,A00,088002,Staff,23,0,25,2
1653547459527,COGS 260,B00,094231,Staff,17,0,20,3
1653547459527,COGS 260,A00,088004,Nitz; Douglas A.,9998,0,9999,1
1653547460052,CSE 202,A00,090110,Paturi; Ramamohan,0,0,0,0
1653547460052,CSE 202,B00,090111,Paturi; Ramamohan,0,0,0,0
1653547460575,CSE 207B,A00,090112,Heninger; Nadia A,0,0,0,0
1653547461101,CSE 208,A00,094858,Micciancio; Daniele,0,0,0,0
1653547461627,CSE 210,A00,090113,Powell; Thomas Allan,0,0,0,0
1653547462152,CSE 219,A00,090898,Staff,0,0,0,0
1653547462675,CSE 221,A00,090114,Zhou; Yuan-Yuan,0,0,0,0
1653547463201,CSE 229A,A00,090115,Porter; George M,0,0,0,0
1653547463736,CSE 229C,A00,090116,Savage; Stefan,0,0,0,0
1653547464261,CSE 230,A00,090117,Jhala; Ranjit,0,0,0,0
1653547464787,CSE 232,A00,090118,Papakonstantinou; Yannis,0,0,0,0
1653547465313,CSE 239A,A00,090121,Kumar; Arun Kumar,0,0,0,0
1653547465842,CSE 239B,A00,090122,Jhala; Ranjit,0,0,0,0
1653547466455,CSE 240A,A00,090123,Zhao; Jishen,0,0,189,189
1653547466978,CSE 243A,A00,090124,Orailoglu; Alex,0,0,15,15
1653547467514,CSE 249B,A00,090125,Kahng; Andrew Byun,13,0,20,7
1653547468043,CSE 250A,A00,090126,Berg-Kirkpatrick; Taylor D,0,0,0,0
1653547468571,CSE 252A,A00,090127,Ochoa; Benjamin Lawrence,0,0,0,0
1653547469095,CSE 258,A01,090129,McAuley; Julian John,0,0,0,0
1653547469635,CSE 258R,A01,090131,McAuley; Julian John,0,0,0,0
1653547470165,CSE 274,A00,090132,Ramamoorthi; Ravi,0,0,0,0
1653547470690,CSE 276A,A00,090133,Christensen; Henrik I,0,0,0,0
1653547471216,CSE 276C,A00,090134,Christensen; Henrik I,0,0,0,0
1653547471740,CSE 290,A00,090135,Bafna; Vineet,0,0,0,0
1653547471740,CSE 290,B00,090136,Ramamoorthi; Ravi,0,0,0,0
1653547471740,CSE 290,C00,090137,Li; Tzumao,8,0,10,2
1653547471740,CSE 290,D00,090138,Zhou; Yuan-Yuan,9,0,10,1
1653547471740,CSE 290,E00,090139,Christensen; Henrik I,8,0,10,2
1653547471740,CSE 290,F00,094053,Shalev; Aaron D,0,0,0,0
1653547472263,CSE 291,A00,090140,Munyaka; Imani N. S.,0,0,0,0
1653547472263,CSE 291,B00,094880,Yu; Qi,0,0,0,0
1653547472263,CSE 291,C00,090142,Pannuto; Patrick William,0,0,0,0
1653547472263,CSE 291,D00,094881,Zhang; Yiying,0,0,0,0
1653547472263,CSE 291,E00,095118,Su; Hao,0,0,0,0
1653547472791,CSE 293,001,094905,Bafna; Vineet,9999,0,9999,0
1653547472791,CSE 293,002,094906,Bellare; Mihir,9999,0,9999,0
1653547472791,CSE 293,003,094907,Berg-Kirkpatrick; Taylor D,9999,0,9999,0
1653547472791,CSE 293,004,094908,Christensen; Henrik I,9999,0,9999,0
1653547472791,CSE 293,005,094909,Cottrell; Garrison W,9999,0,9999,0
1653547472791,CSE 293,006,094910,Deutsch; Alin Bernard,9999,0,9999,0
1653547472791,CSE 293,007,094911,Esmaeilzadeh; Hadi,9999,0,9999,0
1653547472791,CSE 293,008,094912,Freund; Yoav,9999,0,9999,0
1653547472791,CSE 293,009,094913,Griswold; William G.,9999,0,9999,0
1653547472791,CSE 293,010,094914,Gymrek; Melissa Ann,9999,0,9999,0
1653547472791,CSE 293,011,094915,Heninger; Nadia A,9999,0,9999,0
1653547472791,CSE 293,012,094916,Impagliazzo; Russell,9999,0,9999,0
1653547472791,CSE 293,013,094917,Jhala; Ranjit,9999,0,9999,0
1653547472791,CSE 293,014,094918,Kahng; Andrew Byun,9999,0,9999,0
1653547472791,CSE 293,015,094919,Kane; Daniel Mertz,9999,0,9999,0
1653547472791,CSE 293,016,094920,Kriegman; David J,9999,0,9999,0
1653547472791,CSE 293,017,094921,Kumar; Arun Kumar,9999,0,9999,0
1653547472791,CSE 293,018,094922,Lerner; Sorin,9999,0,9999,0
1653547472791,CSE 293,019,094923,Lovett; Shachar,9999,0,9999,0
1653547472791,CSE 293,020,094924,McAuley; Julian John,9999,0,9999,0
1653547472791,CSE 293,021,094925,Micciancio; Daniele,9999,0,9999,0
1653547472791,CSE 293,022,094926,Orailoglu; Alex,9999,0,9999,0
1653547472791,CSE 293,023,094927,Paturi; Ramamohan,9999,0,9999,0
1653547472791,CSE 293,024,094928,Polikarpova; Nadezhda,9999,0,9999,0
1653547472791,CSE 293,025,094929,Politz; Joseph Gibbs,9999,0,9999,0
1653547472791,CSE 293,026,094930,Porter; George M,9999,0,9999,0
1653547472791,CSE 293,027,094931,Porter; Leonard Emerson,9999,0,9999,0
1653547472791,CSE 293,028,094932,Ramamoorthi; Ravi,9999,0,9999,0
1653547472791,CSE 293,029,094933,Sahoo; Debashis,9999,0,9999,0
1653547472791,CSE 293,030,094934,Saul; Lawrence,9999,0,9999,0
1653547472791,CSE 293,031,094935,Savage; Stefan,9999,0,9999,0
1653547472791,CSE 293,032,094936,Schulze; Jurgen P.,9999,0,9999,0
1653547472791,CSE 293,033,094937,Snoeren; Alex C.,9999,0,9999,0
1653547472791,CSE 293,034,094938,Shang; Jingbo,9999,0,9999,0
1653547472791,CSE 293,035,094939,Stefan; Deian,9999,0,9999,0
1653547472791,CSE 293,036,094940,Su; Hao,9999,0,9999,0
1653547472791,CSE 293,037,094941,Swanson; Steven James,9999,0,9999,0
1653547472791,CSE 293,038,094942,Tullsen; Dean Michael,9999,0,9999,0
1653547472791,CSE 293,039,094943,Voelker; Geoffrey M.,9999,0,9999,0
1653547472791,CSE 293,040,094944,Zhao; Jishen,9999,0,9999,0
1653547472791,CSE 293,041,094945,Zhou; Yuan-Yuan,9999,0,9999,0
1653547472791,CSE 293,042,094946,Gao; Sicun,9998,0,9999,1
1653547472791,CSE 293,043,094947,Weibel; Nadir,9999,0,9999,0
1653547472791,CSE 293,044,094948,Gupta; Rajesh K.,9999,0,9999,0
1653547473318,CSE 294,A00,090143,Porter; George M,8,0,10,2
1653547473845,DSE 200,A00,091799,Staff,50,0,50,0
1653547474371,DSE 203,A00,091800,Gupta; Amarnath,30,0,30,0
1653547474894,DSE 250,A00,091801,Deutsch; Alin Bernard,30,0,30,0
1653547475427,DSE 290,A00,091802,Altintas De Callaf; Ilkay,50,0,50,0
1653547475958,ECE 200,001,091003,Antipa; Nicholas A,9999,0,9999,0
1653547475958,ECE 200,002,091004,Atanasov; Nikolay A.,9999,0,9999,0
1653547475958,ECE 200,003,091005,Bharadia; Dinesh,9999,0,9999,0
1653547475958,ECE 200,004,091006,Cheng; Chung Kuan,9999,0,9999,0
1653547475958,ECE 200,005,091007,Cosman; Pamela C.,9999,0,9999,0
1653547475958,ECE 200,006,091008,Staff,9999,0,9999,0
1653547475958,ECE 200,007,091009,Dayeh; Shadi Ahmad,9999,0,9999,0
1653547475958,ECE 200,008,091010,Fainman; Yeshaiahu,9999,0,9999,0
1653547475958,ECE 200,009,091011,Ford; Joseph Earl,9999,0,9999,0
1653547475958,ECE 200,010,091012,Franceschetti; Massimo,9999,0,9999,0
1653547475958,ECE 200,011,091013,Fullerton; Eric E,9999,0,9999,0
1653547475958,ECE 200,012,091014,Galton; Ian A,9999,0,9999,0
1653547475958,ECE 200,013,091015,Gilja; Vikash,9999,0,9999,0
1653547475958,ECE 200,014,091016,Hall; Drew A.,9999,0,9999,0
1653547475958,ECE 200,015,091017,Hsueh; Tzu-Chien,9999,0,9999,0
1653547475958,ECE 200,016,091018,Javidi; Tara,9999,0,9999,0
1653547475958,ECE 200,017,091019,Kahng; Andrew Byun,9999,0,9999,0
1653547475958,ECE 200,018,091020,Kim; Young-Han,9999,0,9999,0
1653547475958,ECE 200,019,091021,Koushanfar; Farinaz,9999,0,9999,0
1653547475958,ECE 200,020,091022,Kuzum; Duygu,9999,0,9999,0
1653547475958,ECE 200,021,091023,Le; Hanh-Phuc,9999,0,9999,0
1653547475958,ECE 200,022,091024,Lin; Bill,9999,0,9999,0
1653547475958,ECE 200,023,091025,Liu; Zhaowei,9999,0,9999,0
1653547475958,ECE 200,024,091026,Lo; Yu-Hwa,9999,0,9999,0
1653547475958,ECE 200,025,091027,Lomakin; Vitaliy,9999,0,9999,0
1653547475958,ECE 200,026,091028,Mercier; Patrick Philip,9999,0,9999,0
1653547475958,ECE 200,027,091029,Meyer; Florian,9999,0,9999,0
1653547475958,ECE 200,028,091030,Milstein; Laurence B.,9999,0,9999,0
1653547475958,ECE 200,029,091031,Mir Arabbaygi; Siavash,9999,0,9999,0
1653547475958,ECE 200,030,091032,Mookherjea; Shayan,9999,0,9999,0
1653547475958,ECE 200,031,091033,Morris; Karcher William,9999,0,9999,0
1653547475958,ECE 200,032,091034,Ng; Tse Nga,9999,0,9999,0
1653547475958,ECE 200,033,091035,Nguyen; Truong Quang,9999,0,9999,0
1653547475958,ECE 200,034,091036,Nomura; Kenji,9999,0,9999,0
1653547475958,ECE 200,035,091037,Orlitsky; Alon,9999,0,9999,0
1653547475958,ECE 200,036,091038,Pal; Piya,9999,0,9999,0
1653547475958,ECE 200,037,091039,Papen; George C.,9999,0,9999,0
1653547475958,ECE 200,038,091040,Radic; Stojan,9999,0,9999,0
1653547475958,ECE 200,039,091041,Rao; Bhaskar D.,9999,0,9999,0
1653547475958,ECE 200,040,091042,Rao; Ramesh R,9999,0,9999,0
1653547475958,ECE 200,041,091043,Rebeiz; Gabriel,9999,0,9999,0
1653547475958,ECE 200,042,091044,Sanford; John R,9999,0,9999,0
1653547475958,ECE 200,043,091045,Siegel; Paul H.,9999,0,9999,0
1653547475958,ECE 200,044,091046,Sievenpiper; Daniel F.,9999,0,9999,0
1653547475958,ECE 200,045,091047,Sworder; David D.,9999,0,9999,0
1653547475958,ECE 200,046,091048,Taur; Yuan,9999,0,9999,0
1653547475958,ECE 200,047,091049,Touri; Behrouz,9999,0,9999,0
1653547475958,ECE 200,048,091050,Trivedi; Mohan M.,9999,0,9999,0
1653547475958,ECE 200,049,091051,Vardy; Alexander,9999,0,9999,0
1653547475958,ECE 200,050,091052,Vasconcelos; Nuno,9999,0,9999,0
1653547475958,ECE 200,051,091053,Wang; Xiaolong,9999,0,9999,0
1653547475958,ECE 200,052,091054,Xie; Pengtao,9999,0,9999,0
1653547475958,ECE 200,053,091055,Yip; Michael,9999,0,9999,0
1653547475958,ECE 200,054,091056,Zeger; Kenneth A.,9999,0,9999,0
1653547475958,ECE 200,055,091057,Zhang; Xinyu,9999,0,9999,0
1653547475958,ECE 200,056,091058,Turakhia; Yatish Girish,9999,0,9999,0
1653547475958,ECE 200,057,091059,Kang; Mingu,9999,0,9999,0
1653547475958,ECE 200,058,091060,Shi; Yuanyuan,9999,0,9999,0
1653547475958,ECE 200,059,091061,Wang; Edward Jay,9999,0,9999,0
1653547475958,ECE 200,060,091062,Zheng; Yang,9999,0,9999,0
1653547476485,ECE 201,A00,095526,Lo; Yu-Hwa,0,0,0,0
1653547477009,ECE 203,A00,091065,Mercier; Patrick Philip,0,0,0,0
1653547477534,ECE 207A,A00,091605,Liu; Thomas Tao-Ming,0,0,0,0
1653547478062,ECE 212AN,A00,091068,Nomura; Kenji,0,0,0,0
1653547478585,ECE 222A,A00,091069,Rebeiz; Gabriel,0,0,0,0
1653547479111,ECE 225A,A00,091070,Orlitsky; Alon,0,0,0,0
1653547479642,ECE 230A,A00,091071,Nomura; Kenji,0,0,0,0
1653547480165,ECE 236A,A00,091072,Dayeh; Shadi Ahmad,0,0,0,0
1653547480695,ECE 238A,A00,091073,Luo; Jian,0,0,0,0
1653547480695,ECE 238A,B00,091074,Luo; Jian,0,0,0,0
1653547481221,ECE 240A,A00,091075,Radic; Stojan,0,0,0,0
1653547481753,ECE 247A,A00,091592,Shi; Lingyan,0,0,0,0
1653547482277,ECE 250,A00,091076,Touri; Behrouz,0,0,0,0
1653547482801,ECE 251C,A00,091078,Nguyen; Truong Quang,0,0,0,0
1653547483327,ECE 253,A00,091079,Cosman; Pamela C.,0,0,0,0
1653547483851,ECE 255A,A00,091080,Orlitsky; Alon,0,0,0,0
1653547484374,ECE 257A,A00,091081,Zhang; Xinyu,0,0,0,0
1653547484905,ECE 260A,A01,091084,Eldon; John,0,0,0,0
1653547485427,ECE 264C,A00,091085,Galton; Ian A,0,0,0,0
1653547485950,ECE 265C,A00,094889,Presti; Calogero Davide,0,0,0,9
1653547486474,ECE 266,A01,091087,Hall; Drew A.,0,0,0,0
1653547487520,ECE 271A,A00,091090,Vasconcelos; Nuno,0,0,0,0
1653547488042,ECE 272B,A00,091091,Sworder; David D.,0,0,0,0
1653547488564,ECE 275A,A00,091092,Meyer; Florian,0,0,0,0
1653547489091,ECE 277,A00,091093,An; Cheolhong,0,0,0,0
1653547489615,ECE 283,A00,091094,Le; Hanh-Phuc,0,0,0,0
1653547490138,ECE 284,A00,091095,Kang; Mingu,0,0,0,0
1653547490138,ECE 284,B00,091096,Wang; Edward Jay,0,0,0,0
1653547490664,ECE 285,A00,094334,Touri; Behrouz,0,0,0,0
1653547491187,ECE 289,A00,091097,Whelan; David Arthur,0,0,0,0
1653547491722,MATH 200A,A00,087414,Salehi Golsefidy; Alireza,7,0,8,1
1653547492250,MATH 202A,A00,087415,Gill; Philip E.,2,0,8,6
1653547492774,MATH 203A,A00,087416,Oprea; Dragos N.,6,0,8,2
1653547493301,MATH 204A,A00,087417,Kedlaya; Kiran S.,6,0,8,2
1653547493827,MATH 205,A00,087418,Sorensen; Claus M,6,0,8,2
1653547494351,MATH 206A,A00,087419,Izadi; Elham,7,0,8,1
1653547494873,MATH 207A,A00,087420,Mohammadi; Amir,5,0,8,3
1653547495395,MATH 208,A00,087421,Staff,9,0,10,1
1653547495917,MATH 209,A00,087422,Staff,10,0,10,0
1653547496441,MATH 218,A00,087423,Staff,10,0,10,0
1653547496964,MATH 220A,A00,087424,Novak; Jonathan I,6,0,8,2
1653547497495,MATH 231A,A00,087425,Bejenaru; Ioan,3,0,8,5
1653547498024,MATH 240A,A00,087426,Ebenfelt; Peter F,5,0,8,3
1653547498550,MATH 243,A00,087427,Staff,9,0,10,1
1653547499075,MATH 248,A00,087429,Staff,10,0,10,0
1653547499599,MATH 250A,A00,087430,Spolaor; Luca,4,0,8,4
1653547500125,MATH 257A,A00,087431,Spolaor; Luca,7,0,8,1
1653547500652,MATH 258,A00,087432,Staff,9,0,10,1
1653547501180,MATH 264A,A00,087433,Warnke; Lutz Peter,5,0,8,3
1653547501706,MATH 268,A00,087434,Staff,15,0,15,0
1653547502241,MATH 269,A00,087435,Staff,14,0,15,1
1653547502768,MATH 270A,A00,087436,Nie; Jiawang,0,0,8,8
1653547503291,MATH 272A,A00,087437,Tian; Xiaochuan,1,0,8,7
1653547503837,MATH 274,A01,087439,Cheng; Li-Tien,9,0,10,1
1653547503837,MATH 274,A02,087440,Cheng; Li-Tien,10,0,10,0
1653547504366,MATH 278A,A00,087441,Staff,8,0,10,2
1653547504891,MATH 278B,A00,087442,Staff,8,0,10,2
1653547505429,MATH 278C,A00,087443,Staff,8,0,10,2
1653547505953,MATH 280A,A00,087444,Zheng; Tianyi,0,0,8,8
1653547506476,MATH 281A,A00,087445,Bradic; Jelena,0,0,8,8
1653547507003,MATH 282A,A00,087446,Zhang; Danna,0,0,8,8
1653547507525,MATH 283,A00,087447,Tesler; Glenn,0,0,0,15
1653547508047,MATH 286,A00,087448,Kemp; Todd Aahron,5,0,8,3
1653547508573,MATH 287D,A00,087449,Bradic; Jelena,0,0,0,0
1653547509096,MATH 288,A00,087450,Staff,14,0,15,1
1653547509096,MATH 288,B00,087451,Staff,15,0,15,0
1653547509096,MATH 288,C00,087452,Staff,15,0,15,0
1653547509621,MATH 290A,A00,087453,Xu; Zhouli,6,0,8,2
1653547510149,MATH 291A,A00,087454,Xu; Zhouli,7,0,8,1
1653547510671,MATH 292,A00,087455,Staff,10,0,10,0
1653547511195,MATH 295,A00,087456,Staff,50,0,50,0
1653547511728,MATH 297,001,087457,Staff,998,0,999,1
1653548070963,COGS 200,A01,087991,Staff,47,0,50,3
1653548071486,COGS 201,A01,094504,Rangel; Lara M,17,0,25,8
1653548072009,COGS 203,A00,087992,Coulson; Seana M,18,0,20,2
1653548072537,COGS 210A,001,087993,Greene; Deanna Jacquelyn,9998,0,9999,1
1653548072537,COGS 210A,002,087994,Saygin; Ayse P,9999,0,9999,0
1653548072537,COGS 210A,003,087995,Xia; Haijun,9999,0,9999,0
1653548072537,COGS 210A,004,087996,Nitz; Douglas A.,9999,0,9999,0
1653548072537,COGS 210A,005,087997,Hollan; James D.,9999,0,9999,0
1653548072537,COGS 210A,006,087998,Deak; Gedeon O.,9998,0,9999,1
1653548072537,COGS 210A,007,087999,Rossano; Federico,9999,0,9999,0
1653548073062,COGS 211A,A00,088000,Coulson; Seana M,9997,0,9999,2
1653548073585,COGS 229,A00,088002,Staff,23,0,25,2
1653548074108,COGS 260,B00,094231,Staff,17,0,20,3
1653548074108,COGS 260,A00,088004,Nitz; Douglas A.,9998,0,9999,1
1653548074631,CSE 202,A00,090110,Paturi; Ramamohan,0,0,0,0
1653548074631,CSE 202,B00,090111,Paturi; Ramamohan,0,0,0,0
1653548075155,CSE 207B,A00,090112,Heninger; Nadia A,0,0,0,0
1653548075681,CSE 208,A00,094858,Micciancio; Daniele,0,0,0,0
1653548076203,CSE 210,A00,090113,Powell; Thomas Allan,0,0,0,0
1653548076731,CSE 219,A00,090898,Staff,0,0,0,0
1653548077257,CSE 221,A00,090114,Zhou; Yuan-Yuan,0,0,0,0
1653548077780,CSE 229A,A00,090115,Porter; George M,0,0,0,0
1653548078313,CSE 229C,A00,090116,Savage; Stefan,0,0,0,0
1653548078836,CSE 230,A00,090117,Jhala; Ranjit,0,0,0,0
1653548079362,CSE 232,A00,090118,Papakonstantinou; Yannis,0,0,0,0
1653548079885,CSE 239A,A00,090121,Kumar; Arun Kumar,0,0,0,0
1653548080411,CSE 239B,A00,090122,Jhala; Ranjit,0,0,0,0
1653548080941,CSE 240A,A00,090123,Zhao; Jishen,0,0,189,189
1653548081471,CSE 243A,A00,090124,Orailoglu; Alex,0,0,15,15
1653548081998,CSE 249B,A00,090125,Kahng; Andrew Byun,13,0,20,7
1653548082524,CSE 250A,A00,090126,Berg-Kirkpatrick; Taylor D,0,0,0,0
1653548083054,CSE 252A,A00,090127,Ochoa; Benjamin Lawrence,0,0,0,0
1653548083595,CSE 258,A01,090129,McAuley; Julian John,0,0,0,0
1653548084118,CSE 258R,A01,090131,McAuley; Julian John,0,0,0,0
1653548084649,CSE 274,A00,090132,Ramamoorthi; Ravi,0,0,0,0
1653548085173,CSE 276A,A00,090133,Christensen; Henrik I,0,0,0,0
1653548085698,CSE 276C,A00,090134,Christensen; Henrik I,0,0,0,0
1653548086230,CSE 290,A00,090135,Bafna; Vineet,0,0,0,0
1653548086230,CSE 290,B00,090136,Ramamoorthi; Ravi,0,0,0,0
1653548086230,CSE 290,C00,090137,Li; Tzumao,8,0,10,2
1653548086230,CSE 290,D00,090138,Zhou; Yuan-Yuan,9,0,10,1
1653548086230,CSE 290,E00,090139,Christensen; Henrik I,8,0,10,2
1653548086230,CSE 290,F00,094053,Shalev; Aaron D,0,0,0,0
1653548086772,CSE 291,A00,090140,Munyaka; Imani N. S.,0,0,0,0
1653548086772,CSE 291,B00,094880,Yu; Qi,0,0,0,0
1653548086772,CSE 291,C00,090142,Pannuto; Patrick William,0,0,0,0
1653548086772,CSE 291,D00,094881,Zhang; Yiying,0,0,0,0
1653548086772,CSE 291,E00,095118,Su; Hao,0,0,0,0
1653548087317,CSE 293,001,094905,Bafna; Vineet,9999,0,9999,0
1653548087317,CSE 293,002,094906,Bellare; Mihir,9999,0,9999,0
1653548087317,CSE 293,003,094907,Berg-Kirkpatrick; Taylor D,9999,0,9999,0
1653548087317,CSE 293,004,094908,Christensen; Henrik I,9999,0,9999,0
1653548087317,CSE 293,005,094909,Cottrell; Garrison W,9999,0,9999,0
1653548087317,CSE 293,006,094910,Deutsch; Alin Bernard,9999,0,9999,0
1653548087317,CSE 293,007,094911,Esmaeilzadeh; Hadi,9999,0,9999,0
1653548087317,CSE 293,008,094912,Freund; Yoav,9999,0,9999,0
1653548087317,CSE 293,009,094913,Griswold; William G.,9999,0,9999,0
1653548087317,CSE 293,010,094914,Gymrek; Melissa Ann,9999,0,9999,0
1653548087317,CSE 293,011,094915,Heninger; Nadia A,9999,0,9999,0
1653548087317,CSE 293,012,094916,Impagliazzo; Russell,9999,0,9999,0
1653548087317,CSE 293,013,094917,Jhala; Ranjit,9999,0,9999,0
1653548087317,CSE 293,014,094918,Kahng; Andrew Byun,9999,0,9999,0
1653548087317,CSE 293,015,094919,Kane; Daniel Mertz,9999,0,9999,0
1653548087317,CSE 293,016,094920,Kriegman; David J,9999,0,9999,0
1653548087317,CSE 293,017,094921,Kumar; Arun Kumar,9999,0,9999,0
1653548087317,CSE 293,018,094922,Lerner; Sorin,9999,0,9999,0
1653548087317,CSE 293,019,094923,Lovett; Shachar,9999,0,9999,0
1653548087317,CSE 293,020,094924,McAuley; Julian John,9999,0,9999,0
1653548087317,CSE 293,021,094925,Micciancio; Daniele,9999,0,9999,0
1653548087317,CSE 293,022,094926,Orailoglu; Alex,9999,0,9999,0
1653548087317,CSE 293,023,094927,Paturi; Ramamohan,9999,0,9999,0
1653548087317,CSE 293,024,094928,Polikarpova; Nadezhda,9999,0,9999,0
1653548087317,CSE 293,025,094929,Politz; Joseph Gibbs,9999,0,9999,0
1653548087317,CSE 293,026,094930,Porter; George M,9999,0,9999,0
1653548087317,CSE 293,027,094931,Porter; Leonard Emerson,9999,0,9999,0
1653548087317,CSE 293,028,094932,Ramamoorthi; Ravi,9999,0,9999,0
1653548087317,CSE 293,029,094933,Sahoo; Debashis,9999,0,9999,0
1653548087317,CSE 293,030,094934,Saul; Lawrence,9999,0,9999,0
1653548087317,CSE 293,031,094935,Savage; Stefan,9999,0,9999,0
1653548087317,CSE 293,032,094936,Schulze; Jurgen P.,9999,0,9999,0
1653548087317,CSE 293,033,094937,Snoeren; Alex C.,9999,0,9999,0
1653548087317,CSE 293,034,094938,Shang; Jingbo,9999,0,9999,0
1653548087317,CSE 293,035,094939,Stefan; Deian,9999,0,9999,0
1653548087317,CSE 293,036,094940,Su; Hao,9999,0,9999,0
1653548087317,CSE 293,037,094941,Swanson; Steven James,9999,0,9999,0
1653548087317,CSE 293,038,094942,Tullsen; Dean Michael,9999,0,9999,0
1653548087317,CSE 293,039,094943,Voelker; Geoffrey M.,9999,0,9999,0
1653548087317,CSE 293,040,094944,Zhao; Jishen,9999,0,9999,0
1653548087317,CSE 293,041,094945,Zhou; Yuan-Yuan,9999,0,9999,0
1653548087317,CSE 293,042,094946,Gao; Sicun,9998,0,9999,1
1653548087317,CSE 293,043,094947,Weibel; Nadir,9999,0,9999,0
1653548087317,CSE 293,044,094948,Gupta; Rajesh K.,9999,0,9999,0
1653548087840,CSE 294,A00,090143,Porter; George M,8,0,10,2
1653548088364,DSE 200,A00,091799,Staff,50,0,50,0
1653548088887,DSE 203,A00,091800,Gupta; Amarnath,30,0,30,0
1653548089412,DSE 250,A00,091801,Deutsch; Alin Bernard,30,0,30,0
1653548089938,DSE 290,A00,091802,Altintas De Callaf; Ilkay,50,0,50,0
1653548090508,ECE 200,001,091003,Antipa; Nicholas A,9999,0,9999,0
1653548090508,ECE 200,002,091004,Atanasov; Nikolay A.,9999,0,9999,0
1653548090508,ECE 200,003,091005,Bharadia; Dinesh,9999,0,9999,0
1653548090508,ECE 200,004,091006,Cheng; Chung Kuan,9999,0,9999,0
1653548090508,ECE 200,005,091007,Cosman; Pamela C.,9999,0,9999,0
1653548090508,ECE 200,006,091008,Staff,9999,0,9999,0
1653548090508,ECE 200,007,091009,Dayeh; Shadi Ahmad,9999,0,9999,0
1653548090508,ECE 200,008,091010,Fainman; Yeshaiahu,9999,0,9999,0
1653548090508,ECE 200,009,091011,Ford; Joseph Earl,9999,0,9999,0
1653548090508,ECE 200,010,091012,Franceschetti; Massimo,9999,0,9999,0
1653548090508,ECE 200,011,091013,Fullerton; Eric E,9999,0,9999,0
1653548090508,ECE 200,012,091014,Galton; Ian A,9999,0,9999,0
1653548090508,ECE 200,013,091015,Gilja; Vikash,9999,0,9999,0
1653548090508,ECE 200,014,091016,Hall; Drew A.,9999,0,9999,0
1653548090508,ECE 200,015,091017,Hsueh; Tzu-Chien,9999,0,9999,0
1653548090508,ECE 200,016,091018,Javidi; Tara,9999,0,9999,0
1653548090508,ECE 200,017,091019,Kahng; Andrew Byun,9999,0,9999,0
1653548090508,ECE 200,018,091020,Kim; Young-Han,9999,0,9999,0
1653548090508,ECE 200,019,091021,Koushanfar; Farinaz,9999,0,9999,0
1653548090508,ECE 200,020,091022,Kuzum; Duygu,9999,0,9999,0
1653548090508,ECE 200,021,091023,Le; Hanh-Phuc,9999,0,9999,0
1653548090508,ECE 200,022,091024,Lin; Bill,9999,0,9999,0
1653548090508,ECE 200,023,091025,Liu; Zhaowei,9999,0,9999,0
1653548090508,ECE 200,024,091026,Lo; Yu-Hwa,9999,0,9999,0
1653548090508,ECE 200,025,091027,Lomakin; Vitaliy,9999,0,9999,0
1653548090508,ECE 200,026,091028,Mercier; Patrick Philip,9999,0,9999,0
1653548090508,ECE 200,027,091029,Meyer; Florian,9999,0,9999,0
1653548090508,ECE 200,028,091030,Milstein; Laurence B.,9999,0,9999,0
1653548090508,ECE 200,029,091031,Mir Arabbaygi; Siavash,9999,0,9999,0
1653548090508,ECE 200,030,091032,Mookherjea; Shayan,9999,0,9999,0
1653548090508,ECE 200,031,091033,Morris; Karcher William,9999,0,9999,0
1653548090508,ECE 200,032,091034,Ng; Tse Nga,9999,0,9999,0
1653548090508,ECE 200,033,091035,Nguyen; Truong Quang,9999,0,9999,0
1653548090508,ECE 200,034,091036,Nomura; Kenji,9999,0,9999,0
1653548090508,ECE 200,035,091037,Orlitsky; Alon,9999,0,9999,0
1653548090508,ECE 200,036,091038,Pal; Piya,9999,0,9999,0
1653548090508,ECE 200,037,091039,Papen; George C.,9999,0,9999,0
1653548090508,ECE 200,038,091040,Radic; Stojan,9999,0,9999,0
1653548090508,ECE 200,039,091041,Rao; Bhaskar D.,9999,0,9999,0
1653548090508,ECE 200,040,091042,Rao; Ramesh R,9999,0,9999,0
1653548090508,ECE 200,041,091043,Rebeiz; Gabriel,9999,0,9999,0
1653548090508,ECE 200,042,091044,Sanford; John R,9999,0,9999,0
1653548090508,ECE 200,043,091045,Siegel; Paul H.,9999,0,9999,0
1653548090508,ECE 200,044,091046,Sievenpiper; Daniel F.,9999,0,9999,0
1653548090508,ECE 200,045,091047,Sworder; David D.,9999,0,9999,0
1653548090508,ECE 200,046,091048,Taur; Yuan,9999,0,9999,0
1653548090508,ECE 200,047,091049,Touri; Behrouz,9999,0,9999,0
1653548090508,ECE 200,048,091050,Trivedi; Mohan M.,9999,0,9999,0
1653548090508,ECE 200,049,091051,Vardy; Alexander,9999,0,9999,0
1653548090508,ECE 200,050,091052,Vasconcelos; Nuno,9999,0,9999,0
1653548090508,ECE 200,051,091053,Wang; Xiaolong,9999,0,9999,0
1653548090508,ECE 200,052,091054,Xie; Pengtao,9999,0,9999,0
1653548090508,ECE 200,053,091055,Yip; Michael,9999,0,9999,0
1653548090508,ECE 200,054,091056,Zeger; Kenneth A.,9999,0,9999,0
1653548090508,ECE 200,055,091057,Zhang; Xinyu,9999,0,9999,0
1653548090508,ECE 200,056,091058,Turakhia; Yatish Girish,9999,0,9999,0
1653548090508,ECE 200,057,091059,Kang; Mingu,9999,0,9999,0
1653548090508,ECE 200,058,091060,Shi; Yuanyuan,9999,0,9999,0
1653548090508,ECE 200,059,091061,Wang; Edward Jay,9999,0,9999,0
1653548090508,ECE 200,060,091062,Zheng; Yang,9999,0,9999,0
1653548091036,ECE 201,A00,095526,Lo; Yu-Hwa,0,0,0,0
1653548091561,ECE 203,A00,091065,Mercier; Patrick Philip,0,0,0,0
1653548092089,ECE 207A,A00,091605,Liu; Thomas Tao-Ming,0,0,0,0
1653548092612,ECE 212AN,A00,091068,Nomura; Kenji,0,0,0,0
1653548093135,ECE 222A,A00,091069,Rebeiz; Gabriel,0,0,0,0
1653548093660,ECE 225A,A00,091070,Orlitsky; Alon,0,0,0,0
1653548094184,ECE 230A,A00,091071,Nomura; Kenji,0,0,0,0
1653548094706,ECE 236A,A00,091072,Dayeh; Shadi Ahmad,0,0,0,0
1653548095228,ECE 238A,A00,091073,Luo; Jian,0,0,0,0
1653548095228,ECE 238A,B00,091074,Luo; Jian,0,0,0,0
1653548095751,ECE 240A,A00,091075,Radic; Stojan,0,0,0,0
1653548096274,ECE 247A,A00,091592,Shi; Lingyan,0,0,0,0
1653548096806,ECE 250,A00,091076,Touri; Behrouz,0,0,0,0
1653548097329,ECE 251C,A00,091078,Nguyen; Truong Quang,0,0,0,0
1653548097854,ECE 253,A00,091079,Cosman; Pamela C.,0,0,0,0
1653548098381,ECE 255A,A00,091080,Orlitsky; Alon,0,0,0,0
1653548098905,ECE 257A,A00,091081,Zhang; Xinyu,0,0,0,0
1653548099429,ECE 260A,A01,091084,Eldon; John,0,0,0,0
1653548099955,ECE 264C,A00,091085,Galton; Ian A,0,0,0,0
1653548100483,ECE 265C,A00,094889,Presti; Calogero Davide,0,0,0,9
1653548101006,ECE 266,A01,091087,Hall; Drew A.,0,0,0,0
1653548102059,ECE 271A,A00,091090,Vasconcelos; Nuno,0,0,0,0
1653548102582,ECE 272B,A00,091091,Sworder; David D.,0,0,0,0
1653548103104,ECE 275A,A00,091092,Meyer; Florian,0,0,0,0
1653548103627,ECE 277,A00,091093,An; Cheolhong,0,0,0,0
1653548104156,ECE 283,A00,091094,Le; Hanh-Phuc,0,0,0,0
1653548104681,ECE 284,A00,091095,Kang; Mingu,0,0,0,0
1653548104681,ECE 284,B00,091096,Wang; Edward Jay,0,0,0,0
1653548105206,ECE 285,A00,094334,Touri; Behrouz,0,0,0,0
1653548105731,ECE 289,A00,091097,Whelan; David Arthur,0,0,0,0
1653548106346,MATH 200A,A00,087414,Salehi Golsefidy; Alireza,7,0,8,1
1653548106874,MATH 202A,A00,087415,Gill; Philip E.,2,0,8,6
1653548107398,MATH 203A,A00,087416,Oprea; Dragos N.,6,0,8,2
1653548107923,MATH 204A,A00,087417,Kedlaya; Kiran S.,6,0,8,2
1653548108448,MATH 205,A00,087418,Sorensen; Claus M,6,0,8,2
1653548108975,MATH 206A,A00,087419,Izadi; Elham,7,0,8,1
1653548109498,MATH 207A,A00,087420,Mohammadi; Amir,5,0,8,3
1653548110022,MATH 208,A00,087421,Staff,9,0,10,1
1653548110547,MATH 209,A00,087422,Staff,10,0,10,0
1653548111071,MATH 218,A00,087423,Staff,10,0,10,0
1653548111594,MATH 220A,A00,087424,Novak; Jonathan I,6,0,8,2
1653548112119,MATH 231A,A00,087425,Bejenaru; Ioan,3,0,8,5
1653548112647,MATH 240A,A00,087426,Ebenfelt; Peter F,5,0,8,3
1653548113174,MATH 243,A00,087427,Staff,9,0,10,1
1653548113697,MATH 248,A00,087429,Staff,10,0,10,0
1653548114226,MATH 250A,A00,087430,Spolaor; Luca,4,0,8,4
1653548114749,MATH 257A,A00,087431,Spolaor; Luca,7,0,8,1
1653548115275,MATH 258,A00,087432,Staff,9,0,10,1
1653548115807,MATH 264A,A00,087433,Warnke; Lutz Peter,5,0,8,3
1653548116329,MATH 268,A00,087434,Staff,15,0,15,0
1653548116854,MATH 269,A00,087435,Staff,14,0,15,1
1653548117378,MATH 270A,A00,087436,Nie; Jiawang,0,0,8,8
1653548117903,MATH 272A,A00,087437,Tian; Xiaochuan,1,0,8,7
1653548118426,MATH 274,A01,087439,Cheng; Li-Tien,9,0,10,1
1653548118426,MATH 274,A02,087440,Cheng; Li-Tien,10,0,10,0
1653548118948,MATH 278A,A00,087441,Staff,8,0,10,2
1653548119471,MATH 278B,A00,087442,Staff,8,0,10,2
1653548119996,MATH 278C,A00,087443,Staff,8,0,10,2
1653548120522,MATH 280A,A00,087444,Zheng; Tianyi,0,0,8,8
1653548121045,MATH 281A,A00,087445,Bradic; Jelena,0,0,8,8
1653548121571,MATH 282A,A00,087446,Zhang; Danna,0,0,8,8
1653548122098,MATH 283,A00,087447,Tesler; Glenn,0,0,0,15
1653548122622,MATH 286,A00,087448,Kemp; Todd Aahron,5,0,8,3
1653548123148,MATH 287D,A00,087449,Bradic; Jelena,0,0,0,0
1653548123672,MATH 288,A00,087450,Staff,14,0,15,1
1653548123672,MATH 288,B00,087451,Staff,15,0,15,0
1653548123672,MATH 288,C00,087452,Staff,15,0,15,0
1653548124195,MATH 290A,A00,087453,Xu; Zhouli,6,0,8,2
1653548124718,MATH 291A,A00,087454,Xu; Zhouli,7,0,8,1
1653548125240,MATH 292,A00,087455,Staff,10,0,10,0
1653548125764,MATH 295,A00,087456,Staff,50,0,50,0
1653548126285,MATH 297,001,087457,Staff,998,0,999,1
1653548696196,COGS 200,A01,087991,Staff,47,0,50,3
1653548696719,COGS 201,A01,094504,Rangel; Lara M,17,0,25,8
1653548697252,COGS 203,A00,087992,Coulson; Seana M,18,0,20,2
1653548697781,COGS 210A,001,087993,Greene; Deanna Jacquelyn,9998,0,9999,1
1653548697781,COGS 210A,002,087994,Saygin; Ayse P,9999,0,9999,0
1653548697781,COGS 210A,003,087995,Xia; Haijun,9999,0,9999,0
1653548697781,COGS 210A,004,087996,Nitz; Douglas A.,9999,0,9999,0
1653548697781,COGS 210A,005,087997,Hollan; James D.,9999,0,9999,0
1653548697781,COGS 210A,006,087998,Deak; Gedeon O.,9998,0,9999,1
1653548697781,COGS 210A,007,087999,Rossano; Federico,9999,0,9999,0
1653548698308,COGS 211A,A00,088000,Coulson; Seana M,9997,0,9999,2
1653548698839,COGS 229,A00,088002,Staff,23,0,25,2
1653548699365,COGS 260,B00,094231,Staff,17,0,20,3
1653548699365,COGS 260,A00,088004,Nitz; Douglas A.,9998,0,9999,1
1653548699889,CSE 202,A00,090110,Paturi; Ramamohan,0,0,0,0
1653548699889,CSE 202,B00,090111,Paturi; Ramamohan,0,0,0,0
1653548700413,CSE 207B,A00,090112,Heninger; Nadia A,0,0,0,0
1653548700936,CSE 208,A00,094858,Micciancio; Daniele,0,0,0,0
1653548701459,CSE 210,A00,090113,Powell; Thomas Allan,0,0,0,0
1653548701987,CSE 219,A00,090898,Staff,0,0,0,0
1653548702513,CSE 221,A00,090114,Zhou; Yuan-Yuan,0,0,0,0
1653548703037,CSE 229A,A00,090115,Porter; George M,0,0,0,0
1653548703636,CSE 229C,A00,090116,Savage; Stefan,0,0,0,0
1653548704160,CSE 230,A00,090117,Jhala; Ranjit,0,0,0,0
1653548704684,CSE 232,A00,090118,Papakonstantinou; Yannis,0,0,0,0
1653548705205,CSE 239A,A00,090121,Kumar; Arun Kumar,0,0,0,0
1653548705729,CSE 239B,A00,090122,Jhala; Ranjit,0,0,0,0
1653548706255,CSE 240A,A00,090123,Zhao; Jishen,0,0,189,189
1653548706780,CSE 243A,A00,090124,Orailoglu; Alex,0,0,15,15
1653548707303,CSE 249B,A00,090125,Kahng; Andrew Byun,13,0,20,7
1653548707826,CSE 250A,A00,090126,Berg-Kirkpatrick; Taylor D,0,0,0,0
1653548708353,CSE 252A,A00,090127,Ochoa; Benjamin Lawrence,0,0,0,0
1653548708875,CSE 258,A01,090129,McAuley; Julian John,0,0,0,0
1653548709402,CSE 258R,A01,090131,McAuley; Julian John,0,0,0,0
1653548709928,CSE 274,A00,090132,Ramamoorthi; Ravi,0,0,0,0
1653548710452,CSE 276A,A00,090133,Christensen; Henrik I,0,0,0,0
1653548710982,CSE 276C,A00,090134,Christensen; Henrik I,0,0,0,0
1653548711510,CSE 290,A00,090135,Bafna; Vineet,0,0,0,0
1653548711510,CSE 290,B00,090136,Ramamoorthi; Ravi,0,0,0,0
1653548711510,CSE 290,C00,090137,Li; Tzumao,8,0,10,2
1653548711510,CSE 290,D00,090138,Zhou; Yuan-Yuan,9,0,10,1
1653548711510,CSE 290,E00,090139,Christensen; Henrik I,8,0,10,2
1653548711510,CSE 290,F00,094053,Shalev; Aaron D,0,0,0,0
1653548712034,CSE 291,A00,090140,Munyaka; Imani N. S.,0,0,0,0
1653548712034,CSE 291,B00,094880,Yu; Qi,0,0,0,0
1653548712034,CSE 291,C00,090142,Pannuto; Patrick William,0,0,0,0
1653548712034,CSE 291,D00,094881,Zhang; Yiying,0,0,0,0
1653548712034,CSE 291,E00,095118,Su; Hao,0,0,0,0
1653548712562,CSE 293,001,094905,Bafna; Vineet,9999,0,9999,0
1653548712562,CSE 293,002,094906,Bellare; Mihir,9999,0,9999,0
1653548712562,CSE 293,003,094907,Berg-Kirkpatrick; Taylor D,9999,0,9999,0
1653548712562,CSE 293,004,094908,Christensen; Henrik I,9999,0,9999,0
1653548712562,CSE 293,005,094909,Cottrell; Garrison W,9999,0,9999,0
1653548712562,CSE 293,006,094910,Deutsch; Alin Bernard,9999,0,9999,0
1653548712562,CSE 293,007,094911,Esmaeilzadeh; Hadi,9999,0,9999,0
1653548712562,CSE 293,008,094912,Freund; Yoav,9999,0,9999,0
1653548712562,CSE 293,009,094913,Griswold; William G.,9999,0,9999,0
1653548712562,CSE 293,010,094914,Gymrek; Melissa Ann,9999,0,9999,0
1653548712562,CSE 293,011,094915,Heninger; Nadia A,9999,0,9999,0
1653548712562,CSE 293,012,094916,Impagliazzo; Russell,9999,0,9999,0
1653548712562,CSE 293,013,094917,Jhala; Ranjit,9999,0,9999,0
1653548712562,CSE 293,014,094918,Kahng; Andrew Byun,9999,0,9999,0
1653548712562,CSE 293,015,094919,Kane; Daniel Mertz,9999,0,9999,0
1653548712562,CSE 293,016,094920,Kriegman; David J,9999,0,9999,0
1653548712562,CSE 293,017,094921,Kumar; Arun Kumar,9999,0,9999,0
1653548712562,CSE 293,018,094922,Lerner; Sorin,9999,0,9999,0
1653548712562,CSE 293,019,094923,Lovett; Shachar,9999,0,9999,0
1653548712562,CSE 293,020,094924,McAuley; Julian John,9999,0,9999,0
1653548712562,CSE 293,021,094925,Micciancio; Daniele,9999,0,9999,0
1653548712562,CSE 293,022,094926,Orailoglu; Alex,9999,0,9999,0
1653548712562,CSE 293,023,094927,Paturi; Ramamohan,9999,0,9999,0
1653548712562,CSE 293,024,094928,Polikarpova; Nadezhda,9999,0,9999,0
1653548712562,CSE 293,025,094929,Politz; Joseph Gibbs,9999,0,9999,0
1653548712562,CSE 293,026,094930,Porter; George M,9999,0,9999,0
1653548712562,CSE 293,027,094931,Porter; Leonard Emerson,9999,0,9999,0
1653548712562,CSE 293,028,094932,Ramamoorthi; Ravi,9999,0,9999,0
1653548712562,CSE 293,029,094933,Sahoo; Debashis,9999,0,9999,0
1653548712562,CSE 293,030,094934,Saul; Lawrence,9999,0,9999,0
1653548712562,CSE 293,031,094935,Savage; Stefan,9999,0,9999,0
1653548712562,CSE 293,032,094936,Schulze; Jurgen P.,9999,0,9999,0
1653548712562,CSE 293,033,094937,Snoeren; Alex C.,9999,0,9999,0
1653548712562,CSE 293,034,094938,Shang; Jingbo,9999,0,9999,0
1653548712562,CSE 293,035,094939,Stefan; Deian,9999,0,9999,0
1653548712562,CSE 293,036,094940,Su; Hao,9999,0,9999,0
1653548712562,CSE 293,037,094941,Swanson; Steven James,9999,0,9999,0
1653548712562,CSE 293,038,094942,Tullsen; Dean Michael,9999,0,9999,0
1653548712562,CSE 293,039,094943,Voelker; Geoffrey M.,9999,0,9999,0
1653548712562,CSE 293,040,094944,Zhao; Jishen,9999,0,9999,0
1653548712562,CSE 293,041,094945,Zhou; Yuan-Yuan,9999,0,9999,0
1653548712562,CSE 293,042,094946,Gao; Sicun,9998,0,9999,1
1653548712562,CSE 293,043,094947,Weibel; Nadir,9999,0,9999,0
1653548712562,CSE 293,044,094948,Gupta; Rajesh K.,9999,0,9999,0
1653548713085,CSE 294,A00,090143,Porter; George M,8,0,10,2
1653548713608,DSE 200,A00,091799,Staff,50,0,50,0
1653548714131,DSE 203,A00,091800,Gupta; Amarnath,30,0,30,0
1653548714655,DSE 250,A00,091801,Deutsch; Alin Bernard,30,0,30,0
1653548715179,DSE 290,A00,091802,Altintas De Callaf; Ilkay,50,0,50,0
1653548715754,ECE 200,001,091003,Antipa; Nicholas A,9999,0,9999,0
1653548715754,ECE 200,002,091004,Atanasov; Nikolay A.,9999,0,9999,0
1653548715754,ECE 200,003,091005,Bharadia; Dinesh,9999,0,9999,0
1653548715754,ECE 200,004,091006,Cheng; Chung Kuan,9999,0,9999,0
1653548715754,ECE 200,005,091007,Cosman; Pamela C.,9999,0,9999,0
1653548715754,ECE 200,006,091008,Staff,9999,0,9999,0
1653548715754,ECE 200,007,091009,Dayeh; Shadi Ahmad,9999,0,9999,0
1653548715754,ECE 200,008,091010,Fainman; Yeshaiahu,9999,0,9999,0
1653548715754,ECE 200,009,091011,Ford; Joseph Earl,9999,0,9999,0
1653548715754,ECE 200,010,091012,Franceschetti; Massimo,9999,0,9999,0
1653548715754,ECE 200,011,091013,Fullerton; Eric E,9999,0,9999,0
1653548715754,ECE 200,012,091014,Galton; Ian A,9999,0,9999,0
1653548715754,ECE 200,013,091015,Gilja; Vikash,9999,0,9999,0
1653548715754,ECE 200,014,091016,Hall; Drew A.,9999,0,9999,0
1653548715754,ECE 200,015,091017,Hsueh; Tzu-Chien,9999,0,9999,0
1653548715754,ECE 200,016,091018,Javidi; Tara,9999,0,9999,0
1653548715754,ECE 200,017,091019,Kahng; Andrew Byun,9999,0,9999,0
1653548715754,ECE 200,018,091020,Kim; Young-Han,9999,0,9999,0
1653548715754,ECE 200,019,091021,Koushanfar; Farinaz,9999,0,9999,0
1653548715754,ECE 200,020,091022,Kuzum; Duygu,9999,0,9999,0
1653548715754,ECE 200,021,091023,Le; Hanh-Phuc,9999,0,9999,0
1653548715754,ECE 200,022,091024,Lin; Bill,9999,0,9999,0
1653548715754,ECE 200,023,091025,Liu; Zhaowei,9999,0,9999,0
1653548715754,ECE 200,024,091026,Lo; Yu-Hwa,9999,0,9999,0
1653548715754,ECE 200,025,091027,Lomakin; Vitaliy,9999,0,9999,0
1653548715754,ECE 200,026,091028,Mercier; Patrick Philip,9999,0,9999,0
1653548715754,ECE 200,027,091029,Meyer; Florian,9999,0,9999,0
1653548715754,ECE 200,028,091030,Milstein; Laurence B.,9999,0,9999,0
1653548715754,ECE 200,029,091031,Mir Arabbaygi; Siavash,9999,0,9999,0
1653548715754,ECE 200,030,091032,Mookherjea; Shayan,9999,0,9999,0
1653548715754,ECE 200,031,091033,Morris; Karcher William,9999,0,9999,0
1653548715754,ECE 200,032,091034,Ng; Tse Nga,9999,0,9999,0
1653548715754,ECE 200,033,091035,Nguyen; Truong Quang,9999,0,9999,0
1653548715754,ECE 200,034,091036,Nomura; Kenji,9999,0,9999,0
1653548715754,ECE 200,035,091037,Orlitsky; Alon,9999,0,9999,0
1653548715754,ECE 200,036,091038,Pal; Piya,9999,0,9999,0
1653548715754,ECE 200,037,091039,Papen; George C.,9999,0,9999,0
1653548715754,ECE 200,038,091040,Radic; Stojan,9999,0,9999,0
1653548715754,ECE 200,039,091041,Rao; Bhaskar D.,9999,0,9999,0
1653548715754,ECE 200,040,091042,Rao; Ramesh R,9999,0,9999,0
1653548715754,ECE 200,041,091043,Rebeiz; Gabriel,9999,0,9999,0
1653548715754,ECE 200,042,091044,Sanford; John R,9999,0,9999,0
1653548715754,ECE 200,043,091045,Siegel; Paul H.,9999,0,9999,0
1653548715754,ECE 200,044,091046,Sievenpiper; Daniel F.,9999,0,9999,0
1653548715754,ECE 200,045,091047,Sworder; David D.,9999,0,9999,0
1653548715754,ECE 200,046,091048,Taur; Yuan,9999,0,9999,0
1653548715754,ECE 200,047,091049,Touri; Behrouz,9999,0,9999,0
1653548715754,ECE 200,048,091050,Trivedi; Mohan M.,9999,0,9999,0
1653548715754,ECE 200,049,091051,Vardy; Alexander,9999,0,9999,0
1653548715754,ECE 200,050,091052,Vasconcelos; Nuno,9999,0,9999,0
1653548715754,ECE 200,051,091053,Wang; Xiaolong,9999,0,9999,0
1653548715754,ECE 200,052,091054,Xie; Pengtao,9999,0,9999,0
1653548715754,ECE 200,053,091055,Yip; Michael,9999,0,9999,0
1653548715754,ECE 200,054,091056,Zeger; Kenneth A.,9999,0,9999,0
1653548715754,ECE 200,055,091057,Zhang; Xinyu,9999,0,9999,0
1653548715754,ECE 200,056,091058,Turakhia; Yatish Girish,9999,0,9999,0
1653548715754,ECE 200,057,091059,Kang; Mingu,9999,0,9999,0
1653548715754,ECE 200,058,091060,Shi; Yuanyuan,9999,0,9999,0
1653548715754,ECE 200,059,091061,Wang; Edward Jay,9999,0,9999,0
1653548715754,ECE 200,060,091062,Zheng; Yang,9999,0,9999,0
1653548716275,ECE 201,A00,095526,Lo; Yu-Hwa,0,0,0,0
1653548716803,ECE 203,A00,091065,Mercier; Patrick Philip,0,0,0,0
1653548717327,ECE 207A,A00,091605,Liu; Thomas Tao-Ming,0,0,0,0
1653548717850,ECE 212AN,A00,091068,Nomura; Kenji,0,0,0,0
1653548718373,ECE 222A,A00,091069,Rebeiz; Gabriel,0,0,0,0
1653548718903,ECE 225A,A00,091070,Orlitsky; Alon,0,0,0,0
1653548719431,ECE 230A,A00,091071,Nomura; Kenji,0,0,0,0
1653548719965,ECE 236A,A00,091072,Dayeh; Shadi Ahmad,0,0,0,0
1653548720493,ECE 238A,A00,091073,Luo; Jian,0,0,0,0
1653548720493,ECE 238A,B00,091074,Luo; Jian,0,0,0,0
1653548721023,ECE 240A,A00,091075,Radic; Stojan,0,0,0,0
1653548721550,ECE 247A,A00,091592,Shi; Lingyan,0,0,0,0
1653548722073,ECE 250,A00,091076,Touri; Behrouz,0,0,0,0
1653548722596,ECE 251C,A00,091078,Nguyen; Truong Quang,0,0,0,0
1653548723119,ECE 253,A00,091079,Cosman; Pamela C.,0,0,0,0
1653548723651,ECE 255A,A00,091080,Orlitsky; Alon,0,0,0,0
1653548724175,ECE 257A,A00,091081,Zhang; Xinyu,0,0,0,0
1653548724700,ECE 260A,A01,091084,Eldon; John,0,0,0,0
1653548725226,ECE 264C,A00,091085,Galton; Ian A,0,0,0,0
1653548725751,ECE 265C,A00,094889,Presti; Calogero Davide,0,0,0,9
1653548726282,ECE 266,A01,091087,Hall; Drew A.,0,0,0,0
1653548727333,ECE 271A,A00,091090,Vasconcelos; Nuno,0,0,0,0
1653548727856,ECE 272B,A00,091091,Sworder; David D.,0,0,0,0
1653548728384,ECE 275A,A00,091092,Meyer; Florian,0,0,0,0
1653548728909,ECE 277,A00,091093,An; Cheolhong,0,0,0,0
1653548729432,ECE 283,A00,091094,Le; Hanh-Phuc,0,0,0,0
1653548729964,ECE 284,A00,091095,Kang; Mingu,0,0,0,0
1653548729964,ECE 284,B00,091096,Wang; Edward Jay,0,0,0,0
1653548730489,ECE 285,A00,094334,Touri; Behrouz,0,0,0,0
1653548731015,ECE 289,A00,091097,Whelan; David Arthur,0,0,0,0
1653548731552,MATH 200A,A00,087414,Salehi Golsefidy; Alireza,7,0,8,1
1653548732075,MATH 202A,A00,087415,Gill; Philip E.,2,0,8,6
1653548732603,MATH 203A,A00,087416,Oprea; Dragos N.,6,0,8,2
1653548733125,MATH 204A,A00,087417,Kedlaya; Kiran S.,6,0,8,2
1653548733653,MATH 205,A00,087418,Sorensen; Claus M,6,0,8,2
1653548734179,MATH 206A,A00,087419,Izadi; Elham,7,0,8,1
1653548734703,MATH 207A,A00,087420,Mohammadi; Amir,5,0,8,3
1653548735226,MATH 208,A00,087421,Staff,9,0,10,1
1653548735751,MATH 209,A00,087422,Staff,10,0,10,0
1653548736279,MATH 218,A00,087423,Staff,10,0,10,0
1653548736802,MATH 220A,A00,087424,Novak; Jonathan I,6,0,8,2
1653548737324,MATH 231A,A00,087425,Bejenaru; Ioan,3,0,8,5
1653548737852,MATH 240A,A00,087426,Ebenfelt; Peter F,5,0,8,3
1653548738375,MATH 243,A00,087427,Staff,9,0,10,1
1653548738902,MATH 248,A00,087429,Staff,10,0,10,0
1653548739429,MATH 250A,A00,087430,Spolaor; Luca,4,0,8,4
1653548739953,MATH 257A,A00,087431,Spolaor; Luca,7,0,8,1
1653548740484,MATH 258,A00,087432,Staff,9,0,10,1
1653548741007,MATH 264A,A00,087433,Warnke; Lutz Peter,5,0,8,3
1653548741530,MATH 268,A00,087434,Staff,15,0,15,0
1653548742052,MATH 269,A00,087435,Staff,14,0,15,1
1653548742575,MATH 270A,A00,087436,Nie; Jiawang,0,0,8,8
1653548743097,MATH 272A,A00,087437,Tian; Xiaochuan,1,0,8,7
1653548743623,MATH 274,A01,087439,Cheng; Li-Tien,9,0,10,1
1653548743623,MATH 274,A02,087440,Cheng; Li-Tien,10,0,10,0
1653548744147,MATH 278A,A00,087441,Staff,8,0,10,2
1653548744673,MATH 278B,A00,087442,Staff,8,0,10,2
1653548745196,MATH 278C,A00,087443,Staff,8,0,10,2
1653548745720,MATH 280A,A00,087444,Zheng; Tianyi,0,0,8,8
1653548746261,MATH 281A,A00,087445,Bradic; Jelena,0,0,8,8
1653548746784,MATH 282A,A00,087446,Zhang; Danna,0,0,8,8
1653548747311,MATH 283,A00,087447,Tesler; Glenn,0,0,0,15
1653548747839,MATH 286,A00,087448,Kemp; Todd Aahron,5,0,8,3
1653548748375,MATH 287D,A00,087449,Bradic; Jelena,0,0,0,0
1653548748903,MATH 288,A00,087450,Staff,14,0,15,1
1653548748903,MATH 288,B00,087451,Staff,15,0,15,0
1653548748903,MATH 288,C00,087452,Staff,15,0,15,0
1653548749427,MATH 290A,A00,087453,Xu; Zhouli,6,0,8,2
1653548749949,MATH 291A,A00,087454,Xu; Zhouli,7,0,8,1
1653548750483,MATH 292,A00,087455,Staff,10,0,10,0
1653548751009,MATH 295,A00,087456,Staff,50,0,50,0
1653548751535,MATH 297,001,087457,Staff,998,0,999,1
1653549312028,COGS 200,A01,087991,Staff,47,0,50,3
1653549312566,COGS 201,A01,094504,Rangel; Lara M,17,0,25,8
1653549313089,COGS 203,A00,087992,Coulson; Seana M,18,0,20,2
1653549313626,COGS 210A,001,087993,Greene; Deanna Jacquelyn,9998,0,9999,1
1653549313626,COGS 210A,002,087994,Saygin; Ayse P,9999,0,9999,0
1653549313626,COGS 210A,003,087995,Xia; Haijun,9999,0,9999,0
1653549313626,COGS 210A,004,087996,Nitz; Douglas A.,9999,0,9999,0
1653549313626,COGS 210A,005,087997,Hollan; James D.,9999,0,9999,0
1653549313626,COGS 210A,006,087998,Deak; Gedeon O.,9998,0,9999,1
1653549313626,COGS 210A,007,087999,Rossano; Federico,9999,0,9999,0
1653549314150,COGS 211A,A00,088000,Coulson; Seana M,9997,0,9999,2
1653549314673,COGS 229,A00,088002,Staff,23,0,25,2
1653549315197,COGS 260,B00,094231,Staff,17,0,20,3
1653549315197,COGS 260,A00,088004,Nitz; Douglas A.,9998,0,9999,1
1653549315722,CSE 202,A00,090110,Paturi; Ramamohan,0,0,0,0
1653549315722,CSE 202,B00,090111,Paturi; Ramamohan,0,0,0,0
1653549316246,CSE 207B,A00,090112,Heninger; Nadia A,0,0,0,0
1653549316774,CSE 208,A00,094858,Micciancio; Daniele,0,0,0,0
1653549317298,CSE 210,A00,090113,Powell; Thomas Allan,0,0,0,0
1653549317826,CSE 219,A00,090898,Staff,0,0,0,0
1653549318351,CSE 221,A00,090114,Zhou; Yuan-Yuan,0,0,0,0
1653549318878,CSE 229A,A00,090115,Porter; George M,0,0,0,0
1653549319409,CSE 229C,A00,090116,Savage; Stefan,0,0,0,0
1653549319938,CSE 230,A00,090117,Jhala; Ranjit,0,0,0,0
1653549320471,CSE 232,A00,090118,Papakonstantinou; Yannis,0,0,0,0
1653549320998,CSE 239A,A00,090121,Kumar; Arun Kumar,0,0,0,0
1653549321525,CSE 239B,A00,090122,Jhala; Ranjit,0,0,0,0
1653549322050,CSE 240A,A00,090123,Zhao; Jishen,0,0,189,189
1653549322574,CSE 243A,A00,090124,Orailoglu; Alex,0,0,15,15
1653549323099,CSE 249B,A00,090125,Kahng; Andrew Byun,13,0,20,7
1653549323623,CSE 250A,A00,090126,Berg-Kirkpatrick; Taylor D,0,0,0,0
1653549324153,CSE 252A,A00,090127,Ochoa; Benjamin Lawrence,0,0,0,0
1653549324677,CSE 258,A01,090129,McAuley; Julian John,0,0,0,0
1653549325208,CSE 258R,A01,090131,McAuley; Julian John,0,0,0,0
1653549325732,CSE 274,A00,090132,Ramamoorthi; Ravi,0,0,0,0
1653549326272,CSE 276A,A00,090133,Christensen; Henrik I,0,0,0,0
1653549326796,CSE 276C,A00,090134,Christensen; Henrik I,0,0,0,0
1653549327326,CSE 290,A00,090135,Bafna; Vineet,0,0,0,0
1653549327326,CSE 290,B00,090136,Ramamoorthi; Ravi,0,0,0,0
1653549327326,CSE 290,C00,090137,Li; Tzumao,8,0,10,2
1653549327326,CSE 290,D00,090138,Zhou; Yuan-Yuan,9,0,10,1
1653549327326,CSE 290,E00,090139,Christensen; Henrik I,8,0,10,2
1653549327326,CSE 290,F00,094053,Shalev; Aaron D,0,0,0,0
1653549327867,CSE 291,A00,090140,Munyaka; Imani N. S.,0,0,0,0
1653549327867,CSE 291,B00,094880,Yu; Qi,0,0,0,0
1653549327867,CSE 291,C00,090142,Pannuto; Patrick William,0,0,0,0
1653549327867,CSE 291,D00,094881,Zhang; Yiying,0,0,0,0
1653549327867,CSE 291,E00,095118,Su; Hao,0,0,0,0
1653549328527,CSE 293,001,094905,Bafna; Vineet,9999,0,9999,0
1653549328527,CSE 293,002,094906,Bellare; Mihir,9999,0,9999,0
1653549328527,CSE 293,003,094907,Berg-Kirkpatrick; Taylor D,9999,0,9999,0
1653549328527,CSE 293,004,094908,Christensen; Henrik I,9999,0,9999,0
1653549328527,CSE 293,005,094909,Cottrell; Garrison W,9999,0,9999,0
1653549328527,CSE 293,006,094910,Deutsch; Alin Bernard,9999,0,9999,0
1653549328527,CSE 293,007,094911,Esmaeilzadeh; Hadi,9999,0,9999,0
1653549328527,CSE 293,008,094912,Freund; Yoav,9999,0,9999,0
1653549328527,CSE 293,009,094913,Griswold; William G.,9999,0,9999,0
1653549328527,CSE 293,010,094914,Gymrek; Melissa Ann,9999,0,9999,0
1653549328527,CSE 293,011,094915,Heninger; Nadia A,9999,0,9999,0
1653549328527,CSE 293,012,094916,Impagliazzo; Russell,9999,0,9999,0
1653549328527,CSE 293,013,094917,Jhala; Ranjit,9999,0,9999,0
1653549328527,CSE 293,014,094918,Kahng; Andrew Byun,9999,0,9999,0
1653549328527,CSE 293,015,094919,Kane; Daniel Mertz,9999,0,9999,0
1653549328527,CSE 293,016,094920,Kriegman; David J,9999,0,9999,0
1653549328527,CSE 293,017,094921,Kumar; Arun Kumar,9999,0,9999,0
1653549328527,CSE 293,018,094922,Lerner; Sorin,9999,0,9999,0
1653549328527,CSE 293,019,094923,Lovett; Shachar,9999,0,9999,0
1653549328527,CSE 293,020,094924,McAuley; Julian John,9999,0,9999,0
1653549328527,CSE 293,021,094925,Micciancio; Daniele,9999,0,9999,0
1653549328527,CSE 293,022,094926,Orailoglu; Alex,9999,0,9999,0
1653549328527,CSE 293,023,094927,Paturi; Ramamohan,9999,0,9999,0
1653549328527,CSE 293,024,094928,Polikarpova; Nadezhda,9999,0,9999,0
1653549328527,CSE 293,025,094929,Politz; Joseph Gibbs,9999,0,9999,0
1653549328527,CSE 293,026,094930,Porter; George M,9999,0,9999,0
1653549328527,CSE 293,027,094931,Porter; Leonard Emerson,9999,0,9999,0
1653549328527,CSE 293,028,094932,Ramamoorthi; Ravi,9999,0,9999,0
1653549328527,CSE 293,029,094933,Sahoo; Debashis,9999,0,9999,0
1653549328527,CSE 293,030,094934,Saul; Lawrence,9999,0,9999,0
1653549328527,CSE 293,031,094935,Savage; Stefan,9999,0,9999,0
1653549328527,CSE 293,032,094936,Schulze; Jurgen P.,9999,0,9999,0
1653549328527,CSE 293,033,094937,Snoeren; Alex C.,9999,0,9999,0
1653549328527,CSE 293,034,094938,Shang; Jingbo,9999,0,9999,0
1653549328527,CSE 293,035,094939,Stefan; Deian,9999,0,9999,0
1653549328527,CSE 293,036,094940,Su; Hao,9999,0,9999,0
1653549328527,CSE 293,037,094941,Swanson; Steven James,9999,0,9999,0
1653549328527,CSE 293,038,094942,Tullsen; Dean Michael,9999,0,9999,0
1653549328527,CSE 293,039,094943,Voelker; Geoffrey M.,9999,0,9999,0
1653549328527,CSE 293,040,094944,Zhao; Jishen,9999,0,9999,0
1653549328527,CSE 293,041,094945,Zhou; Yuan-Yuan,9999,0,9999,0
1653549328527,CSE 293,042,094946,Gao; Sicun,9998,0,9999,1
1653549328527,CSE 293,043,094947,Weibel; Nadir,9999,0,9999,0
1653549328527,CSE 293,044,094948,Gupta; Rajesh K.,9999,0,9999,0
1653549329059,CSE 294,A00,090143,Porter; George M,8,0,10,2
1653549329589,DSE 200,A00,091799,Staff,50,0,50,0
1653549330117,DSE 203,A00,091800,Gupta; Amarnath,30,0,30,0
1653549330660,DSE 250,A00,091801,Deutsch; Alin Bernard,30,0,30,0
1653549331191,DSE 290,A00,091802,Altintas De Callaf; Ilkay,50,0,50,0
1653549331827,ECE 200,001,091003,Antipa; Nicholas A,9999,0,9999,0
1653549331827,ECE 200,002,091004,Atanasov; Nikolay A.,9999,0,9999,0
1653549331827,ECE 200,003,091005,Bharadia; Dinesh,9999,0,9999,0
1653549331827,ECE 200,004,091006,Cheng; Chung Kuan,9999,0,9999,0
1653549331827,ECE 200,005,091007,Cosman; Pamela C.,9999,0,9999,0
1653549331827,ECE 200,006,091008,Staff,9999,0,9999,0
1653549331827,ECE 200,007,091009,Dayeh; Shadi Ahmad,9999,0,9999,0
1653549331827,ECE 200,008,091010,Fainman; Yeshaiahu,9999,0,9999,0
1653549331827,ECE 200,009,091011,Ford; Joseph Earl,9999,0,9999,0
1653549331827,ECE 200,010,091012,Franceschetti; Massimo,9999,0,9999,0
1653549331827,ECE 200,011,091013,Fullerton; Eric E,9999,0,9999,0
1653549331827,ECE 200,012,091014,Galton; Ian A,9999,0,9999,0
1653549331827,ECE 200,013,091015,Gilja; Vikash,9999,0,9999,0
1653549331827,ECE 200,014,091016,Hall; Drew A.,9999,0,9999,0
1653549331827,ECE 200,015,091017,Hsueh; Tzu-Chien,9999,0,9999,0
1653549331827,ECE 200,016,091018,Javidi; Tara,9999,0,9999,0
1653549331827,ECE 200,017,091019,Kahng; Andrew Byun,9999,0,9999,0
1653549331827,ECE 200,018,091020,Kim; Young-Han,9999,0,9999,0
1653549331827,ECE 200,019,091021,Koushanfar; Farinaz,9999,0,9999,0
1653549331827,ECE 200,020,091022,Kuzum; Duygu,9999,0,9999,0
1653549331827,ECE 200,021,091023,Le; Hanh-Phuc,9999,0,9999,0
1653549331827,ECE 200,022,091024,Lin; Bill,9999,0,9999,0
1653549331827,ECE 200,023,091025,Liu; Zhaowei,9999,0,9999,0
1653549331827,ECE 200,024,091026,Lo; Yu-Hwa,9999,0,9999,0
1653549331827,ECE 200,025,091027,Lomakin; Vitaliy,9999,0,9999,0
1653549331827,ECE 200,026,091028,Mercier; Patrick Philip,9999,0,9999,0
1653549331827,ECE 200,027,091029,Meyer; Florian,9999,0,9999,0
1653549331827,ECE 200,028,091030,Milstein; Laurence B.,9999,0,9999,0
1653549331827,ECE 200,029,091031,Mir Arabbaygi; Siavash,9999,0,9999,0
1653549331827,ECE 200,030,091032,Mookherjea; Shayan,9999,0,9999,0
1653549331827,ECE 200,031,091033,Morris; Karcher William,9999,0,9999,0
1653549331827,ECE 200,032,091034,Ng; Tse Nga,9999,0,9999,0
1653549331827,ECE 200,033,091035,Nguyen; Truong Quang,9999,0,9999,0
1653549331827,ECE 200,034,091036,Nomura; Kenji,9999,0,9999,0
1653549331827,ECE 200,035,091037,Orlitsky; Alon,9999,0,9999,0
1653549331827,ECE 200,036,091038,Pal; Piya,9999,0,9999,0
1653549331827,ECE 200,037,091039,Papen; George C.,9999,0,9999,0
1653549331827,ECE 200,038,091040,Radic; Stojan,9999,0,9999,0
1653549331827,ECE 200,039,091041,Rao; Bhaskar D.,9999,0,9999,0
1653549331827,ECE 200,040,091042,Rao; Ramesh R,9999,0,9999,0
1653549331827,ECE 200,041,091043,Rebeiz; Gabriel,9999,0,9999,0
1653549331827,ECE 200,042,091044,Sanford; John R,9999,0,9999,0
1653549331827,ECE 200,043,091045,Siegel; Paul H.,9999,0,9999,0
1653549331827,ECE 200,044,091046,Sievenpiper; Daniel F.,9999,0,9999,0
1653549331827,ECE 200,045,091047,Sworder; David D.,9999,0,9999,0
1653549331827,ECE 200,046,091048,Taur; Yuan,9999,0,9999,0
1653549331827,ECE 200,047,091049,Touri; Behrouz,9999,0,9999,0
1653549331827,ECE 200,048,091050,Trivedi; Mohan M.,9999,0,9999,0
1653549331827,ECE 200,049,091051,Vardy; Alexander,9999,0,9999,0
1653549331827,ECE 200,050,091052,Vasconcelos; Nuno,9999,0,9999,0
1653549331827,ECE 200,051,091053,Wang; Xiaolong,9999,0,9999,0
1653549331827,ECE 200,052,091054,Xie; Pengtao,9999,0,9999,0
1653549331827,ECE 200,053,091055,Yip; Michael,9999,0,9999,0
1653549331827,ECE 200,054,091056,Zeger; Kenneth A.,9999,0,9999,0
1653549331827,ECE 200,055,091057,Zhang; Xinyu,9999,0,9999,0
1653549331827,ECE 200,056,091058,Turakhia; Yatish Girish,9999,0,9999,0
1653549331827,ECE 200,057,091059,Kang; Mingu,9999,0,9999,0
1653549331827,ECE 200,058,091060,Shi; Yuanyuan,9999,0,9999,0
1653549331827,ECE 200,059,091061,Wang; Edward Jay,9999,0,9999,0
1653549331827,ECE 200,060,091062,Zheng; Yang,9999,0,9999,0
1653549332352,ECE 201,A00,095526,Lo; Yu-Hwa,0,0,0,0
1653549332877,ECE 203,A00,091065,Mercier; Patrick Philip,0,0,0,0
1653549333401,ECE 207A,A00,091605,Liu; Thomas Tao-Ming,0,0,0,0
1653549333926,ECE 212AN,A00,091068,Nomura; Kenji,0,0,0,0
1653549334461,ECE 222A,A00,091069,Rebeiz; Gabriel,0,0,0,0
1653549334986,ECE 225A,A00,091070,Orlitsky; Alon,0,0,0,0
1653549335520,ECE 230A,A00,091071,Nomura; Kenji,0,0,0,0
1653549336051,ECE 236A,A00,091072,Dayeh; Shadi Ahmad,0,0,0,0
1653549336577,ECE 238A,A00,091073,Luo; Jian,0,0,0,0
1653549336577,ECE 238A,B00,091074,Luo; Jian,0,0,0,0
1653549337107,ECE 240A,A00,091075,Radic; Stojan,0,0,0,0
1653549337644,ECE 247A,A00,091592,Shi; Lingyan,0,0,0,0
1653549338178,ECE 250,A00,091076,Touri; Behrouz,0,0,0,0
1653549338706,ECE 251C,A00,091078,Nguyen; Truong Quang,0,0,0,0
1653549339259,ECE 253,A00,091079,Cosman; Pamela C.,0,0,0,0
1653549339784,ECE 255A,A00,091080,Orlitsky; Alon,0,0,0,0
1653549340309,ECE 257A,A00,091081,Zhang; Xinyu,0,0,0,0
1653549340833,ECE 260A,A01,091084,Eldon; John,0,0,0,0
1653549341364,ECE 264C,A00,091085,Galton; Ian A,0,0,0,0
1653549341893,ECE 265C,A00,094889,Presti; Calogero Davide,0,0,0,9
1653549342417,ECE 266,A01,091087,Hall; Drew A.,0,0,0,0
1653549343463,ECE 271A,A00,091090,Vasconcelos; Nuno,0,0,0,0
1653549343992,ECE 272B,A00,091091,Sworder; David D.,0,0,0,0
1653549344516,ECE 275A,A00,091092,Meyer; Florian,0,0,0,0
1653549345141,ECE 277,A00,091093,An; Cheolhong,0,0,0,0
1653549345665,ECE 283,A00,091094,Le; Hanh-Phuc,0,0,0,0
1653549346194,ECE 284,A00,091095,Kang; Mingu,0,0,0,0
1653549346194,ECE 284,B00,091096,Wang; Edward Jay,0,0,0,0
1653549346719,ECE 285,A00,094334,Touri; Behrouz,0,0,0,0
1653549347248,ECE 289,A00,091097,Whelan; David Arthur,0,0,0,0
1653549347787,MATH 200A,A00,087414,Salehi Golsefidy; Alireza,7,0,8,1
1653549348312,MATH 202A,A00,087415,Gill; Philip E.,2,0,8,6
1653549348843,MATH 203A,A00,087416,Oprea; Dragos N.,6,0,8,2
1653549349441,MATH 204A,A00,087417,Kedlaya; Kiran S.,6,0,8,2
1653549349969,MATH 205,A00,087418,Sorensen; Claus M,6,0,8,2
1653549350501,MATH 206A,A00,087419,Izadi; Elham,7,0,8,1
1653549351025,MATH 207A,A00,087420,Mohammadi; Amir,5,0,8,3
1653549351554,MATH 208,A00,087421,Staff,9,0,10,1
1653549352082,MATH 209,A00,087422,Staff,10,0,10,0
1653549352606,MATH 218,A00,087423,Staff,10,0,10,0
1653549353131,MATH 220A,A00,087424,Novak; Jonathan I,6,0,8,2
1653549353656,MATH 231A,A00,087425,Bejenaru; Ioan,3,0,8,5
1653549354186,MATH 240A,A00,087426,Ebenfelt; Peter F,5,0,8,3
1653549354715,MATH 243,A00,087427,Staff,9,0,10,1
1653549355243,MATH 248,A00,087429,Staff,10,0,10,0
1653549355778,MATH 250A,A00,087430,Spolaor; Luca,4,0,8,4
1653549356307,MATH 257A,A00,087431,Spolaor; Luca,7,0,8,1
1653549356832,MATH 258,A00,087432,Staff,9,0,10,1
1653549357354,MATH 264A,A00,087433,Warnke; Lutz Peter,5,0,8,3
1653549357879,MATH 268,A00,087434,Staff,15,0,15,0
1653549358403,MATH 269,A00,087435,Staff,14,0,15,1
1653549358927,MATH 270A,A00,087436,Nie; Jiawang,0,0,8,8
1653549359455,MATH 272A,A00,087437,Tian; Xiaochuan,1,0,8,7
1653549359980,MATH 274,A01,087439,Cheng; Li-Tien,9,0,10,1
1653549359980,MATH 274,A02,087440,Cheng; Li-Tien,10,0,10,0
1653549360504,MATH 278A,A00,087441,Staff,8,0,10,2
1653549361029,MATH 278B,A00,087442,Staff,8,0,10,2
1653549361563,MATH 278C,A00,087443,Staff,8,0,10,2
1653549362094,MATH 280A,A00,087444,Zheng; Tianyi,0,0,8,8
1653549362631,MATH 281A,A00,087445,Bradic; Jelena,0,0,8,8
1653549363154,MATH 282A,A00,087446,Zhang; Danna,0,0,8,8
1653549363684,MATH 283,A00,087447,Tesler; Glenn,0,0,0,15
1653549364216,MATH 286,A00,087448,Kemp; Todd Aahron,5,0,8,3
1653549364745,MATH 287D,A00,087449,Bradic; Jelena,0,0,0,0
1653549365275,MATH 288,A00,087450,Staff,14,0,15,1
1653549365275,MATH 288,B00,087451,Staff,15,0,15,0
1653549365275,MATH 288,C00,087452,Staff,15,0,15,0
1653549365805,MATH 290A,A00,087453,Xu; Zhouli,6,0,8,2
1653549366348,MATH 291A,A00,087454,Xu; Zhouli,7,0,8,1
1653549366872,MATH 292,A00,087455,Staff,10,0,10,0
1653549367408,MATH 295,A00,087456,Staff,50,0,50,0
1653549367931,MATH 297,001,087457,Staff,998,0,999,1
1653549928730,COGS 200,A01,087991,Staff,47,0,50,3
1653549929254,COGS 201,A01,094504,Rangel; Lara M,17,0,25,8
1653549929778,COGS 203,A00,087992,Coulson; Seana M,18,0,20,2
1653549930323,COGS 210A,001,087993,Greene; Deanna Jacquelyn,9998,0,9999,1
1653549930323,COGS 210A,002,087994,Saygin; Ayse P,9999,0,9999,0
1653549930323,COGS 210A,003,087995,Xia; Haijun,9999,0,9999,0
1653549930323,COGS 210A,004,087996,Nitz; Douglas A.,9999,0,9999,0
1653549930323,COGS 210A,005,087997,Hollan; James D.,9999,0,9999,0
1653549930323,COGS 210A,006,087998,Deak; Gedeon O.,9998,0,9999,1
1653549930323,COGS 210A,007,087999,Rossano; Federico,9999,0,9999,0
1653549930847,COGS 211A,A00,088000,Coulson; Seana M,9997,0,9999,2
1653549931375,COGS 229,A00,088002,Staff,23,0,25,2
1653549931898,COGS 260,B00,094231,Staff,17,0,20,3
1653549931898,COGS 260,A00,088004,Nitz; Douglas A.,9998,0,9999,1
1653549932423,CSE 202,A00,090110,Paturi; Ramamohan,0,0,0,0
1653549932423,CSE 202,B00,090111,Paturi; Ramamohan,0,0,0,0
1653549932949,CSE 207B,A00,090112,Heninger; Nadia A,0,0,0,0
1653549933546,CSE 208,A00,094858,Micciancio; Daniele,0,0,0,0
1653549934069,CSE 210,A00,090113,Powell; Thomas Allan,0,0,0,0
1653549934593,CSE 219,A00,090898,Staff,0,0,0,0
1653549935121,CSE 221,A00,090114,Zhou; Yuan-Yuan,0,0,0,0
1653549935645,CSE 229A,A00,090115,Porter; George M,0,0,0,0
1653549936169,CSE 229C,A00,090116,Savage; Stefan,0,0,0,0
1653549936694,CSE 230,A00,090117,Jhala; Ranjit,0,0,0,0
1653549937219,CSE 232,A00,090118,Papakonstantinou; Yannis,0,0,0,0
1653549937743,CSE 239A,A00,090121,Kumar; Arun Kumar,0,0,0,0
1653549938267,CSE 239B,A00,090122,Jhala; Ranjit,0,0,0,0
1653549938810,CSE 240A,A00,090123,Zhao; Jishen,0,0,189,189
1653549939336,CSE 243A,A00,090124,Orailoglu; Alex,0,0,15,15
1653549939861,CSE 249B,A00,090125,Kahng; Andrew Byun,13,0,20,7
1653549940385,CSE 250A,A00,090126,Berg-Kirkpatrick; Taylor D,0,0,0,0
1653549940910,CSE 252A,A00,090127,Ochoa; Benjamin Lawrence,0,0,0,0
1653549941442,CSE 258,A01,090129,McAuley; Julian John,0,0,0,0
1653549941966,CSE 258R,A01,090131,McAuley; Julian John,0,0,0,0
1653549942489,CSE 274,A00,090132,Ramamoorthi; Ravi,0,0,0,0
1653549943012,CSE 276A,A00,090133,Christensen; Henrik I,0,0,0,0
1653549943535,CSE 276C,A00,090134,Christensen; Henrik I,0,0,0,0
1653549944060,CSE 290,A00,090135,Bafna; Vineet,0,0,0,0
1653549944060,CSE 290,B00,090136,Ramamoorthi; Ravi,0,0,0,0
1653549944060,CSE 290,C00,090137,Li; Tzumao,8,0,10,2
1653549944060,CSE 290,D00,090138,Zhou; Yuan-Yuan,9,0,10,1
1653549944060,CSE 290,E00,090139,Christensen; Henrik I,8,0,10,2
1653549944060,CSE 290,F00,094053,Shalev; Aaron D,0,0,0,0
1653549944584,CSE 291,A00,090140,Munyaka; Imani N. S.,0,0,0,0
1653549944584,CSE 291,B00,094880,Yu; Qi,0,0,0,0
1653549944584,CSE 291,C00,090142,Pannuto; Patrick William,0,0,0,0
1653549944584,CSE 291,D00,094881,Zhang; Yiying,0,0,0,0
1653549944584,CSE 291,E00,095118,Su; Hao,0,0,0,0
1653549945116,CSE 293,001,094905,Bafna; Vineet,9999,0,9999,0
1653549945116,CSE 293,002,094906,Bellare; Mihir,9999,0,9999,0
1653549945116,CSE 293,003,094907,Berg-Kirkpatrick; Taylor D,9999,0,9999,0
1653549945116,CSE 293,004,094908,Christensen; Henrik I,9999,0,9999,0
1653549945116,CSE 293,005,094909,Cottrell; Garrison W,9999,0,9999,0
1653549945116,CSE 293,006,094910,Deutsch; Alin Bernard,9999,0,9999,0
1653549945116,CSE 293,007,094911,Esmaeilzadeh; Hadi,9999,0,9999,0
1653549945116,CSE 293,008,094912,Freund; Yoav,9999,0,9999,0
1653549945116,CSE 293,009,094913,Griswold; William G.,9999,0,9999,0
1653549945116,CSE 293,010,094914,Gymrek; Melissa Ann,9999,0,9999,0
1653549945116,CSE 293,011,094915,Heninger; Nadia A,9999,0,9999,0
1653549945116,CSE 293,012,094916,Impagliazzo; Russell,9999,0,9999,0
1653549945116,CSE 293,013,094917,Jhala; Ranjit,9999,0,9999,0
1653549945116,CSE 293,014,094918,Kahng; Andrew Byun,9999,0,9999,0
1653549945116,CSE 293,015,094919,Kane; Daniel Mertz,9999,0,9999,0
1653549945116,CSE 293,016,094920,Kriegman; David J,9999,0,9999,0
1653549945116,CSE 293,017,094921,Kumar; Arun Kumar,9999,0,9999,0
1653549945116,CSE 293,018,094922,Lerner; Sorin,9999,0,9999,0
1653549945116,CSE 293,019,094923,Lovett; Shachar,9999,0,9999,0
1653549945116,CSE 293,020,094924,McAuley; Julian John,9999,0,9999,0
1653549945116,CSE 293,021,094925,Micciancio; Daniele,9999,0,9999,0
1653549945116,CSE 293,022,094926,Orailoglu; Alex,9999,0,9999,0
1653549945116,CSE 293,023,094927,Paturi; Ramamohan,9999,0,9999,0
1653549945116,CSE 293,024,094928,Polikarpova; Nadezhda,9999,0,9999,0
1653549945116,CSE 293,025,094929,Politz; Joseph Gibbs,9999,0,9999,0
1653549945116,CSE 293,026,094930,Porter; George M,9999,0,9999,0
1653549945116,CSE 293,027,094931,Porter; Leonard Emerson,9999,0,9999,0
1653549945116,CSE 293,028,094932,Ramamoorthi; Ravi,9999,0,9999,0
1653549945116,CSE 293,029,094933,Sahoo; Debashis,9999,0,9999,0
1653549945116,CSE 293,030,094934,Saul; Lawrence,9999,0,9999,0
1653549945116,CSE 293,031,094935,Savage; Stefan,9999,0,9999,0
1653549945116,CSE 293,032,094936,Schulze; Jurgen P.,9999,0,9999,0
1653549945116,CSE 293,033,094937,Snoeren; Alex C.,9999,0,9999,0
1653549945116,CSE 293,034,094938,Shang; Jingbo,9999,0,9999,0
1653549945116,CSE 293,035,094939,Stefan; Deian,9999,0,9999,0
1653549945116,CSE 293,036,094940,Su; Hao,9999,0,9999,0
1653549945116,CSE 293,037,094941,Swanson; Steven James,9999,0,9999,0
1653549945116,CSE 293,038,094942,Tullsen; Dean Michael,9999,0,9999,0
1653549945116,CSE 293,039,094943,Voelker; Geoffrey M.,9999,0,9999,0
1653549945116,CSE 293,040,094944,Zhao; Jishen,9999,0,9999,0
1653549945116,CSE 293,041,094945,Zhou; Yuan-Yuan,9999,0,9999,0
1653549945116,CSE 293,042,094946,Gao; Sicun,9998,0,9999,1
1653549945116,CSE 293,043,094947,Weibel; Nadir,9999,0,9999,0
1653549945116,CSE 293,044,094948,Gupta; Rajesh K.,9999,0,9999,0
1653549945641,CSE 294,A00,090143,Porter; George M,8,0,10,2
1653549946168,DSE 200,A00,091799,Staff,50,0,50,0
1653549946695,DSE 203,A00,091800,Gupta; Amarnath,30,0,30,0
1653549947219,DSE 250,A00,091801,Deutsch; Alin Bernard,30,0,30,0
1653549947742,DSE 290,A00,091802,Altintas De Callaf; Ilkay,50,0,50,0
1653549948287,ECE 200,001,091003,Antipa; Nicholas A,9999,0,9999,0
1653549948287,ECE 200,002,091004,Atanasov; Nikolay A.,9999,0,9999,0
1653549948287,ECE 200,003,091005,Bharadia; Dinesh,9999,0,9999,0
1653549948287,ECE 200,004,091006,Cheng; Chung Kuan,9999,0,9999,0
1653549948287,ECE 200,005,091007,Cosman; Pamela C.,9999,0,9999,0
1653549948287,ECE 200,006,091008,Staff,9999,0,9999,0
1653549948287,ECE 200,007,091009,Dayeh; Shadi Ahmad,9999,0,9999,0
1653549948287,ECE 200,008,091010,Fainman; Yeshaiahu,9999,0,9999,0
1653549948287,ECE 200,009,091011,Ford; Joseph Earl,9999,0,9999,0
1653549948287,ECE 200,010,091012,Franceschetti; Massimo,9999,0,9999,0
1653549948287,ECE 200,011,091013,Fullerton; Eric E,9999,0,9999,0
1653549948287,ECE 200,012,091014,Galton; Ian A,9999,0,9999,0
1653549948287,ECE 200,013,091015,Gilja; Vikash,9999,0,9999,0
1653549948287,ECE 200,014,091016,Hall; Drew A.,9999,0,9999,0
1653549948287,ECE 200,015,091017,Hsueh; Tzu-Chien,9999,0,9999,0
1653549948287,ECE 200,016,091018,Javidi; Tara,9999,0,9999,0
1653549948287,ECE 200,017,091019,Kahng; Andrew Byun,9999,0,9999,0
1653549948287,ECE 200,018,091020,Kim; Young-Han,9999,0,9999,0
1653549948287,ECE 200,019,091021,Koushanfar; Farinaz,9999,0,9999,0
1653549948287,ECE 200,020,091022,Kuzum; Duygu,9999,0,9999,0
1653549948287,ECE 200,021,091023,Le; Hanh-Phuc,9999,0,9999,0
1653549948287,ECE 200,022,091024,Lin; Bill,9999,0,9999,0
1653549948287,ECE 200,023,091025,Liu; Zhaowei,9999,0,9999,0
1653549948287,ECE 200,024,091026,Lo; Yu-Hwa,9999,0,9999,0
1653549948287,ECE 200,025,091027,Lomakin; Vitaliy,9999,0,9999,0
1653549948287,ECE 200,026,091028,Mercier; Patrick Philip,9999,0,9999,0
1653549948287,ECE 200,027,091029,Meyer; Florian,9999,0,9999,0
1653549948287,ECE 200,028,091030,Milstein; Laurence B.,9999,0,9999,0
1653549948287,ECE 200,029,091031,Mir Arabbaygi; Siavash,9999,0,9999,0
1653549948287,ECE 200,030,091032,Mookherjea; Shayan,9999,0,9999,0
1653549948287,ECE 200,031,091033,Morris; Karcher William,9999,0,9999,0
1653549948287,ECE 200,032,091034,Ng; Tse Nga,9999,0,9999,0
1653549948287,ECE 200,033,091035,Nguyen; Truong Quang,9999,0,9999,0
1653549948287,ECE 200,034,091036,Nomura; Kenji,9999,0,9999,0
1653549948287,ECE 200,035,091037,Orlitsky; Alon,9999,0,9999,0
1653549948287,ECE 200,036,091038,Pal; Piya,9999,0,9999,0
1653549948287,ECE 200,037,091039,Papen; George C.,9999,0,9999,0
1653549948287,ECE 200,038,091040,Radic; Stojan,9999,0,9999,0
1653549948287,ECE 200,039,091041,Rao; Bhaskar D.,9999,0,9999,0
1653549948287,ECE 200,040,091042,Rao; Ramesh R,9999,0,9999,0
1653549948287,ECE 200,041,091043,Rebeiz; Gabriel,9999,0,9999,0
1653549948287,ECE 200,042,091044,Sanford; John R,9999,0,9999,0
1653549948287,ECE 200,043,091045,Siegel; Paul H.,9999,0,9999,0
1653549948287,ECE 200,044,091046,Sievenpiper; Daniel F.,9999,0,9999,0
1653549948287,ECE 200,045,091047,Sworder; David D.,9999,0,9999,0
1653549948287,ECE 200,046,091048,Taur; Yuan,9999,0,9999,0
1653549948287,ECE 200,047,091049,Touri; Behrouz,9999,0,9999,0
1653549948287,ECE 200,048,091050,Trivedi; Mohan M.,9999,0,9999,0
1653549948287,ECE 200,049,091051,Vardy; Alexander,9999,0,9999,0
1653549948287,ECE 200,050,091052,Vasconcelos; Nuno,9999,0,9999,0
1653549948287,ECE 200,051,091053,Wang; Xiaolong,9999,0,9999,0
1653549948287,ECE 200,052,091054,Xie; Pengtao,9999,0,9999,0
1653549948287,ECE 200,053,091055,Yip; Michael,9999,0,9999,0
1653549948287,ECE 200,054,091056,Zeger; Kenneth A.,9999,0,9999,0
1653549948287,ECE 200,055,091057,Zhang; Xinyu,9999,0,9999,0
1653549948287,ECE 200,056,091058,Turakhia; Yatish Girish,9999,0,9999,0
1653549948287,ECE 200,057,091059,Kang; Mingu,9999,0,9999,0
1653549948287,ECE 200,058,091060,Shi; Yuanyuan,9999,0,9999,0
1653549948287,ECE 200,059,091061,Wang; Edward Jay,9999,0,9999,0
1653549948287,ECE 200,060,091062,Zheng; Yang,9999,0,9999,0
1653549948812,ECE 201,A00,095526,Lo; Yu-Hwa,0,0,0,0
1653549949340,ECE 203,A00,091065,Mercier; Patrick Philip,0,0,0,0
1653549949864,ECE 207A,A00,091605,Liu; Thomas Tao-Ming,0,0,0,0
1653549950393,ECE 212AN,A00,091068,Nomura; Kenji,0,0,0,0
1653549950916,ECE 222A,A00,091069,Rebeiz; Gabriel,0,0,0,0
1653549951443,ECE 225A,A00,091070,Orlitsky; Alon,0,0,0,0
1653549951971,ECE 230A,A00,091071,Nomura; Kenji,0,0,0,0
1653549952495,ECE 236A,A00,091072,Dayeh; Shadi Ahmad,0,0,0,0
1653549953026,ECE 238A,A00,091073,Luo; Jian,0,0,0,0
1653549953026,ECE 238A,B00,091074,Luo; Jian,0,0,0,0
1653549953550,ECE 240A,A00,091075,Radic; Stojan,0,0,0,0
1653549954075,ECE 247A,A00,091592,Shi; Lingyan,0,0,0,0
1653549954602,ECE 250,A00,091076,Touri; Behrouz,0,0,0,0
1653549955138,ECE 251C,A00,091078,Nguyen; Truong Quang,0,0,0,0
1653549955668,ECE 253,A00,091079,Cosman; Pamela C.,0,0,0,0
1653549956193,ECE 255A,A00,091080,Orlitsky; Alon,0,0,0,0
1653549956717,ECE 257A,A00,091081,Zhang; Xinyu,0,0,0,0
1653549957240,ECE 260A,A01,091084,Eldon; John,0,0,0,0
1653549957764,ECE 264C,A00,091085,Galton; Ian A,0,0,0,0
1653549958293,ECE 265C,A00,094889,Presti; Calogero Davide,0,0,0,9
1653549958820,ECE 266,A01,091087,Hall; Drew A.,0,0,0,0
1653549959870,ECE 271A,A00,091090,Vasconcelos; Nuno,0,0,0,0
1653549960397,ECE 272B,A00,091091,Sworder; David D.,0,0,0,0
1653549960921,ECE 275A,A00,091092,Meyer; Florian,0,0,0,0
1653549961445,ECE 277,A00,091093,An; Cheolhong,0,0,0,0
1653549961969,ECE 283,A00,091094,Le; Hanh-Phuc,0,0,0,0
1653549962496,ECE 284,A00,091095,Kang; Mingu,0,0,0,0
1653549962496,ECE 284,B00,091096,Wang; Edward Jay,0,0,0,0
1653549963023,ECE 285,A00,094334,Touri; Behrouz,0,0,0,0
1653549963550,ECE 289,A00,091097,Whelan; David Arthur,0,0,0,0
1653549964078,MATH 200A,A00,087414,Salehi Golsefidy; Alireza,7,0,8,1
1653549964602,MATH 202A,A00,087415,Gill; Philip E.,2,0,8,6
1653549965127,MATH 203A,A00,087416,Oprea; Dragos N.,6,0,8,2
1653549965651,MATH 204A,A00,087417,Kedlaya; Kiran S.,6,0,8,2
1653549966182,MATH 205,A00,087418,Sorensen; Claus M,6,0,8,2
1653549966706,MATH 206A,A00,087419,Izadi; Elham,7,0,8,1
1653549967232,MATH 207A,A00,087420,Mohammadi; Amir,5,0,8,3
1653549967759,MATH 208,A00,087421,Staff,9,0,10,1
1653549968282,MATH 209,A00,087422,Staff,10,0,10,0
1653549968805,MATH 218,A00,087423,Staff,10,0,10,0
1653549969327,MATH 220A,A00,087424,Novak; Jonathan I,6,0,8,2
1653549969855,MATH 231A,A00,087425,Bejenaru; Ioan,3,0,8,5
1653549970379,MATH 240A,A00,087426,Ebenfelt; Peter F,5,0,8,3
1653549970902,MATH 243,A00,087427,Staff,9,0,10,1
1653549971427,MATH 248,A00,087429,Staff,10,0,10,0
1653549971955,MATH 250A,A00,087430,Spolaor; Luca,4,0,8,4
1653549972481,MATH 257A,A00,087431,Spolaor; Luca,7,0,8,1
1653549973004,MATH 258,A00,087432,Staff,9,0,10,1
1653549973531,MATH 264A,A00,087433,Warnke; Lutz Peter,5,0,8,3
1653549974058,MATH 268,A00,087434,Staff,15,0,15,0
1653549974582,MATH 269,A00,087435,Staff,14,0,15,1
1653549975105,MATH 270A,A00,087436,Nie; Jiawang,0,0,8,8
1653549975636,MATH 272A,A00,087437,Tian; Xiaochuan,1,0,8,7
1653549976161,MATH 274,A01,087439,Cheng; Li-Tien,9,0,10,1
1653549976161,MATH 274,A02,087440,Cheng; Li-Tien,10,0,10,0
1653549976687,MATH 278A,A00,087441,Staff,8,0,10,2
1653549977211,MATH 278B,A00,087442,Staff,8,0,10,2
1653549977735,MATH 278C,A00,087443,Staff,8,0,10,2
1653549978259,MATH 280A,A00,087444,Zheng; Tianyi,0,0,8,8
1653549978789,MATH 281A,A00,087445,Bradic; Jelena,0,0,8,8
1653549979315,MATH 282A,A00,087446,Zhang; Danna,0,0,8,8
1653549979852,MATH 283,A00,087447,Tesler; Glenn,0,0,0,15
1653549980375,MATH 286,A00,087448,Kemp; Todd Aahron,5,0,8,3
1653549980901,MATH 287D,A00,087449,Bradic; Jelena,0,0,0,0
1653549981432,MATH 288,A00,087450,Staff,14,0,15,1
1653549981432,MATH 288,B00,087451,Staff,15,0,15,0
1653549981432,MATH 288,C00,087452,Staff,15,0,15,0
1653549981958,MATH 290A,A00,087453,Xu; Zhouli,6,0,8,2
1653549982483,MATH 291A,A00,087454,Xu; Zhouli,7,0,8,1
1653549983010,MATH 292,A00,087455,Staff,10,0,10,0
1653549983541,MATH 295,A00,087456,Staff,50,0,50,0
1653549984068,MATH 297,001,087457,Staff,998,0,999,1
1653550545060,COGS 200,A01,087991,Staff,47,0,50,3
1653550545585,COGS 201,A01,094504,Rangel; Lara M,17,0,25,8
1653550546114,COGS 203,A00,087992,Coulson; Seana M,18,0,20,2
1653550546654,COGS 210A,001,087993,Greene; Deanna Jacquelyn,9998,0,9999,1
1653550546654,COGS 210A,002,087994,Saygin; Ayse P,9999,0,9999,0
1653550546654,COGS 210A,003,087995,Xia; Haijun,9999,0,9999,0
1653550546654,COGS 210A,004,087996,Nitz; Douglas A.,9999,0,9999,0
1653550546654,COGS 210A,005,087997,Hollan; James D.,9999,0,9999,0
1653550546654,COGS 210A,006,087998,Deak; Gedeon O.,9998,0,9999,1
1653550546654,COGS 210A,007,087999,Rossano; Federico,9999,0,9999,0
1653550547192,COGS 211A,A00,088000,Coulson; Seana M,9997,0,9999,2
1653550547725,COGS 229,A00,088002,Staff,23,0,25,2
1653550548248,COGS 260,B00,094231,Staff,17,0,20,3
1653550548248,COGS 260,A00,088004,Nitz; Douglas A.,9998,0,9999,1
1653550548775,CSE 202,A00,090110,Paturi; Ramamohan,0,0,0,0
1653550548775,CSE 202,B00,090111,Paturi; Ramamohan,0,0,0,0
1653550549300,CSE 207B,A00,090112,Heninger; Nadia A,0,0,0,0
1653550549825,CSE 208,A00,094858,Micciancio; Daniele,0,0,0,0
1653550550351,CSE 210,A00,090113,Powell; Thomas Allan,0,0,0,0
1653550550877,CSE 219,A00,090898,Staff,0,0,0,0
1653550551401,CSE 221,A00,090114,Zhou; Yuan-Yuan,0,0,0,0
1653550551924,CSE 229A,A00,090115,Porter; George M,0,0,0,0
1653550552448,CSE 229C,A00,090116,Savage; Stefan,0,0,0,0
1653550552975,CSE 230,A00,090117,Jhala; Ranjit,0,0,0,0
1653550553499,CSE 232,A00,090118,Papakonstantinou; Yannis,0,0,0,0
1653550554029,CSE 239A,A00,090121,Kumar; Arun Kumar,0,0,0,0
1653550554552,CSE 239B,A00,090122,Jhala; Ranjit,0,0,0,0
1653550555075,CSE 240A,A00,090123,Zhao; Jishen,0,0,189,189
1653550555602,CSE 243A,A00,090124,Orailoglu; Alex,0,0,15,15
1653550556126,CSE 249B,A00,090125,Kahng; Andrew Byun,13,0,20,7
1653550556649,CSE 250A,A00,090126,Berg-Kirkpatrick; Taylor D,0,0,0,0
1653550557173,CSE 252A,A00,090127,Ochoa; Benjamin Lawrence,0,0,0,0
1653550557697,CSE 258,A01,090129,McAuley; Julian John,0,0,0,0
1653550558229,CSE 258R,A01,090131,McAuley; Julian John,0,0,0,0
1653550558766,CSE 274,A00,090132,Ramamoorthi; Ravi,0,0,0,0
1653550559294,CSE 276A,A00,090133,Christensen; Henrik I,0,0,0,0
1653550559821,CSE 276C,A00,090134,Christensen; Henrik I,0,0,0,0
1653550560352,CSE 290,A00,090135,Bafna; Vineet,0,0,0,0
1653550560352,CSE 290,B00,090136,Ramamoorthi; Ravi,0,0,0,0
1653550560352,CSE 290,C00,090137,Li; Tzumao,8,0,10,2
1653550560352,CSE 290,D00,090138,Zhou; Yuan-Yuan,9,0,10,1
1653550560352,CSE 290,E00,090139,Christensen; Henrik I,8,0,10,2
1653550560352,CSE 290,F00,094053,Shalev; Aaron D,0,0,0,0
1653550560880,CSE 291,A00,090140,Munyaka; Imani N. S.,0,0,0,0
1653550560880,CSE 291,B00,094880,Yu; Qi,0,0,0,0
1653550560880,CSE 291,C00,090142,Pannuto; Patrick William,0,0,0,0
1653550560880,CSE 291,D00,094881,Zhang; Yiying,0,0,0,0
1653550560880,CSE 291,E00,095118,Su; Hao,0,0,0,0
1653550561419,CSE 293,001,094905,Bafna; Vineet,9999,0,9999,0
1653550561419,CSE 293,002,094906,Bellare; Mihir,9999,0,9999,0
1653550561419,CSE 293,003,094907,Berg-Kirkpatrick; Taylor D,9999,0,9999,0
1653550561419,CSE 293,004,094908,Christensen; Henrik I,9999,0,9999,0
1653550561419,CSE 293,005,094909,Cottrell; Garrison W,9999,0,9999,0
1653550561419,CSE 293,006,094910,Deutsch; Alin Bernard,9999,0,9999,0
1653550561419,CSE 293,007,094911,Esmaeilzadeh; Hadi,9999,0,9999,0
1653550561419,CSE 293,008,094912,Freund; Yoav,9999,0,9999,0
1653550561419,CSE 293,009,094913,Griswold; William G.,9999,0,9999,0
1653550561419,CSE 293,010,094914,Gymrek; Melissa Ann,9999,0,9999,0
1653550561419,CSE 293,011,094915,Heninger; Nadia A,9999,0,9999,0
1653550561419,CSE 293,012,094916,Impagliazzo; Russell,9999,0,9999,0
1653550561419,CSE 293,013,094917,Jhala; Ranjit,9999,0,9999,0
1653550561419,CSE 293,014,094918,Kahng; Andrew Byun,9999,0,9999,0
1653550561419,CSE 293,015,094919,Kane; Daniel Mertz,9999,0,9999,0
1653550561419,CSE 293,016,094920,Kriegman; David J,9999,0,9999,0
1653550561419,CSE 293,017,094921,Kumar; Arun Kumar,9999,0,9999,0
1653550561419,CSE 293,018,094922,Lerner; Sorin,9999,0,9999,0
1653550561419,CSE 293,019,094923,Lovett; Shachar,9999,0,9999,0
1653550561419,CSE 293,020,094924,McAuley; Julian John,9999,0,9999,0
1653550561419,CSE 293,021,094925,Micciancio; Daniele,9999,0,9999,0
1653550561419,CSE 293,022,094926,Orailoglu; Alex,9999,0,9999,0
1653550561419,CSE 293,023,094927,Paturi; Ramamohan,9999,0,9999,0
1653550561419,CSE 293,024,094928,Polikarpova; Nadezhda,9999,0,9999,0
1653550561419,CSE 293,025,094929,Politz; Joseph Gibbs,9999,0,9999,0
1653550561419,CSE 293,026,094930,Porter; George M,9999,0,9999,0
1653550561419,CSE 293,027,094931,Porter; Leonard Emerson,9999,0,9999,0
1653550561419,CSE 293,028,094932,Ramamoorthi; Ravi,9999,0,9999,0
1653550561419,CSE 293,029,094933,Sahoo; Debashis,9999,0,9999,0
1653550561419,CSE 293,030,094934,Saul; Lawrence,9999,0,9999,0
1653550561419,CSE 293,031,094935,Savage; Stefan,9999,0,9999,0
1653550561419,CSE 293,032,094936,Schulze; Jurgen P.,9999,0,9999,0
1653550561419,CSE 293,033,094937,Snoeren; Alex C.,9999,0,9999,0
1653550561419,CSE 293,034,094938,Shang; Jingbo,9999,0,9999,0
1653550561419,CSE 293,035,094939,Stefan; Deian,9999,0,9999,0
1653550561419,CSE 293,036,094940,Su; Hao,9999,0,9999,0
1653550561419,CSE 293,037,094941,Swanson; Steven James,9999,0,9999,0
1653550561419,CSE 293,038,094942,Tullsen; Dean Michael,9999,0,9999,0
1653550561419,CSE 293,039,094943,Voelker; Geoffrey M.,9999,0,9999,0
1653550561419,CSE 293,040,094944,Zhao; Jishen,9999,0,9999,0
1653550561419,CSE 293,041,094945,Zhou; Yuan-Yuan,9999,0,9999,0
1653550561419,CSE 293,042,094946,Gao; Sicun,9998,0,9999,1
1653550561419,CSE 293,043,094947,Weibel; Nadir,9999,0,9999,0
1653550561419,CSE 293,044,094948,Gupta; Rajesh K.,9999,0,9999,0
1653550561943,CSE 294,A00,090143,Porter; George M,8,0,10,2
1653550562466,DSE 200,A00,091799,Staff,50,0,50,0
1653550562990,DSE 203,A00,091800,Gupta; Amarnath,30,0,30,0
1653550563512,DSE 250,A00,091801,Deutsch; Alin Bernard,30,0,30,0
1653550564036,DSE 290,A00,091802,Altintas De Callaf; Ilkay,50,0,50,0
1653550564624,ECE 200,001,091003,Antipa; Nicholas A,9999,0,9999,0
1653550564624,ECE 200,002,091004,Atanasov; Nikolay A.,9999,0,9999,0
1653550564624,ECE 200,003,091005,Bharadia; Dinesh,9999,0,9999,0
1653550564624,ECE 200,004,091006,Cheng; Chung Kuan,9999,0,9999,0
1653550564624,ECE 200,005,091007,Cosman; Pamela C.,9999,0,9999,0
1653550564624,ECE 200,006,091008,Staff,9999,0,9999,0
1653550564624,ECE 200,007,091009,Dayeh; Shadi Ahmad,9999,0,9999,0
1653550564624,ECE 200,008,091010,Fainman; Yeshaiahu,9999,0,9999,0
1653550564624,ECE 200,009,091011,Ford; Joseph Earl,9999,0,9999,0
1653550564624,ECE 200,010,091012,Franceschetti; Massimo,9999,0,9999,0
1653550564624,ECE 200,011,091013,Fullerton; Eric E,9999,0,9999,0
1653550564624,ECE 200,012,091014,Galton; Ian A,9999,0,9999,0
1653550564624,ECE 200,013,091015,Gilja; Vikash,9999,0,9999,0
1653550564624,ECE 200,014,091016,Hall; Drew A.,9999,0,9999,0
1653550564624,ECE 200,015,091017,Hsueh; Tzu-Chien,9999,0,9999,0
1653550564624,ECE 200,016,091018,Javidi; Tara,9999,0,9999,0
1653550564624,ECE 200,017,091019,Kahng; Andrew Byun,9999,0,9999,0
1653550564624,ECE 200,018,091020,Kim; Young-Han,9999,0,9999,0
1653550564624,ECE 200,019,091021,Koushanfar; Farinaz,9999,0,9999,0
1653550564624,ECE 200,020,091022,Kuzum; Duygu,9999,0,9999,0
1653550564624,ECE 200,021,091023,Le; Hanh-Phuc,9999,0,9999,0
1653550564624,ECE 200,022,091024,Lin; Bill,9999,0,9999,0
1653550564624,ECE 200,023,091025,Liu; Zhaowei,9999,0,9999,0
1653550564624,ECE 200,024,091026,Lo; Yu-Hwa,9999,0,9999,0
1653550564624,ECE 200,025,091027,Lomakin; Vitaliy,9999,0,9999,0
1653550564624,ECE 200,026,091028,Mercier; Patrick Philip,9999,0,9999,0
1653550564624,ECE 200,027,091029,Meyer; Florian,9999,0,9999,0
1653550564624,ECE 200,028,091030,Milstein; Laurence B.,9999,0,9999,0
1653550564624,ECE 200,029,091031,Mir Arabbaygi; Siavash,9999,0,9999,0
1653550564624,ECE 200,030,091032,Mookherjea; Shayan,9999,0,9999,0
1653550564624,ECE 200,031,091033,Morris; Karcher William,9999,0,9999,0
1653550564624,ECE 200,032,091034,Ng; Tse Nga,9999,0,9999,0
1653550564624,ECE 200,033,091035,Nguyen; Truong Quang,9999,0,9999,0
1653550564624,ECE 200,034,091036,Nomura; Kenji,9999,0,9999,0
1653550564624,ECE 200,035,091037,Orlitsky; Alon,9999,0,9999,0
1653550564624,ECE 200,036,091038,Pal; Piya,9999,0,9999,0
1653550564624,ECE 200,037,091039,Papen; George C.,9999,0,9999,0
1653550564624,ECE 200,038,091040,Radic; Stojan,9999,0,9999,0
1653550564624,ECE 200,039,091041,Rao; Bhaskar D.,9999,0,9999,0
1653550564624,ECE 200,040,091042,Rao; Ramesh R,9999,0,9999,0
1653550564624,ECE 200,041,091043,Rebeiz; Gabriel,9999,0,9999,0
1653550564624,ECE 200,042,091044,Sanford; John R,9999,0,9999,0
1653550564624,ECE 200,043,091045,Siegel; Paul H.,9999,0,9999,0
1653550564624,ECE 200,044,091046,Sievenpiper; Daniel F.,9999,0,9999,0
1653550564624,ECE 200,045,091047,Sworder; David D.,9999,0,9999,0
1653550564624,ECE 200,046,091048,Taur; Yuan,9999,0,9999,0
1653550564624,ECE 200,047,091049,Touri; Behrouz,9999,0,9999,0
1653550564624,ECE 200,048,091050,Trivedi; Mohan M.,9999,0,9999,0
1653550564624,ECE 200,049,091051,Vardy; Alexander,9999,0,9999,0
1653550564624,ECE 200,050,091052,Vasconcelos; Nuno,9999,0,9999,0
1653550564624,ECE 200,051,091053,Wang; Xiaolong,9999,0,9999,0
1653550564624,ECE 200,052,091054,Xie; Pengtao,9999,0,9999,0
1653550564624,ECE 200,053,091055,Yip; Michael,9999,0,9999,0
1653550564624,ECE 200,054,091056,Zeger; Kenneth A.,9999,0,9999,0
1653550564624,ECE 200,055,091057,Zhang; Xinyu,9999,0,9999,0
1653550564624,ECE 200,056,091058,Turakhia; Yatish Girish,9999,0,9999,0
1653550564624,ECE 200,057,091059,Kang; Mingu,9999,0,9999,0
1653550564624,ECE 200,058,091060,Shi; Yuanyuan,9999,0,9999,0
1653550564624,ECE 200,059,091061,Wang; Edward Jay,9999,0,9999,0
1653550564624,ECE 200,060,091062,Zheng; Yang,9999,0,9999,0
1653550565160,ECE 201,A00,095526,Lo; Yu-Hwa,0,0,0,0
1653550565691,ECE 203,A00,091065,Mercier; Patrick Philip,0,0,0,0
1653550566216,ECE 207A,A00,091605,Liu; Thomas Tao-Ming,0,0,0,0
1653550566742,ECE 212AN,A00,091068,Nomura; Kenji,0,0,0,0
1653550567268,ECE 222A,A00,091069,Rebeiz; Gabriel,0,0,0,0
1653550567793,ECE 225A,A00,091070,Orlitsky; Alon,0,0,0,0
1653550568316,ECE 230A,A00,091071,Nomura; Kenji,0,0,0,0
1653550568839,ECE 236A,A00,091072,Dayeh; Shadi Ahmad,0,0,0,0
1653550569367,ECE 238A,A00,091073,Luo; Jian,0,0,0,0
1653550569367,ECE 238A,B00,091074,Luo; Jian,0,0,0,0
1653550569896,ECE 240A,A00,091075,Radic; Stojan,0,0,0,0
1653550570420,ECE 247A,A00,091592,Shi; Lingyan,0,0,0,0
1653550570943,ECE 250,A00,091076,Touri; Behrouz,0,0,0,0
1653550571466,ECE 251C,A00,091078,Nguyen; Truong Quang,0,0,0,0
1653550571989,ECE 253,A00,091079,Cosman; Pamela C.,0,0,0,0
1653550572514,ECE 255A,A00,091080,Orlitsky; Alon,0,0,0,0
1653550573038,ECE 257A,A00,091081,Zhang; Xinyu,0,0,0,0
1653550573562,ECE 260A,A01,091084,Eldon; John,0,0,0,0
1653550574086,ECE 264C,A00,091085,Galton; Ian A,0,0,0,0
1653550574611,ECE 265C,A00,094889,Presti; Calogero Davide,0,0,0,9
1653550575225,ECE 266,A01,091087,Hall; Drew A.,0,0,0,0
1653550576274,ECE 271A,A00,091090,Vasconcelos; Nuno,0,0,0,0
1653550576797,ECE 272B,A00,091091,Sworder; David D.,0,0,0,0
1653550577323,ECE 275A,A00,091092,Meyer; Florian,0,0,0,0
1653550577847,ECE 277,A00,091093,An; Cheolhong,0,0,0,0
1653550578373,ECE 283,A00,091094,Le; Hanh-Phuc,0,0,0,0
1653550578923,ECE 284,A00,091095,Kang; Mingu,0,0,0,0
1653550578923,ECE 284,B00,091096,Wang; Edward Jay,0,0,0,0
1653550579451,ECE 285,A00,094334,Touri; Behrouz,0,0,0,0
1653550579975,ECE 289,A00,091097,Whelan; David Arthur,0,0,0,0
1653550580504,MATH 200A,A00,087414,Salehi Golsefidy; Alireza,7,0,8,1
1653550581033,MATH 202A,A00,087415,Gill; Philip E.,2,0,8,6
1653550581558,MATH 203A,A00,087416,Oprea; Dragos N.,6,0,8,2
1653550582082,MATH 204A,A00,087417,Kedlaya; Kiran S.,6,0,8,2
1653550582609,MATH 205,A00,087418,Sorensen; Claus M,6,0,8,2
1653550583141,MATH 206A,A00,087419,Izadi; Elham,7,0,8,1
1653550583665,MATH 207A,A00,087420,Mohammadi; Amir,5,0,8,3
1653550584187,MATH 208,A00,087421,Staff,9,0,10,1
1653550584710,MATH 209,A00,087422,Staff,10,0,10,0
1653550585233,MATH 218,A00,087423,Staff,10,0,10,0
1653550585757,MATH 220A,A00,087424,Novak; Jonathan I,6,0,8,2
1653550586280,MATH 231A,A00,087425,Bejenaru; Ioan,3,0,8,5
1653550586822,MATH 240A,A00,087426,Ebenfelt; Peter F,5,0,8,3
1653550587345,MATH 243,A00,087427,Staff,9,0,10,1
1653550587873,MATH 248,A00,087429,Staff,10,0,10,0
1653550588398,MATH 250A,A00,087430,Spolaor; Luca,4,0,8,4
1653550588924,MATH 257A,A00,087431,Spolaor; Luca,7,0,8,1
1653550589448,MATH 258,A00,087432,Staff,9,0,10,1
1653550589976,MATH 264A,A00,087433,Warnke; Lutz Peter,5,0,8,3
1653550590502,MATH 268,A00,087434,Staff,15,0,15,0
1653550591025,MATH 269,A00,087435,Staff,14,0,15,1
1653550591551,MATH 270A,A00,087436,Nie; Jiawang,0,0,8,8
1653550592075,MATH 272A,A00,087437,Tian; Xiaochuan,1,0,8,7
1653550592600,MATH 274,A01,087439,Cheng; Li-Tien,9,0,10,1
1653550592600,MATH 274,A02,087440,Cheng; Li-Tien,10,0,10,0
1653550593124,MATH 278A,A00,087441,Staff,8,0,10,2
1653550593648,MATH 278B,A00,087442,Staff,8,0,10,2
1653550594171,MATH 278C,A00,087443,Staff,8,0,10,2
1653550594698,MATH 280A,A00,087444,Zheng; Tianyi,0,0,8,8
1653550595241,MATH 281A,A00,087445,Bradic; Jelena,0,0,8,8
1653550595765,MATH 282A,A00,087446,Zhang; Danna,0,0,8,8
1653550596300,MATH 283,A00,087447,Tesler; Glenn,0,0,0,15
1653550596833,MATH 286,A00,087448,Kemp; Todd Aahron,5,0,8,3
1653550597356,MATH 287D,A00,087449,Bradic; Jelena,0,0,0,0
1653550597882,MATH 288,A00,087450,Staff,14,0,15,1
1653550597882,MATH 288,B00,087451,Staff,15,0,15,0
1653550597882,MATH 288,C00,087452,Staff,15,0,15,0
1653550598405,MATH 290A,A00,087453,Xu; Zhouli,6,0,8,2
1653550598932,MATH 291A,A00,087454,Xu; Zhouli,7,0,8,1
1653550599469,MATH 292,A00,087455,Staff,10,0,10,0
1653550599991,MATH 295,A00,087456,Staff,50,0,50,0
1653550600519,MATH 297,001,087457,Staff,998,0,999,1
1653551161382,COGS 200,A01,087991,Staff,47,0,50,3
1653551161907,COGS 201,A01,094504,Rangel; Lara M,17,0,25,8
1653551162432,COGS 203,A00,087992,Coulson; Seana M,18,0,20,2
1653551162960,COGS 210A,001,087993,Greene; Deanna Jacquelyn,9998,0,9999,1
1653551162960,COGS 210A,002,087994,Saygin; Ayse P,9999,0,9999,0
1653551162960,COGS 210A,003,087995,Xia; Haijun,9999,0,9999,0
1653551162960,COGS 210A,004,087996,Nitz; Douglas A.,9999,0,9999,0
1653551162960,COGS 210A,005,087997,Hollan; James D.,9999,0,9999,0
1653551162960,COGS 210A,006,087998,Deak; Gedeon O.,9998,0,9999,1
1653551162960,COGS 210A,007,087999,Rossano; Federico,9999,0,9999,0
1653551163571,COGS 211A,A00,088000,Coulson; Seana M,9997,0,9999,2
1653551164094,COGS 229,A00,088002,Staff,23,0,25,2
1653551164619,COGS 260,B00,094231,Staff,17,0,20,3
1653551164619,COGS 260,A00,088004,Nitz; Douglas A.,9998,0,9999,1
1653551165147,CSE 202,A00,090110,Paturi; Ramamohan,0,0,0,0
1653551165147,CSE 202,B00,090111,Paturi; Ramamohan,0,0,0,0
1653551165671,CSE 207B,A00,090112,Heninger; Nadia A,0,0,0,0
1653551166196,CSE 208,A00,094858,Micciancio; Daniele,0,0,0,0
1653551166721,CSE 210,A00,090113,Powell; Thomas Allan,0,0,0,0
1653551167246,CSE 219,A00,090898,Staff,0,0,0,0
1653551167777,CSE 221,A00,090114,Zhou; Yuan-Yuan,0,0,0,0
1653551168300,CSE 229A,A00,090115,Porter; George M,0,0,0,0
1653551168834,CSE 229C,A00,090116,Savage; Stefan,0,0,0,0
1653551169359,CSE 230,A00,090117,Jhala; Ranjit,0,0,0,0
1653551169888,CSE 232,A00,090118,Papakonstantinou; Yannis,0,0,0,0
1653551170412,CSE 239A,A00,090121,Kumar; Arun Kumar,0,0,0,0
1653551170938,CSE 239B,A00,090122,Jhala; Ranjit,0,0,0,0
1653551171463,CSE 240A,A00,090123,Zhao; Jishen,0,0,189,189
1653551171988,CSE 243A,A00,090124,Orailoglu; Alex,0,0,15,15
1653551172518,CSE 249B,A00,090125,Kahng; Andrew Byun,13,0,20,7
1653551173045,CSE 250A,A00,090126,Berg-Kirkpatrick; Taylor D,0,0,0,0
1653551173577,CSE 252A,A00,090127,Ochoa; Benjamin Lawrence,0,0,0,0
1653551174104,CSE 258,A01,090129,McAuley; Julian John,0,0,0,0
1653551174629,CSE 258R,A01,090131,McAuley; Julian John,0,0,0,0
1653551175156,CSE 274,A00,090132,Ramamoorthi; Ravi,0,0,0,0
1653551175680,CSE 276A,A00,090133,Christensen; Henrik I,0,0,0,0
1653551176203,CSE 276C,A00,090134,Christensen; Henrik I,0,0,0,0
1653551176731,CSE 290,A00,090135,Bafna; Vineet,0,0,0,0
1653551176731,CSE 290,B00,090136,Ramamoorthi; Ravi,0,0,0,0
1653551176731,CSE 290,C00,090137,Li; Tzumao,8,0,10,2
1653551176731,CSE 290,D00,090138,Zhou; Yuan-Yuan,9,0,10,1
1653551176731,CSE 290,E00,090139,Christensen; Henrik I,8,0,10,2
1653551176731,CSE 290,F00,094053,Shalev; Aaron D,0,0,0,0
1653551177259,CSE 291,A00,090140,Munyaka; Imani N. S.,0,0,0,0
1653551177259,CSE 291,B00,094880,Yu; Qi,0,0,0,0
1653551177259,CSE 291,C00,090142,Pannuto; Patrick William,0,0,0,0
1653551177259,CSE 291,D00,094881,Zhang; Yiying,0,0,0,0
1653551177259,CSE 291,E00,095118,Su; Hao,0,0,0,0
1653551177839,CSE 293,001,094905,Bafna; Vineet,9999,0,9999,0
1653551177839,CSE 293,002,094906,Bellare; Mihir,9999,0,9999,0
1653551177839,CSE 293,003,094907,Berg-Kirkpatrick; Taylor D,9999,0,9999,0
1653551177839,CSE 293,004,094908,Christensen; Henrik I,9999,0,9999,0
1653551177839,CSE 293,005,094909,Cottrell; Garrison W,9999,0,9999,0
1653551177839,CSE 293,006,094910,Deutsch; Alin Bernard,9999,0,9999,0
1653551177839,CSE 293,007,094911,Esmaeilzadeh; Hadi,9999,0,9999,0
1653551177839,CSE 293,008,094912,Freund; Yoav,9999,0,9999,0
1653551177839,CSE 293,009,094913,Griswold; William G.,9999,0,9999,0
1653551177839,CSE 293,010,094914,Gymrek; Melissa Ann,9999,0,9999,0
1653551177839,CSE 293,011,094915,Heninger; Nadia A,9999,0,9999,0
1653551177839,CSE 293,012,094916,Impagliazzo; Russell,9999,0,9999,0
1653551177839,CSE 293,013,094917,Jhala; Ranjit,9999,0,9999,0
1653551177839,CSE 293,014,094918,Kahng; Andrew Byun,9999,0,9999,0
1653551177839,CSE 293,015,094919,Kane; Daniel Mertz,9999,0,9999,0
1653551177839,CSE 293,016,094920,Kriegman; David J,9999,0,9999,0
1653551177839,CSE 293,017,094921,Kumar; Arun Kumar,9999,0,9999,0
1653551177839,CSE 293,018,094922,Lerner; Sorin,9999,0,9999,0
1653551177839,CSE 293,019,094923,Lovett; Shachar,9999,0,9999,0
1653551177839,CSE 293,020,094924,McAuley; Julian John,9999,0,9999,0
1653551177839,CSE 293,021,094925,Micciancio; Daniele,9999,0,9999,0
1653551177839,CSE 293,022,094926,Orailoglu; Alex,9999,0,9999,0
1653551177839,CSE 293,023,094927,Paturi; Ramamohan,9999,0,9999,0
1653551177839,CSE 293,024,094928,Polikarpova; Nadezhda,9999,0,9999,0
1653551177839,CSE 293,025,094929,Politz; Joseph Gibbs,9999,0,9999,0
1653551177839,CSE 293,026,094930,Porter; George M,9999,0,9999,0
1653551177839,CSE 293,027,094931,Porter; Leonard Emerson,9999,0,9999,0
1653551177839,CSE 293,028,094932,Ramamoorthi; Ravi,9999,0,9999,0
1653551177839,CSE 293,029,094933,Sahoo; Debashis,9999,0,9999,0
1653551177839,CSE 293,030,094934,Saul; Lawrence,9999,0,9999,0
1653551177839,CSE 293,031,094935,Savage; Stefan,9999,0,9999,0
1653551177839,CSE 293,032,094936,Schulze; Jurgen P.,9999,0,9999,0
1653551177839,CSE 293,033,094937,Snoeren; Alex C.,9999,0,9999,0
1653551177839,CSE 293,034,094938,Shang; Jingbo,9999,0,9999,0
1653551177839,CSE 293,035,094939,Stefan; Deian,9999,0,9999,0
1653551177839,CSE 293,036,094940,Su; Hao,9999,0,9999,0
1653551177839,CSE 293,037,094941,Swanson; Steven James,9999,0,9999,0
1653551177839,CSE 293,038,094942,Tullsen; Dean Michael,9999,0,9999,0
1653551177839,CSE 293,039,094943,Voelker; Geoffrey M.,9999,0,9999,0
1653551177839,CSE 293,040,094944,Zhao; Jishen,9999,0,9999,0
1653551177839,CSE 293,041,094945,Zhou; Yuan-Yuan,9999,0,9999,0
1653551177839,CSE 293,042,094946,Gao; Sicun,9998,0,9999,1
1653551177839,CSE 293,043,094947,Weibel; Nadir,9999,0,9999,0
1653551177839,CSE 293,044,094948,Gupta; Rajesh K.,9999,0,9999,0
1653551178362,CSE 294,A00,090143,Porter; George M,8,0,10,2
1653551178892,DSE 200,A00,091799,Staff,50,0,50,0
1653551179421,DSE 203,A00,091800,Gupta; Amarnath,30,0,30,0
1653551179951,DSE 250,A00,091801,Deutsch; Alin Bernard,30,0,30,0
1653551180480,DSE 290,A00,091802,Altintas De Callaf; Ilkay,50,0,50,0
1653551181036,ECE 200,001,091003,Antipa; Nicholas A,9999,0,9999,0
1653551181036,ECE 200,002,091004,Atanasov; Nikolay A.,9999,0,9999,0
1653551181036,ECE 200,003,091005,Bharadia; Dinesh,9999,0,9999,0
1653551181036,ECE 200,004,091006,Cheng; Chung Kuan,9999,0,9999,0
1653551181036,ECE 200,005,091007,Cosman; Pamela C.,9999,0,9999,0
1653551181036,ECE 200,006,091008,Staff,9999,0,9999,0
1653551181036,ECE 200,007,091009,Dayeh; Shadi Ahmad,9999,0,9999,0
1653551181036,ECE 200,008,091010,Fainman; Yeshaiahu,9999,0,9999,0
1653551181036,ECE 200,009,091011,Ford; Joseph Earl,9999,0,9999,0
1653551181036,ECE 200,010,091012,Franceschetti; Massimo,9999,0,9999,0
1653551181036,ECE 200,011,091013,Fullerton; Eric E,9999,0,9999,0
1653551181036,ECE 200,012,091014,Galton; Ian A,9999,0,9999,0
1653551181036,ECE 200,013,091015,Gilja; Vikash,9999,0,9999,0
1653551181036,ECE 200,014,091016,Hall; Drew A.,9999,0,9999,0
1653551181036,ECE 200,015,091017,Hsueh; Tzu-Chien,9999,0,9999,0
1653551181036,ECE 200,016,091018,Javidi; Tara,9999,0,9999,0
1653551181036,ECE 200,017,091019,Kahng; Andrew Byun,9999,0,9999,0
1653551181036,ECE 200,018,091020,Kim; Young-Han,9999,0,9999,0
1653551181036,ECE 200,019,091021,Koushanfar; Farinaz,9999,0,9999,0
1653551181036,ECE 200,020,091022,Kuzum; Duygu,9999,0,9999,0
1653551181036,ECE 200,021,091023,Le; Hanh-Phuc,9999,0,9999,0
1653551181036,ECE 200,022,091024,Lin; Bill,9999,0,9999,0
1653551181036,ECE 200,023,091025,Liu; Zhaowei,9999,0,9999,0
1653551181036,ECE 200,024,091026,Lo; Yu-Hwa,9999,0,9999,0
1653551181036,ECE 200,025,091027,Lomakin; Vitaliy,9999,0,9999,0
1653551181036,ECE 200,026,091028,Mercier; Patrick Philip,9999,0,9999,0
1653551181036,ECE 200,027,091029,Meyer; Florian,9999,0,9999,0
1653551181036,ECE 200,028,091030,Milstein; Laurence B.,9999,0,9999,0
1653551181036,ECE 200,029,091031,Mir Arabbaygi; Siavash,9999,0,9999,0
1653551181036,ECE 200,030,091032,Mookherjea; Shayan,9999,0,9999,0
1653551181036,ECE 200,031,091033,Morris; Karcher William,9999,0,9999,0
1653551181036,ECE 200,032,091034,Ng; Tse Nga,9999,0,9999,0
1653551181036,ECE 200,033,091035,Nguyen; Truong Quang,9999,0,9999,0
1653551181036,ECE 200,034,091036,Nomura; Kenji,9999,0,9999,0
1653551181036,ECE 200,035,091037,Orlitsky; Alon,9999,0,9999,0
1653551181036,ECE 200,036,091038,Pal; Piya,9999,0,9999,0
1653551181036,ECE 200,037,091039,Papen; George C.,9999,0,9999,0
1653551181036,ECE 200,038,091040,Radic; Stojan,9999,0,9999,0
1653551181036,ECE 200,039,091041,Rao; Bhaskar D.,9999,0,9999,0
1653551181036,ECE 200,040,091042,Rao; Ramesh R,9999,0,9999,0
1653551181036,ECE 200,041,091043,Rebeiz; Gabriel,9999,0,9999,0
1653551181036,ECE 200,042,091044,Sanford; John R,9999,0,9999,0
1653551181036,ECE 200,043,091045,Siegel; Paul H.,9999,0,9999,0
1653551181036,ECE 200,044,091046,Sievenpiper; Daniel F.,9999,0,9999,0
1653551181036,ECE 200,045,091047,Sworder; David D.,9999,0,9999,0
1653551181036,ECE 200,046,091048,Taur; Yuan,9999,0,9999,0
1653551181036,ECE 200,047,091049,Touri; Behrouz,9999,0,9999,0
1653551181036,ECE 200,048,091050,Trivedi; Mohan M.,9999,0,9999,0
1653551181036,ECE 200,049,091051,Vardy; Alexander,9999,0,9999,0
1653551181036,ECE 200,050,091052,Vasconcelos; Nuno,9999,0,9999,0
1653551181036,ECE 200,051,091053,Wang; Xiaolong,9999,0,9999,0
1653551181036,ECE 200,052,091054,Xie; Pengtao,9999,0,9999,0
1653551181036,ECE 200,053,091055,Yip; Michael,9999,0,9999,0
1653551181036,ECE 200,054,091056,Zeger; Kenneth A.,9999,0,9999,0
1653551181036,ECE 200,055,091057,Zhang; Xinyu,9999,0,9999,0
1653551181036,ECE 200,056,091058,Turakhia; Yatish Girish,9999,0,9999,0
1653551181036,ECE 200,057,091059,Kang; Mingu,9999,0,9999,0
1653551181036,ECE 200,058,091060,Shi; Yuanyuan,9999,0,9999,0
1653551181036,ECE 200,059,091061,Wang; Edward Jay,9999,0,9999,0
1653551181036,ECE 200,060,091062,Zheng; Yang,9999,0,9999,0
1653551181565,ECE 201,A00,095526,Lo; Yu-Hwa,0,0,0,0
1653551182090,ECE 203,A00,091065,Mercier; Patrick Philip,0,0,0,0
1653551182614,ECE 207A,A00,091605,Liu; Thomas Tao-Ming,0,0,0,0
1653551183144,ECE 212AN,A00,091068,Nomura; Kenji,0,0,0,0
1653551183667,ECE 222A,A00,091069,Rebeiz; Gabriel,0,0,0,0
1653551184194,ECE 225A,A00,091070,Orlitsky; Alon,0,0,0,0
1653551184718,ECE 230A,A00,091071,Nomura; Kenji,0,0,0,0
1653551185242,ECE 236A,A00,091072,Dayeh; Shadi Ahmad,0,0,0,0
1653551185778,ECE 238A,A00,091073,Luo; Jian,0,0,0,0
1653551185778,ECE 238A,B00,091074,Luo; Jian,0,0,0,0
1653551186302,ECE 240A,A00,091075,Radic; Stojan,0,0,0,0
1653551186826,ECE 247A,A00,091592,Shi; Lingyan,0,0,0,0
1653551187352,ECE 250,A00,091076,Touri; Behrouz,0,0,0,0
1653551187883,ECE 251C,A00,091078,Nguyen; Truong Quang,0,0,0,0
1653551188409,ECE 253,A00,091079,Cosman; Pamela C.,0,0,0,0
1653551188938,ECE 255A,A00,091080,Orlitsky; Alon,0,0,0,0
1653551189466,ECE 257A,A00,091081,Zhang; Xinyu,0,0,0,0
1653551189991,ECE 260A,A01,091084,Eldon; John,0,0,0,0
1653551190520,ECE 264C,A00,091085,Galton; Ian A,0,0,0,0
1653551191046,ECE 265C,A00,094889,Presti; Calogero Davide,0,0,0,9
1653551191576,ECE 266,A01,091087,Hall; Drew A.,0,0,0,0
1653551192630,ECE 271A,A00,091090,Vasconcelos; Nuno,0,0,0,0
1653551193158,ECE 272B,A00,091091,Sworder; David D.,0,0,0,0
1653551193681,ECE 275A,A00,091092,Meyer; Florian,0,0,0,0
1653551194204,ECE 277,A00,091093,An; Cheolhong,0,0,0,0
1653551194729,ECE 283,A00,091094,Le; Hanh-Phuc,0,0,0,0
1653551195254,ECE 284,A00,091095,Kang; Mingu,0,0,0,0
1653551195254,ECE 284,B00,091096,Wang; Edward Jay,0,0,0,0
1653551195780,ECE 285,A00,094334,Touri; Behrouz,0,0,0,0
1653551196309,ECE 289,A00,091097,Whelan; David Arthur,0,0,0,0
1653551196838,MATH 200A,A00,087414,Salehi Golsefidy; Alireza,7,0,8,1
1653551197362,MATH 202A,A00,087415,Gill; Philip E.,2,0,8,6
1653551197897,MATH 203A,A00,087416,Oprea; Dragos N.,6,0,8,2
1653551198420,MATH 204A,A00,087417,Kedlaya; Kiran S.,6,0,8,2
1653551198944,MATH 205,A00,087418,Sorensen; Claus M,6,0,8,2
1653551199471,MATH 206A,A00,087419,Izadi; Elham,7,0,8,1
1653551199995,MATH 207A,A00,087420,Mohammadi; Amir,5,0,8,3
1653551200521,MATH 208,A00,087421,Staff,9,0,10,1
1653551201044,MATH 209,A00,087422,Staff,10,0,10,0
1653551201567,MATH 218,A00,087423,Staff,10,0,10,0
1653551202093,MATH 220A,A00,087424,Novak; Jonathan I,6,0,8,2
1653551202617,MATH 231A,A00,087425,Bejenaru; Ioan,3,0,8,5
1653551203146,MATH 240A,A00,087426,Ebenfelt; Peter F,5,0,8,3
1653551203672,MATH 243,A00,087427,Staff,9,0,10,1
1653551204196,MATH 248,A00,087429,Staff,10,0,10,0
1653551204724,MATH 250A,A00,087430,Spolaor; Luca,4,0,8,4
1653551205247,MATH 257A,A00,087431,Spolaor; Luca,7,0,8,1
1653551205772,MATH 258,A00,087432,Staff,9,0,10,1
1653551206297,MATH 264A,A00,087433,Warnke; Lutz Peter,5,0,8,3
1653551206821,MATH 268,A00,087434,Staff,15,0,15,0
1653551207347,MATH 269,A00,087435,Staff,14,0,15,1
1653551207871,MATH 270A,A00,087436,Nie; Jiawang,0,0,8,8
1653551208394,MATH 272A,A00,087437,Tian; Xiaochuan,1,0,8,7
1653551208918,MATH 274,A01,087439,Cheng; Li-Tien,9,0,10,1
1653551208918,MATH 274,A02,087440,Cheng; Li-Tien,10,0,10,0
1653551209440,MATH 278A,A00,087441,Staff,8,0,10,2
1653551209963,MATH 278B,A00,087442,Staff,8,0,10,2
1653551210486,MATH 278C,A00,087443,Staff,8,0,10,2
1653551211011,MATH 280A,A00,087444,Zheng; Tianyi,0,0,8,8
1653551211539,MATH 281A,A00,087445,Bradic; Jelena,0,0,8,8
1653551212068,MATH 282A,A00,087446,Zhang; Danna,0,0,8,8
1653551212591,MATH 283,A00,087447,Tesler; Glenn,0,0,0,15
1653551213115,MATH 286,A00,087448,Kemp; Todd Aahron,5,0,8,3
1653551213646,MATH 287D,A00,087449,Bradic; Jelena,0,0,0,0
1653551214171,MATH 288,A00,087450,Staff,14,0,15,1
1653551214171,MATH 288,B00,087451,Staff,15,0,15,0
1653551214171,MATH 288,C00,087452,Staff,15,0,15,0
1653551214701,MATH 290A,A00,087453,Xu; Zhouli,6,0,8,2
1653551215231,MATH 291A,A00,087454,Xu; Zhouli,7,0,8,1
1653551215754,MATH 292,A00,087455,Staff,10,0,10,0
1653551216277,MATH 295,A00,087456,Staff,50,0,50,0
1653551216874,MATH 297,001,087457,Staff,998,0,999,1
1653551777940,COGS 200,A01,087991,Staff,47,0,50,3
1653551778464,COGS 201,A01,094504,Rangel; Lara M,17,0,25,8
1653551778987,COGS 203,A00,087992,Coulson; Seana M,18,0,20,2
1653551779514,COGS 210A,001,087993,Greene; Deanna Jacquelyn,9998,0,9999,1
1653551779514,COGS 210A,002,087994,Saygin; Ayse P,9999,0,9999,0
1653551779514,COGS 210A,003,087995,Xia; Haijun,9999,0,9999,0
1653551779514,COGS 210A,004,087996,Nitz; Douglas A.,9999,0,9999,0
1653551779514,COGS 210A,005,087997,Hollan; James D.,9999,0,9999,0
1653551779514,COGS 210A,006,087998,Deak; Gedeon O.,9998,0,9999,1
1653551779514,COGS 210A,007,087999,Rossano; Federico,9999,0,9999,0
1653551780038,COGS 211A,A00,088000,Coulson; Seana M,9997,0,9999,2
1653551780561,COGS 229,A00,088002,Staff,23,0,25,2
1653551781084,COGS 260,B00,094231,Staff,17,0,20,3
1653551781084,COGS 260,A00,088004,Nitz; Douglas A.,9998,0,9999,1
1653551781609,CSE 202,A00,090110,Paturi; Ramamohan,0,0,0,0
1653551781609,CSE 202,B00,090111,Paturi; Ramamohan,0,0,0,0
1653551782137,CSE 207B,A00,090112,Heninger; Nadia A,0,0,0,0
1653551782664,CSE 208,A00,094858,Micciancio; Daniele,0,0,0,0
1653551783191,CSE 210,A00,090113,Powell; Thomas Allan,0,0,0,0
1653551783715,CSE 219,A00,090898,Staff,0,0,0,0
1653551784238,CSE 221,A00,090114,Zhou; Yuan-Yuan,0,0,0,0
1653551784763,CSE 229A,A00,090115,Porter; George M,0,0,0,0
1653551785286,CSE 229C,A00,090116,Savage; Stefan,0,0,0,0
1653551785818,CSE 230,A00,090117,Jhala; Ranjit,0,0,0,0
1653551786342,CSE 232,A00,090118,Papakonstantinou; Yannis,0,0,0,0
1653551786867,CSE 239A,A00,090121,Kumar; Arun Kumar,0,0,0,0
1653551787393,CSE 239B,A00,090122,Jhala; Ranjit,0,0,0,0
1653551787920,CSE 240A,A00,090123,Zhao; Jishen,0,0,189,189
1653551788444,CSE 243A,A00,090124,Orailoglu; Alex,0,0,15,15
1653551788968,CSE 249B,A00,090125,Kahng; Andrew Byun,13,0,20,7
1653551789491,CSE 250A,A00,090126,Berg-Kirkpatrick; Taylor D,0,0,0,0
1653551790021,CSE 252A,A00,090127,Ochoa; Benjamin Lawrence,0,0,0,0
1653551790549,CSE 258,A01,090129,McAuley; Julian John,0,0,0,0
1653551791077,CSE 258R,A01,090131,McAuley; Julian John,0,0,0,0
1653551791614,CSE 274,A00,090132,Ramamoorthi; Ravi,0,0,0,0
1653551792138,CSE 276A,A00,090133,Christensen; Henrik I,0,0,0,0
1653551792662,CSE 276C,A00,090134,Christensen; Henrik I,0,0,0,0
1653551793197,CSE 290,A00,090135,Bafna; Vineet,0,0,0,0
1653551793197,CSE 290,B00,090136,Ramamoorthi; Ravi,0,0,0,0
1653551793197,CSE 290,C00,090137,Li; Tzumao,8,0,10,2
1653551793197,CSE 290,D00,090138,Zhou; Yuan-Yuan,9,0,10,1
1653551793197,CSE 290,E00,090139,Christensen; Henrik I,8,0,10,2
1653551793197,CSE 290,F00,094053,Shalev; Aaron D,0,0,0,0
1653551793732,CSE 291,A00,090140,Munyaka; Imani N. S.,0,0,0,0
1653551793732,CSE 291,B00,094880,Yu; Qi,0,0,0,0
1653551793732,CSE 291,C00,090142,Pannuto; Patrick William,0,0,0,0
1653551793732,CSE 291,D00,094881,Zhang; Yiying,0,0,0,0
1653551793732,CSE 291,E00,095118,Su; Hao,0,0,0,0
1653551794270,CSE 293,001,094905,Bafna; Vineet,9999,0,9999,0
1653551794270,CSE 293,002,094906,Bellare; Mihir,9999,0,9999,0
1653551794270,CSE 293,003,094907,Berg-Kirkpatrick; Taylor D,9999,0,9999,0
1653551794270,CSE 293,004,094908,Christensen; Henrik I,9999,0,9999,0
1653551794270,CSE 293,005,094909,Cottrell; Garrison W,9999,0,9999,0
1653551794270,CSE 293,006,094910,Deutsch; Alin Bernard,9999,0,9999,0
1653551794270,CSE 293,007,094911,Esmaeilzadeh; Hadi,9999,0,9999,0
1653551794270,CSE 293,008,094912,Freund; Yoav,9999,0,9999,0
1653551794270,CSE 293,009,094913,Griswold; William G.,9999,0,9999,0
1653551794270,CSE 293,010,094914,Gymrek; Melissa Ann,9999,0,9999,0
1653551794270,CSE 293,011,094915,Heninger; Nadia A,9999,0,9999,0
1653551794270,CSE 293,012,094916,Impagliazzo; Russell,9999,0,9999,0
1653551794270,CSE 293,013,094917,Jhala; Ranjit,9999,0,9999,0
1653551794270,CSE 293,014,094918,Kahng; Andrew Byun,9999,0,9999,0
1653551794270,CSE 293,015,094919,Kane; Daniel Mertz,9999,0,9999,0
1653551794270,CSE 293,016,094920,Kriegman; David J,9999,0,9999,0
1653551794270,CSE 293,017,094921,Kumar; Arun Kumar,9999,0,9999,0
1653551794270,CSE 293,018,094922,Lerner; Sorin,9999,0,9999,0
1653551794270,CSE 293,019,094923,Lovett; Shachar,9999,0,9999,0
1653551794270,CSE 293,020,094924,McAuley; Julian John,9999,0,9999,0
1653551794270,CSE 293,021,094925,Micciancio; Daniele,9999,0,9999,0
1653551794270,CSE 293,022,094926,Orailoglu; Alex,9999,0,9999,0
1653551794270,CSE 293,023,094927,Paturi; Ramamohan,9999,0,9999,0
1653551794270,CSE 293,024,094928,Polikarpova; Nadezhda,9999,0,9999,0
1653551794270,CSE 293,025,094929,Politz; Joseph Gibbs,9999,0,9999,0
1653551794270,CSE 293,026,094930,Porter; George M,9999,0,9999,0
1653551794270,CSE 293,027,094931,Porter; Leonard Emerson,9999,0,9999,0
1653551794270,CSE 293,028,094932,Ramamoorthi; Ravi,9999,0,9999,0
1653551794270,CSE 293,029,094933,Sahoo; Debashis,9999,0,9999,0
1653551794270,CSE 293,030,094934,Saul; Lawrence,9999,0,9999,0
1653551794270,CSE 293,031,094935,Savage; Stefan,9999,0,9999,0
1653551794270,CSE 293,032,094936,Schulze; Jurgen P.,9999,0,9999,0
1653551794270,CSE 293,033,094937,Snoeren; Alex C.,9999,0,9999,0
1653551794270,CSE 293,034,094938,Shang; Jingbo,9999,0,9999,0
1653551794270,CSE 293,035,094939,Stefan; Deian,9999,0,9999,0
1653551794270,CSE 293,036,094940,Su; Hao,9999,0,9999,0
1653551794270,CSE 293,037,094941,Swanson; Steven James,9999,0,9999,0
1653551794270,CSE 293,038,094942,Tullsen; Dean Michael,9999,0,9999,0
1653551794270,CSE 293,039,094943,Voelker; Geoffrey M.,9999,0,9999,0
1653551794270,CSE 293,040,094944,Zhao; Jishen,9999,0,9999,0
1653551794270,CSE 293,041,094945,Zhou; Yuan-Yuan,9999,0,9999,0
1653551794270,CSE 293,042,094946,Gao; Sicun,9998,0,9999,1
1653551794270,CSE 293,043,094947,Weibel; Nadir,9999,0,9999,0
1653551794270,CSE 293,044,094948,Gupta; Rajesh K.,9999,0,9999,0
1653551794797,CSE 294,A00,090143,Porter; George M,8,0,10,2
1653551795329,DSE 200,A00,091799,Staff,50,0,50,0
1653551795853,DSE 203,A00,091800,Gupta; Amarnath,30,0,30,0
1653551796375,DSE 250,A00,091801,Deutsch; Alin Bernard,30,0,30,0
1653551796905,DSE 290,A00,091802,Altintas De Callaf; Ilkay,50,0,50,0
1653551797485,ECE 200,001,091003,Antipa; Nicholas A,9999,0,9999,0
1653551797485,ECE 200,002,091004,Atanasov; Nikolay A.,9999,0,9999,0
1653551797485,ECE 200,003,091005,Bharadia; Dinesh,9999,0,9999,0
1653551797485,ECE 200,004,091006,Cheng; Chung Kuan,9999,0,9999,0
1653551797485,ECE 200,005,091007,Cosman; Pamela C.,9999,0,9999,0
1653551797485,ECE 200,006,091008,Staff,9999,0,9999,0
1653551797485,ECE 200,007,091009,Dayeh; Shadi Ahmad,9999,0,9999,0
1653551797485,ECE 200,008,091010,Fainman; Yeshaiahu,9999,0,9999,0
1653551797485,ECE 200,009,091011,Ford; Joseph Earl,9999,0,9999,0
1653551797485,ECE 200,010,091012,Franceschetti; Massimo,9999,0,9999,0
1653551797485,ECE 200,011,091013,Fullerton; Eric E,9999,0,9999,0
1653551797485,ECE 200,012,091014,Galton; Ian A,9999,0,9999,0
1653551797485,ECE 200,013,091015,Gilja; Vikash,9999,0,9999,0
1653551797485,ECE 200,014,091016,Hall; Drew A.,9999,0,9999,0
1653551797485,ECE 200,015,091017,Hsueh; Tzu-Chien,9999,0,9999,0
1653551797485,ECE 200,016,091018,Javidi; Tara,9999,0,9999,0
1653551797485,ECE 200,017,091019,Kahng; Andrew Byun,9999,0,9999,0
1653551797485,ECE 200,018,091020,Kim; Young-Han,9999,0,9999,0
1653551797485,ECE 200,019,091021,Koushanfar; Farinaz,9999,0,9999,0
1653551797485,ECE 200,020,091022,Kuzum; Duygu,9999,0,9999,0
1653551797485,ECE 200,021,091023,Le; Hanh-Phuc,9999,0,9999,0
1653551797485,ECE 200,022,091024,Lin; Bill,9999,0,9999,0
1653551797485,ECE 200,023,091025,Liu; Zhaowei,9999,0,9999,0
1653551797485,ECE 200,024,091026,Lo; Yu-Hwa,9999,0,9999,0
1653551797485,ECE 200,025,091027,Lomakin; Vitaliy,9999,0,9999,0
1653551797485,ECE 200,026,091028,Mercier; Patrick Philip,9999,0,9999,0
1653551797485,ECE 200,027,091029,Meyer; Florian,9999,0,9999,0
1653551797485,ECE 200,028,091030,Milstein; Laurence B.,9999,0,9999,0
1653551797485,ECE 200,029,091031,Mir Arabbaygi; Siavash,9999,0,9999,0
1653551797485,ECE 200,030,091032,Mookherjea; Shayan,9999,0,9999,0
1653551797485,ECE 200,031,091033,Morris; Karcher William,9999,0,9999,0
1653551797485,ECE 200,032,091034,Ng; Tse Nga,9999,0,9999,0
1653551797485,ECE 200,033,091035,Nguyen; Truong Quang,9999,0,9999,0
1653551797485,ECE 200,034,091036,Nomura; Kenji,9999,0,9999,0
1653551797485,ECE 200,035,091037,Orlitsky; Alon,9999,0,9999,0
1653551797485,ECE 200,036,091038,Pal; Piya,9999,0,9999,0
1653551797485,ECE 200,037,091039,Papen; George C.,9999,0,9999,0
1653551797485,ECE 200,038,091040,Radic; Stojan,9999,0,9999,0
1653551797485,ECE 200,039,091041,Rao; Bhaskar D.,9999,0,9999,0
1653551797485,ECE 200,040,091042,Rao; Ramesh R,9999,0,9999,0
1653551797485,ECE 200,041,091043,Rebeiz; Gabriel,9999,0,9999,0
1653551797485,ECE 200,042,091044,Sanford; John R,9999,0,9999,0
1653551797485,ECE 200,043,091045,Siegel; Paul H.,9999,0,9999,0
1653551797485,ECE 200,044,091046,Sievenpiper; Daniel F.,9999,0,9999,0
1653551797485,ECE 200,045,091047,Sworder; David D.,9999,0,9999,0
1653551797485,ECE 200,046,091048,Taur; Yuan,9999,0,9999,0
1653551797485,ECE 200,047,091049,Touri; Behrouz,9999,0,9999,0
1653551797485,ECE 200,048,091050,Trivedi; Mohan M.,9999,0,9999,0
1653551797485,ECE 200,049,091051,Vardy; Alexander,9999,0,9999,0
1653551797485,ECE 200,050,091052,Vasconcelos; Nuno,9999,0,9999,0
1653551797485,ECE 200,051,091053,Wang; Xiaolong,9999,0,9999,0
1653551797485,ECE 200,052,091054,Xie; Pengtao,9999,0,9999,0
1653551797485,ECE 200,053,091055,Yip; Michael,9999,0,9999,0
1653551797485,ECE 200,054,091056,Zeger; Kenneth A.,9999,0,9999,0
1653551797485,ECE 200,055,091057,Zhang; Xinyu,9999,0,9999,0
1653551797485,ECE 200,056,091058,Turakhia; Yatish Girish,9999,0,9999,0
1653551797485,ECE 200,057,091059,Kang; Mingu,9999,0,9999,0
1653551797485,ECE 200,058,091060,Shi; Yuanyuan,9999,0,9999,0
1653551797485,ECE 200,059,091061,Wang; Edward Jay,9999,0,9999,0
1653551797485,ECE 200,060,091062,Zheng; Yang,9999,0,9999,0
1653551798010,ECE 201,A00,095526,Lo; Yu-Hwa,0,0,0,0
1653551798539,ECE 203,A00,091065,Mercier; Patrick Philip,0,0,0,0
1653551799063,ECE 207A,A00,091605,Liu; Thomas Tao-Ming,0,0,0,0
1653551799590,ECE 212AN,A00,091068,Nomura; Kenji,0,0,0,0
1653551800114,ECE 222A,A00,091069,Rebeiz; Gabriel,0,0,0,0
1653551800642,ECE 225A,A00,091070,Orlitsky; Alon,0,0,0,0
1653551801167,ECE 230A,A00,091071,Nomura; Kenji,0,0,0,0
1653551801693,ECE 236A,A00,091072,Dayeh; Shadi Ahmad,0,0,0,0
1653551802217,ECE 238A,A00,091073,Luo; Jian,0,0,0,0
1653551802217,ECE 238A,B00,091074,Luo; Jian,0,0,0,0
1653551802741,ECE 240A,A00,091075,Radic; Stojan,0,0,0,0
1653551803266,ECE 247A,A00,091592,Shi; Lingyan,0,0,0,0
1653551803795,ECE 250,A00,091076,Touri; Behrouz,0,0,0,0
1653551804349,ECE 251C,A00,091078,Nguyen; Truong Quang,0,0,0,0
1653551804872,ECE 253,A00,091079,Cosman; Pamela C.,0,0,0,0
1653551805496,ECE 255A,A00,091080,Orlitsky; Alon,0,0,0,0
1653551806021,ECE 257A,A00,091081,Zhang; Xinyu,0,0,0,0
1653551806549,ECE 260A,A01,091084,Eldon; John,0,0,0,0
1653551807079,ECE 264C,A00,091085,Galton; Ian A,0,0,0,0
1653551807608,ECE 265C,A00,094889,Presti; Calogero Davide,0,0,0,9
1653551808131,ECE 266,A01,091087,Hall; Drew A.,0,0,0,0
1653551809197,ECE 271A,A00,091090,Vasconcelos; Nuno,0,0,0,0
1653551809735,ECE 272B,A00,091091,Sworder; David D.,0,0,0,0
1653551810260,ECE 275A,A00,091092,Meyer; Florian,0,0,0,0
1653551810785,ECE 277,A00,091093,An; Cheolhong,0,0,0,0
1653551811311,ECE 283,A00,091094,Le; Hanh-Phuc,0,0,0,0
1653551811836,ECE 284,A00,091095,Kang; Mingu,0,0,0,0
1653551811836,ECE 284,B00,091096,Wang; Edward Jay,0,0,0,0
1653551812364,ECE 285,A00,094334,Touri; Behrouz,0,0,0,0
1653551812889,ECE 289,A00,091097,Whelan; David Arthur,0,0,0,0
1653551813414,MATH 200A,A00,087414,Salehi Golsefidy; Alireza,7,0,8,1
1653551813942,MATH 202A,A00,087415,Gill; Philip E.,2,0,8,6
1653551814467,MATH 203A,A00,087416,Oprea; Dragos N.,6,0,8,2
1653551814993,MATH 204A,A00,087417,Kedlaya; Kiran S.,6,0,8,2
1653551815516,MATH 205,A00,087418,Sorensen; Claus M,6,0,8,2
1653551816049,MATH 206A,A00,087419,Izadi; Elham,7,0,8,1
1653551816576,MATH 207A,A00,087420,Mohammadi; Amir,5,0,8,3
1653551817105,MATH 208,A00,087421,Staff,9,0,10,1
1653551817634,MATH 209,A00,087422,Staff,10,0,10,0
1653551818161,MATH 218,A00,087423,Staff,10,0,10,0
1653551818695,MATH 220A,A00,087424,Novak; Jonathan I,6,0,8,2
1653551819224,MATH 231A,A00,087425,Bejenaru; Ioan,3,0,8,5
1653551819751,MATH 240A,A00,087426,Ebenfelt; Peter F,5,0,8,3
1653551820278,MATH 243,A00,087427,Staff,9,0,10,1
1653551820804,MATH 248,A00,087429,Staff,10,0,10,0
1653551821332,MATH 250A,A00,087430,Spolaor; Luca,4,0,8,4
1653551821857,MATH 257A,A00,087431,Spolaor; Luca,7,0,8,1
1653551822380,MATH 258,A00,087432,Staff,9,0,10,1
1653551822908,MATH 264A,A00,087433,Warnke; Lutz Peter,5,0,8,3
1653551823431,MATH 268,A00,087434,Staff,15,0,15,0
1653551823955,MATH 269,A00,087435,Staff,14,0,15,1
1653551824484,MATH 270A,A00,087436,Nie; Jiawang,0,0,8,8
1653551825011,MATH 272A,A00,087437,Tian; Xiaochuan,1,0,8,7
1653551825540,MATH 274,A01,087439,Cheng; Li-Tien,9,0,10,1
1653551825540,MATH 274,A02,087440,Cheng; Li-Tien,10,0,10,0
1653551826066,MATH 278A,A00,087441,Staff,8,0,10,2
1653551826591,MATH 278B,A00,087442,Staff,8,0,10,2
1653551827113,MATH 278C,A00,087443,Staff,8,0,10,2
1653551827635,MATH 280A,A00,087444,Zheng; Tianyi,0,0,8,8
1653551828160,MATH 281A,A00,087445,Bradic; Jelena,0,0,8,8
1653551828688,MATH 282A,A00,087446,Zhang; Danna,0,0,8,8
1653551829213,MATH 283,A00,087447,Tesler; Glenn,0,0,0,15
1653551829739,MATH 286,A00,087448,Kemp; Todd Aahron,5,0,8,3
1653551830263,MATH 287D,A00,087449,Bradic; Jelena,0,0,0,0
1653551830797,MATH 288,A00,087450,Staff,14,0,15,1
1653551830797,MATH 288,B00,087451,Staff,15,0,15,0
1653551830797,MATH 288,C00,087452,Staff,15,0,15,0
1653551831320,MATH 290A,A00,087453,Xu; Zhouli,6,0,8,2
1653551831844,MATH 291A,A00,087454,Xu; Zhouli,7,0,8,1
1653551832367,MATH 292,A00,087455,Staff,10,0,10,0
1653551832891,MATH 295,A00,087456,Staff,50,0,50,0
1653551833419,MATH 297,001,087457,Staff,998,0,999,1
1653552394413,COGS 200,A01,087991,Staff,47,0,50,3
1653552394938,COGS 201,A01,094504,Rangel; Lara M,17,0,25,8
1653552395464,COGS 203,A00,087992,Coulson; Seana M,18,0,20,2
1653552395989,COGS 210A,001,087993,Greene; Deanna Jacquelyn,9998,0,9999,1
1653552395989,COGS 210A,002,087994,Saygin; Ayse P,9999,0,9999,0
1653552395989,COGS 210A,003,087995,Xia; Haijun,9999,0,9999,0
1653552395989,COGS 210A,004,087996,Nitz; Douglas A.,9999,0,9999,0
1653552395989,COGS 210A,005,087997,Hollan; James D.,9999,0,9999,0
1653552395989,COGS 210A,006,087998,Deak; Gedeon O.,9998,0,9999,1
1653552395989,COGS 210A,007,087999,Rossano; Federico,9999,0,9999,0
1653552396516,COGS 211A,A00,088000,Coulson; Seana M,9997,0,9999,2
1653552397041,COGS 229,A00,088002,Staff,23,0,25,2
1653552397568,COGS 260,B00,094231,Staff,17,0,20,3
1653552397568,COGS 260,A00,088004,Nitz; Douglas A.,9998,0,9999,1
1653552398095,CSE 202,A00,090110,Paturi; Ramamohan,0,0,0,0
1653552398095,CSE 202,B00,090111,Paturi; Ramamohan,0,0,0,0
1653552398619,CSE 207B,A00,090112,Heninger; Nadia A,0,0,0,0
1653552399155,CSE 208,A00,094858,Micciancio; Daniele,0,0,0,0
1653552399678,CSE 210,A00,090113,Powell; Thomas Allan,0,0,0,0
1653552400204,CSE 219,A00,090898,Staff,0,0,0,0
1653552400729,CSE 221,A00,090114,Zhou; Yuan-Yuan,0,0,0,0
1653552401253,CSE 229A,A00,090115,Porter; George M,0,0,0,0
1653552401779,CSE 229C,A00,090116,Savage; Stefan,0,0,0,0
1653552402303,CSE 230,A00,090117,Jhala; Ranjit,0,0,0,0
1653552402829,CSE 232,A00,090118,Papakonstantinou; Yannis,0,0,0,0
1653552403363,CSE 239A,A00,090121,Kumar; Arun Kumar,0,0,0,0
1653552403888,CSE 239B,A00,090122,Jhala; Ranjit,0,0,0,0
1653552404413,CSE 240A,A00,090123,Zhao; Jishen,0,0,189,189
1653552404938,CSE 243A,A00,090124,Orailoglu; Alex,0,0,15,15
1653552405466,CSE 249B,A00,090125,Kahng; Andrew Byun,13,0,20,7
1653552405992,CSE 250A,A00,090126,Berg-Kirkpatrick; Taylor D,0,0,0,0
1653552406522,CSE 252A,A00,090127,Ochoa; Benjamin Lawrence,0,0,0,0
1653552407055,CSE 258,A01,090129,McAuley; Julian John,0,0,0,0
1653552407577,CSE 258R,A01,090131,McAuley; Julian John,0,0,0,0
1653552408104,CSE 274,A00,090132,Ramamoorthi; Ravi,0,0,0,0
1653552408628,CSE 276A,A00,090133,Christensen; Henrik I,0,0,0,0
1653552409151,CSE 276C,A00,090134,Christensen; Henrik I,0,0,0,0
1653552409679,CSE 290,A00,090135,Bafna; Vineet,0,0,0,0
1653552409679,CSE 290,B00,090136,Ramamoorthi; Ravi,0,0,0,0
1653552409679,CSE 290,C00,090137,Li; Tzumao,8,0,10,2
1653552409679,CSE 290,D00,090138,Zhou; Yuan-Yuan,9,0,10,1
1653552409679,CSE 290,E00,090139,Christensen; Henrik I,8,0,10,2
1653552409679,CSE 290,F00,094053,Shalev; Aaron D,0,0,0,0
1653552410210,CSE 291,A00,090140,Munyaka; Imani N. S.,0,0,0,0
1653552410210,CSE 291,B00,094880,Yu; Qi,0,0,0,0
1653552410210,CSE 291,C00,090142,Pannuto; Patrick William,0,0,0,0
1653552410210,CSE 291,D00,094881,Zhang; Yiying,0,0,0,0
1653552410210,CSE 291,E00,095118,Su; Hao,0,0,0,0
1653552410752,CSE 293,001,094905,Bafna; Vineet,9999,0,9999,0
1653552410752,CSE 293,002,094906,Bellare; Mihir,9999,0,9999,0
1653552410752,CSE 293,003,094907,Berg-Kirkpatrick; Taylor D,9999,0,9999,0
1653552410752,CSE 293,004,094908,Christensen; Henrik I,9999,0,9999,0
1653552410752,CSE 293,005,094909,Cottrell; Garrison W,9999,0,9999,0
1653552410752,CSE 293,006,094910,Deutsch; Alin Bernard,9999,0,9999,0
1653552410752,CSE 293,007,094911,Esmaeilzadeh; Hadi,9999,0,9999,0
1653552410752,CSE 293,008,094912,Freund; Yoav,9999,0,9999,0
1653552410752,CSE 293,009,094913,Griswold; William G.,9999,0,9999,0
1653552410752,CSE 293,010,094914,Gymrek; Melissa Ann,9999,0,9999,0
1653552410752,CSE 293,011,094915,Heninger; Nadia A,9999,0,9999,0
1653552410752,CSE 293,012,094916,Impagliazzo; Russell,9999,0,9999,0
1653552410752,CSE 293,013,094917,Jhala; Ranjit,9999,0,9999,0
1653552410752,CSE 293,014,094918,Kahng; Andrew Byun,9999,0,9999,0
1653552410752,CSE 293,015,094919,Kane; Daniel Mertz,9999,0,9999,0
1653552410752,CSE 293,016,094920,Kriegman; David J,9999,0,9999,0
1653552410752,CSE 293,017,094921,Kumar; Arun Kumar,9999,0,9999,0
1653552410752,CSE 293,018,094922,Lerner; Sorin,9999,0,9999,0
1653552410752,CSE 293,019,094923,Lovett; Shachar,9999,0,9999,0
1653552410752,CSE 293,020,094924,McAuley; Julian John,9999,0,9999,0
1653552410752,CSE 293,021,094925,Micciancio; Daniele,9999,0,9999,0
1653552410752,CSE 293,022,094926,Orailoglu; Alex,9999,0,9999,0
1653552410752,CSE 293,023,094927,Paturi; Ramamohan,9999,0,9999,0
1653552410752,CSE 293,024,094928,Polikarpova; Nadezhda,9999,0,9999,0
1653552410752,CSE 293,025,094929,Politz; Joseph Gibbs,9999,0,9999,0
1653552410752,CSE 293,026,094930,Porter; George M,9999,0,9999,0
1653552410752,CSE 293,027,094931,Porter; Leonard Emerson,9999,0,9999,0
1653552410752,CSE 293,028,094932,Ramamoorthi; Ravi,9999,0,9999,0
1653552410752,CSE 293,029,094933,Sahoo; Debashis,9999,0,9999,0
1653552410752,CSE 293,030,094934,Saul; Lawrence,9999,0,9999,0
1653552410752,CSE 293,031,094935,Savage; Stefan,9999,0,9999,0
1653552410752,CSE 293,032,094936,Schulze; Jurgen P.,9999,0,9999,0
1653552410752,CSE 293,033,094937,Snoeren; Alex C.,9999,0,9999,0
1653552410752,CSE 293,034,094938,Shang; Jingbo,9999,0,9999,0
1653552410752,CSE 293,035,094939,Stefan; Deian,9999,0,9999,0
1653552410752,CSE 293,036,094940,Su; Hao,9999,0,9999,0
1653552410752,CSE 293,037,094941,Swanson; Steven James,9999,0,9999,0
1653552410752,CSE 293,038,094942,Tullsen; Dean Michael,9999,0,9999,0
1653552410752,CSE 293,039,094943,Voelker; Geoffrey M.,9999,0,9999,0
1653552410752,CSE 293,040,094944,Zhao; Jishen,9999,0,9999,0
1653552410752,CSE 293,041,094945,Zhou; Yuan-Yuan,9999,0,9999,0
1653552410752,CSE 293,042,094946,Gao; Sicun,9998,0,9999,1
1653552410752,CSE 293,043,094947,Weibel; Nadir,9999,0,9999,0
1653552410752,CSE 293,044,094948,Gupta; Rajesh K.,9999,0,9999,0
1653552411276,CSE 294,A00,090143,Porter; George M,8,0,10,2
1653552411803,DSE 200,A00,091799,Staff,50,0,50,0
1653552412328,DSE 203,A00,091800,Gupta; Amarnath,30,0,30,0
1653552412852,DSE 250,A00,091801,Deutsch; Alin Bernard,30,0,30,0
1653552413375,DSE 290,A00,091802,Altintas De Callaf; Ilkay,50,0,50,0
1653552413938,ECE 200,001,091003,Antipa; Nicholas A,9999,0,9999,0
1653552413938,ECE 200,002,091004,Atanasov; Nikolay A.,9999,0,9999,0
1653552413938,ECE 200,003,091005,Bharadia; Dinesh,9999,0,9999,0
1653552413938,ECE 200,004,091006,Cheng; Chung Kuan,9999,0,9999,0
1653552413938,ECE 200,005,091007,Cosman; Pamela C.,9999,0,9999,0
1653552413938,ECE 200,006,091008,Staff,9999,0,9999,0
1653552413938,ECE 200,007,091009,Dayeh; Shadi Ahmad,9999,0,9999,0
1653552413938,ECE 200,008,091010,Fainman; Yeshaiahu,9999,0,9999,0
1653552413938,ECE 200,009,091011,Ford; Joseph Earl,9999,0,9999,0
1653552413938,ECE 200,010,091012,Franceschetti; Massimo,9999,0,9999,0
1653552413938,ECE 200,011,091013,Fullerton; Eric E,9999,0,9999,0
1653552413938,ECE 200,012,091014,Galton; Ian A,9999,0,9999,0
1653552413938,ECE 200,013,091015,Gilja; Vikash,9999,0,9999,0
1653552413938,ECE 200,014,091016,Hall; Drew A.,9999,0,9999,0
1653552413938,ECE 200,015,091017,Hsueh; Tzu-Chien,9999,0,9999,0
1653552413938,ECE 200,016,091018,Javidi; Tara,9999,0,9999,0
1653552413938,ECE 200,017,091019,Kahng; Andrew Byun,9999,0,9999,0
1653552413938,ECE 200,018,091020,Kim; Young-Han,9999,0,9999,0
1653552413938,ECE 200,019,091021,Koushanfar; Farinaz,9999,0,9999,0
1653552413938,ECE 200,020,091022,Kuzum; Duygu,9999,0,9999,0
1653552413938,ECE 200,021,091023,Le; Hanh-Phuc,9999,0,9999,0
1653552413938,ECE 200,022,091024,Lin; Bill,9999,0,9999,0
1653552413938,ECE 200,023,091025,Liu; Zhaowei,9999,0,9999,0
1653552413938,ECE 200,024,091026,Lo; Yu-Hwa,9999,0,9999,0
1653552413938,ECE 200,025,091027,Lomakin; Vitaliy,9999,0,9999,0
1653552413938,ECE 200,026,091028,Mercier; Patrick Philip,9999,0,9999,0
1653552413938,ECE 200,027,091029,Meyer; Florian,9999,0,9999,0
1653552413938,ECE 200,028,091030,Milstein; Laurence B.,9999,0,9999,0
1653552413938,ECE 200,029,091031,Mir Arabbaygi; Siavash,9999,0,9999,0
1653552413938,ECE 200,030,091032,Mookherjea; Shayan,9999,0,9999,0
1653552413938,ECE 200,031,091033,Morris; Karcher William,9999,0,9999,0
1653552413938,ECE 200,032,091034,Ng; Tse Nga,9999,0,9999,0
1653552413938,ECE 200,033,091035,Nguyen; Truong Quang,9999,0,9999,0
1653552413938,ECE 200,034,091036,Nomura; Kenji,9999,0,9999,0
1653552413938,ECE 200,035,091037,Orlitsky; Alon,9999,0,9999,0
1653552413938,ECE 200,036,091038,Pal; Piya,9999,0,9999,0
1653552413938,ECE 200,037,091039,Papen; George C.,9999,0,9999,0
1653552413938,ECE 200,038,091040,Radic; Stojan,9999,0,9999,0
1653552413938,ECE 200,039,091041,Rao; Bhaskar D.,9999,0,9999,0
1653552413938,ECE 200,040,091042,Rao; Ramesh R,9999,0,9999,0
1653552413938,ECE 200,041,091043,Rebeiz; Gabriel,9999,0,9999,0
1653552413938,ECE 200,042,091044,Sanford; John R,9999,0,9999,0
1653552413938,ECE 200,043,091045,Siegel; Paul H.,9999,0,9999,0
1653552413938,ECE 200,044,091046,Sievenpiper; Daniel F.,9999,0,9999,0
1653552413938,ECE 200,045,091047,Sworder; David D.,9999,0,9999,0
1653552413938,ECE 200,046,091048,Taur; Yuan,9999,0,9999,0
1653552413938,ECE 200,047,091049,Touri; Behrouz,9999,0,9999,0
1653552413938,ECE 200,048,091050,Trivedi; Mohan M.,9999,0,9999,0
1653552413938,ECE 200,049,091051,Vardy; Alexander,9999,0,9999,0
1653552413938,ECE 200,050,091052,Vasconcelos; Nuno,9999,0,9999,0
1653552413938,ECE 200,051,091053,Wang; Xiaolong,9999,0,9999,0
1653552413938,ECE 200,052,091054,Xie; Pengtao,9999,0,9999,0
1653552413938,ECE 200,053,091055,Yip; Michael,9999,0,9999,0
1653552413938,ECE 200,054,091056,Zeger; Kenneth A.,9999,0,9999,0
1653552413938,ECE 200,055,091057,Zhang; Xinyu,9999,0,9999,0
1653552413938,ECE 200,056,091058,Turakhia; Yatish Girish,9999,0,9999,0
1653552413938,ECE 200,057,091059,Kang; Mingu,9999,0,9999,0
1653552413938,ECE 200,058,091060,Shi; Yuanyuan,9999,0,9999,0
1653552413938,ECE 200,059,091061,Wang; Edward Jay,9999,0,9999,0
1653552413938,ECE 200,060,091062,Zheng; Yang,9999,0,9999,0
1653552414461,ECE 201,A00,095526,Lo; Yu-Hwa,0,0,0,0
1653552414984,ECE 203,A00,091065,Mercier; Patrick Philip,0,0,0,0
1653552415507,ECE 207A,A00,091605,Liu; Thomas Tao-Ming,0,0,0,0
1653552416039,ECE 212AN,A00,091068,Nomura; Kenji,0,0,0,0
1653552416563,ECE 222A,A00,091069,Rebeiz; Gabriel,0,0,0,0
1653552417090,ECE 225A,A00,091070,Orlitsky; Alon,0,0,0,0
1653552417616,ECE 230A,A00,091071,Nomura; Kenji,0,0,0,0
1653552418145,ECE 236A,A00,091072,Dayeh; Shadi Ahmad,0,0,0,0
1653552418673,ECE 238A,A00,091073,Luo; Jian,0,0,0,0
1653552418673,ECE 238A,B00,091074,Luo; Jian,0,0,0,0
1653552419201,ECE 240A,A00,091075,Radic; Stojan,0,0,0,0
1653552419724,ECE 247A,A00,091592,Shi; Lingyan,0,0,0,0
1653552420246,ECE 250,A00,091076,Touri; Behrouz,0,0,0,0
1653552420770,ECE 251C,A00,091078,Nguyen; Truong Quang,0,0,0,0
1653552421294,ECE 253,A00,091079,Cosman; Pamela C.,0,0,0,0
1653552421817,ECE 255A,A00,091080,Orlitsky; Alon,0,0,0,0
1653552422343,ECE 257A,A00,091081,Zhang; Xinyu,0,0,0,0
1653552422873,ECE 260A,A01,091084,Eldon; John,0,0,0,0
1653552423401,ECE 264C,A00,091085,Galton; Ian A,0,0,0,0
1653552423929,ECE 265C,A00,094889,Presti; Calogero Davide,0,0,0,9
1653552424457,ECE 266,A01,091087,Hall; Drew A.,0,0,0,0
1653552425509,ECE 271A,A00,091090,Vasconcelos; Nuno,0,0,0,0
1653552426033,ECE 272B,A00,091091,Sworder; David D.,0,0,0,0
1653552426556,ECE 275A,A00,091092,Meyer; Florian,0,0,0,0
1653552427080,ECE 277,A00,091093,An; Cheolhong,0,0,0,0
1653552427605,ECE 283,A00,091094,Le; Hanh-Phuc,0,0,0,0
1653552428128,ECE 284,A00,091095,Kang; Mingu,0,0,0,0
1653552428128,ECE 284,B00,091096,Wang; Edward Jay,0,0,0,0
1653552428665,ECE 285,A00,094334,Touri; Behrouz,0,0,0,0
1653552429193,ECE 289,A00,091097,Whelan; David Arthur,0,0,0,0
1653552429718,MATH 200A,A00,087414,Salehi Golsefidy; Alireza,7,0,8,1
1653552430242,MATH 202A,A00,087415,Gill; Philip E.,2,0,8,6
1653552430766,MATH 203A,A00,087416,Oprea; Dragos N.,6,0,8,2
1653552431290,MATH 204A,A00,087417,Kedlaya; Kiran S.,6,0,8,2
1653552431817,MATH 205,A00,087418,Sorensen; Claus M,6,0,8,2
1653552432343,MATH 206A,A00,087419,Izadi; Elham,7,0,8,1
1653552432867,MATH 207A,A00,087420,Mohammadi; Amir,5,0,8,3
1653552433392,MATH 208,A00,087421,Staff,9,0,10,1
1653552433917,MATH 209,A00,087422,Staff,10,0,10,0
1653552434451,MATH 218,A00,087423,Staff,10,0,10,0
1653552434975,MATH 220A,A00,087424,Novak; Jonathan I,6,0,8,2
1653552435500,MATH 231A,A00,087425,Bejenaru; Ioan,3,0,8,5
1653552436024,MATH 240A,A00,087426,Ebenfelt; Peter F,5,0,8,3
1653552436547,MATH 243,A00,087427,Staff,9,0,10,1
1653552437077,MATH 248,A00,087429,Staff,10,0,10,0
1653552437602,MATH 250A,A00,087430,Spolaor; Luca,4,0,8,4
1653552438129,MATH 257A,A00,087431,Spolaor; Luca,7,0,8,1
1653552438655,MATH 258,A00,087432,Staff,9,0,10,1
1653552439180,MATH 264A,A00,087433,Warnke; Lutz Peter,5,0,8,3
1653552439716,MATH 268,A00,087434,Staff,15,0,15,0
1653552440241,MATH 269,A00,087435,Staff,14,0,15,1
1653552440785,MATH 270A,A00,087436,Nie; Jiawang,0,0,8,8
1653552441308,MATH 272A,A00,087437,Tian; Xiaochuan,1,0,8,7
1653552441836,MATH 274,A01,087439,Cheng; Li-Tien,9,0,10,1
1653552441836,MATH 274,A02,087440,Cheng; Li-Tien,10,0,10,0
1653552442360,MATH 278A,A00,087441,Staff,8,0,10,2
1653552442883,MATH 278B,A00,087442,Staff,8,0,10,2
1653552443412,MATH 278C,A00,087443,Staff,8,0,10,2
1653552443938,MATH 280A,A00,087444,Zheng; Tianyi,0,0,8,8
1653552444467,MATH 281A,A00,087445,Bradic; Jelena,0,0,8,8
1653552445001,MATH 282A,A00,087446,Zhang; Danna,0,0,8,8
1653552445527,MATH 283,A00,087447,Tesler; Glenn,0,0,0,15
1653552446053,MATH 286,A00,087448,Kemp; Todd Aahron,5,0,8,3
1653552446578,MATH 287D,A00,087449,Bradic; Jelena,0,0,0,1
1653552447194,MATH 288,A00,087450,Staff,14,0,15,1
1653552447194,MATH 288,B00,087451,Staff,15,0,15,0
1653552447194,MATH 288,C00,087452,Staff,15,0,15,0
1653552447719,MATH 290A,A00,087453,Xu; Zhouli,6,0,8,2
1653552448243,MATH 291A,A00,087454,Xu; Zhouli,7,0,8,1
1653552448768,MATH 292,A00,087455,Staff,10,0,10,0
1653552449295,MATH 295,A00,087456,Staff,50,0,50,0
1653552449818,MATH 297,001,087457,Staff,998,0,999,1
1653553010401,COGS 200,A01,087991,Staff,47,0,50,3
1653553010925,COGS 201,A01,094504,Rangel; Lara M,17,0,25,8
1653553011456,COGS 203,A00,087992,Coulson; Seana M,18,0,20,2
1653553011982,COGS 210A,001,087993,Greene; Deanna Jacquelyn,9998,0,9999,1
1653553011982,COGS 210A,002,087994,Saygin; Ayse P,9999,0,9999,0
1653553011982,COGS 210A,003,087995,Xia; Haijun,9999,0,9999,0
1653553011982,COGS 210A,004,087996,Nitz; Douglas A.,9999,0,9999,0
1653553011982,COGS 210A,005,087997,Hollan; James D.,9999,0,9999,0
1653553011982,COGS 210A,006,087998,Deak; Gedeon O.,9998,0,9999,1
1653553011982,COGS 210A,007,087999,Rossano; Federico,9999,0,9999,0
1653553012506,COGS 211A,A00,088000,Coulson; Seana M,9997,0,9999,2
1653553013031,COGS 229,A00,088002,Staff,23,0,25,2
1653553013556,COGS 260,B00,094231,Staff,17,0,20,3
1653553013556,COGS 260,A00,088004,Nitz; Douglas A.,9998,0,9999,1
1653553014087,CSE 202,A00,090110,Paturi; Ramamohan,0,0,0,0
1653553014087,CSE 202,B00,090111,Paturi; Ramamohan,0,0,0,0
1653553014615,CSE 207B,A00,090112,Heninger; Nadia A,0,0,0,0
1653553015147,CSE 208,A00,094858,Micciancio; Daniele,0,0,0,0
1653553015682,CSE 210,A00,090113,Powell; Thomas Allan,0,0,0,0
1653553016206,CSE 219,A00,090898,Staff,0,0,0,0
1653553016734,CSE 221,A00,090114,Zhou; Yuan-Yuan,0,0,0,0
1653553017256,CSE 229A,A00,090115,Porter; George M,0,0,0,0
1653553017779,CSE 229C,A00,090116,Savage; Stefan,0,0,0,0
1653553018310,CSE 230,A00,090117,Jhala; Ranjit,0,0,0,0
1653553018833,CSE 232,A00,090118,Papakonstantinou; Yannis,0,0,0,0
1653553019366,CSE 239A,A00,090121,Kumar; Arun Kumar,0,0,0,0
1653553019894,CSE 239B,A00,090122,Jhala; Ranjit,0,0,0,0
1653553020417,CSE 240A,A00,090123,Zhao; Jishen,0,0,189,189
1653553020945,CSE 243A,A00,090124,Orailoglu; Alex,0,0,15,15
1653553021473,CSE 249B,A00,090125,Kahng; Andrew Byun,13,0,20,7
1653553021998,CSE 250A,A00,090126,Berg-Kirkpatrick; Taylor D,0,0,0,0
1653553022523,CSE 252A,A00,090127,Ochoa; Benjamin Lawrence,0,0,0,0
1653553023063,CSE 258,A01,090129,McAuley; Julian John,0,0,0,0
1653553023587,CSE 258R,A01,090131,McAuley; Julian John,0,0,0,0
1653553024113,CSE 274,A00,090132,Ramamoorthi; Ravi,0,0,0,0
1653553024640,CSE 276A,A00,090133,Christensen; Henrik I,0,0,0,0
1653553025167,CSE 276C,A00,090134,Christensen; Henrik I,0,0,0,0
1653553025695,CSE 290,A00,090135,Bafna; Vineet,0,0,0,0
1653553025695,CSE 290,B00,090136,Ramamoorthi; Ravi,0,0,0,0
1653553025695,CSE 290,C00,090137,Li; Tzumao,8,0,10,2
1653553025695,CSE 290,D00,090138,Zhou; Yuan-Yuan,9,0,10,1
1653553025695,CSE 290,E00,090139,Christensen; Henrik I,8,0,10,2
1653553025695,CSE 290,F00,094053,Shalev; Aaron D,0,0,0,0
1653553026241,CSE 291,A00,090140,Munyaka; Imani N. S.,0,0,0,0
1653553026241,CSE 291,B00,094880,Yu; Qi,0,0,0,0
1653553026241,CSE 291,C00,090142,Pannuto; Patrick William,0,0,0,0
1653553026241,CSE 291,D00,094881,Zhang; Yiying,0,0,0,0
1653553026241,CSE 291,E00,095118,Su; Hao,0,0,0,0
1653553026830,CSE 293,001,094905,Bafna; Vineet,9999,0,9999,0
1653553026830,CSE 293,002,094906,Bellare; Mihir,9999,0,9999,0
1653553026830,CSE 293,003,094907,Berg-Kirkpatrick; Taylor D,9999,0,9999,0
1653553026830,CSE 293,004,094908,Christensen; Henrik I,9999,0,9999,0
1653553026830,CSE 293,005,094909,Cottrell; Garrison W,9999,0,9999,0
1653553026830,CSE 293,006,094910,Deutsch; Alin Bernard,9999,0,9999,0
1653553026830,CSE 293,007,094911,Esmaeilzadeh; Hadi,9999,0,9999,0
1653553026830,CSE 293,008,094912,Freund; Yoav,9999,0,9999,0
1653553026830,CSE 293,009,094913,Griswold; William G.,9999,0,9999,0
1653553026830,CSE 293,010,094914,Gymrek; Melissa Ann,9999,0,9999,0
1653553026830,CSE 293,011,094915,Heninger; Nadia A,9999,0,9999,0
1653553026830,CSE 293,012,094916,Impagliazzo; Russell,9999,0,9999,0
1653553026830,CSE 293,013,094917,Jhala; Ranjit,9999,0,9999,0
1653553026830,CSE 293,014,094918,Kahng; Andrew Byun,9999,0,9999,0
1653553026830,CSE 293,015,094919,Kane; Daniel Mertz,9999,0,9999,0
1653553026830,CSE 293,016,094920,Kriegman; David J,9999,0,9999,0
1653553026830,CSE 293,017,094921,Kumar; Arun Kumar,9999,0,9999,0
1653553026830,CSE 293,018,094922,Lerner; Sorin,9999,0,9999,0
1653553026830,CSE 293,019,094923,Lovett; Shachar,9999,0,9999,0
1653553026830,CSE 293,020,094924,McAuley; Julian John,9999,0,9999,0
1653553026830,CSE 293,021,094925,Micciancio; Daniele,9999,0,9999,0
1653553026830,CSE 293,022,094926,Orailoglu; Alex,9999,0,9999,0
1653553026830,CSE 293,023,094927,Paturi; Ramamohan,9999,0,9999,0
1653553026830,CSE 293,024,094928,Polikarpova; Nadezhda,9999,0,9999,0
1653553026830,CSE 293,025,094929,Politz; Joseph Gibbs,9999,0,9999,0
1653553026830,CSE 293,026,094930,Porter; George M,9999,0,9999,0
1653553026830,CSE 293,027,094931,Porter; Leonard Emerson,9999,0,9999,0
1653553026830,CSE 293,028,094932,Ramamoorthi; Ravi,9999,0,9999,0
1653553026830,CSE 293,029,094933,Sahoo; Debashis,9999,0,9999,0
1653553026830,CSE 293,030,094934,Saul; Lawrence,9999,0,9999,0
1653553026830,CSE 293,031,094935,Savage; Stefan,9999,0,9999,0
1653553026830,CSE 293,032,094936,Schulze; Jurgen P.,9999,0,9999,0
1653553026830,CSE 293,033,094937,Snoeren; Alex C.,9999,0,9999,0
1653553026830,CSE 293,034,094938,Shang; Jingbo,9999,0,9999,0
1653553026830,CSE 293,035,094939,Stefan; Deian,9999,0,9999,0
1653553026830,CSE 293,036,094940,Su; Hao,9999,0,9999,0
1653553026830,CSE 293,037,094941,Swanson; Steven James,9999,0,9999,0
1653553026830,CSE 293,038,094942,Tullsen; Dean Michael,9999,0,9999,0
1653553026830,CSE 293,039,094943,Voelker; Geoffrey M.,9999,0,9999,0
1653553026830,CSE 293,040,094944,Zhao; Jishen,9999,0,9999,0
1653553026830,CSE 293,041,094945,Zhou; Yuan-Yuan,9999,0,9999,0
1653553026830,CSE 293,042,094946,Gao; Sicun,9998,0,9999,1
1653553026830,CSE 293,043,094947,Weibel; Nadir,9999,0,9999,0
1653553026830,CSE 293,044,094948,Gupta; Rajesh K.,9999,0,9999,0
1653553027365,CSE 294,A00,090143,Porter; George M,8,0,10,2
1653553027891,DSE 200,A00,091799,Staff,50,0,50,0
1653553028420,DSE 203,A00,091800,Gupta; Amarnath,30,0,30,0
1653553028947,DSE 250,A00,091801,Deutsch; Alin Bernard,30,0,30,0
1653553029476,DSE 290,A00,091802,Altintas De Callaf; Ilkay,50,0,50,0
1653553030027,ECE 200,001,091003,Antipa; Nicholas A,9999,0,9999,0
1653553030027,ECE 200,002,091004,Atanasov; Nikolay A.,9999,0,9999,0
1653553030027,ECE 200,003,091005,Bharadia; Dinesh,9999,0,9999,0
1653553030027,ECE 200,004,091006,Cheng; Chung Kuan,9999,0,9999,0
1653553030027,ECE 200,005,091007,Cosman; Pamela C.,9999,0,9999,0
1653553030027,ECE 200,006,091008,Staff,9999,0,9999,0
1653553030027,ECE 200,007,091009,Dayeh; Shadi Ahmad,9999,0,9999,0
1653553030027,ECE 200,008,091010,Fainman; Yeshaiahu,9999,0,9999,0
1653553030027,ECE 200,009,091011,Ford; Joseph Earl,9999,0,9999,0
1653553030027,ECE 200,010,091012,Franceschetti; Massimo,9999,0,9999,0
1653553030027,ECE 200,011,091013,Fullerton; Eric E,9999,0,9999,0
1653553030027,ECE 200,012,091014,Galton; Ian A,9999,0,9999,0
1653553030027,ECE 200,013,091015,Gilja; Vikash,9999,0,9999,0
1653553030027,ECE 200,014,091016,Hall; Drew A.,9999,0,9999,0
1653553030027,ECE 200,015,091017,Hsueh; Tzu-Chien,9999,0,9999,0
1653553030027,ECE 200,016,091018,Javidi; Tara,9999,0,9999,0
1653553030027,ECE 200,017,091019,Kahng; Andrew Byun,9999,0,9999,0
1653553030027,ECE 200,018,091020,Kim; Young-Han,9999,0,9999,0
1653553030027,ECE 200,019,091021,Koushanfar; Farinaz,9999,0,9999,0
1653553030027,ECE 200,020,091022,Kuzum; Duygu,9999,0,9999,0
1653553030027,ECE 200,021,091023,Le; Hanh-Phuc,9999,0,9999,0
1653553030027,ECE 200,022,091024,Lin; Bill,9999,0,9999,0
1653553030027,ECE 200,023,091025,Liu; Zhaowei,9999,0,9999,0
1653553030027,ECE 200,024,091026,Lo; Yu-Hwa,9999,0,9999,0
1653553030027,ECE 200,025,091027,Lomakin; Vitaliy,9999,0,9999,0
1653553030027,ECE 200,026,091028,Mercier; Patrick Philip,9999,0,9999,0
1653553030027,ECE 200,027,091029,Meyer; Florian,9999,0,9999,0
1653553030027,ECE 200,028,091030,Milstein; Laurence B.,9999,0,9999,0
1653553030027,ECE 200,029,091031,Mir Arabbaygi; Siavash,9999,0,9999,0
1653553030027,ECE 200,030,091032,Mookherjea; Shayan,9999,0,9999,0
1653553030027,ECE 200,031,091033,Morris; Karcher William,9999,0,9999,0
1653553030027,ECE 200,032,091034,Ng; Tse Nga,9999,0,9999,0
1653553030027,ECE 200,033,091035,Nguyen; Truong Quang,9999,0,9999,0
1653553030027,ECE 200,034,091036,Nomura; Kenji,9999,0,9999,0
1653553030027,ECE 200,035,091037,Orlitsky; Alon,9999,0,9999,0
1653553030027,ECE 200,036,091038,Pal; Piya,9999,0,9999,0
1653553030027,ECE 200,037,091039,Papen; George C.,9999,0,9999,0
1653553030027,ECE 200,038,091040,Radic; Stojan,9999,0,9999,0
1653553030027,ECE 200,039,091041,Rao; Bhaskar D.,9999,0,9999,0
1653553030027,ECE 200,040,091042,Rao; Ramesh R,9999,0,9999,0
1653553030027,ECE 200,041,091043,Rebeiz; Gabriel,9999,0,9999,0
1653553030027,ECE 200,042,091044,Sanford; John R,9999,0,9999,0
1653553030027,ECE 200,043,091045,Siegel; Paul H.,9999,0,9999,0
1653553030027,ECE 200,044,091046,Sievenpiper; Daniel F.,9999,0,9999,0
1653553030027,ECE 200,045,091047,Sworder; David D.,9999,0,9999,0
1653553030027,ECE 200,046,091048,Taur; Yuan,9999,0,9999,0
1653553030027,ECE 200,047,091049,Touri; Behrouz,9999,0,9999,0
1653553030027,ECE 200,048,091050,Trivedi; Mohan M.,9999,0,9999,0
1653553030027,ECE 200,049,091051,Vardy; Alexander,9999,0,9999,0
1653553030027,ECE 200,050,091052,Vasconcelos; Nuno,9999,0,9999,0
1653553030027,ECE 200,051,091053,Wang; Xiaolong,9999,0,9999,0
1653553030027,ECE 200,052,091054,Xie; Pengtao,9999,0,9999,0
1653553030027,ECE 200,053,091055,Yip; Michael,9999,0,9999,0
1653553030027,ECE 200,054,091056,Zeger; Kenneth A.,9999,0,9999,0
1653553030027,ECE 200,055,091057,Zhang; Xinyu,9999,0,9999,0
1653553030027,ECE 200,056,091058,Turakhia; Yatish Girish,9999,0,9999,0
1653553030027,ECE 200,057,091059,Kang; Mingu,9999,0,9999,0
1653553030027,ECE 200,058,091060,Shi; Yuanyuan,9999,0,9999,0
1653553030027,ECE 200,059,091061,Wang; Edward Jay,9999,0,9999,0
1653553030027,ECE 200,060,091062,Zheng; Yang,9999,0,9999,0
1653553030552,ECE 201,A00,095526,Lo; Yu-Hwa,0,0,0,0
1653553031081,ECE 203,A00,091065,Mercier; Patrick Philip,0,0,0,0
1653553031606,ECE 207A,A00,091605,Liu; Thomas Tao-Ming,0,0,0,0
1653553032134,ECE 212AN,A00,091068,Nomura; Kenji,0,0,0,0
1653553032670,ECE 222A,A00,091069,Rebeiz; Gabriel,0,0,0,0
1653553033197,ECE 225A,A00,091070,Orlitsky; Alon,0,0,0,0
1653553033720,ECE 230A,A00,091071,Nomura; Kenji,0,0,0,0
1653553034245,ECE 236A,A00,091072,Dayeh; Shadi Ahmad,0,0,0,0
1653553034785,ECE 238A,A00,091073,Luo; Jian,0,0,0,0
1653553034785,ECE 238A,B00,091074,Luo; Jian,0,0,0,0
1653553035410,ECE 240A,A00,091075,Radic; Stojan,0,0,0,0
1653553035938,ECE 247A,A00,091592,Shi; Lingyan,0,0,0,0
1653553036464,ECE 250,A00,091076,Touri; Behrouz,0,0,0,0
1653553036991,ECE 251C,A00,091078,Nguyen; Truong Quang,0,0,0,0
1653553037515,ECE 253,A00,091079,Cosman; Pamela C.,0,0,0,0
1653553038039,ECE 255A,A00,091080,Orlitsky; Alon,0,0,0,0
1653553038563,ECE 257A,A00,091081,Zhang; Xinyu,0,0,0,0
1653553039092,ECE 260A,A01,091084,Eldon; John,0,0,0,0
1653553039617,ECE 264C,A00,091085,Galton; Ian A,0,0,0,0
1653553040144,ECE 265C,A00,094889,Presti; Calogero Davide,0,0,0,9
1653553040667,ECE 266,A01,091087,Hall; Drew A.,0,0,0,0
1653553041718,ECE 271A,A00,091090,Vasconcelos; Nuno,0,0,0,0
1653553042242,ECE 272B,A00,091091,Sworder; David D.,0,0,0,0
1653553042769,ECE 275A,A00,091092,Meyer; Florian,0,0,0,0
1653553043313,ECE 277,A00,091093,An; Cheolhong,0,0,0,0
1653553043840,ECE 283,A00,091094,Le; Hanh-Phuc,0,0,0,0
1653553044367,ECE 284,A00,091095,Kang; Mingu,0,0,0,0
1653553044367,ECE 284,B00,091096,Wang; Edward Jay,0,0,0,0
1653553044899,ECE 285,A00,094334,Touri; Behrouz,0,0,0,0
1653553045424,ECE 289,A00,091097,Whelan; David Arthur,0,0,0,0
1653553045947,MATH 200A,A00,087414,Salehi Golsefidy; Alireza,7,0,8,1
1653553046479,MATH 202A,A00,087415,Gill; Philip E.,2,0,8,6
1653553047010,MATH 203A,A00,087416,Oprea; Dragos N.,6,0,8,2
1653553047537,MATH 204A,A00,087417,Kedlaya; Kiran S.,6,0,8,2
1653553048062,MATH 205,A00,087418,Sorensen; Claus M,6,0,8,2
1653553048589,MATH 206A,A00,087419,Izadi; Elham,7,0,8,1
1653553049112,MATH 207A,A00,087420,Mohammadi; Amir,5,0,8,3
1653553049635,MATH 208,A00,087421,Staff,9,0,10,1
1653553050159,MATH 209,A00,087422,Staff,10,0,10,0
1653553050684,MATH 218,A00,087423,Staff,10,0,10,0
1653553051209,MATH 220A,A00,087424,Novak; Jonathan I,6,0,8,2
1653553051747,MATH 231A,A00,087425,Bejenaru; Ioan,3,0,8,5
1653553052287,MATH 240A,A00,087426,Ebenfelt; Peter F,5,0,8,3
1653553052812,MATH 243,A00,087427,Staff,9,0,10,1
1653553053338,MATH 248,A00,087429,Staff,10,0,10,0
1653553053866,MATH 250A,A00,087430,Spolaor; Luca,4,0,8,4
1653553054390,MATH 257A,A00,087431,Spolaor; Luca,7,0,8,1
1653553054916,MATH 258,A00,087432,Staff,9,0,10,1
1653553055443,MATH 264A,A00,087433,Warnke; Lutz Peter,5,0,8,3
1653553055966,MATH 268,A00,087434,Staff,15,0,15,0
1653553056492,MATH 269,A00,087435,Staff,14,0,15,1
1653553057015,MATH 270A,A00,087436,Nie; Jiawang,0,0,8,8
1653553057538,MATH 272A,A00,087437,Tian; Xiaochuan,1,0,8,7
1653553058066,MATH 274,A01,087439,Cheng; Li-Tien,9,0,10,1
1653553058066,MATH 274,A02,087440,Cheng; Li-Tien,10,0,10,0
1653553058598,MATH 278A,A00,087441,Staff,8,0,10,2
1653553059123,MATH 278B,A00,087442,Staff,8,0,10,2
1653553059660,MATH 278C,A00,087443,Staff,8,0,10,2
1653553060201,MATH 280A,A00,087444,Zheng; Tianyi,0,0,8,8
1653553060724,MATH 281A,A00,087445,Bradic; Jelena,0,0,8,8
1653553061253,MATH 282A,A00,087446,Zhang; Danna,0,0,8,8
1653553061786,MATH 283,A00,087447,Tesler; Glenn,0,0,0,15
1653553062309,MATH 286,A00,087448,Kemp; Todd Aahron,5,0,8,3
1653553062836,MATH 287D,A00,087449,Bradic; Jelena,0,0,0,1
1653553063368,MATH 288,A00,087450,Staff,14,0,15,1
1653553063368,MATH 288,B00,087451,Staff,15,0,15,0
1653553063368,MATH 288,C00,087452,Staff,15,0,15,0
1653553063892,MATH 290A,A00,087453,Xu; Zhouli,6,0,8,2
1653553064421,MATH 291A,A00,087454,Xu; Zhouli,7,0,8,1
1653553064946,MATH 292,A00,087455,Staff,10,0,10,0
1653553065471,MATH 295,A00,087456,Staff,50,0,50,0
1653553065995,MATH 297,001,087457,Staff,998,0,999,1
1653553626903,COGS 200,A01,087991,Staff,47,0,50,3
1653553627427,COGS 201,A01,094504,Rangel; Lara M,17,0,25,8
1653553627955,COGS 203,A00,087992,Coulson; Seana M,18,0,20,2
1653553628487,COGS 210A,001,087993,Greene; Deanna Jacquelyn,9998,0,9999,1
1653553628487,COGS 210A,002,087994,Saygin; Ayse P,9999,0,9999,0
1653553628487,COGS 210A,003,087995,Xia; Haijun,9999,0,9999,0
1653553628487,COGS 210A,004,087996,Nitz; Douglas A.,9999,0,9999,0
1653553628487,COGS 210A,005,087997,Hollan; James D.,9999,0,9999,0
1653553628487,COGS 210A,006,087998,Deak; Gedeon O.,9998,0,9999,1
1653553628487,COGS 210A,007,087999,Rossano; Federico,9999,0,9999,0
1653553629020,COGS 211A,A00,088000,Coulson; Seana M,9997,0,9999,2
1653553629546,COGS 229,A00,088002,Staff,23,0,25,2
1653553630069,COGS 260,B00,094231,Staff,17,0,20,3
1653553630069,COGS 260,A00,088004,Nitz; Douglas A.,9998,0,9999,1
1653553630623,CSE 202,A00,090110,Paturi; Ramamohan,0,0,0,0
1653553630623,CSE 202,B00,090111,Paturi; Ramamohan,0,0,0,0
1653553631153,CSE 207B,A00,090112,Heninger; Nadia A,0,0,0,0
1653553631683,CSE 208,A00,094858,Micciancio; Daniele,0,0,0,0
1653553632206,CSE 210,A00,090113,Powell; Thomas Allan,0,0,0,0
1653553632730,CSE 219,A00,090898,Staff,0,0,0,0
1653553633259,CSE 221,A00,090114,Zhou; Yuan-Yuan,0,0,0,0
1653553633782,CSE 229A,A00,090115,Porter; George M,0,0,0,0
1653553634318,CSE 229C,A00,090116,Savage; Stefan,0,0,0,0
1653553634855,CSE 230,A00,090117,Jhala; Ranjit,0,0,0,0
1653553635391,CSE 232,A00,090118,Papakonstantinou; Yannis,0,0,0,0
1653553635923,CSE 239A,A00,090121,Kumar; Arun Kumar,0,0,0,0
1653553636447,CSE 239B,A00,090122,Jhala; Ranjit,0,0,0,0
1653553636982,CSE 240A,A00,090123,Zhao; Jishen,0,0,189,189
1653553637510,CSE 243A,A00,090124,Orailoglu; Alex,0,0,15,15
1653553638034,CSE 249B,A00,090125,Kahng; Andrew Byun,13,0,20,7
1653553638557,CSE 250A,A00,090126,Berg-Kirkpatrick; Taylor D,0,0,0,0
1653553639081,CSE 252A,A00,090127,Ochoa; Benjamin Lawrence,0,0,0,0
1653553639605,CSE 258,A01,090129,McAuley; Julian John,0,0,0,0
1653553640129,CSE 258R,A01,090131,McAuley; Julian John,0,0,0,0
1653553640655,CSE 274,A00,090132,Ramamoorthi; Ravi,0,0,0,0
1653553641180,CSE 276A,A00,090133,Christensen; Henrik I,0,0,0,0
1653553641705,CSE 276C,A00,090134,Christensen; Henrik I,0,0,0,0
1653553642231,CSE 290,A00,090135,Bafna; Vineet,0,0,0,0
1653553642231,CSE 290,B00,090136,Ramamoorthi; Ravi,0,0,0,0
1653553642231,CSE 290,C00,090137,Li; Tzumao,8,0,10,2
1653553642231,CSE 290,D00,090138,Zhou; Yuan-Yuan,9,0,10,1
1653553642231,CSE 290,E00,090139,Christensen; Henrik I,8,0,10,2
1653553642231,CSE 290,F00,094053,Shalev; Aaron D,0,0,0,0
1653553642769,CSE 291,A00,090140,Munyaka; Imani N. S.,0,0,0,0
1653553642769,CSE 291,B00,094880,Yu; Qi,0,0,0,0
1653553642769,CSE 291,C00,090142,Pannuto; Patrick William,0,0,0,0
1653553642769,CSE 291,D00,094881,Zhang; Yiying,0,0,0,0
1653553642769,CSE 291,E00,095118,Su; Hao,0,0,0,0
1653553643312,CSE 293,001,094905,Bafna; Vineet,9999,0,9999,0
1653553643312,CSE 293,002,094906,Bellare; Mihir,9999,0,9999,0
1653553643312,CSE 293,003,094907,Berg-Kirkpatrick; Taylor D,9999,0,9999,0
1653553643312,CSE 293,004,094908,Christensen; Henrik I,9999,0,9999,0
1653553643312,CSE 293,005,094909,Cottrell; Garrison W,9999,0,9999,0
1653553643312,CSE 293,006,094910,Deutsch; Alin Bernard,9999,0,9999,0
1653553643312,CSE 293,007,094911,Esmaeilzadeh; Hadi,9999,0,9999,0
1653553643312,CSE 293,008,094912,Freund; Yoav,9999,0,9999,0
1653553643312,CSE 293,009,094913,Griswold; William G.,9999,0,9999,0
1653553643312,CSE 293,010,094914,Gymrek; Melissa Ann,9999,0,9999,0
1653553643312,CSE 293,011,094915,Heninger; Nadia A,9999,0,9999,0
1653553643312,CSE 293,012,094916,Impagliazzo; Russell,9999,0,9999,0
1653553643312,CSE 293,013,094917,Jhala; Ranjit,9999,0,9999,0
1653553643312,CSE 293,014,094918,Kahng; Andrew Byun,9999,0,9999,0
1653553643312,CSE 293,015,094919,Kane; Daniel Mertz,9999,0,9999,0
1653553643312,CSE 293,016,094920,Kriegman; David J,9999,0,9999,0
1653553643312,CSE 293,017,094921,Kumar; Arun Kumar,9999,0,9999,0
1653553643312,CSE 293,018,094922,Lerner; Sorin,9999,0,9999,0
1653553643312,CSE 293,019,094923,Lovett; Shachar,9999,0,9999,0
1653553643312,CSE 293,020,094924,McAuley; Julian John,9999,0,9999,0
1653553643312,CSE 293,021,094925,Micciancio; Daniele,9999,0,9999,0
1653553643312,CSE 293,022,094926,Orailoglu; Alex,9999,0,9999,0
1653553643312,CSE 293,023,094927,Paturi; Ramamohan,9999,0,9999,0
1653553643312,CSE 293,024,094928,Polikarpova; Nadezhda,9999,0,9999,0
1653553643312,CSE 293,025,094929,Politz; Joseph Gibbs,9999,0,9999,0
1653553643312,CSE 293,026,094930,Porter; George M,9999,0,9999,0
1653553643312,CSE 293,027,094931,Porter; Leonard Emerson,9999,0,9999,0
1653553643312,CSE 293,028,094932,Ramamoorthi; Ravi,9999,0,9999,0
1653553643312,CSE 293,029,094933,Sahoo; Debashis,9999,0,9999,0
1653553643312,CSE 293,030,094934,Saul; Lawrence,9999,0,9999,0
1653553643312,CSE 293,031,094935,Savage; Stefan,9999,0,9999,0
1653553643312,CSE 293,032,094936,Schulze; Jurgen P.,9999,0,9999,0
1653553643312,CSE 293,033,094937,Snoeren; Alex C.,9999,0,9999,0
1653553643312,CSE 293,034,094938,Shang; Jingbo,9999,0,9999,0
1653553643312,CSE 293,035,094939,Stefan; Deian,9999,0,9999,0
1653553643312,CSE 293,036,094940,Su; Hao,9999,0,9999,0
1653553643312,CSE 293,037,094941,Swanson; Steven James,9999,0,9999,0
1653553643312,CSE 293,038,094942,Tullsen; Dean Michael,9999,0,9999,0
1653553643312,CSE 293,039,094943,Voelker; Geoffrey M.,9999,0,9999,0
1653553643312,CSE 293,040,094944,Zhao; Jishen,9999,0,9999,0
1653553643312,CSE 293,041,094945,Zhou; Yuan-Yuan,9999,0,9999,0
1653553643312,CSE 293,042,094946,Gao; Sicun,9998,0,9999,1
1653553643312,CSE 293,043,094947,Weibel; Nadir,9999,0,9999,0
1653553643312,CSE 293,044,094948,Gupta; Rajesh K.,9999,0,9999,0
1653553643835,CSE 294,A00,090143,Porter; George M,8,0,10,2
1653553644357,DSE 200,A00,091799,Staff,50,0,50,0
1653553644883,DSE 203,A00,091800,Gupta; Amarnath,30,0,30,0
1653553645411,DSE 250,A00,091801,Deutsch; Alin Bernard,30,0,30,0
1653553645938,DSE 290,A00,091802,Altintas De Callaf; Ilkay,50,0,50,0
1653553646514,ECE 200,001,091003,Antipa; Nicholas A,9999,0,9999,0
1653553646514,ECE 200,002,091004,Atanasov; Nikolay A.,9999,0,9999,0
1653553646514,ECE 200,003,091005,Bharadia; Dinesh,9999,0,9999,0
1653553646514,ECE 200,004,091006,Cheng; Chung Kuan,9999,0,9999,0
1653553646514,ECE 200,005,091007,Cosman; Pamela C.,9999,0,9999,0
1653553646514,ECE 200,006,091008,Staff,9999,0,9999,0
1653553646514,ECE 200,007,091009,Dayeh; Shadi Ahmad,9999,0,9999,0
1653553646514,ECE 200,008,091010,Fainman; Yeshaiahu,9999,0,9999,0
1653553646514,ECE 200,009,091011,Ford; Joseph Earl,9999,0,9999,0
1653553646514,ECE 200,010,091012,Franceschetti; Massimo,9999,0,9999,0
1653553646514,ECE 200,011,091013,Fullerton; Eric E,9999,0,9999,0
1653553646514,ECE 200,012,091014,Galton; Ian A,9999,0,9999,0
1653553646514,ECE 200,013,091015,Gilja; Vikash,9999,0,9999,0
1653553646514,ECE 200,014,091016,Hall; Drew A.,9999,0,9999,0
1653553646514,ECE 200,015,091017,Hsueh; Tzu-Chien,9999,0,9999,0
1653553646514,ECE 200,016,091018,Javidi; Tara,9999,0,9999,0
1653553646514,ECE 200,017,091019,Kahng; Andrew Byun,9999,0,9999,0
1653553646514,ECE 200,018,091020,Kim; Young-Han,9999,0,9999,0
1653553646514,ECE 200,019,091021,Koushanfar; Farinaz,9999,0,9999,0
1653553646514,ECE 200,020,091022,Kuzum; Duygu,9999,0,9999,0
1653553646514,ECE 200,021,091023,Le; Hanh-Phuc,9999,0,9999,0
1653553646514,ECE 200,022,091024,Lin; Bill,9999,0,9999,0
1653553646514,ECE 200,023,091025,Liu; Zhaowei,9999,0,9999,0
1653553646514,ECE 200,024,091026,Lo; Yu-Hwa,9999,0,9999,0
1653553646514,ECE 200,025,091027,Lomakin; Vitaliy,9999,0,9999,0
1653553646514,ECE 200,026,091028,Mercier; Patrick Philip,9999,0,9999,0
1653553646514,ECE 200,027,091029,Meyer; Florian,9999,0,9999,0
1653553646514,ECE 200,028,091030,Milstein; Laurence B.,9999,0,9999,0
1653553646514,ECE 200,029,091031,Mir Arabbaygi; Siavash,9999,0,9999,0
1653553646514,ECE 200,030,091032,Mookherjea; Shayan,9999,0,9999,0
1653553646514,ECE 200,031,091033,Morris; Karcher William,9999,0,9999,0
1653553646514,ECE 200,032,091034,Ng; Tse Nga,9999,0,9999,0
1653553646514,ECE 200,033,091035,Nguyen; Truong Quang,9999,0,9999,0
1653553646514,ECE 200,034,091036,Nomura; Kenji,9999,0,9999,0
1653553646514,ECE 200,035,091037,Orlitsky; Alon,9999,0,9999,0
1653553646514,ECE 200,036,091038,Pal; Piya,9999,0,9999,0
1653553646514,ECE 200,037,091039,Papen; George C.,9999,0,9999,0
1653553646514,ECE 200,038,091040,Radic; Stojan,9999,0,9999,0
1653553646514,ECE 200,039,091041,Rao; Bhaskar D.,9999,0,9999,0
1653553646514,ECE 200,040,091042,Rao; Ramesh R,9999,0,9999,0
1653553646514,ECE 200,041,091043,Rebeiz; Gabriel,9999,0,9999,0
1653553646514,ECE 200,042,091044,Sanford; John R,9999,0,9999,0
1653553646514,ECE 200,043,091045,Siegel; Paul H.,9999,0,9999,0
1653553646514,ECE 200,044,091046,Sievenpiper; Daniel F.,9999,0,9999,0
1653553646514,ECE 200,045,091047,Sworder; David D.,9999,0,9999,0
1653553646514,ECE 200,046,091048,Taur; Yuan,9999,0,9999,0
1653553646514,ECE 200,047,091049,Touri; Behrouz,9999,0,9999,0
1653553646514,ECE 200,048,091050,Trivedi; Mohan M.,9999,0,9999,0
1653553646514,ECE 200,049,091051,Vardy; Alexander,9999,0,9999,0
1653553646514,ECE 200,050,091052,Vasconcelos; Nuno,9999,0,9999,0
1653553646514,ECE 200,051,091053,Wang; Xiaolong,9999,0,9999,0
1653553646514,ECE 200,052,091054,Xie; Pengtao,9999,0,9999,0
1653553646514,ECE 200,053,091055,Yip; Michael,9999,0,9999,0
1653553646514,ECE 200,054,091056,Zeger; Kenneth A.,9999,0,9999,0
1653553646514,ECE 200,055,091057,Zhang; Xinyu,9999,0,9999,0
1653553646514,ECE 200,056,091058,Turakhia; Yatish Girish,9999,0,9999,0
1653553646514,ECE 200,057,091059,Kang; Mingu,9999,0,9999,0
1653553646514,ECE 200,058,091060,Shi; Yuanyuan,9999,0,9999,0
1653553646514,ECE 200,059,091061,Wang; Edward Jay,9999,0,9999,0
1653553646514,ECE 200,060,091062,Zheng; Yang,9999,0,9999,0
1653553647036,ECE 201,A00,095526,Lo; Yu-Hwa,0,0,0,0
1653553647560,ECE 203,A00,091065,Mercier; Patrick Philip,0,0,0,0
1653553648086,ECE 207A,A00,091605,Liu; Thomas Tao-Ming,0,0,0,0
1653553648613,ECE 212AN,A00,091068,Nomura; Kenji,0,0,0,0
1653553649135,ECE 222A,A00,091069,Rebeiz; Gabriel,0,0,0,0
1653553649659,ECE 225A,A00,091070,Orlitsky; Alon,0,0,0,0
1653553650180,ECE 230A,A00,091071,Nomura; Kenji,0,0,0,0
1653553650703,ECE 236A,A00,091072,Dayeh; Shadi Ahmad,0,0,0,0
1653553651231,ECE 238A,A00,091073,Luo; Jian,0,0,0,0
1653553651231,ECE 238A,B00,091074,Luo; Jian,0,0,0,0
1653553651755,ECE 240A,A00,091075,Radic; Stojan,0,0,0,0
1653553652285,ECE 247A,A00,091592,Shi; Lingyan,0,0,0,0
1653553652811,ECE 250,A00,091076,Touri; Behrouz,0,0,0,0
1653553653334,ECE 251C,A00,091078,Nguyen; Truong Quang,0,0,0,0
1653553653860,ECE 253,A00,091079,Cosman; Pamela C.,0,0,0,0
1653553654385,ECE 255A,A00,091080,Orlitsky; Alon,0,0,0,0
1653553654909,ECE 257A,A00,091081,Zhang; Xinyu,0,0,0,0
1653553655432,ECE 260A,A01,091084,Eldon; John,0,0,0,0
1653553655959,ECE 264C,A00,091085,Galton; Ian A,0,0,0,0
1653553656483,ECE 265C,A00,094889,Presti; Calogero Davide,0,0,0,9
1653553657006,ECE 266,A01,091087,Hall; Drew A.,0,0,0,0
1653553658052,ECE 271A,A00,091090,Vasconcelos; Nuno,0,0,0,0
1653553658575,ECE 272B,A00,091091,Sworder; David D.,0,0,0,0
1653553659100,ECE 275A,A00,091092,Meyer; Florian,0,0,0,0
1653553659625,ECE 277,A00,091093,An; Cheolhong,0,0,0,0
1653553660151,ECE 283,A00,091094,Le; Hanh-Phuc,0,0,0,0
1653553660686,ECE 284,A00,091095,Kang; Mingu,0,0,0,0
1653553660686,ECE 284,B00,091096,Wang; Edward Jay,0,0,0,0
1653553661209,ECE 285,A00,094334,Touri; Behrouz,0,0,0,0
1653553661733,ECE 289,A00,091097,Whelan; David Arthur,0,0,0,0
1653553662259,MATH 200A,A00,087414,Salehi Golsefidy; Alireza,7,0,8,1
1653553662786,MATH 202A,A00,087415,Gill; Philip E.,2,0,8,6
1653553663310,MATH 203A,A00,087416,Oprea; Dragos N.,6,0,8,2
1653553663836,MATH 204A,A00,087417,Kedlaya; Kiran S.,6,0,8,2
1653553664362,MATH 205,A00,087418,Sorensen; Claus M,6,0,8,2
1653553664888,MATH 206A,A00,087419,Izadi; Elham,7,0,8,1
1653553665411,MATH 207A,A00,087420,Mohammadi; Amir,5,0,8,3
1653553665940,MATH 208,A00,087421,Staff,9,0,10,1
1653553666463,MATH 209,A00,087422,Staff,10,0,10,0
1653553666986,MATH 218,A00,087423,Staff,10,0,10,0
1653553667518,MATH 220A,A00,087424,Novak; Jonathan I,6,0,8,2
1653553668045,MATH 231A,A00,087425,Bejenaru; Ioan,3,0,8,5
1653553668570,MATH 240A,A00,087426,Ebenfelt; Peter F,5,0,8,3
1653553669092,MATH 243,A00,087427,Staff,9,0,10,1
1653553669616,MATH 248,A00,087429,Staff,10,0,10,0
1653553670139,MATH 250A,A00,087430,Spolaor; Luca,4,0,8,4
1653553670662,MATH 257A,A00,087431,Spolaor; Luca,7,0,8,1
1653553671188,MATH 258,A00,087432,Staff,9,0,10,1
1653553671716,MATH 264A,A00,087433,Warnke; Lutz Peter,5,0,8,3
1653553672238,MATH 268,A00,087434,Staff,15,0,15,0
1653553672764,MATH 269,A00,087435,Staff,14,0,15,1
1653553673286,MATH 270A,A00,087436,Nie; Jiawang,0,0,8,8
1653553673808,MATH 272A,A00,087437,Tian; Xiaochuan,1,0,8,7
1653553674357,MATH 274,A01,087439,Cheng; Li-Tien,9,0,10,1
1653553674357,MATH 274,A02,087440,Cheng; Li-Tien,10,0,10,0
1653553674881,MATH 278A,A00,087441,Staff,8,0,10,2
1653553675407,MATH 278B,A00,087442,Staff,8,0,10,2
1653553675930,MATH 278C,A00,087443,Staff,8,0,10,2
1653553676453,MATH 280A,A00,087444,Zheng; Tianyi,0,0,8,8
1653553677064,MATH 281A,A00,087445,Bradic; Jelena,0,0,8,8
1653553677596,MATH 282A,A00,087446,Zhang; Danna,0,0,8,8
1653553678119,MATH 283,A00,087447,Tesler; Glenn,0,0,0,15
1653553678652,MATH 286,A00,087448,Kemp; Todd Aahron,5,0,8,3
1653553679174,MATH 287D,A00,087449,Bradic; Jelena,0,0,0,1
1653553679696,MATH 288,A00,087450,Staff,14,0,15,1
1653553679696,MATH 288,B00,087451,Staff,15,0,15,0
1653553679696,MATH 288,C00,087452,Staff,15,0,15,0
1653553680230,MATH 290A,A00,087453,Xu; Zhouli,6,0,8,2
1653553680761,MATH 291A,A00,087454,Xu; Zhouli,7,0,8,1
1653553681286,MATH 292,A00,087455,Staff,10,0,10,0
1653553681807,MATH 295,A00,087456,Staff,50,0,50,0
1653553682332,MATH 297,001,087457,Staff,998,0,999,1
1653554242645,COGS 200,A01,087991,Staff,47,0,50,3
1653554243168,COGS 201,A01,094504,Rangel; Lara M,17,0,25,8
1653554243695,COGS 203,A00,087992,Coulson; Seana M,18,0,20,2
1653554244225,COGS 210A,001,087993,Greene; Deanna Jacquelyn,9998,0,9999,1
1653554244225,COGS 210A,002,087994,Saygin; Ayse P,9999,0,9999,0
1653554244225,COGS 210A,003,087995,Xia; Haijun,9999,0,9999,0
1653554244225,COGS 210A,004,087996,Nitz; Douglas A.,9999,0,9999,0
1653554244225,COGS 210A,005,087997,Hollan; James D.,9999,0,9999,0
1653554244225,COGS 210A,006,087998,Deak; Gedeon O.,9998,0,9999,1
1653554244225,COGS 210A,007,087999,Rossano; Federico,9999,0,9999,0
1653554244747,COGS 211A,A00,088000,Coulson; Seana M,9997,0,9999,2
1653554245273,COGS 229,A00,088002,Staff,23,0,25,2
1653554245796,COGS 260,B00,094231,Staff,17,0,20,3
1653554245796,COGS 260,A00,088004,Nitz; Douglas A.,9998,0,9999,1
1653554246319,CSE 202,A00,090110,Paturi; Ramamohan,0,0,0,0
1653554246319,CSE 202,B00,090111,Paturi; Ramamohan,0,0,0,0
1653554246845,CSE 207B,A00,090112,Heninger; Nadia A,0,0,0,0
1653554247372,CSE 208,A00,094858,Micciancio; Daniele,0,0,0,0
1653554247903,CSE 210,A00,090113,Powell; Thomas Allan,0,0,0,0
1653554248429,CSE 219,A00,090898,Staff,0,0,0,0
1653554248952,CSE 221,A00,090114,Zhou; Yuan-Yuan,0,0,0,0
1653554249475,CSE 229A,A00,090115,Porter; George M,0,0,0,0
1653554249999,CSE 229C,A00,090116,Savage; Stefan,0,0,0,0
1653554250522,CSE 230,A00,090117,Jhala; Ranjit,0,0,0,0
1653554251054,CSE 232,A00,090118,Papakonstantinou; Yannis,0,0,0,0
1653554251577,CSE 239A,A00,090121,Kumar; Arun Kumar,0,0,0,0
1653554252099,CSE 239B,A00,090122,Jhala; Ranjit,0,0,0,0
1653554252627,CSE 240A,A00,090123,Zhao; Jishen,0,0,189,189
1653554253153,CSE 243A,A00,090124,Orailoglu; Alex,0,0,15,15
1653554253676,CSE 249B,A00,090125,Kahng; Andrew Byun,13,0,20,7
1653554254199,CSE 250A,A00,090126,Berg-Kirkpatrick; Taylor D,0,0,0,0
1653554254726,CSE 252A,A00,090127,Ochoa; Benjamin Lawrence,0,0,0,0
1653554255249,CSE 258,A01,090129,McAuley; Julian John,0,0,0,0
1653554255774,CSE 258R,A01,090131,McAuley; Julian John,0,0,0,0
1653554256298,CSE 274,A00,090132,Ramamoorthi; Ravi,0,0,0,0
1653554256824,CSE 276A,A00,090133,Christensen; Henrik I,0,0,0,0
1653554257346,CSE 276C,A00,090134,Christensen; Henrik I,0,0,0,0
1653554257871,CSE 290,A00,090135,Bafna; Vineet,0,0,0,0
1653554257871,CSE 290,B00,090136,Ramamoorthi; Ravi,0,0,0,0
1653554257871,CSE 290,C00,090137,Li; Tzumao,8,0,10,2
1653554257871,CSE 290,D00,090138,Zhou; Yuan-Yuan,9,0,10,1
1653554257871,CSE 290,E00,090139,Christensen; Henrik I,8,0,10,2
1653554257871,CSE 290,F00,094053,Shalev; Aaron D,0,0,0,0
1653554258401,CSE 291,A00,090140,Munyaka; Imani N. S.,0,0,0,0
1653554258401,CSE 291,B00,094880,Yu; Qi,0,0,0,0
1653554258401,CSE 291,C00,090142,Pannuto; Patrick William,0,0,0,0
1653554258401,CSE 291,D00,094881,Zhang; Yiying,0,0,0,0
1653554258401,CSE 291,E00,095118,Su; Hao,0,0,0,0
1653554258952,CSE 293,001,094905,Bafna; Vineet,9999,0,9999,0
1653554258952,CSE 293,002,094906,Bellare; Mihir,9999,0,9999,0
1653554258952,CSE 293,003,094907,Berg-Kirkpatrick; Taylor D,9999,0,9999,0
1653554258952,CSE 293,004,094908,Christensen; Henrik I,9999,0,9999,0
1653554258952,CSE 293,005,094909,Cottrell; Garrison W,9999,0,9999,0
1653554258952,CSE 293,006,094910,Deutsch; Alin Bernard,9999,0,9999,0
1653554258952,CSE 293,007,094911,Esmaeilzadeh; Hadi,9999,0,9999,0
1653554258952,CSE 293,008,094912,Freund; Yoav,9999,0,9999,0
1653554258952,CSE 293,009,094913,Griswold; William G.,9999,0,9999,0
1653554258952,CSE 293,010,094914,Gymrek; Melissa Ann,9999,0,9999,0
1653554258952,CSE 293,011,094915,Heninger; Nadia A,9999,0,9999,0
1653554258952,CSE 293,012,094916,Impagliazzo; Russell,9999,0,9999,0
1653554258952,CSE 293,013,094917,Jhala; Ranjit,9999,0,9999,0
1653554258952,CSE 293,014,094918,Kahng; Andrew Byun,9999,0,9999,0
1653554258952,CSE 293,015,094919,Kane; Daniel Mertz,9999,0,9999,0
1653554258952,CSE 293,016,094920,Kriegman; David J,9999,0,9999,0
1653554258952,CSE 293,017,094921,Kumar; Arun Kumar,9999,0,9999,0
1653554258952,CSE 293,018,094922,Lerner; Sorin,9999,0,9999,0
1653554258952,CSE 293,019,094923,Lovett; Shachar,9999,0,9999,0
1653554258952,CSE 293,020,094924,McAuley; Julian John,9999,0,9999,0
1653554258952,CSE 293,021,094925,Micciancio; Daniele,9999,0,9999,0
1653554258952,CSE 293,022,094926,Orailoglu; Alex,9999,0,9999,0
1653554258952,CSE 293,023,094927,Paturi; Ramamohan,9999,0,9999,0
1653554258952,CSE 293,024,094928,Polikarpova; Nadezhda,9999,0,9999,0
1653554258952,CSE 293,025,094929,Politz; Joseph Gibbs,9999,0,9999,0
1653554258952,CSE 293,026,094930,Porter; George M,9999,0,9999,0
1653554258952,CSE 293,027,094931,Porter; Leonard Emerson,9999,0,9999,0
1653554258952,CSE 293,028,094932,Ramamoorthi; Ravi,9999,0,9999,0
1653554258952,CSE 293,029,094933,Sahoo; Debashis,9999,0,9999,0
1653554258952,CSE 293,030,094934,Saul; Lawrence,9999,0,9999,0
1653554258952,CSE 293,031,094935,Savage; Stefan,9999,0,9999,0
1653554258952,CSE 293,032,094936,Schulze; Jurgen P.,9999,0,9999,0
1653554258952,CSE 293,033,094937,Snoeren; Alex C.,9999,0,9999,0
1653554258952,CSE 293,034,094938,Shang; Jingbo,9999,0,9999,0
1653554258952,CSE 293,035,094939,Stefan; Deian,9999,0,9999,0
1653554258952,CSE 293,036,094940,Su; Hao,9999,0,9999,0
1653554258952,CSE 293,037,094941,Swanson; Steven James,9999,0,9999,0
1653554258952,CSE 293,038,094942,Tullsen; Dean Michael,9999,0,9999,0
1653554258952,CSE 293,039,094943,Voelker; Geoffrey M.,9999,0,9999,0
1653554258952,CSE 293,040,094944,Zhao; Jishen,9999,0,9999,0
1653554258952,CSE 293,041,094945,Zhou; Yuan-Yuan,9999,0,9999,0
1653554258952,CSE 293,042,094946,Gao; Sicun,9998,0,9999,1
1653554258952,CSE 293,043,094947,Weibel; Nadir,9999,0,9999,0
1653554258952,CSE 293,044,094948,Gupta; Rajesh K.,9999,0,9999,0
1653554259482,CSE 294,A00,090143,Porter; George M,8,0,10,2
1653554260007,DSE 200,A00,091799,Staff,50,0,50,0
1653554260533,DSE 203,A00,091800,Gupta; Amarnath,30,0,30,0
1653554261055,DSE 250,A00,091801,Deutsch; Alin Bernard,30,0,30,0
1653554261580,DSE 290,A00,091802,Altintas De Callaf; Ilkay,50,0,50,0
1653554262169,ECE 200,001,091003,Antipa; Nicholas A,9999,0,9999,0
1653554262169,ECE 200,002,091004,Atanasov; Nikolay A.,9999,0,9999,0
1653554262169,ECE 200,003,091005,Bharadia; Dinesh,9999,0,9999,0
1653554262169,ECE 200,004,091006,Cheng; Chung Kuan,9999,0,9999,0
1653554262169,ECE 200,005,091007,Cosman; Pamela C.,9999,0,9999,0
1653554262169,ECE 200,006,091008,Staff,9999,0,9999,0
1653554262169,ECE 200,007,091009,Dayeh; Shadi Ahmad,9999,0,9999,0
1653554262169,ECE 200,008,091010,Fainman; Yeshaiahu,9999,0,9999,0
1653554262169,ECE 200,009,091011,Ford; Joseph Earl,9999,0,9999,0
1653554262169,ECE 200,010,091012,Franceschetti; Massimo,9999,0,9999,0
1653554262169,ECE 200,011,091013,Fullerton; Eric E,9999,0,9999,0
1653554262169,ECE 200,012,091014,Galton; Ian A,9999,0,9999,0
1653554262169,ECE 200,013,091015,Gilja; Vikash,9999,0,9999,0
1653554262169,ECE 200,014,091016,Hall; Drew A.,9999,0,9999,0
1653554262169,ECE 200,015,091017,Hsueh; Tzu-Chien,9999,0,9999,0
1653554262169,ECE 200,016,091018,Javidi; Tara,9999,0,9999,0
1653554262169,ECE 200,017,091019,Kahng; Andrew Byun,9999,0,9999,0
1653554262169,ECE 200,018,091020,Kim; Young-Han,9999,0,9999,0
1653554262169,ECE 200,019,091021,Koushanfar; Farinaz,9999,0,9999,0
1653554262169,ECE 200,020,091022,Kuzum; Duygu,9999,0,9999,0
1653554262169,ECE 200,021,091023,Le; Hanh-Phuc,9999,0,9999,0
1653554262169,ECE 200,022,091024,Lin; Bill,9999,0,9999,0
1653554262169,ECE 200,023,091025,Liu; Zhaowei,9999,0,9999,0
1653554262169,ECE 200,024,091026,Lo; Yu-Hwa,9999,0,9999,0
1653554262169,ECE 200,025,091027,Lomakin; Vitaliy,9999,0,9999,0
1653554262169,ECE 200,026,091028,Mercier; Patrick Philip,9999,0,9999,0
1653554262169,ECE 200,027,091029,Meyer; Florian,9999,0,9999,0
1653554262169,ECE 200,028,091030,Milstein; Laurence B.,9999,0,9999,0
1653554262169,ECE 200,029,091031,Mir Arabbaygi; Siavash,9999,0,9999,0
1653554262169,ECE 200,030,091032,Mookherjea; Shayan,9999,0,9999,0
1653554262169,ECE 200,031,091033,Morris; Karcher William,9999,0,9999,0
1653554262169,ECE 200,032,091034,Ng; Tse Nga,9999,0,9999,0
1653554262169,ECE 200,033,091035,Nguyen; Truong Quang,9999,0,9999,0
1653554262169,ECE 200,034,091036,Nomura; Kenji,9999,0,9999,0
1653554262169,ECE 200,035,091037,Orlitsky; Alon,9999,0,9999,0
1653554262169,ECE 200,036,091038,Pal; Piya,9999,0,9999,0
1653554262169,ECE 200,037,091039,Papen; George C.,9999,0,9999,0
1653554262169,ECE 200,038,091040,Radic; Stojan,9999,0,9999,0
1653554262169,ECE 200,039,091041,Rao; Bhaskar D.,9999,0,9999,0
1653554262169,ECE 200,040,091042,Rao; Ramesh R,9999,0,9999,0
1653554262169,ECE 200,041,091043,Rebeiz; Gabriel,9999,0,9999,0
1653554262169,ECE 200,042,091044,Sanford; John R,9999,0,9999,0
1653554262169,ECE 200,043,091045,Siegel; Paul H.,9999,0,9999,0
1653554262169,ECE 200,044,091046,Sievenpiper; Daniel F.,9999,0,9999,0
1653554262169,ECE 200,045,091047,Sworder; David D.,9999,0,9999,0
1653554262169,ECE 200,046,091048,Taur; Yuan,9999,0,9999,0
1653554262169,ECE 200,047,091049,Touri; Behrouz,9999,0,9999,0
1653554262169,ECE 200,048,091050,Trivedi; Mohan M.,9999,0,9999,0
1653554262169,ECE 200,049,091051,Vardy; Alexander,9999,0,9999,0
1653554262169,ECE 200,050,091052,Vasconcelos; Nuno,9999,0,9999,0
1653554262169,ECE 200,051,091053,Wang; Xiaolong,9999,0,9999,0
1653554262169,ECE 200,052,091054,Xie; Pengtao,9999,0,9999,0
1653554262169,ECE 200,053,091055,Yip; Michael,9999,0,9999,0
1653554262169,ECE 200,054,091056,Zeger; Kenneth A.,9999,0,9999,0
1653554262169,ECE 200,055,091057,Zhang; Xinyu,9999,0,9999,0
1653554262169,ECE 200,056,091058,Turakhia; Yatish Girish,9999,0,9999,0
1653554262169,ECE 200,057,091059,Kang; Mingu,9999,0,9999,0
1653554262169,ECE 200,058,091060,Shi; Yuanyuan,9999,0,9999,0
1653554262169,ECE 200,059,091061,Wang; Edward Jay,9999,0,9999,0
1653554262169,ECE 200,060,091062,Zheng; Yang,9999,0,9999,0
1653554262693,ECE 201,A00,095526,Lo; Yu-Hwa,0,0,0,0
1653554263216,ECE 203,A00,091065,Mercier; Patrick Philip,0,0,0,0
1653554263740,ECE 207A,A00,091605,Liu; Thomas Tao-Ming,0,0,0,0
1653554264265,ECE 212AN,A00,091068,Nomura; Kenji,0,0,0,0
1653554264859,ECE 222A,A00,091069,Rebeiz; Gabriel,0,0,0,0
1653554265383,ECE 225A,A00,091070,Orlitsky; Alon,0,0,0,0
1653554265908,ECE 230A,A00,091071,Nomura; Kenji,0,0,0,0
1653554266435,ECE 236A,A00,091072,Dayeh; Shadi Ahmad,0,0,0,0
1653554266971,ECE 238A,A00,091073,Luo; Jian,0,0,0,0
1653554266971,ECE 238A,B00,091074,Luo; Jian,0,0,0,0
1653554267494,ECE 240A,A00,091075,Radic; Stojan,0,0,0,0
1653554268018,ECE 247A,A00,091592,Shi; Lingyan,0,0,0,0
1653554268545,ECE 250,A00,091076,Touri; Behrouz,0,0,0,0
1653554269077,ECE 251C,A00,091078,Nguyen; Truong Quang,0,0,0,0
1653554269601,ECE 253,A00,091079,Cosman; Pamela C.,0,0,0,0
1653554270124,ECE 255A,A00,091080,Orlitsky; Alon,0,0,0,0
1653554270650,ECE 257A,A00,091081,Zhang; Xinyu,0,0,0,0
1653554271175,ECE 260A,A01,091084,Eldon; John,0,0,0,0
1653554271703,ECE 264C,A00,091085,Galton; Ian A,0,0,0,0
1653554272227,ECE 265C,A00,094889,Presti; Calogero Davide,0,0,0,9
1653554272755,ECE 266,A01,091087,Hall; Drew A.,0,0,0,0
1653554273807,ECE 271A,A00,091090,Vasconcelos; Nuno,0,0,0,0
1653554274333,ECE 272B,A00,091091,Sworder; David D.,0,0,0,0
1653554274859,ECE 275A,A00,091092,Meyer; Florian,0,0,0,0
1653554275384,ECE 277,A00,091093,An; Cheolhong,0,0,0,0
1653554275907,ECE 283,A00,091094,Le; Hanh-Phuc,0,0,0,0
1653554276432,ECE 284,A00,091095,Kang; Mingu,0,0,0,0
1653554276432,ECE 284,B00,091096,Wang; Edward Jay,0,0,0,0
1653554276955,ECE 285,A00,094334,Touri; Behrouz,0,0,0,0
1653554277478,ECE 289,A00,091097,Whelan; David Arthur,0,0,0,0
1653554278004,MATH 200A,A00,087414,Salehi Golsefidy; Alireza,7,0,8,1
1653554278527,MATH 202A,A00,087415,Gill; Philip E.,2,0,8,6
1653554279055,MATH 203A,A00,087416,Oprea; Dragos N.,6,0,8,2
1653554279580,MATH 204A,A00,087417,Kedlaya; Kiran S.,6,0,8,2
1653554280106,MATH 205,A00,087418,Sorensen; Claus M,6,0,8,2
1653554280630,MATH 206A,A00,087419,Izadi; Elham,7,0,8,1
1653554281157,MATH 207A,A00,087420,Mohammadi; Amir,5,0,8,3
1653554281680,MATH 208,A00,087421,Staff,9,0,10,1
1653554282203,MATH 209,A00,087422,Staff,10,0,10,0
1653554282726,MATH 218,A00,087423,Staff,10,0,10,0
1653554283251,MATH 220A,A00,087424,Novak; Jonathan I,6,0,8,2
1653554283775,MATH 231A,A00,087425,Bejenaru; Ioan,3,0,8,5
1653554284299,MATH 240A,A00,087426,Ebenfelt; Peter F,5,0,8,3
1653554284823,MATH 243,A00,087427,Staff,9,0,10,1
1653554285348,MATH 248,A00,087429,Staff,10,0,10,0
1653554285874,MATH 250A,A00,087430,Spolaor; Luca,4,0,8,4
1653554286400,MATH 257A,A00,087431,Spolaor; Luca,7,0,8,1
1653554286924,MATH 258,A00,087432,Staff,9,0,10,1
1653554287448,MATH 264A,A00,087433,Warnke; Lutz Peter,5,0,8,3
1653554287973,MATH 268,A00,087434,Staff,15,0,15,0
1653554288497,MATH 269,A00,087435,Staff,14,0,15,1
1653554289020,MATH 270A,A00,087436,Nie; Jiawang,0,0,8,8
1653554289544,MATH 272A,A00,087437,Tian; Xiaochuan,1,0,8,7
1653554290067,MATH 274,A01,087439,Cheng; Li-Tien,9,0,10,1
1653554290067,MATH 274,A02,087440,Cheng; Li-Tien,10,0,10,0
1653554290590,MATH 278A,A00,087441,Staff,8,0,10,2
1653554291116,MATH 278B,A00,087442,Staff,8,0,10,2
1653554291640,MATH 278C,A00,087443,Staff,8,0,10,2
1653554292168,MATH 280A,A00,087444,Zheng; Tianyi,0,0,8,8
1653554292692,MATH 281A,A00,087445,Bradic; Jelena,0,0,8,8
1653554293217,MATH 282A,A00,087446,Zhang; Danna,0,0,8,8
1653554293740,MATH 283,A00,087447,Tesler; Glenn,0,0,0,15
1653554294266,MATH 286,A00,087448,Kemp; Todd Aahron,5,0,8,3
1653554294786,MATH 287D,A00,087449,Bradic; Jelena,0,0,0,1
1653554295309,MATH 288,A00,087450,Staff,14,0,15,1
1653554295309,MATH 288,B00,087451,Staff,15,0,15,0
1653554295309,MATH 288,C00,087452,Staff,15,0,15,0
1653554295834,MATH 290A,A00,087453,Xu; Zhouli,6,0,8,2
1653554296357,MATH 291A,A00,087454,Xu; Zhouli,7,0,8,1
1653554296882,MATH 292,A00,087455,Staff,10,0,10,0
1653554297405,MATH 295,A00,087456,Staff,50,0,50,0
1653554297927,MATH 297,001,087457,Staff,998,0,999,1
1653554859091,COGS 200,A01,087991,Staff,47,0,50,3
1653554859626,COGS 201,A01,094504,Rangel; Lara M,17,0,25,8
1653554860153,COGS 203,A00,087992,Coulson; Seana M,18,0,20,2
1653554860680,COGS 210A,001,087993,Greene; Deanna Jacquelyn,9998,0,9999,1
1653554860680,COGS 210A,002,087994,Saygin; Ayse P,9999,0,9999,0
1653554860680,COGS 210A,003,087995,Xia; Haijun,9999,0,9999,0
1653554860680,COGS 210A,004,087996,Nitz; Douglas A.,9999,0,9999,0
1653554860680,COGS 210A,005,087997,Hollan; James D.,9999,0,9999,0
1653554860680,COGS 210A,006,087998,Deak; Gedeon O.,9998,0,9999,1
1653554860680,COGS 210A,007,087999,Rossano; Federico,9999,0,9999,0
1653554861278,COGS 211A,A00,088000,Coulson; Seana M,9997,0,9999,2
1653554861802,COGS 229,A00,088002,Staff,23,0,25,2
1653554862327,COGS 260,B00,094231,Staff,17,0,20,3
1653554862327,COGS 260,A00,088004,Nitz; Douglas A.,9998,0,9999,1
1653554862857,CSE 202,A00,090110,Paturi; Ramamohan,0,0,0,0
1653554862857,CSE 202,B00,090111,Paturi; Ramamohan,0,0,0,0
1653554863382,CSE 207B,A00,090112,Heninger; Nadia A,0,0,0,0
1653554863907,CSE 208,A00,094858,Micciancio; Daniele,0,0,0,0
1653554864434,CSE 210,A00,090113,Powell; Thomas Allan,0,0,0,0
1653554864957,CSE 219,A00,090898,Staff,0,0,0,0
1653554865480,CSE 221,A00,090114,Zhou; Yuan-Yuan,0,0,0,0
1653554866006,CSE 229A,A00,090115,Porter; George M,0,0,0,0
1653554866532,CSE 229C,A00,090116,Savage; Stefan,0,0,0,0
1653554867059,CSE 230,A00,090117,Jhala; Ranjit,0,0,0,0
1653554867583,CSE 232,A00,090118,Papakonstantinou; Yannis,0,0,0,0
1653554868125,CSE 239A,A00,090121,Kumar; Arun Kumar,0,0,0,0
1653554868653,CSE 239B,A00,090122,Jhala; Ranjit,0,0,0,0
1653554869178,CSE 240A,A00,090123,Zhao; Jishen,1,0,189,188
1653554869715,CSE 243A,A00,090124,Orailoglu; Alex,0,0,15,15
1653554870244,CSE 249B,A00,090125,Kahng; Andrew Byun,13,0,20,7
1653554870772,CSE 250A,A00,090126,Berg-Kirkpatrick; Taylor D,0,0,0,0
1653554871300,CSE 252A,A00,090127,Ochoa; Benjamin Lawrence,0,0,0,0
1653554871833,CSE 258,A01,090129,McAuley; Julian John,0,0,0,0
1653554872359,CSE 258R,A01,090131,McAuley; Julian John,0,0,0,0
1653554872882,CSE 274,A00,090132,Ramamoorthi; Ravi,0,0,0,0
1653554873405,CSE 276A,A00,090133,Christensen; Henrik I,0,0,0,0
1653554873942,CSE 276C,A00,090134,Christensen; Henrik I,0,0,0,0
1653554874467,CSE 290,A00,090135,Bafna; Vineet,0,0,0,0
1653554874467,CSE 290,B00,090136,Ramamoorthi; Ravi,0,0,0,0
1653554874467,CSE 290,C00,090137,Li; Tzumao,8,0,10,2
1653554874467,CSE 290,D00,090138,Zhou; Yuan-Yuan,9,0,10,1
1653554874467,CSE 290,E00,090139,Christensen; Henrik I,8,0,10,2
1653554874467,CSE 290,F00,094053,Shalev; Aaron D,0,0,0,0
1653554875000,CSE 291,A00,090140,Munyaka; Imani N. S.,0,0,0,0
1653554875000,CSE 291,B00,094880,Yu; Qi,0,0,0,0
1653554875000,CSE 291,C00,090142,Pannuto; Patrick William,0,0,0,0
1653554875000,CSE 291,D00,094881,Zhang; Yiying,0,0,0,0
1653554875000,CSE 291,E00,095118,Su; Hao,0,0,0,0
1653554875539,CSE 293,001,094905,Bafna; Vineet,9999,0,9999,0
1653554875539,CSE 293,002,094906,Bellare; Mihir,9999,0,9999,0
1653554875539,CSE 293,003,094907,Berg-Kirkpatrick; Taylor D,9999,0,9999,0
1653554875539,CSE 293,004,094908,Christensen; Henrik I,9999,0,9999,0
1653554875539,CSE 293,005,094909,Cottrell; Garrison W,9999,0,9999,0
1653554875539,CSE 293,006,094910,Deutsch; Alin Bernard,9999,0,9999,0
1653554875539,CSE 293,007,094911,Esmaeilzadeh; Hadi,9999,0,9999,0
1653554875539,CSE 293,008,094912,Freund; Yoav,9999,0,9999,0
1653554875539,CSE 293,009,094913,Griswold; William G.,9999,0,9999,0
1653554875539,CSE 293,010,094914,Gymrek; Melissa Ann,9999,0,9999,0
1653554875539,CSE 293,011,094915,Heninger; Nadia A,9999,0,9999,0
1653554875539,CSE 293,012,094916,Impagliazzo; Russell,9999,0,9999,0
1653554875539,CSE 293,013,094917,Jhala; Ranjit,9999,0,9999,0
1653554875539,CSE 293,014,094918,Kahng; Andrew Byun,9999,0,9999,0
1653554875539,CSE 293,015,094919,Kane; Daniel Mertz,9999,0,9999,0
1653554875539,CSE 293,016,094920,Kriegman; David J,9999,0,9999,0
1653554875539,CSE 293,017,094921,Kumar; Arun Kumar,9999,0,9999,0
1653554875539,CSE 293,018,094922,Lerner; Sorin,9999,0,9999,0
1653554875539,CSE 293,019,094923,Lovett; Shachar,9999,0,9999,0
1653554875539,CSE 293,020,094924,McAuley; Julian John,9999,0,9999,0
1653554875539,CSE 293,021,094925,Micciancio; Daniele,9999,0,9999,0
1653554875539,CSE 293,022,094926,Orailoglu; Alex,9999,0,9999,0
1653554875539,CSE 293,023,094927,Paturi; Ramamohan,9999,0,9999,0
1653554875539,CSE 293,024,094928,Polikarpova; Nadezhda,9999,0,9999,0
1653554875539,CSE 293,025,094929,Politz; Joseph Gibbs,9999,0,9999,0
1653554875539,CSE 293,026,094930,Porter; George M,9999,0,9999,0
1653554875539,CSE 293,027,094931,Porter; Leonard Emerson,9999,0,9999,0
1653554875539,CSE 293,028,094932,Ramamoorthi; Ravi,9999,0,9999,0
1653554875539,CSE 293,029,094933,Sahoo; Debashis,9999,0,9999,0
1653554875539,CSE 293,030,094934,Saul; Lawrence,9999,0,9999,0
1653554875539,CSE 293,031,094935,Savage; Stefan,9999,0,9999,0
1653554875539,CSE 293,032,094936,Schulze; Jurgen P.,9999,0,9999,0
1653554875539,CSE 293,033,094937,Snoeren; Alex C.,9999,0,9999,0
1653554875539,CSE 293,034,094938,Shang; Jingbo,9999,0,9999,0
1653554875539,CSE 293,035,094939,Stefan; Deian,9999,0,9999,0
1653554875539,CSE 293,036,094940,Su; Hao,9999,0,9999,0
1653554875539,CSE 293,037,094941,Swanson; Steven James,9999,0,9999,0
1653554875539,CSE 293,038,094942,Tullsen; Dean Michael,9999,0,9999,0
1653554875539,CSE 293,039,094943,Voelker; Geoffrey M.,9999,0,9999,0
1653554875539,CSE 293,040,094944,Zhao; Jishen,9999,0,9999,0
1653554875539,CSE 293,041,094945,Zhou; Yuan-Yuan,9999,0,9999,0
1653554875539,CSE 293,042,094946,Gao; Sicun,9998,0,9999,1
1653554875539,CSE 293,043,094947,Weibel; Nadir,9999,0,9999,0
1653554875539,CSE 293,044,094948,Gupta; Rajesh K.,9999,0,9999,0
1653554876065,CSE 294,A00,090143,Porter; George M,8,0,10,2
1653554876590,DSE 200,A00,091799,Staff,50,0,50,0
1653554877118,DSE 203,A00,091800,Gupta; Amarnath,30,0,30,0
1653554877644,DSE 250,A00,091801,Deutsch; Alin Bernard,30,0,30,0
1653554878169,DSE 290,A00,091802,Altintas De Callaf; Ilkay,50,0,50,0
1653554878720,ECE 200,001,091003,Antipa; Nicholas A,9999,0,9999,0
1653554878720,ECE 200,002,091004,Atanasov; Nikolay A.,9999,0,9999,0
1653554878720,ECE 200,003,091005,Bharadia; Dinesh,9999,0,9999,0
1653554878720,ECE 200,004,091006,Cheng; Chung Kuan,9999,0,9999,0
1653554878720,ECE 200,005,091007,Cosman; Pamela C.,9999,0,9999,0
1653554878720,ECE 200,006,091008,Staff,9999,0,9999,0
1653554878720,ECE 200,007,091009,Dayeh; Shadi Ahmad,9999,0,9999,0
1653554878720,ECE 200,008,091010,Fainman; Yeshaiahu,9999,0,9999,0
1653554878720,ECE 200,009,091011,Ford; Joseph Earl,9999,0,9999,0
1653554878720,ECE 200,010,091012,Franceschetti; Massimo,9999,0,9999,0
1653554878720,ECE 200,011,091013,Fullerton; Eric E,9999,0,9999,0
1653554878720,ECE 200,012,091014,Galton; Ian A,9999,0,9999,0
1653554878720,ECE 200,013,091015,Gilja; Vikash,9999,0,9999,0
1653554878720,ECE 200,014,091016,Hall; Drew A.,9999,0,9999,0
1653554878720,ECE 200,015,091017,Hsueh; Tzu-Chien,9999,0,9999,0
1653554878720,ECE 200,016,091018,Javidi; Tara,9999,0,9999,0
1653554878720,ECE 200,017,091019,Kahng; Andrew Byun,9999,0,9999,0
1653554878720,ECE 200,018,091020,Kim; Young-Han,9999,0,9999,0
1653554878720,ECE 200,019,091021,Koushanfar; Farinaz,9999,0,9999,0
1653554878720,ECE 200,020,091022,Kuzum; Duygu,9999,0,9999,0
1653554878720,ECE 200,021,091023,Le; Hanh-Phuc,9999,0,9999,0
1653554878720,ECE 200,022,091024,Lin; Bill,9999,0,9999,0
1653554878720,ECE 200,023,091025,Liu; Zhaowei,9999,0,9999,0
1653554878720,ECE 200,024,091026,Lo; Yu-Hwa,9999,0,9999,0
1653554878720,ECE 200,025,091027,Lomakin; Vitaliy,9999,0,9999,0
1653554878720,ECE 200,026,091028,Mercier; Patrick Philip,9999,0,9999,0
1653554878720,ECE 200,027,091029,Meyer; Florian,9999,0,9999,0
1653554878720,ECE 200,028,091030,Milstein; Laurence B.,9999,0,9999,0
1653554878720,ECE 200,029,091031,Mir Arabbaygi; Siavash,9999,0,9999,0
1653554878720,ECE 200,030,091032,Mookherjea; Shayan,9999,0,9999,0
1653554878720,ECE 200,031,091033,Morris; Karcher William,9999,0,9999,0
1653554878720,ECE 200,032,091034,Ng; Tse Nga,9999,0,9999,0
1653554878720,ECE 200,033,091035,Nguyen; Truong Quang,9999,0,9999,0
1653554878720,ECE 200,034,091036,Nomura; Kenji,9999,0,9999,0
1653554878720,ECE 200,035,091037,Orlitsky; Alon,9999,0,9999,0
1653554878720,ECE 200,036,091038,Pal; Piya,9999,0,9999,0
1653554878720,ECE 200,037,091039,Papen; George C.,9999,0,9999,0
1653554878720,ECE 200,038,091040,Radic; Stojan,9999,0,9999,0
1653554878720,ECE 200,039,091041,Rao; Bhaskar D.,9999,0,9999,0
1653554878720,ECE 200,040,091042,Rao; Ramesh R,9999,0,9999,0
1653554878720,ECE 200,041,091043,Rebeiz; Gabriel,9999,0,9999,0
1653554878720,ECE 200,042,091044,Sanford; John R,9999,0,9999,0
1653554878720,ECE 200,043,091045,Siegel; Paul H.,9999,0,9999,0
1653554878720,ECE 200,044,091046,Sievenpiper; Daniel F.,9999,0,9999,0
1653554878720,ECE 200,045,091047,Sworder; David D.,9999,0,9999,0
1653554878720,ECE 200,046,091048,Taur; Yuan,9999,0,9999,0
1653554878720,ECE 200,047,091049,Touri; Behrouz,9999,0,9999,0
1653554878720,ECE 200,048,091050,Trivedi; Mohan M.,9999,0,9999,0
1653554878720,ECE 200,049,091051,Vardy; Alexander,9999,0,9999,0
1653554878720,ECE 200,050,091052,Vasconcelos; Nuno,9999,0,9999,0
1653554878720,ECE 200,051,091053,Wang; Xiaolong,9999,0,9999,0
1653554878720,ECE 200,052,091054,Xie; Pengtao,9999,0,9999,0
1653554878720,ECE 200,053,091055,Yip; Michael,9999,0,9999,0
1653554878720,ECE 200,054,091056,Zeger; Kenneth A.,9999,0,9999,0
1653554878720,ECE 200,055,091057,Zhang; Xinyu,9999,0,9999,0
1653554878720,ECE 200,056,091058,Turakhia; Yatish Girish,9999,0,9999,0
1653554878720,ECE 200,057,091059,Kang; Mingu,9999,0,9999,0
1653554878720,ECE 200,058,091060,Shi; Yuanyuan,9999,0,9999,0
1653554878720,ECE 200,059,091061,Wang; Edward Jay,9999,0,9999,0
1653554878720,ECE 200,060,091062,Zheng; Yang,9999,0,9999,0
1653554879248,ECE 201,A00,095526,Lo; Yu-Hwa,0,0,0,0
1653554879777,ECE 203,A00,091065,Mercier; Patrick Philip,0,0,0,0
1653554880323,ECE 207A,A00,091605,Liu; Thomas Tao-Ming,0,0,0,0
1653554880848,ECE 212AN,A00,091068,Nomura; Kenji,0,0,0,0
1653554881372,ECE 222A,A00,091069,Rebeiz; Gabriel,0,0,0,0
1653554881900,ECE 225A,A00,091070,Orlitsky; Alon,0,0,0,0
1653554882423,ECE 230A,A00,091071,Nomura; Kenji,0,0,0,0
1653554882949,ECE 236A,A00,091072,Dayeh; Shadi Ahmad,0,0,0,0
1653554883473,ECE 238A,A00,091073,Luo; Jian,0,0,0,0
1653554883473,ECE 238A,B00,091074,Luo; Jian,0,0,0,0
1653554883998,ECE 240A,A00,091075,Radic; Stojan,0,0,0,0
1653554884521,ECE 247A,A00,091592,Shi; Lingyan,0,0,0,0
1653554885044,ECE 250,A00,091076,Touri; Behrouz,0,0,0,0
1653554885569,ECE 251C,A00,091078,Nguyen; Truong Quang,0,0,0,0
1653554886103,ECE 253,A00,091079,Cosman; Pamela C.,0,0,0,0
1653554886627,ECE 255A,A00,091080,Orlitsky; Alon,0,0,0,0
1653554887150,ECE 257A,A00,091081,Zhang; Xinyu,0,0,0,0
1653554887678,ECE 260A,A01,091084,Eldon; John,0,0,0,0
1653554888202,ECE 264C,A00,091085,Galton; Ian A,0,0,0,0
1653554888731,ECE 265C,A00,094889,Presti; Calogero Davide,0,0,0,9
1653554889254,ECE 266,A01,091087,Hall; Drew A.,0,0,0,0
1653554890302,ECE 271A,A00,091090,Vasconcelos; Nuno,0,0,0,0
1653554890825,ECE 272B,A00,091091,Sworder; David D.,0,0,0,0
1653554891350,ECE 275A,A00,091092,Meyer; Florian,0,0,0,0
1653554891874,ECE 277,A00,091093,An; Cheolhong,0,0,0,0
1653554892398,ECE 283,A00,091094,Le; Hanh-Phuc,0,0,0,0
1653554892926,ECE 284,A00,091095,Kang; Mingu,0,0,0,0
1653554892926,ECE 284,B00,091096,Wang; Edward Jay,0,0,0,0
1653554893450,ECE 285,A00,094334,Touri; Behrouz,0,0,0,0
1653554893979,ECE 289,A00,091097,Whelan; David Arthur,0,0,0,0
1653554894504,MATH 200A,A00,087414,Salehi Golsefidy; Alireza,7,0,8,1
1653554895028,MATH 202A,A00,087415,Gill; Philip E.,2,0,8,6
1653554895557,MATH 203A,A00,087416,Oprea; Dragos N.,6,0,8,2
1653554896093,MATH 204A,A00,087417,Kedlaya; Kiran S.,6,0,8,2
1653554896616,MATH 205,A00,087418,Sorensen; Claus M,6,0,8,2
1653554897139,MATH 206A,A00,087419,Izadi; Elham,7,0,8,1
1653554897666,MATH 207A,A00,087420,Mohammadi; Amir,5,0,8,3
1653554898189,MATH 208,A00,087421,Staff,9,0,10,1
1653554898715,MATH 209,A00,087422,Staff,10,0,10,0
1653554899238,MATH 218,A00,087423,Staff,10,0,10,0
1653554899766,MATH 220A,A00,087424,Novak; Jonathan I,6,0,8,2
1653554900289,MATH 231A,A00,087425,Bejenaru; Ioan,3,0,8,5
1653554900813,MATH 240A,A00,087426,Ebenfelt; Peter F,5,0,8,3
1653554901338,MATH 243,A00,087427,Staff,9,0,10,1
1653554901861,MATH 248,A00,087429,Staff,10,0,10,0
1653554902386,MATH 250A,A00,087430,Spolaor; Luca,4,0,8,4
1653554902910,MATH 257A,A00,087431,Spolaor; Luca,7,0,8,1
1653554903433,MATH 258,A00,087432,Staff,9,0,10,1
1653554903960,MATH 264A,A00,087433,Warnke; Lutz Peter,5,0,8,3
1653554904488,MATH 268,A00,087434,Staff,15,0,15,0
1653554905022,MATH 269,A00,087435,Staff,14,0,15,1
1653554905546,MATH 270A,A00,087436,Nie; Jiawang,0,0,8,8
1653554906070,MATH 272A,A00,087437,Tian; Xiaochuan,1,0,8,7
1653554906694,MATH 274,A01,087439,Cheng; Li-Tien,9,0,10,1
1653554906694,MATH 274,A02,087440,Cheng; Li-Tien,10,0,10,0
1653554907219,MATH 278A,A00,087441,Staff,8,0,10,2
1653554907745,MATH 278B,A00,087442,Staff,8,0,10,2
1653554908268,MATH 278C,A00,087443,Staff,8,0,10,2
1653554908791,MATH 280A,A00,087444,Zheng; Tianyi,0,0,8,8
1653554909314,MATH 281A,A00,087445,Bradic; Jelena,0,0,8,8
1653554909842,MATH 282A,A00,087446,Zhang; Danna,0,0,8,8
1653554910375,MATH 283,A00,087447,Tesler; Glenn,0,0,0,15
1653554910901,MATH 286,A00,087448,Kemp; Todd Aahron,5,0,8,3
1653554911427,MATH 287D,A00,087449,Bradic; Jelena,0,0,0,1
1653554911953,MATH 288,A00,087450,Staff,14,0,15,1
1653554911953,MATH 288,B00,087451,Staff,15,0,15,0
1653554911953,MATH 288,C00,087452,Staff,15,0,15,0
1653554912485,MATH 290A,A00,087453,Xu; Zhouli,6,0,8,2
1653554913014,MATH 291A,A00,087454,Xu; Zhouli,7,0,8,1
1653554913537,MATH 292,A00,087455,Staff,10,0,10,0
1653554914062,MATH 295,A00,087456,Staff,50,0,50,0
1653554914586,MATH 297,001,087457,Staff,998,0,999,1
1653555475881,COGS 200,A01,087991,Staff,47,0,50,3
1653555476405,COGS 201,A01,094504,Rangel; Lara M,17,0,25,8
1653555476929,COGS 203,A00,087992,Coulson; Seana M,18,0,20,2
1653555477459,COGS 210A,001,087993,Greene; Deanna Jacquelyn,9998,0,9999,1
1653555477459,COGS 210A,002,087994,Saygin; Ayse P,9999,0,9999,0
1653555477459,COGS 210A,003,087995,Xia; Haijun,9999,0,9999,0
1653555477459,COGS 210A,004,087996,Nitz; Douglas A.,9999,0,9999,0
1653555477459,COGS 210A,005,087997,Hollan; James D.,9999,0,9999,0
1653555477459,COGS 210A,006,087998,Deak; Gedeon O.,9998,0,9999,1
1653555477459,COGS 210A,007,087999,Rossano; Federico,9999,0,9999,0
1653555477982,COGS 211A,A00,088000,Coulson; Seana M,9997,0,9999,2
1653555478504,COGS 229,A00,088002,Staff,22,0,25,3
1653555479028,COGS 260,B00,094231,Staff,17,0,20,3
1653555479028,COGS 260,A00,088004,Nitz; Douglas A.,9998,0,9999,1
1653555479558,CSE 202,A00,090110,Paturi; Ramamohan,0,0,0,0
1653555479558,CSE 202,B00,090111,Paturi; Ramamohan,0,0,0,0
1653555480084,CSE 207B,A00,090112,Heninger; Nadia A,0,0,0,0
1653555480608,CSE 208,A00,094858,Micciancio; Daniele,0,0,0,0
1653555481131,CSE 210,A00,090113,Powell; Thomas Allan,0,0,0,0
1653555481655,CSE 219,A00,090898,Staff,0,0,0,0
1653555482180,CSE 221,A00,090114,Zhou; Yuan-Yuan,0,0,0,0
1653555482708,CSE 229A,A00,090115,Porter; George M,0,0,0,0
1653555483231,CSE 229C,A00,090116,Savage; Stefan,0,0,0,0
1653555483755,CSE 230,A00,090117,Jhala; Ranjit,0,0,0,0
1653555484284,CSE 232,A00,090118,Papakonstantinou; Yannis,0,0,0,0
1653555484807,CSE 239A,A00,090121,Kumar; Arun Kumar,0,0,0,0
1653555485335,CSE 239B,A00,090122,Jhala; Ranjit,0,0,0,0
1653555485858,CSE 240A,A00,090123,Zhao; Jishen,1,0,189,188
1653555486381,CSE 243A,A00,090124,Orailoglu; Alex,0,0,15,15
1653555486906,CSE 249B,A00,090125,Kahng; Andrew Byun,13,0,20,7
1653555487429,CSE 250A,A00,090126,Berg-Kirkpatrick; Taylor D,0,0,0,0
1653555487957,CSE 252A,A00,090127,Ochoa; Benjamin Lawrence,0,0,0,0
1653555488481,CSE 258,A01,090129,McAuley; Julian John,0,0,0,0
1653555489024,CSE 258R,A01,090131,McAuley; Julian John,0,0,0,0
1653555489546,CSE 274,A00,090132,Ramamoorthi; Ravi,0,0,0,0
1653555490070,CSE 276A,A00,090133,Christensen; Henrik I,0,0,0,0
1653555490593,CSE 276C,A00,090134,Christensen; Henrik I,0,0,0,0
1653555491123,CSE 290,A00,090135,Bafna; Vineet,0,0,0,0
1653555491123,CSE 290,B00,090136,Ramamoorthi; Ravi,0,0,0,0
1653555491123,CSE 290,C00,090137,Li; Tzumao,8,0,10,2
1653555491123,CSE 290,D00,090138,Zhou; Yuan-Yuan,9,0,10,1
1653555491123,CSE 290,E00,090139,Christensen; Henrik I,8,0,10,2
1653555491123,CSE 290,F00,094053,Shalev; Aaron D,0,0,0,0
1653555491656,CSE 291,A00,090140,Munyaka; Imani N. S.,0,0,0,0
1653555491656,CSE 291,B00,094880,Yu; Qi,0,0,0,0
1653555491656,CSE 291,C00,090142,Pannuto; Patrick William,0,0,0,0
1653555491656,CSE 291,D00,094881,Zhang; Yiying,0,0,0,0
1653555491656,CSE 291,E00,095118,Su; Hao,0,0,0,0
1653555492203,CSE 293,001,094905,Bafna; Vineet,9999,0,9999,0
1653555492203,CSE 293,002,094906,Bellare; Mihir,9999,0,9999,0
1653555492203,CSE 293,003,094907,Berg-Kirkpatrick; Taylor D,9999,0,9999,0
1653555492203,CSE 293,004,094908,Christensen; Henrik I,9999,0,9999,0
1653555492203,CSE 293,005,094909,Cottrell; Garrison W,9999,0,9999,0
1653555492203,CSE 293,006,094910,Deutsch; Alin Bernard,9999,0,9999,0
1653555492203,CSE 293,007,094911,Esmaeilzadeh; Hadi,9999,0,9999,0
1653555492203,CSE 293,008,094912,Freund; Yoav,9999,0,9999,0
1653555492203,CSE 293,009,094913,Griswold; William G.,9999,0,9999,0
1653555492203,CSE 293,010,094914,Gymrek; Melissa Ann,9999,0,9999,0
1653555492203,CSE 293,011,094915,Heninger; Nadia A,9999,0,9999,0
1653555492203,CSE 293,012,094916,Impagliazzo; Russell,9999,0,9999,0
1653555492203,CSE 293,013,094917,Jhala; Ranjit,9999,0,9999,0
1653555492203,CSE 293,014,094918,Kahng; Andrew Byun,9999,0,9999,0
1653555492203,CSE 293,015,094919,Kane; Daniel Mertz,9999,0,9999,0
1653555492203,CSE 293,016,094920,Kriegman; David J,9999,0,9999,0
1653555492203,CSE 293,017,094921,Kumar; Arun Kumar,9999,0,9999,0
1653555492203,CSE 293,018,094922,Lerner; Sorin,9999,0,9999,0
1653555492203,CSE 293,019,094923,Lovett; Shachar,9999,0,9999,0
1653555492203,CSE 293,020,094924,McAuley; Julian John,9999,0,9999,0
1653555492203,CSE 293,021,094925,Micciancio; Daniele,9999,0,9999,0
1653555492203,CSE 293,022,094926,Orailoglu; Alex,9999,0,9999,0
1653555492203,CSE 293,023,094927,Paturi; Ramamohan,9999,0,9999,0
1653555492203,CSE 293,024,094928,Polikarpova; Nadezhda,9999,0,9999,0
1653555492203,CSE 293,025,094929,Politz; Joseph Gibbs,9999,0,9999,0
1653555492203,CSE 293,026,094930,Porter; George M,9999,0,9999,0
1653555492203,CSE 293,027,094931,Porter; Leonard Emerson,9999,0,9999,0
1653555492203,CSE 293,028,094932,Ramamoorthi; Ravi,9999,0,9999,0
1653555492203,CSE 293,029,094933,Sahoo; Debashis,9999,0,9999,0
1653555492203,CSE 293,030,094934,Saul; Lawrence,9999,0,9999,0
1653555492203,CSE 293,031,094935,Savage; Stefan,9999,0,9999,0
1653555492203,CSE 293,032,094936,Schulze; Jurgen P.,9999,0,9999,0
1653555492203,CSE 293,033,094937,Snoeren; Alex C.,9999,0,9999,0
1653555492203,CSE 293,034,094938,Shang; Jingbo,9999,0,9999,0
1653555492203,CSE 293,035,094939,Stefan; Deian,9999,0,9999,0
1653555492203,CSE 293,036,094940,Su; Hao,9999,0,9999,0
1653555492203,CSE 293,037,094941,Swanson; Steven James,9999,0,9999,0
1653555492203,CSE 293,038,094942,Tullsen; Dean Michael,9999,0,9999,0
1653555492203,CSE 293,039,094943,Voelker; Geoffrey M.,9999,0,9999,0
1653555492203,CSE 293,040,094944,Zhao; Jishen,9999,0,9999,0
1653555492203,CSE 293,041,094945,Zhou; Yuan-Yuan,9999,0,9999,0
1653555492203,CSE 293,042,094946,Gao; Sicun,9998,0,9999,1
1653555492203,CSE 293,043,094947,Weibel; Nadir,9999,0,9999,0
1653555492203,CSE 293,044,094948,Gupta; Rajesh K.,9999,0,9999,0
1653555492736,CSE 294,A00,090143,Porter; George M,8,0,10,2
1653555493259,DSE 200,A00,091799,Staff,50,0,50,0
1653555493783,DSE 203,A00,091800,Gupta; Amarnath,30,0,30,0
1653555494311,DSE 250,A00,091801,Deutsch; Alin Bernard,30,0,30,0
1653555494841,DSE 290,A00,091802,Altintas De Callaf; Ilkay,50,0,50,0
1653555495502,ECE 200,001,091003,Antipa; Nicholas A,9999,0,9999,0
1653555495502,ECE 200,002,091004,Atanasov; Nikolay A.,9999,0,9999,0
1653555495502,ECE 200,003,091005,Bharadia; Dinesh,9999,0,9999,0
1653555495502,ECE 200,004,091006,Cheng; Chung Kuan,9999,0,9999,0
1653555495502,ECE 200,005,091007,Cosman; Pamela C.,9999,0,9999,0
1653555495502,ECE 200,006,091008,Staff,9999,0,9999,0
1653555495502,ECE 200,007,091009,Dayeh; Shadi Ahmad,9999,0,9999,0
1653555495502,ECE 200,008,091010,Fainman; Yeshaiahu,9999,0,9999,0
1653555495502,ECE 200,009,091011,Ford; Joseph Earl,9999,0,9999,0
1653555495502,ECE 200,010,091012,Franceschetti; Massimo,9999,0,9999,0
1653555495502,ECE 200,011,091013,Fullerton; Eric E,9999,0,9999,0
1653555495502,ECE 200,012,091014,Galton; Ian A,9999,0,9999,0
1653555495502,ECE 200,013,091015,Gilja; Vikash,9999,0,9999,0
1653555495502,ECE 200,014,091016,Hall; Drew A.,9999,0,9999,0
1653555495502,ECE 200,015,091017,Hsueh; Tzu-Chien,9999,0,9999,0
1653555495502,ECE 200,016,091018,Javidi; Tara,9999,0,9999,0
1653555495502,ECE 200,017,091019,Kahng; Andrew Byun,9999,0,9999,0
1653555495502,ECE 200,018,091020,Kim; Young-Han,9999,0,9999,0
1653555495502,ECE 200,019,091021,Koushanfar; Farinaz,9999,0,9999,0
1653555495502,ECE 200,020,091022,Kuzum; Duygu,9999,0,9999,0
1653555495502,ECE 200,021,091023,Le; Hanh-Phuc,9999,0,9999,0
1653555495502,ECE 200,022,091024,Lin; Bill,9999,0,9999,0
1653555495502,ECE 200,023,091025,Liu; Zhaowei,9999,0,9999,0
1653555495502,ECE 200,024,091026,Lo; Yu-Hwa,9999,0,9999,0
1653555495502,ECE 200,025,091027,Lomakin; Vitaliy,9999,0,9999,0
1653555495502,ECE 200,026,091028,Mercier; Patrick Philip,9999,0,9999,0
1653555495502,ECE 200,027,091029,Meyer; Florian,9999,0,9999,0
1653555495502,ECE 200,028,091030,Milstein; Laurence B.,9999,0,9999,0
1653555495502,ECE 200,029,091031,Mir Arabbaygi; Siavash,9999,0,9999,0
1653555495502,ECE 200,030,091032,Mookherjea; Shayan,9999,0,9999,0
1653555495502,ECE 200,031,091033,Morris; Karcher William,9999,0,9999,0
1653555495502,ECE 200,032,091034,Ng; Tse Nga,9999,0,9999,0
1653555495502,ECE 200,033,091035,Nguyen; Truong Quang,9999,0,9999,0
1653555495502,ECE 200,034,091036,Nomura; Kenji,9999,0,9999,0
1653555495502,ECE 200,035,091037,Orlitsky; Alon,9999,0,9999,0
1653555495502,ECE 200,036,091038,Pal; Piya,9999,0,9999,0
1653555495502,ECE 200,037,091039,Papen; George C.,9999,0,9999,0
1653555495502,ECE 200,038,091040,Radic; Stojan,9999,0,9999,0
1653555495502,ECE 200,039,091041,Rao; Bhaskar D.,9999,0,9999,0
1653555495502,ECE 200,040,091042,Rao; Ramesh R,9999,0,9999,0
1653555495502,ECE 200,041,091043,Rebeiz; Gabriel,9999,0,9999,0
1653555495502,ECE 200,042,091044,Sanford; John R,9999,0,9999,0
1653555495502,ECE 200,043,091045,Siegel; Paul H.,9999,0,9999,0
1653555495502,ECE 200,044,091046,Sievenpiper; Daniel F.,9999,0,9999,0
1653555495502,ECE 200,045,091047,Sworder; David D.,9999,0,9999,0
1653555495502,ECE 200,046,091048,Taur; Yuan,9999,0,9999,0
1653555495502,ECE 200,047,091049,Touri; Behrouz,9999,0,9999,0
1653555495502,ECE 200,048,091050,Trivedi; Mohan M.,9999,0,9999,0
1653555495502,ECE 200,049,091051,Vardy; Alexander,9999,0,9999,0
1653555495502,ECE 200,050,091052,Vasconcelos; Nuno,9999,0,9999,0
1653555495502,ECE 200,051,091053,Wang; Xiaolong,9999,0,9999,0
1653555495502,ECE 200,052,091054,Xie; Pengtao,9999,0,9999,0
1653555495502,ECE 200,053,091055,Yip; Michael,9999,0,9999,0
1653555495502,ECE 200,054,091056,Zeger; Kenneth A.,9999,0,9999,0
1653555495502,ECE 200,055,091057,Zhang; Xinyu,9999,0,9999,0
1653555495502,ECE 200,056,091058,Turakhia; Yatish Girish,9999,0,9999,0
1653555495502,ECE 200,057,091059,Kang; Mingu,9999,0,9999,0
1653555495502,ECE 200,058,091060,Shi; Yuanyuan,9999,0,9999,0
1653555495502,ECE 200,059,091061,Wang; Edward Jay,9999,0,9999,0
1653555495502,ECE 200,060,091062,Zheng; Yang,9999,0,9999,0
1653555496027,ECE 201,A00,095526,Lo; Yu-Hwa,0,0,0,0
1653555496551,ECE 203,A00,091065,Mercier; Patrick Philip,0,0,0,0
1653555497080,ECE 207A,A00,091605,Liu; Thomas Tao-Ming,0,0,0,0
1653555497608,ECE 212AN,A00,091068,Nomura; Kenji,0,0,0,0
1653555498130,ECE 222A,A00,091069,Rebeiz; Gabriel,0,0,0,0
1653555498655,ECE 225A,A00,091070,Orlitsky; Alon,0,0,0,0
1653555499183,ECE 230A,A00,091071,Nomura; Kenji,0,0,0,0
1653555499707,ECE 236A,A00,091072,Dayeh; Shadi Ahmad,0,0,0,0
1653555500242,ECE 238A,A00,091073,Luo; Jian,0,0,0,0
1653555500242,ECE 238A,B00,091074,Luo; Jian,0,0,0,0
1653555500768,ECE 240A,A00,091075,Radic; Stojan,0,0,0,0
1653555501292,ECE 247A,A00,091592,Shi; Lingyan,0,0,0,0
1653555501816,ECE 250,A00,091076,Touri; Behrouz,0,0,0,0
1653555502348,ECE 251C,A00,091078,Nguyen; Truong Quang,0,0,0,0
1653555502875,ECE 253,A00,091079,Cosman; Pamela C.,0,0,0,0
1653555503400,ECE 255A,A00,091080,Orlitsky; Alon,0,0,0,0
1653555503935,ECE 257A,A00,091081,Zhang; Xinyu,0,0,0,0
1653555504458,ECE 260A,A01,091084,Eldon; John,0,0,0,0
1653555504982,ECE 264C,A00,091085,Galton; Ian A,0,0,0,0
1653555505510,ECE 265C,A00,094889,Presti; Calogero Davide,0,0,0,9
1653555506035,ECE 266,A01,091087,Hall; Drew A.,0,0,0,0
1653555507087,ECE 271A,A00,091090,Vasconcelos; Nuno,0,0,0,0
1653555507611,ECE 272B,A00,091091,Sworder; David D.,0,0,0,0
1653555508134,ECE 275A,A00,091092,Meyer; Florian,0,0,0,0
1653555508659,ECE 277,A00,091093,An; Cheolhong,0,0,0,0
1653555509187,ECE 283,A00,091094,Le; Hanh-Phuc,0,0,0,0
1653555509711,ECE 284,A00,091095,Kang; Mingu,0,0,0,0
1653555509711,ECE 284,B00,091096,Wang; Edward Jay,0,0,0,0
1653555510234,ECE 285,A00,094334,Touri; Behrouz,0,0,0,0
1653555510763,ECE 289,A00,091097,Whelan; David Arthur,0,0,0,0
1653555511287,MATH 200A,A00,087414,Salehi Golsefidy; Alireza,7,0,8,1
1653555511810,MATH 202A,A00,087415,Gill; Philip E.,2,0,8,6
1653555512339,MATH 203A,A00,087416,Oprea; Dragos N.,6,0,8,2
1653555512865,MATH 204A,A00,087417,Kedlaya; Kiran S.,6,0,8,2
1653555513389,MATH 205,A00,087418,Sorensen; Claus M,6,0,8,2
1653555513913,MATH 206A,A00,087419,Izadi; Elham,7,0,8,1
1653555514447,MATH 207A,A00,087420,Mohammadi; Amir,5,0,8,3
1653555514972,MATH 208,A00,087421,Staff,9,0,10,1
1653555515496,MATH 209,A00,087422,Staff,10,0,10,0
1653555516020,MATH 218,A00,087423,Staff,10,0,10,0
1653555516548,MATH 220A,A00,087424,Novak; Jonathan I,6,0,8,2
1653555517072,MATH 231A,A00,087425,Bejenaru; Ioan,3,0,8,5
1653555517596,MATH 240A,A00,087426,Ebenfelt; Peter F,5,0,8,3
1653555518119,MATH 243,A00,087427,Staff,9,0,10,1
1653555518642,MATH 248,A00,087429,Staff,10,0,10,0
1653555519164,MATH 250A,A00,087430,Spolaor; Luca,4,0,8,4
1653555519690,MATH 257A,A00,087431,Spolaor; Luca,7,0,8,1
1653555520216,MATH 258,A00,087432,Staff,9,0,10,1
1653555520739,MATH 264A,A00,087433,Warnke; Lutz Peter,5,0,8,3
1653555521266,MATH 268,A00,087434,Staff,15,0,15,0
1653555521791,MATH 269,A00,087435,Staff,14,0,15,1
1653555522315,MATH 270A,A00,087436,Nie; Jiawang,0,0,8,8
1653555522838,MATH 272A,A00,087437,Tian; Xiaochuan,1,0,8,7
1653555523364,MATH 274,A01,087439,Cheng; Li-Tien,9,0,10,1
1653555523364,MATH 274,A02,087440,Cheng; Li-Tien,10,0,10,0
1653555523891,MATH 278A,A00,087441,Staff,8,0,10,2
1653555524414,MATH 278B,A00,087442,Staff,8,0,10,2
1653555524941,MATH 278C,A00,087443,Staff,8,0,10,2
1653555525474,MATH 280A,A00,087444,Zheng; Tianyi,0,0,8,8
1653555525998,MATH 281A,A00,087445,Bradic; Jelena,0,0,8,8
1653555526525,MATH 282A,A00,087446,Zhang; Danna,0,0,8,8
1653555527051,MATH 283,A00,087447,Tesler; Glenn,0,0,0,15
1653555527574,MATH 286,A00,087448,Kemp; Todd Aahron,5,0,8,3
1653555528098,MATH 287D,A00,087449,Bradic; Jelena,0,0,0,1
1653555528621,MATH 288,A00,087450,Staff,14,0,15,1
1653555528621,MATH 288,B00,087451,Staff,15,0,15,0
1653555528621,MATH 288,C00,087452,Staff,15,0,15,0
1653555529149,MATH 290A,A00,087453,Xu; Zhouli,6,0,8,2
1653555529672,MATH 291A,A00,087454,Xu; Zhouli,7,0,8,1
1653555530196,MATH 292,A00,087455,Staff,10,0,10,0
1653555530723,MATH 295,A00,087456,Staff,50,0,50,0
1653555531247,MATH 297,001,087457,Staff,998,0,999,1
1653556091054,COGS 200,A01,087991,Staff,47,0,50,3
1653556091584,COGS 201,A01,094504,Rangel; Lara M,17,0,25,8
1653556092107,COGS 203,A00,087992,Coulson; Seana M,18,0,20,2
1653556092639,COGS 210A,001,087993,Greene; Deanna Jacquelyn,9998,0,9999,1
1653556092639,COGS 210A,002,087994,Saygin; Ayse P,9999,0,9999,0
1653556092639,COGS 210A,003,087995,Xia; Haijun,9999,0,9999,0
1653556092639,COGS 210A,004,087996,Nitz; Douglas A.,9999,0,9999,0
1653556092639,COGS 210A,005,087997,Hollan; James D.,9999,0,9999,0
1653556092639,COGS 210A,006,087998,Deak; Gedeon O.,9998,0,9999,1
1653556092639,COGS 210A,007,087999,Rossano; Federico,9999,0,9999,0
1653556093163,COGS 211A,A00,088000,Coulson; Seana M,9997,0,9999,2
1653556093686,COGS 229,A00,088002,Staff,22,0,25,3
1653556094209,COGS 260,B00,094231,Staff,17,0,20,3
1653556094209,COGS 260,A00,088004,Nitz; Douglas A.,9998,0,9999,1
1653556094732,CSE 202,A00,090110,Paturi; Ramamohan,0,0,0,0
1653556094732,CSE 202,B00,090111,Paturi; Ramamohan,0,0,0,0
1653556095257,CSE 207B,A00,090112,Heninger; Nadia A,0,0,0,0
1653556095780,CSE 208,A00,094858,Micciancio; Daniele,0,0,0,0
1653556096304,CSE 210,A00,090113,Powell; Thomas Allan,0,0,0,0
1653556096830,CSE 219,A00,090898,Staff,0,0,0,0
1653556097354,CSE 221,A00,090114,Zhou; Yuan-Yuan,0,0,0,0
1653556097876,CSE 229A,A00,090115,Porter; George M,0,0,0,0
1653556098402,CSE 229C,A00,090116,Savage; Stefan,0,0,0,0
1653556098926,CSE 230,A00,090117,Jhala; Ranjit,0,0,0,0
1653556099453,CSE 232,A00,090118,Papakonstantinou; Yannis,0,0,0,0
1653556099979,CSE 239A,A00,090121,Kumar; Arun Kumar,0,0,0,0
1653556100501,CSE 239B,A00,090122,Jhala; Ranjit,0,0,0,0
1653556101026,CSE 240A,A00,090123,Zhao; Jishen,1,0,189,188
1653556101549,CSE 243A,A00,090124,Orailoglu; Alex,0,0,15,15
1653556102072,CSE 249B,A00,090125,Kahng; Andrew Byun,13,0,20,7
1653556102599,CSE 250A,A00,090126,Berg-Kirkpatrick; Taylor D,0,0,0,0
1653556103125,CSE 252A,A00,090127,Ochoa; Benjamin Lawrence,0,0,0,0
1653556103648,CSE 258,A01,090129,McAuley; Julian John,0,0,0,0
1653556104172,CSE 258R,A01,090131,McAuley; Julian John,0,0,0,0
1653556104698,CSE 274,A00,090132,Ramamoorthi; Ravi,0,0,0,0
1653556105226,CSE 276A,A00,090133,Christensen; Henrik I,0,0,0,0
1653556105761,CSE 276C,A00,090134,Christensen; Henrik I,0,0,0,0
1653556106292,CSE 290,A00,090135,Bafna; Vineet,0,0,0,0
1653556106292,CSE 290,B00,090136,Ramamoorthi; Ravi,0,0,0,0
1653556106292,CSE 290,C00,090137,Li; Tzumao,8,0,10,2
1653556106292,CSE 290,D00,090138,Zhou; Yuan-Yuan,9,0,10,1
1653556106292,CSE 290,E00,090139,Christensen; Henrik I,8,0,10,2
1653556106292,CSE 290,F00,094053,Shalev; Aaron D,0,0,0,0
1653556106819,CSE 291,A00,090140,Munyaka; Imani N. S.,0,0,0,0
1653556106819,CSE 291,B00,094880,Yu; Qi,0,0,0,0
1653556106819,CSE 291,C00,090142,Pannuto; Patrick William,0,0,0,0
1653556106819,CSE 291,D00,094881,Zhang; Yiying,0,0,0,0
1653556106819,CSE 291,E00,095118,Su; Hao,0,0,0,0
1653556107352,CSE 293,001,094905,Bafna; Vineet,9999,0,9999,0
1653556107352,CSE 293,002,094906,Bellare; Mihir,9999,0,9999,0
1653556107352,CSE 293,003,094907,Berg-Kirkpatrick; Taylor D,9999,0,9999,0
1653556107352,CSE 293,004,094908,Christensen; Henrik I,9999,0,9999,0
1653556107352,CSE 293,005,094909,Cottrell; Garrison W,9999,0,9999,0
1653556107352,CSE 293,006,094910,Deutsch; Alin Bernard,9999,0,9999,0
1653556107352,CSE 293,007,094911,Esmaeilzadeh; Hadi,9999,0,9999,0
1653556107352,CSE 293,008,094912,Freund; Yoav,9999,0,9999,0
1653556107352,CSE 293,009,094913,Griswold; William G.,9999,0,9999,0
1653556107352,CSE 293,010,094914,Gymrek; Melissa Ann,9999,0,9999,0
1653556107352,CSE 293,011,094915,Heninger; Nadia A,9999,0,9999,0
1653556107352,CSE 293,012,094916,Impagliazzo; Russell,9999,0,9999,0
1653556107352,CSE 293,013,094917,Jhala; Ranjit,9999,0,9999,0
1653556107352,CSE 293,014,094918,Kahng; Andrew Byun,9999,0,9999,0
1653556107352,CSE 293,015,094919,Kane; Daniel Mertz,9999,0,9999,0
1653556107352,CSE 293,016,094920,Kriegman; David J,9999,0,9999,0
1653556107352,CSE 293,017,094921,Kumar; Arun Kumar,9999,0,9999,0
1653556107352,CSE 293,018,094922,Lerner; Sorin,9999,0,9999,0
1653556107352,CSE 293,019,094923,Lovett; Shachar,9999,0,9999,0
1653556107352,CSE 293,020,094924,McAuley; Julian John,9999,0,9999,0
1653556107352,CSE 293,021,094925,Micciancio; Daniele,9999,0,9999,0
1653556107352,CSE 293,022,094926,Orailoglu; Alex,9999,0,9999,0
1653556107352,CSE 293,023,094927,Paturi; Ramamohan,9999,0,9999,0
1653556107352,CSE 293,024,094928,Polikarpova; Nadezhda,9999,0,9999,0
1653556107352,CSE 293,025,094929,Politz; Joseph Gibbs,9999,0,9999,0
1653556107352,CSE 293,026,094930,Porter; George M,9999,0,9999,0
1653556107352,CSE 293,027,094931,Porter; Leonard Emerson,9999,0,9999,0
1653556107352,CSE 293,028,094932,Ramamoorthi; Ravi,9999,0,9999,0
1653556107352,CSE 293,029,094933,Sahoo; Debashis,9999,0,9999,0
1653556107352,CSE 293,030,094934,Saul; Lawrence,9999,0,9999,0
1653556107352,CSE 293,031,094935,Savage; Stefan,9999,0,9999,0
1653556107352,CSE 293,032,094936,Schulze; Jurgen P.,9999,0,9999,0
1653556107352,CSE 293,033,094937,Snoeren; Alex C.,9999,0,9999,0
1653556107352,CSE 293,034,094938,Shang; Jingbo,9999,0,9999,0
1653556107352,CSE 293,035,094939,Stefan; Deian,9999,0,9999,0
1653556107352,CSE 293,036,094940,Su; Hao,9999,0,9999,0
1653556107352,CSE 293,037,094941,Swanson; Steven James,9999,0,9999,0
1653556107352,CSE 293,038,094942,Tullsen; Dean Michael,9999,0,9999,0
1653556107352,CSE 293,039,094943,Voelker; Geoffrey M.,9999,0,9999,0
1653556107352,CSE 293,040,094944,Zhao; Jishen,9999,0,9999,0
1653556107352,CSE 293,041,094945,Zhou; Yuan-Yuan,9999,0,9999,0
1653556107352,CSE 293,042,094946,Gao; Sicun,9998,0,9999,1
1653556107352,CSE 293,043,094947,Weibel; Nadir,9999,0,9999,0
1653556107352,CSE 293,044,094948,Gupta; Rajesh K.,9999,0,9999,0
1653556107877,CSE 294,A00,090143,Porter; George M,8,0,10,2
1653556108401,DSE 200,A00,091799,Staff,50,0,50,0
1653556108930,DSE 203,A00,091800,Gupta; Amarnath,30,0,30,0
1653556109453,DSE 250,A00,091801,Deutsch; Alin Bernard,30,0,30,0
1653556109975,DSE 290,A00,091802,Altintas De Callaf; Ilkay,50,0,50,0
1653556110531,ECE 200,001,091003,Antipa; Nicholas A,9999,0,9999,0
1653556110531,ECE 200,002,091004,Atanasov; Nikolay A.,9999,0,9999,0
1653556110531,ECE 200,003,091005,Bharadia; Dinesh,9999,0,9999,0
1653556110531,ECE 200,004,091006,Cheng; Chung Kuan,9999,0,9999,0
1653556110531,ECE 200,005,091007,Cosman; Pamela C.,9999,0,9999,0
1653556110531,ECE 200,006,091008,Staff,9999,0,9999,0
1653556110531,ECE 200,007,091009,Dayeh; Shadi Ahmad,9999,0,9999,0
1653556110531,ECE 200,008,091010,Fainman; Yeshaiahu,9999,0,9999,0
1653556110531,ECE 200,009,091011,Ford; Joseph Earl,9999,0,9999,0
1653556110531,ECE 200,010,091012,Franceschetti; Massimo,9999,0,9999,0
1653556110531,ECE 200,011,091013,Fullerton; Eric E,9999,0,9999,0
1653556110531,ECE 200,012,091014,Galton; Ian A,9999,0,9999,0
1653556110531,ECE 200,013,091015,Gilja; Vikash,9999,0,9999,0
1653556110531,ECE 200,014,091016,Hall; Drew A.,9999,0,9999,0
1653556110531,ECE 200,015,091017,Hsueh; Tzu-Chien,9999,0,9999,0
1653556110531,ECE 200,016,091018,Javidi; Tara,9999,0,9999,0
1653556110531,ECE 200,017,091019,Kahng; Andrew Byun,9999,0,9999,0
1653556110531,ECE 200,018,091020,Kim; Young-Han,9999,0,9999,0
1653556110531,ECE 200,019,091021,Koushanfar; Farinaz,9999,0,9999,0
1653556110531,ECE 200,020,091022,Kuzum; Duygu,9999,0,9999,0
1653556110531,ECE 200,021,091023,Le; Hanh-Phuc,9999,0,9999,0
1653556110531,ECE 200,022,091024,Lin; Bill,9999,0,9999,0
1653556110531,ECE 200,023,091025,Liu; Zhaowei,9999,0,9999,0
1653556110531,ECE 200,024,091026,Lo; Yu-Hwa,9999,0,9999,0
1653556110531,ECE 200,025,091027,Lomakin; Vitaliy,9999,0,9999,0
1653556110531,ECE 200,026,091028,Mercier; Patrick Philip,9999,0,9999,0
1653556110531,ECE 200,027,091029,Meyer; Florian,9999,0,9999,0
1653556110531,ECE 200,028,091030,Milstein; Laurence B.,9999,0,9999,0
1653556110531,ECE 200,029,091031,Mir Arabbaygi; Siavash,9999,0,9999,0
1653556110531,ECE 200,030,091032,Mookherjea; Shayan,9999,0,9999,0
1653556110531,ECE 200,031,091033,Morris; Karcher William,9999,0,9999,0
1653556110531,ECE 200,032,091034,Ng; Tse Nga,9999,0,9999,0
1653556110531,ECE 200,033,091035,Nguyen; Truong Quang,9999,0,9999,0
1653556110531,ECE 200,034,091036,Nomura; Kenji,9999,0,9999,0
1653556110531,ECE 200,035,091037,Orlitsky; Alon,9999,0,9999,0
1653556110531,ECE 200,036,091038,Pal; Piya,9999,0,9999,0
1653556110531,ECE 200,037,091039,Papen; George C.,9999,0,9999,0
1653556110531,ECE 200,038,091040,Radic; Stojan,9999,0,9999,0
1653556110531,ECE 200,039,091041,Rao; Bhaskar D.,9999,0,9999,0
1653556110531,ECE 200,040,091042,Rao; Ramesh R,9999,0,9999,0
1653556110531,ECE 200,041,091043,Rebeiz; Gabriel,9999,0,9999,0
1653556110531,ECE 200,042,091044,Sanford; John R,9999,0,9999,0
1653556110531,ECE 200,043,091045,Siegel; Paul H.,9999,0,9999,0
1653556110531,ECE 200,044,091046,Sievenpiper; Daniel F.,9999,0,9999,0
1653556110531,ECE 200,045,091047,Sworder; David D.,9999,0,9999,0
1653556110531,ECE 200,046,091048,Taur; Yuan,9999,0,9999,0
1653556110531,ECE 200,047,091049,Touri; Behrouz,9999,0,9999,0
1653556110531,ECE 200,048,091050,Trivedi; Mohan M.,9999,0,9999,0
1653556110531,ECE 200,049,091051,Vardy; Alexander,9999,0,9999,0
1653556110531,ECE 200,050,091052,Vasconcelos; Nuno,9999,0,9999,0
1653556110531,ECE 200,051,091053,Wang; Xiaolong,9999,0,9999,0
1653556110531,ECE 200,052,091054,Xie; Pengtao,9999,0,9999,0
1653556110531,ECE 200,053,091055,Yip; Michael,9999,0,9999,0
1653556110531,ECE 200,054,091056,Zeger; Kenneth A.,9999,0,9999,0
1653556110531,ECE 200,055,091057,Zhang; Xinyu,9999,0,9999,0
1653556110531,ECE 200,056,091058,Turakhia; Yatish Girish,9999,0,9999,0
1653556110531,ECE 200,057,091059,Kang; Mingu,9999,0,9999,0
1653556110531,ECE 200,058,091060,Shi; Yuanyuan,9999,0,9999,0
1653556110531,ECE 200,059,091061,Wang; Edward Jay,9999,0,9999,0
1653556110531,ECE 200,060,091062,Zheng; Yang,9999,0,9999,0
1653556111056,ECE 201,A00,095526,Lo; Yu-Hwa,0,0,0,0
1653556111583,ECE 203,A00,091065,Mercier; Patrick Philip,0,0,0,0
1653556112109,ECE 207A,A00,091605,Liu; Thomas Tao-Ming,0,0,0,0
1653556112635,ECE 212AN,A00,091068,Nomura; Kenji,0,0,0,0
1653556113159,ECE 222A,A00,091069,Rebeiz; Gabriel,0,0,0,0
1653556113688,ECE 225A,A00,091070,Orlitsky; Alon,0,0,0,0
1653556114215,ECE 230A,A00,091071,Nomura; Kenji,0,0,0,0
1653556114738,ECE 236A,A00,091072,Dayeh; Shadi Ahmad,0,0,0,0
1653556115264,ECE 238A,A00,091073,Luo; Jian,0,0,0,0
1653556115264,ECE 238A,B00,091074,Luo; Jian,0,0,0,0
1653556115788,ECE 240A,A00,091075,Radic; Stojan,0,0,0,0
1653556116311,ECE 247A,A00,091592,Shi; Lingyan,0,0,0,0
1653556116834,ECE 250,A00,091076,Touri; Behrouz,0,0,0,0
1653556117360,ECE 251C,A00,091078,Nguyen; Truong Quang,0,0,0,0
1653556117884,ECE 253,A00,091079,Cosman; Pamela C.,0,0,0,0
1653556118407,ECE 255A,A00,091080,Orlitsky; Alon,0,0,0,0
1653556118931,ECE 257A,A00,091081,Zhang; Xinyu,0,0,0,0
1653556119457,ECE 260A,A01,091084,Eldon; John,0,0,0,0
1653556119981,ECE 264C,A00,091085,Galton; Ian A,0,0,0,0
1653556120505,ECE 265C,A00,094889,Presti; Calogero Davide,0,0,0,9
1653556121031,ECE 266,A01,091087,Hall; Drew A.,0,0,0,0
1653556122088,ECE 271A,A00,091090,Vasconcelos; Nuno,0,0,0,0
1653556122615,ECE 272B,A00,091091,Sworder; David D.,0,0,0,0
1653556123139,ECE 275A,A00,091092,Meyer; Florian,0,0,0,0
1653556123663,ECE 277,A00,091093,An; Cheolhong,0,0,0,0
1653556124192,ECE 283,A00,091094,Le; Hanh-Phuc,0,0,0,0
1653556124716,ECE 284,A00,091095,Kang; Mingu,0,0,0,0
1653556124716,ECE 284,B00,091096,Wang; Edward Jay,0,0,0,0
1653556125238,ECE 285,A00,094334,Touri; Behrouz,0,0,0,0
1653556125762,ECE 289,A00,091097,Whelan; David Arthur,0,0,0,0
1653556126286,MATH 200A,A00,087414,Salehi Golsefidy; Alireza,7,0,8,1
1653556126813,MATH 202A,A00,087415,Gill; Philip E.,2,0,8,6
1653556127337,MATH 203A,A00,087416,Oprea; Dragos N.,6,0,8,2
1653556127860,MATH 204A,A00,087417,Kedlaya; Kiran S.,6,0,8,2
1653556128391,MATH 205,A00,087418,Sorensen; Claus M,6,0,8,2
1653556128917,MATH 206A,A00,087419,Izadi; Elham,7,0,8,1
1653556129445,MATH 207A,A00,087420,Mohammadi; Amir,5,0,8,3
1653556129969,MATH 208,A00,087421,Staff,9,0,10,1
1653556130492,MATH 209,A00,087422,Staff,10,0,10,0
1653556131018,MATH 218,A00,087423,Staff,10,0,10,0
1653556131541,MATH 220A,A00,087424,Novak; Jonathan I,6,0,8,2
1653556132067,MATH 231A,A00,087425,Bejenaru; Ioan,3,0,8,5
1653556132591,MATH 240A,A00,087426,Ebenfelt; Peter F,5,0,8,3
1653556133114,MATH 243,A00,087427,Staff,9,0,10,1
1653556133640,MATH 248,A00,087429,Staff,10,0,10,0
1653556134168,MATH 250A,A00,087430,Spolaor; Luca,4,0,8,4
1653556134695,MATH 257A,A00,087431,Spolaor; Luca,7,0,8,1
1653556135220,MATH 258,A00,087432,Staff,9,0,10,1
1653556135840,MATH 264A,A00,087433,Warnke; Lutz Peter,5,0,8,3
1653556136367,MATH 268,A00,087434,Staff,15,0,15,0
1653556136893,MATH 269,A00,087435,Staff,14,0,15,1
1653556137417,MATH 270A,A00,087436,Nie; Jiawang,0,0,8,8
1653556137946,MATH 272A,A00,087437,Tian; Xiaochuan,1,0,8,7
1653556138470,MATH 274,A01,087439,Cheng; Li-Tien,9,0,10,1
1653556138470,MATH 274,A02,087440,Cheng; Li-Tien,10,0,10,0
1653556138997,MATH 278A,A00,087441,Staff,8,0,10,2
1653556139522,MATH 278B,A00,087442,Staff,8,0,10,2
1653556140043,MATH 278C,A00,087443,Staff,8,0,10,2
1653556140580,MATH 280A,A00,087444,Zheng; Tianyi,0,0,8,8
1653556141104,MATH 281A,A00,087445,Bradic; Jelena,0,0,8,8
1653556141631,MATH 282A,A00,087446,Zhang; Danna,0,0,8,8
1653556142155,MATH 283,A00,087447,Tesler; Glenn,0,0,0,15
1653556142686,MATH 286,A00,087448,Kemp; Todd Aahron,5,0,8,3
1653556143210,MATH 287D,A00,087449,Bradic; Jelena,0,0,0,1
1653556143738,MATH 288,A00,087450,Staff,14,0,15,1
1653556143738,MATH 288,B00,087451,Staff,15,0,15,0
1653556143738,MATH 288,C00,087452,Staff,15,0,15,0
1653556144262,MATH 290A,A00,087453,Xu; Zhouli,6,0,8,2
1653556144787,MATH 291A,A00,087454,Xu; Zhouli,7,0,8,1
1653556145310,MATH 292,A00,087455,Staff,10,0,10,0
1653556145834,MATH 295,A00,087456,Staff,50,0,50,0
1653556146365,MATH 297,001,087457,Staff,998,0,999,1
1653556705579,COGS 200,A01,087991,Staff,47,0,50,3
1653556706103,COGS 201,A01,094504,Rangel; Lara M,17,0,25,8
1653556706626,COGS 203,A00,087992,Coulson; Seana M,18,0,20,2
1653556707152,COGS 210A,001,087993,Greene; Deanna Jacquelyn,9998,0,9999,1
1653556707152,COGS 210A,002,087994,Saygin; Ayse P,9999,0,9999,0
1653556707152,COGS 210A,003,087995,Xia; Haijun,9999,0,9999,0
1653556707152,COGS 210A,004,087996,Nitz; Douglas A.,9999,0,9999,0
1653556707152,COGS 210A,005,087997,Hollan; James D.,9999,0,9999,0
1653556707152,COGS 210A,006,087998,Deak; Gedeon O.,9998,0,9999,1
1653556707152,COGS 210A,007,087999,Rossano; Federico,9999,0,9999,0
1653556707681,COGS 211A,A00,088000,Coulson; Seana M,9997,0,9999,2
1653556708209,COGS 229,A00,088002,Staff,22,0,25,3
1653556708733,COGS 260,B00,094231,Staff,17,0,20,3
1653556708733,COGS 260,A00,088004,Nitz; Douglas A.,9998,0,9999,1
1653556709258,CSE 202,A00,090110,Paturi; Ramamohan,0,0,0,0
1653556709258,CSE 202,B00,090111,Paturi; Ramamohan,0,0,0,0
1653556709781,CSE 207B,A00,090112,Heninger; Nadia A,0,0,0,0
1653556710305,CSE 208,A00,094858,Micciancio; Daniele,0,0,0,0
1653556710833,CSE 210,A00,090113,Powell; Thomas Allan,0,0,0,0
1653556711358,CSE 219,A00,090898,Staff,0,0,0,0
1653556711885,CSE 221,A00,090114,Zhou; Yuan-Yuan,0,0,0,0
1653556712410,CSE 229A,A00,090115,Porter; George M,0,0,0,0
1653556712933,CSE 229C,A00,090116,Savage; Stefan,0,0,0,0
1653556713460,CSE 230,A00,090117,Jhala; Ranjit,0,0,0,0
1653556713983,CSE 232,A00,090118,Papakonstantinou; Yannis,0,0,0,0
1653556714506,CSE 239A,A00,090121,Kumar; Arun Kumar,0,0,0,0
1653556715032,CSE 239B,A00,090122,Jhala; Ranjit,0,0,0,0
1653556715559,CSE 240A,A00,090123,Zhao; Jishen,1,0,189,188
1653556716082,CSE 243A,A00,090124,Orailoglu; Alex,0,0,15,15
1653556716604,CSE 249B,A00,090125,Kahng; Andrew Byun,13,0,20,7
1653556717130,CSE 250A,A00,090126,Berg-Kirkpatrick; Taylor D,0,0,0,0
1653556717654,CSE 252A,A00,090127,Ochoa; Benjamin Lawrence,0,0,0,0
1653556718178,CSE 258,A01,090129,McAuley; Julian John,0,0,0,0
1653556718704,CSE 258R,A01,090131,McAuley; Julian John,0,0,0,0
1653556719227,CSE 274,A00,090132,Ramamoorthi; Ravi,0,0,0,0
1653556719753,CSE 276A,A00,090133,Christensen; Henrik I,0,0,0,0
1653556720276,CSE 276C,A00,090134,Christensen; Henrik I,0,0,0,0
1653556720800,CSE 290,A00,090135,Bafna; Vineet,0,0,0,0
1653556720800,CSE 290,B00,090136,Ramamoorthi; Ravi,0,0,0,0
1653556720800,CSE 290,C00,090137,Li; Tzumao,8,0,10,2
1653556720800,CSE 290,D00,090138,Zhou; Yuan-Yuan,9,0,10,1
1653556720800,CSE 290,E00,090139,Christensen; Henrik I,8,0,10,2
1653556720800,CSE 290,F00,094053,Shalev; Aaron D,0,0,0,0
1653556721325,CSE 291,A00,090140,Munyaka; Imani N. S.,0,0,0,0
1653556721325,CSE 291,B00,094880,Yu; Qi,0,0,0,0
1653556721325,CSE 291,C00,090142,Pannuto; Patrick William,0,0,0,0
1653556721325,CSE 291,D00,094881,Zhang; Yiying,0,0,0,0
1653556721325,CSE 291,E00,095118,Su; Hao,0,0,0,0
1653556721871,CSE 293,001,094905,Bafna; Vineet,9999,0,9999,0
1653556721871,CSE 293,002,094906,Bellare; Mihir,9999,0,9999,0
1653556721871,CSE 293,003,094907,Berg-Kirkpatrick; Taylor D,9999,0,9999,0
1653556721871,CSE 293,004,094908,Christensen; Henrik I,9999,0,9999,0
1653556721871,CSE 293,005,094909,Cottrell; Garrison W,9999,0,9999,0
1653556721871,CSE 293,006,094910,Deutsch; Alin Bernard,9999,0,9999,0
1653556721871,CSE 293,007,094911,Esmaeilzadeh; Hadi,9999,0,9999,0
1653556721871,CSE 293,008,094912,Freund; Yoav,9999,0,9999,0
1653556721871,CSE 293,009,094913,Griswold; William G.,9999,0,9999,0
1653556721871,CSE 293,010,094914,Gymrek; Melissa Ann,9999,0,9999,0
1653556721871,CSE 293,011,094915,Heninger; Nadia A,9999,0,9999,0
1653556721871,CSE 293,012,094916,Impagliazzo; Russell,9999,0,9999,0
1653556721871,CSE 293,013,094917,Jhala; Ranjit,9999,0,9999,0
1653556721871,CSE 293,014,094918,Kahng; Andrew Byun,9999,0,9999,0
1653556721871,CSE 293,015,094919,Kane; Daniel Mertz,9999,0,9999,0
1653556721871,CSE 293,016,094920,Kriegman; David J,9999,0,9999,0
1653556721871,CSE 293,017,094921,Kumar; Arun Kumar,9999,0,9999,0
1653556721871,CSE 293,018,094922,Lerner; Sorin,9999,0,9999,0
1653556721871,CSE 293,019,094923,Lovett; Shachar,9999,0,9999,0
1653556721871,CSE 293,020,094924,McAuley; Julian John,9999,0,9999,0
1653556721871,CSE 293,021,094925,Micciancio; Daniele,9999,0,9999,0
1653556721871,CSE 293,022,094926,Orailoglu; Alex,9999,0,9999,0
1653556721871,CSE 293,023,094927,Paturi; Ramamohan,9999,0,9999,0
1653556721871,CSE 293,024,094928,Polikarpova; Nadezhda,9999,0,9999,0
1653556721871,CSE 293,025,094929,Politz; Joseph Gibbs,9999,0,9999,0
1653556721871,CSE 293,026,094930,Porter; George M,9999,0,9999,0
1653556721871,CSE 293,027,094931,Porter; Leonard Emerson,9999,0,9999,0
1653556721871,CSE 293,028,094932,Ramamoorthi; Ravi,9999,0,9999,0
1653556721871,CSE 293,029,094933,Sahoo; Debashis,9999,0,9999,0
1653556721871,CSE 293,030,094934,Saul; Lawrence,9999,0,9999,0
1653556721871,CSE 293,031,094935,Savage; Stefan,9999,0,9999,0
1653556721871,CSE 293,032,094936,Schulze; Jurgen P.,9999,0,9999,0
1653556721871,CSE 293,033,094937,Snoeren; Alex C.,9999,0,9999,0
1653556721871,CSE 293,034,094938,Shang; Jingbo,9999,0,9999,0
1653556721871,CSE 293,035,094939,Stefan; Deian,9999,0,9999,0
1653556721871,CSE 293,036,094940,Su; Hao,9999,0,9999,0
1653556721871,CSE 293,037,094941,Swanson; Steven James,9999,0,9999,0
1653556721871,CSE 293,038,094942,Tullsen; Dean Michael,9999,0,9999,0
1653556721871,CSE 293,039,094943,Voelker; Geoffrey M.,9999,0,9999,0
1653556721871,CSE 293,040,094944,Zhao; Jishen,9999,0,9999,0
1653556721871,CSE 293,041,094945,Zhou; Yuan-Yuan,9999,0,9999,0
1653556721871,CSE 293,042,094946,Gao; Sicun,9998,0,9999,1
1653556721871,CSE 293,043,094947,Weibel; Nadir,9999,0,9999,0
1653556721871,CSE 293,044,094948,Gupta; Rajesh K.,9999,0,9999,0
1653556722467,CSE 294,A00,090143,Porter; George M,8,0,10,2
1653556722995,DSE 200,A00,091799,Staff,50,0,50,0
1653556723519,DSE 203,A00,091800,Gupta; Amarnath,30,0,30,0
1653556724043,DSE 250,A00,091801,Deutsch; Alin Bernard,30,0,30,0
1653556724566,DSE 290,A00,091802,Altintas De Callaf; Ilkay,50,0,50,0
1653556725116,ECE 200,001,091003,Antipa; Nicholas A,9999,0,9999,0
1653556725116,ECE 200,002,091004,Atanasov; Nikolay A.,9999,0,9999,0
1653556725116,ECE 200,003,091005,Bharadia; Dinesh,9999,0,9999,0
1653556725116,ECE 200,004,091006,Cheng; Chung Kuan,9999,0,9999,0
1653556725116,ECE 200,005,091007,Cosman; Pamela C.,9999,0,9999,0
1653556725116,ECE 200,006,091008,Staff,9999,0,9999,0
1653556725116,ECE 200,007,091009,Dayeh; Shadi Ahmad,9999,0,9999,0
1653556725116,ECE 200,008,091010,Fainman; Yeshaiahu,9999,0,9999,0
1653556725116,ECE 200,009,091011,Ford; Joseph Earl,9999,0,9999,0
1653556725116,ECE 200,010,091012,Franceschetti; Massimo,9999,0,9999,0
1653556725116,ECE 200,011,091013,Fullerton; Eric E,9999,0,9999,0
1653556725116,ECE 200,012,091014,Galton; Ian A,9999,0,9999,0
1653556725116,ECE 200,013,091015,Gilja; Vikash,9999,0,9999,0
1653556725116,ECE 200,014,091016,Hall; Drew A.,9999,0,9999,0
1653556725116,ECE 200,015,091017,Hsueh; Tzu-Chien,9999,0,9999,0
1653556725116,ECE 200,016,091018,Javidi; Tara,9999,0,9999,0
1653556725116,ECE 200,017,091019,Kahng; Andrew Byun,9999,0,9999,0
1653556725116,ECE 200,018,091020,Kim; Young-Han,9999,0,9999,0
1653556725116,ECE 200,019,091021,Koushanfar; Farinaz,9999,0,9999,0
1653556725116,ECE 200,020,091022,Kuzum; Duygu,9999,0,9999,0
1653556725116,ECE 200,021,091023,Le; Hanh-Phuc,9999,0,9999,0
1653556725116,ECE 200,022,091024,Lin; Bill,9999,0,9999,0
1653556725116,ECE 200,023,091025,Liu; Zhaowei,9999,0,9999,0
1653556725116,ECE 200,024,091026,Lo; Yu-Hwa,9999,0,9999,0
1653556725116,ECE 200,025,091027,Lomakin; Vitaliy,9999,0,9999,0
1653556725116,ECE 200,026,091028,Mercier; Patrick Philip,9999,0,9999,0
1653556725116,ECE 200,027,091029,Meyer; Florian,9999,0,9999,0
1653556725116,ECE 200,028,091030,Milstein; Laurence B.,9999,0,9999,0
1653556725116,ECE 200,029,091031,Mir Arabbaygi; Siavash,9999,0,9999,0
1653556725116,ECE 200,030,091032,Mookherjea; Shayan,9999,0,9999,0
1653556725116,ECE 200,031,091033,Morris; Karcher William,9999,0,9999,0
1653556725116,ECE 200,032,091034,Ng; Tse Nga,9999,0,9999,0
1653556725116,ECE 200,033,091035,Nguyen; Truong Quang,9999,0,9999,0
1653556725116,ECE 200,034,091036,Nomura; Kenji,9999,0,9999,0
1653556725116,ECE 200,035,091037,Orlitsky; Alon,9999,0,9999,0
1653556725116,ECE 200,036,091038,Pal; Piya,9999,0,9999,0
1653556725116,ECE 200,037,091039,Papen; George C.,9999,0,9999,0
1653556725116,ECE 200,038,091040,Radic; Stojan,9999,0,9999,0
1653556725116,ECE 200,039,091041,Rao; Bhaskar D.,9999,0,9999,0
1653556725116,ECE 200,040,091042,Rao; Ramesh R,9999,0,9999,0
1653556725116,ECE 200,041,091043,Rebeiz; Gabriel,9999,0,9999,0
1653556725116,ECE 200,042,091044,Sanford; John R,9999,0,9999,0
1653556725116,ECE 200,043,091045,Siegel; Paul H.,9999,0,9999,0
1653556725116,ECE 200,044,091046,Sievenpiper; Daniel F.,9999,0,9999,0
1653556725116,ECE 200,045,091047,Sworder; David D.,9999,0,9999,0
1653556725116,ECE 200,046,091048,Taur; Yuan,9999,0,9999,0
1653556725116,ECE 200,047,091049,Touri; Behrouz,9999,0,9999,0
1653556725116,ECE 200,048,091050,Trivedi; Mohan M.,9999,0,9999,0
1653556725116,ECE 200,049,091051,Vardy; Alexander,9999,0,9999,0
1653556725116,ECE 200,050,091052,Vasconcelos; Nuno,9999,0,9999,0
1653556725116,ECE 200,051,091053,Wang; Xiaolong,9999,0,9999,0
1653556725116,ECE 200,052,091054,Xie; Pengtao,9999,0,9999,0
1653556725116,ECE 200,053,091055,Yip; Michael,9999,0,9999,0
1653556725116,ECE 200,054,091056,Zeger; Kenneth A.,9999,0,9999,0
1653556725116,ECE 200,055,091057,Zhang; Xinyu,9999,0,9999,0
1653556725116,ECE 200,056,091058,Turakhia; Yatish Girish,9999,0,9999,0
1653556725116,ECE 200,057,091059,Kang; Mingu,9999,0,9999,0
1653556725116,ECE 200,058,091060,Shi; Yuanyuan,9999,0,9999,0
1653556725116,ECE 200,059,091061,Wang; Edward Jay,9999,0,9999,0
1653556725116,ECE 200,060,091062,Zheng; Yang,9999,0,9999,0
1653556725648,ECE 201,A00,095526,Lo; Yu-Hwa,0,0,0,0
1653556726173,ECE 203,A00,091065,Mercier; Patrick Philip,0,0,0,0
1653556726702,ECE 207A,A00,091605,Liu; Thomas Tao-Ming,0,0,0,0
1653556727229,ECE 212AN,A00,091068,Nomura; Kenji,0,0,0,0
1653556727761,ECE 222A,A00,091069,Rebeiz; Gabriel,0,0,0,0
1653556728287,ECE 225A,A00,091070,Orlitsky; Alon,0,0,0,0
1653556728811,ECE 230A,A00,091071,Nomura; Kenji,0,0,0,0
1653556729339,ECE 236A,A00,091072,Dayeh; Shadi Ahmad,0,0,0,0
1653556729863,ECE 238A,A00,091073,Luo; Jian,0,0,0,0
1653556729863,ECE 238A,B00,091074,Luo; Jian,0,0,0,0
1653556730387,ECE 240A,A00,091075,Radic; Stojan,0,0,0,0
1653556730912,ECE 247A,A00,091592,Shi; Lingyan,0,0,0,0
1653556731439,ECE 250,A00,091076,Touri; Behrouz,0,0,0,0
1653556731962,ECE 251C,A00,091078,Nguyen; Truong Quang,0,0,0,0
1653556732485,ECE 253,A00,091079,Cosman; Pamela C.,0,0,0,0
1653556733011,ECE 255A,A00,091080,Orlitsky; Alon,0,0,0,0
1653556733534,ECE 257A,A00,091081,Zhang; Xinyu,0,0,0,0
1653556734056,ECE 260A,A01,091084,Eldon; John,0,0,0,0
1653556734586,ECE 264C,A00,091085,Galton; Ian A,0,0,0,0
1653556735109,ECE 265C,A00,094889,Presti; Calogero Davide,0,0,0,9
1653556735632,ECE 266,A01,091087,Hall; Drew A.,0,0,0,0
1653556736684,ECE 271A,A00,091090,Vasconcelos; Nuno,0,0,0,0
1653556737209,ECE 272B,A00,091091,Sworder; David D.,0,0,0,0
1653556737734,ECE 275A,A00,091092,Meyer; Florian,0,0,0,0
1653556738263,ECE 277,A00,091093,An; Cheolhong,0,0,0,0
1653556738785,ECE 283,A00,091094,Le; Hanh-Phuc,0,0,0,0
1653556739309,ECE 284,A00,091095,Kang; Mingu,0,0,0,0
1653556739309,ECE 284,B00,091096,Wang; Edward Jay,0,0,0,0
1653556739837,ECE 285,A00,094334,Touri; Behrouz,0,0,0,0
1653556740361,ECE 289,A00,091097,Whelan; David Arthur,0,0,0,0
1653556740885,MATH 200A,A00,087414,Salehi Golsefidy; Alireza,7,0,8,1
1653556741412,MATH 202A,A00,087415,Gill; Philip E.,2,0,8,6
1653556741942,MATH 203A,A00,087416,Oprea; Dragos N.,6,0,8,2
1653556742466,MATH 204A,A00,087417,Kedlaya; Kiran S.,6,0,8,2
1653556742990,MATH 205,A00,087418,Sorensen; Claus M,6,0,8,2
1653556743515,MATH 206A,A00,087419,Izadi; Elham,7,0,8,1
1653556744039,MATH 207A,A00,087420,Mohammadi; Amir,5,0,8,3
1653556744565,MATH 208,A00,087421,Staff,9,0,10,1
1653556745089,MATH 209,A00,087422,Staff,10,0,10,0
1653556745613,MATH 218,A00,087423,Staff,10,0,10,0
1653556746149,MATH 220A,A00,087424,Novak; Jonathan I,6,0,8,2
1653556746677,MATH 231A,A00,087425,Bejenaru; Ioan,3,0,8,5
1653556747216,MATH 240A,A00,087426,Ebenfelt; Peter F,5,0,8,3
1653556747741,MATH 243,A00,087427,Staff,9,0,10,1
1653556748265,MATH 248,A00,087429,Staff,10,0,10,0
1653556748788,MATH 250A,A00,087430,Spolaor; Luca,4,0,8,4
1653556749309,MATH 257A,A00,087431,Spolaor; Luca,7,0,8,1
1653556749832,MATH 258,A00,087432,Staff,9,0,10,1
1653556750360,MATH 264A,A00,087433,Warnke; Lutz Peter,5,0,8,3
1653556750886,MATH 268,A00,087434,Staff,15,0,15,0
1653556751410,MATH 269,A00,087435,Staff,14,0,15,1
1653556751934,MATH 270A,A00,087436,Nie; Jiawang,0,0,8,8
1653556752458,MATH 272A,A00,087437,Tian; Xiaochuan,1,0,8,7
1653556752982,MATH 274,A01,087439,Cheng; Li-Tien,9,0,10,1
1653556752982,MATH 274,A02,087440,Cheng; Li-Tien,10,0,10,0
1653556753508,MATH 278A,A00,087441,Staff,8,0,10,2
1653556754033,MATH 278B,A00,087442,Staff,8,0,10,2
1653556754559,MATH 278C,A00,087443,Staff,8,0,10,2
1653556755086,MATH 280A,A00,087444,Zheng; Tianyi,0,0,8,8
1653556755611,MATH 281A,A00,087445,Bradic; Jelena,0,0,8,8
1653556756134,MATH 282A,A00,087446,Zhang; Danna,0,0,8,8
1653556756657,MATH 283,A00,087447,Tesler; Glenn,0,0,0,15
1653556757184,MATH 286,A00,087448,Kemp; Todd Aahron,5,0,8,3
1653556757710,MATH 287D,A00,087449,Bradic; Jelena,0,0,0,1
1653556758233,MATH 288,A00,087450,Staff,14,0,15,1
1653556758233,MATH 288,B00,087451,Staff,15,0,15,0
1653556758233,MATH 288,C00,087452,Staff,15,0,15,0
1653556758762,MATH 290A,A00,087453,Xu; Zhouli,6,0,8,2
1653556759289,MATH 291A,A00,087454,Xu; Zhouli,7,0,8,1
1653556759813,MATH 292,A00,087455,Staff,10,0,10,0
1653556760337,MATH 295,A00,087456,Staff,50,0,50,0
1653556760864,MATH 297,001,087457,Staff,998,0,999,1
1653557322139,COGS 200,A01,087991,Staff,47,0,50,3
1653557322664,COGS 201,A01,094504,Rangel; Lara M,17,0,25,8
1653557323188,COGS 203,A00,087992,Coulson; Seana M,18,0,20,2
1653557323714,COGS 210A,001,087993,Greene; Deanna Jacquelyn,9998,0,9999,1
1653557323714,COGS 210A,002,087994,Saygin; Ayse P,9999,0,9999,0
1653557323714,COGS 210A,003,087995,Xia; Haijun,9999,0,9999,0
1653557323714,COGS 210A,004,087996,Nitz; Douglas A.,9999,0,9999,0
1653557323714,COGS 210A,005,087997,Hollan; James D.,9999,0,9999,0
1653557323714,COGS 210A,006,087998,Deak; Gedeon O.,9998,0,9999,1
1653557323714,COGS 210A,007,087999,Rossano; Federico,9999,0,9999,0
1653557324237,COGS 211A,A00,088000,Coulson; Seana M,9997,0,9999,2
1653557324769,COGS 229,A00,088002,Staff,22,0,25,3
1653557325293,COGS 260,B00,094231,Staff,17,0,20,3
1653557325293,COGS 260,A00,088004,Nitz; Douglas A.,9998,0,9999,1
1653557325832,CSE 202,A00,090110,Paturi; Ramamohan,0,0,0,0
1653557325832,CSE 202,B00,090111,Paturi; Ramamohan,0,0,0,0
1653557326357,CSE 207B,A00,090112,Heninger; Nadia A,0,0,0,0
1653557326880,CSE 208,A00,094858,Micciancio; Daniele,0,0,0,0
1653557327405,CSE 210,A00,090113,Powell; Thomas Allan,0,0,0,0
1653557327928,CSE 219,A00,090898,Staff,0,0,0,0
1653557328455,CSE 221,A00,090114,Zhou; Yuan-Yuan,0,0,0,0
1653557328989,CSE 229A,A00,090115,Porter; George M,0,0,0,0
1653557329512,CSE 229C,A00,090116,Savage; Stefan,0,0,0,0
1653557330039,CSE 230,A00,090117,Jhala; Ranjit,0,0,0,0
1653557330570,CSE 232,A00,090118,Papakonstantinou; Yannis,0,0,0,0
1653557331092,CSE 239A,A00,090121,Kumar; Arun Kumar,0,0,0,0
1653557331618,CSE 239B,A00,090122,Jhala; Ranjit,0,0,0,0
1653557332142,CSE 240A,A00,090123,Zhao; Jishen,1,0,189,188
1653557332676,CSE 243A,A00,090124,Orailoglu; Alex,0,0,15,15
1653557333204,CSE 249B,A00,090125,Kahng; Andrew Byun,13,0,20,7
1653557333730,CSE 250A,A00,090126,Berg-Kirkpatrick; Taylor D,0,0,0,0
1653557334254,CSE 252A,A00,090127,Ochoa; Benjamin Lawrence,0,0,0,0
1653557334780,CSE 258,A01,090129,McAuley; Julian John,0,0,0,0
1653557335305,CSE 258R,A01,090131,McAuley; Julian John,0,0,0,0
1653557335829,CSE 274,A00,090132,Ramamoorthi; Ravi,0,0,0,0
1653557336361,CSE 276A,A00,090133,Christensen; Henrik I,0,0,0,0
1653557336886,CSE 276C,A00,090134,Christensen; Henrik I,0,0,0,0
1653557337411,CSE 290,A00,090135,Bafna; Vineet,0,0,0,0
1653557337411,CSE 290,B00,090136,Ramamoorthi; Ravi,0,0,0,0
1653557337411,CSE 290,C00,090137,Li; Tzumao,8,0,10,2
1653557337411,CSE 290,D00,090138,Zhou; Yuan-Yuan,9,0,10,1
1653557337411,CSE 290,E00,090139,Christensen; Henrik I,8,0,10,2
1653557337411,CSE 290,F00,094053,Shalev; Aaron D,0,0,0,0
1653557337944,CSE 291,A00,090140,Munyaka; Imani N. S.,0,0,0,0
1653557337944,CSE 291,B00,094880,Yu; Qi,0,0,0,0
1653557337944,CSE 291,C00,090142,Pannuto; Patrick William,0,0,0,0
1653557337944,CSE 291,D00,094881,Zhang; Yiying,0,0,0,0
1653557337944,CSE 291,E00,095118,Su; Hao,0,0,0,0
1653557338485,CSE 293,001,094905,Bafna; Vineet,9999,0,9999,0
1653557338485,CSE 293,002,094906,Bellare; Mihir,9999,0,9999,0
1653557338485,CSE 293,003,094907,Berg-Kirkpatrick; Taylor D,9999,0,9999,0
1653557338485,CSE 293,004,094908,Christensen; Henrik I,9999,0,9999,0
1653557338485,CSE 293,005,094909,Cottrell; Garrison W,9999,0,9999,0
1653557338485,CSE 293,006,094910,Deutsch; Alin Bernard,9999,0,9999,0
1653557338485,CSE 293,007,094911,Esmaeilzadeh; Hadi,9999,0,9999,0
1653557338485,CSE 293,008,094912,Freund; Yoav,9999,0,9999,0
1653557338485,CSE 293,009,094913,Griswold; William G.,9999,0,9999,0
1653557338485,CSE 293,010,094914,Gymrek; Melissa Ann,9999,0,9999,0
1653557338485,CSE 293,011,094915,Heninger; Nadia A,9999,0,9999,0
1653557338485,CSE 293,012,094916,Impagliazzo; Russell,9999,0,9999,0
1653557338485,CSE 293,013,094917,Jhala; Ranjit,9999,0,9999,0
1653557338485,CSE 293,014,094918,Kahng; Andrew Byun,9999,0,9999,0
1653557338485,CSE 293,015,094919,Kane; Daniel Mertz,9999,0,9999,0
1653557338485,CSE 293,016,094920,Kriegman; David J,9999,0,9999,0
1653557338485,CSE 293,017,094921,Kumar; Arun Kumar,9999,0,9999,0
1653557338485,CSE 293,018,094922,Lerner; Sorin,9999,0,9999,0
1653557338485,CSE 293,019,094923,Lovett; Shachar,9999,0,9999,0
1653557338485,CSE 293,020,094924,McAuley; Julian John,9999,0,9999,0
1653557338485,CSE 293,021,094925,Micciancio; Daniele,9999,0,9999,0
1653557338485,CSE 293,022,094926,Orailoglu; Alex,9999,0,9999,0
1653557338485,CSE 293,023,094927,Paturi; Ramamohan,9999,0,9999,0
1653557338485,CSE 293,024,094928,Polikarpova; Nadezhda,9999,0,9999,0
1653557338485,CSE 293,025,094929,Politz; Joseph Gibbs,9999,0,9999,0
1653557338485,CSE 293,026,094930,Porter; George M,9999,0,9999,0
1653557338485,CSE 293,027,094931,Porter; Leonard Emerson,9999,0,9999,0
1653557338485,CSE 293,028,094932,Ramamoorthi; Ravi,9999,0,9999,0
1653557338485,CSE 293,029,094933,Sahoo; Debashis,9999,0,9999,0
1653557338485,CSE 293,030,094934,Saul; Lawrence,9999,0,9999,0
1653557338485,CSE 293,031,094935,Savage; Stefan,9999,0,9999,0
1653557338485,CSE 293,032,094936,Schulze; Jurgen P.,9999,0,9999,0
1653557338485,CSE 293,033,094937,Snoeren; Alex C.,9999,0,9999,0
1653557338485,CSE 293,034,094938,Shang; Jingbo,9999,0,9999,0
1653557338485,CSE 293,035,094939,Stefan; Deian,9999,0,9999,0
1653557338485,CSE 293,036,094940,Su; Hao,9999,0,9999,0
1653557338485,CSE 293,037,094941,Swanson; Steven James,9999,0,9999,0
1653557338485,CSE 293,038,094942,Tullsen; Dean Michael,9999,0,9999,0
1653557338485,CSE 293,039,094943,Voelker; Geoffrey M.,9999,0,9999,0
1653557338485,CSE 293,040,094944,Zhao; Jishen,9999,0,9999,0
1653557338485,CSE 293,041,094945,Zhou; Yuan-Yuan,9999,0,9999,0
1653557338485,CSE 293,042,094946,Gao; Sicun,9998,0,9999,1
1653557338485,CSE 293,043,094947,Weibel; Nadir,9999,0,9999,0
1653557338485,CSE 293,044,094948,Gupta; Rajesh K.,9999,0,9999,0
1653557339014,CSE 294,A00,090143,Porter; George M,8,0,10,2
1653557339537,DSE 200,A00,091799,Staff,50,0,50,0
1653557340060,DSE 203,A00,091800,Gupta; Amarnath,30,0,30,0
1653557340583,DSE 250,A00,091801,Deutsch; Alin Bernard,30,0,30,0
1653557341108,DSE 290,A00,091802,Altintas De Callaf; Ilkay,50,0,50,0
1653557341651,ECE 200,001,091003,Antipa; Nicholas A,9999,0,9999,0
1653557341651,ECE 200,002,091004,Atanasov; Nikolay A.,9999,0,9999,0
1653557341651,ECE 200,003,091005,Bharadia; Dinesh,9999,0,9999,0
1653557341651,ECE 200,004,091006,Cheng; Chung Kuan,9999,0,9999,0
1653557341651,ECE 200,005,091007,Cosman; Pamela C.,9999,0,9999,0
1653557341651,ECE 200,006,091008,Staff,9999,0,9999,0
1653557341651,ECE 200,007,091009,Dayeh; Shadi Ahmad,9999,0,9999,0
1653557341651,ECE 200,008,091010,Fainman; Yeshaiahu,9999,0,9999,0
1653557341651,ECE 200,009,091011,Ford; Joseph Earl,9999,0,9999,0
1653557341651,ECE 200,010,091012,Franceschetti; Massimo,9999,0,9999,0
1653557341651,ECE 200,011,091013,Fullerton; Eric E,9999,0,9999,0
1653557341651,ECE 200,012,091014,Galton; Ian A,9999,0,9999,0
1653557341651,ECE 200,013,091015,Gilja; Vikash,9999,0,9999,0
1653557341651,ECE 200,014,091016,Hall; Drew A.,9999,0,9999,0
1653557341651,ECE 200,015,091017,Hsueh; Tzu-Chien,9999,0,9999,0
1653557341651,ECE 200,016,091018,Javidi; Tara,9999,0,9999,0
1653557341651,ECE 200,017,091019,Kahng; Andrew Byun,9999,0,9999,0
1653557341651,ECE 200,018,091020,Kim; Young-Han,9999,0,9999,0
1653557341651,ECE 200,019,091021,Koushanfar; Farinaz,9999,0,9999,0
1653557341651,ECE 200,020,091022,Kuzum; Duygu,9999,0,9999,0
1653557341651,ECE 200,021,091023,Le; Hanh-Phuc,9999,0,9999,0
1653557341651,ECE 200,022,091024,Lin; Bill,9999,0,9999,0
1653557341651,ECE 200,023,091025,Liu; Zhaowei,9999,0,9999,0
1653557341651,ECE 200,024,091026,Lo; Yu-Hwa,9999,0,9999,0
1653557341651,ECE 200,025,091027,Lomakin; Vitaliy,9999,0,9999,0
1653557341651,ECE 200,026,091028,Mercier; Patrick Philip,9999,0,9999,0
1653557341651,ECE 200,027,091029,Meyer; Florian,9999,0,9999,0
1653557341651,ECE 200,028,091030,Milstein; Laurence B.,9999,0,9999,0
1653557341651,ECE 200,029,091031,Mir Arabbaygi; Siavash,9999,0,9999,0
1653557341651,ECE 200,030,091032,Mookherjea; Shayan,9999,0,9999,0
1653557341651,ECE 200,031,091033,Morris; Karcher William,9999,0,9999,0
1653557341651,ECE 200,032,091034,Ng; Tse Nga,9999,0,9999,0
1653557341651,ECE 200,033,091035,Nguyen; Truong Quang,9999,0,9999,0
1653557341651,ECE 200,034,091036,Nomura; Kenji,9999,0,9999,0
1653557341651,ECE 200,035,091037,Orlitsky; Alon,9999,0,9999,0
1653557341651,ECE 200,036,091038,Pal; Piya,9999,0,9999,0
1653557341651,ECE 200,037,091039,Papen; George C.,9999,0,9999,0
1653557341651,ECE 200,038,091040,Radic; Stojan,9999,0,9999,0
1653557341651,ECE 200,039,091041,Rao; Bhaskar D.,9999,0,9999,0
1653557341651,ECE 200,040,091042,Rao; Ramesh R,9999,0,9999,0
1653557341651,ECE 200,041,091043,Rebeiz; Gabriel,9999,0,9999,0
1653557341651,ECE 200,042,091044,Sanford; John R,9999,0,9999,0
1653557341651,ECE 200,043,091045,Siegel; Paul H.,9999,0,9999,0
1653557341651,ECE 200,044,091046,Sievenpiper; Daniel F.,9999,0,9999,0
1653557341651,ECE 200,045,091047,Sworder; David D.,9999,0,9999,0
1653557341651,ECE 200,046,091048,Taur; Yuan,9999,0,9999,0
1653557341651,ECE 200,047,091049,Touri; Behrouz,9999,0,9999,0
1653557341651,ECE 200,048,091050,Trivedi; Mohan M.,9999,0,9999,0
1653557341651,ECE 200,049,091051,Vardy; Alexander,9999,0,9999,0
1653557341651,ECE 200,050,091052,Vasconcelos; Nuno,9999,0,9999,0
1653557341651,ECE 200,051,091053,Wang; Xiaolong,9999,0,9999,0
1653557341651,ECE 200,052,091054,Xie; Pengtao,9999,0,9999,0
1653557341651,ECE 200,053,091055,Yip; Michael,9999,0,9999,0
1653557341651,ECE 200,054,091056,Zeger; Kenneth A.,9999,0,9999,0
1653557341651,ECE 200,055,091057,Zhang; Xinyu,9999,0,9999,0
1653557341651,ECE 200,056,091058,Turakhia; Yatish Girish,9999,0,9999,0
1653557341651,ECE 200,057,091059,Kang; Mingu,9999,0,9999,0
1653557341651,ECE 200,058,091060,Shi; Yuanyuan,9999,0,9999,0
1653557341651,ECE 200,059,091061,Wang; Edward Jay,9999,0,9999,0
1653557341651,ECE 200,060,091062,Zheng; Yang,9999,0,9999,0
1653557342179,ECE 201,A00,095526,Lo; Yu-Hwa,0,0,0,0
1653557342708,ECE 203,A00,091065,Mercier; Patrick Philip,0,0,0,0
1653557343233,ECE 207A,A00,091605,Liu; Thomas Tao-Ming,0,0,0,0
1653557343761,ECE 212AN,A00,091068,Nomura; Kenji,0,0,0,0
1653557344287,ECE 222A,A00,091069,Rebeiz; Gabriel,0,0,0,0
1653557344814,ECE 225A,A00,091070,Orlitsky; Alon,0,0,0,0
1653557345338,ECE 230A,A00,091071,Nomura; Kenji,0,0,0,0
1653557345866,ECE 236A,A00,091072,Dayeh; Shadi Ahmad,0,0,0,0
1653557346393,ECE 238A,A00,091073,Luo; Jian,0,0,0,0
1653557346393,ECE 238A,B00,091074,Luo; Jian,0,0,0,0
1653557346919,ECE 240A,A00,091075,Radic; Stojan,0,0,0,0
1653557347442,ECE 247A,A00,091592,Shi; Lingyan,0,0,0,0
1653557347965,ECE 250,A00,091076,Touri; Behrouz,0,0,0,0
1653557348487,ECE 251C,A00,091078,Nguyen; Truong Quang,0,0,0,0
1653557349015,ECE 253,A00,091079,Cosman; Pamela C.,0,0,0,0
1653557349539,ECE 255A,A00,091080,Orlitsky; Alon,0,0,0,0
1653557350062,ECE 257A,A00,091081,Zhang; Xinyu,0,0,0,0
1653557350589,ECE 260A,A01,091084,Eldon; John,0,0,0,0
1653557351113,ECE 264C,A00,091085,Galton; Ian A,0,0,0,0
1653557351637,ECE 265C,A00,094889,Presti; Calogero Davide,0,0,0,9
1653557352160,ECE 266,A01,091087,Hall; Drew A.,0,0,0,0
1653557353208,ECE 271A,A00,091090,Vasconcelos; Nuno,0,0,0,0
1653557353731,ECE 272B,A00,091091,Sworder; David D.,0,0,0,0
1653557354258,ECE 275A,A00,091092,Meyer; Florian,0,0,0,0
1653557354781,ECE 277,A00,091093,An; Cheolhong,0,0,0,0
1653557355307,ECE 283,A00,091094,Le; Hanh-Phuc,0,0,0,0
1653557355831,ECE 284,A00,091095,Kang; Mingu,0,0,0,0
1653557355831,ECE 284,B00,091096,Wang; Edward Jay,0,0,0,0
1653557356354,ECE 285,A00,094334,Touri; Behrouz,0,0,0,0
1653557356878,ECE 289,A00,091097,Whelan; David Arthur,0,0,0,0
1653557357405,MATH 200A,A00,087414,Salehi Golsefidy; Alireza,7,0,8,1
1653557357932,MATH 202A,A00,087415,Gill; Philip E.,2,0,8,6
1653557358460,MATH 203A,A00,087416,Oprea; Dragos N.,6,0,8,2
1653557358986,MATH 204A,A00,087417,Kedlaya; Kiran S.,6,0,8,2
1653557359508,MATH 205,A00,087418,Sorensen; Claus M,6,0,8,2
1653557360039,MATH 206A,A00,087419,Izadi; Elham,7,0,8,1
1653557360566,MATH 207A,A00,087420,Mohammadi; Amir,5,0,8,3
1653557361091,MATH 208,A00,087421,Staff,9,0,10,1
1653557361616,MATH 209,A00,087422,Staff,10,0,10,0
1653557362146,MATH 218,A00,087423,Staff,10,0,10,0
1653557362680,MATH 220A,A00,087424,Novak; Jonathan I,6,0,8,2
1653557363205,MATH 231A,A00,087425,Bejenaru; Ioan,3,0,8,5
1653557363730,MATH 240A,A00,087426,Ebenfelt; Peter F,5,0,8,3
1653557364353,MATH 243,A00,087427,Staff,9,0,10,1
1653557364875,MATH 248,A00,087429,Staff,10,0,10,0
1653557365398,MATH 250A,A00,087430,Spolaor; Luca,4,0,8,4
1653557365922,MATH 257A,A00,087431,Spolaor; Luca,7,0,8,1
1653557366445,MATH 258,A00,087432,Staff,9,0,10,1
1653557366968,MATH 264A,A00,087433,Warnke; Lutz Peter,5,0,8,3
1653557367492,MATH 268,A00,087434,Staff,15,0,15,0
1653557368014,MATH 269,A00,087435,Staff,14,0,15,1
1653557368547,MATH 270A,A00,087436,Nie; Jiawang,0,0,8,8
1653557369070,MATH 272A,A00,087437,Tian; Xiaochuan,1,0,8,7
1653557369593,MATH 274,A01,087439,Cheng; Li-Tien,9,0,10,1
1653557369593,MATH 274,A02,087440,Cheng; Li-Tien,10,0,10,0
1653557370119,MATH 278A,A00,087441,Staff,8,0,10,2
1653557370646,MATH 278B,A00,087442,Staff,8,0,10,2
1653557371171,MATH 278C,A00,087443,Staff,8,0,10,2
1653557371694,MATH 280A,A00,087444,Zheng; Tianyi,0,0,8,8
1653557372219,MATH 281A,A00,087445,Bradic; Jelena,0,0,8,8
1653557372745,MATH 282A,A00,087446,Zhang; Danna,0,0,8,8
1653557373268,MATH 283,A00,087447,Tesler; Glenn,0,0,0,15
1653557373792,MATH 286,A00,087448,Kemp; Todd Aahron,5,0,8,3
1653557374318,MATH 287D,A00,087449,Bradic; Jelena,0,0,0,1
1653557374840,MATH 288,A00,087450,Staff,14,0,15,1
1653557374840,MATH 288,B00,087451,Staff,15,0,15,0
1653557374840,MATH 288,C00,087452,Staff,15,0,15,0
1653557375364,MATH 290A,A00,087453,Xu; Zhouli,6,0,8,2
1653557375887,MATH 291A,A00,087454,Xu; Zhouli,7,0,8,1
1653557376409,MATH 292,A00,087455,Staff,10,0,10,0
1653557376934,MATH 295,A00,087456,Staff,50,0,50,0
1653557377457,MATH 297,001,087457,Staff,998,0,999,1
1653557936845,COGS 200,A01,087991,Staff,47,0,50,3
1653557937370,COGS 201,A01,094504,Rangel; Lara M,17,0,25,8
1653557937895,COGS 203,A00,087992,Coulson; Seana M,18,0,20,2
1653557938418,COGS 210A,001,087993,Greene; Deanna Jacquelyn,9998,0,9999,1
1653557938418,COGS 210A,002,087994,Saygin; Ayse P,9999,0,9999,0
1653557938418,COGS 210A,003,087995,Xia; Haijun,9999,0,9999,0
1653557938418,COGS 210A,004,087996,Nitz; Douglas A.,9999,0,9999,0
1653557938418,COGS 210A,005,087997,Hollan; James D.,9999,0,9999,0
1653557938418,COGS 210A,006,087998,Deak; Gedeon O.,9998,0,9999,1
1653557938418,COGS 210A,007,087999,Rossano; Federico,9999,0,9999,0
1653557938940,COGS 211A,A00,088000,Coulson; Seana M,9997,0,9999,2
1653557939464,COGS 229,A00,088002,Staff,22,0,25,3
1653557939987,COGS 260,B00,094231,Staff,17,0,20,3
1653557939987,COGS 260,A00,088004,Nitz; Douglas A.,9998,0,9999,1
1653557940512,CSE 202,A00,090110,Paturi; Ramamohan,0,0,0,0
1653557940512,CSE 202,B00,090111,Paturi; Ramamohan,0,0,0,0
1653557941035,CSE 207B,A00,090112,Heninger; Nadia A,0,0,0,0
1653557941571,CSE 208,A00,094858,Micciancio; Daniele,0,0,0,0
1653557942097,CSE 210,A00,090113,Powell; Thomas Allan,0,0,0,0
1653557942625,CSE 219,A00,090898,Staff,0,0,0,0
1653557943152,CSE 221,A00,090114,Zhou; Yuan-Yuan,0,0,0,0
1653557943677,CSE 229A,A00,090115,Porter; George M,0,0,0,0
1653557944205,CSE 229C,A00,090116,Savage; Stefan,0,0,0,0
1653557944728,CSE 230,A00,090117,Jhala; Ranjit,0,0,0,0
1653557945258,CSE 232,A00,090118,Papakonstantinou; Yannis,0,0,0,0
1653557945786,CSE 239A,A00,090121,Kumar; Arun Kumar,0,0,0,0
1653557946310,CSE 239B,A00,090122,Jhala; Ranjit,0,0,0,0
1653557946833,CSE 240A,A00,090123,Zhao; Jishen,1,0,189,188
1653557947359,CSE 243A,A00,090124,Orailoglu; Alex,0,0,15,15
1653557947884,CSE 249B,A00,090125,Kahng; Andrew Byun,13,0,20,7
1653557948407,CSE 250A,A00,090126,Berg-Kirkpatrick; Taylor D,0,0,0,0
1653557948930,CSE 252A,A00,090127,Ochoa; Benjamin Lawrence,0,0,0,0
1653557949453,CSE 258,A01,090129,McAuley; Julian John,0,0,0,0
1653557949976,CSE 258R,A01,090131,McAuley; Julian John,0,0,0,0
1653557950500,CSE 274,A00,090132,Ramamoorthi; Ravi,0,0,0,0
1653557951115,CSE 276A,A00,090133,Christensen; Henrik I,0,0,0,0
1653557951645,CSE 276C,A00,090134,Christensen; Henrik I,0,0,0,0
1653557952169,CSE 290,A00,090135,Bafna; Vineet,0,0,0,0
1653557952169,CSE 290,B00,090136,Ramamoorthi; Ravi,0,0,0,0
1653557952169,CSE 290,C00,090137,Li; Tzumao,8,0,10,2
1653557952169,CSE 290,D00,090138,Zhou; Yuan-Yuan,9,0,10,1
1653557952169,CSE 290,E00,090139,Christensen; Henrik I,8,0,10,2
1653557952169,CSE 290,F00,094053,Shalev; Aaron D,0,0,0,0
1653557952693,CSE 291,A00,090140,Munyaka; Imani N. S.,0,0,0,0
1653557952693,CSE 291,B00,094880,Yu; Qi,0,0,0,0
1653557952693,CSE 291,C00,090142,Pannuto; Patrick William,0,0,0,0
1653557952693,CSE 291,D00,094881,Zhang; Yiying,0,0,0,0
1653557952693,CSE 291,E00,095118,Su; Hao,0,0,0,0
1653557953222,CSE 293,001,094905,Bafna; Vineet,9999,0,9999,0
1653557953222,CSE 293,002,094906,Bellare; Mihir,9999,0,9999,0
1653557953222,CSE 293,003,094907,Berg-Kirkpatrick; Taylor D,9999,0,9999,0
1653557953222,CSE 293,004,094908,Christensen; Henrik I,9999,0,9999,0
1653557953222,CSE 293,005,094909,Cottrell; Garrison W,9999,0,9999,0
1653557953222,CSE 293,006,094910,Deutsch; Alin Bernard,9999,0,9999,0
1653557953222,CSE 293,007,094911,Esmaeilzadeh; Hadi,9999,0,9999,0
1653557953222,CSE 293,008,094912,Freund; Yoav,9999,0,9999,0
1653557953222,CSE 293,009,094913,Griswold; William G.,9999,0,9999,0
1653557953222,CSE 293,010,094914,Gymrek; Melissa Ann,9999,0,9999,0
1653557953222,CSE 293,011,094915,Heninger; Nadia A,9999,0,9999,0
1653557953222,CSE 293,012,094916,Impagliazzo; Russell,9999,0,9999,0
1653557953222,CSE 293,013,094917,Jhala; Ranjit,9999,0,9999,0
1653557953222,CSE 293,014,094918,Kahng; Andrew Byun,9999,0,9999,0
1653557953222,CSE 293,015,094919,Kane; Daniel Mertz,9999,0,9999,0
1653557953222,CSE 293,016,094920,Kriegman; David J,9999,0,9999,0
1653557953222,CSE 293,017,094921,Kumar; Arun Kumar,9999,0,9999,0
1653557953222,CSE 293,018,094922,Lerner; Sorin,9999,0,9999,0
1653557953222,CSE 293,019,094923,Lovett; Shachar,9999,0,9999,0
1653557953222,CSE 293,020,094924,McAuley; Julian John,9999,0,9999,0
1653557953222,CSE 293,021,094925,Micciancio; Daniele,9999,0,9999,0
1653557953222,CSE 293,022,094926,Orailoglu; Alex,9999,0,9999,0
1653557953222,CSE 293,023,094927,Paturi; Ramamohan,9999,0,9999,0
1653557953222,CSE 293,024,094928,Polikarpova; Nadezhda,9999,0,9999,0
1653557953222,CSE 293,025,094929,Politz; Joseph Gibbs,9999,0,9999,0
1653557953222,CSE 293,026,094930,Porter; George M,9999,0,9999,0
1653557953222,CSE 293,027,094931,Porter; Leonard Emerson,9999,0,9999,0
1653557953222,CSE 293,028,094932,Ramamoorthi; Ravi,9999,0,9999,0
1653557953222,CSE 293,029,094933,Sahoo; Debashis,9999,0,9999,0
1653557953222,CSE 293,030,094934,Saul; Lawrence,9999,0,9999,0
1653557953222,CSE 293,031,094935,Savage; Stefan,9999,0,9999,0
1653557953222,CSE 293,032,094936,Schulze; Jurgen P.,9999,0,9999,0
1653557953222,CSE 293,033,094937,Snoeren; Alex C.,9999,0,9999,0
1653557953222,CSE 293,034,094938,Shang; Jingbo,9999,0,9999,0
1653557953222,CSE 293,035,094939,Stefan; Deian,9999,0,9999,0
1653557953222,CSE 293,036,094940,Su; Hao,9999,0,9999,0
1653557953222,CSE 293,037,094941,Swanson; Steven James,9999,0,9999,0
1653557953222,CSE 293,038,094942,Tullsen; Dean Michael,9999,0,9999,0
1653557953222,CSE 293,039,094943,Voelker; Geoffrey M.,9999,0,9999,0
1653557953222,CSE 293,040,094944,Zhao; Jishen,9999,0,9999,0
1653557953222,CSE 293,041,094945,Zhou; Yuan-Yuan,9999,0,9999,0
1653557953222,CSE 293,042,094946,Gao; Sicun,9998,0,9999,1
1653557953222,CSE 293,043,094947,Weibel; Nadir,9999,0,9999,0
1653557953222,CSE 293,044,094948,Gupta; Rajesh K.,9999,0,9999,0
1653557953744,CSE 294,A00,090143,Porter; George M,8,0,10,2
1653557954270,DSE 200,A00,091799,Staff,50,0,50,0
1653557954796,DSE 203,A00,091800,Gupta; Amarnath,30,0,30,0
1653557955319,DSE 250,A00,091801,Deutsch; Alin Bernard,30,0,30,0
1653557955843,DSE 290,A00,091802,Altintas De Callaf; Ilkay,50,0,50,0
1653557956375,ECE 200,001,091003,Antipa; Nicholas A,9999,0,9999,0
1653557956375,ECE 200,002,091004,Atanasov; Nikolay A.,9999,0,9999,0
1653557956375,ECE 200,003,091005,Bharadia; Dinesh,9999,0,9999,0
1653557956375,ECE 200,004,091006,Cheng; Chung Kuan,9999,0,9999,0
1653557956375,ECE 200,005,091007,Cosman; Pamela C.,9999,0,9999,0
1653557956375,ECE 200,006,091008,Staff,9999,0,9999,0
1653557956375,ECE 200,007,091009,Dayeh; Shadi Ahmad,9999,0,9999,0
1653557956375,ECE 200,008,091010,Fainman; Yeshaiahu,9999,0,9999,0
1653557956375,ECE 200,009,091011,Ford; Joseph Earl,9999,0,9999,0
1653557956375,ECE 200,010,091012,Franceschetti; Massimo,9999,0,9999,0
1653557956375,ECE 200,011,091013,Fullerton; Eric E,9999,0,9999,0
1653557956375,ECE 200,012,091014,Galton; Ian A,9999,0,9999,0
1653557956375,ECE 200,013,091015,Gilja; Vikash,9999,0,9999,0
1653557956375,ECE 200,014,091016,Hall; Drew A.,9999,0,9999,0
1653557956375,ECE 200,015,091017,Hsueh; Tzu-Chien,9999,0,9999,0
1653557956375,ECE 200,016,091018,Javidi; Tara,9999,0,9999,0
1653557956375,ECE 200,017,091019,Kahng; Andrew Byun,9999,0,9999,0
1653557956375,ECE 200,018,091020,Kim; Young-Han,9999,0,9999,0
1653557956375,ECE 200,019,091021,Koushanfar; Farinaz,9999,0,9999,0
1653557956375,ECE 200,020,091022,Kuzum; Duygu,9999,0,9999,0
1653557956375,ECE 200,021,091023,Le; Hanh-Phuc,9999,0,9999,0
1653557956375,ECE 200,022,091024,Lin; Bill,9999,0,9999,0
1653557956375,ECE 200,023,091025,Liu; Zhaowei,9999,0,9999,0
1653557956375,ECE 200,024,091026,Lo; Yu-Hwa,9999,0,9999,0
1653557956375,ECE 200,025,091027,Lomakin; Vitaliy,9999,0,9999,0
1653557956375,ECE 200,026,091028,Mercier; Patrick Philip,9999,0,9999,0
1653557956375,ECE 200,027,091029,Meyer; Florian,9999,0,9999,0
1653557956375,ECE 200,028,091030,Milstein; Laurence B.,9999,0,9999,0
1653557956375,ECE 200,029,091031,Mir Arabbaygi; Siavash,9999,0,9999,0
1653557956375,ECE 200,030,091032,Mookherjea; Shayan,9999,0,9999,0
1653557956375,ECE 200,031,091033,Morris; Karcher William,9999,0,9999,0
1653557956375,ECE 200,032,091034,Ng; Tse Nga,9999,0,9999,0
1653557956375,ECE 200,033,091035,Nguyen; Truong Quang,9999,0,9999,0
1653557956375,ECE 200,034,091036,Nomura; Kenji,9999,0,9999,0
1653557956375,ECE 200,035,091037,Orlitsky; Alon,9999,0,9999,0
1653557956375,ECE 200,036,091038,Pal; Piya,9999,0,9999,0
1653557956375,ECE 200,037,091039,Papen; George C.,9999,0,9999,0
1653557956375,ECE 200,038,091040,Radic; Stojan,9999,0,9999,0
1653557956375,ECE 200,039,091041,Rao; Bhaskar D.,9999,0,9999,0
1653557956375,ECE 200,040,091042,Rao; Ramesh R,9999,0,9999,0
1653557956375,ECE 200,041,091043,Rebeiz; Gabriel,9999,0,9999,0
1653557956375,ECE 200,042,091044,Sanford; John R,9999,0,9999,0
1653557956375,ECE 200,043,091045,Siegel; Paul H.,9999,0,9999,0
1653557956375,ECE 200,044,091046,Sievenpiper; Daniel F.,9999,0,9999,0
1653557956375,ECE 200,045,091047,Sworder; David D.,9999,0,9999,0
1653557956375,ECE 200,046,091048,Taur; Yuan,9999,0,9999,0
1653557956375,ECE 200,047,091049,Touri; Behrouz,9999,0,9999,0
1653557956375,ECE 200,048,091050,Trivedi; Mohan M.,9999,0,9999,0
1653557956375,ECE 200,049,091051,Vardy; Alexander,9999,0,9999,0
1653557956375,ECE 200,050,091052,Vasconcelos; Nuno,9999,0,9999,0
1653557956375,ECE 200,051,091053,Wang; Xiaolong,9999,0,9999,0
1653557956375,ECE 200,052,091054,Xie; Pengtao,9999,0,9999,0
1653557956375,ECE 200,053,091055,Yip; Michael,9999,0,9999,0
1653557956375,ECE 200,054,091056,Zeger; Kenneth A.,9999,0,9999,0
1653557956375,ECE 200,055,091057,Zhang; Xinyu,9999,0,9999,0
1653557956375,ECE 200,056,091058,Turakhia; Yatish Girish,9999,0,9999,0
1653557956375,ECE 200,057,091059,Kang; Mingu,9999,0,9999,0
1653557956375,ECE 200,058,091060,Shi; Yuanyuan,9999,0,9999,0
1653557956375,ECE 200,059,091061,Wang; Edward Jay,9999,0,9999,0
1653557956375,ECE 200,060,091062,Zheng; Yang,9999,0,9999,0
1653557956902,ECE 201,A00,095526,Lo; Yu-Hwa,0,0,0,0
1653557957425,ECE 203,A00,091065,Mercier; Patrick Philip,0,0,0,0
1653557957948,ECE 207A,A00,091605,Liu; Thomas Tao-Ming,0,0,0,0
1653557958474,ECE 212AN,A00,091068,Nomura; Kenji,0,0,0,0
1653557958997,ECE 222A,A00,091069,Rebeiz; Gabriel,0,0,0,0
1653557959523,ECE 225A,A00,091070,Orlitsky; Alon,0,0,0,0
1653557960046,ECE 230A,A00,091071,Nomura; Kenji,0,0,0,0
1653557960570,ECE 236A,A00,091072,Dayeh; Shadi Ahmad,0,0,0,0
1653557961094,ECE 238A,A00,091073,Luo; Jian,0,0,0,0
1653557961094,ECE 238A,B00,091074,Luo; Jian,0,0,0,0
1653557961619,ECE 240A,A00,091075,Radic; Stojan,0,0,0,0
1653557962143,ECE 247A,A00,091592,Shi; Lingyan,0,0,0,0
1653557962665,ECE 250,A00,091076,Touri; Behrouz,0,0,0,0
1653557963191,ECE 251C,A00,091078,Nguyen; Truong Quang,0,0,0,0
1653557963718,ECE 253,A00,091079,Cosman; Pamela C.,0,0,0,0
1653557964240,ECE 255A,A00,091080,Orlitsky; Alon,0,0,0,0
1653557964764,ECE 257A,A00,091081,Zhang; Xinyu,0,0,0,0
1653557965291,ECE 260A,A01,091084,Eldon; John,0,0,0,0
1653557965821,ECE 264C,A00,091085,Galton; Ian A,0,0,0,0
1653557966347,ECE 265C,A00,094889,Presti; Calogero Davide,0,0,0,9
1653557966871,ECE 266,A01,091087,Hall; Drew A.,0,0,0,0
1653557967922,ECE 271A,A00,091090,Vasconcelos; Nuno,0,0,0,0
1653557968445,ECE 272B,A00,091091,Sworder; David D.,0,0,0,0
1653557968971,ECE 275A,A00,091092,Meyer; Florian,0,0,0,0
1653557969495,ECE 277,A00,091093,An; Cheolhong,0,0,0,0
1653557970022,ECE 283,A00,091094,Le; Hanh-Phuc,0,0,0,0
1653557970547,ECE 284,A00,091095,Kang; Mingu,0,0,0,0
1653557970547,ECE 284,B00,091096,Wang; Edward Jay,0,0,0,0
1653557971074,ECE 285,A00,094334,Touri; Behrouz,0,0,0,0
1653557971597,ECE 289,A00,091097,Whelan; David Arthur,0,0,0,0
1653557972124,MATH 200A,A00,087414,Salehi Golsefidy; Alireza,7,0,8,1
1653557972651,MATH 202A,A00,087415,Gill; Philip E.,2,0,8,6
1653557973178,MATH 203A,A00,087416,Oprea; Dragos N.,6,0,8,2
1653557973701,MATH 204A,A00,087417,Kedlaya; Kiran S.,6,0,8,2
1653557974228,MATH 205,A00,087418,Sorensen; Claus M,6,0,8,2
1653557974764,MATH 206A,A00,087419,Izadi; Elham,7,0,8,1
1653557975286,MATH 207A,A00,087420,Mohammadi; Amir,5,0,8,3
1653557975809,MATH 208,A00,087421,Staff,9,0,10,1
1653557976334,MATH 209,A00,087422,Staff,10,0,10,0
1653557976856,MATH 218,A00,087423,Staff,10,0,10,0
1653557977388,MATH 220A,A00,087424,Novak; Jonathan I,6,0,8,2
1653557977920,MATH 231A,A00,087425,Bejenaru; Ioan,3,0,8,5
1653557978448,MATH 240A,A00,087426,Ebenfelt; Peter F,5,0,8,3
1653557978970,MATH 243,A00,087427,Staff,9,0,10,1
1653557979494,MATH 248,A00,087429,Staff,10,0,10,0
1653557980018,MATH 250A,A00,087430,Spolaor; Luca,4,0,8,4
1653557980542,MATH 257A,A00,087431,Spolaor; Luca,7,0,8,1
1653557981067,MATH 258,A00,087432,Staff,9,0,10,1
1653557981593,MATH 264A,A00,087433,Warnke; Lutz Peter,5,0,8,3
1653557982116,MATH 268,A00,087434,Staff,15,0,15,0
1653557982642,MATH 269,A00,087435,Staff,14,0,15,1
1653557983166,MATH 270A,A00,087436,Nie; Jiawang,0,0,8,8
1653557983692,MATH 272A,A00,087437,Tian; Xiaochuan,1,0,8,7
1653557984218,MATH 274,A01,087439,Cheng; Li-Tien,9,0,10,1
1653557984218,MATH 274,A02,087440,Cheng; Li-Tien,10,0,10,0
1653557984741,MATH 278A,A00,087441,Staff,8,0,10,2
1653557985263,MATH 278B,A00,087442,Staff,8,0,10,2
1653557985786,MATH 278C,A00,087443,Staff,8,0,10,2
1653557986311,MATH 280A,A00,087444,Zheng; Tianyi,0,0,8,8
1653557986838,MATH 281A,A00,087445,Bradic; Jelena,0,0,8,8
1653557987365,MATH 282A,A00,087446,Zhang; Danna,0,0,8,8
1653557987888,MATH 283,A00,087447,Tesler; Glenn,0,0,0,15
1653557988414,MATH 286,A00,087448,Kemp; Todd Aahron,5,0,8,3
1653557988937,MATH 287D,A00,087449,Bradic; Jelena,0,0,0,1
1653557989460,MATH 288,A00,087450,Staff,14,0,15,1
1653557989460,MATH 288,B00,087451,Staff,15,0,15,0
1653557989460,MATH 288,C00,087452,Staff,15,0,15,0
1653557989985,MATH 290A,A00,087453,Xu; Zhouli,6,0,8,2
1653557990508,MATH 291A,A00,087454,Xu; Zhouli,7,0,8,1
1653557991034,MATH 292,A00,087455,Staff,10,0,10,0
1653557991558,MATH 295,A00,087456,Staff,50,0,50,0
1653557992083,MATH 297,001,087457,Staff,998,0,999,1
1653558551421,COGS 200,A01,087991,Staff,47,0,50,3
1653558551946,COGS 201,A01,094504,Rangel; Lara M,17,0,25,8
1653558552468,COGS 203,A00,087992,Coulson; Seana M,18,0,20,2
1653558552998,COGS 210A,001,087993,Greene; Deanna Jacquelyn,9998,0,9999,1
1653558552998,COGS 210A,002,087994,Saygin; Ayse P,9999,0,9999,0
1653558552998,COGS 210A,003,087995,Xia; Haijun,9999,0,9999,0
1653558552998,COGS 210A,004,087996,Nitz; Douglas A.,9999,0,9999,0
1653558552998,COGS 210A,005,087997,Hollan; James D.,9999,0,9999,0
1653558552998,COGS 210A,006,087998,Deak; Gedeon O.,9998,0,9999,1
1653558552998,COGS 210A,007,087999,Rossano; Federico,9999,0,9999,0
1653558553521,COGS 211A,A00,088000,Coulson; Seana M,9997,0,9999,2
1653558554046,COGS 229,A00,088002,Staff,22,0,25,3
1653558554569,COGS 260,B00,094231,Staff,17,0,20,3
1653558554569,COGS 260,A00,088004,Nitz; Douglas A.,9998,0,9999,1
1653558555095,CSE 202,A00,090110,Paturi; Ramamohan,0,0,0,0
1653558555095,CSE 202,B00,090111,Paturi; Ramamohan,0,0,0,0
1653558555624,CSE 207B,A00,090112,Heninger; Nadia A,0,0,0,0
1653558556147,CSE 208,A00,094858,Micciancio; Daniele,0,0,0,0
1653558556676,CSE 210,A00,090113,Powell; Thomas Allan,0,0,0,0
1653558557199,CSE 219,A00,090898,Staff,0,0,0,0
1653558557721,CSE 221,A00,090114,Zhou; Yuan-Yuan,0,0,0,0
1653558558243,CSE 229A,A00,090115,Porter; George M,0,0,0,0
1653558558769,CSE 229C,A00,090116,Savage; Stefan,0,0,0,0
1653558559292,CSE 230,A00,090117,Jhala; Ranjit,0,0,0,0
1653558559814,CSE 232,A00,090118,Papakonstantinou; Yannis,0,0,0,0
1653558560338,CSE 239A,A00,090121,Kumar; Arun Kumar,0,0,0,0
1653558560863,CSE 239B,A00,090122,Jhala; Ranjit,0,0,0,0
1653558561387,CSE 240A,A00,090123,Zhao; Jishen,1,0,189,188
1653558561910,CSE 243A,A00,090124,Orailoglu; Alex,0,0,15,15
1653558562434,CSE 249B,A00,090125,Kahng; Andrew Byun,13,0,20,7
1653558562956,CSE 250A,A00,090126,Berg-Kirkpatrick; Taylor D,0,0,0,0
1653558563486,CSE 252A,A00,090127,Ochoa; Benjamin Lawrence,0,0,0,0
1653558564010,CSE 258,A01,090129,McAuley; Julian John,0,0,0,0
1653558564533,CSE 258R,A01,090131,McAuley; Julian John,0,0,0,0
1653558565056,CSE 274,A00,090132,Ramamoorthi; Ravi,0,0,0,0
1653558565583,CSE 276A,A00,090133,Christensen; Henrik I,0,0,0,0
1653558566107,CSE 276C,A00,090134,Christensen; Henrik I,0,0,0,0
1653558566630,CSE 290,A00,090135,Bafna; Vineet,0,0,0,0
1653558566630,CSE 290,B00,090136,Ramamoorthi; Ravi,0,0,0,0
1653558566630,CSE 290,C00,090137,Li; Tzumao,8,0,10,2
1653558566630,CSE 290,D00,090138,Zhou; Yuan-Yuan,9,0,10,1
1653558566630,CSE 290,E00,090139,Christensen; Henrik I,8,0,10,2
1653558566630,CSE 290,F00,094053,Shalev; Aaron D,0,0,0,0
1653558567153,CSE 291,A00,090140,Munyaka; Imani N. S.,0,0,0,0
1653558567153,CSE 291,B00,094880,Yu; Qi,0,0,0,0
1653558567153,CSE 291,C00,090142,Pannuto; Patrick William,0,0,0,0
1653558567153,CSE 291,D00,094881,Zhang; Yiying,0,0,0,0
1653558567153,CSE 291,E00,095118,Su; Hao,0,0,0,0
1653558567680,CSE 293,001,094905,Bafna; Vineet,9999,0,9999,0
1653558567680,CSE 293,002,094906,Bellare; Mihir,9999,0,9999,0
1653558567680,CSE 293,003,094907,Berg-Kirkpatrick; Taylor D,9999,0,9999,0
1653558567680,CSE 293,004,094908,Christensen; Henrik I,9999,0,9999,0
1653558567680,CSE 293,005,094909,Cottrell; Garrison W,9999,0,9999,0
1653558567680,CSE 293,006,094910,Deutsch; Alin Bernard,9999,0,9999,0
1653558567680,CSE 293,007,094911,Esmaeilzadeh; Hadi,9999,0,9999,0
1653558567680,CSE 293,008,094912,Freund; Yoav,9999,0,9999,0
1653558567680,CSE 293,009,094913,Griswold; William G.,9999,0,9999,0
1653558567680,CSE 293,010,094914,Gymrek; Melissa Ann,9999,0,9999,0
1653558567680,CSE 293,011,094915,Heninger; Nadia A,9999,0,9999,0
1653558567680,CSE 293,012,094916,Impagliazzo; Russell,9999,0,9999,0
1653558567680,CSE 293,013,094917,Jhala; Ranjit,9999,0,9999,0
1653558567680,CSE 293,014,094918,Kahng; Andrew Byun,9999,0,9999,0
1653558567680,CSE 293,015,094919,Kane; Daniel Mertz,9999,0,9999,0
1653558567680,CSE 293,016,094920,Kriegman; David J,9999,0,9999,0
1653558567680,CSE 293,017,094921,Kumar; Arun Kumar,9999,0,9999,0
1653558567680,CSE 293,018,094922,Lerner; Sorin,9999,0,9999,0
1653558567680,CSE 293,019,094923,Lovett; Shachar,9999,0,9999,0
1653558567680,CSE 293,020,094924,McAuley; Julian John,9999,0,9999,0
1653558567680,CSE 293,021,094925,Micciancio; Daniele,9999,0,9999,0
1653558567680,CSE 293,022,094926,Orailoglu; Alex,9999,0,9999,0
1653558567680,CSE 293,023,094927,Paturi; Ramamohan,9999,0,9999,0
1653558567680,CSE 293,024,094928,Polikarpova; Nadezhda,9999,0,9999,0
1653558567680,CSE 293,025,094929,Politz; Joseph Gibbs,9999,0,9999,0
1653558567680,CSE 293,026,094930,Porter; George M,9999,0,9999,0
1653558567680,CSE 293,027,094931,Porter; Leonard Emerson,9999,0,9999,0
1653558567680,CSE 293,028,094932,Ramamoorthi; Ravi,9999,0,9999,0
1653558567680,CSE 293,029,094933,Sahoo; Debashis,9999,0,9999,0
1653558567680,CSE 293,030,094934,Saul; Lawrence,9999,0,9999,0
1653558567680,CSE 293,031,094935,Savage; Stefan,9999,0,9999,0
1653558567680,CSE 293,032,094936,Schulze; Jurgen P.,9999,0,9999,0
1653558567680,CSE 293,033,094937,Snoeren; Alex C.,9999,0,9999,0
1653558567680,CSE 293,034,094938,Shang; Jingbo,9999,0,9999,0
1653558567680,CSE 293,035,094939,Stefan; Deian,9999,0,9999,0
1653558567680,CSE 293,036,094940,Su; Hao,9999,0,9999,0
1653558567680,CSE 293,037,094941,Swanson; Steven James,9999,0,9999,0
1653558567680,CSE 293,038,094942,Tullsen; Dean Michael,9999,0,9999,0
1653558567680,CSE 293,039,094943,Voelker; Geoffrey M.,9999,0,9999,0
1653558567680,CSE 293,040,094944,Zhao; Jishen,9999,0,9999,0
1653558567680,CSE 293,041,094945,Zhou; Yuan-Yuan,9999,0,9999,0
1653558567680,CSE 293,042,094946,Gao; Sicun,9998,0,9999,1
1653558567680,CSE 293,043,094947,Weibel; Nadir,9999,0,9999,0
1653558567680,CSE 293,044,094948,Gupta; Rajesh K.,9999,0,9999,0
1653558568206,CSE 294,A00,090143,Porter; George M,8,0,10,2
1653558568731,DSE 200,A00,091799,Staff,50,0,50,0
1653558569258,DSE 203,A00,091800,Gupta; Amarnath,30,0,30,0
1653558569781,DSE 250,A00,091801,Deutsch; Alin Bernard,30,0,30,0
1653558570303,DSE 290,A00,091802,Altintas De Callaf; Ilkay,50,0,50,0
1653558570840,ECE 200,001,091003,Antipa; Nicholas A,9999,0,9999,0
1653558570840,ECE 200,002,091004,Atanasov; Nikolay A.,9999,0,9999,0
1653558570840,ECE 200,003,091005,Bharadia; Dinesh,9999,0,9999,0
1653558570840,ECE 200,004,091006,Cheng; Chung Kuan,9999,0,9999,0
1653558570840,ECE 200,005,091007,Cosman; Pamela C.,9999,0,9999,0
1653558570840,ECE 200,006,091008,Staff,9999,0,9999,0
1653558570840,ECE 200,007,091009,Dayeh; Shadi Ahmad,9999,0,9999,0
1653558570840,ECE 200,008,091010,Fainman; Yeshaiahu,9999,0,9999,0
1653558570840,ECE 200,009,091011,Ford; Joseph Earl,9999,0,9999,0
1653558570840,ECE 200,010,091012,Franceschetti; Massimo,9999,0,9999,0
1653558570840,ECE 200,011,091013,Fullerton; Eric E,9999,0,9999,0
1653558570840,ECE 200,012,091014,Galton; Ian A,9999,0,9999,0
1653558570840,ECE 200,013,091015,Gilja; Vikash,9999,0,9999,0
1653558570840,ECE 200,014,091016,Hall; Drew A.,9999,0,9999,0
1653558570840,ECE 200,015,091017,Hsueh; Tzu-Chien,9999,0,9999,0
1653558570840,ECE 200,016,091018,Javidi; Tara,9999,0,9999,0
1653558570840,ECE 200,017,091019,Kahng; Andrew Byun,9999,0,9999,0
1653558570840,ECE 200,018,091020,Kim; Young-Han,9999,0,9999,0
1653558570840,ECE 200,019,091021,Koushanfar; Farinaz,9999,0,9999,0
1653558570840,ECE 200,020,091022,Kuzum; Duygu,9999,0,9999,0
1653558570840,ECE 200,021,091023,Le; Hanh-Phuc,9999,0,9999,0
1653558570840,ECE 200,022,091024,Lin; Bill,9999,0,9999,0
1653558570840,ECE 200,023,091025,Liu; Zhaowei,9999,0,9999,0
1653558570840,ECE 200,024,091026,Lo; Yu-Hwa,9999,0,9999,0
1653558570840,ECE 200,025,091027,Lomakin; Vitaliy,9999,0,9999,0
1653558570840,ECE 200,026,091028,Mercier; Patrick Philip,9999,0,9999,0
1653558570840,ECE 200,027,091029,Meyer; Florian,9999,0,9999,0
1653558570840,ECE 200,028,091030,Milstein; Laurence B.,9999,0,9999,0
1653558570840,ECE 200,029,091031,Mir Arabbaygi; Siavash,9999,0,9999,0
1653558570840,ECE 200,030,091032,Mookherjea; Shayan,9999,0,9999,0
1653558570840,ECE 200,031,091033,Morris; Karcher William,9999,0,9999,0
1653558570840,ECE 200,032,091034,Ng; Tse Nga,9999,0,9999,0
1653558570840,ECE 200,033,091035,Nguyen; Truong Quang,9999,0,9999,0
1653558570840,ECE 200,034,091036,Nomura; Kenji,9999,0,9999,0
1653558570840,ECE 200,035,091037,Orlitsky; Alon,9999,0,9999,0
1653558570840,ECE 200,036,091038,Pal; Piya,9999,0,9999,0
1653558570840,ECE 200,037,091039,Papen; George C.,9999,0,9999,0
1653558570840,ECE 200,038,091040,Radic; Stojan,9999,0,9999,0
1653558570840,ECE 200,039,091041,Rao; Bhaskar D.,9999,0,9999,0
1653558570840,ECE 200,040,091042,Rao; Ramesh R,9999,0,9999,0
1653558570840,ECE 200,041,091043,Rebeiz; Gabriel,9999,0,9999,0
1653558570840,ECE 200,042,091044,Sanford; John R,9999,0,9999,0
1653558570840,ECE 200,043,091045,Siegel; Paul H.,9999,0,9999,0
1653558570840,ECE 200,044,091046,Sievenpiper; Daniel F.,9999,0,9999,0
1653558570840,ECE 200,045,091047,Sworder; David D.,9999,0,9999,0
1653558570840,ECE 200,046,091048,Taur; Yuan,9999,0,9999,0
1653558570840,ECE 200,047,091049,Touri; Behrouz,9999,0,9999,0
1653558570840,ECE 200,048,091050,Trivedi; Mohan M.,9999,0,9999,0
1653558570840,ECE 200,049,091051,Vardy; Alexander,9999,0,9999,0
1653558570840,ECE 200,050,091052,Vasconcelos; Nuno,9999,0,9999,0
1653558570840,ECE 200,051,091053,Wang; Xiaolong,9999,0,9999,0
1653558570840,ECE 200,052,091054,Xie; Pengtao,9999,0,9999,0
1653558570840,ECE 200,053,091055,Yip; Michael,9999,0,9999,0
1653558570840,ECE 200,054,091056,Zeger; Kenneth A.,9999,0,9999,0
1653558570840,ECE 200,055,091057,Zhang; Xinyu,9999,0,9999,0
1653558570840,ECE 200,056,091058,Turakhia; Yatish Girish,9999,0,9999,0
1653558570840,ECE 200,057,091059,Kang; Mingu,9999,0,9999,0
1653558570840,ECE 200,058,091060,Shi; Yuanyuan,9999,0,9999,0
1653558570840,ECE 200,059,091061,Wang; Edward Jay,9999,0,9999,0
1653558570840,ECE 200,060,091062,Zheng; Yang,9999,0,9999,0
1653558571367,ECE 201,A00,095526,Lo; Yu-Hwa,0,0,0,0
1653558571892,ECE 203,A00,091065,Mercier; Patrick Philip,0,0,0,0
1653558572418,ECE 207A,A00,091605,Liu; Thomas Tao-Ming,0,0,0,0
1653558572942,ECE 212AN,A00,091068,Nomura; Kenji,0,0,0,0
1653558573468,ECE 222A,A00,091069,Rebeiz; Gabriel,0,0,0,0
1653558573999,ECE 225A,A00,091070,Orlitsky; Alon,0,0,0,0
1653558574522,ECE 230A,A00,091071,Nomura; Kenji,0,0,0,0
1653558575046,ECE 236A,A00,091072,Dayeh; Shadi Ahmad,0,0,0,0
1653558575569,ECE 238A,A00,091073,Luo; Jian,0,0,0,0
1653558575569,ECE 238A,B00,091074,Luo; Jian,0,0,0,0
1653558576110,ECE 240A,A00,091075,Radic; Stojan,0,0,0,0
1653558576633,ECE 247A,A00,091592,Shi; Lingyan,0,0,0,0
1653558577164,ECE 250,A00,091076,Touri; Behrouz,0,0,0,0
1653558577703,ECE 251C,A00,091078,Nguyen; Truong Quang,0,0,0,0
1653558578226,ECE 253,A00,091079,Cosman; Pamela C.,0,0,0,0
1653558578749,ECE 255A,A00,091080,Orlitsky; Alon,0,0,0,0
1653558579277,ECE 257A,A00,091081,Zhang; Xinyu,0,0,0,0
1653558579809,ECE 260A,A01,091084,Eldon; John,0,0,0,0
1653558580337,ECE 264C,A00,091085,Galton; Ian A,0,0,0,0
1653558580866,ECE 265C,A00,094889,Presti; Calogero Davide,0,0,0,9
1653558581389,ECE 266,A01,091087,Hall; Drew A.,0,0,0,0
1653558582440,ECE 271A,A00,091090,Vasconcelos; Nuno,0,0,0,0
1653558582963,ECE 272B,A00,091091,Sworder; David D.,0,0,0,0
1653558583487,ECE 275A,A00,091092,Meyer; Florian,0,0,0,0
1653558584010,ECE 277,A00,091093,An; Cheolhong,0,0,0,0
1653558584533,ECE 283,A00,091094,Le; Hanh-Phuc,0,0,0,0
1653558585059,ECE 284,A00,091095,Kang; Mingu,0,0,0,0
1653558585059,ECE 284,B00,091096,Wang; Edward Jay,0,0,0,0
1653558585582,ECE 285,A00,094334,Touri; Behrouz,0,0,0,0
1653558586105,ECE 289,A00,091097,Whelan; David Arthur,0,0,0,0
1653558586628,MATH 200A,A00,087414,Salehi Golsefidy; Alireza,7,0,8,1
1653558587153,MATH 202A,A00,087415,Gill; Philip E.,2,0,8,6
1653558587677,MATH 203A,A00,087416,Oprea; Dragos N.,6,0,8,2
1653558588198,MATH 204A,A00,087417,Kedlaya; Kiran S.,6,0,8,2
1653558588721,MATH 205,A00,087418,Sorensen; Claus M,6,0,8,2
1653558589243,MATH 206A,A00,087419,Izadi; Elham,7,0,8,1
1653558589769,MATH 207A,A00,087420,Mohammadi; Amir,5,0,8,3
1653558590300,MATH 208,A00,087421,Staff,9,0,10,1
1653558590907,MATH 209,A00,087422,Staff,10,0,10,0
1653558591429,MATH 218,A00,087423,Staff,10,0,10,0
1653558591955,MATH 220A,A00,087424,Novak; Jonathan I,6,0,8,2
1653558592481,MATH 231A,A00,087425,Bejenaru; Ioan,3,0,8,5
1653558593006,MATH 240A,A00,087426,Ebenfelt; Peter F,5,0,8,3
1653558593531,MATH 243,A00,087427,Staff,9,0,10,1
1653558594053,MATH 248,A00,087429,Staff,10,0,10,0
1653558594592,MATH 250A,A00,087430,Spolaor; Luca,4,0,8,4
1653558595119,MATH 257A,A00,087431,Spolaor; Luca,7,0,8,1
1653558595645,MATH 258,A00,087432,Staff,9,0,10,1
1653558596170,MATH 264A,A00,087433,Warnke; Lutz Peter,5,0,8,3
1653558596694,MATH 268,A00,087434,Staff,15,0,15,0
1653558597217,MATH 269,A00,087435,Staff,14,0,15,1
1653558597755,MATH 270A,A00,087436,Nie; Jiawang,0,0,8,8
1653558598282,MATH 272A,A00,087437,Tian; Xiaochuan,1,0,8,7
1653558598808,MATH 274,A01,087439,Cheng; Li-Tien,9,0,10,1
1653558598808,MATH 274,A02,087440,Cheng; Li-Tien,10,0,10,0
1653558599331,MATH 278A,A00,087441,Staff,8,0,10,2
1653558599854,MATH 278B,A00,087442,Staff,8,0,10,2
1653558600379,MATH 278C,A00,087443,Staff,8,0,10,2
1653558600902,MATH 280A,A00,087444,Zheng; Tianyi,0,0,8,8
1653558601428,MATH 281A,A00,087445,Bradic; Jelena,0,0,8,8
1653558601952,MATH 282A,A00,087446,Zhang; Danna,0,0,8,8
1653558602477,MATH 283,A00,087447,Tesler; Glenn,0,0,0,15
1653558603007,MATH 286,A00,087448,Kemp; Todd Aahron,5,0,8,3
1653558603529,MATH 287D,A00,087449,Bradic; Jelena,0,0,0,1
1653558604052,MATH 288,A00,087450,Staff,14,0,15,1
1653558604052,MATH 288,B00,087451,Staff,15,0,15,0
1653558604052,MATH 288,C00,087452,Staff,15,0,15,0
1653558604578,MATH 290A,A00,087453,Xu; Zhouli,6,0,8,2
1653558605102,MATH 291A,A00,087454,Xu; Zhouli,7,0,8,1
1653558605626,MATH 292,A00,087455,Staff,10,0,10,0
1653558606156,MATH 295,A00,087456,Staff,50,0,50,0
1653558606679,MATH 297,001,087457,Staff,998,0,999,1
1653559165460,COGS 200,A01,087991,Staff,47,0,50,3
1653559165982,COGS 201,A01,094504,Rangel; Lara M,17,0,25,8
1653559166509,COGS 203,A00,087992,Coulson; Seana M,18,0,20,2
1653559167034,COGS 210A,001,087993,Greene; Deanna Jacquelyn,9998,0,9999,1
1653559167034,COGS 210A,002,087994,Saygin; Ayse P,9999,0,9999,0
1653559167034,COGS 210A,003,087995,Xia; Haijun,9999,0,9999,0
1653559167034,COGS 210A,004,087996,Nitz; Douglas A.,9999,0,9999,0
1653559167034,COGS 210A,005,087997,Hollan; James D.,9999,0,9999,0
1653559167034,COGS 210A,006,087998,Deak; Gedeon O.,9998,0,9999,1
1653559167034,COGS 210A,007,087999,Rossano; Federico,9999,0,9999,0
1653559167559,COGS 211A,A00,088000,Coulson; Seana M,9997,0,9999,2
1653559168082,COGS 229,A00,088002,Staff,22,0,25,3
1653559168609,COGS 260,B00,094231,Staff,17,0,20,3
1653559168609,COGS 260,A00,088004,Nitz; Douglas A.,9998,0,9999,1
1653559169133,CSE 202,A00,090110,Paturi; Ramamohan,0,0,0,0
1653559169133,CSE 202,B00,090111,Paturi; Ramamohan,0,0,0,0
1653559169660,CSE 207B,A00,090112,Heninger; Nadia A,0,0,0,0
1653559170185,CSE 208,A00,094858,Micciancio; Daniele,0,0,0,0
1653559170711,CSE 210,A00,090113,Powell; Thomas Allan,0,0,0,0
1653559171234,CSE 219,A00,090898,Staff,0,0,0,0
1653559171760,CSE 221,A00,090114,Zhou; Yuan-Yuan,0,0,0,0
1653559172283,CSE 229A,A00,090115,Porter; George M,0,0,0,0
1653559172805,CSE 229C,A00,090116,Savage; Stefan,0,0,0,0
1653559173326,CSE 230,A00,090117,Jhala; Ranjit,0,0,0,0
1653559173852,CSE 232,A00,090118,Papakonstantinou; Yannis,0,0,0,0
1653559174376,CSE 239A,A00,090121,Kumar; Arun Kumar,0,0,0,0
1653559174902,CSE 239B,A00,090122,Jhala; Ranjit,0,0,0,0
1653559175429,CSE 240A,A00,090123,Zhao; Jishen,1,0,189,188
1653559175953,CSE 243A,A00,090124,Orailoglu; Alex,0,0,15,15
1653559176483,CSE 249B,A00,090125,Kahng; Andrew Byun,13,0,20,7
1653559177101,CSE 250A,A00,090126,Berg-Kirkpatrick; Taylor D,0,0,0,0
1653559177628,CSE 252A,A00,090127,Ochoa; Benjamin Lawrence,0,0,0,0
1653559178151,CSE 258,A01,090129,McAuley; Julian John,0,0,0,0
1653559178675,CSE 258R,A01,090131,McAuley; Julian John,0,0,0,0
1653559179196,CSE 274,A00,090132,Ramamoorthi; Ravi,0,0,0,0
1653559179719,CSE 276A,A00,090133,Christensen; Henrik I,0,0,0,0
1653559180242,CSE 276C,A00,090134,Christensen; Henrik I,0,0,0,0
1653559180769,CSE 290,A00,090135,Bafna; Vineet,0,0,0,0
1653559180769,CSE 290,B00,090136,Ramamoorthi; Ravi,0,0,0,0
1653559180769,CSE 290,C00,090137,Li; Tzumao,8,0,10,2
1653559180769,CSE 290,D00,090138,Zhou; Yuan-Yuan,9,0,10,1
1653559180769,CSE 290,E00,090139,Christensen; Henrik I,8,0,10,2
1653559180769,CSE 290,F00,094053,Shalev; Aaron D,0,0,0,0
1653559181293,CSE 291,A00,090140,Munyaka; Imani N. S.,0,0,0,0
1653559181293,CSE 291,B00,094880,Yu; Qi,0,0,0,0
1653559181293,CSE 291,C00,090142,Pannuto; Patrick William,0,0,0,0
1653559181293,CSE 291,D00,094881,Zhang; Yiying,0,0,0,0
1653559181293,CSE 291,E00,095118,Su; Hao,0,0,0,0
1653559181840,CSE 293,001,094905,Bafna; Vineet,9999,0,9999,0
1653559181840,CSE 293,002,094906,Bellare; Mihir,9999,0,9999,0
1653559181840,CSE 293,003,094907,Berg-Kirkpatrick; Taylor D,9999,0,9999,0
1653559181840,CSE 293,004,094908,Christensen; Henrik I,9999,0,9999,0
1653559181840,CSE 293,005,094909,Cottrell; Garrison W,9999,0,9999,0
1653559181840,CSE 293,006,094910,Deutsch; Alin Bernard,9999,0,9999,0
1653559181840,CSE 293,007,094911,Esmaeilzadeh; Hadi,9999,0,9999,0
1653559181840,CSE 293,008,094912,Freund; Yoav,9999,0,9999,0
1653559181840,CSE 293,009,094913,Griswold; William G.,9999,0,9999,0
1653559181840,CSE 293,010,094914,Gymrek; Melissa Ann,9999,0,9999,0
1653559181840,CSE 293,011,094915,Heninger; Nadia A,9999,0,9999,0
1653559181840,CSE 293,012,094916,Impagliazzo; Russell,9999,0,9999,0
1653559181840,CSE 293,013,094917,Jhala; Ranjit,9999,0,9999,0
1653559181840,CSE 293,014,094918,Kahng; Andrew Byun,9999,0,9999,0
1653559181840,CSE 293,015,094919,Kane; Daniel Mertz,9999,0,9999,0
1653559181840,CSE 293,016,094920,Kriegman; David J,9999,0,9999,0
1653559181840,CSE 293,017,094921,Kumar; Arun Kumar,9999,0,9999,0
1653559181840,CSE 293,018,094922,Lerner; Sorin,9999,0,9999,0
1653559181840,CSE 293,019,094923,Lovett; Shachar,9999,0,9999,0
1653559181840,CSE 293,020,094924,McAuley; Julian John,9999,0,9999,0
1653559181840,CSE 293,021,094925,Micciancio; Daniele,9999,0,9999,0
1653559181840,CSE 293,022,094926,Orailoglu; Alex,9999,0,9999,0
1653559181840,CSE 293,023,094927,Paturi; Ramamohan,9999,0,9999,0
1653559181840,CSE 293,024,094928,Polikarpova; Nadezhda,9999,0,9999,0
1653559181840,CSE 293,025,094929,Politz; Joseph Gibbs,9999,0,9999,0
1653559181840,CSE 293,026,094930,Porter; George M,9999,0,9999,0
1653559181840,CSE 293,027,094931,Porter; Leonard Emerson,9999,0,9999,0
1653559181840,CSE 293,028,094932,Ramamoorthi; Ravi,9999,0,9999,0
1653559181840,CSE 293,029,094933,Sahoo; Debashis,9999,0,9999,0
1653559181840,CSE 293,030,094934,Saul; Lawrence,9999,0,9999,0
1653559181840,CSE 293,031,094935,Savage; Stefan,9999,0,9999,0
1653559181840,CSE 293,032,094936,Schulze; Jurgen P.,9999,0,9999,0
1653559181840,CSE 293,033,094937,Snoeren; Alex C.,9999,0,9999,0
1653559181840,CSE 293,034,094938,Shang; Jingbo,9999,0,9999,0
1653559181840,CSE 293,035,094939,Stefan; Deian,9999,0,9999,0
1653559181840,CSE 293,036,094940,Su; Hao,9999,0,9999,0
1653559181840,CSE 293,037,094941,Swanson; Steven James,9999,0,9999,0
1653559181840,CSE 293,038,094942,Tullsen; Dean Michael,9999,0,9999,0
1653559181840,CSE 293,039,094943,Voelker; Geoffrey M.,9999,0,9999,0
1653559181840,CSE 293,040,094944,Zhao; Jishen,9999,0,9999,0
1653559181840,CSE 293,041,094945,Zhou; Yuan-Yuan,9999,0,9999,0
1653559181840,CSE 293,042,094946,Gao; Sicun,9998,0,9999,1
1653559181840,CSE 293,043,094947,Weibel; Nadir,9999,0,9999,0
1653559181840,CSE 293,044,094948,Gupta; Rajesh K.,9999,0,9999,0
1653559182365,CSE 294,A00,090143,Porter; George M,8,0,10,2
1653559182888,DSE 200,A00,091799,Staff,50,0,50,0
1653559183414,DSE 203,A00,091800,Gupta; Amarnath,30,0,30,0
1653559183940,DSE 250,A00,091801,Deutsch; Alin Bernard,30,0,30,0
1653559184463,DSE 290,A00,091802,Altintas De Callaf; Ilkay,50,0,50,0
1653559185000,ECE 200,001,091003,Antipa; Nicholas A,9999,0,9999,0
1653559185000,ECE 200,002,091004,Atanasov; Nikolay A.,9999,0,9999,0
1653559185000,ECE 200,003,091005,Bharadia; Dinesh,9999,0,9999,0
1653559185000,ECE 200,004,091006,Cheng; Chung Kuan,9999,0,9999,0
1653559185000,ECE 200,005,091007,Cosman; Pamela C.,9999,0,9999,0
1653559185000,ECE 200,006,091008,Staff,9999,0,9999,0
1653559185000,ECE 200,007,091009,Dayeh; Shadi Ahmad,9999,0,9999,0
1653559185000,ECE 200,008,091010,Fainman; Yeshaiahu,9999,0,9999,0
1653559185000,ECE 200,009,091011,Ford; Joseph Earl,9999,0,9999,0
1653559185000,ECE 200,010,091012,Franceschetti; Massimo,9999,0,9999,0
1653559185000,ECE 200,011,091013,Fullerton; Eric E,9999,0,9999,0
1653559185000,ECE 200,012,091014,Galton; Ian A,9999,0,9999,0
1653559185000,ECE 200,013,091015,Gilja; Vikash,9999,0,9999,0
1653559185000,ECE 200,014,091016,Hall; Drew A.,9999,0,9999,0
1653559185000,ECE 200,015,091017,Hsueh; Tzu-Chien,9999,0,9999,0
1653559185000,ECE 200,016,091018,Javidi; Tara,9999,0,9999,0
1653559185000,ECE 200,017,091019,Kahng; Andrew Byun,9999,0,9999,0
1653559185000,ECE 200,018,091020,Kim; Young-Han,9999,0,9999,0
1653559185000,ECE 200,019,091021,Koushanfar; Farinaz,9999,0,9999,0
1653559185000,ECE 200,020,091022,Kuzum; Duygu,9999,0,9999,0
1653559185000,ECE 200,021,091023,Le; Hanh-Phuc,9999,0,9999,0
1653559185000,ECE 200,022,091024,Lin; Bill,9999,0,9999,0
1653559185000,ECE 200,023,091025,Liu; Zhaowei,9999,0,9999,0
1653559185000,ECE 200,024,091026,Lo; Yu-Hwa,9999,0,9999,0
1653559185000,ECE 200,025,091027,Lomakin; Vitaliy,9999,0,9999,0
1653559185000,ECE 200,026,091028,Mercier; Patrick Philip,9999,0,9999,0
1653559185000,ECE 200,027,091029,Meyer; Florian,9999,0,9999,0
1653559185000,ECE 200,028,091030,Milstein; Laurence B.,9999,0,9999,0
1653559185000,ECE 200,029,091031,Mir Arabbaygi; Siavash,9999,0,9999,0
1653559185000,ECE 200,030,091032,Mookherjea; Shayan,9999,0,9999,0
1653559185000,ECE 200,031,091033,Morris; Karcher William,9999,0,9999,0
1653559185000,ECE 200,032,091034,Ng; Tse Nga,9999,0,9999,0
1653559185000,ECE 200,033,091035,Nguyen; Truong Quang,9999,0,9999,0
1653559185000,ECE 200,034,091036,Nomura; Kenji,9999,0,9999,0
1653559185000,ECE 200,035,091037,Orlitsky; Alon,9999,0,9999,0
1653559185000,ECE 200,036,091038,Pal; Piya,9999,0,9999,0
1653559185000,ECE 200,037,091039,Papen; George C.,9999,0,9999,0
1653559185000,ECE 200,038,091040,Radic; Stojan,9999,0,9999,0
1653559185000,ECE 200,039,091041,Rao; Bhaskar D.,9999,0,9999,0
1653559185000,ECE 200,040,091042,Rao; Ramesh R,9999,0,9999,0
1653559185000,ECE 200,041,091043,Rebeiz; Gabriel,9999,0,9999,0
1653559185000,ECE 200,042,091044,Sanford; John R,9999,0,9999,0
1653559185000,ECE 200,043,091045,Siegel; Paul H.,9999,0,9999,0
1653559185000,ECE 200,044,091046,Sievenpiper; Daniel F.,9999,0,9999,0
1653559185000,ECE 200,045,091047,Sworder; David D.,9999,0,9999,0
1653559185000,ECE 200,046,091048,Taur; Yuan,9999,0,9999,0
1653559185000,ECE 200,047,091049,Touri; Behrouz,9999,0,9999,0
1653559185000,ECE 200,048,091050,Trivedi; Mohan M.,9999,0,9999,0
1653559185000,ECE 200,049,091051,Vardy; Alexander,9999,0,9999,0
1653559185000,ECE 200,050,091052,Vasconcelos; Nuno,9999,0,9999,0
1653559185000,ECE 200,051,091053,Wang; Xiaolong,9999,0,9999,0
1653559185000,ECE 200,052,091054,Xie; Pengtao,9999,0,9999,0
1653559185000,ECE 200,053,091055,Yip; Michael,9999,0,9999,0
1653559185000,ECE 200,054,091056,Zeger; Kenneth A.,9999,0,9999,0
1653559185000,ECE 200,055,091057,Zhang; Xinyu,9999,0,9999,0
1653559185000,ECE 200,056,091058,Turakhia; Yatish Girish,9999,0,9999,0
1653559185000,ECE 200,057,091059,Kang; Mingu,9999,0,9999,0
1653559185000,ECE 200,058,091060,Shi; Yuanyuan,9999,0,9999,0
1653559185000,ECE 200,059,091061,Wang; Edward Jay,9999,0,9999,0
1653559185000,ECE 200,060,091062,Zheng; Yang,9999,0,9999,0
1653559185527,ECE 201,A00,095526,Lo; Yu-Hwa,0,0,0,0
1653559186064,ECE 203,A00,091065,Mercier; Patrick Philip,0,0,0,0
1653559186588,ECE 207A,A00,091605,Liu; Thomas Tao-Ming,0,0,0,0
1653559187114,ECE 212AN,A00,091068,Nomura; Kenji,0,0,0,0
1653559187637,ECE 222A,A00,091069,Rebeiz; Gabriel,0,0,0,0
1653559188159,ECE 225A,A00,091070,Orlitsky; Alon,0,0,0,0
1653559188684,ECE 230A,A00,091071,Nomura; Kenji,0,0,0,0
1653559189207,ECE 236A,A00,091072,Dayeh; Shadi Ahmad,0,0,0,0
1653559189731,ECE 238A,A00,091073,Luo; Jian,0,0,0,0
1653559189731,ECE 238A,B00,091074,Luo; Jian,0,0,0,0
1653559190253,ECE 240A,A00,091075,Radic; Stojan,0,0,0,0
1653559190779,ECE 247A,A00,091592,Shi; Lingyan,0,0,0,0
1653559191304,ECE 250,A00,091076,Touri; Behrouz,0,0,0,0
1653559191828,ECE 251C,A00,091078,Nguyen; Truong Quang,0,0,0,0
1653559192351,ECE 253,A00,091079,Cosman; Pamela C.,0,0,0,0
1653559192878,ECE 255A,A00,091080,Orlitsky; Alon,0,0,0,0
1653559193401,ECE 257A,A00,091081,Zhang; Xinyu,0,0,0,0
1653559193927,ECE 260A,A01,091084,Eldon; John,0,0,0,0
1653559194451,ECE 264C,A00,091085,Galton; Ian A,0,0,0,0
1653559194974,ECE 265C,A00,094889,Presti; Calogero Davide,0,0,0,9
1653559195498,ECE 266,A01,091087,Hall; Drew A.,0,0,0,0
1653559196548,ECE 271A,A00,091090,Vasconcelos; Nuno,0,0,0,0
1653559197071,ECE 272B,A00,091091,Sworder; David D.,0,0,0,0
1653559197600,ECE 275A,A00,091092,Meyer; Florian,0,0,0,0
1653559198125,ECE 277,A00,091093,An; Cheolhong,0,0,0,0
1653559198648,ECE 283,A00,091094,Le; Hanh-Phuc,0,0,0,0
1653559199175,ECE 284,A00,091095,Kang; Mingu,0,0,0,0
1653559199175,ECE 284,B00,091096,Wang; Edward Jay,0,0,0,0
1653559199697,ECE 285,A00,094334,Touri; Behrouz,0,0,0,0
1653559200220,ECE 289,A00,091097,Whelan; David Arthur,0,0,0,0
1653559200746,MATH 200A,A00,087414,Salehi Golsefidy; Alireza,7,0,8,1
1653559201273,MATH 202A,A00,087415,Gill; Philip E.,2,0,8,6
1653559201798,MATH 203A,A00,087416,Oprea; Dragos N.,6,0,8,2
1653559202326,MATH 204A,A00,087417,Kedlaya; Kiran S.,6,0,8,2
1653559202850,MATH 205,A00,087418,Sorensen; Claus M,6,0,8,2
1653559203375,MATH 206A,A00,087419,Izadi; Elham,7,0,8,1
1653559203900,MATH 207A,A00,087420,Mohammadi; Amir,5,0,8,3
1653559204427,MATH 208,A00,087421,Staff,9,0,10,1
1653559204950,MATH 209,A00,087422,Staff,10,0,10,0
1653559205472,MATH 218,A00,087423,Staff,10,0,10,0
1653559205998,MATH 220A,A00,087424,Novak; Jonathan I,6,0,8,2
1653559206524,MATH 231A,A00,087425,Bejenaru; Ioan,3,0,8,5
1653559207046,MATH 240A,A00,087426,Ebenfelt; Peter F,5,0,8,3
1653559207568,MATH 243,A00,087427,Staff,9,0,10,1
1653559208092,MATH 248,A00,087429,Staff,10,0,10,0
1653559208618,MATH 250A,A00,087430,Spolaor; Luca,4,0,8,4
1653559209143,MATH 257A,A00,087431,Spolaor; Luca,7,0,8,1
1653559209666,MATH 258,A00,087432,Staff,9,0,10,1
1653559210192,MATH 264A,A00,087433,Warnke; Lutz Peter,5,0,8,3
1653559210715,MATH 268,A00,087434,Staff,15,0,15,0
1653559211239,MATH 269,A00,087435,Staff,14,0,15,1
1653559211763,MATH 270A,A00,087436,Nie; Jiawang,0,0,8,8
1653559212285,MATH 272A,A00,087437,Tian; Xiaochuan,1,0,8,7
1653559212811,MATH 274,A01,087439,Cheng; Li-Tien,9,0,10,1
1653559212811,MATH 274,A02,087440,Cheng; Li-Tien,10,0,10,0
1653559213337,MATH 278A,A00,087441,Staff,8,0,10,2
1653559213861,MATH 278B,A00,087442,Staff,8,0,10,2
1653559214382,MATH 278C,A00,087443,Staff,8,0,10,2
1653559214906,MATH 280A,A00,087444,Zheng; Tianyi,0,0,8,8
1653559215428,MATH 281A,A00,087445,Bradic; Jelena,0,0,8,8
1653559215975,MATH 282A,A00,087446,Zhang; Danna,0,0,8,8
1653559216504,MATH 283,A00,087447,Tesler; Glenn,0,0,0,15
1653559217027,MATH 286,A00,087448,Kemp; Todd Aahron,5,0,8,3
1653559217557,MATH 287D,A00,087449,Bradic; Jelena,0,0,0,1
1653559218082,MATH 288,A00,087450,Staff,14,0,15,1
1653559218082,MATH 288,B00,087451,Staff,15,0,15,0
1653559218082,MATH 288,C00,087452,Staff,15,0,15,0
1653559218616,MATH 290A,A00,087453,Xu; Zhouli,6,0,8,2
1653559219139,MATH 291A,A00,087454,Xu; Zhouli,7,0,8,1
1653559219667,MATH 292,A00,087455,Staff,10,0,10,0
1653559220191,MATH 295,A00,087456,Staff,50,0,50,0
1653559220714,MATH 297,001,087457,Staff,998,0,999,1
1653559780427,COGS 200,A01,087991,Staff,47,0,50,3
1653559780952,COGS 201,A01,094504,Rangel; Lara M,17,0,25,8
1653559781481,COGS 203,A00,087992,Coulson; Seana M,18,0,20,2
1653559782026,COGS 210A,001,087993,Greene; Deanna Jacquelyn,9998,0,9999,1
1653559782026,COGS 210A,002,087994,Saygin; Ayse P,9999,0,9999,0
1653559782026,COGS 210A,003,087995,Xia; Haijun,9999,0,9999,0
1653559782026,COGS 210A,004,087996,Nitz; Douglas A.,9999,0,9999,0
1653559782026,COGS 210A,005,087997,Hollan; James D.,9999,0,9999,0
1653559782026,COGS 210A,006,087998,Deak; Gedeon O.,9998,0,9999,1
1653559782026,COGS 210A,007,087999,Rossano; Federico,9999,0,9999,0
1653559782552,COGS 211A,A00,088000,Coulson; Seana M,9997,0,9999,2
1653559783079,COGS 229,A00,088002,Staff,22,0,25,3
1653559783609,COGS 260,B00,094231,Staff,17,0,20,3
1653559783609,COGS 260,A00,088004,Nitz; Douglas A.,9998,0,9999,1
1653559784145,CSE 202,A00,090110,Paturi; Ramamohan,0,0,0,0
1653559784145,CSE 202,B00,090111,Paturi; Ramamohan,0,0,0,0
1653559784670,CSE 207B,A00,090112,Heninger; Nadia A,0,0,0,0
1653559785200,CSE 208,A00,094858,Micciancio; Daniele,0,0,0,0
1653559785729,CSE 210,A00,090113,Powell; Thomas Allan,0,0,0,0
1653559786253,CSE 219,A00,090898,Staff,0,0,0,0
1653559786777,CSE 221,A00,090114,Zhou; Yuan-Yuan,0,0,0,0
1653559787301,CSE 229A,A00,090115,Porter; George M,0,0,0,0
1653559787832,CSE 229C,A00,090116,Savage; Stefan,0,0,0,0
1653559788377,CSE 230,A00,090117,Jhala; Ranjit,0,0,0,0
1653559788914,CSE 232,A00,090118,Papakonstantinou; Yannis,0,0,0,0
1653559789439,CSE 239A,A00,090121,Kumar; Arun Kumar,0,0,0,0
1653559789974,CSE 239B,A00,090122,Jhala; Ranjit,0,0,0,0
1653559790504,CSE 240A,A00,090123,Zhao; Jishen,1,0,189,188
1653559791035,CSE 243A,A00,090124,Orailoglu; Alex,0,0,15,15
1653559791561,CSE 249B,A00,090125,Kahng; Andrew Byun,13,0,20,7
1653559792086,CSE 250A,A00,090126,Berg-Kirkpatrick; Taylor D,0,0,0,0
1653559792609,CSE 252A,A00,090127,Ochoa; Benjamin Lawrence,0,0,0,0
1653559793137,CSE 258,A01,090129,McAuley; Julian John,0,0,0,0
1653559793662,CSE 258R,A01,090131,McAuley; Julian John,0,0,0,0
1653559794186,CSE 274,A00,090132,Ramamoorthi; Ravi,0,0,0,0
1653559794714,CSE 276A,A00,090133,Christensen; Henrik I,0,0,0,0
1653559795237,CSE 276C,A00,090134,Christensen; Henrik I,0,0,0,0
1653559795772,CSE 290,A00,090135,Bafna; Vineet,0,0,0,0
1653559795772,CSE 290,B00,090136,Ramamoorthi; Ravi,0,0,0,0
1653559795772,CSE 290,C00,090137,Li; Tzumao,8,0,10,2
1653559795772,CSE 290,D00,090138,Zhou; Yuan-Yuan,9,0,10,1
1653559795772,CSE 290,E00,090139,Christensen; Henrik I,8,0,10,2
1653559795772,CSE 290,F00,094053,Shalev; Aaron D,0,0,0,0
1653559796300,CSE 291,A00,090140,Munyaka; Imani N. S.,0,0,0,0
1653559796300,CSE 291,B00,094880,Yu; Qi,0,0,0,0
1653559796300,CSE 291,C00,090142,Pannuto; Patrick William,0,0,0,0
1653559796300,CSE 291,D00,094881,Zhang; Yiying,0,0,0,0
1653559796300,CSE 291,E00,095118,Su; Hao,0,0,0,0
1653559796848,CSE 293,001,094905,Bafna; Vineet,9999,0,9999,0
1653559796848,CSE 293,002,094906,Bellare; Mihir,9999,0,9999,0
1653559796848,CSE 293,003,094907,Berg-Kirkpatrick; Taylor D,9999,0,9999,0
1653559796848,CSE 293,004,094908,Christensen; Henrik I,9999,0,9999,0
1653559796848,CSE 293,005,094909,Cottrell; Garrison W,9999,0,9999,0
1653559796848,CSE 293,006,094910,Deutsch; Alin Bernard,9999,0,9999,0
1653559796848,CSE 293,007,094911,Esmaeilzadeh; Hadi,9999,0,9999,0
1653559796848,CSE 293,008,094912,Freund; Yoav,9999,0,9999,0
1653559796848,CSE 293,009,094913,Griswold; William G.,9999,0,9999,0
1653559796848,CSE 293,010,094914,Gymrek; Melissa Ann,9999,0,9999,0
1653559796848,CSE 293,011,094915,Heninger; Nadia A,9999,0,9999,0
1653559796848,CSE 293,012,094916,Impagliazzo; Russell,9999,0,9999,0
1653559796848,CSE 293,013,094917,Jhala; Ranjit,9999,0,9999,0
1653559796848,CSE 293,014,094918,Kahng; Andrew Byun,9999,0,9999,0
1653559796848,CSE 293,015,094919,Kane; Daniel Mertz,9999,0,9999,0
1653559796848,CSE 293,016,094920,Kriegman; David J,9999,0,9999,0
1653559796848,CSE 293,017,094921,Kumar; Arun Kumar,9999,0,9999,0
1653559796848,CSE 293,018,094922,Lerner; Sorin,9999,0,9999,0
1653559796848,CSE 293,019,094923,Lovett; Shachar,9999,0,9999,0
1653559796848,CSE 293,020,094924,McAuley; Julian John,9999,0,9999,0
1653559796848,CSE 293,021,094925,Micciancio; Daniele,9999,0,9999,0
1653559796848,CSE 293,022,094926,Orailoglu; Alex,9999,0,9999,0
1653559796848,CSE 293,023,094927,Paturi; Ramamohan,9999,0,9999,0
1653559796848,CSE 293,024,094928,Polikarpova; Nadezhda,9999,0,9999,0
1653559796848,CSE 293,025,094929,Politz; Joseph Gibbs,9999,0,9999,0
1653559796848,CSE 293,026,094930,Porter; George M,9999,0,9999,0
1653559796848,CSE 293,027,094931,Porter; Leonard Emerson,9999,0,9999,0
1653559796848,CSE 293,028,094932,Ramamoorthi; Ravi,9999,0,9999,0
1653559796848,CSE 293,029,094933,Sahoo; Debashis,9999,0,9999,0
1653559796848,CSE 293,030,094934,Saul; Lawrence,9999,0,9999,0
1653559796848,CSE 293,031,094935,Savage; Stefan,9999,0,9999,0
1653559796848,CSE 293,032,094936,Schulze; Jurgen P.,9999,0,9999,0
1653559796848,CSE 293,033,094937,Snoeren; Alex C.,9999,0,9999,0
1653559796848,CSE 293,034,094938,Shang; Jingbo,9999,0,9999,0
1653559796848,CSE 293,035,094939,Stefan; Deian,9999,0,9999,0
1653559796848,CSE 293,036,094940,Su; Hao,9999,0,9999,0
1653559796848,CSE 293,037,094941,Swanson; Steven James,9999,0,9999,0
1653559796848,CSE 293,038,094942,Tullsen; Dean Michael,9999,0,9999,0
1653559796848,CSE 293,039,094943,Voelker; Geoffrey M.,9999,0,9999,0
1653559796848,CSE 293,040,094944,Zhao; Jishen,9999,0,9999,0
1653559796848,CSE 293,041,094945,Zhou; Yuan-Yuan,9999,0,9999,0
1653559796848,CSE 293,042,094946,Gao; Sicun,9998,0,9999,1
1653559796848,CSE 293,043,094947,Weibel; Nadir,9999,0,9999,0
1653559796848,CSE 293,044,094948,Gupta; Rajesh K.,9999,0,9999,0
1653559797372,CSE 294,A00,090143,Porter; George M,8,0,10,2
1653559797901,DSE 200,A00,091799,Staff,50,0,50,0
1653559798427,DSE 203,A00,091800,Gupta; Amarnath,30,0,30,0
1653559798953,DSE 250,A00,091801,Deutsch; Alin Bernard,30,0,30,0
1653559799483,DSE 290,A00,091802,Altintas De Callaf; Ilkay,50,0,50,0
1653559800045,ECE 200,001,091003,Antipa; Nicholas A,9999,0,9999,0
1653559800045,ECE 200,002,091004,Atanasov; Nikolay A.,9999,0,9999,0
1653559800045,ECE 200,003,091005,Bharadia; Dinesh,9999,0,9999,0
1653559800045,ECE 200,004,091006,Cheng; Chung Kuan,9999,0,9999,0
1653559800045,ECE 200,005,091007,Cosman; Pamela C.,9999,0,9999,0
1653559800045,ECE 200,006,091008,Staff,9999,0,9999,0
1653559800045,ECE 200,007,091009,Dayeh; Shadi Ahmad,9999,0,9999,0
1653559800045,ECE 200,008,091010,Fainman; Yeshaiahu,9999,0,9999,0
1653559800045,ECE 200,009,091011,Ford; Joseph Earl,9999,0,9999,0
1653559800045,ECE 200,010,091012,Franceschetti; Massimo,9999,0,9999,0
1653559800045,ECE 200,011,091013,Fullerton; Eric E,9999,0,9999,0
1653559800045,ECE 200,012,091014,Galton; Ian A,9999,0,9999,0
1653559800045,ECE 200,013,091015,Gilja; Vikash,9999,0,9999,0
1653559800045,ECE 200,014,091016,Hall; Drew A.,9999,0,9999,0
1653559800045,ECE 200,015,091017,Hsueh; Tzu-Chien,9999,0,9999,0
1653559800045,ECE 200,016,091018,Javidi; Tara,9999,0,9999,0
1653559800045,ECE 200,017,091019,Kahng; Andrew Byun,9999,0,9999,0
1653559800045,ECE 200,018,091020,Kim; Young-Han,9999,0,9999,0
1653559800045,ECE 200,019,091021,Koushanfar; Farinaz,9999,0,9999,0
1653559800045,ECE 200,020,091022,Kuzum; Duygu,9999,0,9999,0
1653559800045,ECE 200,021,091023,Le; Hanh-Phuc,9999,0,9999,0
1653559800045,ECE 200,022,091024,Lin; Bill,9999,0,9999,0
1653559800045,ECE 200,023,091025,Liu; Zhaowei,9999,0,9999,0
1653559800045,ECE 200,024,091026,Lo; Yu-Hwa,9999,0,9999,0
1653559800045,ECE 200,025,091027,Lomakin; Vitaliy,9999,0,9999,0
1653559800045,ECE 200,026,091028,Mercier; Patrick Philip,9999,0,9999,0
1653559800045,ECE 200,027,091029,Meyer; Florian,9999,0,9999,0
1653559800045,ECE 200,028,091030,Milstein; Laurence B.,9999,0,9999,0
1653559800045,ECE 200,029,091031,Mir Arabbaygi; Siavash,9999,0,9999,0
1653559800045,ECE 200,030,091032,Mookherjea; Shayan,9999,0,9999,0
1653559800045,ECE 200,031,091033,Morris; Karcher William,9999,0,9999,0
1653559800045,ECE 200,032,091034,Ng; Tse Nga,9999,0,9999,0
1653559800045,ECE 200,033,091035,Nguyen; Truong Quang,9999,0,9999,0
1653559800045,ECE 200,034,091036,Nomura; Kenji,9999,0,9999,0
1653559800045,ECE 200,035,091037,Orlitsky; Alon,9999,0,9999,0
1653559800045,ECE 200,036,091038,Pal; Piya,9999,0,9999,0
1653559800045,ECE 200,037,091039,Papen; George C.,9999,0,9999,0
1653559800045,ECE 200,038,091040,Radic; Stojan,9999,0,9999,0
1653559800045,ECE 200,039,091041,Rao; Bhaskar D.,9999,0,9999,0
1653559800045,ECE 200,040,091042,Rao; Ramesh R,9999,0,9999,0
1653559800045,ECE 200,041,091043,Rebeiz; Gabriel,9999,0,9999,0
1653559800045,ECE 200,042,091044,Sanford; John R,9999,0,9999,0
1653559800045,ECE 200,043,091045,Siegel; Paul H.,9999,0,9999,0
1653559800045,ECE 200,044,091046,Sievenpiper; Daniel F.,9999,0,9999,0
1653559800045,ECE 200,045,091047,Sworder; David D.,9999,0,9999,0
1653559800045,ECE 200,046,091048,Taur; Yuan,9999,0,9999,0
1653559800045,ECE 200,047,091049,Touri; Behrouz,9999,0,9999,0
1653559800045,ECE 200,048,091050,Trivedi; Mohan M.,9999,0,9999,0
1653559800045,ECE 200,049,091051,Vardy; Alexander,9999,0,9999,0
1653559800045,ECE 200,050,091052,Vasconcelos; Nuno,9999,0,9999,0
1653559800045,ECE 200,051,091053,Wang; Xiaolong,9999,0,9999,0
1653559800045,ECE 200,052,091054,Xie; Pengtao,9999,0,9999,0
1653559800045,ECE 200,053,091055,Yip; Michael,9999,0,9999,0
1653559800045,ECE 200,054,091056,Zeger; Kenneth A.,9999,0,9999,0
1653559800045,ECE 200,055,091057,Zhang; Xinyu,9999,0,9999,0
1653559800045,ECE 200,056,091058,Turakhia; Yatish Girish,9999,0,9999,0
1653559800045,ECE 200,057,091059,Kang; Mingu,9999,0,9999,0
1653559800045,ECE 200,058,091060,Shi; Yuanyuan,9999,0,9999,0
1653559800045,ECE 200,059,091061,Wang; Edward Jay,9999,0,9999,0
1653559800045,ECE 200,060,091062,Zheng; Yang,9999,0,9999,0
1653559800576,ECE 201,A00,095526,Lo; Yu-Hwa,0,0,0,0
1653559801100,ECE 203,A00,091065,Mercier; Patrick Philip,0,0,0,0
1653559801631,ECE 207A,A00,091605,Liu; Thomas Tao-Ming,0,0,0,0
1653559802162,ECE 212AN,A00,091068,Nomura; Kenji,0,0,0,0
1653559802688,ECE 222A,A00,091069,Rebeiz; Gabriel,0,0,0,0
1653559803216,ECE 225A,A00,091070,Orlitsky; Alon,0,0,0,0
1653559803745,ECE 230A,A00,091071,Nomura; Kenji,0,0,0,0
1653559804272,ECE 236A,A00,091072,Dayeh; Shadi Ahmad,0,0,0,0
1653559804797,ECE 238A,A00,091073,Luo; Jian,0,0,0,0
1653559804797,ECE 238A,B00,091074,Luo; Jian,0,0,0,0
1653559805325,ECE 240A,A00,091075,Radic; Stojan,0,0,0,0
1653559805855,ECE 247A,A00,091592,Shi; Lingyan,0,0,0,0
1653559806378,ECE 250,A00,091076,Touri; Behrouz,0,0,0,0
1653559806905,ECE 251C,A00,091078,Nguyen; Truong Quang,0,0,0,0
1653559807429,ECE 253,A00,091079,Cosman; Pamela C.,0,0,0,0
1653559807956,ECE 255A,A00,091080,Orlitsky; Alon,0,0,0,0
1653559808481,ECE 257A,A00,091081,Zhang; Xinyu,0,0,0,0
1653559809020,ECE 260A,A01,091084,Eldon; John,0,0,0,0
1653559809545,ECE 264C,A00,091085,Galton; Ian A,0,0,0,0
1653559810076,ECE 265C,A00,094889,Presti; Calogero Davide,0,0,0,9
1653559810600,ECE 266,A01,091087,Hall; Drew A.,0,0,0,0
1653559811651,ECE 271A,A00,091090,Vasconcelos; Nuno,0,0,0,0
1653559812174,ECE 272B,A00,091091,Sworder; David D.,0,0,0,0
1653559812703,ECE 275A,A00,091092,Meyer; Florian,0,0,0,0
1653559813228,ECE 277,A00,091093,An; Cheolhong,0,0,0,0
1653559813751,ECE 283,A00,091094,Le; Hanh-Phuc,0,0,0,0
1653559814283,ECE 284,A00,091095,Kang; Mingu,0,0,0,0
1653559814283,ECE 284,B00,091096,Wang; Edward Jay,0,0,0,0
1653559814809,ECE 285,A00,094334,Touri; Behrouz,0,0,0,0
1653559815338,ECE 289,A00,091097,Whelan; David Arthur,0,0,0,0
1653559815875,MATH 200A,A00,087414,Salehi Golsefidy; Alireza,7,0,8,1
1653559816398,MATH 202A,A00,087415,Gill; Philip E.,2,0,8,6
1653559816927,MATH 203A,A00,087416,Oprea; Dragos N.,6,0,8,2
1653559817544,MATH 204A,A00,087417,Kedlaya; Kiran S.,6,0,8,2
1653559818069,MATH 205,A00,087418,Sorensen; Claus M,6,0,8,2
1653559818597,MATH 206A,A00,087419,Izadi; Elham,7,0,8,1
1653559819122,MATH 207A,A00,087420,Mohammadi; Amir,5,0,8,3
1653559819646,MATH 208,A00,087421,Staff,9,0,10,1
1653559820173,MATH 209,A00,087422,Staff,10,0,10,0
1653559820699,MATH 218,A00,087423,Staff,10,0,10,0
1653559821235,MATH 220A,A00,087424,Novak; Jonathan I,6,0,8,2
1653559821760,MATH 231A,A00,087425,Bejenaru; Ioan,3,0,8,5
1653559822285,MATH 240A,A00,087426,Ebenfelt; Peter F,5,0,8,3
1653559822808,MATH 243,A00,087427,Staff,9,0,10,1
1653559823333,MATH 248,A00,087429,Staff,10,0,10,0
1653559823867,MATH 250A,A00,087430,Spolaor; Luca,4,0,8,4
1653559824395,MATH 257A,A00,087431,Spolaor; Luca,7,0,8,1
1653559824922,MATH 258,A00,087432,Staff,9,0,10,1
1653559825446,MATH 264A,A00,087433,Warnke; Lutz Peter,5,0,8,3
1653559825970,MATH 268,A00,087434,Staff,15,0,15,0
1653559826496,MATH 269,A00,087435,Staff,14,0,15,1
1653559827021,MATH 270A,A00,087436,Nie; Jiawang,0,0,8,8
1653559827544,MATH 272A,A00,087437,Tian; Xiaochuan,1,0,8,7
1653559828077,MATH 274,A01,087439,Cheng; Li-Tien,9,0,10,1
1653559828077,MATH 274,A02,087440,Cheng; Li-Tien,10,0,10,0
1653559828601,MATH 278A,A00,087441,Staff,8,0,10,2
1653559829132,MATH 278B,A00,087442,Staff,8,0,10,2
1653559829660,MATH 278C,A00,087443,Staff,8,0,10,2
1653559830182,MATH 280A,A00,087444,Zheng; Tianyi,0,0,8,8
1653559830713,MATH 281A,A00,087445,Bradic; Jelena,0,0,8,8
1653559831237,MATH 282A,A00,087446,Zhang; Danna,0,0,8,8
1653559831763,MATH 283,A00,087447,Tesler; Glenn,0,0,0,15
1653559832290,MATH 286,A00,087448,Kemp; Todd Aahron,5,0,8,3
1653559832813,MATH 287D,A00,087449,Bradic; Jelena,0,0,0,1
1653559833339,MATH 288,A00,087450,Staff,14,0,15,1
1653559833339,MATH 288,B00,087451,Staff,15,0,15,0
1653559833339,MATH 288,C00,087452,Staff,15,0,15,0
1653559833864,MATH 290A,A00,087453,Xu; Zhouli,6,0,8,2
1653559834393,MATH 291A,A00,087454,Xu; Zhouli,7,0,8,1
1653559834918,MATH 292,A00,087455,Staff,10,0,10,0
1653559835448,MATH 295,A00,087456,Staff,50,0,50,0
1653559835971,MATH 297,001,087457,Staff,998,0,999,1
1653560407254,COGS 200,A01,087991,Staff,47,0,50,3
1653560407778,COGS 201,A01,094504,Rangel; Lara M,17,0,25,8
1653560408305,COGS 203,A00,087992,Coulson; Seana M,18,0,20,2
1653560408829,COGS 210A,001,087993,Greene; Deanna Jacquelyn,9998,0,9999,1
1653560408829,COGS 210A,002,087994,Saygin; Ayse P,9999,0,9999,0
1653560408829,COGS 210A,003,087995,Xia; Haijun,9999,0,9999,0
1653560408829,COGS 210A,004,087996,Nitz; Douglas A.,9999,0,9999,0
1653560408829,COGS 210A,005,087997,Hollan; James D.,9999,0,9999,0
1653560408829,COGS 210A,006,087998,Deak; Gedeon O.,9998,0,9999,1
1653560408829,COGS 210A,007,087999,Rossano; Federico,9999,0,9999,0
1653560409356,COGS 211A,A00,088000,Coulson; Seana M,9997,0,9999,2
1653560409884,COGS 229,A00,088002,Staff,22,0,25,3
1653560410422,COGS 260,B00,094231,Staff,17,0,20,3
1653560410422,COGS 260,A00,088004,Nitz; Douglas A.,9998,0,9999,1
1653560410947,CSE 202,A00,090110,Paturi; Ramamohan,0,0,0,0
1653560410947,CSE 202,B00,090111,Paturi; Ramamohan,0,0,0,0
1653560411470,CSE 207B,A00,090112,Heninger; Nadia A,0,0,0,0
1653560411994,CSE 208,A00,094858,Micciancio; Daniele,0,0,0,0
1653560412519,CSE 210,A00,090113,Powell; Thomas Allan,0,0,0,0
1653560413047,CSE 219,A00,090898,Staff,0,0,0,0
1653560413576,CSE 221,A00,090114,Zhou; Yuan-Yuan,0,0,0,0
1653560414100,CSE 229A,A00,090115,Porter; George M,0,0,0,0
1653560414627,CSE 229C,A00,090116,Savage; Stefan,0,0,0,0
1653560415154,CSE 230,A00,090117,Jhala; Ranjit,0,0,0,0
1653560415678,CSE 232,A00,090118,Papakonstantinou; Yannis,0,0,0,0
1653560416298,CSE 239A,A00,090121,Kumar; Arun Kumar,0,0,0,0
1653560416821,CSE 239B,A00,090122,Jhala; Ranjit,0,0,0,0
1653560417350,CSE 240A,A00,090123,Zhao; Jishen,1,0,189,188
1653560417872,CSE 243A,A00,090124,Orailoglu; Alex,0,0,15,15
1653560418401,CSE 249B,A00,090125,Kahng; Andrew Byun,13,0,20,7
1653560418936,CSE 250A,A00,090126,Berg-Kirkpatrick; Taylor D,0,0,0,0
1653560419459,CSE 252A,A00,090127,Ochoa; Benjamin Lawrence,0,0,0,0
1653560419985,CSE 258,A01,090129,McAuley; Julian John,0,0,0,0
1653560420512,CSE 258R,A01,090131,McAuley; Julian John,0,0,0,0
1653560421033,CSE 274,A00,090132,Ramamoorthi; Ravi,0,0,0,0
1653560421557,CSE 276A,A00,090133,Christensen; Henrik I,0,0,0,0
1653560422080,CSE 276C,A00,090134,Christensen; Henrik I,0,0,0,0
1653560422614,CSE 290,A00,090135,Bafna; Vineet,0,0,0,0
1653560422614,CSE 290,B00,090136,Ramamoorthi; Ravi,0,0,0,0
1653560422614,CSE 290,C00,090137,Li; Tzumao,8,0,10,2
1653560422614,CSE 290,D00,090138,Zhou; Yuan-Yuan,9,0,10,1
1653560422614,CSE 290,E00,090139,Christensen; Henrik I,8,0,10,2
1653560422614,CSE 290,F00,094053,Shalev; Aaron D,0,0,0,0
1653560423152,CSE 291,A00,090140,Munyaka; Imani N. S.,0,0,0,0
1653560423152,CSE 291,B00,094880,Yu; Qi,0,0,0,0
1653560423152,CSE 291,C00,090142,Pannuto; Patrick William,0,0,0,0
1653560423152,CSE 291,D00,094881,Zhang; Yiying,0,0,0,0
1653560423152,CSE 291,E00,095118,Su; Hao,0,0,0,0
1653560423688,CSE 293,001,094905,Bafna; Vineet,9999,0,9999,0
1653560423688,CSE 293,002,094906,Bellare; Mihir,9999,0,9999,0
1653560423688,CSE 293,003,094907,Berg-Kirkpatrick; Taylor D,9999,0,9999,0
1653560423688,CSE 293,004,094908,Christensen; Henrik I,9999,0,9999,0
1653560423688,CSE 293,005,094909,Cottrell; Garrison W,9999,0,9999,0
1653560423688,CSE 293,006,094910,Deutsch; Alin Bernard,9999,0,9999,0
1653560423688,CSE 293,007,094911,Esmaeilzadeh; Hadi,9999,0,9999,0
1653560423688,CSE 293,008,094912,Freund; Yoav,9999,0,9999,0
1653560423688,CSE 293,009,094913,Griswold; William G.,9999,0,9999,0
1653560423688,CSE 293,010,094914,Gymrek; Melissa Ann,9999,0,9999,0
1653560423688,CSE 293,011,094915,Heninger; Nadia A,9999,0,9999,0
1653560423688,CSE 293,012,094916,Impagliazzo; Russell,9999,0,9999,0
1653560423688,CSE 293,013,094917,Jhala; Ranjit,9999,0,9999,0
1653560423688,CSE 293,014,094918,Kahng; Andrew Byun,9999,0,9999,0
1653560423688,CSE 293,015,094919,Kane; Daniel Mertz,9999,0,9999,0
1653560423688,CSE 293,016,094920,Kriegman; David J,9999,0,9999,0
1653560423688,CSE 293,017,094921,Kumar; Arun Kumar,9999,0,9999,0
1653560423688,CSE 293,018,094922,Lerner; Sorin,9999,0,9999,0
1653560423688,CSE 293,019,094923,Lovett; Shachar,9999,0,9999,0
1653560423688,CSE 293,020,094924,McAuley; Julian John,9999,0,9999,0
1653560423688,CSE 293,021,094925,Micciancio; Daniele,9999,0,9999,0
1653560423688,CSE 293,022,094926,Orailoglu; Alex,9999,0,9999,0
1653560423688,CSE 293,023,094927,Paturi; Ramamohan,9999,0,9999,0
1653560423688,CSE 293,024,094928,Polikarpova; Nadezhda,9999,0,9999,0
1653560423688,CSE 293,025,094929,Politz; Joseph Gibbs,9999,0,9999,0
1653560423688,CSE 293,026,094930,Porter; George M,9999,0,9999,0
1653560423688,CSE 293,027,094931,Porter; Leonard Emerson,9999,0,9999,0
1653560423688,CSE 293,028,094932,Ramamoorthi; Ravi,9999,0,9999,0
1653560423688,CSE 293,029,094933,Sahoo; Debashis,9999,0,9999,0
1653560423688,CSE 293,030,094934,Saul; Lawrence,9999,0,9999,0
1653560423688,CSE 293,031,094935,Savage; Stefan,9999,0,9999,0
1653560423688,CSE 293,032,094936,Schulze; Jurgen P.,9999,0,9999,0
1653560423688,CSE 293,033,094937,Snoeren; Alex C.,9999,0,9999,0
1653560423688,CSE 293,034,094938,Shang; Jingbo,9999,0,9999,0
1653560423688,CSE 293,035,094939,Stefan; Deian,9999,0,9999,0
1653560423688,CSE 293,036,094940,Su; Hao,9999,0,9999,0
1653560423688,CSE 293,037,094941,Swanson; Steven James,9999,0,9999,0
1653560423688,CSE 293,038,094942,Tullsen; Dean Michael,9999,0,9999,0
1653560423688,CSE 293,039,094943,Voelker; Geoffrey M.,9999,0,9999,0
1653560423688,CSE 293,040,094944,Zhao; Jishen,9999,0,9999,0
1653560423688,CSE 293,041,094945,Zhou; Yuan-Yuan,9999,0,9999,0
1653560423688,CSE 293,042,094946,Gao; Sicun,9998,0,9999,1
1653560423688,CSE 293,043,094947,Weibel; Nadir,9999,0,9999,0
1653560423688,CSE 293,044,094948,Gupta; Rajesh K.,9999,0,9999,0
1653560424215,CSE 294,A00,090143,Porter; George M,8,0,10,2
1653560424740,DSE 200,A00,091799,Staff,50,0,50,0
1653560425264,DSE 203,A00,091800,Gupta; Amarnath,30,0,30,0
1653560425791,DSE 250,A00,091801,Deutsch; Alin Bernard,30,0,30,0
1653560426319,DSE 290,A00,091802,Altintas De Callaf; Ilkay,50,0,50,0
1653560426905,ECE 200,001,091003,Antipa; Nicholas A,9999,0,9999,0
1653560426905,ECE 200,002,091004,Atanasov; Nikolay A.,9999,0,9999,0
1653560426905,ECE 200,003,091005,Bharadia; Dinesh,9999,0,9999,0
1653560426905,ECE 200,004,091006,Cheng; Chung Kuan,9999,0,9999,0
1653560426905,ECE 200,005,091007,Cosman; Pamela C.,9999,0,9999,0
1653560426905,ECE 200,006,091008,Staff,9999,0,9999,0
1653560426905,ECE 200,007,091009,Dayeh; Shadi Ahmad,9999,0,9999,0
1653560426905,ECE 200,008,091010,Fainman; Yeshaiahu,9999,0,9999,0
1653560426905,ECE 200,009,091011,Ford; Joseph Earl,9999,0,9999,0
1653560426905,ECE 200,010,091012,Franceschetti; Massimo,9999,0,9999,0
1653560426905,ECE 200,011,091013,Fullerton; Eric E,9999,0,9999,0
1653560426905,ECE 200,012,091014,Galton; Ian A,9999,0,9999,0
1653560426905,ECE 200,013,091015,Gilja; Vikash,9999,0,9999,0
1653560426905,ECE 200,014,091016,Hall; Drew A.,9999,0,9999,0
1653560426905,ECE 200,015,091017,Hsueh; Tzu-Chien,9999,0,9999,0
1653560426905,ECE 200,016,091018,Javidi; Tara,9999,0,9999,0
1653560426905,ECE 200,017,091019,Kahng; Andrew Byun,9999,0,9999,0
1653560426905,ECE 200,018,091020,Kim; Young-Han,9999,0,9999,0
1653560426905,ECE 200,019,091021,Koushanfar; Farinaz,9999,0,9999,0
1653560426905,ECE 200,020,091022,Kuzum; Duygu,9999,0,9999,0
1653560426905,ECE 200,021,091023,Le; Hanh-Phuc,9999,0,9999,0
1653560426905,ECE 200,022,091024,Lin; Bill,9999,0,9999,0
1653560426905,ECE 200,023,091025,Liu; Zhaowei,9999,0,9999,0
1653560426905,ECE 200,024,091026,Lo; Yu-Hwa,9999,0,9999,0
1653560426905,ECE 200,025,091027,Lomakin; Vitaliy,9999,0,9999,0
1653560426905,ECE 200,026,091028,Mercier; Patrick Philip,9999,0,9999,0
1653560426905,ECE 200,027,091029,Meyer; Florian,9999,0,9999,0
1653560426905,ECE 200,028,091030,Milstein; Laurence B.,9999,0,9999,0
1653560426905,ECE 200,029,091031,Mir Arabbaygi; Siavash,9999,0,9999,0
1653560426905,ECE 200,030,091032,Mookherjea; Shayan,9999,0,9999,0
1653560426905,ECE 200,031,091033,Morris; Karcher William,9999,0,9999,0
1653560426905,ECE 200,032,091034,Ng; Tse Nga,9999,0,9999,0
1653560426905,ECE 200,033,091035,Nguyen; Truong Quang,9999,0,9999,0
1653560426905,ECE 200,034,091036,Nomura; Kenji,9999,0,9999,0
1653560426905,ECE 200,035,091037,Orlitsky; Alon,9999,0,9999,0
1653560426905,ECE 200,036,091038,Pal; Piya,9999,0,9999,0
1653560426905,ECE 200,037,091039,Papen; George C.,9999,0,9999,0
1653560426905,ECE 200,038,091040,Radic; Stojan,9999,0,9999,0
1653560426905,ECE 200,039,091041,Rao; Bhaskar D.,9999,0,9999,0
1653560426905,ECE 200,040,091042,Rao; Ramesh R,9999,0,9999,0
1653560426905,ECE 200,041,091043,Rebeiz; Gabriel,9999,0,9999,0
1653560426905,ECE 200,042,091044,Sanford; John R,9999,0,9999,0
1653560426905,ECE 200,043,091045,Siegel; Paul H.,9999,0,9999,0
1653560426905,ECE 200,044,091046,Sievenpiper; Daniel F.,9999,0,9999,0
1653560426905,ECE 200,045,091047,Sworder; David D.,9999,0,9999,0
1653560426905,ECE 200,046,091048,Taur; Yuan,9999,0,9999,0
1653560426905,ECE 200,047,091049,Touri; Behrouz,9999,0,9999,0
1653560426905,ECE 200,048,091050,Trivedi; Mohan M.,9999,0,9999,0
1653560426905,ECE 200,049,091051,Vardy; Alexander,9999,0,9999,0
1653560426905,ECE 200,050,091052,Vasconcelos; Nuno,9999,0,9999,0
1653560426905,ECE 200,051,091053,Wang; Xiaolong,9999,0,9999,0
1653560426905,ECE 200,052,091054,Xie; Pengtao,9999,0,9999,0
1653560426905,ECE 200,053,091055,Yip; Michael,9999,0,9999,0
1653560426905,ECE 200,054,091056,Zeger; Kenneth A.,9999,0,9999,0
1653560426905,ECE 200,055,091057,Zhang; Xinyu,9999,0,9999,0
1653560426905,ECE 200,056,091058,Turakhia; Yatish Girish,9999,0,9999,0
1653560426905,ECE 200,057,091059,Kang; Mingu,9999,0,9999,0
1653560426905,ECE 200,058,091060,Shi; Yuanyuan,9999,0,9999,0
1653560426905,ECE 200,059,091061,Wang; Edward Jay,9999,0,9999,0
1653560426905,ECE 200,060,091062,Zheng; Yang,9999,0,9999,0
1653560427430,ECE 201,A00,095526,Lo; Yu-Hwa,0,0,0,0
1653560427960,ECE 203,A00,091065,Mercier; Patrick Philip,0,0,0,0
1653560428488,ECE 207A,A00,091605,Liu; Thomas Tao-Ming,0,0,0,0
1653560429022,ECE 212AN,A00,091068,Nomura; Kenji,0,0,0,0
1653560429552,ECE 222A,A00,091069,Rebeiz; Gabriel,0,0,0,0
1653560430074,ECE 225A,A00,091070,Orlitsky; Alon,0,0,0,0
1653560430602,ECE 230A,A00,091071,Nomura; Kenji,0,0,0,0
1653560431131,ECE 236A,A00,091072,Dayeh; Shadi Ahmad,0,0,0,0
1653560431656,ECE 238A,A00,091073,Luo; Jian,0,0,0,0
1653560431656,ECE 238A,B00,091074,Luo; Jian,0,0,0,0
1653560432179,ECE 240A,A00,091075,Radic; Stojan,0,0,0,0
1653560432707,ECE 247A,A00,091592,Shi; Lingyan,0,0,0,0
1653560433230,ECE 250,A00,091076,Touri; Behrouz,0,0,0,0
1653560433753,ECE 251C,A00,091078,Nguyen; Truong Quang,0,0,0,0
1653560434278,ECE 253,A00,091079,Cosman; Pamela C.,0,0,0,0
1653560434801,ECE 255A,A00,091080,Orlitsky; Alon,0,0,0,0
1653560435325,ECE 257A,A00,091081,Zhang; Xinyu,0,0,0,0
1653560435849,ECE 260A,A01,091084,Eldon; John,0,0,0,0
1653560436398,ECE 264C,A00,091085,Galton; Ian A,0,0,0,0
1653560436927,ECE 265C,A00,094889,Presti; Calogero Davide,0,0,0,9
1653560437452,ECE 266,A01,091087,Hall; Drew A.,0,0,0,0
1653560438515,ECE 271A,A00,091090,Vasconcelos; Nuno,0,0,0,0
1653560439037,ECE 272B,A00,091091,Sworder; David D.,0,0,0,0
1653560439564,ECE 275A,A00,091092,Meyer; Florian,0,0,0,0
1653560440090,ECE 277,A00,091093,An; Cheolhong,0,0,0,0
1653560440642,ECE 283,A00,091094,Le; Hanh-Phuc,0,0,0,0
1653560441167,ECE 284,A00,091095,Kang; Mingu,0,0,0,0
1653560441167,ECE 284,B00,091096,Wang; Edward Jay,0,0,0,0
1653560441695,ECE 285,A00,094334,Touri; Behrouz,0,0,0,0
1653560442221,ECE 289,A00,091097,Whelan; David Arthur,0,0,0,0
1653560442745,MATH 200A,A00,087414,Salehi Golsefidy; Alireza,7,0,8,1
1653560443282,MATH 202A,A00,087415,Gill; Philip E.,2,0,8,6
1653560443805,MATH 203A,A00,087416,Oprea; Dragos N.,6,0,8,2
1653560444331,MATH 204A,A00,087417,Kedlaya; Kiran S.,6,0,8,2
1653560444854,MATH 205,A00,087418,Sorensen; Claus M,6,0,8,2
1653560445382,MATH 206A,A00,087419,Izadi; Elham,7,0,8,1
1653560445911,MATH 207A,A00,087420,Mohammadi; Amir,5,0,8,3
1653560446434,MATH 208,A00,087421,Staff,9,0,10,1
1653560446957,MATH 209,A00,087422,Staff,10,0,10,0
1653560447480,MATH 218,A00,087423,Staff,10,0,10,0
1653560448007,MATH 220A,A00,087424,Novak; Jonathan I,6,0,8,2
1653560448536,MATH 231A,A00,087425,Bejenaru; Ioan,3,0,8,5
1653560449073,MATH 240A,A00,087426,Ebenfelt; Peter F,5,0,8,3
1653560449601,MATH 243,A00,087427,Staff,9,0,10,1
1653560450125,MATH 248,A00,087429,Staff,10,0,10,0
1653560450653,MATH 250A,A00,087430,Spolaor; Luca,4,0,8,4
1653560451175,MATH 257A,A00,087431,Spolaor; Luca,7,0,8,1
1653560451701,MATH 258,A00,087432,Staff,9,0,10,1
1653560452224,MATH 264A,A00,087433,Warnke; Lutz Peter,5,0,8,3
1653560452748,MATH 268,A00,087434,Staff,15,0,15,0
1653560453272,MATH 269,A00,087435,Staff,14,0,15,1
1653560453796,MATH 270A,A00,087436,Nie; Jiawang,0,0,8,8
1653560454321,MATH 272A,A00,087437,Tian; Xiaochuan,1,0,8,7
1653560454846,MATH 274,A01,087439,Cheng; Li-Tien,9,0,10,1
1653560454846,MATH 274,A02,087440,Cheng; Li-Tien,10,0,10,0
1653560455373,MATH 278A,A00,087441,Staff,8,0,10,2
1653560455896,MATH 278B,A00,087442,Staff,8,0,10,2
1653560456422,MATH 278C,A00,087443,Staff,8,0,10,2
1653560456946,MATH 280A,A00,087444,Zheng; Tianyi,0,0,8,8
1653560457470,MATH 281A,A00,087445,Bradic; Jelena,0,0,8,8
1653560457994,MATH 282A,A00,087446,Zhang; Danna,0,0,8,8
1653560458522,MATH 283,A00,087447,Tesler; Glenn,0,0,0,15
1653560459046,MATH 286,A00,087448,Kemp; Todd Aahron,5,0,8,3
1653560459569,MATH 287D,A00,087449,Bradic; Jelena,0,0,0,1
1653560460104,MATH 288,A00,087450,Staff,14,0,15,1
1653560460104,MATH 288,B00,087451,Staff,15,0,15,0
1653560460104,MATH 288,C00,087452,Staff,15,0,15,0
1653560460632,MATH 290A,A00,087453,Xu; Zhouli,6,0,8,2
1653560461161,MATH 291A,A00,087454,Xu; Zhouli,7,0,8,1
1653560461690,MATH 292,A00,087455,Staff,10,0,10,0
1653560462217,MATH 295,A00,087456,Staff,50,0,50,0
1653560462740,MATH 297,001,087457,Staff,998,0,999,1
1653561023380,COGS 200,A01,087991,Staff,47,0,50,3
1653561023911,COGS 201,A01,094504,Rangel; Lara M,17,0,25,8
1653561024435,COGS 203,A00,087992,Coulson; Seana M,18,0,20,2
1653561024969,COGS 210A,001,087993,Greene; Deanna Jacquelyn,9998,0,9999,1
1653561024969,COGS 210A,002,087994,Saygin; Ayse P,9999,0,9999,0
1653561024969,COGS 210A,003,087995,Xia; Haijun,9999,0,9999,0
1653561024969,COGS 210A,004,087996,Nitz; Douglas A.,9999,0,9999,0
1653561024969,COGS 210A,005,087997,Hollan; James D.,9999,0,9999,0
1653561024969,COGS 210A,006,087998,Deak; Gedeon O.,9998,0,9999,1
1653561024969,COGS 210A,007,087999,Rossano; Federico,9999,0,9999,0
1653561025492,COGS 211A,A00,088000,Coulson; Seana M,9997,0,9999,2
1653561026019,COGS 229,A00,088002,Staff,22,0,25,3
1653561026542,COGS 260,B00,094231,Staff,17,0,20,3
1653561026542,COGS 260,A00,088004,Nitz; Douglas A.,9998,0,9999,1
1653561027074,CSE 202,A00,090110,Paturi; Ramamohan,0,0,0,0
1653561027074,CSE 202,B00,090111,Paturi; Ramamohan,0,0,0,0
1653561027598,CSE 207B,A00,090112,Heninger; Nadia A,0,0,0,0
1653561028125,CSE 208,A00,094858,Micciancio; Daniele,0,0,0,0
1653561028649,CSE 210,A00,090113,Powell; Thomas Allan,0,0,0,0
1653561029176,CSE 219,A00,090898,Staff,0,0,0,0
1653561029701,CSE 221,A00,090114,Zhou; Yuan-Yuan,0,0,0,0
1653561030227,CSE 229A,A00,090115,Porter; George M,0,0,0,0
1653561030750,CSE 229C,A00,090116,Savage; Stefan,0,0,0,0
1653561031274,CSE 230,A00,090117,Jhala; Ranjit,0,0,0,0
1653561031804,CSE 232,A00,090118,Papakonstantinou; Yannis,0,0,0,0
1653561032327,CSE 239A,A00,090121,Kumar; Arun Kumar,0,0,0,0
1653561032853,CSE 239B,A00,090122,Jhala; Ranjit,0,0,0,0
1653561033381,CSE 240A,A00,090123,Zhao; Jishen,1,0,189,188
1653561033905,CSE 243A,A00,090124,Orailoglu; Alex,0,0,15,15
1653561034433,CSE 249B,A00,090125,Kahng; Andrew Byun,13,0,20,7
1653561034957,CSE 250A,A00,090126,Berg-Kirkpatrick; Taylor D,0,0,0,0
1653561035483,CSE 252A,A00,090127,Ochoa; Benjamin Lawrence,0,0,0,0
1653561036008,CSE 258,A01,090129,McAuley; Julian John,0,0,0,0
1653561036531,CSE 258R,A01,090131,McAuley; Julian John,0,0,0,0
1653561037054,CSE 274,A00,090132,Ramamoorthi; Ravi,0,0,0,0
1653561037581,CSE 276A,A00,090133,Christensen; Henrik I,0,0,0,0
1653561038107,CSE 276C,A00,090134,Christensen; Henrik I,0,0,0,0
1653561038640,CSE 290,A00,090135,Bafna; Vineet,0,0,0,0
1653561038640,CSE 290,B00,090136,Ramamoorthi; Ravi,0,0,0,0
1653561038640,CSE 290,C00,090137,Li; Tzumao,8,0,10,2
1653561038640,CSE 290,D00,090138,Zhou; Yuan-Yuan,9,0,10,1
1653561038640,CSE 290,E00,090139,Christensen; Henrik I,8,0,10,2
1653561038640,CSE 290,F00,094053,Shalev; Aaron D,0,0,0,0
1653561039176,CSE 291,A00,090140,Munyaka; Imani N. S.,0,0,0,0
1653561039176,CSE 291,B00,094880,Yu; Qi,0,0,0,0
1653561039176,CSE 291,C00,090142,Pannuto; Patrick William,0,0,0,0
1653561039176,CSE 291,D00,094881,Zhang; Yiying,0,0,0,0
1653561039176,CSE 291,E00,095118,Su; Hao,0,0,0,0
1653561039712,CSE 293,001,094905,Bafna; Vineet,9999,0,9999,0
1653561039712,CSE 293,002,094906,Bellare; Mihir,9999,0,9999,0
1653561039712,CSE 293,003,094907,Berg-Kirkpatrick; Taylor D,9999,0,9999,0
1653561039712,CSE 293,004,094908,Christensen; Henrik I,9999,0,9999,0
1653561039712,CSE 293,005,094909,Cottrell; Garrison W,9999,0,9999,0
1653561039712,CSE 293,006,094910,Deutsch; Alin Bernard,9999,0,9999,0
1653561039712,CSE 293,007,094911,Esmaeilzadeh; Hadi,9999,0,9999,0
1653561039712,CSE 293,008,094912,Freund; Yoav,9999,0,9999,0
1653561039712,CSE 293,009,094913,Griswold; William G.,9999,0,9999,0
1653561039712,CSE 293,010,094914,Gymrek; Melissa Ann,9999,0,9999,0
1653561039712,CSE 293,011,094915,Heninger; Nadia A,9999,0,9999,0
1653561039712,CSE 293,012,094916,Impagliazzo; Russell,9999,0,9999,0
1653561039712,CSE 293,013,094917,Jhala; Ranjit,9999,0,9999,0
1653561039712,CSE 293,014,094918,Kahng; Andrew Byun,9999,0,9999,0
1653561039712,CSE 293,015,094919,Kane; Daniel Mertz,9999,0,9999,0
1653561039712,CSE 293,016,094920,Kriegman; David J,9999,0,9999,0
1653561039712,CSE 293,017,094921,Kumar; Arun Kumar,9999,0,9999,0
1653561039712,CSE 293,018,094922,Lerner; Sorin,9999,0,9999,0
1653561039712,CSE 293,019,094923,Lovett; Shachar,9999,0,9999,0
1653561039712,CSE 293,020,094924,McAuley; Julian John,9999,0,9999,0
1653561039712,CSE 293,021,094925,Micciancio; Daniele,9999,0,9999,0
1653561039712,CSE 293,022,094926,Orailoglu; Alex,9999,0,9999,0
1653561039712,CSE 293,023,094927,Paturi; Ramamohan,9999,0,9999,0
1653561039712,CSE 293,024,094928,Polikarpova; Nadezhda,9999,0,9999,0
1653561039712,CSE 293,025,094929,Politz; Joseph Gibbs,9999,0,9999,0
1653561039712,CSE 293,026,094930,Porter; George M,9999,0,9999,0
1653561039712,CSE 293,027,094931,Porter; Leonard Emerson,9999,0,9999,0
1653561039712,CSE 293,028,094932,Ramamoorthi; Ravi,9999,0,9999,0
1653561039712,CSE 293,029,094933,Sahoo; Debashis,9999,0,9999,0
1653561039712,CSE 293,030,094934,Saul; Lawrence,9999,0,9999,0
1653561039712,CSE 293,031,094935,Savage; Stefan,9999,0,9999,0
1653561039712,CSE 293,032,094936,Schulze; Jurgen P.,9999,0,9999,0
1653561039712,CSE 293,033,094937,Snoeren; Alex C.,9999,0,9999,0
1653561039712,CSE 293,034,094938,Shang; Jingbo,9999,0,9999,0
1653561039712,CSE 293,035,094939,Stefan; Deian,9999,0,9999,0
1653561039712,CSE 293,036,094940,Su; Hao,9999,0,9999,0
1653561039712,CSE 293,037,094941,Swanson; Steven James,9999,0,9999,0
1653561039712,CSE 293,038,094942,Tullsen; Dean Michael,9999,0,9999,0
1653561039712,CSE 293,039,094943,Voelker; Geoffrey M.,9999,0,9999,0
1653561039712,CSE 293,040,094944,Zhao; Jishen,9999,0,9999,0
1653561039712,CSE 293,041,094945,Zhou; Yuan-Yuan,9999,0,9999,0
1653561039712,CSE 293,042,094946,Gao; Sicun,9998,0,9999,1
1653561039712,CSE 293,043,094947,Weibel; Nadir,9999,0,9999,0
1653561039712,CSE 293,044,094948,Gupta; Rajesh K.,9999,0,9999,0
1653561040240,CSE 294,A00,090143,Porter; George M,8,0,10,2
1653561040769,DSE 200,A00,091799,Staff,50,0,50,0
1653561041297,DSE 203,A00,091800,Gupta; Amarnath,30,0,30,0
1653561041823,DSE 250,A00,091801,Deutsch; Alin Bernard,30,0,30,0
1653561042347,DSE 290,A00,091802,Altintas De Callaf; Ilkay,50,0,50,0
1653561042906,ECE 200,001,091003,Antipa; Nicholas A,9999,0,9999,0
1653561042906,ECE 200,002,091004,Atanasov; Nikolay A.,9999,0,9999,0
1653561042906,ECE 200,003,091005,Bharadia; Dinesh,9999,0,9999,0
1653561042906,ECE 200,004,091006,Cheng; Chung Kuan,9999,0,9999,0
1653561042906,ECE 200,005,091007,Cosman; Pamela C.,9999,0,9999,0
1653561042906,ECE 200,006,091008,Staff,9999,0,9999,0
1653561042906,ECE 200,007,091009,Dayeh; Shadi Ahmad,9999,0,9999,0
1653561042906,ECE 200,008,091010,Fainman; Yeshaiahu,9999,0,9999,0
1653561042906,ECE 200,009,091011,Ford; Joseph Earl,9999,0,9999,0
1653561042906,ECE 200,010,091012,Franceschetti; Massimo,9999,0,9999,0
1653561042906,ECE 200,011,091013,Fullerton; Eric E,9999,0,9999,0
1653561042906,ECE 200,012,091014,Galton; Ian A,9999,0,9999,0
1653561042906,ECE 200,013,091015,Gilja; Vikash,9999,0,9999,0
1653561042906,ECE 200,014,091016,Hall; Drew A.,9999,0,9999,0
1653561042906,ECE 200,015,091017,Hsueh; Tzu-Chien,9999,0,9999,0
1653561042906,ECE 200,016,091018,Javidi; Tara,9999,0,9999,0
1653561042906,ECE 200,017,091019,Kahng; Andrew Byun,9999,0,9999,0
1653561042906,ECE 200,018,091020,Kim; Young-Han,9999,0,9999,0
1653561042906,ECE 200,019,091021,Koushanfar; Farinaz,9999,0,9999,0
1653561042906,ECE 200,020,091022,Kuzum; Duygu,9999,0,9999,0
1653561042906,ECE 200,021,091023,Le; Hanh-Phuc,9999,0,9999,0
1653561042906,ECE 200,022,091024,Lin; Bill,9999,0,9999,0
1653561042906,ECE 200,023,091025,Liu; Zhaowei,9999,0,9999,0
1653561042906,ECE 200,024,091026,Lo; Yu-Hwa,9999,0,9999,0
1653561042906,ECE 200,025,091027,Lomakin; Vitaliy,9999,0,9999,0
1653561042906,ECE 200,026,091028,Mercier; Patrick Philip,9999,0,9999,0
1653561042906,ECE 200,027,091029,Meyer; Florian,9999,0,9999,0
1653561042906,ECE 200,028,091030,Milstein; Laurence B.,9999,0,9999,0
1653561042906,ECE 200,029,091031,Mir Arabbaygi; Siavash,9999,0,9999,0
1653561042906,ECE 200,030,091032,Mookherjea; Shayan,9999,0,9999,0
1653561042906,ECE 200,031,091033,Morris; Karcher William,9999,0,9999,0
1653561042906,ECE 200,032,091034,Ng; Tse Nga,9999,0,9999,0
1653561042906,ECE 200,033,091035,Nguyen; Truong Quang,9999,0,9999,0
1653561042906,ECE 200,034,091036,Nomura; Kenji,9999,0,9999,0
1653561042906,ECE 200,035,091037,Orlitsky; Alon,9999,0,9999,0
1653561042906,ECE 200,036,091038,Pal; Piya,9999,0,9999,0
1653561042906,ECE 200,037,091039,Papen; George C.,9999,0,9999,0
1653561042906,ECE 200,038,091040,Radic; Stojan,9999,0,9999,0
1653561042906,ECE 200,039,091041,Rao; Bhaskar D.,9999,0,9999,0
1653561042906,ECE 200,040,091042,Rao; Ramesh R,9999,0,9999,0
1653561042906,ECE 200,041,091043,Rebeiz; Gabriel,9999,0,9999,0
1653561042906,ECE 200,042,091044,Sanford; John R,9999,0,9999,0
1653561042906,ECE 200,043,091045,Siegel; Paul H.,9999,0,9999,0
1653561042906,ECE 200,044,091046,Sievenpiper; Daniel F.,9999,0,9999,0
1653561042906,ECE 200,045,091047,Sworder; David D.,9999,0,9999,0
1653561042906,ECE 200,046,091048,Taur; Yuan,9999,0,9999,0
1653561042906,ECE 200,047,091049,Touri; Behrouz,9999,0,9999,0
1653561042906,ECE 200,048,091050,Trivedi; Mohan M.,9999,0,9999,0
1653561042906,ECE 200,049,091051,Vardy; Alexander,9999,0,9999,0
1653561042906,ECE 200,050,091052,Vasconcelos; Nuno,9999,0,9999,0
1653561042906,ECE 200,051,091053,Wang; Xiaolong,9999,0,9999,0
1653561042906,ECE 200,052,091054,Xie; Pengtao,9999,0,9999,0
1653561042906,ECE 200,053,091055,Yip; Michael,9999,0,9999,0
1653561042906,ECE 200,054,091056,Zeger; Kenneth A.,9999,0,9999,0
1653561042906,ECE 200,055,091057,Zhang; Xinyu,9999,0,9999,0
1653561042906,ECE 200,056,091058,Turakhia; Yatish Girish,9999,0,9999,0
1653561042906,ECE 200,057,091059,Kang; Mingu,9999,0,9999,0
1653561042906,ECE 200,058,091060,Shi; Yuanyuan,9999,0,9999,0
1653561042906,ECE 200,059,091061,Wang; Edward Jay,9999,0,9999,0
1653561042906,ECE 200,060,091062,Zheng; Yang,9999,0,9999,0
1653561043435,ECE 201,A00,095526,Lo; Yu-Hwa,0,0,0,0
1653561043965,ECE 203,A00,091065,Mercier; Patrick Philip,0,0,0,0
1653561044490,ECE 207A,A00,091605,Liu; Thomas Tao-Ming,0,0,0,0
1653561045015,ECE 212AN,A00,091068,Nomura; Kenji,0,0,0,0
1653561045541,ECE 222A,A00,091069,Rebeiz; Gabriel,0,0,0,0
1653561046069,ECE 225A,A00,091070,Orlitsky; Alon,0,0,0,0
1653561046595,ECE 230A,A00,091071,Nomura; Kenji,0,0,0,0
1653561047119,ECE 236A,A00,091072,Dayeh; Shadi Ahmad,0,0,0,0
1653561047642,ECE 238A,A00,091073,Luo; Jian,0,0,0,0
1653561047642,ECE 238A,B00,091074,Luo; Jian,0,0,0,0
1653561048169,ECE 240A,A00,091075,Radic; Stojan,0,0,0,0
1653561048697,ECE 247A,A00,091592,Shi; Lingyan,0,0,0,0
1653561049221,ECE 250,A00,091076,Touri; Behrouz,0,0,0,0
1653561049746,ECE 251C,A00,091078,Nguyen; Truong Quang,0,0,0,0
1653561050272,ECE 253,A00,091079,Cosman; Pamela C.,0,0,0,0
1653561050796,ECE 255A,A00,091080,Orlitsky; Alon,0,0,0,0
1653561051324,ECE 257A,A00,091081,Zhang; Xinyu,0,0,0,0
1653561051853,ECE 260A,A01,091084,Eldon; John,0,0,0,0
1653561052376,ECE 264C,A00,091085,Galton; Ian A,0,0,0,0
1653561052900,ECE 265C,A00,094889,Presti; Calogero Davide,0,0,0,9
1653561053428,ECE 266,A01,091087,Hall; Drew A.,0,0,0,0
1653561054474,ECE 271A,A00,091090,Vasconcelos; Nuno,0,0,0,0
1653561054997,ECE 272B,A00,091091,Sworder; David D.,0,0,0,0
1653561055523,ECE 275A,A00,091092,Meyer; Florian,0,0,0,0
1653561056046,ECE 277,A00,091093,An; Cheolhong,0,0,0,0
1653561056574,ECE 283,A00,091094,Le; Hanh-Phuc,0,0,0,0
1653561057100,ECE 284,A00,091095,Kang; Mingu,0,0,0,0
1653561057100,ECE 284,B00,091096,Wang; Edward Jay,0,0,0,0
1653561057709,ECE 285,A00,094334,Touri; Behrouz,0,0,0,0
1653561058232,ECE 289,A00,091097,Whelan; David Arthur,0,0,0,0
1653561058763,MATH 200A,A00,087414,Salehi Golsefidy; Alireza,7,0,8,1
1653561059287,MATH 202A,A00,087415,Gill; Philip E.,2,0,8,6
1653561059810,MATH 203A,A00,087416,Oprea; Dragos N.,6,0,8,2
1653561060348,MATH 204A,A00,087417,Kedlaya; Kiran S.,6,0,8,2
1653561060871,MATH 205,A00,087418,Sorensen; Claus M,6,0,8,2
1653561061394,MATH 206A,A00,087419,Izadi; Elham,7,0,8,1
1653561061918,MATH 207A,A00,087420,Mohammadi; Amir,5,0,8,3
1653561062443,MATH 208,A00,087421,Staff,9,0,10,1
1653561062974,MATH 209,A00,087422,Staff,10,0,10,0
1653561063497,MATH 218,A00,087423,Staff,10,0,10,0
1653561064026,MATH 220A,A00,087424,Novak; Jonathan I,6,0,8,2
1653561064550,MATH 231A,A00,087425,Bejenaru; Ioan,3,0,8,5
1653561065074,MATH 240A,A00,087426,Ebenfelt; Peter F,5,0,8,3
1653561065597,MATH 243,A00,087427,Staff,9,0,10,1
1653561066120,MATH 248,A00,087429,Staff,10,0,10,0
1653561066645,MATH 250A,A00,087430,Spolaor; Luca,4,0,8,4
1653561067172,MATH 257A,A00,087431,Spolaor; Luca,7,0,8,1
1653561067695,MATH 258,A00,087432,Staff,9,0,10,1
1653561068221,MATH 264A,A00,087433,Warnke; Lutz Peter,5,0,8,3
1653561068743,MATH 268,A00,087434,Staff,15,0,15,0
1653561069272,MATH 269,A00,087435,Staff,14,0,15,1
1653561069795,MATH 270A,A00,087436,Nie; Jiawang,0,0,8,8
1653561070337,MATH 272A,A00,087437,Tian; Xiaochuan,1,0,8,7
1653561070868,MATH 274,A01,087439,Cheng; Li-Tien,9,0,10,1
1653561070868,MATH 274,A02,087440,Cheng; Li-Tien,10,0,10,0
1653561071392,MATH 278A,A00,087441,Staff,8,0,10,2
1653561071915,MATH 278B,A00,087442,Staff,8,0,10,2
1653561072437,MATH 278C,A00,087443,Staff,8,0,10,2
1653561072960,MATH 280A,A00,087444,Zheng; Tianyi,0,0,8,8
1653561073487,MATH 281A,A00,087445,Bradic; Jelena,0,0,8,8
1653561074010,MATH 282A,A00,087446,Zhang; Danna,0,0,8,8
1653561074538,MATH 283,A00,087447,Tesler; Glenn,0,0,0,15
1653561075061,MATH 286,A00,087448,Kemp; Todd Aahron,5,0,8,3
1653561075590,MATH 287D,A00,087449,Bradic; Jelena,0,0,0,1
1653561076113,MATH 288,A00,087450,Staff,14,0,15,1
1653561076113,MATH 288,B00,087451,Staff,15,0,15,0
1653561076113,MATH 288,C00,087452,Staff,15,0,15,0
1653561076636,MATH 290A,A00,087453,Xu; Zhouli,6,0,8,2
1653561077161,MATH 291A,A00,087454,Xu; Zhouli,7,0,8,1
1653561077686,MATH 292,A00,087455,Staff,10,0,10,0
1653561078208,MATH 295,A00,087456,Staff,50,0,50,0
1653561078741,MATH 297,001,087457,Staff,998,0,999,1
1653561640056,COGS 200,A01,087991,Staff,47,0,50,3
1653561640581,COGS 201,A01,094504,Rangel; Lara M,17,0,25,8
1653561641105,COGS 203,A00,087992,Coulson; Seana M,18,0,20,2
1653561641634,COGS 210A,001,087993,Greene; Deanna Jacquelyn,9998,0,9999,1
1653561641634,COGS 210A,002,087994,Saygin; Ayse P,9999,0,9999,0
1653561641634,COGS 210A,003,087995,Xia; Haijun,9999,0,9999,0
1653561641634,COGS 210A,004,087996,Nitz; Douglas A.,9999,0,9999,0
1653561641634,COGS 210A,005,087997,Hollan; James D.,9999,0,9999,0
1653561641634,COGS 210A,006,087998,Deak; Gedeon O.,9998,0,9999,1
1653561641634,COGS 210A,007,087999,Rossano; Federico,9999,0,9999,0
1653561642158,COGS 211A,A00,088000,Coulson; Seana M,9997,0,9999,2
1653561642682,COGS 229,A00,088002,Staff,22,0,25,3
1653561643211,COGS 260,B00,094231,Staff,17,0,20,3
1653561643211,COGS 260,A00,088004,Nitz; Douglas A.,9998,0,9999,1
1653561643736,CSE 202,A00,090110,Paturi; Ramamohan,0,0,0,0
1653561643736,CSE 202,B00,090111,Paturi; Ramamohan,0,0,0,0
1653561644265,CSE 207B,A00,090112,Heninger; Nadia A,0,0,0,0
1653561644789,CSE 208,A00,094858,Micciancio; Daniele,0,0,0,0
1653561645319,CSE 210,A00,090113,Powell; Thomas Allan,0,0,0,0
1653561645846,CSE 219,A00,090898,Staff,0,0,0,0
1653561646460,CSE 221,A00,090114,Zhou; Yuan-Yuan,0,0,0,0
1653561646985,CSE 229A,A00,090115,Porter; George M,0,0,0,0
1653561647507,CSE 229C,A00,090116,Savage; Stefan,0,0,0,0
1653561648030,CSE 230,A00,090117,Jhala; Ranjit,0,0,0,0
1653561648554,CSE 232,A00,090118,Papakonstantinou; Yannis,0,0,0,0
1653561649082,CSE 239A,A00,090121,Kumar; Arun Kumar,0,0,0,0
1653561649609,CSE 239B,A00,090122,Jhala; Ranjit,0,0,0,0
1653561650131,CSE 240A,A00,090123,Zhao; Jishen,1,0,189,188
1653561650663,CSE 243A,A00,090124,Orailoglu; Alex,0,0,15,15
1653561651188,CSE 249B,A00,090125,Kahng; Andrew Byun,13,0,20,7
1653561651712,CSE 250A,A00,090126,Berg-Kirkpatrick; Taylor D,0,0,0,0
1653561652242,CSE 252A,A00,090127,Ochoa; Benjamin Lawrence,0,0,0,0
1653561652770,CSE 258,A01,090129,McAuley; Julian John,0,0,0,0
1653561653298,CSE 258R,A01,090131,McAuley; Julian John,0,0,0,0
1653561653826,CSE 274,A00,090132,Ramamoorthi; Ravi,0,0,0,0
1653561654349,CSE 276A,A00,090133,Christensen; Henrik I,0,0,0,0
1653561654897,CSE 276C,A00,090134,Christensen; Henrik I,0,0,0,0
1653561655431,CSE 290,A00,090135,Bafna; Vineet,0,0,0,0
1653561655431,CSE 290,B00,090136,Ramamoorthi; Ravi,0,0,0,0
1653561655431,CSE 290,C00,090137,Li; Tzumao,8,0,10,2
1653561655431,CSE 290,D00,090138,Zhou; Yuan-Yuan,9,0,10,1
1653561655431,CSE 290,E00,090139,Christensen; Henrik I,8,0,10,2
1653561655431,CSE 290,F00,094053,Shalev; Aaron D,0,0,0,0
1653561655958,CSE 291,A00,090140,Munyaka; Imani N. S.,0,0,0,0
1653561655958,CSE 291,B00,094880,Yu; Qi,0,0,0,0
1653561655958,CSE 291,C00,090142,Pannuto; Patrick William,0,0,0,0
1653561655958,CSE 291,D00,094881,Zhang; Yiying,0,0,0,0
1653561655958,CSE 291,E00,095118,Su; Hao,0,0,0,0
1653561656498,CSE 293,001,094905,Bafna; Vineet,9999,0,9999,0
1653561656498,CSE 293,002,094906,Bellare; Mihir,9999,0,9999,0
1653561656498,CSE 293,003,094907,Berg-Kirkpatrick; Taylor D,9999,0,9999,0
1653561656498,CSE 293,004,094908,Christensen; Henrik I,9999,0,9999,0
1653561656498,CSE 293,005,094909,Cottrell; Garrison W,9999,0,9999,0
1653561656498,CSE 293,006,094910,Deutsch; Alin Bernard,9999,0,9999,0
1653561656498,CSE 293,007,094911,Esmaeilzadeh; Hadi,9999,0,9999,0
1653561656498,CSE 293,008,094912,Freund; Yoav,9999,0,9999,0
1653561656498,CSE 293,009,094913,Griswold; William G.,9999,0,9999,0
1653561656498,CSE 293,010,094914,Gymrek; Melissa Ann,9999,0,9999,0
1653561656498,CSE 293,011,094915,Heninger; Nadia A,9999,0,9999,0
1653561656498,CSE 293,012,094916,Impagliazzo; Russell,9999,0,9999,0
1653561656498,CSE 293,013,094917,Jhala; Ranjit,9999,0,9999,0
1653561656498,CSE 293,014,094918,Kahng; Andrew Byun,9999,0,9999,0
1653561656498,CSE 293,015,094919,Kane; Daniel Mertz,9999,0,9999,0
1653561656498,CSE 293,016,094920,Kriegman; David J,9999,0,9999,0
1653561656498,CSE 293,017,094921,Kumar; Arun Kumar,9999,0,9999,0
1653561656498,CSE 293,018,094922,Lerner; Sorin,9999,0,9999,0
1653561656498,CSE 293,019,094923,Lovett; Shachar,9999,0,9999,0
1653561656498,CSE 293,020,094924,McAuley; Julian John,9999,0,9999,0
1653561656498,CSE 293,021,094925,Micciancio; Daniele,9999,0,9999,0
1653561656498,CSE 293,022,094926,Orailoglu; Alex,9999,0,9999,0
1653561656498,CSE 293,023,094927,Paturi; Ramamohan,9999,0,9999,0
1653561656498,CSE 293,024,094928,Polikarpova; Nadezhda,9999,0,9999,0
1653561656498,CSE 293,025,094929,Politz; Joseph Gibbs,9999,0,9999,0
1653561656498,CSE 293,026,094930,Porter; George M,9999,0,9999,0
1653561656498,CSE 293,027,094931,Porter; Leonard Emerson,9999,0,9999,0
1653561656498,CSE 293,028,094932,Ramamoorthi; Ravi,9999,0,9999,0
1653561656498,CSE 293,029,094933,Sahoo; Debashis,9999,0,9999,0
1653561656498,CSE 293,030,094934,Saul; Lawrence,9999,0,9999,0
1653561656498,CSE 293,031,094935,Savage; Stefan,9999,0,9999,0
1653561656498,CSE 293,032,094936,Schulze; Jurgen P.,9999,0,9999,0
1653561656498,CSE 293,033,094937,Snoeren; Alex C.,9999,0,9999,0
1653561656498,CSE 293,034,094938,Shang; Jingbo,9999,0,9999,0
1653561656498,CSE 293,035,094939,Stefan; Deian,9999,0,9999,0
1653561656498,CSE 293,036,094940,Su; Hao,9999,0,9999,0
1653561656498,CSE 293,037,094941,Swanson; Steven James,9999,0,9999,0
1653561656498,CSE 293,038,094942,Tullsen; Dean Michael,9999,0,9999,0
1653561656498,CSE 293,039,094943,Voelker; Geoffrey M.,9999,0,9999,0
1653561656498,CSE 293,040,094944,Zhao; Jishen,9999,0,9999,0
1653561656498,CSE 293,041,094945,Zhou; Yuan-Yuan,9999,0,9999,0
1653561656498,CSE 293,042,094946,Gao; Sicun,9998,0,9999,1
1653561656498,CSE 293,043,094947,Weibel; Nadir,9999,0,9999,0
1653561656498,CSE 293,044,094948,Gupta; Rajesh K.,9999,0,9999,0
1653561657025,CSE 294,A00,090143,Porter; George M,8,0,10,2
1653561657549,DSE 200,A00,091799,Staff,50,0,50,0
1653561658073,DSE 203,A00,091800,Gupta; Amarnath,30,0,30,0
1653561658599,DSE 250,A00,091801,Deutsch; Alin Bernard,30,0,30,0
1653561659123,DSE 290,A00,091802,Altintas De Callaf; Ilkay,50,0,50,0
1653561659679,ECE 200,001,091003,Antipa; Nicholas A,9999,0,9999,0
1653561659679,ECE 200,002,091004,Atanasov; Nikolay A.,9999,0,9999,0
1653561659679,ECE 200,003,091005,Bharadia; Dinesh,9999,0,9999,0
1653561659679,ECE 200,004,091006,Cheng; Chung Kuan,9999,0,9999,0
1653561659679,ECE 200,005,091007,Cosman; Pamela C.,9999,0,9999,0
1653561659679,ECE 200,006,091008,Staff,9999,0,9999,0
1653561659679,ECE 200,007,091009,Dayeh; Shadi Ahmad,9999,0,9999,0
1653561659679,ECE 200,008,091010,Fainman; Yeshaiahu,9999,0,9999,0
1653561659679,ECE 200,009,091011,Ford; Joseph Earl,9999,0,9999,0
1653561659679,ECE 200,010,091012,Franceschetti; Massimo,9999,0,9999,0
1653561659679,ECE 200,011,091013,Fullerton; Eric E,9999,0,9999,0
1653561659679,ECE 200,012,091014,Galton; Ian A,9999,0,9999,0
1653561659679,ECE 200,013,091015,Gilja; Vikash,9999,0,9999,0
1653561659679,ECE 200,014,091016,Hall; Drew A.,9999,0,9999,0
1653561659679,ECE 200,015,091017,Hsueh; Tzu-Chien,9999,0,9999,0
1653561659679,ECE 200,016,091018,Javidi; Tara,9999,0,9999,0
1653561659679,ECE 200,017,091019,Kahng; Andrew Byun,9999,0,9999,0
1653561659679,ECE 200,018,091020,Kim; Young-Han,9999,0,9999,0
1653561659679,ECE 200,019,091021,Koushanfar; Farinaz,9999,0,9999,0
1653561659679,ECE 200,020,091022,Kuzum; Duygu,9999,0,9999,0
1653561659679,ECE 200,021,091023,Le; Hanh-Phuc,9999,0,9999,0
1653561659679,ECE 200,022,091024,Lin; Bill,9999,0,9999,0
1653561659679,ECE 200,023,091025,Liu; Zhaowei,9999,0,9999,0
1653561659679,ECE 200,024,091026,Lo; Yu-Hwa,9999,0,9999,0
1653561659679,ECE 200,025,091027,Lomakin; Vitaliy,9999,0,9999,0
1653561659679,ECE 200,026,091028,Mercier; Patrick Philip,9999,0,9999,0
1653561659679,ECE 200,027,091029,Meyer; Florian,9999,0,9999,0
1653561659679,ECE 200,028,091030,Milstein; Laurence B.,9999,0,9999,0
1653561659679,ECE 200,029,091031,Mir Arabbaygi; Siavash,9999,0,9999,0
1653561659679,ECE 200,030,091032,Mookherjea; Shayan,9999,0,9999,0
1653561659679,ECE 200,031,091033,Morris; Karcher William,9999,0,9999,0
1653561659679,ECE 200,032,091034,Ng; Tse Nga,9999,0,9999,0
1653561659679,ECE 200,033,091035,Nguyen; Truong Quang,9999,0,9999,0
1653561659679,ECE 200,034,091036,Nomura; Kenji,9999,0,9999,0
1653561659679,ECE 200,035,091037,Orlitsky; Alon,9999,0,9999,0
1653561659679,ECE 200,036,091038,Pal; Piya,9999,0,9999,0
1653561659679,ECE 200,037,091039,Papen; George C.,9999,0,9999,0
1653561659679,ECE 200,038,091040,Radic; Stojan,9999,0,9999,0
1653561659679,ECE 200,039,091041,Rao; Bhaskar D.,9999,0,9999,0
1653561659679,ECE 200,040,091042,Rao; Ramesh R,9999,0,9999,0
1653561659679,ECE 200,041,091043,Rebeiz; Gabriel,9999,0,9999,0
1653561659679,ECE 200,042,091044,Sanford; John R,9999,0,9999,0
1653561659679,ECE 200,043,091045,Siegel; Paul H.,9999,0,9999,0
1653561659679,ECE 200,044,091046,Sievenpiper; Daniel F.,9999,0,9999,0
1653561659679,ECE 200,045,091047,Sworder; David D.,9999,0,9999,0
1653561659679,ECE 200,046,091048,Taur; Yuan,9999,0,9999,0
1653561659679,ECE 200,047,091049,Touri; Behrouz,9999,0,9999,0
1653561659679,ECE 200,048,091050,Trivedi; Mohan M.,9999,0,9999,0
1653561659679,ECE 200,049,091051,Vardy; Alexander,9999,0,9999,0
1653561659679,ECE 200,050,091052,Vasconcelos; Nuno,9999,0,9999,0
1653561659679,ECE 200,051,091053,Wang; Xiaolong,9999,0,9999,0
1653561659679,ECE 200,052,091054,Xie; Pengtao,9999,0,9999,0
1653561659679,ECE 200,053,091055,Yip; Michael,9999,0,9999,0
1653561659679,ECE 200,054,091056,Zeger; Kenneth A.,9999,0,9999,0
1653561659679,ECE 200,055,091057,Zhang; Xinyu,9999,0,9999,0
1653561659679,ECE 200,056,091058,Turakhia; Yatish Girish,9999,0,9999,0
1653561659679,ECE 200,057,091059,Kang; Mingu,9999,0,9999,0
1653561659679,ECE 200,058,091060,Shi; Yuanyuan,9999,0,9999,0
1653561659679,ECE 200,059,091061,Wang; Edward Jay,9999,0,9999,0
1653561659679,ECE 200,060,091062,Zheng; Yang,9999,0,9999,0
1653561660211,ECE 201,A00,095526,Lo; Yu-Hwa,0,0,0,0
1653561660734,ECE 203,A00,091065,Mercier; Patrick Philip,0,0,0,0
1653561661258,ECE 207A,A00,091605,Liu; Thomas Tao-Ming,0,0,0,0
1653561661789,ECE 212AN,A00,091068,Nomura; Kenji,0,0,0,0
1653561662312,ECE 222A,A00,091069,Rebeiz; Gabriel,0,0,0,0
1653561662835,ECE 225A,A00,091070,Orlitsky; Alon,0,0,0,0
1653561663359,ECE 230A,A00,091071,Nomura; Kenji,0,0,0,0
1653561663883,ECE 236A,A00,091072,Dayeh; Shadi Ahmad,0,0,0,0
1653561664408,ECE 238A,A00,091073,Luo; Jian,0,0,0,0
1653561664408,ECE 238A,B00,091074,Luo; Jian,0,0,0,0
1653561664932,ECE 240A,A00,091075,Radic; Stojan,0,0,0,0
1653561665458,ECE 247A,A00,091592,Shi; Lingyan,0,0,0,0
1653561665985,ECE 250,A00,091076,Touri; Behrouz,0,0,0,0
1653561666513,ECE 251C,A00,091078,Nguyen; Truong Quang,0,0,0,0
1653561667040,ECE 253,A00,091079,Cosman; Pamela C.,0,0,0,0
1653561667563,ECE 255A,A00,091080,Orlitsky; Alon,0,0,0,0
1653561668088,ECE 257A,A00,091081,Zhang; Xinyu,0,0,0,0
1653561668616,ECE 260A,A01,091084,Eldon; John,0,0,0,0
1653561669158,ECE 264C,A00,091085,Galton; Ian A,0,0,0,0
1653561669686,ECE 265C,A00,094889,Presti; Calogero Davide,0,0,0,9
1653561670223,ECE 266,A01,091087,Hall; Drew A.,0,0,0,0
1653561671272,ECE 271A,A00,091090,Vasconcelos; Nuno,0,0,0,0
1653561671796,ECE 272B,A00,091091,Sworder; David D.,0,0,0,0
1653561672319,ECE 275A,A00,091092,Meyer; Florian,0,0,0,0
1653561672865,ECE 277,A00,091093,An; Cheolhong,0,0,0,0
1653561673388,ECE 283,A00,091094,Le; Hanh-Phuc,0,0,0,0
1653561673912,ECE 284,A00,091095,Kang; Mingu,0,0,0,0
1653561673912,ECE 284,B00,091096,Wang; Edward Jay,0,0,0,0
1653561674440,ECE 285,A00,094334,Touri; Behrouz,0,0,0,0
1653561674967,ECE 289,A00,091097,Whelan; David Arthur,0,0,0,0
1653561675498,MATH 200A,A00,087414,Salehi Golsefidy; Alireza,7,0,8,1
1653561676029,MATH 202A,A00,087415,Gill; Philip E.,2,0,8,6
1653561676554,MATH 203A,A00,087416,Oprea; Dragos N.,6,0,8,2
1653561677080,MATH 204A,A00,087417,Kedlaya; Kiran S.,6,0,8,2
1653561677604,MATH 205,A00,087418,Sorensen; Claus M,6,0,8,2
1653561678130,MATH 206A,A00,087419,Izadi; Elham,7,0,8,1
1653561678657,MATH 207A,A00,087420,Mohammadi; Amir,5,0,8,3
1653561679180,MATH 208,A00,087421,Staff,9,0,10,1
1653561679705,MATH 209,A00,087422,Staff,10,0,10,0
1653561680228,MATH 218,A00,087423,Staff,10,0,10,0
1653561680759,MATH 220A,A00,087424,Novak; Jonathan I,6,0,8,2
1653561681283,MATH 231A,A00,087425,Bejenaru; Ioan,3,0,8,5
1653561681807,MATH 240A,A00,087426,Ebenfelt; Peter F,5,0,8,3
1653561682330,MATH 243,A00,087427,Staff,9,0,10,1
1653561682856,MATH 248,A00,087429,Staff,10,0,10,0
1653561683389,MATH 250A,A00,087430,Spolaor; Luca,4,0,8,4
1653561683915,MATH 257A,A00,087431,Spolaor; Luca,7,0,8,1
1653561684439,MATH 258,A00,087432,Staff,9,0,10,1
1653561684965,MATH 264A,A00,087433,Warnke; Lutz Peter,5,0,8,3
1653561685489,MATH 268,A00,087434,Staff,15,0,15,0
1653561686013,MATH 269,A00,087435,Staff,14,0,15,1
1653561686535,MATH 270A,A00,087436,Nie; Jiawang,0,0,8,8
1653561687062,MATH 272A,A00,087437,Tian; Xiaochuan,1,0,8,7
1653561687588,MATH 274,A01,087439,Cheng; Li-Tien,9,0,10,1
1653561687588,MATH 274,A02,087440,Cheng; Li-Tien,10,0,10,0
1653561688113,MATH 278A,A00,087441,Staff,8,0,10,2
1653561688635,MATH 278B,A00,087442,Staff,8,0,10,2
1653561689161,MATH 278C,A00,087443,Staff,8,0,10,2
1653561689688,MATH 280A,A00,087444,Zheng; Tianyi,0,0,8,8
1653561690212,MATH 281A,A00,087445,Bradic; Jelena,0,0,8,8
1653561690736,MATH 282A,A00,087446,Zhang; Danna,0,0,8,8
1653561691263,MATH 283,A00,087447,Tesler; Glenn,0,0,0,15
1653561691797,MATH 286,A00,087448,Kemp; Todd Aahron,5,0,8,3
1653561692320,MATH 287D,A00,087449,Bradic; Jelena,0,0,0,1
1653561692848,MATH 288,A00,087450,Staff,14,0,15,1
1653561692848,MATH 288,B00,087451,Staff,15,0,15,0
1653561692848,MATH 288,C00,087452,Staff,15,0,15,0
1653561693375,MATH 290A,A00,087453,Xu; Zhouli,6,0,8,2
1653561693902,MATH 291A,A00,087454,Xu; Zhouli,7,0,8,1
1653561694424,MATH 292,A00,087455,Staff,10,0,10,0
1653561694949,MATH 295,A00,087456,Staff,50,0,50,0
1653561695473,MATH 297,001,087457,Staff,998,0,999,1
1653562256065,COGS 200,A01,087991,Staff,47,0,50,3
1653562256595,COGS 201,A01,094504,Rangel; Lara M,17,0,25,8
1653562257120,COGS 203,A00,087992,Coulson; Seana M,18,0,20,2
1653562257648,COGS 210A,001,087993,Greene; Deanna Jacquelyn,9998,0,9999,1
1653562257648,COGS 210A,002,087994,Saygin; Ayse P,9999,0,9999,0
1653562257648,COGS 210A,003,087995,Xia; Haijun,9999,0,9999,0
1653562257648,COGS 210A,004,087996,Nitz; Douglas A.,9999,0,9999,0
1653562257648,COGS 210A,005,087997,Hollan; James D.,9999,0,9999,0
1653562257648,COGS 210A,006,087998,Deak; Gedeon O.,9998,0,9999,1
1653562257648,COGS 210A,007,087999,Rossano; Federico,9999,0,9999,0
1653562258172,COGS 211A,A00,088000,Coulson; Seana M,9997,0,9999,2
1653562258696,COGS 229,A00,088002,Staff,22,0,25,3
1653562259220,COGS 260,B00,094231,Staff,17,0,20,3
1653562259220,COGS 260,A00,088004,Nitz; Douglas A.,9998,0,9999,1
1653562259746,CSE 202,A00,090110,Paturi; Ramamohan,0,0,0,0
1653562259746,CSE 202,B00,090111,Paturi; Ramamohan,0,0,0,0
1653562260285,CSE 207B,A00,090112,Heninger; Nadia A,0,0,0,0
1653562260813,CSE 208,A00,094858,Micciancio; Daniele,0,0,0,0
1653562261340,CSE 210,A00,090113,Powell; Thomas Allan,0,0,0,0
1653562261867,CSE 219,A00,090898,Staff,0,0,0,0
1653562262395,CSE 221,A00,090114,Zhou; Yuan-Yuan,0,0,0,0
1653562262918,CSE 229A,A00,090115,Porter; George M,0,0,0,0
1653562263442,CSE 229C,A00,090116,Savage; Stefan,0,0,0,0
1653562263968,CSE 230,A00,090117,Jhala; Ranjit,0,0,0,0
1653562264492,CSE 232,A00,090118,Papakonstantinou; Yannis,0,0,0,0
1653562265023,CSE 239A,A00,090121,Kumar; Arun Kumar,0,0,0,0
1653562265547,CSE 239B,A00,090122,Jhala; Ranjit,0,0,0,0
1653562266075,CSE 240A,A00,090123,Zhao; Jishen,1,0,189,188
1653562266599,CSE 243A,A00,090124,Orailoglu; Alex,0,0,15,15
1653562267127,CSE 249B,A00,090125,Kahng; Andrew Byun,13,0,20,7
1653562267660,CSE 250A,A00,090126,Berg-Kirkpatrick; Taylor D,0,0,0,0
1653562268185,CSE 252A,A00,090127,Ochoa; Benjamin Lawrence,0,0,0,0
1653562268715,CSE 258,A01,090129,McAuley; Julian John,0,0,0,0
1653562269246,CSE 258R,A01,090131,McAuley; Julian John,0,0,0,0
1653562269774,CSE 274,A00,090132,Ramamoorthi; Ravi,0,0,0,0
1653562270297,CSE 276A,A00,090133,Christensen; Henrik I,0,0,0,0
1653562270821,CSE 276C,A00,090134,Christensen; Henrik I,0,0,0,0
1653562271356,CSE 290,A00,090135,Bafna; Vineet,0,0,0,0
1653562271356,CSE 290,B00,090136,Ramamoorthi; Ravi,0,0,0,0
1653562271356,CSE 290,C00,090137,Li; Tzumao,8,0,10,2
1653562271356,CSE 290,D00,090138,Zhou; Yuan-Yuan,9,0,10,1
1653562271356,CSE 290,E00,090139,Christensen; Henrik I,8,0,10,2
1653562271356,CSE 290,F00,094053,Shalev; Aaron D,0,0,0,0
1653562271882,CSE 291,A00,090140,Munyaka; Imani N. S.,0,0,0,0
1653562271882,CSE 291,B00,094880,Yu; Qi,0,0,0,0
1653562271882,CSE 291,C00,090142,Pannuto; Patrick William,0,0,0,0
1653562271882,CSE 291,D00,094881,Zhang; Yiying,0,0,0,0
1653562271882,CSE 291,E00,095118,Su; Hao,0,0,0,0
1653562272457,CSE 293,001,094905,Bafna; Vineet,9999,0,9999,0
1653562272457,CSE 293,002,094906,Bellare; Mihir,9999,0,9999,0
1653562272457,CSE 293,003,094907,Berg-Kirkpatrick; Taylor D,9999,0,9999,0
1653562272457,CSE 293,004,094908,Christensen; Henrik I,9999,0,9999,0
1653562272457,CSE 293,005,094909,Cottrell; Garrison W,9999,0,9999,0
1653562272457,CSE 293,006,094910,Deutsch; Alin Bernard,9999,0,9999,0
1653562272457,CSE 293,007,094911,Esmaeilzadeh; Hadi,9999,0,9999,0
1653562272457,CSE 293,008,094912,Freund; Yoav,9999,0,9999,0
1653562272457,CSE 293,009,094913,Griswold; William G.,9999,0,9999,0
1653562272457,CSE 293,010,094914,Gymrek; Melissa Ann,9999,0,9999,0
1653562272457,CSE 293,011,094915,Heninger; Nadia A,9999,0,9999,0
1653562272457,CSE 293,012,094916,Impagliazzo; Russell,9999,0,9999,0
1653562272457,CSE 293,013,094917,Jhala; Ranjit,9999,0,9999,0
1653562272457,CSE 293,014,094918,Kahng; Andrew Byun,9999,0,9999,0
1653562272457,CSE 293,015,094919,Kane; Daniel Mertz,9999,0,9999,0
1653562272457,CSE 293,016,094920,Kriegman; David J,9999,0,9999,0
1653562272457,CSE 293,017,094921,Kumar; Arun Kumar,9999,0,9999,0
1653562272457,CSE 293,018,094922,Lerner; Sorin,9999,0,9999,0
1653562272457,CSE 293,019,094923,Lovett; Shachar,9999,0,9999,0
1653562272457,CSE 293,020,094924,McAuley; Julian John,9999,0,9999,0
1653562272457,CSE 293,021,094925,Micciancio; Daniele,9999,0,9999,0
1653562272457,CSE 293,022,094926,Orailoglu; Alex,9999,0,9999,0
1653562272457,CSE 293,023,094927,Paturi; Ramamohan,9999,0,9999,0
1653562272457,CSE 293,024,094928,Polikarpova; Nadezhda,9999,0,9999,0
1653562272457,CSE 293,025,094929,Politz; Joseph Gibbs,9999,0,9999,0
1653562272457,CSE 293,026,094930,Porter; George M,9999,0,9999,0
1653562272457,CSE 293,027,094931,Porter; Leonard Emerson,9999,0,9999,0
1653562272457,CSE 293,028,094932,Ramamoorthi; Ravi,9999,0,9999,0
1653562272457,CSE 293,029,094933,Sahoo; Debashis,9999,0,9999,0
1653562272457,CSE 293,030,094934,Saul; Lawrence,9999,0,9999,0
1653562272457,CSE 293,031,094935,Savage; Stefan,9999,0,9999,0
1653562272457,CSE 293,032,094936,Schulze; Jurgen P.,9999,0,9999,0
1653562272457,CSE 293,033,094937,Snoeren; Alex C.,9999,0,9999,0
1653562272457,CSE 293,034,094938,Shang; Jingbo,9999,0,9999,0
1653562272457,CSE 293,035,094939,Stefan; Deian,9999,0,9999,0
1653562272457,CSE 293,036,094940,Su; Hao,9999,0,9999,0
1653562272457,CSE 293,037,094941,Swanson; Steven James,9999,0,9999,0
1653562272457,CSE 293,038,094942,Tullsen; Dean Michael,9999,0,9999,0
1653562272457,CSE 293,039,094943,Voelker; Geoffrey M.,9999,0,9999,0
1653562272457,CSE 293,040,094944,Zhao; Jishen,9999,0,9999,0
1653562272457,CSE 293,041,094945,Zhou; Yuan-Yuan,9999,0,9999,0
1653562272457,CSE 293,042,094946,Gao; Sicun,9998,0,9999,1
1653562272457,CSE 293,043,094947,Weibel; Nadir,9999,0,9999,0
1653562272457,CSE 293,044,094948,Gupta; Rajesh K.,9999,0,9999,0
1653562272988,CSE 294,A00,090143,Porter; George M,8,0,10,2
1653562273517,DSE 200,A00,091799,Staff,50,0,50,0
1653562274041,DSE 203,A00,091800,Gupta; Amarnath,30,0,30,0
1653562274567,DSE 250,A00,091801,Deutsch; Alin Bernard,30,0,30,0
1653562275094,DSE 290,A00,091802,Altintas De Callaf; Ilkay,50,0,50,0
1653562275648,ECE 200,001,091003,Antipa; Nicholas A,9999,0,9999,0
1653562275648,ECE 200,002,091004,Atanasov; Nikolay A.,9999,0,9999,0
1653562275648,ECE 200,003,091005,Bharadia; Dinesh,9999,0,9999,0
1653562275648,ECE 200,004,091006,Cheng; Chung Kuan,9999,0,9999,0
1653562275648,ECE 200,005,091007,Cosman; Pamela C.,9999,0,9999,0
1653562275648,ECE 200,006,091008,Staff,9999,0,9999,0
1653562275648,ECE 200,007,091009,Dayeh; Shadi Ahmad,9999,0,9999,0
1653562275648,ECE 200,008,091010,Fainman; Yeshaiahu,9999,0,9999,0
1653562275648,ECE 200,009,091011,Ford; Joseph Earl,9999,0,9999,0
1653562275648,ECE 200,010,091012,Franceschetti; Massimo,9999,0,9999,0
1653562275648,ECE 200,011,091013,Fullerton; Eric E,9999,0,9999,0
1653562275648,ECE 200,012,091014,Galton; Ian A,9999,0,9999,0
1653562275648,ECE 200,013,091015,Gilja; Vikash,9999,0,9999,0
1653562275648,ECE 200,014,091016,Hall; Drew A.,9999,0,9999,0
1653562275648,ECE 200,015,091017,Hsueh; Tzu-Chien,9999,0,9999,0
1653562275648,ECE 200,016,091018,Javidi; Tara,9999,0,9999,0
1653562275648,ECE 200,017,091019,Kahng; Andrew Byun,9999,0,9999,0
1653562275648,ECE 200,018,091020,Kim; Young-Han,9999,0,9999,0
1653562275648,ECE 200,019,091021,Koushanfar; Farinaz,9999,0,9999,0
1653562275648,ECE 200,020,091022,Kuzum; Duygu,9999,0,9999,0
1653562275648,ECE 200,021,091023,Le; Hanh-Phuc,9999,0,9999,0
1653562275648,ECE 200,022,091024,Lin; Bill,9999,0,9999,0
1653562275648,ECE 200,023,091025,Liu; Zhaowei,9999,0,9999,0
1653562275648,ECE 200,024,091026,Lo; Yu-Hwa,9999,0,9999,0
1653562275648,ECE 200,025,091027,Lomakin; Vitaliy,9999,0,9999,0
1653562275648,ECE 200,026,091028,Mercier; Patrick Philip,9999,0,9999,0
1653562275648,ECE 200,027,091029,Meyer; Florian,9999,0,9999,0
1653562275648,ECE 200,028,091030,Milstein; Laurence B.,9999,0,9999,0
1653562275648,ECE 200,029,091031,Mir Arabbaygi; Siavash,9999,0,9999,0
1653562275648,ECE 200,030,091032,Mookherjea; Shayan,9999,0,9999,0
1653562275648,ECE 200,031,091033,Morris; Karcher William,9999,0,9999,0
1653562275648,ECE 200,032,091034,Ng; Tse Nga,9999,0,9999,0
1653562275648,ECE 200,033,091035,Nguyen; Truong Quang,9999,0,9999,0
1653562275648,ECE 200,034,091036,Nomura; Kenji,9999,0,9999,0
1653562275648,ECE 200,035,091037,Orlitsky; Alon,9999,0,9999,0
1653562275648,ECE 200,036,091038,Pal; Piya,9999,0,9999,0
1653562275648,ECE 200,037,091039,Papen; George C.,9999,0,9999,0
1653562275648,ECE 200,038,091040,Radic; Stojan,9999,0,9999,0
1653562275648,ECE 200,039,091041,Rao; Bhaskar D.,9999,0,9999,0
1653562275648,ECE 200,040,091042,Rao; Ramesh R,9999,0,9999,0
1653562275648,ECE 200,041,091043,Rebeiz; Gabriel,9999,0,9999,0
1653562275648,ECE 200,042,091044,Sanford; John R,9999,0,9999,0
1653562275648,ECE 200,043,091045,Siegel; Paul H.,9999,0,9999,0
1653562275648,ECE 200,044,091046,Sievenpiper; Daniel F.,9999,0,9999,0
1653562275648,ECE 200,045,091047,Sworder; David D.,9999,0,9999,0
1653562275648,ECE 200,046,091048,Taur; Yuan,9999,0,9999,0
1653562275648,ECE 200,047,091049,Touri; Behrouz,9999,0,9999,0
1653562275648,ECE 200,048,091050,Trivedi; Mohan M.,9999,0,9999,0
1653562275648,ECE 200,049,091051,Vardy; Alexander,9999,0,9999,0
1653562275648,ECE 200,050,091052,Vasconcelos; Nuno,9999,0,9999,0
1653562275648,ECE 200,051,091053,Wang; Xiaolong,9999,0,9999,0
1653562275648,ECE 200,052,091054,Xie; Pengtao,9999,0,9999,0
1653562275648,ECE 200,053,091055,Yip; Michael,9999,0,9999,0
1653562275648,ECE 200,054,091056,Zeger; Kenneth A.,9999,0,9999,0
1653562275648,ECE 200,055,091057,Zhang; Xinyu,9999,0,9999,0
1653562275648,ECE 200,056,091058,Turakhia; Yatish Girish,9999,0,9999,0
1653562275648,ECE 200,057,091059,Kang; Mingu,9999,0,9999,0
1653562275648,ECE 200,058,091060,Shi; Yuanyuan,9999,0,9999,0
1653562275648,ECE 200,059,091061,Wang; Edward Jay,9999,0,9999,0
1653562275648,ECE 200,060,091062,Zheng; Yang,9999,0,9999,0
1653562276178,ECE 201,A00,095526,Lo; Yu-Hwa,0,0,0,0
1653562276702,ECE 203,A00,091065,Mercier; Patrick Philip,0,0,0,0
1653562277230,ECE 207A,A00,091605,Liu; Thomas Tao-Ming,0,0,0,0
1653562277754,ECE 212AN,A00,091068,Nomura; Kenji,0,0,0,0
1653562278284,ECE 222A,A00,091069,Rebeiz; Gabriel,0,0,0,0
1653562278808,ECE 225A,A00,091070,Orlitsky; Alon,0,0,0,0
1653562279332,ECE 230A,A00,091071,Nomura; Kenji,0,0,0,0
1653562279856,ECE 236A,A00,091072,Dayeh; Shadi Ahmad,0,0,0,0
1653562280399,ECE 238A,A00,091073,Luo; Jian,0,0,0,0
1653562280399,ECE 238A,B00,091074,Luo; Jian,0,0,0,0
1653562280926,ECE 240A,A00,091075,Radic; Stojan,0,0,0,0
1653562281460,ECE 247A,A00,091592,Shi; Lingyan,0,0,0,0
1653562281988,ECE 250,A00,091076,Touri; Behrouz,0,0,0,0
1653562282518,ECE 251C,A00,091078,Nguyen; Truong Quang,0,0,0,0
1653562283042,ECE 253,A00,091079,Cosman; Pamela C.,0,0,0,0
1653562283569,ECE 255A,A00,091080,Orlitsky; Alon,0,0,0,0
1653562284098,ECE 257A,A00,091081,Zhang; Xinyu,0,0,0,0
1653562284629,ECE 260A,A01,091084,Eldon; John,0,0,0,0
1653562285154,ECE 264C,A00,091085,Galton; Ian A,0,0,0,0
1653562285683,ECE 265C,A00,094889,Presti; Calogero Davide,0,0,0,9
1653562286215,ECE 266,A01,091087,Hall; Drew A.,0,0,0,0
1653562287264,ECE 271A,A00,091090,Vasconcelos; Nuno,0,0,0,0
1653562287856,ECE 272B,A00,091091,Sworder; David D.,0,0,0,0
1653562288390,ECE 275A,A00,091092,Meyer; Florian,0,0,0,0
1653562288920,ECE 277,A00,091093,An; Cheolhong,0,0,0,0
1653562289445,ECE 283,A00,091094,Le; Hanh-Phuc,0,0,0,0
1653562289971,ECE 284,A00,091095,Kang; Mingu,0,0,0,0
1653562289971,ECE 284,B00,091096,Wang; Edward Jay,0,0,0,0
1653562290500,ECE 285,A00,094334,Touri; Behrouz,0,0,0,0
1653562291027,ECE 289,A00,091097,Whelan; David Arthur,0,0,0,0
1653562291558,MATH 200A,A00,087414,Salehi Golsefidy; Alireza,7,0,8,1
1653562292084,MATH 202A,A00,087415,Gill; Philip E.,2,0,8,6
1653562292609,MATH 203A,A00,087416,Oprea; Dragos N.,6,0,8,2
1653562293138,MATH 204A,A00,087417,Kedlaya; Kiran S.,6,0,8,2
1653562293665,MATH 205,A00,087418,Sorensen; Claus M,6,0,8,2
1653562294194,MATH 206A,A00,087419,Izadi; Elham,7,0,8,1
1653562294718,MATH 207A,A00,087420,Mohammadi; Amir,5,0,8,3
1653562295240,MATH 208,A00,087421,Staff,9,0,10,1
1653562295769,MATH 209,A00,087422,Staff,10,0,10,0
1653562296295,MATH 218,A00,087423,Staff,10,0,10,0
1653562296828,MATH 220A,A00,087424,Novak; Jonathan I,6,0,8,2
1653562297354,MATH 231A,A00,087425,Bejenaru; Ioan,3,0,8,5
1653562297882,MATH 240A,A00,087426,Ebenfelt; Peter F,5,0,8,3
1653562298407,MATH 243,A00,087427,Staff,9,0,10,1
1653562298936,MATH 248,A00,087429,Staff,10,0,10,0
1653562299466,MATH 250A,A00,087430,Spolaor; Luca,4,0,8,4
1653562299994,MATH 257A,A00,087431,Spolaor; Luca,7,0,8,1
1653562300518,MATH 258,A00,087432,Staff,9,0,10,1
1653562301043,MATH 264A,A00,087433,Warnke; Lutz Peter,5,0,8,3
1653562301571,MATH 268,A00,087434,Staff,15,0,15,0
1653562302100,MATH 269,A00,087435,Staff,14,0,15,1
1653562302624,MATH 270A,A00,087436,Nie; Jiawang,0,0,8,8
1653562303149,MATH 272A,A00,087437,Tian; Xiaochuan,1,0,8,7
1653562303685,MATH 274,A01,087439,Cheng; Li-Tien,9,0,10,1
1653562303685,MATH 274,A02,087440,Cheng; Li-Tien,10,0,10,0
1653562304211,MATH 278A,A00,087441,Staff,8,0,10,2
1653562304735,MATH 278B,A00,087442,Staff,8,0,10,2
1653562305262,MATH 278C,A00,087443,Staff,8,0,10,2
1653562305786,MATH 280A,A00,087444,Zheng; Tianyi,0,0,8,8
1653562306312,MATH 281A,A00,087445,Bradic; Jelena,0,0,8,8
1653562306840,MATH 282A,A00,087446,Zhang; Danna,0,0,8,8
1653562307364,MATH 283,A00,087447,Tesler; Glenn,0,0,0,15
1653562307890,MATH 286,A00,087448,Kemp; Todd Aahron,5,0,8,3
1653562308415,MATH 287D,A00,087449,Bradic; Jelena,0,0,0,1
1653562308945,MATH 288,A00,087450,Staff,14,0,15,1
1653562308945,MATH 288,B00,087451,Staff,15,0,15,0
1653562308945,MATH 288,C00,087452,Staff,15,0,15,0
1653562309474,MATH 290A,A00,087453,Xu; Zhouli,6,0,8,2
1653562310001,MATH 291A,A00,087454,Xu; Zhouli,7,0,8,1
1653562310525,MATH 292,A00,087455,Staff,10,0,10,0
1653562311049,MATH 295,A00,087456,Staff,50,0,50,0
1653562311577,MATH 297,001,087457,Staff,998,0,999,1
1653563018429,COGS 200,A01,087991,Staff,47,0,50,3
1653563018955,COGS 201,A01,094504,Rangel; Lara M,17,0,25,8
1653563019480,COGS 203,A00,087992,Coulson; Seana M,18,0,20,2
1653563020010,COGS 210A,001,087993,Greene; Deanna Jacquelyn,9998,0,9999,1
1653563020010,COGS 210A,002,087994,Saygin; Ayse P,9999,0,9999,0
1653563020010,COGS 210A,003,087995,Xia; Haijun,9999,0,9999,0
1653563020010,COGS 210A,004,087996,Nitz; Douglas A.,9999,0,9999,0
1653563020010,COGS 210A,005,087997,Hollan; James D.,9999,0,9999,0
1653563020010,COGS 210A,006,087998,Deak; Gedeon O.,9998,0,9999,1
1653563020010,COGS 210A,007,087999,Rossano; Federico,9999,0,9999,0
1653563020532,COGS 211A,A00,088000,Coulson; Seana M,9997,0,9999,2
1653563021060,COGS 229,A00,088002,Staff,22,0,25,3
1653563021588,COGS 260,B00,094231,Staff,17,0,20,3
1653563021588,COGS 260,A00,088004,Nitz; Douglas A.,9998,0,9999,1
1653563022196,CSE 202,A00,090110,Paturi; Ramamohan,0,0,0,0
1653563022196,CSE 202,B00,090111,Paturi; Ramamohan,0,0,0,0
1653563022719,CSE 207B,A00,090112,Heninger; Nadia A,0,0,0,0
1653563023243,CSE 208,A00,094858,Micciancio; Daniele,0,0,0,0
1653563023767,CSE 210,A00,090113,Powell; Thomas Allan,0,0,0,0
1653563024295,CSE 219,A00,090898,Staff,0,0,0,0
1653563024818,CSE 221,A00,090114,Zhou; Yuan-Yuan,0,0,0,0
1653563025353,CSE 229A,A00,090115,Porter; George M,0,0,0,0
1653563025876,CSE 229C,A00,090116,Savage; Stefan,0,0,0,0
1653563026405,CSE 230,A00,090117,Jhala; Ranjit,0,0,0,0
1653563026938,CSE 232,A00,090118,Papakonstantinou; Yannis,0,0,0,0
1653563027465,CSE 239A,A00,090121,Kumar; Arun Kumar,0,0,0,0
1653563027993,CSE 239B,A00,090122,Jhala; Ranjit,0,0,0,0
1653563028516,CSE 240A,A00,090123,Zhao; Jishen,1,0,189,188
1653563029041,CSE 243A,A00,090124,Orailoglu; Alex,0,0,15,15
1653563029565,CSE 249B,A00,090125,Kahng; Andrew Byun,13,0,20,7
1653563030090,CSE 250A,A00,090126,Berg-Kirkpatrick; Taylor D,0,0,0,0
1653563030617,CSE 252A,A00,090127,Ochoa; Benjamin Lawrence,0,0,0,0
1653563031145,CSE 258,A01,090129,McAuley; Julian John,0,0,0,0
1653563031677,CSE 258R,A01,090131,McAuley; Julian John,0,0,0,0
1653563032211,CSE 274,A00,090132,Ramamoorthi; Ravi,0,0,0,0
1653563032746,CSE 276A,A00,090133,Christensen; Henrik I,0,0,0,0
1653563033269,CSE 276C,A00,090134,Christensen; Henrik I,0,0,0,0
1653563033798,CSE 290,A00,090135,Bafna; Vineet,0,0,0,0
1653563033798,CSE 290,B00,090136,Ramamoorthi; Ravi,0,0,0,0
1653563033798,CSE 290,C00,090137,Li; Tzumao,8,0,10,2
1653563033798,CSE 290,D00,090138,Zhou; Yuan-Yuan,9,0,10,1
1653563033798,CSE 290,E00,090139,Christensen; Henrik I,8,0,10,2
1653563033798,CSE 290,F00,094053,Shalev; Aaron D,0,0,0,0
1653563034326,CSE 291,A00,090140,Munyaka; Imani N. S.,0,0,0,0
1653563034326,CSE 291,B00,094880,Yu; Qi,0,0,0,0
1653563034326,CSE 291,C00,090142,Pannuto; Patrick William,0,0,0,0
1653563034326,CSE 291,D00,094881,Zhang; Yiying,0,0,0,0
1653563034326,CSE 291,E00,095118,Su; Hao,0,0,0,0
1653563034865,CSE 293,001,094905,Bafna; Vineet,9999,0,9999,0
1653563034865,CSE 293,002,094906,Bellare; Mihir,9999,0,9999,0
1653563034865,CSE 293,003,094907,Berg-Kirkpatrick; Taylor D,9999,0,9999,0
1653563034865,CSE 293,004,094908,Christensen; Henrik I,9999,0,9999,0
1653563034865,CSE 293,005,094909,Cottrell; Garrison W,9999,0,9999,0
1653563034865,CSE 293,006,094910,Deutsch; Alin Bernard,9999,0,9999,0
1653563034865,CSE 293,007,094911,Esmaeilzadeh; Hadi,9999,0,9999,0
1653563034865,CSE 293,008,094912,Freund; Yoav,9999,0,9999,0
1653563034865,CSE 293,009,094913,Griswold; William G.,9999,0,9999,0
1653563034865,CSE 293,010,094914,Gymrek; Melissa Ann,9999,0,9999,0
1653563034865,CSE 293,011,094915,Heninger; Nadia A,9999,0,9999,0
1653563034865,CSE 293,012,094916,Impagliazzo; Russell,9999,0,9999,0
1653563034865,CSE 293,013,094917,Jhala; Ranjit,9999,0,9999,0
1653563034865,CSE 293,014,094918,Kahng; Andrew Byun,9999,0,9999,0
1653563034865,CSE 293,015,094919,Kane; Daniel Mertz,9999,0,9999,0
1653563034865,CSE 293,016,094920,Kriegman; David J,9999,0,9999,0
1653563034865,CSE 293,017,094921,Kumar; Arun Kumar,9999,0,9999,0
1653563034865,CSE 293,018,094922,Lerner; Sorin,9999,0,9999,0
1653563034865,CSE 293,019,094923,Lovett; Shachar,9999,0,9999,0
1653563034865,CSE 293,020,094924,McAuley; Julian John,9999,0,9999,0
1653563034865,CSE 293,021,094925,Micciancio; Daniele,9999,0,9999,0
1653563034865,CSE 293,022,094926,Orailoglu; Alex,9999,0,9999,0
1653563034865,CSE 293,023,094927,Paturi; Ramamohan,9999,0,9999,0
1653563034865,CSE 293,024,094928,Polikarpova; Nadezhda,9999,0,9999,0
1653563034865,CSE 293,025,094929,Politz; Joseph Gibbs,9999,0,9999,0
1653563034865,CSE 293,026,094930,Porter; George M,9999,0,9999,0
1653563034865,CSE 293,027,094931,Porter; Leonard Emerson,9999,0,9999,0
1653563034865,CSE 293,028,094932,Ramamoorthi; Ravi,9999,0,9999,0
1653563034865,CSE 293,029,094933,Sahoo; Debashis,9999,0,9999,0
1653563034865,CSE 293,030,094934,Saul; Lawrence,9999,0,9999,0
1653563034865,CSE 293,031,094935,Savage; Stefan,9999,0,9999,0
1653563034865,CSE 293,032,094936,Schulze; Jurgen P.,9999,0,9999,0
1653563034865,CSE 293,033,094937,Snoeren; Alex C.,9999,0,9999,0
1653563034865,CSE 293,034,094938,Shang; Jingbo,9999,0,9999,0
1653563034865,CSE 293,035,094939,Stefan; Deian,9999,0,9999,0
1653563034865,CSE 293,036,094940,Su; Hao,9999,0,9999,0
1653563034865,CSE 293,037,094941,Swanson; Steven James,9999,0,9999,0
1653563034865,CSE 293,038,094942,Tullsen; Dean Michael,9999,0,9999,0
1653563034865,CSE 293,039,094943,Voelker; Geoffrey M.,9999,0,9999,0
1653563034865,CSE 293,040,094944,Zhao; Jishen,9999,0,9999,0
1653563034865,CSE 293,041,094945,Zhou; Yuan-Yuan,9999,0,9999,0
1653563034865,CSE 293,042,094946,Gao; Sicun,9998,0,9999,1
1653563034865,CSE 293,043,094947,Weibel; Nadir,9999,0,9999,0
1653563034865,CSE 293,044,094948,Gupta; Rajesh K.,9999,0,9999,0
1653563035388,CSE 294,A00,090143,Porter; George M,8,0,10,2
1653563035918,DSE 200,A00,091799,Staff,50,0,50,0
1653563036446,DSE 203,A00,091800,Gupta; Amarnath,30,0,30,0
1653563036970,DSE 250,A00,091801,Deutsch; Alin Bernard,30,0,30,0
1653563037496,DSE 290,A00,091802,Altintas De Callaf; Ilkay,50,0,50,0
1653563038054,ECE 200,001,091003,Antipa; Nicholas A,9999,0,9999,0
1653563038054,ECE 200,002,091004,Atanasov; Nikolay A.,9999,0,9999,0
1653563038054,ECE 200,003,091005,Bharadia; Dinesh,9999,0,9999,0
1653563038054,ECE 200,004,091006,Cheng; Chung Kuan,9999,0,9999,0
1653563038054,ECE 200,005,091007,Cosman; Pamela C.,9999,0,9999,0
1653563038054,ECE 200,006,091008,Staff,9999,0,9999,0
1653563038054,ECE 200,007,091009,Dayeh; Shadi Ahmad,9999,0,9999,0
1653563038054,ECE 200,008,091010,Fainman; Yeshaiahu,9999,0,9999,0
1653563038054,ECE 200,009,091011,Ford; Joseph Earl,9999,0,9999,0
1653563038054,ECE 200,010,091012,Franceschetti; Massimo,9999,0,9999,0
1653563038054,ECE 200,011,091013,Fullerton; Eric E,9999,0,9999,0
1653563038054,ECE 200,012,091014,Galton; Ian A,9999,0,9999,0
1653563038054,ECE 200,013,091015,Gilja; Vikash,9999,0,9999,0
1653563038054,ECE 200,014,091016,Hall; Drew A.,9999,0,9999,0
1653563038054,ECE 200,015,091017,Hsueh; Tzu-Chien,9999,0,9999,0
1653563038054,ECE 200,016,091018,Javidi; Tara,9999,0,9999,0
1653563038054,ECE 200,017,091019,Kahng; Andrew Byun,9999,0,9999,0
1653563038054,ECE 200,018,091020,Kim; Young-Han,9999,0,9999,0
1653563038054,ECE 200,019,091021,Koushanfar; Farinaz,9999,0,9999,0
1653563038054,ECE 200,020,091022,Kuzum; Duygu,9999,0,9999,0
1653563038054,ECE 200,021,091023,Le; Hanh-Phuc,9999,0,9999,0
1653563038054,ECE 200,022,091024,Lin; Bill,9999,0,9999,0
1653563038054,ECE 200,023,091025,Liu; Zhaowei,9999,0,9999,0
1653563038054,ECE 200,024,091026,Lo; Yu-Hwa,9999,0,9999,0
1653563038054,ECE 200,025,091027,Lomakin; Vitaliy,9999,0,9999,0
1653563038054,ECE 200,026,091028,Mercier; Patrick Philip,9999,0,9999,0
1653563038054,ECE 200,027,091029,Meyer; Florian,9999,0,9999,0
1653563038054,ECE 200,028,091030,Milstein; Laurence B.,9999,0,9999,0
1653563038054,ECE 200,029,091031,Mir Arabbaygi; Siavash,9999,0,9999,0
1653563038054,ECE 200,030,091032,Mookherjea; Shayan,9999,0,9999,0
1653563038054,ECE 200,031,091033,Morris; Karcher William,9999,0,9999,0
1653563038054,ECE 200,032,091034,Ng; Tse Nga,9999,0,9999,0
1653563038054,ECE 200,033,091035,Nguyen; Truong Quang,9999,0,9999,0
1653563038054,ECE 200,034,091036,Nomura; Kenji,9999,0,9999,0
1653563038054,ECE 200,035,091037,Orlitsky; Alon,9999,0,9999,0
1653563038054,ECE 200,036,091038,Pal; Piya,9999,0,9999,0
1653563038054,ECE 200,037,091039,Papen; George C.,9999,0,9999,0
1653563038054,ECE 200,038,091040,Radic; Stojan,9999,0,9999,0
1653563038054,ECE 200,039,091041,Rao; Bhaskar D.,9999,0,9999,0
1653563038054,ECE 200,040,091042,Rao; Ramesh R,9999,0,9999,0
1653563038054,ECE 200,041,091043,Rebeiz; Gabriel,9999,0,9999,0
1653563038054,ECE 200,042,091044,Sanford; John R,9999,0,9999,0
1653563038054,ECE 200,043,091045,Siegel; Paul H.,9999,0,9999,0
1653563038054,ECE 200,044,091046,Sievenpiper; Daniel F.,9999,0,9999,0
1653563038054,ECE 200,045,091047,Sworder; David D.,9999,0,9999,0
1653563038054,ECE 200,046,091048,Taur; Yuan,9999,0,9999,0
1653563038054,ECE 200,047,091049,Touri; Behrouz,9999,0,9999,0
1653563038054,ECE 200,048,091050,Trivedi; Mohan M.,9999,0,9999,0
1653563038054,ECE 200,049,091051,Vardy; Alexander,9999,0,9999,0
1653563038054,ECE 200,050,091052,Vasconcelos; Nuno,9999,0,9999,0
1653563038054,ECE 200,051,091053,Wang; Xiaolong,9999,0,9999,0
1653563038054,ECE 200,052,091054,Xie; Pengtao,9999,0,9999,0
1653563038054,ECE 200,053,091055,Yip; Michael,9999,0,9999,0
1653563038054,ECE 200,054,091056,Zeger; Kenneth A.,9999,0,9999,0
1653563038054,ECE 200,055,091057,Zhang; Xinyu,9999,0,9999,0
1653563038054,ECE 200,056,091058,Turakhia; Yatish Girish,9999,0,9999,0
1653563038054,ECE 200,057,091059,Kang; Mingu,9999,0,9999,0
1653563038054,ECE 200,058,091060,Shi; Yuanyuan,9999,0,9999,0
1653563038054,ECE 200,059,091061,Wang; Edward Jay,9999,0,9999,0
1653563038054,ECE 200,060,091062,Zheng; Yang,9999,0,9999,0
1653563038585,ECE 201,A00,095526,Lo; Yu-Hwa,0,0,0,0
1653563039109,ECE 203,A00,091065,Mercier; Patrick Philip,0,0,0,0
1653563039636,ECE 207A,A00,091605,Liu; Thomas Tao-Ming,0,0,0,0
1653563040165,ECE 212AN,A00,091068,Nomura; Kenji,0,0,0,0
1653563040692,ECE 222A,A00,091069,Rebeiz; Gabriel,0,0,0,0
1653563041216,ECE 225A,A00,091070,Orlitsky; Alon,0,0,0,0
1653563041743,ECE 230A,A00,091071,Nomura; Kenji,0,0,0,0
1653563042267,ECE 236A,A00,091072,Dayeh; Shadi Ahmad,0,0,0,0
1653563042792,ECE 238A,A00,091073,Luo; Jian,0,0,0,0
1653563042792,ECE 238A,B00,091074,Luo; Jian,0,0,0,0
1653563043316,ECE 240A,A00,091075,Radic; Stojan,0,0,0,0
1653563043842,ECE 247A,A00,091592,Shi; Lingyan,0,0,0,0
1653563044367,ECE 250,A00,091076,Touri; Behrouz,0,0,0,0
1653563044894,ECE 251C,A00,091078,Nguyen; Truong Quang,0,0,0,0
1653563045419,ECE 253,A00,091079,Cosman; Pamela C.,0,0,0,0
1653563045944,ECE 255A,A00,091080,Orlitsky; Alon,0,0,0,0
1653563046471,ECE 257A,A00,091081,Zhang; Xinyu,0,0,0,0
1653563046997,ECE 260A,A01,091084,Eldon; John,0,0,0,0
1653563047522,ECE 264C,A00,091085,Galton; Ian A,0,0,0,0
1653563048047,ECE 265C,A00,094889,Presti; Calogero Davide,0,0,0,9
1653563048577,ECE 266,A01,091087,Hall; Drew A.,0,0,0,0
1653563049629,ECE 271A,A00,091090,Vasconcelos; Nuno,0,0,0,0
1653563050152,ECE 272B,A00,091091,Sworder; David D.,0,0,0,0
1653563050676,ECE 275A,A00,091092,Meyer; Florian,0,0,0,0
1653563051205,ECE 277,A00,091093,An; Cheolhong,0,0,0,0
1653563051729,ECE 283,A00,091094,Le; Hanh-Phuc,0,0,0,0
1653563052258,ECE 284,A00,091095,Kang; Mingu,0,0,0,0
1653563052258,ECE 284,B00,091096,Wang; Edward Jay,0,0,0,0
1653563052787,ECE 285,A00,094334,Touri; Behrouz,0,0,0,0
1653563053312,ECE 289,A00,091097,Whelan; David Arthur,0,0,0,0
1653563053843,MATH 200A,A00,087414,Salehi Golsefidy; Alireza,7,0,8,1
1653563054372,MATH 202A,A00,087415,Gill; Philip E.,2,0,8,6
1653563054901,MATH 203A,A00,087416,Oprea; Dragos N.,6,0,8,2
1653563055428,MATH 204A,A00,087417,Kedlaya; Kiran S.,6,0,8,2
1653563055957,MATH 205,A00,087418,Sorensen; Claus M,6,0,8,2
1653563056480,MATH 206A,A00,087419,Izadi; Elham,7,0,8,1
1653563057007,MATH 207A,A00,087420,Mohammadi; Amir,5,0,8,3
1653563057531,MATH 208,A00,087421,Staff,9,0,10,1
1653563058055,MATH 209,A00,087422,Staff,10,0,10,0
1653563058583,MATH 218,A00,087423,Staff,10,0,10,0
1653563059108,MATH 220A,A00,087424,Novak; Jonathan I,6,0,8,2
1653563059632,MATH 231A,A00,087425,Bejenaru; Ioan,3,0,8,5
1653563060158,MATH 240A,A00,087426,Ebenfelt; Peter F,5,0,8,3
1653563060688,MATH 243,A00,087427,Staff,9,0,10,1
1653563061211,MATH 248,A00,087429,Staff,10,0,10,0
1653563061736,MATH 250A,A00,087430,Spolaor; Luca,4,0,8,4
1653563062265,MATH 257A,A00,087431,Spolaor; Luca,7,0,8,1
1653563062789,MATH 258,A00,087432,Staff,9,0,10,1
1653563063315,MATH 264A,A00,087433,Warnke; Lutz Peter,5,0,8,3
1653563063841,MATH 268,A00,087434,Staff,15,0,15,0
1653563064363,MATH 269,A00,087435,Staff,14,0,15,1
1653563064886,MATH 270A,A00,087436,Nie; Jiawang,0,0,8,8
1653563065416,MATH 272A,A00,087437,Tian; Xiaochuan,1,0,8,7
1653563065948,MATH 274,A01,087439,Cheng; Li-Tien,9,0,10,1
1653563065948,MATH 274,A02,087440,Cheng; Li-Tien,10,0,10,0
1653563066473,MATH 278A,A00,087441,Staff,8,0,10,2
1653563066997,MATH 278B,A00,087442,Staff,8,0,10,2
1653563067521,MATH 278C,A00,087443,Staff,8,0,10,2
1653563068045,MATH 280A,A00,087444,Zheng; Tianyi,0,0,8,8
1653563068572,MATH 281A,A00,087445,Bradic; Jelena,0,0,8,8
1653563069102,MATH 282A,A00,087446,Zhang; Danna,0,0,8,8
1653563069628,MATH 283,A00,087447,Tesler; Glenn,0,0,0,15
1653563070154,MATH 286,A00,087448,Kemp; Todd Aahron,5,0,8,3
1653563070684,MATH 287D,A00,087449,Bradic; Jelena,0,0,0,1
1653563071210,MATH 288,A00,087450,Staff,14,0,15,1
1653563071210,MATH 288,B00,087451,Staff,15,0,15,0
1653563071210,MATH 288,C00,087452,Staff,15,0,15,0
1653563071737,MATH 290A,A00,087453,Xu; Zhouli,6,0,8,2
1653563072264,MATH 291A,A00,087454,Xu; Zhouli,7,0,8,1
1653563072812,MATH 292,A00,087455,Staff,10,0,10,0
1653563073334,MATH 295,A00,087456,Staff,50,0,50,0
1653563073858,MATH 297,001,087457,Staff,998,0,999,1
1653563641562,COGS 200,A01,087991,Staff,47,0,50,3
1653563642088,COGS 201,A01,094504,Rangel; Lara M,17,0,25,8
1653563642611,COGS 203,A00,087992,Coulson; Seana M,18,0,20,2
1653563643139,COGS 210A,001,087993,Greene; Deanna Jacquelyn,9998,0,9999,1
1653563643139,COGS 210A,002,087994,Saygin; Ayse P,9999,0,9999,0
1653563643139,COGS 210A,003,087995,Xia; Haijun,9999,0,9999,0
1653563643139,COGS 210A,004,087996,Nitz; Douglas A.,9999,0,9999,0
1653563643139,COGS 210A,005,087997,Hollan; James D.,9999,0,9999,0
1653563643139,COGS 210A,006,087998,Deak; Gedeon O.,9998,0,9999,1
1653563643139,COGS 210A,007,087999,Rossano; Federico,9999,0,9999,0
1653563643666,COGS 211A,A00,088000,Coulson; Seana M,9997,0,9999,2
1653563644194,COGS 229,A00,088002,Staff,22,0,25,3
1653563644720,COGS 260,B00,094231,Staff,17,0,20,3
1653563644720,COGS 260,A00,088004,Nitz; Douglas A.,9998,0,9999,1
1653563645244,CSE 202,A00,090110,Paturi; Ramamohan,0,0,0,0
1653563645244,CSE 202,B00,090111,Paturi; Ramamohan,0,0,0,0
1653563645768,CSE 207B,A00,090112,Heninger; Nadia A,0,0,0,0
1653563646374,CSE 208,A00,094858,Micciancio; Daniele,0,0,0,0
1653563646899,CSE 210,A00,090113,Powell; Thomas Allan,0,0,0,0
1653563647422,CSE 219,A00,090898,Staff,0,0,0,0
1653563647945,CSE 221,A00,090114,Zhou; Yuan-Yuan,0,0,0,0
1653563648469,CSE 229A,A00,090115,Porter; George M,0,0,0,0
1653563648995,CSE 229C,A00,090116,Savage; Stefan,0,0,0,0
1653563649524,CSE 230,A00,090117,Jhala; Ranjit,0,0,0,0
1653563650046,CSE 232,A00,090118,Papakonstantinou; Yannis,0,0,0,0
1653563650574,CSE 239A,A00,090121,Kumar; Arun Kumar,0,0,0,0
1653563651102,CSE 239B,A00,090122,Jhala; Ranjit,0,0,0,0
1653563651626,CSE 240A,A00,090123,Zhao; Jishen,1,0,189,188
1653563652150,CSE 243A,A00,090124,Orailoglu; Alex,0,0,15,15
1653563652674,CSE 249B,A00,090125,Kahng; Andrew Byun,13,0,20,7
1653563653199,CSE 250A,A00,090126,Berg-Kirkpatrick; Taylor D,0,0,0,0
1653563653722,CSE 252A,A00,090127,Ochoa; Benjamin Lawrence,0,0,0,0
1653563654245,CSE 258,A01,090129,McAuley; Julian John,0,0,0,0
1653563654776,CSE 258R,A01,090131,McAuley; Julian John,0,0,0,0
1653563655302,CSE 274,A00,090132,Ramamoorthi; Ravi,0,0,0,0
1653563655830,CSE 276A,A00,090133,Christensen; Henrik I,0,0,0,0
1653563656355,CSE 276C,A00,090134,Christensen; Henrik I,0,0,0,0
1653563656886,CSE 290,A00,090135,Bafna; Vineet,0,0,0,0
1653563656886,CSE 290,B00,090136,Ramamoorthi; Ravi,0,0,0,0
1653563656886,CSE 290,C00,090137,Li; Tzumao,8,0,10,2
1653563656886,CSE 290,D00,090138,Zhou; Yuan-Yuan,9,0,10,1
1653563656886,CSE 290,E00,090139,Christensen; Henrik I,8,0,10,2
1653563656886,CSE 290,F00,094053,Shalev; Aaron D,0,0,0,0
1653563657423,CSE 291,A00,090140,Munyaka; Imani N. S.,0,0,0,0
1653563657423,CSE 291,B00,094880,Yu; Qi,0,0,0,0
1653563657423,CSE 291,C00,090142,Pannuto; Patrick William,0,0,0,0
1653563657423,CSE 291,D00,094881,Zhang; Yiying,0,0,0,0
1653563657423,CSE 291,E00,095118,Su; Hao,0,0,0,0
1653563657961,CSE 293,001,094905,Bafna; Vineet,9999,0,9999,0
1653563657961,CSE 293,002,094906,Bellare; Mihir,9999,0,9999,0
1653563657961,CSE 293,003,094907,Berg-Kirkpatrick; Taylor D,9999,0,9999,0
1653563657961,CSE 293,004,094908,Christensen; Henrik I,9999,0,9999,0
1653563657961,CSE 293,005,094909,Cottrell; Garrison W,9999,0,9999,0
1653563657961,CSE 293,006,094910,Deutsch; Alin Bernard,9999,0,9999,0
1653563657961,CSE 293,007,094911,Esmaeilzadeh; Hadi,9999,0,9999,0
1653563657961,CSE 293,008,094912,Freund; Yoav,9999,0,9999,0
1653563657961,CSE 293,009,094913,Griswold; William G.,9999,0,9999,0
1653563657961,CSE 293,010,094914,Gymrek; Melissa Ann,9999,0,9999,0
1653563657961,CSE 293,011,094915,Heninger; Nadia A,9999,0,9999,0
1653563657961,CSE 293,012,094916,Impagliazzo; Russell,9999,0,9999,0
1653563657961,CSE 293,013,094917,Jhala; Ranjit,9999,0,9999,0
1653563657961,CSE 293,014,094918,Kahng; Andrew Byun,9999,0,9999,0
1653563657961,CSE 293,015,094919,Kane; Daniel Mertz,9999,0,9999,0
1653563657961,CSE 293,016,094920,Kriegman; David J,9999,0,9999,0
1653563657961,CSE 293,017,094921,Kumar; Arun Kumar,9999,0,9999,0
1653563657961,CSE 293,018,094922,Lerner; Sorin,9999,0,9999,0
1653563657961,CSE 293,019,094923,Lovett; Shachar,9999,0,9999,0
1653563657961,CSE 293,020,094924,McAuley; Julian John,9999,0,9999,0
1653563657961,CSE 293,021,094925,Micciancio; Daniele,9999,0,9999,0
1653563657961,CSE 293,022,094926,Orailoglu; Alex,9999,0,9999,0
1653563657961,CSE 293,023,094927,Paturi; Ramamohan,9999,0,9999,0
1653563657961,CSE 293,024,094928,Polikarpova; Nadezhda,9999,0,9999,0
1653563657961,CSE 293,025,094929,Politz; Joseph Gibbs,9999,0,9999,0
1653563657961,CSE 293,026,094930,Porter; George M,9999,0,9999,0
1653563657961,CSE 293,027,094931,Porter; Leonard Emerson,9999,0,9999,0
1653563657961,CSE 293,028,094932,Ramamoorthi; Ravi,9999,0,9999,0
1653563657961,CSE 293,029,094933,Sahoo; Debashis,9999,0,9999,0
1653563657961,CSE 293,030,094934,Saul; Lawrence,9999,0,9999,0
1653563657961,CSE 293,031,094935,Savage; Stefan,9999,0,9999,0
1653563657961,CSE 293,032,094936,Schulze; Jurgen P.,9999,0,9999,0
1653563657961,CSE 293,033,094937,Snoeren; Alex C.,9999,0,9999,0
1653563657961,CSE 293,034,094938,Shang; Jingbo,9999,0,9999,0
1653563657961,CSE 293,035,094939,Stefan; Deian,9999,0,9999,0
1653563657961,CSE 293,036,094940,Su; Hao,9999,0,9999,0
1653563657961,CSE 293,037,094941,Swanson; Steven James,9999,0,9999,0
1653563657961,CSE 293,038,094942,Tullsen; Dean Michael,9999,0,9999,0
1653563657961,CSE 293,039,094943,Voelker; Geoffrey M.,9999,0,9999,0
1653563657961,CSE 293,040,094944,Zhao; Jishen,9999,0,9999,0
1653563657961,CSE 293,041,094945,Zhou; Yuan-Yuan,9999,0,9999,0
1653563657961,CSE 293,042,094946,Gao; Sicun,9998,0,9999,1
1653563657961,CSE 293,043,094947,Weibel; Nadir,9999,0,9999,0
1653563657961,CSE 293,044,094948,Gupta; Rajesh K.,9999,0,9999,0
1653563658484,CSE 294,A00,090143,Porter; George M,8,0,10,2
1653563659013,DSE 200,A00,091799,Staff,50,0,50,0
1653563659540,DSE 203,A00,091800,Gupta; Amarnath,30,0,30,0
1653563660065,DSE 250,A00,091801,Deutsch; Alin Bernard,30,0,30,0
1653563660592,DSE 290,A00,091802,Altintas De Callaf; Ilkay,50,0,50,0
1653563661146,ECE 200,001,091003,Antipa; Nicholas A,9999,0,9999,0
1653563661146,ECE 200,002,091004,Atanasov; Nikolay A.,9999,0,9999,0
1653563661146,ECE 200,003,091005,Bharadia; Dinesh,9999,0,9999,0
1653563661146,ECE 200,004,091006,Cheng; Chung Kuan,9999,0,9999,0
1653563661146,ECE 200,005,091007,Cosman; Pamela C.,9999,0,9999,0
1653563661146,ECE 200,006,091008,Staff,9999,0,9999,0
1653563661146,ECE 200,007,091009,Dayeh; Shadi Ahmad,9999,0,9999,0
1653563661146,ECE 200,008,091010,Fainman; Yeshaiahu,9999,0,9999,0
1653563661146,ECE 200,009,091011,Ford; Joseph Earl,9999,0,9999,0
1653563661146,ECE 200,010,091012,Franceschetti; Massimo,9999,0,9999,0
1653563661146,ECE 200,011,091013,Fullerton; Eric E,9999,0,9999,0
1653563661146,ECE 200,012,091014,Galton; Ian A,9999,0,9999,0
1653563661146,ECE 200,013,091015,Gilja; Vikash,9999,0,9999,0
1653563661146,ECE 200,014,091016,Hall; Drew A.,9999,0,9999,0
1653563661146,ECE 200,015,091017,Hsueh; Tzu-Chien,9999,0,9999,0
1653563661146,ECE 200,016,091018,Javidi; Tara,9999,0,9999,0
1653563661146,ECE 200,017,091019,Kahng; Andrew Byun,9999,0,9999,0
1653563661146,ECE 200,018,091020,Kim; Young-Han,9999,0,9999,0
1653563661146,ECE 200,019,091021,Koushanfar; Farinaz,9999,0,9999,0
1653563661146,ECE 200,020,091022,Kuzum; Duygu,9999,0,9999,0
1653563661146,ECE 200,021,091023,Le; Hanh-Phuc,9999,0,9999,0
1653563661146,ECE 200,022,091024,Lin; Bill,9999,0,9999,0
1653563661146,ECE 200,023,091025,Liu; Zhaowei,9999,0,9999,0
1653563661146,ECE 200,024,091026,Lo; Yu-Hwa,9999,0,9999,0
1653563661146,ECE 200,025,091027,Lomakin; Vitaliy,9999,0,9999,0
1653563661146,ECE 200,026,091028,Mercier; Patrick Philip,9999,0,9999,0
1653563661146,ECE 200,027,091029,Meyer; Florian,9999,0,9999,0
1653563661146,ECE 200,028,091030,Milstein; Laurence B.,9999,0,9999,0
1653563661146,ECE 200,029,091031,Mir Arabbaygi; Siavash,9999,0,9999,0
1653563661146,ECE 200,030,091032,Mookherjea; Shayan,9999,0,9999,0
1653563661146,ECE 200,031,091033,Morris; Karcher William,9999,0,9999,0
1653563661146,ECE 200,032,091034,Ng; Tse Nga,9999,0,9999,0
1653563661146,ECE 200,033,091035,Nguyen; Truong Quang,9999,0,9999,0
1653563661146,ECE 200,034,091036,Nomura; Kenji,9999,0,9999,0
1653563661146,ECE 200,035,091037,Orlitsky; Alon,9999,0,9999,0
1653563661146,ECE 200,036,091038,Pal; Piya,9999,0,9999,0
1653563661146,ECE 200,037,091039,Papen; George C.,9999,0,9999,0
1653563661146,ECE 200,038,091040,Radic; Stojan,9999,0,9999,0
1653563661146,ECE 200,039,091041,Rao; Bhaskar D.,9999,0,9999,0
1653563661146,ECE 200,040,091042,Rao; Ramesh R,9999,0,9999,0
1653563661146,ECE 200,041,091043,Rebeiz; Gabriel,9999,0,9999,0
1653563661146,ECE 200,042,091044,Sanford; John R,9999,0,9999,0
1653563661146,ECE 200,043,091045,Siegel; Paul H.,9999,0,9999,0
1653563661146,ECE 200,044,091046,Sievenpiper; Daniel F.,9999,0,9999,0
1653563661146,ECE 200,045,091047,Sworder; David D.,9999,0,9999,0
1653563661146,ECE 200,046,091048,Taur; Yuan,9999,0,9999,0
1653563661146,ECE 200,047,091049,Touri; Behrouz,9999,0,9999,0
1653563661146,ECE 200,048,091050,Trivedi; Mohan M.,9999,0,9999,0
1653563661146,ECE 200,049,091051,Vardy; Alexander,9999,0,9999,0
1653563661146,ECE 200,050,091052,Vasconcelos; Nuno,9999,0,9999,0
1653563661146,ECE 200,051,091053,Wang; Xiaolong,9999,0,9999,0
1653563661146,ECE 200,052,091054,Xie; Pengtao,9999,0,9999,0
1653563661146,ECE 200,053,091055,Yip; Michael,9999,0,9999,0
1653563661146,ECE 200,054,091056,Zeger; Kenneth A.,9999,0,9999,0
1653563661146,ECE 200,055,091057,Zhang; Xinyu,9999,0,9999,0
1653563661146,ECE 200,056,091058,Turakhia; Yatish Girish,9999,0,9999,0
1653563661146,ECE 200,057,091059,Kang; Mingu,9999,0,9999,0
1653563661146,ECE 200,058,091060,Shi; Yuanyuan,9999,0,9999,0
1653563661146,ECE 200,059,091061,Wang; Edward Jay,9999,0,9999,0
1653563661146,ECE 200,060,091062,Zheng; Yang,9999,0,9999,0
1653563661671,ECE 201,A00,095526,Lo; Yu-Hwa,0,0,0,0
1653563662200,ECE 203,A00,091065,Mercier; Patrick Philip,0,0,0,0
1653563662726,ECE 207A,A00,091605,Liu; Thomas Tao-Ming,0,0,0,0
1653563663250,ECE 212AN,A00,091068,Nomura; Kenji,0,0,0,0
1653563663777,ECE 222A,A00,091069,Rebeiz; Gabriel,0,0,0,0
1653563664305,ECE 225A,A00,091070,Orlitsky; Alon,0,0,0,0
1653563664833,ECE 230A,A00,091071,Nomura; Kenji,0,0,0,0
1653563665358,ECE 236A,A00,091072,Dayeh; Shadi Ahmad,0,0,0,0
1653563665887,ECE 238A,A00,091073,Luo; Jian,0,0,0,0
1653563665887,ECE 238A,B00,091074,Luo; Jian,0,0,0,0
1653563666411,ECE 240A,A00,091075,Radic; Stojan,0,0,0,0
1653563666936,ECE 247A,A00,091592,Shi; Lingyan,0,0,0,0
1653563667461,ECE 250,A00,091076,Touri; Behrouz,0,0,0,0
1653563667986,ECE 251C,A00,091078,Nguyen; Truong Quang,0,0,0,0
1653563668511,ECE 253,A00,091079,Cosman; Pamela C.,0,0,0,0
1653563669055,ECE 255A,A00,091080,Orlitsky; Alon,0,0,0,0
1653563669586,ECE 257A,A00,091081,Zhang; Xinyu,0,0,0,0
1653563670114,ECE 260A,A01,091084,Eldon; John,0,0,0,0
1653563670637,ECE 264C,A00,091085,Galton; Ian A,0,0,0,0
1653563671168,ECE 265C,A00,094889,Presti; Calogero Davide,0,0,0,9
1653563671692,ECE 266,A01,091087,Hall; Drew A.,0,0,0,0
1653563672741,ECE 271A,A00,091090,Vasconcelos; Nuno,0,0,0,0
1653563673267,ECE 272B,A00,091091,Sworder; David D.,0,0,0,0
1653563673791,ECE 275A,A00,091092,Meyer; Florian,0,0,0,0
1653563674315,ECE 277,A00,091093,An; Cheolhong,0,0,0,0
1653563674840,ECE 283,A00,091094,Le; Hanh-Phuc,0,0,0,0
1653563675365,ECE 284,A00,091095,Kang; Mingu,0,0,0,0
1653563675365,ECE 284,B00,091096,Wang; Edward Jay,0,0,0,0
1653563675891,ECE 285,A00,094334,Touri; Behrouz,0,0,0,0
1653563676415,ECE 289,A00,091097,Whelan; David Arthur,0,0,0,0
1653563676940,MATH 200A,A00,087414,Salehi Golsefidy; Alireza,7,0,8,1
1653563677465,MATH 202A,A00,087415,Gill; Philip E.,2,0,8,6
1653563677995,MATH 203A,A00,087416,Oprea; Dragos N.,6,0,8,2
1653563678520,MATH 204A,A00,087417,Kedlaya; Kiran S.,6,0,8,2
1653563679046,MATH 205,A00,087418,Sorensen; Claus M,6,0,8,2
1653563679571,MATH 206A,A00,087419,Izadi; Elham,7,0,8,1
1653563680095,MATH 207A,A00,087420,Mohammadi; Amir,5,0,8,3
1653563680622,MATH 208,A00,087421,Staff,9,0,10,1
1653563681145,MATH 209,A00,087422,Staff,10,0,10,0
1653563681669,MATH 218,A00,087423,Staff,10,0,10,0
1653563682193,MATH 220A,A00,087424,Novak; Jonathan I,6,0,8,2
1653563682717,MATH 231A,A00,087425,Bejenaru; Ioan,3,0,8,5
1653563683243,MATH 240A,A00,087426,Ebenfelt; Peter F,5,0,8,3
