time,subj_course_id,sec_code,sec_id,prof,available,waitlist,total,enrolled_ct
1653426236354,COGS 200,A01,087991,Staff,47,0,50,3
1653426236878,COGS 201,A01,094504,Rangel; Lara M,17,0,25,8
1653426237405,COGS 203,A00,087992,Coulson; Seana M,18,0,20,2
1653426237947,COGS 210A,001,087993,Greene; Deanna Jacquelyn,9998,0,9999,1
1653426237947,COGS 210A,002,087994,Saygin; Ayse P,9999,0,9999,0
1653426237947,COGS 210A,003,087995,Xia; Haijun,9999,0,9999,0
1653426237947,COGS 210A,004,087996,Nitz; Douglas A.,9999,0,9999,0
1653426237947,COGS 210A,005,087997,Hollan; James D.,9999,0,9999,0
1653426237947,COGS 210A,006,087998,Deak; Gedeon O.,9998,0,9999,1
1653426237947,COGS 210A,007,087999,Rossano; Federico,9999,0,9999,0
1653426238486,COGS 211A,A00,088000,Coulson; Seana M,9997,0,9999,2
1653426239012,COGS 229,A00,088002,Staff,23,0,25,2
1653426239536,COGS 260,B00,094231,Staff,17,0,20,3
1653426239536,COGS 260,A00,088004,Nitz; Douglas A.,9998,0,9999,1
1653426240063,CSE 202,A00,090110,Paturi; Ramamohan,0,0,0,0
1653426240063,CSE 202,B00,090111,Paturi; Ramamohan,0,0,0,0
1653426240599,CSE 207B,A00,090112,Heninger; Nadia A,0,0,0,0
1653426241126,CSE 208,A00,094858,Micciancio; Daniele,0,0,0,0
1653426241648,CSE 210,A00,090113,Powell; Thomas Allan,0,0,0,0
1653426242184,CSE 219,A00,090898,Staff,0,0,0,0
1653426242707,CSE 221,A00,090114,Zhou; Yuan-Yuan,0,0,0,0
1653426243237,CSE 229A,A00,090115,Porter; George M,0,0,0,0
1653426243768,CSE 229C,A00,090116,Savage; Stefan,0,0,0,0
1653426244298,CSE 230,A00,090117,Jhala; Ranjit,0,0,0,0
1653426244827,CSE 232,A00,090118,Papakonstantinou; Yannis,0,0,0,0
1653426245358,CSE 239A,A00,090121,Kumar; Arun Kumar,0,0,0,0
1653426245881,CSE 239B,A00,090122,Jhala; Ranjit,0,0,0,0
1653426246407,CSE 240A,A00,090123,Zhao; Jishen,0,0,189,189
1653426246937,CSE 243A,A00,090124,Orailoglu; Alex,3,0,15,12
1653426247463,CSE 249B,A00,090125,Kahng; Andrew Byun,13,0,20,7
1653426247992,CSE 250A,A00,090126,Berg-Kirkpatrick; Taylor D,0,0,0,0
1653426248524,CSE 252A,A00,090127,Ochoa; Benjamin Lawrence,0,0,0,0
1653426249055,CSE 258,A01,090129,McAuley; Julian John,0,0,0,0
1653426249583,CSE 258R,A01,090131,McAuley; Julian John,0,0,0,0
1653426250113,CSE 274,A00,090132,Ramamoorthi; Ravi,0,0,0,0
1653426250646,CSE 276A,A00,090133,Christensen; Henrik I,0,0,0,0
1653426251176,CSE 276C,A00,090134,Christensen; Henrik I,0,0,0,0
1653426251698,CSE 290,A00,090135,Bafna; Vineet,0,0,0,0
1653426251698,CSE 290,B00,090136,Ramamoorthi; Ravi,0,0,0,0
1653426251698,CSE 290,C00,090137,Li; Tzumao,9,0,10,1
1653426251698,CSE 290,D00,090138,Zhou; Yuan-Yuan,10,0,10,0
1653426251698,CSE 290,E00,090139,Christensen; Henrik I,10,0,10,0
1653426251698,CSE 290,F00,094053,Shalev; Aaron D,0,0,0,0
1653426252240,CSE 291,A00,090140,Munyaka; Imani N. S.,0,0,0,0
1653426252240,CSE 291,B00,094880,Yu; Qi,0,0,0,0
1653426252240,CSE 291,C00,090142,Pannuto; Patrick William,0,0,0,0
1653426252240,CSE 291,D00,094881,Zhang; Yiying,0,0,0,0
1653426252240,CSE 291,E00,095118,Su; Hao,0,0,0,0
1653426252779,CSE 293,001,094905,Bafna; Vineet,9999,0,9999,0
1653426252779,CSE 293,002,094906,Bellare; Mihir,9999,0,9999,0
1653426252779,CSE 293,003,094907,Berg-Kirkpatrick; Taylor D,9999,0,9999,0
1653426252779,CSE 293,004,094908,Christensen; Henrik I,9999,0,9999,0
1653426252779,CSE 293,005,094909,Cottrell; Garrison W,9999,0,9999,0
1653426252779,CSE 293,006,094910,Deutsch; Alin Bernard,9999,0,9999,0
1653426252779,CSE 293,007,094911,Esmaeilzadeh; Hadi,9999,0,9999,0
1653426252779,CSE 293,008,094912,Freund; Yoav,9999,0,9999,0
1653426252779,CSE 293,009,094913,Griswold; William G.,9999,0,9999,0
1653426252779,CSE 293,010,094914,Gymrek; Melissa Ann,9999,0,9999,0
1653426252779,CSE 293,011,094915,Heninger; Nadia A,9999,0,9999,0
1653426252779,CSE 293,012,094916,Impagliazzo; Russell,9999,0,9999,0
1653426252779,CSE 293,013,094917,Jhala; Ranjit,9999,0,9999,0
1653426252779,CSE 293,014,094918,Kahng; Andrew Byun,9999,0,9999,0
1653426252779,CSE 293,015,094919,Kane; Daniel Mertz,9999,0,9999,0
1653426252779,CSE 293,016,094920,Kriegman; David J,9999,0,9999,0
1653426252779,CSE 293,017,094921,Kumar; Arun Kumar,9999,0,9999,0
1653426252779,CSE 293,018,094922,Lerner; Sorin,9999,0,9999,0
1653426252779,CSE 293,019,094923,Lovett; Shachar,9999,0,9999,0
1653426252779,CSE 293,020,094924,McAuley; Julian John,9999,0,9999,0
1653426252779,CSE 293,021,094925,Micciancio; Daniele,9999,0,9999,0
1653426252779,CSE 293,022,094926,Orailoglu; Alex,9999,0,9999,0
1653426252779,CSE 293,023,094927,Paturi; Ramamohan,9999,0,9999,0
1653426252779,CSE 293,024,094928,Polikarpova; Nadezhda,9999,0,9999,0
1653426252779,CSE 293,025,094929,Politz; Joseph Gibbs,9999,0,9999,0
1653426252779,CSE 293,026,094930,Porter; George M,9999,0,9999,0
1653426252779,CSE 293,027,094931,Porter; Leonard Emerson,9999,0,9999,0
1653426252779,CSE 293,028,094932,Ramamoorthi; Ravi,9999,0,9999,0
1653426252779,CSE 293,029,094933,Sahoo; Debashis,9999,0,9999,0
1653426252779,CSE 293,030,094934,Saul; Lawrence,9999,0,9999,0
1653426252779,CSE 293,031,094935,Savage; Stefan,9999,0,9999,0
1653426252779,CSE 293,032,094936,Schulze; Jurgen P.,9999,0,9999,0
1653426252779,CSE 293,033,094937,Snoeren; Alex C.,9999,0,9999,0
1653426252779,CSE 293,034,094938,Shang; Jingbo,9999,0,9999,0
1653426252779,CSE 293,035,094939,Stefan; Deian,9999,0,9999,0
1653426252779,CSE 293,036,094940,Su; Hao,9999,0,9999,0
1653426252779,CSE 293,037,094941,Swanson; Steven James,9999,0,9999,0
1653426252779,CSE 293,038,094942,Tullsen; Dean Michael,9999,0,9999,0
1653426252779,CSE 293,039,094943,Voelker; Geoffrey M.,9999,0,9999,0
1653426252779,CSE 293,040,094944,Zhao; Jishen,9999,0,9999,0
1653426252779,CSE 293,041,094945,Zhou; Yuan-Yuan,9999,0,9999,0
1653426252779,CSE 293,042,094946,Gao; Sicun,9998,0,9999,1
1653426252779,CSE 293,043,094947,Weibel; Nadir,9999,0,9999,0
1653426252779,CSE 293,044,094948,Gupta; Rajesh K.,9999,0,9999,0
1653426253306,CSE 294,A00,090143,Porter; George M,9,0,10,1
1653426253835,DSE 200,A00,091799,Staff,50,0,50,0
1653426254360,DSE 203,A00,091800,Gupta; Amarnath,30,0,30,0
1653426254883,DSE 250,A00,091801,Deutsch; Alin Bernard,30,0,30,0
1653426255411,DSE 290,A00,091802,Altintas De Callaf; Ilkay,50,0,50,0
1653426255963,ECE 200,001,091003,Antipa; Nicholas A,9999,0,9999,0
1653426255963,ECE 200,002,091004,Atanasov; Nikolay A.,9999,0,9999,0
1653426255963,ECE 200,003,091005,Bharadia; Dinesh,9999,0,9999,0
1653426255963,ECE 200,004,091006,Cheng; Chung Kuan,9999,0,9999,0
1653426255963,ECE 200,005,091007,Cosman; Pamela C.,9999,0,9999,0
1653426255963,ECE 200,006,091008,Staff,9999,0,9999,0
1653426255963,ECE 200,007,091009,Dayeh; Shadi Ahmad,9999,0,9999,0
1653426255963,ECE 200,008,091010,Fainman; Yeshaiahu,9999,0,9999,0
1653426255963,ECE 200,009,091011,Ford; Joseph Earl,9999,0,9999,0
1653426255963,ECE 200,010,091012,Franceschetti; Massimo,9999,0,9999,0
1653426255963,ECE 200,011,091013,Fullerton; Eric E,9999,0,9999,0
1653426255963,ECE 200,012,091014,Galton; Ian A,9999,0,9999,0
1653426255963,ECE 200,013,091015,Gilja; Vikash,9999,0,9999,0
1653426255963,ECE 200,014,091016,Hall; Drew A.,9999,0,9999,0
1653426255963,ECE 200,015,091017,Hsueh; Tzu-Chien,9999,0,9999,0
1653426255963,ECE 200,016,091018,Javidi; Tara,9999,0,9999,0
1653426255963,ECE 200,017,091019,Kahng; Andrew Byun,9999,0,9999,0
1653426255963,ECE 200,018,091020,Kim; Young-Han,9999,0,9999,0
1653426255963,ECE 200,019,091021,Koushanfar; Farinaz,9999,0,9999,0
1653426255963,ECE 200,020,091022,Kuzum; Duygu,9999,0,9999,0
1653426255963,ECE 200,021,091023,Le; Hanh-Phuc,9999,0,9999,0
1653426255963,ECE 200,022,091024,Lin; Bill,9999,0,9999,0
1653426255963,ECE 200,023,091025,Liu; Zhaowei,9999,0,9999,0
1653426255963,ECE 200,024,091026,Lo; Yu-Hwa,9999,0,9999,0
1653426255963,ECE 200,025,091027,Lomakin; Vitaliy,9999,0,9999,0
1653426255963,ECE 200,026,091028,Mercier; Patrick Philip,9999,0,9999,0
1653426255963,ECE 200,027,091029,Meyer; Florian,9999,0,9999,0
1653426255963,ECE 200,028,091030,Milstein; Laurence B.,9999,0,9999,0
1653426255963,ECE 200,029,091031,Mir Arabbaygi; Siavash,9999,0,9999,0
1653426255963,ECE 200,030,091032,Mookherjea; Shayan,9999,0,9999,0
1653426255963,ECE 200,031,091033,Morris; Karcher William,9999,0,9999,0
1653426255963,ECE 200,032,091034,Ng; Tse Nga,9999,0,9999,0
1653426255963,ECE 200,033,091035,Nguyen; Truong Quang,9999,0,9999,0
1653426255963,ECE 200,034,091036,Nomura; Kenji,9999,0,9999,0
1653426255963,ECE 200,035,091037,Orlitsky; Alon,9999,0,9999,0
1653426255963,ECE 200,036,091038,Pal; Piya,9999,0,9999,0
1653426255963,ECE 200,037,091039,Papen; George C.,9999,0,9999,0
1653426255963,ECE 200,038,091040,Radic; Stojan,9999,0,9999,0
1653426255963,ECE 200,039,091041,Rao; Bhaskar D.,9999,0,9999,0
1653426255963,ECE 200,040,091042,Rao; Ramesh R,9999,0,9999,0
1653426255963,ECE 200,041,091043,Rebeiz; Gabriel,9999,0,9999,0
1653426255963,ECE 200,042,091044,Sanford; John R,9999,0,9999,0
1653426255963,ECE 200,043,091045,Siegel; Paul H.,9999,0,9999,0
1653426255963,ECE 200,044,091046,Sievenpiper; Daniel F.,9999,0,9999,0
1653426255963,ECE 200,045,091047,Sworder; David D.,9999,0,9999,0
1653426255963,ECE 200,046,091048,Taur; Yuan,9999,0,9999,0
1653426255963,ECE 200,047,091049,Touri; Behrouz,9999,0,9999,0
1653426255963,ECE 200,048,091050,Trivedi; Mohan M.,9999,0,9999,0
1653426255963,ECE 200,049,091051,Vardy; Alexander,9999,0,9999,0
1653426255963,ECE 200,050,091052,Vasconcelos; Nuno,9999,0,9999,0
1653426255963,ECE 200,051,091053,Wang; Xiaolong,9999,0,9999,0
1653426255963,ECE 200,052,091054,Xie; Pengtao,9999,0,9999,0
1653426255963,ECE 200,053,091055,Yip; Michael,9999,0,9999,0
1653426255963,ECE 200,054,091056,Zeger; Kenneth A.,9999,0,9999,0
1653426255963,ECE 200,055,091057,Zhang; Xinyu,9999,0,9999,0
1653426255963,ECE 200,056,091058,Turakhia; Yatish Girish,9999,0,9999,0
1653426255963,ECE 200,057,091059,Kang; Mingu,9999,0,9999,0
1653426255963,ECE 200,058,091060,Shi; Yuanyuan,9999,0,9999,0
1653426255963,ECE 200,059,091061,Wang; Edward Jay,9999,0,9999,0
1653426255963,ECE 200,060,091062,Zheng; Yang,9999,0,9999,0
1653426256492,ECE 203,A00,091065,Mercier; Patrick Philip,0,0,0,0
1653426257014,ECE 207A,A00,091605,Liu; Thomas Tao-Ming,0,0,0,0
1653426257548,ECE 212AN,A00,091068,Nomura; Kenji,0,0,0,0
1653426258076,ECE 222A,A00,091069,Rebeiz; Gabriel,0,0,0,0
1653426258599,ECE 225A,A00,091070,Orlitsky; Alon,0,0,0,0
1653426259123,ECE 230A,A00,091071,Nomura; Kenji,0,0,0,0
1653426259657,ECE 236A,A00,091072,Dayeh; Shadi Ahmad,0,0,0,0
1653426260191,ECE 238A,A00,091073,Luo; Jian,0,0,0,0
1653426260191,ECE 238A,B00,091074,Luo; Jian,0,0,0,0
1653426260729,ECE 240A,A00,091075,Radic; Stojan,0,0,0,0
1653426261273,ECE 247A,A00,091592,Shi; Lingyan,0,0,0,0
1653426261800,ECE 250,A00,091076,Touri; Behrouz,0,0,0,0
1653426262336,ECE 251C,A00,091078,Nguyen; Truong Quang,0,0,0,0
1653426262946,ECE 253,A00,091079,Cosman; Pamela C.,0,0,0,0
1653426263469,ECE 255A,A00,091080,Orlitsky; Alon,0,0,0,0
1653426263991,ECE 257A,A00,091081,Zhang; Xinyu,0,0,0,0
1653426264516,ECE 260A,A01,091084,Eldon; John,0,0,0,0
1653426265039,ECE 264C,A00,091085,Galton; Ian A,0,0,0,0
1653426265561,ECE 265C,A00,094889,Presti; Calogero Davide,0,0,0,9
1653426266099,ECE 266,A01,091087,Hall; Drew A.,0,0,0,0
1653426267158,ECE 271A,A00,091090,Vasconcelos; Nuno,0,0,0,0
1653426267683,ECE 272B,A00,091091,Sworder; David D.,0,0,0,0
1653426268214,ECE 275A,A00,091092,Meyer; Florian,0,0,0,0
1653426268736,ECE 277,A00,091093,An; Cheolhong,0,0,0,0
1653426269269,ECE 283,A00,091094,Le; Hanh-Phuc,0,0,0,0
1653426269807,ECE 284,A00,091095,Kang; Mingu,0,0,0,0
1653426269807,ECE 284,B00,091096,Wang; Edward Jay,0,0,0,0
1653426270331,ECE 285,A00,094334,Touri; Behrouz,0,0,0,0
1653426270856,ECE 289,A00,091097,Whelan; David Arthur,0,0,0,0
1653426271391,MATH 200A,A00,087414,Salehi Golsefidy; Alireza,7,0,8,1
1653426271915,MATH 202A,A00,087415,Gill; Philip E.,3,0,8,5
1653426272454,MATH 203A,A00,087416,Oprea; Dragos N.,6,0,8,2
1653426272977,MATH 204A,A00,087417,Kedlaya; Kiran S.,6,0,8,2
1653426273512,MATH 205,A00,087418,Sorensen; Claus M,6,0,8,2
1653426274040,MATH 206A,A00,087419,Izadi; Elham,7,0,8,1
1653426274563,MATH 207A,A00,087420,Mohammadi; Amir,6,0,8,2
1653426275088,MATH 208,A00,087421,Staff,9,0,10,1
1653426275628,MATH 209,A00,087422,Staff,10,0,10,0
1653426276160,MATH 218,A00,087423,Staff,10,0,10,0
1653426276689,MATH 220A,A00,087424,Novak; Jonathan I,7,0,8,1
1653426277216,MATH 231A,A00,087425,Bejenaru; Ioan,4,0,8,4
1653426277747,MATH 240A,A00,087426,Ebenfelt; Peter F,5,0,8,3
1653426278269,MATH 243,A00,087427,Staff,9,0,10,1
1653426278807,MATH 248,A00,087429,Staff,10,0,10,0
1653426279338,MATH 250A,A00,087430,Spolaor; Luca,5,0,8,3
1653426279867,MATH 257A,A00,087431,Spolaor; Luca,7,0,8,1
1653426280389,MATH 258,A00,087432,Staff,9,0,10,1
1653426280916,MATH 264A,A00,087433,Warnke; Lutz Peter,5,0,8,3
1653426281456,MATH 268,A00,087434,Staff,15,0,15,0
1653426281978,MATH 269,A00,087435,Staff,14,0,15,1
1653426282505,MATH 270A,A00,087436,Nie; Jiawang,0,0,8,8
1653426283035,MATH 272A,A00,087437,Tian; Xiaochuan,2,0,8,6
1653426283557,MATH 274,A01,087439,Cheng; Li-Tien,9,0,10,1
1653426283557,MATH 274,A02,087440,Cheng; Li-Tien,10,0,10,0
1653426284081,MATH 278A,A00,087441,Staff,8,0,10,2
1653426284607,MATH 278B,A00,087442,Staff,8,0,10,2
1653426285127,MATH 278C,A00,087443,Staff,8,0,10,2
1653426285656,MATH 280A,A00,087444,Zheng; Tianyi,0,0,8,8
1653426286196,MATH 281A,A00,087445,Bradic; Jelena,0,0,8,8
1653426286718,MATH 282A,A00,087446,Zhang; Danna,0,0,8,8
1653426287253,MATH 283,A00,087447,Tesler; Glenn,0,0,0,14
1653426287783,MATH 286,A00,087448,Kemp; Todd Aahron,6,0,8,2
1653426288306,MATH 287D,A00,087449,Bradic; Jelena,8,0,8,0
1653426288831,MATH 288,A00,087450,Staff,14,0,15,1
1653426288831,MATH 288,B00,087451,Staff,15,0,15,0
1653426288831,MATH 288,C00,087452,Staff,15,0,15,0
1653426289354,MATH 290A,A00,087453,Xu; Zhouli,7,0,8,1
1653426289876,MATH 291A,A00,087454,Xu; Zhouli,7,0,8,1
1653426290402,MATH 292,A00,087455,Staff,10,0,10,0
1653426290925,MATH 295,A00,087456,Staff,50,0,50,0
1653426291450,MATH 297,001,087457,Staff,998,0,999,1
1653426857732,COGS 200,A01,087991,Staff,47,0,50,3
1653426858264,COGS 201,A01,094504,Rangel; Lara M,17,0,25,8
1653426858794,COGS 203,A00,087992,Coulson; Seana M,18,0,20,2
1653426859326,COGS 210A,001,087993,Greene; Deanna Jacquelyn,9998,0,9999,1
1653426859326,COGS 210A,002,087994,Saygin; Ayse P,9999,0,9999,0
1653426859326,COGS 210A,003,087995,Xia; Haijun,9999,0,9999,0
1653426859326,COGS 210A,004,087996,Nitz; Douglas A.,9999,0,9999,0
1653426859326,COGS 210A,005,087997,Hollan; James D.,9999,0,9999,0
1653426859326,COGS 210A,006,087998,Deak; Gedeon O.,9998,0,9999,1
1653426859326,COGS 210A,007,087999,Rossano; Federico,9999,0,9999,0
1653426859850,COGS 211A,A00,088000,Coulson; Seana M,9997,0,9999,2
1653426860375,COGS 229,A00,088002,Staff,23,0,25,2
1653426860908,COGS 260,B00,094231,Staff,17,0,20,3
1653426860908,COGS 260,A00,088004,Nitz; Douglas A.,9998,0,9999,1
1653426861431,CSE 202,A00,090110,Paturi; Ramamohan,0,0,0,0
1653426861431,CSE 202,B00,090111,Paturi; Ramamohan,0,0,0,0
1653426861968,CSE 207B,A00,090112,Heninger; Nadia A,0,0,0,0
1653426862498,CSE 208,A00,094858,Micciancio; Daniele,0,0,0,0
1653426863021,CSE 210,A00,090113,Powell; Thomas Allan,0,0,0,0
1653426863552,CSE 219,A00,090898,Staff,0,0,0,0
1653426864081,CSE 221,A00,090114,Zhou; Yuan-Yuan,0,0,0,0
1653426864610,CSE 229A,A00,090115,Porter; George M,0,0,0,0
1653426865134,CSE 229C,A00,090116,Savage; Stefan,0,0,0,0
1653426865660,CSE 230,A00,090117,Jhala; Ranjit,0,0,0,0
1653426866186,CSE 232,A00,090118,Papakonstantinou; Yannis,0,0,0,0
1653426866718,CSE 239A,A00,090121,Kumar; Arun Kumar,0,0,0,0
1653426867247,CSE 239B,A00,090122,Jhala; Ranjit,0,0,0,0
1653426867775,CSE 240A,A00,090123,Zhao; Jishen,0,0,189,189
1653426868309,CSE 243A,A00,090124,Orailoglu; Alex,3,0,15,12
1653426868833,CSE 249B,A00,090125,Kahng; Andrew Byun,13,0,20,7
1653426869368,CSE 250A,A00,090126,Berg-Kirkpatrick; Taylor D,0,0,0,0
1653426869906,CSE 252A,A00,090127,Ochoa; Benjamin Lawrence,0,0,0,0
1653426870430,CSE 258,A01,090129,McAuley; Julian John,0,0,0,0
1653426870955,CSE 258R,A01,090131,McAuley; Julian John,0,0,0,0
1653426871483,CSE 274,A00,090132,Ramamoorthi; Ravi,0,0,0,0
1653426872006,CSE 276A,A00,090133,Christensen; Henrik I,0,0,0,0
1653426872528,CSE 276C,A00,090134,Christensen; Henrik I,0,0,0,0
1653426873050,CSE 290,A00,090135,Bafna; Vineet,0,0,0,0
1653426873050,CSE 290,B00,090136,Ramamoorthi; Ravi,0,0,0,0
1653426873050,CSE 290,C00,090137,Li; Tzumao,9,0,10,1
1653426873050,CSE 290,D00,090138,Zhou; Yuan-Yuan,10,0,10,0
1653426873050,CSE 290,E00,090139,Christensen; Henrik I,10,0,10,0
1653426873050,CSE 290,F00,094053,Shalev; Aaron D,0,0,0,0
1653426873580,CSE 291,A00,090140,Munyaka; Imani N. S.,0,0,0,0
1653426873580,CSE 291,B00,094880,Yu; Qi,0,0,0,0
1653426873580,CSE 291,C00,090142,Pannuto; Patrick William,0,0,0,0
1653426873580,CSE 291,D00,094881,Zhang; Yiying,0,0,0,0
1653426873580,CSE 291,E00,095118,Su; Hao,0,0,0,0
1653426874112,CSE 293,001,094905,Bafna; Vineet,9999,0,9999,0
1653426874112,CSE 293,002,094906,Bellare; Mihir,9999,0,9999,0
1653426874112,CSE 293,003,094907,Berg-Kirkpatrick; Taylor D,9999,0,9999,0
1653426874112,CSE 293,004,094908,Christensen; Henrik I,9999,0,9999,0
1653426874112,CSE 293,005,094909,Cottrell; Garrison W,9999,0,9999,0
1653426874112,CSE 293,006,094910,Deutsch; Alin Bernard,9999,0,9999,0
1653426874112,CSE 293,007,094911,Esmaeilzadeh; Hadi,9999,0,9999,0
1653426874112,CSE 293,008,094912,Freund; Yoav,9999,0,9999,0
1653426874112,CSE 293,009,094913,Griswold; William G.,9999,0,9999,0
1653426874112,CSE 293,010,094914,Gymrek; Melissa Ann,9999,0,9999,0
1653426874112,CSE 293,011,094915,Heninger; Nadia A,9999,0,9999,0
1653426874112,CSE 293,012,094916,Impagliazzo; Russell,9999,0,9999,0
1653426874112,CSE 293,013,094917,Jhala; Ranjit,9999,0,9999,0
1653426874112,CSE 293,014,094918,Kahng; Andrew Byun,9999,0,9999,0
1653426874112,CSE 293,015,094919,Kane; Daniel Mertz,9999,0,9999,0
1653426874112,CSE 293,016,094920,Kriegman; David J,9999,0,9999,0
1653426874112,CSE 293,017,094921,Kumar; Arun Kumar,9999,0,9999,0
1653426874112,CSE 293,018,094922,Lerner; Sorin,9999,0,9999,0
1653426874112,CSE 293,019,094923,Lovett; Shachar,9999,0,9999,0
1653426874112,CSE 293,020,094924,McAuley; Julian John,9999,0,9999,0
1653426874112,CSE 293,021,094925,Micciancio; Daniele,9999,0,9999,0
1653426874112,CSE 293,022,094926,Orailoglu; Alex,9999,0,9999,0
1653426874112,CSE 293,023,094927,Paturi; Ramamohan,9999,0,9999,0
1653426874112,CSE 293,024,094928,Polikarpova; Nadezhda,9999,0,9999,0
1653426874112,CSE 293,025,094929,Politz; Joseph Gibbs,9999,0,9999,0
1653426874112,CSE 293,026,094930,Porter; George M,9999,0,9999,0
1653426874112,CSE 293,027,094931,Porter; Leonard Emerson,9999,0,9999,0
1653426874112,CSE 293,028,094932,Ramamoorthi; Ravi,9999,0,9999,0
1653426874112,CSE 293,029,094933,Sahoo; Debashis,9999,0,9999,0
1653426874112,CSE 293,030,094934,Saul; Lawrence,9999,0,9999,0
1653426874112,CSE 293,031,094935,Savage; Stefan,9999,0,9999,0
1653426874112,CSE 293,032,094936,Schulze; Jurgen P.,9999,0,9999,0
1653426874112,CSE 293,033,094937,Snoeren; Alex C.,9999,0,9999,0
1653426874112,CSE 293,034,094938,Shang; Jingbo,9999,0,9999,0
1653426874112,CSE 293,035,094939,Stefan; Deian,9999,0,9999,0
1653426874112,CSE 293,036,094940,Su; Hao,9999,0,9999,0
1653426874112,CSE 293,037,094941,Swanson; Steven James,9999,0,9999,0
1653426874112,CSE 293,038,094942,Tullsen; Dean Michael,9999,0,9999,0
1653426874112,CSE 293,039,094943,Voelker; Geoffrey M.,9999,0,9999,0
1653426874112,CSE 293,040,094944,Zhao; Jishen,9999,0,9999,0
1653426874112,CSE 293,041,094945,Zhou; Yuan-Yuan,9999,0,9999,0
1653426874112,CSE 293,042,094946,Gao; Sicun,9998,0,9999,1
1653426874112,CSE 293,043,094947,Weibel; Nadir,9999,0,9999,0
1653426874112,CSE 293,044,094948,Gupta; Rajesh K.,9999,0,9999,0
1653426874636,CSE 294,A00,090143,Porter; George M,9,0,10,1
1653426875163,DSE 200,A00,091799,Staff,50,0,50,0
1653426875705,DSE 203,A00,091800,Gupta; Amarnath,30,0,30,0
1653426876227,DSE 250,A00,091801,Deutsch; Alin Bernard,30,0,30,0
1653426876755,DSE 290,A00,091802,Altintas De Callaf; Ilkay,50,0,50,0
1653426877288,ECE 200,001,091003,Antipa; Nicholas A,9999,0,9999,0
1653426877288,ECE 200,002,091004,Atanasov; Nikolay A.,9999,0,9999,0
1653426877288,ECE 200,003,091005,Bharadia; Dinesh,9999,0,9999,0
1653426877288,ECE 200,004,091006,Cheng; Chung Kuan,9999,0,9999,0
1653426877288,ECE 200,005,091007,Cosman; Pamela C.,9999,0,9999,0
1653426877288,ECE 200,006,091008,Staff,9999,0,9999,0
1653426877288,ECE 200,007,091009,Dayeh; Shadi Ahmad,9999,0,9999,0
1653426877288,ECE 200,008,091010,Fainman; Yeshaiahu,9999,0,9999,0
1653426877288,ECE 200,009,091011,Ford; Joseph Earl,9999,0,9999,0
1653426877288,ECE 200,010,091012,Franceschetti; Massimo,9999,0,9999,0
1653426877288,ECE 200,011,091013,Fullerton; Eric E,9999,0,9999,0
1653426877288,ECE 200,012,091014,Galton; Ian A,9999,0,9999,0
1653426877288,ECE 200,013,091015,Gilja; Vikash,9999,0,9999,0
1653426877288,ECE 200,014,091016,Hall; Drew A.,9999,0,9999,0
1653426877288,ECE 200,015,091017,Hsueh; Tzu-Chien,9999,0,9999,0
1653426877288,ECE 200,016,091018,Javidi; Tara,9999,0,9999,0
1653426877288,ECE 200,017,091019,Kahng; Andrew Byun,9999,0,9999,0
1653426877288,ECE 200,018,091020,Kim; Young-Han,9999,0,9999,0
1653426877288,ECE 200,019,091021,Koushanfar; Farinaz,9999,0,9999,0
1653426877288,ECE 200,020,091022,Kuzum; Duygu,9999,0,9999,0
1653426877288,ECE 200,021,091023,Le; Hanh-Phuc,9999,0,9999,0
1653426877288,ECE 200,022,091024,Lin; Bill,9999,0,9999,0
1653426877288,ECE 200,023,091025,Liu; Zhaowei,9999,0,9999,0
1653426877288,ECE 200,024,091026,Lo; Yu-Hwa,9999,0,9999,0
1653426877288,ECE 200,025,091027,Lomakin; Vitaliy,9999,0,9999,0
1653426877288,ECE 200,026,091028,Mercier; Patrick Philip,9999,0,9999,0
1653426877288,ECE 200,027,091029,Meyer; Florian,9999,0,9999,0
1653426877288,ECE 200,028,091030,Milstein; Laurence B.,9999,0,9999,0
1653426877288,ECE 200,029,091031,Mir Arabbaygi; Siavash,9999,0,9999,0
1653426877288,ECE 200,030,091032,Mookherjea; Shayan,9999,0,9999,0
1653426877288,ECE 200,031,091033,Morris; Karcher William,9999,0,9999,0
1653426877288,ECE 200,032,091034,Ng; Tse Nga,9999,0,9999,0
1653426877288,ECE 200,033,091035,Nguyen; Truong Quang,9999,0,9999,0
1653426877288,ECE 200,034,091036,Nomura; Kenji,9999,0,9999,0
1653426877288,ECE 200,035,091037,Orlitsky; Alon,9999,0,9999,0
1653426877288,ECE 200,036,091038,Pal; Piya,9999,0,9999,0
1653426877288,ECE 200,037,091039,Papen; George C.,9999,0,9999,0
1653426877288,ECE 200,038,091040,Radic; Stojan,9999,0,9999,0
1653426877288,ECE 200,039,091041,Rao; Bhaskar D.,9999,0,9999,0
1653426877288,ECE 200,040,091042,Rao; Ramesh R,9999,0,9999,0
1653426877288,ECE 200,041,091043,Rebeiz; Gabriel,9999,0,9999,0
1653426877288,ECE 200,042,091044,Sanford; John R,9999,0,9999,0
1653426877288,ECE 200,043,091045,Siegel; Paul H.,9999,0,9999,0
1653426877288,ECE 200,044,091046,Sievenpiper; Daniel F.,9999,0,9999,0
1653426877288,ECE 200,045,091047,Sworder; David D.,9999,0,9999,0
1653426877288,ECE 200,046,091048,Taur; Yuan,9999,0,9999,0
1653426877288,ECE 200,047,091049,Touri; Behrouz,9999,0,9999,0
1653426877288,ECE 200,048,091050,Trivedi; Mohan M.,9999,0,9999,0
1653426877288,ECE 200,049,091051,Vardy; Alexander,9999,0,9999,0
1653426877288,ECE 200,050,091052,Vasconcelos; Nuno,9999,0,9999,0
1653426877288,ECE 200,051,091053,Wang; Xiaolong,9999,0,9999,0
1653426877288,ECE 200,052,091054,Xie; Pengtao,9999,0,9999,0
1653426877288,ECE 200,053,091055,Yip; Michael,9999,0,9999,0
1653426877288,ECE 200,054,091056,Zeger; Kenneth A.,9999,0,9999,0
1653426877288,ECE 200,055,091057,Zhang; Xinyu,9999,0,9999,0
1653426877288,ECE 200,056,091058,Turakhia; Yatish Girish,9999,0,9999,0
1653426877288,ECE 200,057,091059,Kang; Mingu,9999,0,9999,0
1653426877288,ECE 200,058,091060,Shi; Yuanyuan,9999,0,9999,0
1653426877288,ECE 200,059,091061,Wang; Edward Jay,9999,0,9999,0
1653426877288,ECE 200,060,091062,Zheng; Yang,9999,0,9999,0
1653426877826,ECE 203,A00,091065,Mercier; Patrick Philip,0,0,0,0
1653426878355,ECE 207A,A00,091605,Liu; Thomas Tao-Ming,0,0,0,0
1653426878889,ECE 212AN,A00,091068,Nomura; Kenji,0,0,0,0
1653426879411,ECE 222A,A00,091069,Rebeiz; Gabriel,0,0,0,0
1653426879936,ECE 225A,A00,091070,Orlitsky; Alon,0,0,0,0
1653426880463,ECE 230A,A00,091071,Nomura; Kenji,0,0,0,0
1653426880992,ECE 236A,A00,091072,Dayeh; Shadi Ahmad,0,0,0,0
1653426881532,ECE 238A,A00,091073,Luo; Jian,0,0,0,0
1653426881532,ECE 238A,B00,091074,Luo; Jian,0,0,0,0
1653426882056,ECE 240A,A00,091075,Radic; Stojan,0,0,0,0
1653426882591,ECE 247A,A00,091592,Shi; Lingyan,0,0,0,0
1653426883116,ECE 250,A00,091076,Touri; Behrouz,0,0,0,0
1653426883640,ECE 251C,A00,091078,Nguyen; Truong Quang,0,0,0,0
1653426884179,ECE 253,A00,091079,Cosman; Pamela C.,0,0,0,0
1653426884708,ECE 255A,A00,091080,Orlitsky; Alon,0,0,0,0
1653426885245,ECE 257A,A00,091081,Zhang; Xinyu,0,0,0,0
1653426885772,ECE 260A,A01,091084,Eldon; John,0,0,0,0
1653426886303,ECE 264C,A00,091085,Galton; Ian A,0,0,0,0
1653426886838,ECE 265C,A00,094889,Presti; Calogero Davide,0,0,0,9
1653426887370,ECE 266,A01,091087,Hall; Drew A.,0,0,0,0
1653426888439,ECE 271A,A00,091090,Vasconcelos; Nuno,0,0,0,0
1653426888976,ECE 272B,A00,091091,Sworder; David D.,0,0,0,0
1653426889517,ECE 275A,A00,091092,Meyer; Florian,0,0,0,0
1653426890040,ECE 277,A00,091093,An; Cheolhong,0,0,0,0
1653426890573,ECE 283,A00,091094,Le; Hanh-Phuc,0,0,0,0
1653426891109,ECE 284,A00,091095,Kang; Mingu,0,0,0,0
1653426891109,ECE 284,B00,091096,Wang; Edward Jay,0,0,0,0
1653426891644,ECE 285,A00,094334,Touri; Behrouz,0,0,0,0
1653426892167,ECE 289,A00,091097,Whelan; David Arthur,0,0,0,0
1653426892702,MATH 200A,A00,087414,Salehi Golsefidy; Alireza,7,0,8,1
1653426893225,MATH 202A,A00,087415,Gill; Philip E.,3,0,8,5
1653426893755,MATH 203A,A00,087416,Oprea; Dragos N.,6,0,8,2
1653426894286,MATH 204A,A00,087417,Kedlaya; Kiran S.,6,0,8,2
1653426894812,MATH 205,A00,087418,Sorensen; Claus M,6,0,8,2
1653426895345,MATH 206A,A00,087419,Izadi; Elham,7,0,8,1
1653426895892,MATH 207A,A00,087420,Mohammadi; Amir,6,0,8,2
1653426896427,MATH 208,A00,087421,Staff,9,0,10,1
1653426896949,MATH 209,A00,087422,Staff,10,0,10,0
1653426897476,MATH 218,A00,087423,Staff,10,0,10,0
1653426898003,MATH 220A,A00,087424,Novak; Jonathan I,7,0,8,1
1653426898534,MATH 231A,A00,087425,Bejenaru; Ioan,4,0,8,4
1653426899057,MATH 240A,A00,087426,Ebenfelt; Peter F,5,0,8,3
1653426899581,MATH 243,A00,087427,Staff,9,0,10,1
1653426900107,MATH 248,A00,087429,Staff,10,0,10,0
1653426900638,MATH 250A,A00,087430,Spolaor; Luca,5,0,8,3
1653426901173,MATH 257A,A00,087431,Spolaor; Luca,7,0,8,1
1653426901696,MATH 258,A00,087432,Staff,9,0,10,1
1653426902222,MATH 264A,A00,087433,Warnke; Lutz Peter,5,0,8,3
1653426902753,MATH 268,A00,087434,Staff,15,0,15,0
1653426903291,MATH 269,A00,087435,Staff,14,0,15,1
1653426903821,MATH 270A,A00,087436,Nie; Jiawang,0,0,8,8
1653426904345,MATH 272A,A00,087437,Tian; Xiaochuan,2,0,8,6
1653426904878,MATH 274,A01,087439,Cheng; Li-Tien,9,0,10,1
1653426904878,MATH 274,A02,087440,Cheng; Li-Tien,10,0,10,0
1653426905407,MATH 278A,A00,087441,Staff,8,0,10,2
1653426905943,MATH 278B,A00,087442,Staff,8,0,10,2
1653426906476,MATH 278C,A00,087443,Staff,8,0,10,2
1653426907008,MATH 280A,A00,087444,Zheng; Tianyi,0,0,8,8
1653426907543,MATH 281A,A00,087445,Bradic; Jelena,0,0,8,8
1653426908067,MATH 282A,A00,087446,Zhang; Danna,0,0,8,8
1653426908589,MATH 283,A00,087447,Tesler; Glenn,0,0,0,14
1653426909116,MATH 286,A00,087448,Kemp; Todd Aahron,6,0,8,2
1653426909648,MATH 287D,A00,087449,Bradic; Jelena,8,0,8,0
1653426910262,MATH 288,A00,087450,Staff,14,0,15,1
1653426910262,MATH 288,B00,087451,Staff,15,0,15,0
1653426910262,MATH 288,C00,087452,Staff,15,0,15,0
1653426910785,MATH 290A,A00,087453,Xu; Zhouli,7,0,8,1
1653426911308,MATH 291A,A00,087454,Xu; Zhouli,7,0,8,1
1653426911834,MATH 292,A00,087455,Staff,10,0,10,0
1653426912367,MATH 295,A00,087456,Staff,50,0,50,0
1653426912894,MATH 297,001,087457,Staff,998,0,999,1
1653427479395,COGS 200,A01,087991,Staff,47,0,50,3
1653427479930,COGS 201,A01,094504,Rangel; Lara M,17,0,25,8
1653427480452,COGS 203,A00,087992,Coulson; Seana M,18,0,20,2
1653427480986,COGS 210A,001,087993,Greene; Deanna Jacquelyn,9998,0,9999,1
1653427480986,COGS 210A,002,087994,Saygin; Ayse P,9999,0,9999,0
1653427480986,COGS 210A,003,087995,Xia; Haijun,9999,0,9999,0
1653427480986,COGS 210A,004,087996,Nitz; Douglas A.,9999,0,9999,0
1653427480986,COGS 210A,005,087997,Hollan; James D.,9999,0,9999,0
1653427480986,COGS 210A,006,087998,Deak; Gedeon O.,9998,0,9999,1
1653427480986,COGS 210A,007,087999,Rossano; Federico,9999,0,9999,0
1653427481514,COGS 211A,A00,088000,Coulson; Seana M,9997,0,9999,2
1653427482040,COGS 229,A00,088002,Staff,23,0,25,2
1653427482564,COGS 260,B00,094231,Staff,17,0,20,3
1653427482564,COGS 260,A00,088004,Nitz; Douglas A.,9998,0,9999,1
1653427483087,CSE 202,A00,090110,Paturi; Ramamohan,0,0,0,0
1653427483087,CSE 202,B00,090111,Paturi; Ramamohan,0,0,0,0
1653427483611,CSE 207B,A00,090112,Heninger; Nadia A,0,0,0,0
1653427484136,CSE 208,A00,094858,Micciancio; Daniele,0,0,0,0
1653427484659,CSE 210,A00,090113,Powell; Thomas Allan,0,0,0,0
1653427485199,CSE 219,A00,090898,Staff,0,0,0,0
1653427485721,CSE 221,A00,090114,Zhou; Yuan-Yuan,0,0,0,0
1653427486261,CSE 229A,A00,090115,Porter; George M,0,0,0,0
1653427486786,CSE 229C,A00,090116,Savage; Stefan,0,0,0,0
1653427487321,CSE 230,A00,090117,Jhala; Ranjit,0,0,0,0
1653427487851,CSE 232,A00,090118,Papakonstantinou; Yannis,0,0,0,0
1653427488373,CSE 239A,A00,090121,Kumar; Arun Kumar,0,0,0,0
1653427488902,CSE 239B,A00,090122,Jhala; Ranjit,0,0,0,0
1653427489425,CSE 240A,A00,090123,Zhao; Jishen,0,0,189,189
1653427489953,CSE 243A,A00,090124,Orailoglu; Alex,3,0,15,12
1653427490491,CSE 249B,A00,090125,Kahng; Andrew Byun,13,0,20,7
1653427491025,CSE 250A,A00,090126,Berg-Kirkpatrick; Taylor D,0,0,0,0
1653427491557,CSE 252A,A00,090127,Ochoa; Benjamin Lawrence,0,0,0,0
1653427492103,CSE 258,A01,090129,McAuley; Julian John,0,0,0,0
1653427492626,CSE 258R,A01,090131,McAuley; Julian John,0,0,0,0
1653427493149,CSE 274,A00,090132,Ramamoorthi; Ravi,0,0,0,0
1653427493678,CSE 276A,A00,090133,Christensen; Henrik I,0,0,0,0
1653427494213,CSE 276C,A00,090134,Christensen; Henrik I,0,0,0,0
1653427494752,CSE 290,A00,090135,Bafna; Vineet,0,0,0,0
1653427494752,CSE 290,B00,090136,Ramamoorthi; Ravi,0,0,0,0
1653427494752,CSE 290,C00,090137,Li; Tzumao,9,0,10,1
1653427494752,CSE 290,D00,090138,Zhou; Yuan-Yuan,10,0,10,0
1653427494752,CSE 290,E00,090139,Christensen; Henrik I,10,0,10,0
1653427494752,CSE 290,F00,094053,Shalev; Aaron D,0,0,0,0
1653427495284,CSE 291,A00,090140,Munyaka; Imani N. S.,0,0,0,0
1653427495284,CSE 291,B00,094880,Yu; Qi,0,0,0,0
1653427495284,CSE 291,C00,090142,Pannuto; Patrick William,0,0,0,0
1653427495284,CSE 291,D00,094881,Zhang; Yiying,0,0,0,0
1653427495284,CSE 291,E00,095118,Su; Hao,0,0,0,0
1653427495820,CSE 293,001,094905,Bafna; Vineet,9999,0,9999,0
1653427495820,CSE 293,002,094906,Bellare; Mihir,9999,0,9999,0
1653427495820,CSE 293,003,094907,Berg-Kirkpatrick; Taylor D,9999,0,9999,0
1653427495820,CSE 293,004,094908,Christensen; Henrik I,9999,0,9999,0
1653427495820,CSE 293,005,094909,Cottrell; Garrison W,9999,0,9999,0
1653427495820,CSE 293,006,094910,Deutsch; Alin Bernard,9999,0,9999,0
1653427495820,CSE 293,007,094911,Esmaeilzadeh; Hadi,9999,0,9999,0
1653427495820,CSE 293,008,094912,Freund; Yoav,9999,0,9999,0
1653427495820,CSE 293,009,094913,Griswold; William G.,9999,0,9999,0
1653427495820,CSE 293,010,094914,Gymrek; Melissa Ann,9999,0,9999,0
1653427495820,CSE 293,011,094915,Heninger; Nadia A,9999,0,9999,0
1653427495820,CSE 293,012,094916,Impagliazzo; Russell,9999,0,9999,0
1653427495820,CSE 293,013,094917,Jhala; Ranjit,9999,0,9999,0
1653427495820,CSE 293,014,094918,Kahng; Andrew Byun,9999,0,9999,0
1653427495820,CSE 293,015,094919,Kane; Daniel Mertz,9999,0,9999,0
1653427495820,CSE 293,016,094920,Kriegman; David J,9999,0,9999,0
1653427495820,CSE 293,017,094921,Kumar; Arun Kumar,9999,0,9999,0
1653427495820,CSE 293,018,094922,Lerner; Sorin,9999,0,9999,0
1653427495820,CSE 293,019,094923,Lovett; Shachar,9999,0,9999,0
1653427495820,CSE 293,020,094924,McAuley; Julian John,9999,0,9999,0
1653427495820,CSE 293,021,094925,Micciancio; Daniele,9999,0,9999,0
1653427495820,CSE 293,022,094926,Orailoglu; Alex,9999,0,9999,0
1653427495820,CSE 293,023,094927,Paturi; Ramamohan,9999,0,9999,0
1653427495820,CSE 293,024,094928,Polikarpova; Nadezhda,9999,0,9999,0
1653427495820,CSE 293,025,094929,Politz; Joseph Gibbs,9999,0,9999,0
1653427495820,CSE 293,026,094930,Porter; George M,9999,0,9999,0
1653427495820,CSE 293,027,094931,Porter; Leonard Emerson,9999,0,9999,0
1653427495820,CSE 293,028,094932,Ramamoorthi; Ravi,9999,0,9999,0
1653427495820,CSE 293,029,094933,Sahoo; Debashis,9999,0,9999,0
1653427495820,CSE 293,030,094934,Saul; Lawrence,9999,0,9999,0
1653427495820,CSE 293,031,094935,Savage; Stefan,9999,0,9999,0
1653427495820,CSE 293,032,094936,Schulze; Jurgen P.,9999,0,9999,0
1653427495820,CSE 293,033,094937,Snoeren; Alex C.,9999,0,9999,0
1653427495820,CSE 293,034,094938,Shang; Jingbo,9999,0,9999,0
1653427495820,CSE 293,035,094939,Stefan; Deian,9999,0,9999,0
1653427495820,CSE 293,036,094940,Su; Hao,9999,0,9999,0
1653427495820,CSE 293,037,094941,Swanson; Steven James,9999,0,9999,0
1653427495820,CSE 293,038,094942,Tullsen; Dean Michael,9999,0,9999,0
1653427495820,CSE 293,039,094943,Voelker; Geoffrey M.,9999,0,9999,0
1653427495820,CSE 293,040,094944,Zhao; Jishen,9999,0,9999,0
1653427495820,CSE 293,041,094945,Zhou; Yuan-Yuan,9999,0,9999,0
1653427495820,CSE 293,042,094946,Gao; Sicun,9998,0,9999,1
1653427495820,CSE 293,043,094947,Weibel; Nadir,9999,0,9999,0
1653427495820,CSE 293,044,094948,Gupta; Rajesh K.,9999,0,9999,0
1653427496359,CSE 294,A00,090143,Porter; George M,9,0,10,1
1653427496881,DSE 200,A00,091799,Staff,50,0,50,0
1653427497406,DSE 203,A00,091800,Gupta; Amarnath,30,0,30,0
1653427497945,DSE 250,A00,091801,Deutsch; Alin Bernard,30,0,30,0
1653427498471,DSE 290,A00,091802,Altintas De Callaf; Ilkay,50,0,50,0
1653427499052,ECE 200,001,091003,Antipa; Nicholas A,9999,0,9999,0
1653427499052,ECE 200,002,091004,Atanasov; Nikolay A.,9999,0,9999,0
1653427499052,ECE 200,003,091005,Bharadia; Dinesh,9999,0,9999,0
1653427499052,ECE 200,004,091006,Cheng; Chung Kuan,9999,0,9999,0
1653427499052,ECE 200,005,091007,Cosman; Pamela C.,9999,0,9999,0
1653427499052,ECE 200,006,091008,Staff,9999,0,9999,0
1653427499052,ECE 200,007,091009,Dayeh; Shadi Ahmad,9999,0,9999,0
1653427499052,ECE 200,008,091010,Fainman; Yeshaiahu,9999,0,9999,0
1653427499052,ECE 200,009,091011,Ford; Joseph Earl,9999,0,9999,0
1653427499052,ECE 200,010,091012,Franceschetti; Massimo,9999,0,9999,0
1653427499052,ECE 200,011,091013,Fullerton; Eric E,9999,0,9999,0
1653427499052,ECE 200,012,091014,Galton; Ian A,9999,0,9999,0
1653427499052,ECE 200,013,091015,Gilja; Vikash,9999,0,9999,0
1653427499052,ECE 200,014,091016,Hall; Drew A.,9999,0,9999,0
1653427499052,ECE 200,015,091017,Hsueh; Tzu-Chien,9999,0,9999,0
1653427499052,ECE 200,016,091018,Javidi; Tara,9999,0,9999,0
1653427499052,ECE 200,017,091019,Kahng; Andrew Byun,9999,0,9999,0
1653427499052,ECE 200,018,091020,Kim; Young-Han,9999,0,9999,0
1653427499052,ECE 200,019,091021,Koushanfar; Farinaz,9999,0,9999,0
1653427499052,ECE 200,020,091022,Kuzum; Duygu,9999,0,9999,0
1653427499052,ECE 200,021,091023,Le; Hanh-Phuc,9999,0,9999,0
1653427499052,ECE 200,022,091024,Lin; Bill,9999,0,9999,0
1653427499052,ECE 200,023,091025,Liu; Zhaowei,9999,0,9999,0
1653427499052,ECE 200,024,091026,Lo; Yu-Hwa,9999,0,9999,0
1653427499052,ECE 200,025,091027,Lomakin; Vitaliy,9999,0,9999,0
1653427499052,ECE 200,026,091028,Mercier; Patrick Philip,9999,0,9999,0
1653427499052,ECE 200,027,091029,Meyer; Florian,9999,0,9999,0
1653427499052,ECE 200,028,091030,Milstein; Laurence B.,9999,0,9999,0
1653427499052,ECE 200,029,091031,Mir Arabbaygi; Siavash,9999,0,9999,0
1653427499052,ECE 200,030,091032,Mookherjea; Shayan,9999,0,9999,0
1653427499052,ECE 200,031,091033,Morris; Karcher William,9999,0,9999,0
1653427499052,ECE 200,032,091034,Ng; Tse Nga,9999,0,9999,0
1653427499052,ECE 200,033,091035,Nguyen; Truong Quang,9999,0,9999,0
1653427499052,ECE 200,034,091036,Nomura; Kenji,9999,0,9999,0
1653427499052,ECE 200,035,091037,Orlitsky; Alon,9999,0,9999,0
1653427499052,ECE 200,036,091038,Pal; Piya,9999,0,9999,0
1653427499052,ECE 200,037,091039,Papen; George C.,9999,0,9999,0
1653427499052,ECE 200,038,091040,Radic; Stojan,9999,0,9999,0
1653427499052,ECE 200,039,091041,Rao; Bhaskar D.,9999,0,9999,0
1653427499052,ECE 200,040,091042,Rao; Ramesh R,9999,0,9999,0
1653427499052,ECE 200,041,091043,Rebeiz; Gabriel,9999,0,9999,0
1653427499052,ECE 200,042,091044,Sanford; John R,9999,0,9999,0
1653427499052,ECE 200,043,091045,Siegel; Paul H.,9999,0,9999,0
1653427499052,ECE 200,044,091046,Sievenpiper; Daniel F.,9999,0,9999,0
1653427499052,ECE 200,045,091047,Sworder; David D.,9999,0,9999,0
1653427499052,ECE 200,046,091048,Taur; Yuan,9999,0,9999,0
1653427499052,ECE 200,047,091049,Touri; Behrouz,9999,0,9999,0
1653427499052,ECE 200,048,091050,Trivedi; Mohan M.,9999,0,9999,0
1653427499052,ECE 200,049,091051,Vardy; Alexander,9999,0,9999,0
1653427499052,ECE 200,050,091052,Vasconcelos; Nuno,9999,0,9999,0
1653427499052,ECE 200,051,091053,Wang; Xiaolong,9999,0,9999,0
1653427499052,ECE 200,052,091054,Xie; Pengtao,9999,0,9999,0
1653427499052,ECE 200,053,091055,Yip; Michael,9999,0,9999,0
1653427499052,ECE 200,054,091056,Zeger; Kenneth A.,9999,0,9999,0
1653427499052,ECE 200,055,091057,Zhang; Xinyu,9999,0,9999,0
1653427499052,ECE 200,056,091058,Turakhia; Yatish Girish,9999,0,9999,0
1653427499052,ECE 200,057,091059,Kang; Mingu,9999,0,9999,0
1653427499052,ECE 200,058,091060,Shi; Yuanyuan,9999,0,9999,0
1653427499052,ECE 200,059,091061,Wang; Edward Jay,9999,0,9999,0
1653427499052,ECE 200,060,091062,Zheng; Yang,9999,0,9999,0
1653427499594,ECE 203,A00,091065,Mercier; Patrick Philip,0,0,0,0
1653427500122,ECE 207A,A00,091605,Liu; Thomas Tao-Ming,0,0,0,0
1653427500655,ECE 212AN,A00,091068,Nomura; Kenji,0,0,0,0
1653427501180,ECE 222A,A00,091069,Rebeiz; Gabriel,0,0,0,0
1653427501721,ECE 225A,A00,091070,Orlitsky; Alon,0,0,0,0
1653427502244,ECE 230A,A00,091071,Nomura; Kenji,0,0,0,0
1653427502779,ECE 236A,A00,091072,Dayeh; Shadi Ahmad,0,0,0,0
1653427503301,ECE 238A,A00,091073,Luo; Jian,0,0,0,0
1653427503301,ECE 238A,B00,091074,Luo; Jian,0,0,0,0
1653427503827,ECE 240A,A00,091075,Radic; Stojan,0,0,0,0
1653427504452,ECE 247A,A00,091592,Shi; Lingyan,0,0,0,0
1653427504980,ECE 250,A00,091076,Touri; Behrouz,0,0,0,0
1653427505509,ECE 251C,A00,091078,Nguyen; Truong Quang,0,0,0,0
1653427506031,ECE 253,A00,091079,Cosman; Pamela C.,0,0,0,0
1653427506566,ECE 255A,A00,091080,Orlitsky; Alon,0,0,0,0
1653427507097,ECE 257A,A00,091081,Zhang; Xinyu,0,0,0,0
1653427507619,ECE 260A,A01,091084,Eldon; John,0,0,0,0
1653427508144,ECE 264C,A00,091085,Galton; Ian A,0,0,0,0
1653427508671,ECE 265C,A00,094889,Presti; Calogero Davide,0,0,0,9
1653427509208,ECE 266,A01,091087,Hall; Drew A.,0,0,0,0
1653427510256,ECE 271A,A00,091090,Vasconcelos; Nuno,0,0,0,0
1653427510789,ECE 272B,A00,091091,Sworder; David D.,0,0,0,0
1653427511322,ECE 275A,A00,091092,Meyer; Florian,0,0,0,0
1653427511855,ECE 277,A00,091093,An; Cheolhong,0,0,0,0
1653427512379,ECE 283,A00,091094,Le; Hanh-Phuc,0,0,0,0
1653427512912,ECE 284,A00,091095,Kang; Mingu,0,0,0,0
1653427512912,ECE 284,B00,091096,Wang; Edward Jay,0,0,0,0
1653427513444,ECE 285,A00,094334,Touri; Behrouz,0,0,0,0
1653427513973,ECE 289,A00,091097,Whelan; David Arthur,0,0,0,0
1653427514500,MATH 200A,A00,087414,Salehi Golsefidy; Alireza,7,0,8,1
1653427515036,MATH 202A,A00,087415,Gill; Philip E.,3,0,8,5
1653427515560,MATH 203A,A00,087416,Oprea; Dragos N.,6,0,8,2
1653427516112,MATH 204A,A00,087417,Kedlaya; Kiran S.,6,0,8,2
1653427516658,MATH 205,A00,087418,Sorensen; Claus M,6,0,8,2
1653427517183,MATH 206A,A00,087419,Izadi; Elham,7,0,8,1
1653427517706,MATH 207A,A00,087420,Mohammadi; Amir,6,0,8,2
1653427518233,MATH 208,A00,087421,Staff,9,0,10,1
1653427518765,MATH 209,A00,087422,Staff,10,0,10,0
1653427519300,MATH 218,A00,087423,Staff,10,0,10,0
1653427519826,MATH 220A,A00,087424,Novak; Jonathan I,7,0,8,1
1653427520348,MATH 231A,A00,087425,Bejenaru; Ioan,4,0,8,4
1653427520875,MATH 240A,A00,087426,Ebenfelt; Peter F,5,0,8,3
1653427521401,MATH 243,A00,087427,Staff,9,0,10,1
1653427521934,MATH 248,A00,087429,Staff,10,0,10,0
1653427522457,MATH 250A,A00,087430,Spolaor; Luca,5,0,8,3
1653427522983,MATH 257A,A00,087431,Spolaor; Luca,7,0,8,1
1653427523518,MATH 258,A00,087432,Staff,9,0,10,1
1653427524045,MATH 264A,A00,087433,Warnke; Lutz Peter,5,0,8,3
1653427524576,MATH 268,A00,087434,Staff,15,0,15,0
1653427525114,MATH 269,A00,087435,Staff,14,0,15,1
1653427525641,MATH 270A,A00,087436,Nie; Jiawang,0,0,8,8
1653427526167,MATH 272A,A00,087437,Tian; Xiaochuan,2,0,8,6
1653427526694,MATH 274,A01,087439,Cheng; Li-Tien,9,0,10,1
1653427526694,MATH 274,A02,087440,Cheng; Li-Tien,10,0,10,0
1653427527222,MATH 278A,A00,087441,Staff,8,0,10,2
1653427527746,MATH 278B,A00,087442,Staff,8,0,10,2
1653427528271,MATH 278C,A00,087443,Staff,8,0,10,2
1653427528793,MATH 280A,A00,087444,Zheng; Tianyi,0,0,8,8
1653427529322,MATH 281A,A00,087445,Bradic; Jelena,0,0,8,8
1653427529852,MATH 282A,A00,087446,Zhang; Danna,0,0,8,8
1653427530374,MATH 283,A00,087447,Tesler; Glenn,0,0,0,14
1653427530907,MATH 286,A00,087448,Kemp; Todd Aahron,6,0,8,2
1653427531437,MATH 287D,A00,087449,Bradic; Jelena,8,0,8,0
1653427531959,MATH 288,A00,087450,Staff,14,0,15,1
1653427531959,MATH 288,B00,087451,Staff,15,0,15,0
1653427531959,MATH 288,C00,087452,Staff,15,0,15,0
1653427532485,MATH 290A,A00,087453,Xu; Zhouli,7,0,8,1
1653427533023,MATH 291A,A00,087454,Xu; Zhouli,7,0,8,1
1653427533546,MATH 292,A00,087455,Staff,10,0,10,0
1653427534069,MATH 295,A00,087456,Staff,50,0,50,0
1653427534592,MATH 297,001,087457,Staff,998,0,999,1
1653428112326,COGS 200,A01,087991,Staff,47,0,50,3
1653428112854,COGS 201,A01,094504,Rangel; Lara M,17,0,25,8
1653428113385,COGS 203,A00,087992,Coulson; Seana M,18,0,20,2
1653428113908,COGS 210A,001,087993,Greene; Deanna Jacquelyn,9998,0,9999,1
1653428113908,COGS 210A,002,087994,Saygin; Ayse P,9999,0,9999,0
1653428113908,COGS 210A,003,087995,Xia; Haijun,9999,0,9999,0
1653428113908,COGS 210A,004,087996,Nitz; Douglas A.,9999,0,9999,0
1653428113908,COGS 210A,005,087997,Hollan; James D.,9999,0,9999,0
1653428113908,COGS 210A,006,087998,Deak; Gedeon O.,9998,0,9999,1
1653428113908,COGS 210A,007,087999,Rossano; Federico,9999,0,9999,0
1653428114438,COGS 211A,A00,088000,Coulson; Seana M,9997,0,9999,2
1653428114972,COGS 229,A00,088002,Staff,23,0,25,2
1653428115495,COGS 260,B00,094231,Staff,17,0,20,3
1653428115495,COGS 260,A00,088004,Nitz; Douglas A.,9998,0,9999,1
1653428116019,CSE 202,A00,090110,Paturi; Ramamohan,0,0,0,0
1653428116019,CSE 202,B00,090111,Paturi; Ramamohan,0,0,0,0
1653428116551,CSE 207B,A00,090112,Heninger; Nadia A,0,0,0,0
1653428117074,CSE 208,A00,094858,Micciancio; Daniele,0,0,0,0
1653428117615,CSE 210,A00,090113,Powell; Thomas Allan,0,0,0,0
1653428118140,CSE 219,A00,090898,Staff,0,0,0,0
1653428118668,CSE 221,A00,090114,Zhou; Yuan-Yuan,0,0,0,0
1653428119197,CSE 229A,A00,090115,Porter; George M,0,0,0,0
1653428119718,CSE 229C,A00,090116,Savage; Stefan,0,0,0,0
1653428120244,CSE 230,A00,090117,Jhala; Ranjit,0,0,0,0
1653428120781,CSE 232,A00,090118,Papakonstantinou; Yannis,0,0,0,0
1653428121305,CSE 239A,A00,090121,Kumar; Arun Kumar,0,0,0,0
1653428121828,CSE 239B,A00,090122,Jhala; Ranjit,0,0,0,0
1653428122349,CSE 240A,A00,090123,Zhao; Jishen,0,0,189,189
1653428122887,CSE 243A,A00,090124,Orailoglu; Alex,3,0,15,12
1653428123424,CSE 249B,A00,090125,Kahng; Andrew Byun,13,0,20,7
1653428123951,CSE 250A,A00,090126,Berg-Kirkpatrick; Taylor D,0,0,0,0
1653428124480,CSE 252A,A00,090127,Ochoa; Benjamin Lawrence,0,0,0,0
1653428125009,CSE 258,A01,090129,McAuley; Julian John,0,0,0,0
1653428125534,CSE 258R,A01,090131,McAuley; Julian John,0,0,0,0
1653428126060,CSE 274,A00,090132,Ramamoorthi; Ravi,0,0,0,0
1653428126583,CSE 276A,A00,090133,Christensen; Henrik I,0,0,0,0
1653428127109,CSE 276C,A00,090134,Christensen; Henrik I,0,0,0,0
1653428127640,CSE 290,A00,090135,Bafna; Vineet,0,0,0,0
1653428127640,CSE 290,B00,090136,Ramamoorthi; Ravi,0,0,0,0
1653428127640,CSE 290,C00,090137,Li; Tzumao,9,0,10,1
1653428127640,CSE 290,D00,090138,Zhou; Yuan-Yuan,10,0,10,0
1653428127640,CSE 290,E00,090139,Christensen; Henrik I,10,0,10,0
1653428127640,CSE 290,F00,094053,Shalev; Aaron D,0,0,0,0
1653428128163,CSE 291,A00,090140,Munyaka; Imani N. S.,0,0,0,0
1653428128163,CSE 291,B00,094880,Yu; Qi,0,0,0,0
1653428128163,CSE 291,C00,090142,Pannuto; Patrick William,0,0,0,0
1653428128163,CSE 291,D00,094881,Zhang; Yiying,0,0,0,0
1653428128163,CSE 291,E00,095118,Su; Hao,0,0,0,0
1653428128718,CSE 293,001,094905,Bafna; Vineet,9999,0,9999,0
1653428128718,CSE 293,002,094906,Bellare; Mihir,9999,0,9999,0
1653428128718,CSE 293,003,094907,Berg-Kirkpatrick; Taylor D,9999,0,9999,0
1653428128718,CSE 293,004,094908,Christensen; Henrik I,9999,0,9999,0
1653428128718,CSE 293,005,094909,Cottrell; Garrison W,9999,0,9999,0
1653428128718,CSE 293,006,094910,Deutsch; Alin Bernard,9999,0,9999,0
1653428128718,CSE 293,007,094911,Esmaeilzadeh; Hadi,9999,0,9999,0
1653428128718,CSE 293,008,094912,Freund; Yoav,9999,0,9999,0
1653428128718,CSE 293,009,094913,Griswold; William G.,9999,0,9999,0
1653428128718,CSE 293,010,094914,Gymrek; Melissa Ann,9999,0,9999,0
1653428128718,CSE 293,011,094915,Heninger; Nadia A,9999,0,9999,0
1653428128718,CSE 293,012,094916,Impagliazzo; Russell,9999,0,9999,0
1653428128718,CSE 293,013,094917,Jhala; Ranjit,9999,0,9999,0
1653428128718,CSE 293,014,094918,Kahng; Andrew Byun,9999,0,9999,0
1653428128718,CSE 293,015,094919,Kane; Daniel Mertz,9999,0,9999,0
1653428128718,CSE 293,016,094920,Kriegman; David J,9999,0,9999,0
1653428128718,CSE 293,017,094921,Kumar; Arun Kumar,9999,0,9999,0
1653428128718,CSE 293,018,094922,Lerner; Sorin,9999,0,9999,0
1653428128718,CSE 293,019,094923,Lovett; Shachar,9999,0,9999,0
1653428128718,CSE 293,020,094924,McAuley; Julian John,9999,0,9999,0
1653428128718,CSE 293,021,094925,Micciancio; Daniele,9999,0,9999,0
1653428128718,CSE 293,022,094926,Orailoglu; Alex,9999,0,9999,0
1653428128718,CSE 293,023,094927,Paturi; Ramamohan,9999,0,9999,0
1653428128718,CSE 293,024,094928,Polikarpova; Nadezhda,9999,0,9999,0
1653428128718,CSE 293,025,094929,Politz; Joseph Gibbs,9999,0,9999,0
1653428128718,CSE 293,026,094930,Porter; George M,9999,0,9999,0
1653428128718,CSE 293,027,094931,Porter; Leonard Emerson,9999,0,9999,0
1653428128718,CSE 293,028,094932,Ramamoorthi; Ravi,9999,0,9999,0
1653428128718,CSE 293,029,094933,Sahoo; Debashis,9999,0,9999,0
1653428128718,CSE 293,030,094934,Saul; Lawrence,9999,0,9999,0
1653428128718,CSE 293,031,094935,Savage; Stefan,9999,0,9999,0
1653428128718,CSE 293,032,094936,Schulze; Jurgen P.,9999,0,9999,0
1653428128718,CSE 293,033,094937,Snoeren; Alex C.,9999,0,9999,0
1653428128718,CSE 293,034,094938,Shang; Jingbo,9999,0,9999,0
1653428128718,CSE 293,035,094939,Stefan; Deian,9999,0,9999,0
1653428128718,CSE 293,036,094940,Su; Hao,9999,0,9999,0
1653428128718,CSE 293,037,094941,Swanson; Steven James,9999,0,9999,0
1653428128718,CSE 293,038,094942,Tullsen; Dean Michael,9999,0,9999,0
1653428128718,CSE 293,039,094943,Voelker; Geoffrey M.,9999,0,9999,0
1653428128718,CSE 293,040,094944,Zhao; Jishen,9999,0,9999,0
1653428128718,CSE 293,041,094945,Zhou; Yuan-Yuan,9999,0,9999,0
1653428128718,CSE 293,042,094946,Gao; Sicun,9998,0,9999,1
1653428128718,CSE 293,043,094947,Weibel; Nadir,9999,0,9999,0
1653428128718,CSE 293,044,094948,Gupta; Rajesh K.,9999,0,9999,0
1653428129259,CSE 294,A00,090143,Porter; George M,9,0,10,1
1653428129781,DSE 200,A00,091799,Staff,50,0,50,0
1653428130310,DSE 203,A00,091800,Gupta; Amarnath,30,0,30,0
1653428130833,DSE 250,A00,091801,Deutsch; Alin Bernard,30,0,30,0
1653428131369,DSE 290,A00,091802,Altintas De Callaf; Ilkay,50,0,50,0
1653428131893,ECE 200,001,091003,Antipa; Nicholas A,9999,0,9999,0
1653428131893,ECE 200,002,091004,Atanasov; Nikolay A.,9999,0,9999,0
1653428131893,ECE 200,003,091005,Bharadia; Dinesh,9999,0,9999,0
1653428131893,ECE 200,004,091006,Cheng; Chung Kuan,9999,0,9999,0
1653428131893,ECE 200,005,091007,Cosman; Pamela C.,9999,0,9999,0
1653428131893,ECE 200,006,091008,Staff,9999,0,9999,0
1653428131893,ECE 200,007,091009,Dayeh; Shadi Ahmad,9999,0,9999,0
1653428131893,ECE 200,008,091010,Fainman; Yeshaiahu,9999,0,9999,0
1653428131893,ECE 200,009,091011,Ford; Joseph Earl,9999,0,9999,0
1653428131893,ECE 200,010,091012,Franceschetti; Massimo,9999,0,9999,0
1653428131893,ECE 200,011,091013,Fullerton; Eric E,9999,0,9999,0
1653428131893,ECE 200,012,091014,Galton; Ian A,9999,0,9999,0
1653428131893,ECE 200,013,091015,Gilja; Vikash,9999,0,9999,0
1653428131893,ECE 200,014,091016,Hall; Drew A.,9999,0,9999,0
1653428131893,ECE 200,015,091017,Hsueh; Tzu-Chien,9999,0,9999,0
1653428131893,ECE 200,016,091018,Javidi; Tara,9999,0,9999,0
1653428131893,ECE 200,017,091019,Kahng; Andrew Byun,9999,0,9999,0
1653428131893,ECE 200,018,091020,Kim; Young-Han,9999,0,9999,0
1653428131893,ECE 200,019,091021,Koushanfar; Farinaz,9999,0,9999,0
1653428131893,ECE 200,020,091022,Kuzum; Duygu,9999,0,9999,0
1653428131893,ECE 200,021,091023,Le; Hanh-Phuc,9999,0,9999,0
1653428131893,ECE 200,022,091024,Lin; Bill,9999,0,9999,0
1653428131893,ECE 200,023,091025,Liu; Zhaowei,9999,0,9999,0
1653428131893,ECE 200,024,091026,Lo; Yu-Hwa,9999,0,9999,0
1653428131893,ECE 200,025,091027,Lomakin; Vitaliy,9999,0,9999,0
1653428131893,ECE 200,026,091028,Mercier; Patrick Philip,9999,0,9999,0
1653428131893,ECE 200,027,091029,Meyer; Florian,9999,0,9999,0
1653428131893,ECE 200,028,091030,Milstein; Laurence B.,9999,0,9999,0
1653428131893,ECE 200,029,091031,Mir Arabbaygi; Siavash,9999,0,9999,0
1653428131893,ECE 200,030,091032,Mookherjea; Shayan,9999,0,9999,0
1653428131893,ECE 200,031,091033,Morris; Karcher William,9999,0,9999,0
1653428131893,ECE 200,032,091034,Ng; Tse Nga,9999,0,9999,0
1653428131893,ECE 200,033,091035,Nguyen; Truong Quang,9999,0,9999,0
1653428131893,ECE 200,034,091036,Nomura; Kenji,9999,0,9999,0
1653428131893,ECE 200,035,091037,Orlitsky; Alon,9999,0,9999,0
1653428131893,ECE 200,036,091038,Pal; Piya,9999,0,9999,0
1653428131893,ECE 200,037,091039,Papen; George C.,9999,0,9999,0
1653428131893,ECE 200,038,091040,Radic; Stojan,9999,0,9999,0
1653428131893,ECE 200,039,091041,Rao; Bhaskar D.,9999,0,9999,0
1653428131893,ECE 200,040,091042,Rao; Ramesh R,9999,0,9999,0
1653428131893,ECE 200,041,091043,Rebeiz; Gabriel,9999,0,9999,0
1653428131893,ECE 200,042,091044,Sanford; John R,9999,0,9999,0
1653428131893,ECE 200,043,091045,Siegel; Paul H.,9999,0,9999,0
1653428131893,ECE 200,044,091046,Sievenpiper; Daniel F.,9999,0,9999,0
1653428131893,ECE 200,045,091047,Sworder; David D.,9999,0,9999,0
1653428131893,ECE 200,046,091048,Taur; Yuan,9999,0,9999,0
1653428131893,ECE 200,047,091049,Touri; Behrouz,9999,0,9999,0
1653428131893,ECE 200,048,091050,Trivedi; Mohan M.,9999,0,9999,0
1653428131893,ECE 200,049,091051,Vardy; Alexander,9999,0,9999,0
1653428131893,ECE 200,050,091052,Vasconcelos; Nuno,9999,0,9999,0
1653428131893,ECE 200,051,091053,Wang; Xiaolong,9999,0,9999,0
1653428131893,ECE 200,052,091054,Xie; Pengtao,9999,0,9999,0
1653428131893,ECE 200,053,091055,Yip; Michael,9999,0,9999,0
1653428131893,ECE 200,054,091056,Zeger; Kenneth A.,9999,0,9999,0
1653428131893,ECE 200,055,091057,Zhang; Xinyu,9999,0,9999,0
1653428131893,ECE 200,056,091058,Turakhia; Yatish Girish,9999,0,9999,0
1653428131893,ECE 200,057,091059,Kang; Mingu,9999,0,9999,0
1653428131893,ECE 200,058,091060,Shi; Yuanyuan,9999,0,9999,0
1653428131893,ECE 200,059,091061,Wang; Edward Jay,9999,0,9999,0
1653428131893,ECE 200,060,091062,Zheng; Yang,9999,0,9999,0
1653428132425,ECE 203,A00,091065,Mercier; Patrick Philip,0,0,0,0
1653428132948,ECE 207A,A00,091605,Liu; Thomas Tao-Ming,0,0,0,0
1653428133477,ECE 212AN,A00,091068,Nomura; Kenji,0,0,0,0
1653428134003,ECE 222A,A00,091069,Rebeiz; Gabriel,0,0,0,0
1653428134537,ECE 225A,A00,091070,Orlitsky; Alon,0,0,0,0
1653428135059,ECE 230A,A00,091071,Nomura; Kenji,0,0,0,0
1653428135581,ECE 236A,A00,091072,Dayeh; Shadi Ahmad,0,0,0,0
1653428136103,ECE 238A,A00,091073,Luo; Jian,0,0,0,0
1653428136103,ECE 238A,B00,091074,Luo; Jian,0,0,0,0
1653428136632,ECE 240A,A00,091075,Radic; Stojan,0,0,0,0
1653428137161,ECE 247A,A00,091592,Shi; Lingyan,0,0,0,0
1653428137692,ECE 250,A00,091076,Touri; Behrouz,0,0,0,0
1653428138224,ECE 251C,A00,091078,Nguyen; Truong Quang,0,0,0,0
1653428138753,ECE 253,A00,091079,Cosman; Pamela C.,0,0,0,0
1653428139284,ECE 255A,A00,091080,Orlitsky; Alon,0,0,0,0
1653428139813,ECE 257A,A00,091081,Zhang; Xinyu,0,0,0,0
1653428140350,ECE 260A,A01,091084,Eldon; John,0,0,0,0
1653428140882,ECE 264C,A00,091085,Galton; Ian A,0,0,0,0
1653428141421,ECE 265C,A00,094889,Presti; Calogero Davide,0,0,0,9
1653428141961,ECE 266,A01,091087,Hall; Drew A.,0,0,0,0
1653428143032,ECE 271A,A00,091090,Vasconcelos; Nuno,0,0,0,0
1653428143563,ECE 272B,A00,091091,Sworder; David D.,0,0,0,0
1653428144108,ECE 275A,A00,091092,Meyer; Florian,0,0,0,0
1653428144633,ECE 277,A00,091093,An; Cheolhong,0,0,0,0
1653428145158,ECE 283,A00,091094,Le; Hanh-Phuc,0,0,0,0
1653428145689,ECE 284,A00,091095,Kang; Mingu,0,0,0,0
1653428145689,ECE 284,B00,091096,Wang; Edward Jay,0,0,0,0
1653428146216,ECE 285,A00,094334,Touri; Behrouz,0,0,0,0
1653428146750,ECE 289,A00,091097,Whelan; David Arthur,0,0,0,0
1653428147284,MATH 200A,A00,087414,Salehi Golsefidy; Alireza,7,0,8,1
1653428147817,MATH 202A,A00,087415,Gill; Philip E.,3,0,8,5
1653428148349,MATH 203A,A00,087416,Oprea; Dragos N.,6,0,8,2
1653428148881,MATH 204A,A00,087417,Kedlaya; Kiran S.,6,0,8,2
1653428149412,MATH 205,A00,087418,Sorensen; Claus M,6,0,8,2
1653428149938,MATH 206A,A00,087419,Izadi; Elham,7,0,8,1
1653428150463,MATH 207A,A00,087420,Mohammadi; Amir,6,0,8,2
1653428150993,MATH 208,A00,087421,Staff,9,0,10,1
1653428151519,MATH 209,A00,087422,Staff,10,0,10,0
1653428152045,MATH 218,A00,087423,Staff,10,0,10,0
1653428152585,MATH 220A,A00,087424,Novak; Jonathan I,7,0,8,1
1653428153110,MATH 231A,A00,087425,Bejenaru; Ioan,4,0,8,4
1653428153635,MATH 240A,A00,087426,Ebenfelt; Peter F,5,0,8,3
1653428154168,MATH 243,A00,087427,Staff,9,0,10,1
1653428154691,MATH 248,A00,087429,Staff,10,0,10,0
1653428155219,MATH 250A,A00,087430,Spolaor; Luca,5,0,8,3
1653428155741,MATH 257A,A00,087431,Spolaor; Luca,7,0,8,1
1653428156279,MATH 258,A00,087432,Staff,9,0,10,1
1653428156808,MATH 264A,A00,087433,Warnke; Lutz Peter,5,0,8,3
1653428157344,MATH 268,A00,087434,Staff,15,0,15,0
1653428157868,MATH 269,A00,087435,Staff,14,0,15,1
1653428158392,MATH 270A,A00,087436,Nie; Jiawang,0,0,8,8
1653428158920,MATH 272A,A00,087437,Tian; Xiaochuan,2,0,8,6
1653428159447,MATH 274,A01,087439,Cheng; Li-Tien,9,0,10,1
1653428159447,MATH 274,A02,087440,Cheng; Li-Tien,10,0,10,0
1653428159967,MATH 278A,A00,087441,Staff,8,0,10,2
1653428160491,MATH 278B,A00,087442,Staff,8,0,10,2
1653428161027,MATH 278C,A00,087443,Staff,8,0,10,2
1653428161558,MATH 280A,A00,087444,Zheng; Tianyi,0,0,8,8
1653428162092,MATH 281A,A00,087445,Bradic; Jelena,0,0,8,8
1653428162616,MATH 282A,A00,087446,Zhang; Danna,0,0,8,8
1653428163222,MATH 283,A00,087447,Tesler; Glenn,0,0,0,14
1653428163747,MATH 286,A00,087448,Kemp; Todd Aahron,6,0,8,2
1653428164300,MATH 287D,A00,087449,Bradic; Jelena,8,0,8,0
1653428164823,MATH 288,A00,087450,Staff,14,0,15,1
1653428164823,MATH 288,B00,087451,Staff,15,0,15,0
1653428164823,MATH 288,C00,087452,Staff,15,0,15,0
1653428165362,MATH 290A,A00,087453,Xu; Zhouli,7,0,8,1
1653428165891,MATH 291A,A00,087454,Xu; Zhouli,7,0,8,1
1653428166425,MATH 292,A00,087455,Staff,10,0,10,0
1653428166958,MATH 295,A00,087456,Staff,50,0,50,0
1653428167488,MATH 297,001,087457,Staff,998,0,999,1
1653428731578,COGS 200,A01,087991,Staff,47,0,50,3
1653428732102,COGS 201,A01,094504,Rangel; Lara M,17,0,25,8
1653428732624,COGS 203,A00,087992,Coulson; Seana M,18,0,20,2
1653428733146,COGS 210A,001,087993,Greene; Deanna Jacquelyn,9998,0,9999,1
1653428733146,COGS 210A,002,087994,Saygin; Ayse P,9999,0,9999,0
1653428733146,COGS 210A,003,087995,Xia; Haijun,9999,0,9999,0
1653428733146,COGS 210A,004,087996,Nitz; Douglas A.,9999,0,9999,0
1653428733146,COGS 210A,005,087997,Hollan; James D.,9999,0,9999,0
1653428733146,COGS 210A,006,087998,Deak; Gedeon O.,9998,0,9999,1
1653428733146,COGS 210A,007,087999,Rossano; Federico,9999,0,9999,0
1653428733675,COGS 211A,A00,088000,Coulson; Seana M,9997,0,9999,2
1653428734197,COGS 229,A00,088002,Staff,23,0,25,2
1653428734722,COGS 260,B00,094231,Staff,17,0,20,3
1653428734722,COGS 260,A00,088004,Nitz; Douglas A.,9998,0,9999,1
1653428735246,CSE 202,A00,090110,Paturi; Ramamohan,0,0,0,0
1653428735246,CSE 202,B00,090111,Paturi; Ramamohan,0,0,0,0
1653428735772,CSE 207B,A00,090112,Heninger; Nadia A,0,0,0,0
1653428736301,CSE 208,A00,094858,Micciancio; Daniele,0,0,0,0
1653428736839,CSE 210,A00,090113,Powell; Thomas Allan,0,0,0,0
1653428737362,CSE 219,A00,090898,Staff,0,0,0,0
1653428737887,CSE 221,A00,090114,Zhou; Yuan-Yuan,0,0,0,0
1653428738420,CSE 229A,A00,090115,Porter; George M,0,0,0,0
1653428738959,CSE 229C,A00,090116,Savage; Stefan,0,0,0,0
1653428739493,CSE 230,A00,090117,Jhala; Ranjit,0,0,0,0
1653428740034,CSE 232,A00,090118,Papakonstantinou; Yannis,0,0,0,0
1653428740568,CSE 239A,A00,090121,Kumar; Arun Kumar,0,0,0,0
1653428741095,CSE 239B,A00,090122,Jhala; Ranjit,0,0,0,0
1653428741615,CSE 240A,A00,090123,Zhao; Jishen,0,0,189,189
1653428742144,CSE 243A,A00,090124,Orailoglu; Alex,3,0,15,12
1653428742681,CSE 249B,A00,090125,Kahng; Andrew Byun,13,0,20,7
1653428743206,CSE 250A,A00,090126,Berg-Kirkpatrick; Taylor D,0,0,0,0
1653428743733,CSE 252A,A00,090127,Ochoa; Benjamin Lawrence,0,0,0,0
1653428744256,CSE 258,A01,090129,McAuley; Julian John,0,0,0,0
1653428744787,CSE 258R,A01,090131,McAuley; Julian John,0,0,0,0
1653428745312,CSE 274,A00,090132,Ramamoorthi; Ravi,0,0,0,0
1653428745843,CSE 276A,A00,090133,Christensen; Henrik I,0,0,0,0
1653428746368,CSE 276C,A00,090134,Christensen; Henrik I,0,0,0,0
1653428746910,CSE 290,A00,090135,Bafna; Vineet,0,0,0,0
1653428746910,CSE 290,B00,090136,Ramamoorthi; Ravi,0,0,0,0
1653428746910,CSE 290,C00,090137,Li; Tzumao,9,0,10,1
1653428746910,CSE 290,D00,090138,Zhou; Yuan-Yuan,10,0,10,0
1653428746910,CSE 290,E00,090139,Christensen; Henrik I,10,0,10,0
1653428746910,CSE 290,F00,094053,Shalev; Aaron D,0,0,0,0
1653428747441,CSE 291,A00,090140,Munyaka; Imani N. S.,0,0,0,0
1653428747441,CSE 291,B00,094880,Yu; Qi,0,0,0,0
1653428747441,CSE 291,C00,090142,Pannuto; Patrick William,0,0,0,0
1653428747441,CSE 291,D00,094881,Zhang; Yiying,0,0,0,0
1653428747441,CSE 291,E00,095118,Su; Hao,0,0,0,0
1653428747985,CSE 293,001,094905,Bafna; Vineet,9999,0,9999,0
1653428747985,CSE 293,002,094906,Bellare; Mihir,9999,0,9999,0
1653428747985,CSE 293,003,094907,Berg-Kirkpatrick; Taylor D,9999,0,9999,0
1653428747985,CSE 293,004,094908,Christensen; Henrik I,9999,0,9999,0
1653428747985,CSE 293,005,094909,Cottrell; Garrison W,9999,0,9999,0
1653428747985,CSE 293,006,094910,Deutsch; Alin Bernard,9999,0,9999,0
1653428747985,CSE 293,007,094911,Esmaeilzadeh; Hadi,9999,0,9999,0
1653428747985,CSE 293,008,094912,Freund; Yoav,9999,0,9999,0
1653428747985,CSE 293,009,094913,Griswold; William G.,9999,0,9999,0
1653428747985,CSE 293,010,094914,Gymrek; Melissa Ann,9999,0,9999,0
1653428747985,CSE 293,011,094915,Heninger; Nadia A,9999,0,9999,0
1653428747985,CSE 293,012,094916,Impagliazzo; Russell,9999,0,9999,0
1653428747985,CSE 293,013,094917,Jhala; Ranjit,9999,0,9999,0
1653428747985,CSE 293,014,094918,Kahng; Andrew Byun,9999,0,9999,0
1653428747985,CSE 293,015,094919,Kane; Daniel Mertz,9999,0,9999,0
1653428747985,CSE 293,016,094920,Kriegman; David J,9999,0,9999,0
1653428747985,CSE 293,017,094921,Kumar; Arun Kumar,9999,0,9999,0
1653428747985,CSE 293,018,094922,Lerner; Sorin,9999,0,9999,0
1653428747985,CSE 293,019,094923,Lovett; Shachar,9999,0,9999,0
1653428747985,CSE 293,020,094924,McAuley; Julian John,9999,0,9999,0
1653428747985,CSE 293,021,094925,Micciancio; Daniele,9999,0,9999,0
1653428747985,CSE 293,022,094926,Orailoglu; Alex,9999,0,9999,0
1653428747985,CSE 293,023,094927,Paturi; Ramamohan,9999,0,9999,0
1653428747985,CSE 293,024,094928,Polikarpova; Nadezhda,9999,0,9999,0
1653428747985,CSE 293,025,094929,Politz; Joseph Gibbs,9999,0,9999,0
1653428747985,CSE 293,026,094930,Porter; George M,9999,0,9999,0
1653428747985,CSE 293,027,094931,Porter; Leonard Emerson,9999,0,9999,0
1653428747985,CSE 293,028,094932,Ramamoorthi; Ravi,9999,0,9999,0
1653428747985,CSE 293,029,094933,Sahoo; Debashis,9999,0,9999,0
1653428747985,CSE 293,030,094934,Saul; Lawrence,9999,0,9999,0
1653428747985,CSE 293,031,094935,Savage; Stefan,9999,0,9999,0
1653428747985,CSE 293,032,094936,Schulze; Jurgen P.,9999,0,9999,0
1653428747985,CSE 293,033,094937,Snoeren; Alex C.,9999,0,9999,0
1653428747985,CSE 293,034,094938,Shang; Jingbo,9999,0,9999,0
1653428747985,CSE 293,035,094939,Stefan; Deian,9999,0,9999,0
1653428747985,CSE 293,036,094940,Su; Hao,9999,0,9999,0
1653428747985,CSE 293,037,094941,Swanson; Steven James,9999,0,9999,0
1653428747985,CSE 293,038,094942,Tullsen; Dean Michael,9999,0,9999,0
1653428747985,CSE 293,039,094943,Voelker; Geoffrey M.,9999,0,9999,0
1653428747985,CSE 293,040,094944,Zhao; Jishen,9999,0,9999,0
1653428747985,CSE 293,041,094945,Zhou; Yuan-Yuan,9999,0,9999,0
1653428747985,CSE 293,042,094946,Gao; Sicun,9998,0,9999,1
1653428747985,CSE 293,043,094947,Weibel; Nadir,9999,0,9999,0
1653428747985,CSE 293,044,094948,Gupta; Rajesh K.,9999,0,9999,0
1653428748514,CSE 294,A00,090143,Porter; George M,9,0,10,1
1653428749058,DSE 200,A00,091799,Staff,50,0,50,0
1653428749591,DSE 203,A00,091800,Gupta; Amarnath,30,0,30,0
1653428750115,DSE 250,A00,091801,Deutsch; Alin Bernard,30,0,30,0
1653428750647,DSE 290,A00,091802,Altintas De Callaf; Ilkay,50,0,50,0
1653428751195,ECE 200,001,091003,Antipa; Nicholas A,9999,0,9999,0
1653428751195,ECE 200,002,091004,Atanasov; Nikolay A.,9999,0,9999,0
1653428751195,ECE 200,003,091005,Bharadia; Dinesh,9999,0,9999,0
1653428751195,ECE 200,004,091006,Cheng; Chung Kuan,9999,0,9999,0
1653428751195,ECE 200,005,091007,Cosman; Pamela C.,9999,0,9999,0
1653428751195,ECE 200,006,091008,Staff,9999,0,9999,0
1653428751195,ECE 200,007,091009,Dayeh; Shadi Ahmad,9999,0,9999,0
1653428751195,ECE 200,008,091010,Fainman; Yeshaiahu,9999,0,9999,0
1653428751195,ECE 200,009,091011,Ford; Joseph Earl,9999,0,9999,0
1653428751195,ECE 200,010,091012,Franceschetti; Massimo,9999,0,9999,0
1653428751195,ECE 200,011,091013,Fullerton; Eric E,9999,0,9999,0
1653428751195,ECE 200,012,091014,Galton; Ian A,9999,0,9999,0
1653428751195,ECE 200,013,091015,Gilja; Vikash,9999,0,9999,0
1653428751195,ECE 200,014,091016,Hall; Drew A.,9999,0,9999,0
1653428751195,ECE 200,015,091017,Hsueh; Tzu-Chien,9999,0,9999,0
1653428751195,ECE 200,016,091018,Javidi; Tara,9999,0,9999,0
1653428751195,ECE 200,017,091019,Kahng; Andrew Byun,9999,0,9999,0
1653428751195,ECE 200,018,091020,Kim; Young-Han,9999,0,9999,0
1653428751195,ECE 200,019,091021,Koushanfar; Farinaz,9999,0,9999,0
1653428751195,ECE 200,020,091022,Kuzum; Duygu,9999,0,9999,0
1653428751195,ECE 200,021,091023,Le; Hanh-Phuc,9999,0,9999,0
1653428751195,ECE 200,022,091024,Lin; Bill,9999,0,9999,0
1653428751195,ECE 200,023,091025,Liu; Zhaowei,9999,0,9999,0
1653428751195,ECE 200,024,091026,Lo; Yu-Hwa,9999,0,9999,0
1653428751195,ECE 200,025,091027,Lomakin; Vitaliy,9999,0,9999,0
1653428751195,ECE 200,026,091028,Mercier; Patrick Philip,9999,0,9999,0
1653428751195,ECE 200,027,091029,Meyer; Florian,9999,0,9999,0
1653428751195,ECE 200,028,091030,Milstein; Laurence B.,9999,0,9999,0
1653428751195,ECE 200,029,091031,Mir Arabbaygi; Siavash,9999,0,9999,0
1653428751195,ECE 200,030,091032,Mookherjea; Shayan,9999,0,9999,0
1653428751195,ECE 200,031,091033,Morris; Karcher William,9999,0,9999,0
1653428751195,ECE 200,032,091034,Ng; Tse Nga,9999,0,9999,0
1653428751195,ECE 200,033,091035,Nguyen; Truong Quang,9999,0,9999,0
1653428751195,ECE 200,034,091036,Nomura; Kenji,9999,0,9999,0
1653428751195,ECE 200,035,091037,Orlitsky; Alon,9999,0,9999,0
1653428751195,ECE 200,036,091038,Pal; Piya,9999,0,9999,0
1653428751195,ECE 200,037,091039,Papen; George C.,9999,0,9999,0
1653428751195,ECE 200,038,091040,Radic; Stojan,9999,0,9999,0
1653428751195,ECE 200,039,091041,Rao; Bhaskar D.,9999,0,9999,0
1653428751195,ECE 200,040,091042,Rao; Ramesh R,9999,0,9999,0
1653428751195,ECE 200,041,091043,Rebeiz; Gabriel,9999,0,9999,0
1653428751195,ECE 200,042,091044,Sanford; John R,9999,0,9999,0
1653428751195,ECE 200,043,091045,Siegel; Paul H.,9999,0,9999,0
1653428751195,ECE 200,044,091046,Sievenpiper; Daniel F.,9999,0,9999,0
1653428751195,ECE 200,045,091047,Sworder; David D.,9999,0,9999,0
1653428751195,ECE 200,046,091048,Taur; Yuan,9999,0,9999,0
1653428751195,ECE 200,047,091049,Touri; Behrouz,9999,0,9999,0
1653428751195,ECE 200,048,091050,Trivedi; Mohan M.,9999,0,9999,0
1653428751195,ECE 200,049,091051,Vardy; Alexander,9999,0,9999,0
1653428751195,ECE 200,050,091052,Vasconcelos; Nuno,9999,0,9999,0
1653428751195,ECE 200,051,091053,Wang; Xiaolong,9999,0,9999,0
1653428751195,ECE 200,052,091054,Xie; Pengtao,9999,0,9999,0
1653428751195,ECE 200,053,091055,Yip; Michael,9999,0,9999,0
1653428751195,ECE 200,054,091056,Zeger; Kenneth A.,9999,0,9999,0
1653428751195,ECE 200,055,091057,Zhang; Xinyu,9999,0,9999,0
1653428751195,ECE 200,056,091058,Turakhia; Yatish Girish,9999,0,9999,0
1653428751195,ECE 200,057,091059,Kang; Mingu,9999,0,9999,0
1653428751195,ECE 200,058,091060,Shi; Yuanyuan,9999,0,9999,0
1653428751195,ECE 200,059,091061,Wang; Edward Jay,9999,0,9999,0
1653428751195,ECE 200,060,091062,Zheng; Yang,9999,0,9999,0
1653428751731,ECE 203,A00,091065,Mercier; Patrick Philip,0,0,0,0
1653428752255,ECE 207A,A00,091605,Liu; Thomas Tao-Ming,0,0,0,0
1653428752787,ECE 212AN,A00,091068,Nomura; Kenji,0,0,0,0
1653428753317,ECE 222A,A00,091069,Rebeiz; Gabriel,0,0,0,0
1653428753843,ECE 225A,A00,091070,Orlitsky; Alon,0,0,0,0
1653428754367,ECE 230A,A00,091071,Nomura; Kenji,0,0,0,0
1653428754972,ECE 236A,A00,091072,Dayeh; Shadi Ahmad,0,0,0,0
1653428755495,ECE 238A,A00,091073,Luo; Jian,0,0,0,0
1653428755495,ECE 238A,B00,091074,Luo; Jian,0,0,0,0
1653428756027,ECE 240A,A00,091075,Radic; Stojan,0,0,0,0
1653428756548,ECE 247A,A00,091592,Shi; Lingyan,0,0,0,0
1653428757084,ECE 250,A00,091076,Touri; Behrouz,0,0,0,0
1653428757613,ECE 251C,A00,091078,Nguyen; Truong Quang,0,0,0,0
1653428758150,ECE 253,A00,091079,Cosman; Pamela C.,0,0,0,0
1653428758686,ECE 255A,A00,091080,Orlitsky; Alon,0,0,0,0
1653428759221,ECE 257A,A00,091081,Zhang; Xinyu,0,0,0,0
1653428759749,ECE 260A,A01,091084,Eldon; John,0,0,0,0
1653428760275,ECE 264C,A00,091085,Galton; Ian A,0,0,0,0
1653428760802,ECE 265C,A00,094889,Presti; Calogero Davide,0,0,0,9
1653428761330,ECE 266,A01,091087,Hall; Drew A.,0,0,0,0
1653428762388,ECE 271A,A00,091090,Vasconcelos; Nuno,0,0,0,0
1653428762915,ECE 272B,A00,091091,Sworder; David D.,0,0,0,0
1653428763441,ECE 275A,A00,091092,Meyer; Florian,0,0,0,0
1653428763964,ECE 277,A00,091093,An; Cheolhong,0,0,0,0
1653428764494,ECE 283,A00,091094,Le; Hanh-Phuc,0,0,0,0
1653428765022,ECE 284,A00,091095,Kang; Mingu,0,0,0,0
1653428765022,ECE 284,B00,091096,Wang; Edward Jay,0,0,0,0
1653428765548,ECE 285,A00,094334,Touri; Behrouz,0,0,0,0
1653428766071,ECE 289,A00,091097,Whelan; David Arthur,0,0,0,0
1653428766599,MATH 200A,A00,087414,Salehi Golsefidy; Alireza,7,0,8,1
1653428767129,MATH 202A,A00,087415,Gill; Philip E.,3,0,8,5
1653428767652,MATH 203A,A00,087416,Oprea; Dragos N.,6,0,8,2
1653428768178,MATH 204A,A00,087417,Kedlaya; Kiran S.,6,0,8,2
1653428768699,MATH 205,A00,087418,Sorensen; Claus M,6,0,8,2
1653428769223,MATH 206A,A00,087419,Izadi; Elham,7,0,8,1
1653428769750,MATH 207A,A00,087420,Mohammadi; Amir,6,0,8,2
1653428770272,MATH 208,A00,087421,Staff,9,0,10,1
1653428770794,MATH 209,A00,087422,Staff,10,0,10,0
1653428771319,MATH 218,A00,087423,Staff,10,0,10,0
1653428771841,MATH 220A,A00,087424,Novak; Jonathan I,7,0,8,1
1653428772363,MATH 231A,A00,087425,Bejenaru; Ioan,4,0,8,4
1653428772893,MATH 240A,A00,087426,Ebenfelt; Peter F,5,0,8,3
1653428773433,MATH 243,A00,087427,Staff,9,0,10,1
1653428773958,MATH 248,A00,087429,Staff,10,0,10,0
1653428774492,MATH 250A,A00,087430,Spolaor; Luca,5,0,8,3
1653428775019,MATH 257A,A00,087431,Spolaor; Luca,7,0,8,1
1653428775557,MATH 258,A00,087432,Staff,9,0,10,1
1653428776083,MATH 264A,A00,087433,Warnke; Lutz Peter,5,0,8,3
1653428776607,MATH 268,A00,087434,Staff,15,0,15,0
1653428777130,MATH 269,A00,087435,Staff,14,0,15,1
1653428777660,MATH 270A,A00,087436,Nie; Jiawang,0,0,8,8
1653428778183,MATH 272A,A00,087437,Tian; Xiaochuan,2,0,8,6
1653428778706,MATH 274,A01,087439,Cheng; Li-Tien,9,0,10,1
1653428778706,MATH 274,A02,087440,Cheng; Li-Tien,10,0,10,0
1653428779231,MATH 278A,A00,087441,Staff,8,0,10,2
1653428779769,MATH 278B,A00,087442,Staff,8,0,10,2
1653428780290,MATH 278C,A00,087443,Staff,8,0,10,2
1653428780815,MATH 280A,A00,087444,Zheng; Tianyi,0,0,8,8
1653428781341,MATH 281A,A00,087445,Bradic; Jelena,0,0,8,8
1653428781863,MATH 282A,A00,087446,Zhang; Danna,0,0,8,8
1653428782386,MATH 283,A00,087447,Tesler; Glenn,0,0,0,14
1653428782910,MATH 286,A00,087448,Kemp; Todd Aahron,6,0,8,2
1653428783433,MATH 287D,A00,087449,Bradic; Jelena,8,0,8,0
1653428783960,MATH 288,A00,087450,Staff,14,0,15,1
1653428783960,MATH 288,B00,087451,Staff,15,0,15,0
1653428783960,MATH 288,C00,087452,Staff,15,0,15,0
1653428784502,MATH 290A,A00,087453,Xu; Zhouli,7,0,8,1
1653428785030,MATH 291A,A00,087454,Xu; Zhouli,7,0,8,1
1653428785559,MATH 292,A00,087455,Staff,10,0,10,0
1653428786085,MATH 295,A00,087456,Staff,50,0,50,0
1653428786608,MATH 297,001,087457,Staff,998,0,999,1
1653429351773,COGS 200,A01,087991,Staff,47,0,50,3
1653429352307,COGS 201,A01,094504,Rangel; Lara M,17,0,25,8
1653429352830,COGS 203,A00,087992,Coulson; Seana M,18,0,20,2
1653429353365,COGS 210A,001,087993,Greene; Deanna Jacquelyn,9998,0,9999,1
1653429353365,COGS 210A,002,087994,Saygin; Ayse P,9999,0,9999,0
1653429353365,COGS 210A,003,087995,Xia; Haijun,9999,0,9999,0
1653429353365,COGS 210A,004,087996,Nitz; Douglas A.,9999,0,9999,0
1653429353365,COGS 210A,005,087997,Hollan; James D.,9999,0,9999,0
1653429353365,COGS 210A,006,087998,Deak; Gedeon O.,9998,0,9999,1
1653429353365,COGS 210A,007,087999,Rossano; Federico,9999,0,9999,0
1653429353890,COGS 211A,A00,088000,Coulson; Seana M,9997,0,9999,2
1653429354421,COGS 229,A00,088002,Staff,23,0,25,2
1653429354960,COGS 260,B00,094231,Staff,17,0,20,3
1653429354960,COGS 260,A00,088004,Nitz; Douglas A.,9998,0,9999,1
1653429355489,CSE 202,A00,090110,Paturi; Ramamohan,0,0,0,0
1653429355489,CSE 202,B00,090111,Paturi; Ramamohan,0,0,0,0
1653429356016,CSE 207B,A00,090112,Heninger; Nadia A,0,0,0,0
1653429356543,CSE 208,A00,094858,Micciancio; Daniele,0,0,0,0
1653429357090,CSE 210,A00,090113,Powell; Thomas Allan,0,0,0,0
1653429357615,CSE 219,A00,090898,Staff,0,0,0,0
1653429358140,CSE 221,A00,090114,Zhou; Yuan-Yuan,0,0,0,0
1653429358662,CSE 229A,A00,090115,Porter; George M,0,0,0,0
1653429359183,CSE 229C,A00,090116,Savage; Stefan,0,0,0,0
1653429359714,CSE 230,A00,090117,Jhala; Ranjit,0,0,0,0
1653429360238,CSE 232,A00,090118,Papakonstantinou; Yannis,0,0,0,0
1653429360762,CSE 239A,A00,090121,Kumar; Arun Kumar,0,0,0,0
1653429361290,CSE 239B,A00,090122,Jhala; Ranjit,0,0,0,0
1653429361821,CSE 240A,A00,090123,Zhao; Jishen,0,0,189,189
1653429362346,CSE 243A,A00,090124,Orailoglu; Alex,3,0,15,12
1653429362887,CSE 249B,A00,090125,Kahng; Andrew Byun,13,0,20,7
1653429363409,CSE 250A,A00,090126,Berg-Kirkpatrick; Taylor D,0,0,0,0
1653429363931,CSE 252A,A00,090127,Ochoa; Benjamin Lawrence,0,0,0,0
1653429364456,CSE 258,A01,090129,McAuley; Julian John,0,0,0,0
1653429364982,CSE 258R,A01,090131,McAuley; Julian John,0,0,0,0
1653429365540,CSE 274,A00,090132,Ramamoorthi; Ravi,0,0,0,0
1653429366067,CSE 276A,A00,090133,Christensen; Henrik I,0,0,0,0
1653429366607,CSE 276C,A00,090134,Christensen; Henrik I,0,0,0,0
1653429367133,CSE 290,A00,090135,Bafna; Vineet,0,0,0,0
1653429367133,CSE 290,B00,090136,Ramamoorthi; Ravi,0,0,0,0
1653429367133,CSE 290,C00,090137,Li; Tzumao,9,0,10,1
1653429367133,CSE 290,D00,090138,Zhou; Yuan-Yuan,10,0,10,0
1653429367133,CSE 290,E00,090139,Christensen; Henrik I,10,0,10,0
1653429367133,CSE 290,F00,094053,Shalev; Aaron D,0,0,0,0
1653429367666,CSE 291,A00,090140,Munyaka; Imani N. S.,0,0,0,0
1653429367666,CSE 291,B00,094880,Yu; Qi,0,0,0,0
1653429367666,CSE 291,C00,090142,Pannuto; Patrick William,0,0,0,0
1653429367666,CSE 291,D00,094881,Zhang; Yiying,0,0,0,0
1653429367666,CSE 291,E00,095118,Su; Hao,0,0,0,0
1653429368224,CSE 293,001,094905,Bafna; Vineet,9999,0,9999,0
1653429368224,CSE 293,002,094906,Bellare; Mihir,9999,0,9999,0
1653429368224,CSE 293,003,094907,Berg-Kirkpatrick; Taylor D,9999,0,9999,0
1653429368224,CSE 293,004,094908,Christensen; Henrik I,9999,0,9999,0
1653429368224,CSE 293,005,094909,Cottrell; Garrison W,9999,0,9999,0
1653429368224,CSE 293,006,094910,Deutsch; Alin Bernard,9999,0,9999,0
1653429368224,CSE 293,007,094911,Esmaeilzadeh; Hadi,9999,0,9999,0
1653429368224,CSE 293,008,094912,Freund; Yoav,9999,0,9999,0
1653429368224,CSE 293,009,094913,Griswold; William G.,9999,0,9999,0
1653429368224,CSE 293,010,094914,Gymrek; Melissa Ann,9999,0,9999,0
1653429368224,CSE 293,011,094915,Heninger; Nadia A,9999,0,9999,0
1653429368224,CSE 293,012,094916,Impagliazzo; Russell,9999,0,9999,0
1653429368224,CSE 293,013,094917,Jhala; Ranjit,9999,0,9999,0
1653429368224,CSE 293,014,094918,Kahng; Andrew Byun,9999,0,9999,0
1653429368224,CSE 293,015,094919,Kane; Daniel Mertz,9999,0,9999,0
1653429368224,CSE 293,016,094920,Kriegman; David J,9999,0,9999,0
1653429368224,CSE 293,017,094921,Kumar; Arun Kumar,9999,0,9999,0
1653429368224,CSE 293,018,094922,Lerner; Sorin,9999,0,9999,0
1653429368224,CSE 293,019,094923,Lovett; Shachar,9999,0,9999,0
1653429368224,CSE 293,020,094924,McAuley; Julian John,9999,0,9999,0
1653429368224,CSE 293,021,094925,Micciancio; Daniele,9999,0,9999,0
1653429368224,CSE 293,022,094926,Orailoglu; Alex,9999,0,9999,0
1653429368224,CSE 293,023,094927,Paturi; Ramamohan,9999,0,9999,0
1653429368224,CSE 293,024,094928,Polikarpova; Nadezhda,9999,0,9999,0
1653429368224,CSE 293,025,094929,Politz; Joseph Gibbs,9999,0,9999,0
1653429368224,CSE 293,026,094930,Porter; George M,9999,0,9999,0
1653429368224,CSE 293,027,094931,Porter; Leonard Emerson,9999,0,9999,0
1653429368224,CSE 293,028,094932,Ramamoorthi; Ravi,9999,0,9999,0
1653429368224,CSE 293,029,094933,Sahoo; Debashis,9999,0,9999,0
1653429368224,CSE 293,030,094934,Saul; Lawrence,9999,0,9999,0
1653429368224,CSE 293,031,094935,Savage; Stefan,9999,0,9999,0
1653429368224,CSE 293,032,094936,Schulze; Jurgen P.,9999,0,9999,0
1653429368224,CSE 293,033,094937,Snoeren; Alex C.,9999,0,9999,0
1653429368224,CSE 293,034,094938,Shang; Jingbo,9999,0,9999,0
1653429368224,CSE 293,035,094939,Stefan; Deian,9999,0,9999,0
1653429368224,CSE 293,036,094940,Su; Hao,9999,0,9999,0
1653429368224,CSE 293,037,094941,Swanson; Steven James,9999,0,9999,0
1653429368224,CSE 293,038,094942,Tullsen; Dean Michael,9999,0,9999,0
1653429368224,CSE 293,039,094943,Voelker; Geoffrey M.,9999,0,9999,0
1653429368224,CSE 293,040,094944,Zhao; Jishen,9999,0,9999,0
1653429368224,CSE 293,041,094945,Zhou; Yuan-Yuan,9999,0,9999,0
1653429368224,CSE 293,042,094946,Gao; Sicun,9998,0,9999,1
1653429368224,CSE 293,043,094947,Weibel; Nadir,9999,0,9999,0
1653429368224,CSE 293,044,094948,Gupta; Rajesh K.,9999,0,9999,0
1653429368761,CSE 294,A00,090143,Porter; George M,9,0,10,1
1653429369312,DSE 200,A00,091799,Staff,50,0,50,0
1653429369847,DSE 203,A00,091800,Gupta; Amarnath,30,0,30,0
1653429370391,DSE 250,A00,091801,Deutsch; Alin Bernard,30,0,30,0
1653429370914,DSE 290,A00,091802,Altintas De Callaf; Ilkay,50,0,50,0
1653429371496,ECE 200,001,091003,Antipa; Nicholas A,9999,0,9999,0
1653429371496,ECE 200,002,091004,Atanasov; Nikolay A.,9999,0,9999,0
1653429371496,ECE 200,003,091005,Bharadia; Dinesh,9999,0,9999,0
1653429371496,ECE 200,004,091006,Cheng; Chung Kuan,9999,0,9999,0
1653429371496,ECE 200,005,091007,Cosman; Pamela C.,9999,0,9999,0
1653429371496,ECE 200,006,091008,Staff,9999,0,9999,0
1653429371496,ECE 200,007,091009,Dayeh; Shadi Ahmad,9999,0,9999,0
1653429371496,ECE 200,008,091010,Fainman; Yeshaiahu,9999,0,9999,0
1653429371496,ECE 200,009,091011,Ford; Joseph Earl,9999,0,9999,0
1653429371496,ECE 200,010,091012,Franceschetti; Massimo,9999,0,9999,0
1653429371496,ECE 200,011,091013,Fullerton; Eric E,9999,0,9999,0
1653429371496,ECE 200,012,091014,Galton; Ian A,9999,0,9999,0
1653429371496,ECE 200,013,091015,Gilja; Vikash,9999,0,9999,0
1653429371496,ECE 200,014,091016,Hall; Drew A.,9999,0,9999,0
1653429371496,ECE 200,015,091017,Hsueh; Tzu-Chien,9999,0,9999,0
1653429371496,ECE 200,016,091018,Javidi; Tara,9999,0,9999,0
1653429371496,ECE 200,017,091019,Kahng; Andrew Byun,9999,0,9999,0
1653429371496,ECE 200,018,091020,Kim; Young-Han,9999,0,9999,0
1653429371496,ECE 200,019,091021,Koushanfar; Farinaz,9999,0,9999,0
1653429371496,ECE 200,020,091022,Kuzum; Duygu,9999,0,9999,0
1653429371496,ECE 200,021,091023,Le; Hanh-Phuc,9999,0,9999,0
1653429371496,ECE 200,022,091024,Lin; Bill,9999,0,9999,0
1653429371496,ECE 200,023,091025,Liu; Zhaowei,9999,0,9999,0
1653429371496,ECE 200,024,091026,Lo; Yu-Hwa,9999,0,9999,0
1653429371496,ECE 200,025,091027,Lomakin; Vitaliy,9999,0,9999,0
1653429371496,ECE 200,026,091028,Mercier; Patrick Philip,9999,0,9999,0
1653429371496,ECE 200,027,091029,Meyer; Florian,9999,0,9999,0
1653429371496,ECE 200,028,091030,Milstein; Laurence B.,9999,0,9999,0
1653429371496,ECE 200,029,091031,Mir Arabbaygi; Siavash,9999,0,9999,0
1653429371496,ECE 200,030,091032,Mookherjea; Shayan,9999,0,9999,0
1653429371496,ECE 200,031,091033,Morris; Karcher William,9999,0,9999,0
1653429371496,ECE 200,032,091034,Ng; Tse Nga,9999,0,9999,0
1653429371496,ECE 200,033,091035,Nguyen; Truong Quang,9999,0,9999,0
1653429371496,ECE 200,034,091036,Nomura; Kenji,9999,0,9999,0
1653429371496,ECE 200,035,091037,Orlitsky; Alon,9999,0,9999,0
1653429371496,ECE 200,036,091038,Pal; Piya,9999,0,9999,0
1653429371496,ECE 200,037,091039,Papen; George C.,9999,0,9999,0
1653429371496,ECE 200,038,091040,Radic; Stojan,9999,0,9999,0
1653429371496,ECE 200,039,091041,Rao; Bhaskar D.,9999,0,9999,0
1653429371496,ECE 200,040,091042,Rao; Ramesh R,9999,0,9999,0
1653429371496,ECE 200,041,091043,Rebeiz; Gabriel,9999,0,9999,0
1653429371496,ECE 200,042,091044,Sanford; John R,9999,0,9999,0
1653429371496,ECE 200,043,091045,Siegel; Paul H.,9999,0,9999,0
1653429371496,ECE 200,044,091046,Sievenpiper; Daniel F.,9999,0,9999,0
1653429371496,ECE 200,045,091047,Sworder; David D.,9999,0,9999,0
1653429371496,ECE 200,046,091048,Taur; Yuan,9999,0,9999,0
1653429371496,ECE 200,047,091049,Touri; Behrouz,9999,0,9999,0
1653429371496,ECE 200,048,091050,Trivedi; Mohan M.,9999,0,9999,0
1653429371496,ECE 200,049,091051,Vardy; Alexander,9999,0,9999,0
1653429371496,ECE 200,050,091052,Vasconcelos; Nuno,9999,0,9999,0
1653429371496,ECE 200,051,091053,Wang; Xiaolong,9999,0,9999,0
1653429371496,ECE 200,052,091054,Xie; Pengtao,9999,0,9999,0
1653429371496,ECE 200,053,091055,Yip; Michael,9999,0,9999,0
1653429371496,ECE 200,054,091056,Zeger; Kenneth A.,9999,0,9999,0
1653429371496,ECE 200,055,091057,Zhang; Xinyu,9999,0,9999,0
1653429371496,ECE 200,056,091058,Turakhia; Yatish Girish,9999,0,9999,0
1653429371496,ECE 200,057,091059,Kang; Mingu,9999,0,9999,0
1653429371496,ECE 200,058,091060,Shi; Yuanyuan,9999,0,9999,0
1653429371496,ECE 200,059,091061,Wang; Edward Jay,9999,0,9999,0
1653429371496,ECE 200,060,091062,Zheng; Yang,9999,0,9999,0
1653429372029,ECE 203,A00,091065,Mercier; Patrick Philip,0,0,0,0
1653429372552,ECE 207A,A00,091605,Liu; Thomas Tao-Ming,0,0,0,0
1653429373074,ECE 212AN,A00,091068,Nomura; Kenji,0,0,0,0
1653429373598,ECE 222A,A00,091069,Rebeiz; Gabriel,0,0,0,0
1653429374128,ECE 225A,A00,091070,Orlitsky; Alon,0,0,0,0
1653429374653,ECE 230A,A00,091071,Nomura; Kenji,0,0,0,0
1653429375179,ECE 236A,A00,091072,Dayeh; Shadi Ahmad,0,0,0,0
1653429375701,ECE 238A,A00,091073,Luo; Jian,0,0,0,0
1653429375701,ECE 238A,B00,091074,Luo; Jian,0,0,0,0
1653429376230,ECE 240A,A00,091075,Radic; Stojan,0,0,0,0
1653429376760,ECE 247A,A00,091592,Shi; Lingyan,0,0,0,0
1653429377297,ECE 250,A00,091076,Touri; Behrouz,0,0,0,0
1653429377823,ECE 251C,A00,091078,Nguyen; Truong Quang,0,0,0,0
1653429378356,ECE 253,A00,091079,Cosman; Pamela C.,0,0,0,0
1653429378883,ECE 255A,A00,091080,Orlitsky; Alon,0,0,0,0
1653429379420,ECE 257A,A00,091081,Zhang; Xinyu,0,0,0,0
1653429379943,ECE 260A,A01,091084,Eldon; John,0,0,0,0
1653429380476,ECE 264C,A00,091085,Galton; Ian A,0,0,0,0
1653429380999,ECE 265C,A00,094889,Presti; Calogero Davide,0,0,0,9
1653429381522,ECE 266,A01,091087,Hall; Drew A.,0,0,0,0
1653429382579,ECE 271A,A00,091090,Vasconcelos; Nuno,0,0,0,0
1653429383108,ECE 272B,A00,091091,Sworder; David D.,0,0,0,0
1653429383641,ECE 275A,A00,091092,Meyer; Florian,0,0,0,0
1653429384165,ECE 277,A00,091093,An; Cheolhong,0,0,0,0
1653429384711,ECE 283,A00,091094,Le; Hanh-Phuc,0,0,0,0
1653429385237,ECE 284,A00,091095,Kang; Mingu,0,0,0,0
1653429385237,ECE 284,B00,091096,Wang; Edward Jay,0,0,0,0
1653429385762,ECE 285,A00,094334,Touri; Behrouz,0,0,0,0
1653429386291,ECE 289,A00,091097,Whelan; David Arthur,0,0,0,0
1653429386837,MATH 200A,A00,087414,Salehi Golsefidy; Alireza,7,0,8,1
1653429387368,MATH 202A,A00,087415,Gill; Philip E.,3,0,8,5
1653429387903,MATH 203A,A00,087416,Oprea; Dragos N.,6,0,8,2
1653429388446,MATH 204A,A00,087417,Kedlaya; Kiran S.,6,0,8,2
1653429388972,MATH 205,A00,087418,Sorensen; Claus M,6,0,8,2
1653429389502,MATH 206A,A00,087419,Izadi; Elham,7,0,8,1
1653429390031,MATH 207A,A00,087420,Mohammadi; Amir,6,0,8,2
1653429390554,MATH 208,A00,087421,Staff,9,0,10,1
1653429391094,MATH 209,A00,087422,Staff,10,0,10,0
1653429391621,MATH 218,A00,087423,Staff,10,0,10,0
1653429392145,MATH 220A,A00,087424,Novak; Jonathan I,7,0,8,1
1653429392676,MATH 231A,A00,087425,Bejenaru; Ioan,4,0,8,4
1653429393199,MATH 240A,A00,087426,Ebenfelt; Peter F,5,0,8,3
1653429393723,MATH 243,A00,087427,Staff,9,0,10,1
1653429394245,MATH 248,A00,087429,Staff,10,0,10,0
1653429394768,MATH 250A,A00,087430,Spolaor; Luca,5,0,8,3
1653429395293,MATH 257A,A00,087431,Spolaor; Luca,7,0,8,1
1653429395818,MATH 258,A00,087432,Staff,9,0,10,1
1653429396350,MATH 264A,A00,087433,Warnke; Lutz Peter,5,0,8,3
1653429396874,MATH 268,A00,087434,Staff,15,0,15,0
1653429397398,MATH 269,A00,087435,Staff,14,0,15,1
1653429397920,MATH 270A,A00,087436,Nie; Jiawang,0,0,8,8
1653429398444,MATH 272A,A00,087437,Tian; Xiaochuan,2,0,8,6
1653429398970,MATH 274,A01,087439,Cheng; Li-Tien,9,0,10,1
1653429398970,MATH 274,A02,087440,Cheng; Li-Tien,10,0,10,0
1653429399492,MATH 278A,A00,087441,Staff,8,0,10,2
1653429400014,MATH 278B,A00,087442,Staff,8,0,10,2
1653429400542,MATH 278C,A00,087443,Staff,8,0,10,2
1653429401167,MATH 280A,A00,087444,Zheng; Tianyi,0,0,8,8
1653429401689,MATH 281A,A00,087445,Bradic; Jelena,0,0,8,8
1653429402215,MATH 282A,A00,087446,Zhang; Danna,0,0,8,8
1653429402767,MATH 283,A00,087447,Tesler; Glenn,0,0,0,14
1653429403315,MATH 286,A00,087448,Kemp; Todd Aahron,6,0,8,2
1653429403849,MATH 287D,A00,087449,Bradic; Jelena,8,0,8,0
1653429404376,MATH 288,A00,087450,Staff,14,0,15,1
1653429404376,MATH 288,B00,087451,Staff,15,0,15,0
1653429404376,MATH 288,C00,087452,Staff,15,0,15,0
1653429404902,MATH 290A,A00,087453,Xu; Zhouli,7,0,8,1
1653429405424,MATH 291A,A00,087454,Xu; Zhouli,7,0,8,1
1653429405956,MATH 292,A00,087455,Staff,10,0,10,0
1653429406478,MATH 295,A00,087456,Staff,50,0,50,0
1653429407003,MATH 297,001,087457,Staff,998,0,999,1
1653429973426,COGS 200,A01,087991,Staff,47,0,50,3
1653429973947,COGS 201,A01,094504,Rangel; Lara M,17,0,25,8
1653429974475,COGS 203,A00,087992,Coulson; Seana M,18,0,20,2
1653429974998,COGS 210A,001,087993,Greene; Deanna Jacquelyn,9998,0,9999,1
1653429974998,COGS 210A,002,087994,Saygin; Ayse P,9999,0,9999,0
1653429974998,COGS 210A,003,087995,Xia; Haijun,9999,0,9999,0
1653429974998,COGS 210A,004,087996,Nitz; Douglas A.,9999,0,9999,0
1653429974998,COGS 210A,005,087997,Hollan; James D.,9999,0,9999,0
1653429974998,COGS 210A,006,087998,Deak; Gedeon O.,9998,0,9999,1
1653429974998,COGS 210A,007,087999,Rossano; Federico,9999,0,9999,0
1653429975527,COGS 211A,A00,088000,Coulson; Seana M,9997,0,9999,2
1653429976052,COGS 229,A00,088002,Staff,23,0,25,2
1653429976574,COGS 260,B00,094231,Staff,17,0,20,3
1653429976574,COGS 260,A00,088004,Nitz; Douglas A.,9998,0,9999,1
1653429977101,CSE 202,A00,090110,Paturi; Ramamohan,0,0,0,0
1653429977101,CSE 202,B00,090111,Paturi; Ramamohan,0,0,0,0
1653429977644,CSE 207B,A00,090112,Heninger; Nadia A,0,0,0,0
1653429978175,CSE 208,A00,094858,Micciancio; Daniele,0,0,0,0
1653429978707,CSE 210,A00,090113,Powell; Thomas Allan,0,0,0,0
1653429979233,CSE 219,A00,090898,Staff,0,0,0,0
1653429979757,CSE 221,A00,090114,Zhou; Yuan-Yuan,0,0,0,0
1653429980280,CSE 229A,A00,090115,Porter; George M,0,0,0,0
1653429980809,CSE 229C,A00,090116,Savage; Stefan,0,0,0,0
1653429981332,CSE 230,A00,090117,Jhala; Ranjit,0,0,0,0
1653429981855,CSE 232,A00,090118,Papakonstantinou; Yannis,0,0,0,0
1653429982380,CSE 239A,A00,090121,Kumar; Arun Kumar,0,0,0,0
1653429982901,CSE 239B,A00,090122,Jhala; Ranjit,0,0,0,0
1653429983427,CSE 240A,A00,090123,Zhao; Jishen,0,0,189,189
1653429983955,CSE 243A,A00,090124,Orailoglu; Alex,3,0,15,12
1653429984488,CSE 249B,A00,090125,Kahng; Andrew Byun,13,0,20,7
1653429985014,CSE 250A,A00,090126,Berg-Kirkpatrick; Taylor D,0,0,0,0
1653429985539,CSE 252A,A00,090127,Ochoa; Benjamin Lawrence,0,0,0,0
1653429986061,CSE 258,A01,090129,McAuley; Julian John,0,0,0,0
1653429986583,CSE 258R,A01,090131,McAuley; Julian John,0,0,0,0
1653429987115,CSE 274,A00,090132,Ramamoorthi; Ravi,0,0,0,0
1653429987642,CSE 276A,A00,090133,Christensen; Henrik I,0,0,0,0
1653429988164,CSE 276C,A00,090134,Christensen; Henrik I,0,0,0,0
1653429988687,CSE 290,A00,090135,Bafna; Vineet,0,0,0,0
1653429988687,CSE 290,B00,090136,Ramamoorthi; Ravi,0,0,0,0
1653429988687,CSE 290,C00,090137,Li; Tzumao,9,0,10,1
1653429988687,CSE 290,D00,090138,Zhou; Yuan-Yuan,10,0,10,0
1653429988687,CSE 290,E00,090139,Christensen; Henrik I,10,0,10,0
1653429988687,CSE 290,F00,094053,Shalev; Aaron D,0,0,0,0
1653429989210,CSE 291,A00,090140,Munyaka; Imani N. S.,0,0,0,0
1653429989210,CSE 291,B00,094880,Yu; Qi,0,0,0,0
1653429989210,CSE 291,C00,090142,Pannuto; Patrick William,0,0,0,0
1653429989210,CSE 291,D00,094881,Zhang; Yiying,0,0,0,0
1653429989210,CSE 291,E00,095118,Su; Hao,0,0,0,0
1653429989755,CSE 293,001,094905,Bafna; Vineet,9999,0,9999,0
1653429989755,CSE 293,002,094906,Bellare; Mihir,9999,0,9999,0
1653429989755,CSE 293,003,094907,Berg-Kirkpatrick; Taylor D,9999,0,9999,0
1653429989755,CSE 293,004,094908,Christensen; Henrik I,9999,0,9999,0
1653429989755,CSE 293,005,094909,Cottrell; Garrison W,9999,0,9999,0
1653429989755,CSE 293,006,094910,Deutsch; Alin Bernard,9999,0,9999,0
1653429989755,CSE 293,007,094911,Esmaeilzadeh; Hadi,9999,0,9999,0
1653429989755,CSE 293,008,094912,Freund; Yoav,9999,0,9999,0
1653429989755,CSE 293,009,094913,Griswold; William G.,9999,0,9999,0
1653429989755,CSE 293,010,094914,Gymrek; Melissa Ann,9999,0,9999,0
1653429989755,CSE 293,011,094915,Heninger; Nadia A,9999,0,9999,0
1653429989755,CSE 293,012,094916,Impagliazzo; Russell,9999,0,9999,0
1653429989755,CSE 293,013,094917,Jhala; Ranjit,9999,0,9999,0
1653429989755,CSE 293,014,094918,Kahng; Andrew Byun,9999,0,9999,0
1653429989755,CSE 293,015,094919,Kane; Daniel Mertz,9999,0,9999,0
1653429989755,CSE 293,016,094920,Kriegman; David J,9999,0,9999,0
1653429989755,CSE 293,017,094921,Kumar; Arun Kumar,9999,0,9999,0
1653429989755,CSE 293,018,094922,Lerner; Sorin,9999,0,9999,0
1653429989755,CSE 293,019,094923,Lovett; Shachar,9999,0,9999,0
1653429989755,CSE 293,020,094924,McAuley; Julian John,9999,0,9999,0
1653429989755,CSE 293,021,094925,Micciancio; Daniele,9999,0,9999,0
1653429989755,CSE 293,022,094926,Orailoglu; Alex,9999,0,9999,0
1653429989755,CSE 293,023,094927,Paturi; Ramamohan,9999,0,9999,0
1653429989755,CSE 293,024,094928,Polikarpova; Nadezhda,9999,0,9999,0
1653429989755,CSE 293,025,094929,Politz; Joseph Gibbs,9999,0,9999,0
1653429989755,CSE 293,026,094930,Porter; George M,9999,0,9999,0
1653429989755,CSE 293,027,094931,Porter; Leonard Emerson,9999,0,9999,0
1653429989755,CSE 293,028,094932,Ramamoorthi; Ravi,9999,0,9999,0
1653429989755,CSE 293,029,094933,Sahoo; Debashis,9999,0,9999,0
1653429989755,CSE 293,030,094934,Saul; Lawrence,9999,0,9999,0
1653429989755,CSE 293,031,094935,Savage; Stefan,9999,0,9999,0
1653429989755,CSE 293,032,094936,Schulze; Jurgen P.,9999,0,9999,0
1653429989755,CSE 293,033,094937,Snoeren; Alex C.,9999,0,9999,0
1653429989755,CSE 293,034,094938,Shang; Jingbo,9999,0,9999,0
1653429989755,CSE 293,035,094939,Stefan; Deian,9999,0,9999,0
1653429989755,CSE 293,036,094940,Su; Hao,9999,0,9999,0
1653429989755,CSE 293,037,094941,Swanson; Steven James,9999,0,9999,0
1653429989755,CSE 293,038,094942,Tullsen; Dean Michael,9999,0,9999,0
1653429989755,CSE 293,039,094943,Voelker; Geoffrey M.,9999,0,9999,0
1653429989755,CSE 293,040,094944,Zhao; Jishen,9999,0,9999,0
1653429989755,CSE 293,041,094945,Zhou; Yuan-Yuan,9999,0,9999,0
1653429989755,CSE 293,042,094946,Gao; Sicun,9998,0,9999,1
1653429989755,CSE 293,043,094947,Weibel; Nadir,9999,0,9999,0
1653429989755,CSE 293,044,094948,Gupta; Rajesh K.,9999,0,9999,0
1653429990276,CSE 294,A00,090143,Porter; George M,9,0,10,1
1653429990801,DSE 200,A00,091799,Staff,50,0,50,0
1653429991324,DSE 203,A00,091800,Gupta; Amarnath,30,0,30,0
1653429991845,DSE 250,A00,091801,Deutsch; Alin Bernard,30,0,30,0
1653429992367,DSE 290,A00,091802,Altintas De Callaf; Ilkay,50,0,50,0
1653429992924,ECE 200,001,091003,Antipa; Nicholas A,9999,0,9999,0
1653429992924,ECE 200,002,091004,Atanasov; Nikolay A.,9999,0,9999,0
1653429992924,ECE 200,003,091005,Bharadia; Dinesh,9999,0,9999,0
1653429992924,ECE 200,004,091006,Cheng; Chung Kuan,9999,0,9999,0
1653429992924,ECE 200,005,091007,Cosman; Pamela C.,9999,0,9999,0
1653429992924,ECE 200,006,091008,Staff,9999,0,9999,0
1653429992924,ECE 200,007,091009,Dayeh; Shadi Ahmad,9999,0,9999,0
1653429992924,ECE 200,008,091010,Fainman; Yeshaiahu,9999,0,9999,0
1653429992924,ECE 200,009,091011,Ford; Joseph Earl,9999,0,9999,0
1653429992924,ECE 200,010,091012,Franceschetti; Massimo,9999,0,9999,0
1653429992924,ECE 200,011,091013,Fullerton; Eric E,9999,0,9999,0
1653429992924,ECE 200,012,091014,Galton; Ian A,9999,0,9999,0
1653429992924,ECE 200,013,091015,Gilja; Vikash,9999,0,9999,0
1653429992924,ECE 200,014,091016,Hall; Drew A.,9999,0,9999,0
1653429992924,ECE 200,015,091017,Hsueh; Tzu-Chien,9999,0,9999,0
1653429992924,ECE 200,016,091018,Javidi; Tara,9999,0,9999,0
1653429992924,ECE 200,017,091019,Kahng; Andrew Byun,9999,0,9999,0
1653429992924,ECE 200,018,091020,Kim; Young-Han,9999,0,9999,0
1653429992924,ECE 200,019,091021,Koushanfar; Farinaz,9999,0,9999,0
1653429992924,ECE 200,020,091022,Kuzum; Duygu,9999,0,9999,0
1653429992924,ECE 200,021,091023,Le; Hanh-Phuc,9999,0,9999,0
1653429992924,ECE 200,022,091024,Lin; Bill,9999,0,9999,0
1653429992924,ECE 200,023,091025,Liu; Zhaowei,9999,0,9999,0
1653429992924,ECE 200,024,091026,Lo; Yu-Hwa,9999,0,9999,0
1653429992924,ECE 200,025,091027,Lomakin; Vitaliy,9999,0,9999,0
1653429992924,ECE 200,026,091028,Mercier; Patrick Philip,9999,0,9999,0
1653429992924,ECE 200,027,091029,Meyer; Florian,9999,0,9999,0
1653429992924,ECE 200,028,091030,Milstein; Laurence B.,9999,0,9999,0
1653429992924,ECE 200,029,091031,Mir Arabbaygi; Siavash,9999,0,9999,0
1653429992924,ECE 200,030,091032,Mookherjea; Shayan,9999,0,9999,0
1653429992924,ECE 200,031,091033,Morris; Karcher William,9999,0,9999,0
1653429992924,ECE 200,032,091034,Ng; Tse Nga,9999,0,9999,0
1653429992924,ECE 200,033,091035,Nguyen; Truong Quang,9999,0,9999,0
1653429992924,ECE 200,034,091036,Nomura; Kenji,9999,0,9999,0
1653429992924,ECE 200,035,091037,Orlitsky; Alon,9999,0,9999,0
1653429992924,ECE 200,036,091038,Pal; Piya,9999,0,9999,0
1653429992924,ECE 200,037,091039,Papen; George C.,9999,0,9999,0
1653429992924,ECE 200,038,091040,Radic; Stojan,9999,0,9999,0
1653429992924,ECE 200,039,091041,Rao; Bhaskar D.,9999,0,9999,0
1653429992924,ECE 200,040,091042,Rao; Ramesh R,9999,0,9999,0
1653429992924,ECE 200,041,091043,Rebeiz; Gabriel,9999,0,9999,0
1653429992924,ECE 200,042,091044,Sanford; John R,9999,0,9999,0
1653429992924,ECE 200,043,091045,Siegel; Paul H.,9999,0,9999,0
1653429992924,ECE 200,044,091046,Sievenpiper; Daniel F.,9999,0,9999,0
1653429992924,ECE 200,045,091047,Sworder; David D.,9999,0,9999,0
1653429992924,ECE 200,046,091048,Taur; Yuan,9999,0,9999,0
1653429992924,ECE 200,047,091049,Touri; Behrouz,9999,0,9999,0
1653429992924,ECE 200,048,091050,Trivedi; Mohan M.,9999,0,9999,0
1653429992924,ECE 200,049,091051,Vardy; Alexander,9999,0,9999,0
1653429992924,ECE 200,050,091052,Vasconcelos; Nuno,9999,0,9999,0
1653429992924,ECE 200,051,091053,Wang; Xiaolong,9999,0,9999,0
1653429992924,ECE 200,052,091054,Xie; Pengtao,9999,0,9999,0
1653429992924,ECE 200,053,091055,Yip; Michael,9999,0,9999,0
1653429992924,ECE 200,054,091056,Zeger; Kenneth A.,9999,0,9999,0
1653429992924,ECE 200,055,091057,Zhang; Xinyu,9999,0,9999,0
1653429992924,ECE 200,056,091058,Turakhia; Yatish Girish,9999,0,9999,0
1653429992924,ECE 200,057,091059,Kang; Mingu,9999,0,9999,0
1653429992924,ECE 200,058,091060,Shi; Yuanyuan,9999,0,9999,0
1653429992924,ECE 200,059,091061,Wang; Edward Jay,9999,0,9999,0
1653429992924,ECE 200,060,091062,Zheng; Yang,9999,0,9999,0
1653429993457,ECE 203,A00,091065,Mercier; Patrick Philip,0,0,0,0
1653429993980,ECE 207A,A00,091605,Liu; Thomas Tao-Ming,0,0,0,0
1653429994502,ECE 212AN,A00,091068,Nomura; Kenji,0,0,0,0
1653429995151,ECE 222A,A00,091069,Rebeiz; Gabriel,0,0,0,0
1653429995674,ECE 225A,A00,091070,Orlitsky; Alon,0,0,0,0
1653429996210,ECE 230A,A00,091071,Nomura; Kenji,0,0,0,0
1653429996736,ECE 236A,A00,091072,Dayeh; Shadi Ahmad,0,0,0,0
1653429997274,ECE 238A,A00,091073,Luo; Jian,0,0,0,0
1653429997274,ECE 238A,B00,091074,Luo; Jian,0,0,0,0
1653429997800,ECE 240A,A00,091075,Radic; Stojan,0,0,0,0
1653429998341,ECE 247A,A00,091592,Shi; Lingyan,0,0,0,0
1653429998871,ECE 250,A00,091076,Touri; Behrouz,0,0,0,0
1653429999399,ECE 251C,A00,091078,Nguyen; Truong Quang,0,0,0,0
1653429999926,ECE 253,A00,091079,Cosman; Pamela C.,0,0,0,0
1653430000456,ECE 255A,A00,091080,Orlitsky; Alon,0,0,0,0
1653430000981,ECE 257A,A00,091081,Zhang; Xinyu,0,0,0,0
1653430001508,ECE 260A,A01,091084,Eldon; John,0,0,0,0
1653430002032,ECE 264C,A00,091085,Galton; Ian A,0,0,0,0
1653430002560,ECE 265C,A00,094889,Presti; Calogero Davide,0,0,0,9
1653430003083,ECE 266,A01,091087,Hall; Drew A.,0,0,0,0
1653430004135,ECE 271A,A00,091090,Vasconcelos; Nuno,0,0,0,0
1653430004657,ECE 272B,A00,091091,Sworder; David D.,0,0,0,0
1653430005183,ECE 275A,A00,091092,Meyer; Florian,0,0,0,0
1653430005717,ECE 277,A00,091093,An; Cheolhong,0,0,0,0
1653430006243,ECE 283,A00,091094,Le; Hanh-Phuc,0,0,0,0
1653430006772,ECE 284,A00,091095,Kang; Mingu,0,0,0,0
1653430006772,ECE 284,B00,091096,Wang; Edward Jay,0,0,0,0
1653430007294,ECE 285,A00,094334,Touri; Behrouz,0,0,0,0
1653430007820,ECE 289,A00,091097,Whelan; David Arthur,0,0,0,0
1653430019124,MATH 200A,A00,087414,Salehi Golsefidy; Alireza,7,0,8,1
1653430019646,MATH 202A,A00,087415,Gill; Philip E.,3,0,8,5
1653430020168,MATH 203A,A00,087416,Oprea; Dragos N.,6,0,8,2
1653430020694,MATH 204A,A00,087417,Kedlaya; Kiran S.,6,0,8,2
1653430021220,MATH 205,A00,087418,Sorensen; Claus M,6,0,8,2
1653430021740,MATH 206A,A00,087419,Izadi; Elham,7,0,8,1
1653430022276,MATH 207A,A00,087420,Mohammadi; Amir,6,0,8,2
1653430022814,MATH 208,A00,087421,Staff,9,0,10,1
1653430023342,MATH 209,A00,087422,Staff,10,0,10,0
1653430023864,MATH 218,A00,087423,Staff,10,0,10,0
1653430024392,MATH 220A,A00,087424,Novak; Jonathan I,7,0,8,1
1653430024916,MATH 231A,A00,087425,Bejenaru; Ioan,4,0,8,4
1653430025449,MATH 240A,A00,087426,Ebenfelt; Peter F,5,0,8,3
1653430025973,MATH 243,A00,087427,Staff,9,0,10,1
1653430026497,MATH 248,A00,087429,Staff,10,0,10,0
1653430027020,MATH 250A,A00,087430,Spolaor; Luca,5,0,8,3
1653430027550,MATH 257A,A00,087431,Spolaor; Luca,7,0,8,1
1653430028075,MATH 258,A00,087432,Staff,9,0,10,1
1653430028606,MATH 264A,A00,087433,Warnke; Lutz Peter,5,0,8,3
1653430029130,MATH 268,A00,087434,Staff,15,0,15,0
1653430029654,MATH 269,A00,087435,Staff,14,0,15,1
1653430030177,MATH 270A,A00,087436,Nie; Jiawang,0,0,8,8
1653430030706,MATH 272A,A00,087437,Tian; Xiaochuan,1,0,8,7
1653430031241,MATH 274,A01,087439,Cheng; Li-Tien,9,0,10,1
1653430031241,MATH 274,A02,087440,Cheng; Li-Tien,10,0,10,0
1653430031766,MATH 278A,A00,087441,Staff,8,0,10,2
1653430032289,MATH 278B,A00,087442,Staff,8,0,10,2
1653430032819,MATH 278C,A00,087443,Staff,8,0,10,2
1653430033344,MATH 280A,A00,087444,Zheng; Tianyi,0,0,8,8
1653430033877,MATH 281A,A00,087445,Bradic; Jelena,0,0,8,8
1653430034409,MATH 282A,A00,087446,Zhang; Danna,0,0,8,8
1653430034933,MATH 283,A00,087447,Tesler; Glenn,0,0,0,14
1653430035461,MATH 286,A00,087448,Kemp; Todd Aahron,6,0,8,2
1653430035996,MATH 287D,A00,087449,Bradic; Jelena,8,0,8,0
1653430036536,MATH 288,A00,087450,Staff,14,0,15,1
1653430036536,MATH 288,B00,087451,Staff,15,0,15,0
1653430036536,MATH 288,C00,087452,Staff,15,0,15,0
1653430037073,MATH 290A,A00,087453,Xu; Zhouli,7,0,8,1
1653430037606,MATH 291A,A00,087454,Xu; Zhouli,7,0,8,1
1653430038130,MATH 292,A00,087455,Staff,10,0,10,0
1653430038653,MATH 295,A00,087456,Staff,50,0,50,0
1653430039182,MATH 297,001,087457,Staff,998,0,999,1
1653430603433,COGS 200,A01,087991,Staff,47,0,50,3
1653430603967,COGS 201,A01,094504,Rangel; Lara M,17,0,25,8
1653430604494,COGS 203,A00,087992,Coulson; Seana M,18,0,20,2
1653430605019,COGS 210A,001,087993,Greene; Deanna Jacquelyn,9998,0,9999,1
1653430605019,COGS 210A,002,087994,Saygin; Ayse P,9999,0,9999,0
1653430605019,COGS 210A,003,087995,Xia; Haijun,9999,0,9999,0
1653430605019,COGS 210A,004,087996,Nitz; Douglas A.,9999,0,9999,0
1653430605019,COGS 210A,005,087997,Hollan; James D.,9999,0,9999,0
1653430605019,COGS 210A,006,087998,Deak; Gedeon O.,9998,0,9999,1
1653430605019,COGS 210A,007,087999,Rossano; Federico,9999,0,9999,0
1653430605542,COGS 211A,A00,088000,Coulson; Seana M,9997,0,9999,2
1653430606068,COGS 229,A00,088002,Staff,23,0,25,2
1653430606598,COGS 260,B00,094231,Staff,17,0,20,3
1653430606598,COGS 260,A00,088004,Nitz; Douglas A.,9998,0,9999,1
1653430607135,CSE 202,A00,090110,Paturi; Ramamohan,0,0,0,0
1653430607135,CSE 202,B00,090111,Paturi; Ramamohan,0,0,0,0
1653430607663,CSE 207B,A00,090112,Heninger; Nadia A,0,0,0,0
1653430608191,CSE 208,A00,094858,Micciancio; Daniele,0,0,0,0
1653430608714,CSE 210,A00,090113,Powell; Thomas Allan,0,0,0,0
1653430609253,CSE 219,A00,090898,Staff,0,0,0,0
1653430609776,CSE 221,A00,090114,Zhou; Yuan-Yuan,0,0,0,0
1653430610300,CSE 229A,A00,090115,Porter; George M,0,0,0,0
1653430610828,CSE 229C,A00,090116,Savage; Stefan,0,0,0,0
1653430611351,CSE 230,A00,090117,Jhala; Ranjit,0,0,0,0
1653430611876,CSE 232,A00,090118,Papakonstantinou; Yannis,0,0,0,0
1653430612417,CSE 239A,A00,090121,Kumar; Arun Kumar,0,0,0,0
1653430612941,CSE 239B,A00,090122,Jhala; Ranjit,0,0,0,0
1653430613571,CSE 240A,A00,090123,Zhao; Jishen,0,0,189,189
1653430614099,CSE 243A,A00,090124,Orailoglu; Alex,3,0,15,12
1653430614625,CSE 249B,A00,090125,Kahng; Andrew Byun,13,0,20,7
1653430615148,CSE 250A,A00,090126,Berg-Kirkpatrick; Taylor D,0,0,0,0
1653430615675,CSE 252A,A00,090127,Ochoa; Benjamin Lawrence,0,0,0,0
1653430616212,CSE 258,A01,090129,McAuley; Julian John,0,0,0,0
1653430616736,CSE 258R,A01,090131,McAuley; Julian John,0,0,0,0
1653430617257,CSE 274,A00,090132,Ramamoorthi; Ravi,0,0,0,0
1653430617790,CSE 276A,A00,090133,Christensen; Henrik I,0,0,0,0
1653430618316,CSE 276C,A00,090134,Christensen; Henrik I,0,0,0,0
1653430618839,CSE 290,A00,090135,Bafna; Vineet,0,0,0,0
1653430618839,CSE 290,B00,090136,Ramamoorthi; Ravi,0,0,0,0
1653430618839,CSE 290,C00,090137,Li; Tzumao,9,0,10,1
1653430618839,CSE 290,D00,090138,Zhou; Yuan-Yuan,10,0,10,0
1653430618839,CSE 290,E00,090139,Christensen; Henrik I,10,0,10,0
1653430618839,CSE 290,F00,094053,Shalev; Aaron D,0,0,0,0
1653430619373,CSE 291,A00,090140,Munyaka; Imani N. S.,0,0,0,0
1653430619373,CSE 291,B00,094880,Yu; Qi,0,0,0,0
1653430619373,CSE 291,C00,090142,Pannuto; Patrick William,0,0,0,0
1653430619373,CSE 291,D00,094881,Zhang; Yiying,0,0,0,0
1653430619373,CSE 291,E00,095118,Su; Hao,0,0,0,0
1653430619917,CSE 293,001,094905,Bafna; Vineet,9999,0,9999,0
1653430619917,CSE 293,002,094906,Bellare; Mihir,9999,0,9999,0
1653430619917,CSE 293,003,094907,Berg-Kirkpatrick; Taylor D,9999,0,9999,0
1653430619917,CSE 293,004,094908,Christensen; Henrik I,9999,0,9999,0
1653430619917,CSE 293,005,094909,Cottrell; Garrison W,9999,0,9999,0
1653430619917,CSE 293,006,094910,Deutsch; Alin Bernard,9999,0,9999,0
1653430619917,CSE 293,007,094911,Esmaeilzadeh; Hadi,9999,0,9999,0
1653430619917,CSE 293,008,094912,Freund; Yoav,9999,0,9999,0
1653430619917,CSE 293,009,094913,Griswold; William G.,9999,0,9999,0
1653430619917,CSE 293,010,094914,Gymrek; Melissa Ann,9999,0,9999,0
1653430619917,CSE 293,011,094915,Heninger; Nadia A,9999,0,9999,0
1653430619917,CSE 293,012,094916,Impagliazzo; Russell,9999,0,9999,0
1653430619917,CSE 293,013,094917,Jhala; Ranjit,9999,0,9999,0
1653430619917,CSE 293,014,094918,Kahng; Andrew Byun,9999,0,9999,0
1653430619917,CSE 293,015,094919,Kane; Daniel Mertz,9999,0,9999,0
1653430619917,CSE 293,016,094920,Kriegman; David J,9999,0,9999,0
1653430619917,CSE 293,017,094921,Kumar; Arun Kumar,9999,0,9999,0
1653430619917,CSE 293,018,094922,Lerner; Sorin,9999,0,9999,0
1653430619917,CSE 293,019,094923,Lovett; Shachar,9999,0,9999,0
1653430619917,CSE 293,020,094924,McAuley; Julian John,9999,0,9999,0
1653430619917,CSE 293,021,094925,Micciancio; Daniele,9999,0,9999,0
1653430619917,CSE 293,022,094926,Orailoglu; Alex,9999,0,9999,0
1653430619917,CSE 293,023,094927,Paturi; Ramamohan,9999,0,9999,0
1653430619917,CSE 293,024,094928,Polikarpova; Nadezhda,9999,0,9999,0
1653430619917,CSE 293,025,094929,Politz; Joseph Gibbs,9999,0,9999,0
1653430619917,CSE 293,026,094930,Porter; George M,9999,0,9999,0
1653430619917,CSE 293,027,094931,Porter; Leonard Emerson,9999,0,9999,0
1653430619917,CSE 293,028,094932,Ramamoorthi; Ravi,9999,0,9999,0
1653430619917,CSE 293,029,094933,Sahoo; Debashis,9999,0,9999,0
1653430619917,CSE 293,030,094934,Saul; Lawrence,9999,0,9999,0
1653430619917,CSE 293,031,094935,Savage; Stefan,9999,0,9999,0
1653430619917,CSE 293,032,094936,Schulze; Jurgen P.,9999,0,9999,0
1653430619917,CSE 293,033,094937,Snoeren; Alex C.,9999,0,9999,0
1653430619917,CSE 293,034,094938,Shang; Jingbo,9999,0,9999,0
1653430619917,CSE 293,035,094939,Stefan; Deian,9999,0,9999,0
1653430619917,CSE 293,036,094940,Su; Hao,9999,0,9999,0
1653430619917,CSE 293,037,094941,Swanson; Steven James,9999,0,9999,0
1653430619917,CSE 293,038,094942,Tullsen; Dean Michael,9999,0,9999,0
1653430619917,CSE 293,039,094943,Voelker; Geoffrey M.,9999,0,9999,0
1653430619917,CSE 293,040,094944,Zhao; Jishen,9999,0,9999,0
1653430619917,CSE 293,041,094945,Zhou; Yuan-Yuan,9999,0,9999,0
1653430619917,CSE 293,042,094946,Gao; Sicun,9998,0,9999,1
1653430619917,CSE 293,043,094947,Weibel; Nadir,9999,0,9999,0
1653430619917,CSE 293,044,094948,Gupta; Rajesh K.,9999,0,9999,0
1653430620439,CSE 294,A00,090143,Porter; George M,9,0,10,1
1653430620962,DSE 200,A00,091799,Staff,50,0,50,0
1653430621487,DSE 203,A00,091800,Gupta; Amarnath,30,0,30,0
1653430622011,DSE 250,A00,091801,Deutsch; Alin Bernard,30,0,30,0
1653430622539,DSE 290,A00,091802,Altintas De Callaf; Ilkay,50,0,50,0
1653430623086,ECE 200,001,091003,Antipa; Nicholas A,9999,0,9999,0
1653430623086,ECE 200,002,091004,Atanasov; Nikolay A.,9999,0,9999,0
1653430623086,ECE 200,003,091005,Bharadia; Dinesh,9999,0,9999,0
1653430623086,ECE 200,004,091006,Cheng; Chung Kuan,9999,0,9999,0
1653430623086,ECE 200,005,091007,Cosman; Pamela C.,9999,0,9999,0
1653430623086,ECE 200,006,091008,Staff,9999,0,9999,0
1653430623086,ECE 200,007,091009,Dayeh; Shadi Ahmad,9999,0,9999,0
1653430623086,ECE 200,008,091010,Fainman; Yeshaiahu,9999,0,9999,0
1653430623086,ECE 200,009,091011,Ford; Joseph Earl,9999,0,9999,0
1653430623086,ECE 200,010,091012,Franceschetti; Massimo,9999,0,9999,0
1653430623086,ECE 200,011,091013,Fullerton; Eric E,9999,0,9999,0
1653430623086,ECE 200,012,091014,Galton; Ian A,9999,0,9999,0
1653430623086,ECE 200,013,091015,Gilja; Vikash,9999,0,9999,0
1653430623086,ECE 200,014,091016,Hall; Drew A.,9999,0,9999,0
1653430623086,ECE 200,015,091017,Hsueh; Tzu-Chien,9999,0,9999,0
1653430623086,ECE 200,016,091018,Javidi; Tara,9999,0,9999,0
1653430623086,ECE 200,017,091019,Kahng; Andrew Byun,9999,0,9999,0
1653430623086,ECE 200,018,091020,Kim; Young-Han,9999,0,9999,0
1653430623086,ECE 200,019,091021,Koushanfar; Farinaz,9999,0,9999,0
1653430623086,ECE 200,020,091022,Kuzum; Duygu,9999,0,9999,0
1653430623086,ECE 200,021,091023,Le; Hanh-Phuc,9999,0,9999,0
1653430623086,ECE 200,022,091024,Lin; Bill,9999,0,9999,0
1653430623086,ECE 200,023,091025,Liu; Zhaowei,9999,0,9999,0
1653430623086,ECE 200,024,091026,Lo; Yu-Hwa,9999,0,9999,0
1653430623086,ECE 200,025,091027,Lomakin; Vitaliy,9999,0,9999,0
1653430623086,ECE 200,026,091028,Mercier; Patrick Philip,9999,0,9999,0
1653430623086,ECE 200,027,091029,Meyer; Florian,9999,0,9999,0
1653430623086,ECE 200,028,091030,Milstein; Laurence B.,9999,0,9999,0
1653430623086,ECE 200,029,091031,Mir Arabbaygi; Siavash,9999,0,9999,0
1653430623086,ECE 200,030,091032,Mookherjea; Shayan,9999,0,9999,0
1653430623086,ECE 200,031,091033,Morris; Karcher William,9999,0,9999,0
1653430623086,ECE 200,032,091034,Ng; Tse Nga,9999,0,9999,0
1653430623086,ECE 200,033,091035,Nguyen; Truong Quang,9999,0,9999,0
1653430623086,ECE 200,034,091036,Nomura; Kenji,9999,0,9999,0
1653430623086,ECE 200,035,091037,Orlitsky; Alon,9999,0,9999,0
1653430623086,ECE 200,036,091038,Pal; Piya,9999,0,9999,0
1653430623086,ECE 200,037,091039,Papen; George C.,9999,0,9999,0
1653430623086,ECE 200,038,091040,Radic; Stojan,9999,0,9999,0
1653430623086,ECE 200,039,091041,Rao; Bhaskar D.,9999,0,9999,0
1653430623086,ECE 200,040,091042,Rao; Ramesh R,9999,0,9999,0
1653430623086,ECE 200,041,091043,Rebeiz; Gabriel,9999,0,9999,0
1653430623086,ECE 200,042,091044,Sanford; John R,9999,0,9999,0
1653430623086,ECE 200,043,091045,Siegel; Paul H.,9999,0,9999,0
1653430623086,ECE 200,044,091046,Sievenpiper; Daniel F.,9999,0,9999,0
1653430623086,ECE 200,045,091047,Sworder; David D.,9999,0,9999,0
1653430623086,ECE 200,046,091048,Taur; Yuan,9999,0,9999,0
1653430623086,ECE 200,047,091049,Touri; Behrouz,9999,0,9999,0
1653430623086,ECE 200,048,091050,Trivedi; Mohan M.,9999,0,9999,0
1653430623086,ECE 200,049,091051,Vardy; Alexander,9999,0,9999,0
1653430623086,ECE 200,050,091052,Vasconcelos; Nuno,9999,0,9999,0
1653430623086,ECE 200,051,091053,Wang; Xiaolong,9999,0,9999,0
1653430623086,ECE 200,052,091054,Xie; Pengtao,9999,0,9999,0
1653430623086,ECE 200,053,091055,Yip; Michael,9999,0,9999,0
1653430623086,ECE 200,054,091056,Zeger; Kenneth A.,9999,0,9999,0
1653430623086,ECE 200,055,091057,Zhang; Xinyu,9999,0,9999,0
1653430623086,ECE 200,056,091058,Turakhia; Yatish Girish,9999,0,9999,0
1653430623086,ECE 200,057,091059,Kang; Mingu,9999,0,9999,0
1653430623086,ECE 200,058,091060,Shi; Yuanyuan,9999,0,9999,0
1653430623086,ECE 200,059,091061,Wang; Edward Jay,9999,0,9999,0
1653430623086,ECE 200,060,091062,Zheng; Yang,9999,0,9999,0
1653430623612,ECE 203,A00,091065,Mercier; Patrick Philip,0,0,0,0
1653430624143,ECE 207A,A00,091605,Liu; Thomas Tao-Ming,0,0,0,0
1653430624665,ECE 212AN,A00,091068,Nomura; Kenji,0,0,0,0
1653430625186,ECE 222A,A00,091069,Rebeiz; Gabriel,0,0,0,0
1653430625710,ECE 225A,A00,091070,Orlitsky; Alon,0,0,0,0
1653430626240,ECE 230A,A00,091071,Nomura; Kenji,0,0,0,0
1653430626779,ECE 236A,A00,091072,Dayeh; Shadi Ahmad,0,0,0,0
1653430627306,ECE 238A,A00,091073,Luo; Jian,0,0,0,0
1653430627306,ECE 238A,B00,091074,Luo; Jian,0,0,0,0
1653430627837,ECE 240A,A00,091075,Radic; Stojan,0,0,0,0
1653430628372,ECE 247A,A00,091592,Shi; Lingyan,0,0,0,0
1653430628910,ECE 250,A00,091076,Touri; Behrouz,0,0,0,0
1653430629436,ECE 251C,A00,091078,Nguyen; Truong Quang,0,0,0,0
1653430629960,ECE 253,A00,091079,Cosman; Pamela C.,0,0,0,0
1653430630488,ECE 255A,A00,091080,Orlitsky; Alon,0,0,0,0
1653430631013,ECE 257A,A00,091081,Zhang; Xinyu,0,0,0,0
1653430631537,ECE 260A,A01,091084,Eldon; John,0,0,0,0
1653430632059,ECE 264C,A00,091085,Galton; Ian A,0,0,0,0
1653430632587,ECE 265C,A00,094889,Presti; Calogero Davide,0,0,0,9
1653430633122,ECE 266,A01,091087,Hall; Drew A.,0,0,0,0
1653430634172,ECE 271A,A00,091090,Vasconcelos; Nuno,0,0,0,0
1653430634695,ECE 272B,A00,091091,Sworder; David D.,0,0,0,0
1653430635226,ECE 275A,A00,091092,Meyer; Florian,0,0,0,0
1653430635756,ECE 277,A00,091093,An; Cheolhong,0,0,0,0
1653430636280,ECE 283,A00,091094,Le; Hanh-Phuc,0,0,0,0
1653430636803,ECE 284,A00,091095,Kang; Mingu,0,0,0,0
1653430636803,ECE 284,B00,091096,Wang; Edward Jay,0,0,0,0
1653430637334,ECE 285,A00,094334,Touri; Behrouz,0,0,0,0
1653430637861,ECE 289,A00,091097,Whelan; David Arthur,0,0,0,0
1653430638387,MATH 200A,A00,087414,Salehi Golsefidy; Alireza,7,0,8,1
1653430638922,MATH 202A,A00,087415,Gill; Philip E.,3,0,8,5
1653430639448,MATH 203A,A00,087416,Oprea; Dragos N.,6,0,8,2
1653430639970,MATH 204A,A00,087417,Kedlaya; Kiran S.,6,0,8,2
1653430640491,MATH 205,A00,087418,Sorensen; Claus M,6,0,8,2
1653430641018,MATH 206A,A00,087419,Izadi; Elham,7,0,8,1
1653430641548,MATH 207A,A00,087420,Mohammadi; Amir,6,0,8,2
1653430642083,MATH 208,A00,087421,Staff,9,0,10,1
1653430642605,MATH 209,A00,087422,Staff,10,0,10,0
1653430643129,MATH 218,A00,087423,Staff,10,0,10,0
1653430643661,MATH 220A,A00,087424,Novak; Jonathan I,7,0,8,1
1653430644184,MATH 231A,A00,087425,Bejenaru; Ioan,4,0,8,4
1653430644722,MATH 240A,A00,087426,Ebenfelt; Peter F,5,0,8,3
1653430645245,MATH 243,A00,087427,Staff,9,0,10,1
1653430645771,MATH 248,A00,087429,Staff,10,0,10,0
1653430646294,MATH 250A,A00,087430,Spolaor; Luca,5,0,8,3
1653430646820,MATH 257A,A00,087431,Spolaor; Luca,7,0,8,1
1653430647347,MATH 258,A00,087432,Staff,9,0,10,1
1653430647870,MATH 264A,A00,087433,Warnke; Lutz Peter,5,0,8,3
1653430648396,MATH 268,A00,087434,Staff,15,0,15,0
1653430648917,MATH 269,A00,087435,Staff,14,0,15,1
1653430649439,MATH 270A,A00,087436,Nie; Jiawang,0,0,8,8
1653430649967,MATH 272A,A00,087437,Tian; Xiaochuan,1,0,8,7
1653430650493,MATH 274,A01,087439,Cheng; Li-Tien,9,0,10,1
1653430650493,MATH 274,A02,087440,Cheng; Li-Tien,10,0,10,0
1653430651114,MATH 278A,A00,087441,Staff,8,0,10,2
1653430651645,MATH 278B,A00,087442,Staff,8,0,10,2
1653430652170,MATH 278C,A00,087443,Staff,8,0,10,2
1653430652698,MATH 280A,A00,087444,Zheng; Tianyi,0,0,8,8
1653430653219,MATH 281A,A00,087445,Bradic; Jelena,0,0,8,8
1653430653749,MATH 282A,A00,087446,Zhang; Danna,0,0,8,8
1653430654273,MATH 283,A00,087447,Tesler; Glenn,0,0,0,14
1653430654807,MATH 286,A00,087448,Kemp; Todd Aahron,6,0,8,2
1653430655343,MATH 287D,A00,087449,Bradic; Jelena,8,0,8,0
1653430655869,MATH 288,A00,087450,Staff,14,0,15,1
1653430655869,MATH 288,B00,087451,Staff,15,0,15,0
1653430655869,MATH 288,C00,087452,Staff,15,0,15,0
1653430656395,MATH 290A,A00,087453,Xu; Zhouli,7,0,8,1
1653430656918,MATH 291A,A00,087454,Xu; Zhouli,7,0,8,1
1653430657441,MATH 292,A00,087455,Staff,10,0,10,0
1653430657965,MATH 295,A00,087456,Staff,50,0,50,0
1653430658487,MATH 297,001,087457,Staff,998,0,999,1
1653431222544,COGS 200,A01,087991,Staff,47,0,50,3
1653431223067,COGS 201,A01,094504,Rangel; Lara M,17,0,25,8
1653431223598,COGS 203,A00,087992,Coulson; Seana M,18,0,20,2
1653431224122,COGS 210A,001,087993,Greene; Deanna Jacquelyn,9998,0,9999,1
1653431224122,COGS 210A,002,087994,Saygin; Ayse P,9999,0,9999,0
1653431224122,COGS 210A,003,087995,Xia; Haijun,9999,0,9999,0
1653431224122,COGS 210A,004,087996,Nitz; Douglas A.,9999,0,9999,0
1653431224122,COGS 210A,005,087997,Hollan; James D.,9999,0,9999,0
1653431224122,COGS 210A,006,087998,Deak; Gedeon O.,9998,0,9999,1
1653431224122,COGS 210A,007,087999,Rossano; Federico,9999,0,9999,0
1653431224647,COGS 211A,A00,088000,Coulson; Seana M,9997,0,9999,2
1653431225228,COGS 229,A00,088002,Staff,23,0,25,2
1653431225752,COGS 260,B00,094231,Staff,17,0,20,3
1653431225752,COGS 260,A00,088004,Nitz; Douglas A.,9998,0,9999,1
1653431226288,CSE 202,A00,090110,Paturi; Ramamohan,0,0,0,0
1653431226288,CSE 202,B00,090111,Paturi; Ramamohan,0,0,0,0
1653431226822,CSE 207B,A00,090112,Heninger; Nadia A,0,0,0,0
1653431227344,CSE 208,A00,094858,Micciancio; Daniele,0,0,0,0
1653431227866,CSE 210,A00,090113,Powell; Thomas Allan,0,0,0,0
1653431228388,CSE 219,A00,090898,Staff,0,0,0,0
1653431228913,CSE 221,A00,090114,Zhou; Yuan-Yuan,0,0,0,0
1653431229446,CSE 229A,A00,090115,Porter; George M,0,0,0,0
1653431229975,CSE 229C,A00,090116,Savage; Stefan,0,0,0,0
1653431230505,CSE 230,A00,090117,Jhala; Ranjit,0,0,0,0
1653431231027,CSE 232,A00,090118,Papakonstantinou; Yannis,0,0,0,0
1653431231550,CSE 239A,A00,090121,Kumar; Arun Kumar,0,0,0,0
1653431232073,CSE 239B,A00,090122,Jhala; Ranjit,0,0,0,0
1653431232605,CSE 240A,A00,090123,Zhao; Jishen,0,0,189,189
1653431233153,CSE 243A,A00,090124,Orailoglu; Alex,3,0,15,12
1653431233685,CSE 249B,A00,090125,Kahng; Andrew Byun,13,0,20,7
1653431234214,CSE 250A,A00,090126,Berg-Kirkpatrick; Taylor D,0,0,0,0
1653431234745,CSE 252A,A00,090127,Ochoa; Benjamin Lawrence,0,0,0,0
1653431235267,CSE 258,A01,090129,McAuley; Julian John,0,0,0,0
1653431235790,CSE 258R,A01,090131,McAuley; Julian John,0,0,0,0
1653431236313,CSE 274,A00,090132,Ramamoorthi; Ravi,0,0,0,0
1653431236850,CSE 276A,A00,090133,Christensen; Henrik I,0,0,0,0
1653431237378,CSE 276C,A00,090134,Christensen; Henrik I,0,0,0,0
1653431237902,CSE 290,A00,090135,Bafna; Vineet,0,0,0,0
1653431237902,CSE 290,B00,090136,Ramamoorthi; Ravi,0,0,0,0
1653431237902,CSE 290,C00,090137,Li; Tzumao,9,0,10,1
1653431237902,CSE 290,D00,090138,Zhou; Yuan-Yuan,10,0,10,0
1653431237902,CSE 290,E00,090139,Christensen; Henrik I,10,0,10,0
1653431237902,CSE 290,F00,094053,Shalev; Aaron D,0,0,0,0
1653431238434,CSE 291,A00,090140,Munyaka; Imani N. S.,0,0,0,0
1653431238434,CSE 291,B00,094880,Yu; Qi,0,0,0,0
1653431238434,CSE 291,C00,090142,Pannuto; Patrick William,0,0,0,0
1653431238434,CSE 291,D00,094881,Zhang; Yiying,0,0,0,0
1653431238434,CSE 291,E00,095118,Su; Hao,0,0,0,0
1653431238961,CSE 293,001,094905,Bafna; Vineet,9999,0,9999,0
1653431238961,CSE 293,002,094906,Bellare; Mihir,9999,0,9999,0
1653431238961,CSE 293,003,094907,Berg-Kirkpatrick; Taylor D,9999,0,9999,0
1653431238961,CSE 293,004,094908,Christensen; Henrik I,9999,0,9999,0
1653431238961,CSE 293,005,094909,Cottrell; Garrison W,9999,0,9999,0
1653431238961,CSE 293,006,094910,Deutsch; Alin Bernard,9999,0,9999,0
1653431238961,CSE 293,007,094911,Esmaeilzadeh; Hadi,9999,0,9999,0
1653431238961,CSE 293,008,094912,Freund; Yoav,9999,0,9999,0
1653431238961,CSE 293,009,094913,Griswold; William G.,9999,0,9999,0
1653431238961,CSE 293,010,094914,Gymrek; Melissa Ann,9999,0,9999,0
1653431238961,CSE 293,011,094915,Heninger; Nadia A,9999,0,9999,0
1653431238961,CSE 293,012,094916,Impagliazzo; Russell,9999,0,9999,0
1653431238961,CSE 293,013,094917,Jhala; Ranjit,9999,0,9999,0
1653431238961,CSE 293,014,094918,Kahng; Andrew Byun,9999,0,9999,0
1653431238961,CSE 293,015,094919,Kane; Daniel Mertz,9999,0,9999,0
1653431238961,CSE 293,016,094920,Kriegman; David J,9999,0,9999,0
1653431238961,CSE 293,017,094921,Kumar; Arun Kumar,9999,0,9999,0
1653431238961,CSE 293,018,094922,Lerner; Sorin,9999,0,9999,0
1653431238961,CSE 293,019,094923,Lovett; Shachar,9999,0,9999,0
1653431238961,CSE 293,020,094924,McAuley; Julian John,9999,0,9999,0
1653431238961,CSE 293,021,094925,Micciancio; Daniele,9999,0,9999,0
1653431238961,CSE 293,022,094926,Orailoglu; Alex,9999,0,9999,0
1653431238961,CSE 293,023,094927,Paturi; Ramamohan,9999,0,9999,0
1653431238961,CSE 293,024,094928,Polikarpova; Nadezhda,9999,0,9999,0
1653431238961,CSE 293,025,094929,Politz; Joseph Gibbs,9999,0,9999,0
1653431238961,CSE 293,026,094930,Porter; George M,9999,0,9999,0
1653431238961,CSE 293,027,094931,Porter; Leonard Emerson,9999,0,9999,0
1653431238961,CSE 293,028,094932,Ramamoorthi; Ravi,9999,0,9999,0
1653431238961,CSE 293,029,094933,Sahoo; Debashis,9999,0,9999,0
1653431238961,CSE 293,030,094934,Saul; Lawrence,9999,0,9999,0
1653431238961,CSE 293,031,094935,Savage; Stefan,9999,0,9999,0
1653431238961,CSE 293,032,094936,Schulze; Jurgen P.,9999,0,9999,0
1653431238961,CSE 293,033,094937,Snoeren; Alex C.,9999,0,9999,0
1653431238961,CSE 293,034,094938,Shang; Jingbo,9999,0,9999,0
1653431238961,CSE 293,035,094939,Stefan; Deian,9999,0,9999,0
1653431238961,CSE 293,036,094940,Su; Hao,9999,0,9999,0
1653431238961,CSE 293,037,094941,Swanson; Steven James,9999,0,9999,0
1653431238961,CSE 293,038,094942,Tullsen; Dean Michael,9999,0,9999,0
1653431238961,CSE 293,039,094943,Voelker; Geoffrey M.,9999,0,9999,0
1653431238961,CSE 293,040,094944,Zhao; Jishen,9999,0,9999,0
1653431238961,CSE 293,041,094945,Zhou; Yuan-Yuan,9999,0,9999,0
1653431238961,CSE 293,042,094946,Gao; Sicun,9998,0,9999,1
1653431238961,CSE 293,043,094947,Weibel; Nadir,9999,0,9999,0
1653431238961,CSE 293,044,094948,Gupta; Rajesh K.,9999,0,9999,0
1653431239485,CSE 294,A00,090143,Porter; George M,9,0,10,1
1653431240007,DSE 200,A00,091799,Staff,50,0,50,0
1653431240533,DSE 203,A00,091800,Gupta; Amarnath,30,0,30,0
1653431241057,DSE 250,A00,091801,Deutsch; Alin Bernard,30,0,30,0
1653431241581,DSE 290,A00,091802,Altintas De Callaf; Ilkay,50,0,50,0
1653431242123,ECE 200,001,091003,Antipa; Nicholas A,9999,0,9999,0
1653431242123,ECE 200,002,091004,Atanasov; Nikolay A.,9999,0,9999,0
1653431242123,ECE 200,003,091005,Bharadia; Dinesh,9999,0,9999,0
1653431242123,ECE 200,004,091006,Cheng; Chung Kuan,9999,0,9999,0
1653431242123,ECE 200,005,091007,Cosman; Pamela C.,9999,0,9999,0
1653431242123,ECE 200,006,091008,Staff,9999,0,9999,0
1653431242123,ECE 200,007,091009,Dayeh; Shadi Ahmad,9999,0,9999,0
1653431242123,ECE 200,008,091010,Fainman; Yeshaiahu,9999,0,9999,0
1653431242123,ECE 200,009,091011,Ford; Joseph Earl,9999,0,9999,0
1653431242123,ECE 200,010,091012,Franceschetti; Massimo,9999,0,9999,0
1653431242123,ECE 200,011,091013,Fullerton; Eric E,9999,0,9999,0
1653431242123,ECE 200,012,091014,Galton; Ian A,9999,0,9999,0
1653431242123,ECE 200,013,091015,Gilja; Vikash,9999,0,9999,0
1653431242123,ECE 200,014,091016,Hall; Drew A.,9999,0,9999,0
1653431242123,ECE 200,015,091017,Hsueh; Tzu-Chien,9999,0,9999,0
1653431242123,ECE 200,016,091018,Javidi; Tara,9999,0,9999,0
1653431242123,ECE 200,017,091019,Kahng; Andrew Byun,9999,0,9999,0
1653431242123,ECE 200,018,091020,Kim; Young-Han,9999,0,9999,0
1653431242123,ECE 200,019,091021,Koushanfar; Farinaz,9999,0,9999,0
1653431242123,ECE 200,020,091022,Kuzum; Duygu,9999,0,9999,0
1653431242123,ECE 200,021,091023,Le; Hanh-Phuc,9999,0,9999,0
1653431242123,ECE 200,022,091024,Lin; Bill,9999,0,9999,0
1653431242123,ECE 200,023,091025,Liu; Zhaowei,9999,0,9999,0
1653431242123,ECE 200,024,091026,Lo; Yu-Hwa,9999,0,9999,0
1653431242123,ECE 200,025,091027,Lomakin; Vitaliy,9999,0,9999,0
1653431242123,ECE 200,026,091028,Mercier; Patrick Philip,9999,0,9999,0
1653431242123,ECE 200,027,091029,Meyer; Florian,9999,0,9999,0
1653431242123,ECE 200,028,091030,Milstein; Laurence B.,9999,0,9999,0
1653431242123,ECE 200,029,091031,Mir Arabbaygi; Siavash,9999,0,9999,0
1653431242123,ECE 200,030,091032,Mookherjea; Shayan,9999,0,9999,0
1653431242123,ECE 200,031,091033,Morris; Karcher William,9999,0,9999,0
1653431242123,ECE 200,032,091034,Ng; Tse Nga,9999,0,9999,0
1653431242123,ECE 200,033,091035,Nguyen; Truong Quang,9999,0,9999,0
1653431242123,ECE 200,034,091036,Nomura; Kenji,9999,0,9999,0
1653431242123,ECE 200,035,091037,Orlitsky; Alon,9999,0,9999,0
1653431242123,ECE 200,036,091038,Pal; Piya,9999,0,9999,0
1653431242123,ECE 200,037,091039,Papen; George C.,9999,0,9999,0
1653431242123,ECE 200,038,091040,Radic; Stojan,9999,0,9999,0
1653431242123,ECE 200,039,091041,Rao; Bhaskar D.,9999,0,9999,0
1653431242123,ECE 200,040,091042,Rao; Ramesh R,9999,0,9999,0
1653431242123,ECE 200,041,091043,Rebeiz; Gabriel,9999,0,9999,0
1653431242123,ECE 200,042,091044,Sanford; John R,9999,0,9999,0
1653431242123,ECE 200,043,091045,Siegel; Paul H.,9999,0,9999,0
1653431242123,ECE 200,044,091046,Sievenpiper; Daniel F.,9999,0,9999,0
1653431242123,ECE 200,045,091047,Sworder; David D.,9999,0,9999,0
1653431242123,ECE 200,046,091048,Taur; Yuan,9999,0,9999,0
1653431242123,ECE 200,047,091049,Touri; Behrouz,9999,0,9999,0
1653431242123,ECE 200,048,091050,Trivedi; Mohan M.,9999,0,9999,0
1653431242123,ECE 200,049,091051,Vardy; Alexander,9999,0,9999,0
1653431242123,ECE 200,050,091052,Vasconcelos; Nuno,9999,0,9999,0
1653431242123,ECE 200,051,091053,Wang; Xiaolong,9999,0,9999,0
1653431242123,ECE 200,052,091054,Xie; Pengtao,9999,0,9999,0
1653431242123,ECE 200,053,091055,Yip; Michael,9999,0,9999,0
1653431242123,ECE 200,054,091056,Zeger; Kenneth A.,9999,0,9999,0
1653431242123,ECE 200,055,091057,Zhang; Xinyu,9999,0,9999,0
1653431242123,ECE 200,056,091058,Turakhia; Yatish Girish,9999,0,9999,0
1653431242123,ECE 200,057,091059,Kang; Mingu,9999,0,9999,0
1653431242123,ECE 200,058,091060,Shi; Yuanyuan,9999,0,9999,0
1653431242123,ECE 200,059,091061,Wang; Edward Jay,9999,0,9999,0
1653431242123,ECE 200,060,091062,Zheng; Yang,9999,0,9999,0
1653431242770,ECE 203,A00,091065,Mercier; Patrick Philip,0,0,0,0
1653431243297,ECE 207A,A00,091605,Liu; Thomas Tao-Ming,0,0,0,0
1653431243820,ECE 212AN,A00,091068,Nomura; Kenji,0,0,0,0
1653431244344,ECE 222A,A00,091069,Rebeiz; Gabriel,0,0,0,0
1653431244876,ECE 225A,A00,091070,Orlitsky; Alon,0,0,0,0
1653431245398,ECE 230A,A00,091071,Nomura; Kenji,0,0,0,0
1653431245924,ECE 236A,A00,091072,Dayeh; Shadi Ahmad,0,0,0,0
1653431246446,ECE 238A,A00,091073,Luo; Jian,0,0,0,0
1653431246446,ECE 238A,B00,091074,Luo; Jian,0,0,0,0
1653431246969,ECE 240A,A00,091075,Radic; Stojan,0,0,0,0
1653431247495,ECE 247A,A00,091592,Shi; Lingyan,0,0,0,0
1653431248024,ECE 250,A00,091076,Touri; Behrouz,0,0,0,0
1653431248546,ECE 251C,A00,091078,Nguyen; Truong Quang,0,0,0,0
1653431249075,ECE 253,A00,091079,Cosman; Pamela C.,0,0,0,0
1653431249606,ECE 255A,A00,091080,Orlitsky; Alon,0,0,0,0
1653431250135,ECE 257A,A00,091081,Zhang; Xinyu,0,0,0,0
1653431250662,ECE 260A,A01,091084,Eldon; John,0,0,0,0
1653431251187,ECE 264C,A00,091085,Galton; Ian A,0,0,0,0
1653431251724,ECE 265C,A00,094889,Presti; Calogero Davide,0,0,0,9
1653431252263,ECE 266,A01,091087,Hall; Drew A.,0,0,0,0
1653431253308,ECE 271A,A00,091090,Vasconcelos; Nuno,0,0,0,0
1653431253832,ECE 272B,A00,091091,Sworder; David D.,0,0,0,0
1653431254369,ECE 275A,A00,091092,Meyer; Florian,0,0,0,0
1653431254893,ECE 277,A00,091093,An; Cheolhong,0,0,0,0
1653431255419,ECE 283,A00,091094,Le; Hanh-Phuc,0,0,0,0
1653431255941,ECE 284,A00,091095,Kang; Mingu,0,0,0,0
1653431255941,ECE 284,B00,091096,Wang; Edward Jay,0,0,0,0
1653431256463,ECE 285,A00,094334,Touri; Behrouz,0,0,0,0
1653431256993,ECE 289,A00,091097,Whelan; David Arthur,0,0,0,0
1653431257516,MATH 200A,A00,087414,Salehi Golsefidy; Alireza,7,0,8,1
1653431258045,MATH 202A,A00,087415,Gill; Philip E.,3,0,8,5
1653431258574,MATH 203A,A00,087416,Oprea; Dragos N.,6,0,8,2
1653431259098,MATH 204A,A00,087417,Kedlaya; Kiran S.,6,0,8,2
1653431259623,MATH 205,A00,087418,Sorensen; Claus M,6,0,8,2
1653431260147,MATH 206A,A00,087419,Izadi; Elham,7,0,8,1
1653431260669,MATH 207A,A00,087420,Mohammadi; Amir,6,0,8,2
1653431261194,MATH 208,A00,087421,Staff,9,0,10,1
1653431261718,MATH 209,A00,087422,Staff,10,0,10,0
1653431262252,MATH 218,A00,087423,Staff,10,0,10,0
1653431262784,MATH 220A,A00,087424,Novak; Jonathan I,7,0,8,1
1653431263306,MATH 231A,A00,087425,Bejenaru; Ioan,4,0,8,4
1653431263830,MATH 240A,A00,087426,Ebenfelt; Peter F,5,0,8,3
1653431264354,MATH 243,A00,087427,Staff,9,0,10,1
1653431264897,MATH 248,A00,087429,Staff,10,0,10,0
1653431265431,MATH 250A,A00,087430,Spolaor; Luca,5,0,8,3
1653431265956,MATH 257A,A00,087431,Spolaor; Luca,7,0,8,1
1653431266480,MATH 258,A00,087432,Staff,9,0,10,1
1653431267006,MATH 264A,A00,087433,Warnke; Lutz Peter,5,0,8,3
1653431267529,MATH 268,A00,087434,Staff,15,0,15,0
1653431268056,MATH 269,A00,087435,Staff,14,0,15,1
1653431268586,MATH 270A,A00,087436,Nie; Jiawang,0,0,8,8
1653431269114,MATH 272A,A00,087437,Tian; Xiaochuan,1,0,8,7
1653431269646,MATH 274,A01,087439,Cheng; Li-Tien,9,0,10,1
1653431269646,MATH 274,A02,087440,Cheng; Li-Tien,10,0,10,0
1653431270168,MATH 278A,A00,087441,Staff,8,0,10,2
1653431270696,MATH 278B,A00,087442,Staff,8,0,10,2
1653431271230,MATH 278C,A00,087443,Staff,8,0,10,2
1653431271756,MATH 280A,A00,087444,Zheng; Tianyi,0,0,8,8
1653431272279,MATH 281A,A00,087445,Bradic; Jelena,0,0,8,8
1653431272809,MATH 282A,A00,087446,Zhang; Danna,0,0,8,8
1653431273331,MATH 283,A00,087447,Tesler; Glenn,0,0,0,14
1653431273854,MATH 286,A00,087448,Kemp; Todd Aahron,6,0,8,2
1653431274381,MATH 287D,A00,087449,Bradic; Jelena,8,0,8,0
1653431274903,MATH 288,A00,087450,Staff,14,0,15,1
1653431274903,MATH 288,B00,087451,Staff,15,0,15,0
1653431274903,MATH 288,C00,087452,Staff,15,0,15,0
1653431275437,MATH 290A,A00,087453,Xu; Zhouli,7,0,8,1
1653431275968,MATH 291A,A00,087454,Xu; Zhouli,7,0,8,1
1653431276492,MATH 292,A00,087455,Staff,10,0,10,0
1653431277022,MATH 295,A00,087456,Staff,50,0,50,0
1653431277545,MATH 297,001,087457,Staff,998,0,999,1
1653431842202,COGS 200,A01,087991,Staff,47,0,50,3
1653431842729,COGS 201,A01,094504,Rangel; Lara M,17,0,25,8
1653431843250,COGS 203,A00,087992,Coulson; Seana M,18,0,20,2
1653431843777,COGS 210A,001,087993,Greene; Deanna Jacquelyn,9998,0,9999,1
1653431843777,COGS 210A,002,087994,Saygin; Ayse P,9999,0,9999,0
1653431843777,COGS 210A,003,087995,Xia; Haijun,9999,0,9999,0
1653431843777,COGS 210A,004,087996,Nitz; Douglas A.,9999,0,9999,0
1653431843777,COGS 210A,005,087997,Hollan; James D.,9999,0,9999,0
1653431843777,COGS 210A,006,087998,Deak; Gedeon O.,9998,0,9999,1
1653431843777,COGS 210A,007,087999,Rossano; Federico,9999,0,9999,0
1653431844303,COGS 211A,A00,088000,Coulson; Seana M,9997,0,9999,2
1653431844829,COGS 229,A00,088002,Staff,23,0,25,2
1653431845356,COGS 260,B00,094231,Staff,17,0,20,3
1653431845356,COGS 260,A00,088004,Nitz; Douglas A.,9998,0,9999,1
1653431845885,CSE 202,A00,090110,Paturi; Ramamohan,0,0,0,0
1653431845885,CSE 202,B00,090111,Paturi; Ramamohan,0,0,0,0
1653431846425,CSE 207B,A00,090112,Heninger; Nadia A,0,0,0,0
1653431846947,CSE 208,A00,094858,Micciancio; Daniele,0,0,0,0
1653431847471,CSE 210,A00,090113,Powell; Thomas Allan,0,0,0,0
1653431847996,CSE 219,A00,090898,Staff,0,0,0,0
1653431848523,CSE 221,A00,090114,Zhou; Yuan-Yuan,0,0,0,0
1653431849045,CSE 229A,A00,090115,Porter; George M,0,0,0,0
1653431849577,CSE 229C,A00,090116,Savage; Stefan,0,0,0,0
1653431850099,CSE 230,A00,090117,Jhala; Ranjit,0,0,0,0
1653431850623,CSE 232,A00,090118,Papakonstantinou; Yannis,0,0,0,0
1653431851153,CSE 239A,A00,090121,Kumar; Arun Kumar,0,0,0,0
1653431851682,CSE 239B,A00,090122,Jhala; Ranjit,0,0,0,0
1653431852214,CSE 240A,A00,090123,Zhao; Jishen,0,0,189,189
1653431852758,CSE 243A,A00,090124,Orailoglu; Alex,3,0,15,12
1653431853282,CSE 249B,A00,090125,Kahng; Andrew Byun,13,0,20,7
1653431853806,CSE 250A,A00,090126,Berg-Kirkpatrick; Taylor D,0,0,0,0
1653431854330,CSE 252A,A00,090127,Ochoa; Benjamin Lawrence,0,0,0,0
1653431854868,CSE 258,A01,090129,McAuley; Julian John,0,0,0,0
1653431855389,CSE 258R,A01,090131,McAuley; Julian John,0,0,0,0
1653431855923,CSE 274,A00,090132,Ramamoorthi; Ravi,0,0,0,0
1653431856449,CSE 276A,A00,090133,Christensen; Henrik I,0,0,0,0
1653431856974,CSE 276C,A00,090134,Christensen; Henrik I,0,0,0,0
1653431857498,CSE 290,A00,090135,Bafna; Vineet,0,0,0,0
1653431857498,CSE 290,B00,090136,Ramamoorthi; Ravi,0,0,0,0
1653431857498,CSE 290,C00,090137,Li; Tzumao,9,0,10,1
1653431857498,CSE 290,D00,090138,Zhou; Yuan-Yuan,10,0,10,0
1653431857498,CSE 290,E00,090139,Christensen; Henrik I,10,0,10,0
1653431857498,CSE 290,F00,094053,Shalev; Aaron D,0,0,0,0
1653431858023,CSE 291,A00,090140,Munyaka; Imani N. S.,0,0,0,0
1653431858023,CSE 291,B00,094880,Yu; Qi,0,0,0,0
1653431858023,CSE 291,C00,090142,Pannuto; Patrick William,0,0,0,0
1653431858023,CSE 291,D00,094881,Zhang; Yiying,0,0,0,0
1653431858023,CSE 291,E00,095118,Su; Hao,0,0,0,0
1653431858555,CSE 293,001,094905,Bafna; Vineet,9999,0,9999,0
1653431858555,CSE 293,002,094906,Bellare; Mihir,9999,0,9999,0
1653431858555,CSE 293,003,094907,Berg-Kirkpatrick; Taylor D,9999,0,9999,0
1653431858555,CSE 293,004,094908,Christensen; Henrik I,9999,0,9999,0
1653431858555,CSE 293,005,094909,Cottrell; Garrison W,9999,0,9999,0
1653431858555,CSE 293,006,094910,Deutsch; Alin Bernard,9999,0,9999,0
1653431858555,CSE 293,007,094911,Esmaeilzadeh; Hadi,9999,0,9999,0
1653431858555,CSE 293,008,094912,Freund; Yoav,9999,0,9999,0
1653431858555,CSE 293,009,094913,Griswold; William G.,9999,0,9999,0
1653431858555,CSE 293,010,094914,Gymrek; Melissa Ann,9999,0,9999,0
1653431858555,CSE 293,011,094915,Heninger; Nadia A,9999,0,9999,0
1653431858555,CSE 293,012,094916,Impagliazzo; Russell,9999,0,9999,0
1653431858555,CSE 293,013,094917,Jhala; Ranjit,9999,0,9999,0
1653431858555,CSE 293,014,094918,Kahng; Andrew Byun,9999,0,9999,0
1653431858555,CSE 293,015,094919,Kane; Daniel Mertz,9999,0,9999,0
1653431858555,CSE 293,016,094920,Kriegman; David J,9999,0,9999,0
1653431858555,CSE 293,017,094921,Kumar; Arun Kumar,9999,0,9999,0
1653431858555,CSE 293,018,094922,Lerner; Sorin,9999,0,9999,0
1653431858555,CSE 293,019,094923,Lovett; Shachar,9999,0,9999,0
1653431858555,CSE 293,020,094924,McAuley; Julian John,9999,0,9999,0
1653431858555,CSE 293,021,094925,Micciancio; Daniele,9999,0,9999,0
1653431858555,CSE 293,022,094926,Orailoglu; Alex,9999,0,9999,0
1653431858555,CSE 293,023,094927,Paturi; Ramamohan,9999,0,9999,0
1653431858555,CSE 293,024,094928,Polikarpova; Nadezhda,9999,0,9999,0
1653431858555,CSE 293,025,094929,Politz; Joseph Gibbs,9999,0,9999,0
1653431858555,CSE 293,026,094930,Porter; George M,9999,0,9999,0
1653431858555,CSE 293,027,094931,Porter; Leonard Emerson,9999,0,9999,0
1653431858555,CSE 293,028,094932,Ramamoorthi; Ravi,9999,0,9999,0
1653431858555,CSE 293,029,094933,Sahoo; Debashis,9999,0,9999,0
1653431858555,CSE 293,030,094934,Saul; Lawrence,9999,0,9999,0
1653431858555,CSE 293,031,094935,Savage; Stefan,9999,0,9999,0
1653431858555,CSE 293,032,094936,Schulze; Jurgen P.,9999,0,9999,0
1653431858555,CSE 293,033,094937,Snoeren; Alex C.,9999,0,9999,0
1653431858555,CSE 293,034,094938,Shang; Jingbo,9999,0,9999,0
1653431858555,CSE 293,035,094939,Stefan; Deian,9999,0,9999,0
1653431858555,CSE 293,036,094940,Su; Hao,9999,0,9999,0
1653431858555,CSE 293,037,094941,Swanson; Steven James,9999,0,9999,0
1653431858555,CSE 293,038,094942,Tullsen; Dean Michael,9999,0,9999,0
1653431858555,CSE 293,039,094943,Voelker; Geoffrey M.,9999,0,9999,0
1653431858555,CSE 293,040,094944,Zhao; Jishen,9999,0,9999,0
1653431858555,CSE 293,041,094945,Zhou; Yuan-Yuan,9999,0,9999,0
1653431858555,CSE 293,042,094946,Gao; Sicun,9998,0,9999,1
1653431858555,CSE 293,043,094947,Weibel; Nadir,9999,0,9999,0
1653431858555,CSE 293,044,094948,Gupta; Rajesh K.,9999,0,9999,0
1653431859079,CSE 294,A00,090143,Porter; George M,9,0,10,1
1653431859602,DSE 200,A00,091799,Staff,50,0,50,0
1653431860127,DSE 203,A00,091800,Gupta; Amarnath,30,0,30,0
1653431860652,DSE 250,A00,091801,Deutsch; Alin Bernard,30,0,30,0
1653431861179,DSE 290,A00,091802,Altintas De Callaf; Ilkay,50,0,50,0
1653431861731,ECE 200,001,091003,Antipa; Nicholas A,9999,0,9999,0
1653431861731,ECE 200,002,091004,Atanasov; Nikolay A.,9999,0,9999,0
1653431861731,ECE 200,003,091005,Bharadia; Dinesh,9999,0,9999,0
1653431861731,ECE 200,004,091006,Cheng; Chung Kuan,9999,0,9999,0
1653431861731,ECE 200,005,091007,Cosman; Pamela C.,9999,0,9999,0
1653431861731,ECE 200,006,091008,Staff,9999,0,9999,0
1653431861731,ECE 200,007,091009,Dayeh; Shadi Ahmad,9999,0,9999,0
1653431861731,ECE 200,008,091010,Fainman; Yeshaiahu,9999,0,9999,0
1653431861731,ECE 200,009,091011,Ford; Joseph Earl,9999,0,9999,0
1653431861731,ECE 200,010,091012,Franceschetti; Massimo,9999,0,9999,0
1653431861731,ECE 200,011,091013,Fullerton; Eric E,9999,0,9999,0
1653431861731,ECE 200,012,091014,Galton; Ian A,9999,0,9999,0
1653431861731,ECE 200,013,091015,Gilja; Vikash,9999,0,9999,0
1653431861731,ECE 200,014,091016,Hall; Drew A.,9999,0,9999,0
1653431861731,ECE 200,015,091017,Hsueh; Tzu-Chien,9999,0,9999,0
1653431861731,ECE 200,016,091018,Javidi; Tara,9999,0,9999,0
1653431861731,ECE 200,017,091019,Kahng; Andrew Byun,9999,0,9999,0
1653431861731,ECE 200,018,091020,Kim; Young-Han,9999,0,9999,0
1653431861731,ECE 200,019,091021,Koushanfar; Farinaz,9999,0,9999,0
1653431861731,ECE 200,020,091022,Kuzum; Duygu,9999,0,9999,0
1653431861731,ECE 200,021,091023,Le; Hanh-Phuc,9999,0,9999,0
1653431861731,ECE 200,022,091024,Lin; Bill,9999,0,9999,0
1653431861731,ECE 200,023,091025,Liu; Zhaowei,9999,0,9999,0
1653431861731,ECE 200,024,091026,Lo; Yu-Hwa,9999,0,9999,0
1653431861731,ECE 200,025,091027,Lomakin; Vitaliy,9999,0,9999,0
1653431861731,ECE 200,026,091028,Mercier; Patrick Philip,9999,0,9999,0
1653431861731,ECE 200,027,091029,Meyer; Florian,9999,0,9999,0
1653431861731,ECE 200,028,091030,Milstein; Laurence B.,9999,0,9999,0
1653431861731,ECE 200,029,091031,Mir Arabbaygi; Siavash,9999,0,9999,0
1653431861731,ECE 200,030,091032,Mookherjea; Shayan,9999,0,9999,0
1653431861731,ECE 200,031,091033,Morris; Karcher William,9999,0,9999,0
1653431861731,ECE 200,032,091034,Ng; Tse Nga,9999,0,9999,0
1653431861731,ECE 200,033,091035,Nguyen; Truong Quang,9999,0,9999,0
1653431861731,ECE 200,034,091036,Nomura; Kenji,9999,0,9999,0
1653431861731,ECE 200,035,091037,Orlitsky; Alon,9999,0,9999,0
1653431861731,ECE 200,036,091038,Pal; Piya,9999,0,9999,0
1653431861731,ECE 200,037,091039,Papen; George C.,9999,0,9999,0
1653431861731,ECE 200,038,091040,Radic; Stojan,9999,0,9999,0
1653431861731,ECE 200,039,091041,Rao; Bhaskar D.,9999,0,9999,0
1653431861731,ECE 200,040,091042,Rao; Ramesh R,9999,0,9999,0
1653431861731,ECE 200,041,091043,Rebeiz; Gabriel,9999,0,9999,0
1653431861731,ECE 200,042,091044,Sanford; John R,9999,0,9999,0
1653431861731,ECE 200,043,091045,Siegel; Paul H.,9999,0,9999,0
1653431861731,ECE 200,044,091046,Sievenpiper; Daniel F.,9999,0,9999,0
1653431861731,ECE 200,045,091047,Sworder; David D.,9999,0,9999,0
1653431861731,ECE 200,046,091048,Taur; Yuan,9999,0,9999,0
1653431861731,ECE 200,047,091049,Touri; Behrouz,9999,0,9999,0
1653431861731,ECE 200,048,091050,Trivedi; Mohan M.,9999,0,9999,0
1653431861731,ECE 200,049,091051,Vardy; Alexander,9999,0,9999,0
1653431861731,ECE 200,050,091052,Vasconcelos; Nuno,9999,0,9999,0
1653431861731,ECE 200,051,091053,Wang; Xiaolong,9999,0,9999,0
1653431861731,ECE 200,052,091054,Xie; Pengtao,9999,0,9999,0
1653431861731,ECE 200,053,091055,Yip; Michael,9999,0,9999,0
1653431861731,ECE 200,054,091056,Zeger; Kenneth A.,9999,0,9999,0
1653431861731,ECE 200,055,091057,Zhang; Xinyu,9999,0,9999,0
1653431861731,ECE 200,056,091058,Turakhia; Yatish Girish,9999,0,9999,0
1653431861731,ECE 200,057,091059,Kang; Mingu,9999,0,9999,0
1653431861731,ECE 200,058,091060,Shi; Yuanyuan,9999,0,9999,0
1653431861731,ECE 200,059,091061,Wang; Edward Jay,9999,0,9999,0
1653431861731,ECE 200,060,091062,Zheng; Yang,9999,0,9999,0
1653431862254,ECE 203,A00,091065,Mercier; Patrick Philip,0,0,0,0
1653431862782,ECE 207A,A00,091605,Liu; Thomas Tao-Ming,0,0,0,0
1653431863311,ECE 212AN,A00,091068,Nomura; Kenji,0,0,0,0
1653431863838,ECE 222A,A00,091069,Rebeiz; Gabriel,0,0,0,0
1653431864369,ECE 225A,A00,091070,Orlitsky; Alon,0,0,0,0
1653431864893,ECE 230A,A00,091071,Nomura; Kenji,0,0,0,0
1653431865420,ECE 236A,A00,091072,Dayeh; Shadi Ahmad,0,0,0,0
1653431865943,ECE 238A,A00,091073,Luo; Jian,0,0,0,0
1653431865943,ECE 238A,B00,091074,Luo; Jian,0,0,0,0
1653431866468,ECE 240A,A00,091075,Radic; Stojan,0,0,0,0
1653431866991,ECE 247A,A00,091592,Shi; Lingyan,0,0,0,0
1653431867520,ECE 250,A00,091076,Touri; Behrouz,0,0,0,0
1653431868044,ECE 251C,A00,091078,Nguyen; Truong Quang,0,0,0,0
1653431868567,ECE 253,A00,091079,Cosman; Pamela C.,0,0,0,0
1653431869103,ECE 255A,A00,091080,Orlitsky; Alon,0,0,0,0
1653431869633,ECE 257A,A00,091081,Zhang; Xinyu,0,0,0,0
1653431870156,ECE 260A,A01,091084,Eldon; John,0,0,0,0
1653431870691,ECE 264C,A00,091085,Galton; Ian A,0,0,0,0
1653431871219,ECE 265C,A00,094889,Presti; Calogero Davide,0,0,0,9
1653431871747,ECE 266,A01,091087,Hall; Drew A.,0,0,0,0
1653431872809,ECE 271A,A00,091090,Vasconcelos; Nuno,0,0,0,0
1653431873339,ECE 272B,A00,091091,Sworder; David D.,0,0,0,0
1653431873864,ECE 275A,A00,091092,Meyer; Florian,0,0,0,0
1653431874397,ECE 277,A00,091093,An; Cheolhong,0,0,0,0
1653431874929,ECE 283,A00,091094,Le; Hanh-Phuc,0,0,0,0
1653431875461,ECE 284,A00,091095,Kang; Mingu,0,0,0,0
1653431875461,ECE 284,B00,091096,Wang; Edward Jay,0,0,0,0
1653431875990,ECE 285,A00,094334,Touri; Behrouz,0,0,0,0
1653431876517,ECE 289,A00,091097,Whelan; David Arthur,0,0,0,0
1653431877050,MATH 200A,A00,087414,Salehi Golsefidy; Alireza,7,0,8,1
1653431877580,MATH 202A,A00,087415,Gill; Philip E.,3,0,8,5
1653431878103,MATH 203A,A00,087416,Oprea; Dragos N.,6,0,8,2
1653431878640,MATH 204A,A00,087417,Kedlaya; Kiran S.,6,0,8,2
1653431879169,MATH 205,A00,087418,Sorensen; Claus M,6,0,8,2
1653431879693,MATH 206A,A00,087419,Izadi; Elham,7,0,8,1
1653431880225,MATH 207A,A00,087420,Mohammadi; Amir,6,0,8,2
1653431880752,MATH 208,A00,087421,Staff,9,0,10,1
1653431881288,MATH 209,A00,087422,Staff,10,0,10,0
1653431881820,MATH 218,A00,087423,Staff,10,0,10,0
1653431882345,MATH 220A,A00,087424,Novak; Jonathan I,7,0,8,1
1653431882873,MATH 231A,A00,087425,Bejenaru; Ioan,4,0,8,4
1653431883403,MATH 240A,A00,087426,Ebenfelt; Peter F,5,0,8,3
1653431883929,MATH 243,A00,087427,Staff,9,0,10,1
1653431884450,MATH 248,A00,087429,Staff,10,0,10,0
1653431884977,MATH 250A,A00,087430,Spolaor; Luca,5,0,8,3
1653431885509,MATH 257A,A00,087431,Spolaor; Luca,7,0,8,1
1653431886045,MATH 258,A00,087432,Staff,9,0,10,1
1653431886566,MATH 264A,A00,087433,Warnke; Lutz Peter,5,0,8,3
1653431887090,MATH 268,A00,087434,Staff,15,0,15,0
1653431887620,MATH 269,A00,087435,Staff,14,0,15,1
1653431888237,MATH 270A,A00,087436,Nie; Jiawang,0,0,8,8
1653431888763,MATH 272A,A00,087437,Tian; Xiaochuan,1,0,8,7
1653431889290,MATH 274,A01,087439,Cheng; Li-Tien,9,0,10,1
1653431889290,MATH 274,A02,087440,Cheng; Li-Tien,10,0,10,0
1653431889813,MATH 278A,A00,087441,Staff,8,0,10,2
1653431890344,MATH 278B,A00,087442,Staff,8,0,10,2
1653431890868,MATH 278C,A00,087443,Staff,8,0,10,2
1653431891390,MATH 280A,A00,087444,Zheng; Tianyi,0,0,8,8
1653431891924,MATH 281A,A00,087445,Bradic; Jelena,0,0,8,8
1653431892446,MATH 282A,A00,087446,Zhang; Danna,0,0,8,8
1653431892969,MATH 283,A00,087447,Tesler; Glenn,0,0,0,14
1653431893492,MATH 286,A00,087448,Kemp; Todd Aahron,6,0,8,2
1653431894030,MATH 287D,A00,087449,Bradic; Jelena,8,0,8,0
1653431894554,MATH 288,A00,087450,Staff,14,0,15,1
1653431894554,MATH 288,B00,087451,Staff,15,0,15,0
1653431894554,MATH 288,C00,087452,Staff,15,0,15,0
1653431895078,MATH 290A,A00,087453,Xu; Zhouli,7,0,8,1
1653431895603,MATH 291A,A00,087454,Xu; Zhouli,7,0,8,1
1653431896136,MATH 292,A00,087455,Staff,10,0,10,0
1653431896662,MATH 295,A00,087456,Staff,50,0,50,0
1653431897187,MATH 297,001,087457,Staff,998,0,999,1
1653432461468,COGS 200,A01,087991,Staff,47,0,50,3
1653432461992,COGS 201,A01,094504,Rangel; Lara M,17,0,25,8
1653432462520,COGS 203,A00,087992,Coulson; Seana M,18,0,20,2
1653432463052,COGS 210A,001,087993,Greene; Deanna Jacquelyn,9998,0,9999,1
1653432463052,COGS 210A,002,087994,Saygin; Ayse P,9999,0,9999,0
1653432463052,COGS 210A,003,087995,Xia; Haijun,9999,0,9999,0
1653432463052,COGS 210A,004,087996,Nitz; Douglas A.,9999,0,9999,0
1653432463052,COGS 210A,005,087997,Hollan; James D.,9999,0,9999,0
1653432463052,COGS 210A,006,087998,Deak; Gedeon O.,9998,0,9999,1
1653432463052,COGS 210A,007,087999,Rossano; Federico,9999,0,9999,0
1653432463575,COGS 211A,A00,088000,Coulson; Seana M,9997,0,9999,2
1653432464099,COGS 229,A00,088002,Staff,23,0,25,2
1653432464626,COGS 260,B00,094231,Staff,17,0,20,3
1653432464626,COGS 260,A00,088004,Nitz; Douglas A.,9998,0,9999,1
1653432465154,CSE 202,A00,090110,Paturi; Ramamohan,0,0,0,0
1653432465154,CSE 202,B00,090111,Paturi; Ramamohan,0,0,0,0
1653432465679,CSE 207B,A00,090112,Heninger; Nadia A,0,0,0,0
1653432466208,CSE 208,A00,094858,Micciancio; Daniele,0,0,0,0
1653432466735,CSE 210,A00,090113,Powell; Thomas Allan,0,0,0,0
1653432467257,CSE 219,A00,090898,Staff,0,0,0,0
1653432467780,CSE 221,A00,090114,Zhou; Yuan-Yuan,0,0,0,0
1653432468315,CSE 229A,A00,090115,Porter; George M,0,0,0,0
1653432468838,CSE 229C,A00,090116,Savage; Stefan,0,0,0,0
1653432469364,CSE 230,A00,090117,Jhala; Ranjit,0,0,0,0
1653432469888,CSE 232,A00,090118,Papakonstantinou; Yannis,0,0,0,0
1653432470416,CSE 239A,A00,090121,Kumar; Arun Kumar,0,0,0,0
1653432470951,CSE 239B,A00,090122,Jhala; Ranjit,0,0,0,0
1653432471474,CSE 240A,A00,090123,Zhao; Jishen,0,0,189,189
1653432472001,CSE 243A,A00,090124,Orailoglu; Alex,3,0,15,12
1653432472528,CSE 249B,A00,090125,Kahng; Andrew Byun,13,0,20,7
1653432473054,CSE 250A,A00,090126,Berg-Kirkpatrick; Taylor D,0,0,0,0
1653432473577,CSE 252A,A00,090127,Ochoa; Benjamin Lawrence,0,0,0,0
1653432474105,CSE 258,A01,090129,McAuley; Julian John,0,0,0,0
1653432474627,CSE 258R,A01,090131,McAuley; Julian John,0,0,0,0
1653432475151,CSE 274,A00,090132,Ramamoorthi; Ravi,0,0,0,0
1653432475676,CSE 276A,A00,090133,Christensen; Henrik I,0,0,0,0
1653432476198,CSE 276C,A00,090134,Christensen; Henrik I,0,0,0,0
1653432476724,CSE 290,A00,090135,Bafna; Vineet,0,0,0,0
1653432476724,CSE 290,B00,090136,Ramamoorthi; Ravi,0,0,0,0
1653432476724,CSE 290,C00,090137,Li; Tzumao,9,0,10,1
1653432476724,CSE 290,D00,090138,Zhou; Yuan-Yuan,10,0,10,0
1653432476724,CSE 290,E00,090139,Christensen; Henrik I,10,0,10,0
1653432476724,CSE 290,F00,094053,Shalev; Aaron D,0,0,0,0
1653432477260,CSE 291,A00,090140,Munyaka; Imani N. S.,0,0,0,0
1653432477260,CSE 291,B00,094880,Yu; Qi,0,0,0,0
1653432477260,CSE 291,C00,090142,Pannuto; Patrick William,0,0,0,0
1653432477260,CSE 291,D00,094881,Zhang; Yiying,0,0,0,0
1653432477260,CSE 291,E00,095118,Su; Hao,0,0,0,0
1653432477793,CSE 293,001,094905,Bafna; Vineet,9999,0,9999,0
1653432477793,CSE 293,002,094906,Bellare; Mihir,9999,0,9999,0
1653432477793,CSE 293,003,094907,Berg-Kirkpatrick; Taylor D,9999,0,9999,0
1653432477793,CSE 293,004,094908,Christensen; Henrik I,9999,0,9999,0
1653432477793,CSE 293,005,094909,Cottrell; Garrison W,9999,0,9999,0
1653432477793,CSE 293,006,094910,Deutsch; Alin Bernard,9999,0,9999,0
1653432477793,CSE 293,007,094911,Esmaeilzadeh; Hadi,9999,0,9999,0
1653432477793,CSE 293,008,094912,Freund; Yoav,9999,0,9999,0
1653432477793,CSE 293,009,094913,Griswold; William G.,9999,0,9999,0
1653432477793,CSE 293,010,094914,Gymrek; Melissa Ann,9999,0,9999,0
1653432477793,CSE 293,011,094915,Heninger; Nadia A,9999,0,9999,0
1653432477793,CSE 293,012,094916,Impagliazzo; Russell,9999,0,9999,0
1653432477793,CSE 293,013,094917,Jhala; Ranjit,9999,0,9999,0
1653432477793,CSE 293,014,094918,Kahng; Andrew Byun,9999,0,9999,0
1653432477793,CSE 293,015,094919,Kane; Daniel Mertz,9999,0,9999,0
1653432477793,CSE 293,016,094920,Kriegman; David J,9999,0,9999,0
1653432477793,CSE 293,017,094921,Kumar; Arun Kumar,9999,0,9999,0
1653432477793,CSE 293,018,094922,Lerner; Sorin,9999,0,9999,0
1653432477793,CSE 293,019,094923,Lovett; Shachar,9999,0,9999,0
1653432477793,CSE 293,020,094924,McAuley; Julian John,9999,0,9999,0
1653432477793,CSE 293,021,094925,Micciancio; Daniele,9999,0,9999,0
1653432477793,CSE 293,022,094926,Orailoglu; Alex,9999,0,9999,0
1653432477793,CSE 293,023,094927,Paturi; Ramamohan,9999,0,9999,0
1653432477793,CSE 293,024,094928,Polikarpova; Nadezhda,9999,0,9999,0
1653432477793,CSE 293,025,094929,Politz; Joseph Gibbs,9999,0,9999,0
1653432477793,CSE 293,026,094930,Porter; George M,9999,0,9999,0
1653432477793,CSE 293,027,094931,Porter; Leonard Emerson,9999,0,9999,0
1653432477793,CSE 293,028,094932,Ramamoorthi; Ravi,9999,0,9999,0
1653432477793,CSE 293,029,094933,Sahoo; Debashis,9999,0,9999,0
1653432477793,CSE 293,030,094934,Saul; Lawrence,9999,0,9999,0
1653432477793,CSE 293,031,094935,Savage; Stefan,9999,0,9999,0
1653432477793,CSE 293,032,094936,Schulze; Jurgen P.,9999,0,9999,0
1653432477793,CSE 293,033,094937,Snoeren; Alex C.,9999,0,9999,0
1653432477793,CSE 293,034,094938,Shang; Jingbo,9999,0,9999,0
1653432477793,CSE 293,035,094939,Stefan; Deian,9999,0,9999,0
1653432477793,CSE 293,036,094940,Su; Hao,9999,0,9999,0
1653432477793,CSE 293,037,094941,Swanson; Steven James,9999,0,9999,0
1653432477793,CSE 293,038,094942,Tullsen; Dean Michael,9999,0,9999,0
1653432477793,CSE 293,039,094943,Voelker; Geoffrey M.,9999,0,9999,0
1653432477793,CSE 293,040,094944,Zhao; Jishen,9999,0,9999,0
1653432477793,CSE 293,041,094945,Zhou; Yuan-Yuan,9999,0,9999,0
1653432477793,CSE 293,042,094946,Gao; Sicun,9998,0,9999,1
1653432477793,CSE 293,043,094947,Weibel; Nadir,9999,0,9999,0
1653432477793,CSE 293,044,094948,Gupta; Rajesh K.,9999,0,9999,0
1653432478318,CSE 294,A00,090143,Porter; George M,9,0,10,1
1653432478845,DSE 200,A00,091799,Staff,50,0,50,0
1653432479379,DSE 203,A00,091800,Gupta; Amarnath,30,0,30,0
1653432479981,DSE 250,A00,091801,Deutsch; Alin Bernard,30,0,30,0
1653432480506,DSE 290,A00,091802,Altintas De Callaf; Ilkay,50,0,50,0
1653432492663,ECE 200,001,091003,Antipa; Nicholas A,9999,0,9999,0
1653432492663,ECE 200,002,091004,Atanasov; Nikolay A.,9999,0,9999,0
1653432492663,ECE 200,003,091005,Bharadia; Dinesh,9999,0,9999,0
1653432492663,ECE 200,004,091006,Cheng; Chung Kuan,9999,0,9999,0
1653432492663,ECE 200,005,091007,Cosman; Pamela C.,9999,0,9999,0
1653432492663,ECE 200,006,091008,Staff,9999,0,9999,0
1653432492663,ECE 200,007,091009,Dayeh; Shadi Ahmad,9999,0,9999,0
1653432492663,ECE 200,008,091010,Fainman; Yeshaiahu,9999,0,9999,0
1653432492663,ECE 200,009,091011,Ford; Joseph Earl,9999,0,9999,0
1653432492663,ECE 200,010,091012,Franceschetti; Massimo,9999,0,9999,0
1653432492663,ECE 200,011,091013,Fullerton; Eric E,9999,0,9999,0
1653432492663,ECE 200,012,091014,Galton; Ian A,9999,0,9999,0
1653432492663,ECE 200,013,091015,Gilja; Vikash,9999,0,9999,0
1653432492663,ECE 200,014,091016,Hall; Drew A.,9999,0,9999,0
1653432492663,ECE 200,015,091017,Hsueh; Tzu-Chien,9999,0,9999,0
1653432492663,ECE 200,016,091018,Javidi; Tara,9999,0,9999,0
1653432492663,ECE 200,017,091019,Kahng; Andrew Byun,9999,0,9999,0
1653432492663,ECE 200,018,091020,Kim; Young-Han,9999,0,9999,0
1653432492663,ECE 200,019,091021,Koushanfar; Farinaz,9999,0,9999,0
1653432492663,ECE 200,020,091022,Kuzum; Duygu,9999,0,9999,0
1653432492663,ECE 200,021,091023,Le; Hanh-Phuc,9999,0,9999,0
1653432492663,ECE 200,022,091024,Lin; Bill,9999,0,9999,0
1653432492663,ECE 200,023,091025,Liu; Zhaowei,9999,0,9999,0
1653432492663,ECE 200,024,091026,Lo; Yu-Hwa,9999,0,9999,0
1653432492663,ECE 200,025,091027,Lomakin; Vitaliy,9999,0,9999,0
1653432492663,ECE 200,026,091028,Mercier; Patrick Philip,9999,0,9999,0
1653432492663,ECE 200,027,091029,Meyer; Florian,9999,0,9999,0
1653432492663,ECE 200,028,091030,Milstein; Laurence B.,9999,0,9999,0
1653432492663,ECE 200,029,091031,Mir Arabbaygi; Siavash,9999,0,9999,0
1653432492663,ECE 200,030,091032,Mookherjea; Shayan,9999,0,9999,0
1653432492663,ECE 200,031,091033,Morris; Karcher William,9999,0,9999,0
1653432492663,ECE 200,032,091034,Ng; Tse Nga,9999,0,9999,0
1653432492663,ECE 200,033,091035,Nguyen; Truong Quang,9999,0,9999,0
1653432492663,ECE 200,034,091036,Nomura; Kenji,9999,0,9999,0
1653432492663,ECE 200,035,091037,Orlitsky; Alon,9999,0,9999,0
1653432492663,ECE 200,036,091038,Pal; Piya,9999,0,9999,0
1653432492663,ECE 200,037,091039,Papen; George C.,9999,0,9999,0
1653432492663,ECE 200,038,091040,Radic; Stojan,9999,0,9999,0
1653432492663,ECE 200,039,091041,Rao; Bhaskar D.,9999,0,9999,0
1653432492663,ECE 200,040,091042,Rao; Ramesh R,9999,0,9999,0
1653432492663,ECE 200,041,091043,Rebeiz; Gabriel,9999,0,9999,0
1653432492663,ECE 200,042,091044,Sanford; John R,9999,0,9999,0
1653432492663,ECE 200,043,091045,Siegel; Paul H.,9999,0,9999,0
1653432492663,ECE 200,044,091046,Sievenpiper; Daniel F.,9999,0,9999,0
1653432492663,ECE 200,045,091047,Sworder; David D.,9999,0,9999,0
1653432492663,ECE 200,046,091048,Taur; Yuan,9999,0,9999,0
1653432492663,ECE 200,047,091049,Touri; Behrouz,9999,0,9999,0
1653432492663,ECE 200,048,091050,Trivedi; Mohan M.,9999,0,9999,0
1653432492663,ECE 200,049,091051,Vardy; Alexander,9999,0,9999,0
1653432492663,ECE 200,050,091052,Vasconcelos; Nuno,9999,0,9999,0
1653432492663,ECE 200,051,091053,Wang; Xiaolong,9999,0,9999,0
1653432492663,ECE 200,052,091054,Xie; Pengtao,9999,0,9999,0
1653432492663,ECE 200,053,091055,Yip; Michael,9999,0,9999,0
1653432492663,ECE 200,054,091056,Zeger; Kenneth A.,9999,0,9999,0
1653432492663,ECE 200,055,091057,Zhang; Xinyu,9999,0,9999,0
1653432492663,ECE 200,056,091058,Turakhia; Yatish Girish,9999,0,9999,0
1653432492663,ECE 200,057,091059,Kang; Mingu,9999,0,9999,0
1653432492663,ECE 200,058,091060,Shi; Yuanyuan,9999,0,9999,0
1653432492663,ECE 200,059,091061,Wang; Edward Jay,9999,0,9999,0
1653432492663,ECE 200,060,091062,Zheng; Yang,9999,0,9999,0
1653432493189,ECE 203,A00,091065,Mercier; Patrick Philip,0,0,0,0
1653432493717,ECE 207A,A00,091605,Liu; Thomas Tao-Ming,0,0,0,0
1653432494243,ECE 212AN,A00,091068,Nomura; Kenji,0,0,0,0
1653432494772,ECE 222A,A00,091069,Rebeiz; Gabriel,0,0,0,0
1653432495310,ECE 225A,A00,091070,Orlitsky; Alon,0,0,0,0
1653432495843,ECE 230A,A00,091071,Nomura; Kenji,0,0,0,0
1653432496367,ECE 236A,A00,091072,Dayeh; Shadi Ahmad,0,0,0,0
1653432496891,ECE 238A,A00,091073,Luo; Jian,0,0,0,0
1653432496891,ECE 238A,B00,091074,Luo; Jian,0,0,0,0
1653432497414,ECE 240A,A00,091075,Radic; Stojan,0,0,0,0
1653432497938,ECE 247A,A00,091592,Shi; Lingyan,0,0,0,0
1653432498468,ECE 250,A00,091076,Touri; Behrouz,0,0,0,0
1653432498989,ECE 251C,A00,091078,Nguyen; Truong Quang,0,0,0,0
1653432499513,ECE 253,A00,091079,Cosman; Pamela C.,0,0,0,0
1653432500036,ECE 255A,A00,091080,Orlitsky; Alon,0,0,0,0
1653432500560,ECE 257A,A00,091081,Zhang; Xinyu,0,0,0,0
1653432501083,ECE 260A,A01,091084,Eldon; John,0,0,0,0
1653432501618,ECE 264C,A00,091085,Galton; Ian A,0,0,0,0
1653432502141,ECE 265C,A00,094889,Presti; Calogero Davide,0,0,0,9
1653432502665,ECE 266,A01,091087,Hall; Drew A.,0,0,0,0
1653432503731,ECE 271A,A00,091090,Vasconcelos; Nuno,0,0,0,0
1653432504256,ECE 272B,A00,091091,Sworder; David D.,0,0,0,0
1653432504779,ECE 275A,A00,091092,Meyer; Florian,0,0,0,0
1653432505305,ECE 277,A00,091093,An; Cheolhong,0,0,0,0
1653432505827,ECE 283,A00,091094,Le; Hanh-Phuc,0,0,0,0
1653432506354,ECE 284,A00,091095,Kang; Mingu,0,0,0,0
1653432506354,ECE 284,B00,091096,Wang; Edward Jay,0,0,0,0
1653432506876,ECE 285,A00,094334,Touri; Behrouz,0,0,0,0
1653432507404,ECE 289,A00,091097,Whelan; David Arthur,0,0,0,0
1653432507931,MATH 200A,A00,087414,Salehi Golsefidy; Alireza,7,0,8,1
1653432508454,MATH 202A,A00,087415,Gill; Philip E.,3,0,8,5
1653432508987,MATH 203A,A00,087416,Oprea; Dragos N.,6,0,8,2
1653432509512,MATH 204A,A00,087417,Kedlaya; Kiran S.,6,0,8,2
1653432510034,MATH 205,A00,087418,Sorensen; Claus M,6,0,8,2
1653432510557,MATH 206A,A00,087419,Izadi; Elham,7,0,8,1
1653432511092,MATH 207A,A00,087420,Mohammadi; Amir,6,0,8,2
1653432511621,MATH 208,A00,087421,Staff,9,0,10,1
1653432512143,MATH 209,A00,087422,Staff,10,0,10,0
1653432512666,MATH 218,A00,087423,Staff,10,0,10,0
1653432513189,MATH 220A,A00,087424,Novak; Jonathan I,7,0,8,1
1653432513711,MATH 231A,A00,087425,Bejenaru; Ioan,4,0,8,4
1653432514260,MATH 240A,A00,087426,Ebenfelt; Peter F,5,0,8,3
1653432514782,MATH 243,A00,087427,Staff,9,0,10,1
1653432515319,MATH 248,A00,087429,Staff,10,0,10,0
1653432515847,MATH 250A,A00,087430,Spolaor; Luca,5,0,8,3
1653432516369,MATH 257A,A00,087431,Spolaor; Luca,7,0,8,1
1653432516893,MATH 258,A00,087432,Staff,9,0,10,1
1653432517414,MATH 264A,A00,087433,Warnke; Lutz Peter,5,0,8,3
1653432517940,MATH 268,A00,087434,Staff,15,0,15,0
1653432518482,MATH 269,A00,087435,Staff,14,0,15,1
1653432519014,MATH 270A,A00,087436,Nie; Jiawang,0,0,8,8
1653432519537,MATH 272A,A00,087437,Tian; Xiaochuan,1,0,8,7
1653432520118,MATH 274,A01,087439,Cheng; Li-Tien,9,0,10,1
1653432520118,MATH 274,A02,087440,Cheng; Li-Tien,10,0,10,0
1653432520644,MATH 278A,A00,087441,Staff,8,0,10,2
1653432521178,MATH 278B,A00,087442,Staff,8,0,10,2
1653432521700,MATH 278C,A00,087443,Staff,8,0,10,2
1653432522225,MATH 280A,A00,087444,Zheng; Tianyi,0,0,8,8
1653432522747,MATH 281A,A00,087445,Bradic; Jelena,0,0,8,8
1653432523273,MATH 282A,A00,087446,Zhang; Danna,0,0,8,8
1653432523796,MATH 283,A00,087447,Tesler; Glenn,0,0,0,14
1653432524319,MATH 286,A00,087448,Kemp; Todd Aahron,6,0,8,2
1653432524851,MATH 287D,A00,087449,Bradic; Jelena,8,0,8,0
1653432525374,MATH 288,A00,087450,Staff,14,0,15,1
1653432525374,MATH 288,B00,087451,Staff,15,0,15,0
1653432525374,MATH 288,C00,087452,Staff,15,0,15,0
1653432525925,MATH 290A,A00,087453,Xu; Zhouli,7,0,8,1
1653432526458,MATH 291A,A00,087454,Xu; Zhouli,7,0,8,1
1653432526998,MATH 292,A00,087455,Staff,10,0,10,0
1653432527523,MATH 295,A00,087456,Staff,50,0,50,0
1653432528048,MATH 297,001,087457,Staff,998,0,999,1
1653433093393,COGS 200,A01,087991,Staff,47,0,50,3
1653433093922,COGS 201,A01,094504,Rangel; Lara M,17,0,25,8
1653433094453,COGS 203,A00,087992,Coulson; Seana M,18,0,20,2
1653433094981,COGS 210A,001,087993,Greene; Deanna Jacquelyn,9998,0,9999,1
1653433094981,COGS 210A,002,087994,Saygin; Ayse P,9999,0,9999,0
1653433094981,COGS 210A,003,087995,Xia; Haijun,9999,0,9999,0
1653433094981,COGS 210A,004,087996,Nitz; Douglas A.,9999,0,9999,0
1653433094981,COGS 210A,005,087997,Hollan; James D.,9999,0,9999,0
1653433094981,COGS 210A,006,087998,Deak; Gedeon O.,9998,0,9999,1
1653433094981,COGS 210A,007,087999,Rossano; Federico,9999,0,9999,0
1653433095504,COGS 211A,A00,088000,Coulson; Seana M,9997,0,9999,2
1653433096026,COGS 229,A00,088002,Staff,23,0,25,2
1653433096554,COGS 260,B00,094231,Staff,17,0,20,3
1653433096554,COGS 260,A00,088004,Nitz; Douglas A.,9998,0,9999,1
1653433097085,CSE 202,A00,090110,Paturi; Ramamohan,0,0,0,0
1653433097085,CSE 202,B00,090111,Paturi; Ramamohan,0,0,0,0
1653433097607,CSE 207B,A00,090112,Heninger; Nadia A,0,0,0,0
1653433098132,CSE 208,A00,094858,Micciancio; Daniele,0,0,0,0
1653433098670,CSE 210,A00,090113,Powell; Thomas Allan,0,0,0,0
1653433099192,CSE 219,A00,090898,Staff,0,0,0,0
1653433099719,CSE 221,A00,090114,Zhou; Yuan-Yuan,0,0,0,0
1653433100257,CSE 229A,A00,090115,Porter; George M,0,0,0,0
1653433100782,CSE 229C,A00,090116,Savage; Stefan,0,0,0,0
1653433101308,CSE 230,A00,090117,Jhala; Ranjit,0,0,0,0
1653433101836,CSE 232,A00,090118,Papakonstantinou; Yannis,0,0,0,0
1653433102362,CSE 239A,A00,090121,Kumar; Arun Kumar,0,0,0,0
1653433102884,CSE 239B,A00,090122,Jhala; Ranjit,0,0,0,0
1653433103405,CSE 240A,A00,090123,Zhao; Jishen,0,0,189,189
1653433103931,CSE 243A,A00,090124,Orailoglu; Alex,3,0,15,12
1653433104458,CSE 249B,A00,090125,Kahng; Andrew Byun,13,0,20,7
1653433105011,CSE 250A,A00,090126,Berg-Kirkpatrick; Taylor D,0,0,0,0
1653433105547,CSE 252A,A00,090127,Ochoa; Benjamin Lawrence,0,0,0,0
1653433106069,CSE 258,A01,090129,McAuley; Julian John,0,0,0,0
1653433106596,CSE 258R,A01,090131,McAuley; Julian John,0,0,0,0
1653433107126,CSE 274,A00,090132,Ramamoorthi; Ravi,0,0,0,0
1653433107656,CSE 276A,A00,090133,Christensen; Henrik I,0,0,0,0
1653433108182,CSE 276C,A00,090134,Christensen; Henrik I,0,0,0,0
1653433108715,CSE 290,A00,090135,Bafna; Vineet,0,0,0,0
1653433108715,CSE 290,B00,090136,Ramamoorthi; Ravi,0,0,0,0
1653433108715,CSE 290,C00,090137,Li; Tzumao,9,0,10,1
1653433108715,CSE 290,D00,090138,Zhou; Yuan-Yuan,10,0,10,0
1653433108715,CSE 290,E00,090139,Christensen; Henrik I,10,0,10,0
1653433108715,CSE 290,F00,094053,Shalev; Aaron D,0,0,0,0
1653433109254,CSE 291,A00,090140,Munyaka; Imani N. S.,0,0,0,0
1653433109254,CSE 291,B00,094880,Yu; Qi,0,0,0,0
1653433109254,CSE 291,C00,090142,Pannuto; Patrick William,0,0,0,0
1653433109254,CSE 291,D00,094881,Zhang; Yiying,0,0,0,0
1653433109254,CSE 291,E00,095118,Su; Hao,0,0,0,0
1653433109786,CSE 293,001,094905,Bafna; Vineet,9999,0,9999,0
1653433109786,CSE 293,002,094906,Bellare; Mihir,9999,0,9999,0
1653433109786,CSE 293,003,094907,Berg-Kirkpatrick; Taylor D,9999,0,9999,0
1653433109786,CSE 293,004,094908,Christensen; Henrik I,9999,0,9999,0
1653433109786,CSE 293,005,094909,Cottrell; Garrison W,9999,0,9999,0
1653433109786,CSE 293,006,094910,Deutsch; Alin Bernard,9999,0,9999,0
1653433109786,CSE 293,007,094911,Esmaeilzadeh; Hadi,9999,0,9999,0
1653433109786,CSE 293,008,094912,Freund; Yoav,9999,0,9999,0
1653433109786,CSE 293,009,094913,Griswold; William G.,9999,0,9999,0
1653433109786,CSE 293,010,094914,Gymrek; Melissa Ann,9999,0,9999,0
1653433109786,CSE 293,011,094915,Heninger; Nadia A,9999,0,9999,0
1653433109786,CSE 293,012,094916,Impagliazzo; Russell,9999,0,9999,0
1653433109786,CSE 293,013,094917,Jhala; Ranjit,9999,0,9999,0
1653433109786,CSE 293,014,094918,Kahng; Andrew Byun,9999,0,9999,0
1653433109786,CSE 293,015,094919,Kane; Daniel Mertz,9999,0,9999,0
1653433109786,CSE 293,016,094920,Kriegman; David J,9999,0,9999,0
1653433109786,CSE 293,017,094921,Kumar; Arun Kumar,9999,0,9999,0
1653433109786,CSE 293,018,094922,Lerner; Sorin,9999,0,9999,0
1653433109786,CSE 293,019,094923,Lovett; Shachar,9999,0,9999,0
1653433109786,CSE 293,020,094924,McAuley; Julian John,9999,0,9999,0
1653433109786,CSE 293,021,094925,Micciancio; Daniele,9999,0,9999,0
1653433109786,CSE 293,022,094926,Orailoglu; Alex,9999,0,9999,0
1653433109786,CSE 293,023,094927,Paturi; Ramamohan,9999,0,9999,0
1653433109786,CSE 293,024,094928,Polikarpova; Nadezhda,9999,0,9999,0
1653433109786,CSE 293,025,094929,Politz; Joseph Gibbs,9999,0,9999,0
1653433109786,CSE 293,026,094930,Porter; George M,9999,0,9999,0
1653433109786,CSE 293,027,094931,Porter; Leonard Emerson,9999,0,9999,0
1653433109786,CSE 293,028,094932,Ramamoorthi; Ravi,9999,0,9999,0
1653433109786,CSE 293,029,094933,Sahoo; Debashis,9999,0,9999,0
1653433109786,CSE 293,030,094934,Saul; Lawrence,9999,0,9999,0
1653433109786,CSE 293,031,094935,Savage; Stefan,9999,0,9999,0
1653433109786,CSE 293,032,094936,Schulze; Jurgen P.,9999,0,9999,0
1653433109786,CSE 293,033,094937,Snoeren; Alex C.,9999,0,9999,0
1653433109786,CSE 293,034,094938,Shang; Jingbo,9999,0,9999,0
1653433109786,CSE 293,035,094939,Stefan; Deian,9999,0,9999,0
1653433109786,CSE 293,036,094940,Su; Hao,9999,0,9999,0
1653433109786,CSE 293,037,094941,Swanson; Steven James,9999,0,9999,0
1653433109786,CSE 293,038,094942,Tullsen; Dean Michael,9999,0,9999,0
1653433109786,CSE 293,039,094943,Voelker; Geoffrey M.,9999,0,9999,0
1653433109786,CSE 293,040,094944,Zhao; Jishen,9999,0,9999,0
1653433109786,CSE 293,041,094945,Zhou; Yuan-Yuan,9999,0,9999,0
1653433109786,CSE 293,042,094946,Gao; Sicun,9998,0,9999,1
1653433109786,CSE 293,043,094947,Weibel; Nadir,9999,0,9999,0
1653433109786,CSE 293,044,094948,Gupta; Rajesh K.,9999,0,9999,0
1653433110309,CSE 294,A00,090143,Porter; George M,9,0,10,1
1653433110831,DSE 200,A00,091799,Staff,50,0,50,0
1653433111357,DSE 203,A00,091800,Gupta; Amarnath,30,0,30,0
1653433111883,DSE 250,A00,091801,Deutsch; Alin Bernard,30,0,30,0
1653433112417,DSE 290,A00,091802,Altintas De Callaf; Ilkay,50,0,50,0
1653433112946,ECE 200,001,091003,Antipa; Nicholas A,9999,0,9999,0
1653433112946,ECE 200,002,091004,Atanasov; Nikolay A.,9999,0,9999,0
1653433112946,ECE 200,003,091005,Bharadia; Dinesh,9999,0,9999,0
1653433112946,ECE 200,004,091006,Cheng; Chung Kuan,9999,0,9999,0
1653433112946,ECE 200,005,091007,Cosman; Pamela C.,9999,0,9999,0
1653433112946,ECE 200,006,091008,Staff,9999,0,9999,0
1653433112946,ECE 200,007,091009,Dayeh; Shadi Ahmad,9999,0,9999,0
1653433112946,ECE 200,008,091010,Fainman; Yeshaiahu,9999,0,9999,0
1653433112946,ECE 200,009,091011,Ford; Joseph Earl,9999,0,9999,0
1653433112946,ECE 200,010,091012,Franceschetti; Massimo,9999,0,9999,0
1653433112946,ECE 200,011,091013,Fullerton; Eric E,9999,0,9999,0
1653433112946,ECE 200,012,091014,Galton; Ian A,9999,0,9999,0
1653433112946,ECE 200,013,091015,Gilja; Vikash,9999,0,9999,0
1653433112946,ECE 200,014,091016,Hall; Drew A.,9999,0,9999,0
1653433112946,ECE 200,015,091017,Hsueh; Tzu-Chien,9999,0,9999,0
1653433112946,ECE 200,016,091018,Javidi; Tara,9999,0,9999,0
1653433112946,ECE 200,017,091019,Kahng; Andrew Byun,9999,0,9999,0
1653433112946,ECE 200,018,091020,Kim; Young-Han,9999,0,9999,0
1653433112946,ECE 200,019,091021,Koushanfar; Farinaz,9999,0,9999,0
1653433112946,ECE 200,020,091022,Kuzum; Duygu,9999,0,9999,0
1653433112946,ECE 200,021,091023,Le; Hanh-Phuc,9999,0,9999,0
1653433112946,ECE 200,022,091024,Lin; Bill,9999,0,9999,0
1653433112946,ECE 200,023,091025,Liu; Zhaowei,9999,0,9999,0
1653433112946,ECE 200,024,091026,Lo; Yu-Hwa,9999,0,9999,0
1653433112946,ECE 200,025,091027,Lomakin; Vitaliy,9999,0,9999,0
1653433112946,ECE 200,026,091028,Mercier; Patrick Philip,9999,0,9999,0
1653433112946,ECE 200,027,091029,Meyer; Florian,9999,0,9999,0
1653433112946,ECE 200,028,091030,Milstein; Laurence B.,9999,0,9999,0
1653433112946,ECE 200,029,091031,Mir Arabbaygi; Siavash,9999,0,9999,0
1653433112946,ECE 200,030,091032,Mookherjea; Shayan,9999,0,9999,0
1653433112946,ECE 200,031,091033,Morris; Karcher William,9999,0,9999,0
1653433112946,ECE 200,032,091034,Ng; Tse Nga,9999,0,9999,0
1653433112946,ECE 200,033,091035,Nguyen; Truong Quang,9999,0,9999,0
1653433112946,ECE 200,034,091036,Nomura; Kenji,9999,0,9999,0
1653433112946,ECE 200,035,091037,Orlitsky; Alon,9999,0,9999,0
1653433112946,ECE 200,036,091038,Pal; Piya,9999,0,9999,0
1653433112946,ECE 200,037,091039,Papen; George C.,9999,0,9999,0
1653433112946,ECE 200,038,091040,Radic; Stojan,9999,0,9999,0
1653433112946,ECE 200,039,091041,Rao; Bhaskar D.,9999,0,9999,0
1653433112946,ECE 200,040,091042,Rao; Ramesh R,9999,0,9999,0
1653433112946,ECE 200,041,091043,Rebeiz; Gabriel,9999,0,9999,0
1653433112946,ECE 200,042,091044,Sanford; John R,9999,0,9999,0
1653433112946,ECE 200,043,091045,Siegel; Paul H.,9999,0,9999,0
1653433112946,ECE 200,044,091046,Sievenpiper; Daniel F.,9999,0,9999,0
1653433112946,ECE 200,045,091047,Sworder; David D.,9999,0,9999,0
1653433112946,ECE 200,046,091048,Taur; Yuan,9999,0,9999,0
1653433112946,ECE 200,047,091049,Touri; Behrouz,9999,0,9999,0
1653433112946,ECE 200,048,091050,Trivedi; Mohan M.,9999,0,9999,0
1653433112946,ECE 200,049,091051,Vardy; Alexander,9999,0,9999,0
1653433112946,ECE 200,050,091052,Vasconcelos; Nuno,9999,0,9999,0
1653433112946,ECE 200,051,091053,Wang; Xiaolong,9999,0,9999,0
1653433112946,ECE 200,052,091054,Xie; Pengtao,9999,0,9999,0
1653433112946,ECE 200,053,091055,Yip; Michael,9999,0,9999,0
1653433112946,ECE 200,054,091056,Zeger; Kenneth A.,9999,0,9999,0
1653433112946,ECE 200,055,091057,Zhang; Xinyu,9999,0,9999,0
1653433112946,ECE 200,056,091058,Turakhia; Yatish Girish,9999,0,9999,0
1653433112946,ECE 200,057,091059,Kang; Mingu,9999,0,9999,0
1653433112946,ECE 200,058,091060,Shi; Yuanyuan,9999,0,9999,0
1653433112946,ECE 200,059,091061,Wang; Edward Jay,9999,0,9999,0
1653433112946,ECE 200,060,091062,Zheng; Yang,9999,0,9999,0
1653433113467,ECE 203,A00,091065,Mercier; Patrick Philip,0,0,0,0
1653433113998,ECE 207A,A00,091605,Liu; Thomas Tao-Ming,0,0,0,0
1653433114525,ECE 212AN,A00,091068,Nomura; Kenji,0,0,0,0
1653433115050,ECE 222A,A00,091069,Rebeiz; Gabriel,0,0,0,0
1653433115582,ECE 225A,A00,091070,Orlitsky; Alon,0,0,0,0
1653433116113,ECE 230A,A00,091071,Nomura; Kenji,0,0,0,0
1653433116641,ECE 236A,A00,091072,Dayeh; Shadi Ahmad,0,0,0,0
1653433117171,ECE 238A,A00,091073,Luo; Jian,0,0,0,0
1653433117171,ECE 238A,B00,091074,Luo; Jian,0,0,0,0
1653433117704,ECE 240A,A00,091075,Radic; Stojan,0,0,0,0
1653433118236,ECE 247A,A00,091592,Shi; Lingyan,0,0,0,0
1653433118767,ECE 250,A00,091076,Touri; Behrouz,0,0,0,0
1653433119291,ECE 251C,A00,091078,Nguyen; Truong Quang,0,0,0,0
1653433119827,ECE 253,A00,091079,Cosman; Pamela C.,0,0,0,0
1653433120353,ECE 255A,A00,091080,Orlitsky; Alon,0,0,0,0
1653433120874,ECE 257A,A00,091081,Zhang; Xinyu,0,0,0,0
1653433121397,ECE 260A,A01,091084,Eldon; John,0,0,0,0
1653433121941,ECE 264C,A00,091085,Galton; Ian A,0,0,0,0
1653433122463,ECE 265C,A00,094889,Presti; Calogero Davide,0,0,0,9
1653433122986,ECE 266,A01,091087,Hall; Drew A.,0,0,0,0
1653433124033,ECE 271A,A00,091090,Vasconcelos; Nuno,0,0,0,0
1653433124557,ECE 272B,A00,091091,Sworder; David D.,0,0,0,0
1653433125088,ECE 275A,A00,091092,Meyer; Florian,0,0,0,0
1653433125611,ECE 277,A00,091093,An; Cheolhong,0,0,0,0
1653433126141,ECE 283,A00,091094,Le; Hanh-Phuc,0,0,0,0
1653433126671,ECE 284,A00,091095,Kang; Mingu,0,0,0,0
1653433126671,ECE 284,B00,091096,Wang; Edward Jay,0,0,0,0
1653433127198,ECE 285,A00,094334,Touri; Behrouz,0,0,0,0
1653433127724,ECE 289,A00,091097,Whelan; David Arthur,0,0,0,0
1653433128247,MATH 200A,A00,087414,Salehi Golsefidy; Alireza,7,0,8,1
1653433128773,MATH 202A,A00,087415,Gill; Philip E.,3,0,8,5
1653433129299,MATH 203A,A00,087416,Oprea; Dragos N.,6,0,8,2
1653433129821,MATH 204A,A00,087417,Kedlaya; Kiran S.,6,0,8,2
1653433130343,MATH 205,A00,087418,Sorensen; Claus M,6,0,8,2
1653433130880,MATH 206A,A00,087419,Izadi; Elham,7,0,8,1
1653433131402,MATH 207A,A00,087420,Mohammadi; Amir,6,0,8,2
1653433131927,MATH 208,A00,087421,Staff,9,0,10,1
1653433132449,MATH 209,A00,087422,Staff,10,0,10,0
1653433132980,MATH 218,A00,087423,Staff,10,0,10,0
1653433133514,MATH 220A,A00,087424,Novak; Jonathan I,7,0,8,1
1653433134039,MATH 231A,A00,087425,Bejenaru; Ioan,4,0,8,4
1653433134573,MATH 240A,A00,087426,Ebenfelt; Peter F,5,0,8,3
1653433135115,MATH 243,A00,087427,Staff,9,0,10,1
1653433135639,MATH 248,A00,087429,Staff,10,0,10,0
1653433136163,MATH 250A,A00,087430,Spolaor; Luca,5,0,8,3
1653433136689,MATH 257A,A00,087431,Spolaor; Luca,7,0,8,1
1653433137216,MATH 258,A00,087432,Staff,9,0,10,1
1653433137824,MATH 264A,A00,087433,Warnke; Lutz Peter,5,0,8,3
1653433138348,MATH 268,A00,087434,Staff,15,0,15,0
1653433138883,MATH 269,A00,087435,Staff,14,0,15,1
1653433139407,MATH 270A,A00,087436,Nie; Jiawang,0,0,8,8
1653433139929,MATH 272A,A00,087437,Tian; Xiaochuan,1,0,8,7
1653433140452,MATH 274,A01,087439,Cheng; Li-Tien,9,0,10,1
1653433140452,MATH 274,A02,087440,Cheng; Li-Tien,10,0,10,0
1653433140975,MATH 278A,A00,087441,Staff,8,0,10,2
1653433141498,MATH 278B,A00,087442,Staff,8,0,10,2
1653433142034,MATH 278C,A00,087443,Staff,8,0,10,2
1653433142558,MATH 280A,A00,087444,Zheng; Tianyi,0,0,8,8
1653433143080,MATH 281A,A00,087445,Bradic; Jelena,0,0,8,8
1653433143602,MATH 282A,A00,087446,Zhang; Danna,0,0,8,8
1653433144132,MATH 283,A00,087447,Tesler; Glenn,0,0,0,14
1653433144659,MATH 286,A00,087448,Kemp; Todd Aahron,6,0,8,2
1653433145181,MATH 287D,A00,087449,Bradic; Jelena,8,0,8,0
1653433145702,MATH 288,A00,087450,Staff,14,0,15,1
1653433145702,MATH 288,B00,087451,Staff,15,0,15,0
1653433145702,MATH 288,C00,087452,Staff,15,0,15,0
1653433146235,MATH 290A,A00,087453,Xu; Zhouli,7,0,8,1
1653433146772,MATH 291A,A00,087454,Xu; Zhouli,7,0,8,1
1653433147296,MATH 292,A00,087455,Staff,10,0,10,0
1653433147825,MATH 295,A00,087456,Staff,50,0,50,0
1653433148356,MATH 297,001,087457,Staff,998,0,999,1
1653433713784,COGS 200,A01,087991,Staff,47,0,50,3
1653433714310,COGS 201,A01,094504,Rangel; Lara M,17,0,25,8
1653433714837,COGS 203,A00,087992,Coulson; Seana M,18,0,20,2
1653433715364,COGS 210A,001,087993,Greene; Deanna Jacquelyn,9998,0,9999,1
1653433715364,COGS 210A,002,087994,Saygin; Ayse P,9999,0,9999,0
1653433715364,COGS 210A,003,087995,Xia; Haijun,9999,0,9999,0
1653433715364,COGS 210A,004,087996,Nitz; Douglas A.,9999,0,9999,0
1653433715364,COGS 210A,005,087997,Hollan; James D.,9999,0,9999,0
1653433715364,COGS 210A,006,087998,Deak; Gedeon O.,9998,0,9999,1
1653433715364,COGS 210A,007,087999,Rossano; Federico,9999,0,9999,0
1653433715913,COGS 211A,A00,088000,Coulson; Seana M,9997,0,9999,2
1653433716444,COGS 229,A00,088002,Staff,23,0,25,2
1653433716971,COGS 260,B00,094231,Staff,17,0,20,3
1653433716971,COGS 260,A00,088004,Nitz; Douglas A.,9998,0,9999,1
1653433717503,CSE 202,A00,090110,Paturi; Ramamohan,0,0,0,0
1653433717503,CSE 202,B00,090111,Paturi; Ramamohan,0,0,0,0
1653433718034,CSE 207B,A00,090112,Heninger; Nadia A,0,0,0,0
1653433718573,CSE 208,A00,094858,Micciancio; Daniele,0,0,0,0
1653433719097,CSE 210,A00,090113,Powell; Thomas Allan,0,0,0,0
1653433719619,CSE 219,A00,090898,Staff,0,0,0,0
1653433720152,CSE 221,A00,090114,Zhou; Yuan-Yuan,0,0,0,0
1653433720675,CSE 229A,A00,090115,Porter; George M,0,0,0,0
1653433721202,CSE 229C,A00,090116,Savage; Stefan,0,0,0,0
1653433721728,CSE 230,A00,090117,Jhala; Ranjit,0,0,0,0
1653433722263,CSE 232,A00,090118,Papakonstantinou; Yannis,0,0,0,0
1653433722790,CSE 239A,A00,090121,Kumar; Arun Kumar,0,0,0,0
1653433723322,CSE 239B,A00,090122,Jhala; Ranjit,0,0,0,0
1653433723852,CSE 240A,A00,090123,Zhao; Jishen,0,0,189,189
1653433724377,CSE 243A,A00,090124,Orailoglu; Alex,3,0,15,12
1653433724900,CSE 249B,A00,090125,Kahng; Andrew Byun,13,0,20,7
1653433725423,CSE 250A,A00,090126,Berg-Kirkpatrick; Taylor D,0,0,0,0
1653433725948,CSE 252A,A00,090127,Ochoa; Benjamin Lawrence,0,0,0,0
1653433726490,CSE 258,A01,090129,McAuley; Julian John,0,0,0,0
1653433727023,CSE 258R,A01,090131,McAuley; Julian John,0,0,0,0
1653433727559,CSE 274,A00,090132,Ramamoorthi; Ravi,0,0,0,0
1653433728092,CSE 276A,A00,090133,Christensen; Henrik I,0,0,0,0
1653433728616,CSE 276C,A00,090134,Christensen; Henrik I,0,0,0,0
1653433729154,CSE 290,A00,090135,Bafna; Vineet,0,0,0,0
1653433729154,CSE 290,B00,090136,Ramamoorthi; Ravi,0,0,0,0
1653433729154,CSE 290,C00,090137,Li; Tzumao,9,0,10,1
1653433729154,CSE 290,D00,090138,Zhou; Yuan-Yuan,10,0,10,0
1653433729154,CSE 290,E00,090139,Christensen; Henrik I,10,0,10,0
1653433729154,CSE 290,F00,094053,Shalev; Aaron D,0,0,0,0
1653433729692,CSE 291,A00,090140,Munyaka; Imani N. S.,0,0,0,0
1653433729692,CSE 291,B00,094880,Yu; Qi,0,0,0,0
1653433729692,CSE 291,C00,090142,Pannuto; Patrick William,0,0,0,0
1653433729692,CSE 291,D00,094881,Zhang; Yiying,0,0,0,0
1653433729692,CSE 291,E00,095118,Su; Hao,0,0,0,0
1653433730232,CSE 293,001,094905,Bafna; Vineet,9999,0,9999,0
1653433730232,CSE 293,002,094906,Bellare; Mihir,9999,0,9999,0
1653433730232,CSE 293,003,094907,Berg-Kirkpatrick; Taylor D,9999,0,9999,0
1653433730232,CSE 293,004,094908,Christensen; Henrik I,9999,0,9999,0
1653433730232,CSE 293,005,094909,Cottrell; Garrison W,9999,0,9999,0
1653433730232,CSE 293,006,094910,Deutsch; Alin Bernard,9999,0,9999,0
1653433730232,CSE 293,007,094911,Esmaeilzadeh; Hadi,9999,0,9999,0
1653433730232,CSE 293,008,094912,Freund; Yoav,9999,0,9999,0
1653433730232,CSE 293,009,094913,Griswold; William G.,9999,0,9999,0
1653433730232,CSE 293,010,094914,Gymrek; Melissa Ann,9999,0,9999,0
1653433730232,CSE 293,011,094915,Heninger; Nadia A,9999,0,9999,0
1653433730232,CSE 293,012,094916,Impagliazzo; Russell,9999,0,9999,0
1653433730232,CSE 293,013,094917,Jhala; Ranjit,9999,0,9999,0
1653433730232,CSE 293,014,094918,Kahng; Andrew Byun,9999,0,9999,0
1653433730232,CSE 293,015,094919,Kane; Daniel Mertz,9999,0,9999,0
1653433730232,CSE 293,016,094920,Kriegman; David J,9999,0,9999,0
1653433730232,CSE 293,017,094921,Kumar; Arun Kumar,9999,0,9999,0
1653433730232,CSE 293,018,094922,Lerner; Sorin,9999,0,9999,0
1653433730232,CSE 293,019,094923,Lovett; Shachar,9999,0,9999,0
1653433730232,CSE 293,020,094924,McAuley; Julian John,9999,0,9999,0
1653433730232,CSE 293,021,094925,Micciancio; Daniele,9999,0,9999,0
1653433730232,CSE 293,022,094926,Orailoglu; Alex,9999,0,9999,0
1653433730232,CSE 293,023,094927,Paturi; Ramamohan,9999,0,9999,0
1653433730232,CSE 293,024,094928,Polikarpova; Nadezhda,9999,0,9999,0
1653433730232,CSE 293,025,094929,Politz; Joseph Gibbs,9999,0,9999,0
1653433730232,CSE 293,026,094930,Porter; George M,9999,0,9999,0
1653433730232,CSE 293,027,094931,Porter; Leonard Emerson,9999,0,9999,0
1653433730232,CSE 293,028,094932,Ramamoorthi; Ravi,9999,0,9999,0
1653433730232,CSE 293,029,094933,Sahoo; Debashis,9999,0,9999,0
1653433730232,CSE 293,030,094934,Saul; Lawrence,9999,0,9999,0
1653433730232,CSE 293,031,094935,Savage; Stefan,9999,0,9999,0
1653433730232,CSE 293,032,094936,Schulze; Jurgen P.,9999,0,9999,0
1653433730232,CSE 293,033,094937,Snoeren; Alex C.,9999,0,9999,0
1653433730232,CSE 293,034,094938,Shang; Jingbo,9999,0,9999,0
1653433730232,CSE 293,035,094939,Stefan; Deian,9999,0,9999,0
1653433730232,CSE 293,036,094940,Su; Hao,9999,0,9999,0
1653433730232,CSE 293,037,094941,Swanson; Steven James,9999,0,9999,0
1653433730232,CSE 293,038,094942,Tullsen; Dean Michael,9999,0,9999,0
1653433730232,CSE 293,039,094943,Voelker; Geoffrey M.,9999,0,9999,0
1653433730232,CSE 293,040,094944,Zhao; Jishen,9999,0,9999,0
1653433730232,CSE 293,041,094945,Zhou; Yuan-Yuan,9999,0,9999,0
1653433730232,CSE 293,042,094946,Gao; Sicun,9998,0,9999,1
1653433730232,CSE 293,043,094947,Weibel; Nadir,9999,0,9999,0
1653433730232,CSE 293,044,094948,Gupta; Rajesh K.,9999,0,9999,0
1653433730864,CSE 294,A00,090143,Porter; George M,9,0,10,1
1653433731389,DSE 200,A00,091799,Staff,50,0,50,0
1653433731912,DSE 203,A00,091800,Gupta; Amarnath,30,0,30,0
1653433732442,DSE 250,A00,091801,Deutsch; Alin Bernard,30,0,30,0
1653433732965,DSE 290,A00,091802,Altintas De Callaf; Ilkay,50,0,50,0
1653433733524,ECE 200,001,091003,Antipa; Nicholas A,9999,0,9999,0
1653433733524,ECE 200,002,091004,Atanasov; Nikolay A.,9999,0,9999,0
1653433733524,ECE 200,003,091005,Bharadia; Dinesh,9999,0,9999,0
1653433733524,ECE 200,004,091006,Cheng; Chung Kuan,9999,0,9999,0
1653433733524,ECE 200,005,091007,Cosman; Pamela C.,9999,0,9999,0
1653433733524,ECE 200,006,091008,Staff,9999,0,9999,0
1653433733524,ECE 200,007,091009,Dayeh; Shadi Ahmad,9999,0,9999,0
1653433733524,ECE 200,008,091010,Fainman; Yeshaiahu,9999,0,9999,0
1653433733524,ECE 200,009,091011,Ford; Joseph Earl,9999,0,9999,0
1653433733524,ECE 200,010,091012,Franceschetti; Massimo,9999,0,9999,0
1653433733524,ECE 200,011,091013,Fullerton; Eric E,9999,0,9999,0
1653433733524,ECE 200,012,091014,Galton; Ian A,9999,0,9999,0
1653433733524,ECE 200,013,091015,Gilja; Vikash,9999,0,9999,0
1653433733524,ECE 200,014,091016,Hall; Drew A.,9999,0,9999,0
1653433733524,ECE 200,015,091017,Hsueh; Tzu-Chien,9999,0,9999,0
1653433733524,ECE 200,016,091018,Javidi; Tara,9999,0,9999,0
1653433733524,ECE 200,017,091019,Kahng; Andrew Byun,9999,0,9999,0
1653433733524,ECE 200,018,091020,Kim; Young-Han,9999,0,9999,0
1653433733524,ECE 200,019,091021,Koushanfar; Farinaz,9999,0,9999,0
1653433733524,ECE 200,020,091022,Kuzum; Duygu,9999,0,9999,0
1653433733524,ECE 200,021,091023,Le; Hanh-Phuc,9999,0,9999,0
1653433733524,ECE 200,022,091024,Lin; Bill,9999,0,9999,0
1653433733524,ECE 200,023,091025,Liu; Zhaowei,9999,0,9999,0
1653433733524,ECE 200,024,091026,Lo; Yu-Hwa,9999,0,9999,0
1653433733524,ECE 200,025,091027,Lomakin; Vitaliy,9999,0,9999,0
1653433733524,ECE 200,026,091028,Mercier; Patrick Philip,9999,0,9999,0
1653433733524,ECE 200,027,091029,Meyer; Florian,9999,0,9999,0
1653433733524,ECE 200,028,091030,Milstein; Laurence B.,9999,0,9999,0
1653433733524,ECE 200,029,091031,Mir Arabbaygi; Siavash,9999,0,9999,0
1653433733524,ECE 200,030,091032,Mookherjea; Shayan,9999,0,9999,0
1653433733524,ECE 200,031,091033,Morris; Karcher William,9999,0,9999,0
1653433733524,ECE 200,032,091034,Ng; Tse Nga,9999,0,9999,0
1653433733524,ECE 200,033,091035,Nguyen; Truong Quang,9999,0,9999,0
1653433733524,ECE 200,034,091036,Nomura; Kenji,9999,0,9999,0
1653433733524,ECE 200,035,091037,Orlitsky; Alon,9999,0,9999,0
1653433733524,ECE 200,036,091038,Pal; Piya,9999,0,9999,0
1653433733524,ECE 200,037,091039,Papen; George C.,9999,0,9999,0
1653433733524,ECE 200,038,091040,Radic; Stojan,9999,0,9999,0
1653433733524,ECE 200,039,091041,Rao; Bhaskar D.,9999,0,9999,0
1653433733524,ECE 200,040,091042,Rao; Ramesh R,9999,0,9999,0
1653433733524,ECE 200,041,091043,Rebeiz; Gabriel,9999,0,9999,0
1653433733524,ECE 200,042,091044,Sanford; John R,9999,0,9999,0
1653433733524,ECE 200,043,091045,Siegel; Paul H.,9999,0,9999,0
1653433733524,ECE 200,044,091046,Sievenpiper; Daniel F.,9999,0,9999,0
1653433733524,ECE 200,045,091047,Sworder; David D.,9999,0,9999,0
1653433733524,ECE 200,046,091048,Taur; Yuan,9999,0,9999,0
1653433733524,ECE 200,047,091049,Touri; Behrouz,9999,0,9999,0
1653433733524,ECE 200,048,091050,Trivedi; Mohan M.,9999,0,9999,0
1653433733524,ECE 200,049,091051,Vardy; Alexander,9999,0,9999,0
1653433733524,ECE 200,050,091052,Vasconcelos; Nuno,9999,0,9999,0
1653433733524,ECE 200,051,091053,Wang; Xiaolong,9999,0,9999,0
1653433733524,ECE 200,052,091054,Xie; Pengtao,9999,0,9999,0
1653433733524,ECE 200,053,091055,Yip; Michael,9999,0,9999,0
1653433733524,ECE 200,054,091056,Zeger; Kenneth A.,9999,0,9999,0
1653433733524,ECE 200,055,091057,Zhang; Xinyu,9999,0,9999,0
1653433733524,ECE 200,056,091058,Turakhia; Yatish Girish,9999,0,9999,0
1653433733524,ECE 200,057,091059,Kang; Mingu,9999,0,9999,0
1653433733524,ECE 200,058,091060,Shi; Yuanyuan,9999,0,9999,0
1653433733524,ECE 200,059,091061,Wang; Edward Jay,9999,0,9999,0
1653433733524,ECE 200,060,091062,Zheng; Yang,9999,0,9999,0
1653433734050,ECE 203,A00,091065,Mercier; Patrick Philip,0,0,0,0
1653433734577,ECE 207A,A00,091605,Liu; Thomas Tao-Ming,0,0,0,0
1653433735099,ECE 212AN,A00,091068,Nomura; Kenji,0,0,0,0
1653433735625,ECE 222A,A00,091069,Rebeiz; Gabriel,0,0,0,0
1653433736161,ECE 225A,A00,091070,Orlitsky; Alon,0,0,0,0
1653433736699,ECE 230A,A00,091071,Nomura; Kenji,0,0,0,0
1653433737231,ECE 236A,A00,091072,Dayeh; Shadi Ahmad,0,0,0,0
1653433737754,ECE 238A,A00,091073,Luo; Jian,0,0,0,0
1653433737754,ECE 238A,B00,091074,Luo; Jian,0,0,0,0
1653433738285,ECE 240A,A00,091075,Radic; Stojan,0,0,0,0
1653433738813,ECE 247A,A00,091592,Shi; Lingyan,0,0,0,0
1653433739336,ECE 250,A00,091076,Touri; Behrouz,0,0,0,0
1653433739869,ECE 251C,A00,091078,Nguyen; Truong Quang,0,0,0,0
1653433740411,ECE 253,A00,091079,Cosman; Pamela C.,0,0,0,0
1653433740944,ECE 255A,A00,091080,Orlitsky; Alon,0,0,0,0
1653433741466,ECE 257A,A00,091081,Zhang; Xinyu,0,0,0,0
1653433741992,ECE 260A,A01,091084,Eldon; John,0,0,0,0
1653433742522,ECE 264C,A00,091085,Galton; Ian A,0,0,0,0
1653433743049,ECE 265C,A00,094889,Presti; Calogero Davide,0,0,0,9
1653433743594,ECE 266,A01,091087,Hall; Drew A.,0,0,0,0
1653433744662,ECE 271A,A00,091090,Vasconcelos; Nuno,0,0,0,0
1653433745186,ECE 272B,A00,091091,Sworder; David D.,0,0,0,0
1653433745709,ECE 275A,A00,091092,Meyer; Florian,0,0,0,0
1653433746238,ECE 277,A00,091093,An; Cheolhong,0,0,0,0
1653433746780,ECE 283,A00,091094,Le; Hanh-Phuc,0,0,0,0
1653433747303,ECE 284,A00,091095,Kang; Mingu,0,0,0,0
1653433747303,ECE 284,B00,091096,Wang; Edward Jay,0,0,0,0
1653433747827,ECE 285,A00,094334,Touri; Behrouz,0,0,0,0
1653433748364,ECE 289,A00,091097,Whelan; David Arthur,0,0,0,0
1653433748897,MATH 200A,A00,087414,Salehi Golsefidy; Alireza,7,0,8,1
1653433749423,MATH 202A,A00,087415,Gill; Philip E.,3,0,8,5
1653433749953,MATH 203A,A00,087416,Oprea; Dragos N.,6,0,8,2
1653433750496,MATH 204A,A00,087417,Kedlaya; Kiran S.,6,0,8,2
1653433751019,MATH 205,A00,087418,Sorensen; Claus M,6,0,8,2
1653433751540,MATH 206A,A00,087419,Izadi; Elham,7,0,8,1
1653433752065,MATH 207A,A00,087420,Mohammadi; Amir,6,0,8,2
1653433752601,MATH 208,A00,087421,Staff,9,0,10,1
1653433753135,MATH 209,A00,087422,Staff,10,0,10,0
1653433753677,MATH 218,A00,087423,Staff,10,0,10,0
1653433754223,MATH 220A,A00,087424,Novak; Jonathan I,7,0,8,1
1653433754757,MATH 231A,A00,087425,Bejenaru; Ioan,4,0,8,4
1653433755288,MATH 240A,A00,087426,Ebenfelt; Peter F,5,0,8,3
1653433755815,MATH 243,A00,087427,Staff,9,0,10,1
1653433756338,MATH 248,A00,087429,Staff,10,0,10,0
1653433756863,MATH 250A,A00,087430,Spolaor; Luca,5,0,8,3
1653433757393,MATH 257A,A00,087431,Spolaor; Luca,7,0,8,1
1653433757920,MATH 258,A00,087432,Staff,9,0,10,1
1653433758445,MATH 264A,A00,087433,Warnke; Lutz Peter,5,0,8,3
1653433758982,MATH 268,A00,087434,Staff,15,0,15,0
1653433759515,MATH 269,A00,087435,Staff,14,0,15,1
1653433760052,MATH 270A,A00,087436,Nie; Jiawang,0,0,8,8
1653433760580,MATH 272A,A00,087437,Tian; Xiaochuan,1,0,8,7
1653433761109,MATH 274,A01,087439,Cheng; Li-Tien,9,0,10,1
1653433761109,MATH 274,A02,087440,Cheng; Li-Tien,10,0,10,0
1653433761647,MATH 278A,A00,087441,Staff,8,0,10,2
1653433762170,MATH 278B,A00,087442,Staff,8,0,10,2
1653433762694,MATH 278C,A00,087443,Staff,8,0,10,2
1653433763216,MATH 280A,A00,087444,Zheng; Tianyi,0,0,8,8
1653433763743,MATH 281A,A00,087445,Bradic; Jelena,0,0,8,8
1653433764265,MATH 282A,A00,087446,Zhang; Danna,0,0,8,8
1653433764798,MATH 283,A00,087447,Tesler; Glenn,0,0,0,14
1653433765324,MATH 286,A00,087448,Kemp; Todd Aahron,6,0,8,2
1653433765865,MATH 287D,A00,087449,Bradic; Jelena,8,0,8,0
1653433766393,MATH 288,A00,087450,Staff,14,0,15,1
1653433766393,MATH 288,B00,087451,Staff,15,0,15,0
1653433766393,MATH 288,C00,087452,Staff,15,0,15,0
1653433766914,MATH 290A,A00,087453,Xu; Zhouli,7,0,8,1
1653433767441,MATH 291A,A00,087454,Xu; Zhouli,7,0,8,1
1653433767968,MATH 292,A00,087455,Staff,10,0,10,0
1653433768510,MATH 295,A00,087456,Staff,50,0,50,0
1653433769039,MATH 297,001,087457,Staff,998,0,999,1
1653434334245,COGS 200,A01,087991,Staff,47,0,50,3
1653434334770,COGS 201,A01,094504,Rangel; Lara M,17,0,25,8
1653434335291,COGS 203,A00,087992,Coulson; Seana M,18,0,20,2
1653434335814,COGS 210A,001,087993,Greene; Deanna Jacquelyn,9998,0,9999,1
1653434335814,COGS 210A,002,087994,Saygin; Ayse P,9999,0,9999,0
1653434335814,COGS 210A,003,087995,Xia; Haijun,9999,0,9999,0
1653434335814,COGS 210A,004,087996,Nitz; Douglas A.,9999,0,9999,0
1653434335814,COGS 210A,005,087997,Hollan; James D.,9999,0,9999,0
1653434335814,COGS 210A,006,087998,Deak; Gedeon O.,9998,0,9999,1
1653434335814,COGS 210A,007,087999,Rossano; Federico,9999,0,9999,0
1653434336346,COGS 211A,A00,088000,Coulson; Seana M,9997,0,9999,2
1653434336872,COGS 229,A00,088002,Staff,23,0,25,2
1653434337415,COGS 260,B00,094231,Staff,17,0,20,3
1653434337415,COGS 260,A00,088004,Nitz; Douglas A.,9998,0,9999,1
1653434337940,CSE 202,A00,090110,Paturi; Ramamohan,0,0,0,0
1653434337940,CSE 202,B00,090111,Paturi; Ramamohan,0,0,0,0
1653434338469,CSE 207B,A00,090112,Heninger; Nadia A,0,0,0,0
1653434338997,CSE 208,A00,094858,Micciancio; Daniele,0,0,0,0
1653434339520,CSE 210,A00,090113,Powell; Thomas Allan,0,0,0,0
1653434340059,CSE 219,A00,090898,Staff,0,0,0,0
1653434340590,CSE 221,A00,090114,Zhou; Yuan-Yuan,0,0,0,0
1653434341123,CSE 229A,A00,090115,Porter; George M,0,0,0,0
1653434341651,CSE 229C,A00,090116,Savage; Stefan,0,0,0,0
1653434342181,CSE 230,A00,090117,Jhala; Ranjit,0,0,0,0
1653434342710,CSE 232,A00,090118,Papakonstantinou; Yannis,0,0,0,0
1653434343236,CSE 239A,A00,090121,Kumar; Arun Kumar,0,0,0,0
1653434343772,CSE 239B,A00,090122,Jhala; Ranjit,0,0,0,0
1653434344298,CSE 240A,A00,090123,Zhao; Jishen,0,0,189,189
1653434344827,CSE 243A,A00,090124,Orailoglu; Alex,3,0,15,12
1653434345350,CSE 249B,A00,090125,Kahng; Andrew Byun,13,0,20,7
1653434345874,CSE 250A,A00,090126,Berg-Kirkpatrick; Taylor D,0,0,0,0
1653434346397,CSE 252A,A00,090127,Ochoa; Benjamin Lawrence,0,0,0,0
1653434346926,CSE 258,A01,090129,McAuley; Julian John,0,0,0,0
1653434347466,CSE 258R,A01,090131,McAuley; Julian John,0,0,0,0
1653434347997,CSE 274,A00,090132,Ramamoorthi; Ravi,0,0,0,0
1653434348521,CSE 276A,A00,090133,Christensen; Henrik I,0,0,0,0
1653434349070,CSE 276C,A00,090134,Christensen; Henrik I,0,0,0,0
1653434349604,CSE 290,A00,090135,Bafna; Vineet,0,0,0,0
1653434349604,CSE 290,B00,090136,Ramamoorthi; Ravi,0,0,0,0
1653434349604,CSE 290,C00,090137,Li; Tzumao,9,0,10,1
1653434349604,CSE 290,D00,090138,Zhou; Yuan-Yuan,10,0,10,0
1653434349604,CSE 290,E00,090139,Christensen; Henrik I,10,0,10,0
1653434349604,CSE 290,F00,094053,Shalev; Aaron D,0,0,0,0
1653434350132,CSE 291,A00,090140,Munyaka; Imani N. S.,0,0,0,0
1653434350132,CSE 291,B00,094880,Yu; Qi,0,0,0,0
1653434350132,CSE 291,C00,090142,Pannuto; Patrick William,0,0,0,0
1653434350132,CSE 291,D00,094881,Zhang; Yiying,0,0,0,0
1653434350132,CSE 291,E00,095118,Su; Hao,0,0,0,0
1653434350666,CSE 293,001,094905,Bafna; Vineet,9999,0,9999,0
1653434350666,CSE 293,002,094906,Bellare; Mihir,9999,0,9999,0
1653434350666,CSE 293,003,094907,Berg-Kirkpatrick; Taylor D,9999,0,9999,0
1653434350666,CSE 293,004,094908,Christensen; Henrik I,9999,0,9999,0
1653434350666,CSE 293,005,094909,Cottrell; Garrison W,9999,0,9999,0
1653434350666,CSE 293,006,094910,Deutsch; Alin Bernard,9999,0,9999,0
1653434350666,CSE 293,007,094911,Esmaeilzadeh; Hadi,9999,0,9999,0
1653434350666,CSE 293,008,094912,Freund; Yoav,9999,0,9999,0
1653434350666,CSE 293,009,094913,Griswold; William G.,9999,0,9999,0
1653434350666,CSE 293,010,094914,Gymrek; Melissa Ann,9999,0,9999,0
1653434350666,CSE 293,011,094915,Heninger; Nadia A,9999,0,9999,0
1653434350666,CSE 293,012,094916,Impagliazzo; Russell,9999,0,9999,0
1653434350666,CSE 293,013,094917,Jhala; Ranjit,9999,0,9999,0
1653434350666,CSE 293,014,094918,Kahng; Andrew Byun,9999,0,9999,0
1653434350666,CSE 293,015,094919,Kane; Daniel Mertz,9999,0,9999,0
1653434350666,CSE 293,016,094920,Kriegman; David J,9999,0,9999,0
1653434350666,CSE 293,017,094921,Kumar; Arun Kumar,9999,0,9999,0
1653434350666,CSE 293,018,094922,Lerner; Sorin,9999,0,9999,0
1653434350666,CSE 293,019,094923,Lovett; Shachar,9999,0,9999,0
1653434350666,CSE 293,020,094924,McAuley; Julian John,9999,0,9999,0
1653434350666,CSE 293,021,094925,Micciancio; Daniele,9999,0,9999,0
1653434350666,CSE 293,022,094926,Orailoglu; Alex,9999,0,9999,0
1653434350666,CSE 293,023,094927,Paturi; Ramamohan,9999,0,9999,0
1653434350666,CSE 293,024,094928,Polikarpova; Nadezhda,9999,0,9999,0
1653434350666,CSE 293,025,094929,Politz; Joseph Gibbs,9999,0,9999,0
1653434350666,CSE 293,026,094930,Porter; George M,9999,0,9999,0
1653434350666,CSE 293,027,094931,Porter; Leonard Emerson,9999,0,9999,0
1653434350666,CSE 293,028,094932,Ramamoorthi; Ravi,9999,0,9999,0
1653434350666,CSE 293,029,094933,Sahoo; Debashis,9999,0,9999,0
1653434350666,CSE 293,030,094934,Saul; Lawrence,9999,0,9999,0
1653434350666,CSE 293,031,094935,Savage; Stefan,9999,0,9999,0
1653434350666,CSE 293,032,094936,Schulze; Jurgen P.,9999,0,9999,0
1653434350666,CSE 293,033,094937,Snoeren; Alex C.,9999,0,9999,0
1653434350666,CSE 293,034,094938,Shang; Jingbo,9999,0,9999,0
1653434350666,CSE 293,035,094939,Stefan; Deian,9999,0,9999,0
1653434350666,CSE 293,036,094940,Su; Hao,9999,0,9999,0
1653434350666,CSE 293,037,094941,Swanson; Steven James,9999,0,9999,0
1653434350666,CSE 293,038,094942,Tullsen; Dean Michael,9999,0,9999,0
1653434350666,CSE 293,039,094943,Voelker; Geoffrey M.,9999,0,9999,0
1653434350666,CSE 293,040,094944,Zhao; Jishen,9999,0,9999,0
1653434350666,CSE 293,041,094945,Zhou; Yuan-Yuan,9999,0,9999,0
1653434350666,CSE 293,042,094946,Gao; Sicun,9998,0,9999,1
1653434350666,CSE 293,043,094947,Weibel; Nadir,9999,0,9999,0
1653434350666,CSE 293,044,094948,Gupta; Rajesh K.,9999,0,9999,0
1653434351194,CSE 294,A00,090143,Porter; George M,9,0,10,1
1653434351718,DSE 200,A00,091799,Staff,50,0,50,0
1653434352249,DSE 203,A00,091800,Gupta; Amarnath,30,0,30,0
1653434352776,DSE 250,A00,091801,Deutsch; Alin Bernard,30,0,30,0
1653434353300,DSE 290,A00,091802,Altintas De Callaf; Ilkay,50,0,50,0
1653434353886,ECE 200,001,091003,Antipa; Nicholas A,9999,0,9999,0
1653434353886,ECE 200,002,091004,Atanasov; Nikolay A.,9999,0,9999,0
1653434353886,ECE 200,003,091005,Bharadia; Dinesh,9999,0,9999,0
1653434353886,ECE 200,004,091006,Cheng; Chung Kuan,9999,0,9999,0
1653434353886,ECE 200,005,091007,Cosman; Pamela C.,9999,0,9999,0
1653434353886,ECE 200,006,091008,Staff,9999,0,9999,0
1653434353886,ECE 200,007,091009,Dayeh; Shadi Ahmad,9999,0,9999,0
1653434353886,ECE 200,008,091010,Fainman; Yeshaiahu,9999,0,9999,0
1653434353886,ECE 200,009,091011,Ford; Joseph Earl,9999,0,9999,0
1653434353886,ECE 200,010,091012,Franceschetti; Massimo,9999,0,9999,0
1653434353886,ECE 200,011,091013,Fullerton; Eric E,9999,0,9999,0
1653434353886,ECE 200,012,091014,Galton; Ian A,9999,0,9999,0
1653434353886,ECE 200,013,091015,Gilja; Vikash,9999,0,9999,0
1653434353886,ECE 200,014,091016,Hall; Drew A.,9999,0,9999,0
1653434353886,ECE 200,015,091017,Hsueh; Tzu-Chien,9999,0,9999,0
1653434353886,ECE 200,016,091018,Javidi; Tara,9999,0,9999,0
1653434353886,ECE 200,017,091019,Kahng; Andrew Byun,9999,0,9999,0
1653434353886,ECE 200,018,091020,Kim; Young-Han,9999,0,9999,0
1653434353886,ECE 200,019,091021,Koushanfar; Farinaz,9999,0,9999,0
1653434353886,ECE 200,020,091022,Kuzum; Duygu,9999,0,9999,0
1653434353886,ECE 200,021,091023,Le; Hanh-Phuc,9999,0,9999,0
1653434353886,ECE 200,022,091024,Lin; Bill,9999,0,9999,0
1653434353886,ECE 200,023,091025,Liu; Zhaowei,9999,0,9999,0
1653434353886,ECE 200,024,091026,Lo; Yu-Hwa,9999,0,9999,0
1653434353886,ECE 200,025,091027,Lomakin; Vitaliy,9999,0,9999,0
1653434353886,ECE 200,026,091028,Mercier; Patrick Philip,9999,0,9999,0
1653434353886,ECE 200,027,091029,Meyer; Florian,9999,0,9999,0
1653434353886,ECE 200,028,091030,Milstein; Laurence B.,9999,0,9999,0
1653434353886,ECE 200,029,091031,Mir Arabbaygi; Siavash,9999,0,9999,0
1653434353886,ECE 200,030,091032,Mookherjea; Shayan,9999,0,9999,0
1653434353886,ECE 200,031,091033,Morris; Karcher William,9999,0,9999,0
1653434353886,ECE 200,032,091034,Ng; Tse Nga,9999,0,9999,0
1653434353886,ECE 200,033,091035,Nguyen; Truong Quang,9999,0,9999,0
1653434353886,ECE 200,034,091036,Nomura; Kenji,9999,0,9999,0
1653434353886,ECE 200,035,091037,Orlitsky; Alon,9999,0,9999,0
1653434353886,ECE 200,036,091038,Pal; Piya,9999,0,9999,0
1653434353886,ECE 200,037,091039,Papen; George C.,9999,0,9999,0
1653434353886,ECE 200,038,091040,Radic; Stojan,9999,0,9999,0
1653434353886,ECE 200,039,091041,Rao; Bhaskar D.,9999,0,9999,0
1653434353886,ECE 200,040,091042,Rao; Ramesh R,9999,0,9999,0
1653434353886,ECE 200,041,091043,Rebeiz; Gabriel,9999,0,9999,0
1653434353886,ECE 200,042,091044,Sanford; John R,9999,0,9999,0
1653434353886,ECE 200,043,091045,Siegel; Paul H.,9999,0,9999,0
1653434353886,ECE 200,044,091046,Sievenpiper; Daniel F.,9999,0,9999,0
1653434353886,ECE 200,045,091047,Sworder; David D.,9999,0,9999,0
1653434353886,ECE 200,046,091048,Taur; Yuan,9999,0,9999,0
1653434353886,ECE 200,047,091049,Touri; Behrouz,9999,0,9999,0
1653434353886,ECE 200,048,091050,Trivedi; Mohan M.,9999,0,9999,0
1653434353886,ECE 200,049,091051,Vardy; Alexander,9999,0,9999,0
1653434353886,ECE 200,050,091052,Vasconcelos; Nuno,9999,0,9999,0
1653434353886,ECE 200,051,091053,Wang; Xiaolong,9999,0,9999,0
1653434353886,ECE 200,052,091054,Xie; Pengtao,9999,0,9999,0
1653434353886,ECE 200,053,091055,Yip; Michael,9999,0,9999,0
1653434353886,ECE 200,054,091056,Zeger; Kenneth A.,9999,0,9999,0
1653434353886,ECE 200,055,091057,Zhang; Xinyu,9999,0,9999,0
1653434353886,ECE 200,056,091058,Turakhia; Yatish Girish,9999,0,9999,0
1653434353886,ECE 200,057,091059,Kang; Mingu,9999,0,9999,0
1653434353886,ECE 200,058,091060,Shi; Yuanyuan,9999,0,9999,0
1653434353886,ECE 200,059,091061,Wang; Edward Jay,9999,0,9999,0
1653434353886,ECE 200,060,091062,Zheng; Yang,9999,0,9999,0
1653434354416,ECE 203,A00,091065,Mercier; Patrick Philip,0,0,0,0
1653434354938,ECE 207A,A00,091605,Liu; Thomas Tao-Ming,0,0,0,0
1653434355461,ECE 212AN,A00,091068,Nomura; Kenji,0,0,0,0
1653434355987,ECE 222A,A00,091069,Rebeiz; Gabriel,0,0,0,0
1653434356510,ECE 225A,A00,091070,Orlitsky; Alon,0,0,0,0
1653434357043,ECE 230A,A00,091071,Nomura; Kenji,0,0,0,0
1653434357569,ECE 236A,A00,091072,Dayeh; Shadi Ahmad,0,0,0,0
1653434358094,ECE 238A,A00,091073,Luo; Jian,0,0,0,0
1653434358094,ECE 238A,B00,091074,Luo; Jian,0,0,0,0
1653434358626,ECE 240A,A00,091075,Radic; Stojan,0,0,0,0
1653434359158,ECE 247A,A00,091592,Shi; Lingyan,0,0,0,0
1653434359679,ECE 250,A00,091076,Touri; Behrouz,0,0,0,0
1653434360202,ECE 251C,A00,091078,Nguyen; Truong Quang,0,0,0,0
1653434360729,ECE 253,A00,091079,Cosman; Pamela C.,0,0,0,0
1653434361269,ECE 255A,A00,091080,Orlitsky; Alon,0,0,0,0
1653434361797,ECE 257A,A00,091081,Zhang; Xinyu,0,0,0,0
1653434362321,ECE 260A,A01,091084,Eldon; John,0,0,0,0
1653434362847,ECE 264C,A00,091085,Galton; Ian A,0,0,0,0
1653434363375,ECE 265C,A00,094889,Presti; Calogero Davide,0,0,0,9
1653434363931,ECE 266,A01,091087,Hall; Drew A.,0,0,0,0
1653434364979,ECE 271A,A00,091090,Vasconcelos; Nuno,0,0,0,0
1653434365502,ECE 272B,A00,091091,Sworder; David D.,0,0,0,0
1653434366031,ECE 275A,A00,091092,Meyer; Florian,0,0,0,0
1653434366562,ECE 277,A00,091093,An; Cheolhong,0,0,0,0
1653434367091,ECE 283,A00,091094,Le; Hanh-Phuc,0,0,0,0
1653434367617,ECE 284,A00,091095,Kang; Mingu,0,0,0,0
1653434367617,ECE 284,B00,091096,Wang; Edward Jay,0,0,0,0
1653434368140,ECE 285,A00,094334,Touri; Behrouz,0,0,0,0
1653434368666,ECE 289,A00,091097,Whelan; David Arthur,0,0,0,0
1653434369192,MATH 200A,A00,087414,Salehi Golsefidy; Alireza,7,0,8,1
1653434369718,MATH 202A,A00,087415,Gill; Philip E.,3,0,8,5
1653434370258,MATH 203A,A00,087416,Oprea; Dragos N.,6,0,8,2
1653434370779,MATH 204A,A00,087417,Kedlaya; Kiran S.,6,0,8,2
1653434371303,MATH 205,A00,087418,Sorensen; Claus M,6,0,8,2
1653434371826,MATH 206A,A00,087419,Izadi; Elham,7,0,8,1
1653434372351,MATH 207A,A00,087420,Mohammadi; Amir,6,0,8,2
1653434372875,MATH 208,A00,087421,Staff,9,0,10,1
1653434373398,MATH 209,A00,087422,Staff,10,0,10,0
1653434373921,MATH 218,A00,087423,Staff,10,0,10,0
1653434374450,MATH 220A,A00,087424,Novak; Jonathan I,7,0,8,1
1653434374973,MATH 231A,A00,087425,Bejenaru; Ioan,4,0,8,4
1653434375496,MATH 240A,A00,087426,Ebenfelt; Peter F,5,0,8,3
1653434376020,MATH 243,A00,087427,Staff,9,0,10,1
1653434376563,MATH 248,A00,087429,Staff,10,0,10,0
1653434377173,MATH 250A,A00,087430,Spolaor; Luca,5,0,8,3
1653434377718,MATH 257A,A00,087431,Spolaor; Luca,7,0,8,1
1653434378248,MATH 258,A00,087432,Staff,9,0,10,1
1653434378778,MATH 264A,A00,087433,Warnke; Lutz Peter,5,0,8,3
1653434379312,MATH 268,A00,087434,Staff,15,0,15,0
1653434379851,MATH 269,A00,087435,Staff,14,0,15,1
1653434380374,MATH 270A,A00,087436,Nie; Jiawang,0,0,8,8
1653434380927,MATH 272A,A00,087437,Tian; Xiaochuan,1,0,8,7
1653434381458,MATH 274,A01,087439,Cheng; Li-Tien,9,0,10,1
1653434381458,MATH 274,A02,087440,Cheng; Li-Tien,10,0,10,0
1653434381982,MATH 278A,A00,087441,Staff,8,0,10,2
1653434382512,MATH 278B,A00,087442,Staff,8,0,10,2
1653434383041,MATH 278C,A00,087443,Staff,8,0,10,2
1653434383562,MATH 280A,A00,087444,Zheng; Tianyi,0,0,8,8
1653434384097,MATH 281A,A00,087445,Bradic; Jelena,0,0,8,8
1653434384624,MATH 282A,A00,087446,Zhang; Danna,0,0,8,8
1653434385159,MATH 283,A00,087447,Tesler; Glenn,0,0,0,14
1653434385683,MATH 286,A00,087448,Kemp; Todd Aahron,6,0,8,2
1653434386224,MATH 287D,A00,087449,Bradic; Jelena,8,0,8,0
1653434386749,MATH 288,A00,087450,Staff,14,0,15,1
1653434386749,MATH 288,B00,087451,Staff,15,0,15,0
1653434386749,MATH 288,C00,087452,Staff,15,0,15,0
1653434387285,MATH 290A,A00,087453,Xu; Zhouli,7,0,8,1
1653434387808,MATH 291A,A00,087454,Xu; Zhouli,7,0,8,1
1653434388338,MATH 292,A00,087455,Staff,10,0,10,0
1653434388860,MATH 295,A00,087456,Staff,50,0,50,0
1653434389382,MATH 297,001,087457,Staff,998,0,999,1
1653434964805,COGS 200,A01,087991,Staff,47,0,50,3
1653434965330,COGS 201,A01,094504,Rangel; Lara M,17,0,25,8
1653434965853,COGS 203,A00,087992,Coulson; Seana M,18,0,20,2
1653434966376,COGS 210A,001,087993,Greene; Deanna Jacquelyn,9998,0,9999,1
1653434966376,COGS 210A,002,087994,Saygin; Ayse P,9999,0,9999,0
1653434966376,COGS 210A,003,087995,Xia; Haijun,9999,0,9999,0
1653434966376,COGS 210A,004,087996,Nitz; Douglas A.,9999,0,9999,0
1653434966376,COGS 210A,005,087997,Hollan; James D.,9999,0,9999,0
1653434966376,COGS 210A,006,087998,Deak; Gedeon O.,9998,0,9999,1
1653434966376,COGS 210A,007,087999,Rossano; Federico,9999,0,9999,0
1653434966906,COGS 211A,A00,088000,Coulson; Seana M,9997,0,9999,2
1653434967429,COGS 229,A00,088002,Staff,23,0,25,2
1653434967960,COGS 260,B00,094231,Staff,17,0,20,3
1653434967960,COGS 260,A00,088004,Nitz; Douglas A.,9998,0,9999,1
1653434968487,CSE 202,A00,090110,Paturi; Ramamohan,0,0,0,0
1653434968487,CSE 202,B00,090111,Paturi; Ramamohan,0,0,0,0
1653434969010,CSE 207B,A00,090112,Heninger; Nadia A,0,0,0,0
1653434969539,CSE 208,A00,094858,Micciancio; Daniele,0,0,0,0
1653434970078,CSE 210,A00,090113,Powell; Thomas Allan,0,0,0,0
1653434970608,CSE 219,A00,090898,Staff,0,0,0,0
1653434971134,CSE 221,A00,090114,Zhou; Yuan-Yuan,0,0,0,0
1653434971667,CSE 229A,A00,090115,Porter; George M,0,0,0,0
1653434972194,CSE 229C,A00,090116,Savage; Stefan,0,0,0,0
1653434972729,CSE 230,A00,090117,Jhala; Ranjit,0,0,0,0
1653434973256,CSE 232,A00,090118,Papakonstantinou; Yannis,0,0,0,0
1653434973791,CSE 239A,A00,090121,Kumar; Arun Kumar,0,0,0,0
1653434974327,CSE 239B,A00,090122,Jhala; Ranjit,0,0,0,0
1653434974850,CSE 240A,A00,090123,Zhao; Jishen,0,0,189,189
1653434975376,CSE 243A,A00,090124,Orailoglu; Alex,3,0,15,12
1653434975912,CSE 249B,A00,090125,Kahng; Andrew Byun,13,0,20,7
1653434976434,CSE 250A,A00,090126,Berg-Kirkpatrick; Taylor D,0,0,0,0
1653434976961,CSE 252A,A00,090127,Ochoa; Benjamin Lawrence,0,0,0,0
1653434977486,CSE 258,A01,090129,McAuley; Julian John,0,0,0,0
1653434978020,CSE 258R,A01,090131,McAuley; Julian John,0,0,0,0
1653434978550,CSE 274,A00,090132,Ramamoorthi; Ravi,0,0,0,0
1653434979080,CSE 276A,A00,090133,Christensen; Henrik I,0,0,0,0
1653434979605,CSE 276C,A00,090134,Christensen; Henrik I,0,0,0,0
1653434980218,CSE 290,A00,090135,Bafna; Vineet,0,0,0,0
1653434980218,CSE 290,B00,090136,Ramamoorthi; Ravi,0,0,0,0
1653434980218,CSE 290,C00,090137,Li; Tzumao,9,0,10,1
1653434980218,CSE 290,D00,090138,Zhou; Yuan-Yuan,10,0,10,0
1653434980218,CSE 290,E00,090139,Christensen; Henrik I,10,0,10,0
1653434980218,CSE 290,F00,094053,Shalev; Aaron D,0,0,0,0
1653434980740,CSE 291,A00,090140,Munyaka; Imani N. S.,0,0,0,0
1653434980740,CSE 291,B00,094880,Yu; Qi,0,0,0,0
1653434980740,CSE 291,C00,090142,Pannuto; Patrick William,0,0,0,0
1653434980740,CSE 291,D00,094881,Zhang; Yiying,0,0,0,0
1653434980740,CSE 291,E00,095118,Su; Hao,0,0,0,0
1653434981305,CSE 293,001,094905,Bafna; Vineet,9999,0,9999,0
1653434981305,CSE 293,002,094906,Bellare; Mihir,9999,0,9999,0
1653434981305,CSE 293,003,094907,Berg-Kirkpatrick; Taylor D,9999,0,9999,0
1653434981305,CSE 293,004,094908,Christensen; Henrik I,9999,0,9999,0
1653434981305,CSE 293,005,094909,Cottrell; Garrison W,9999,0,9999,0
1653434981305,CSE 293,006,094910,Deutsch; Alin Bernard,9999,0,9999,0
1653434981305,CSE 293,007,094911,Esmaeilzadeh; Hadi,9999,0,9999,0
1653434981305,CSE 293,008,094912,Freund; Yoav,9999,0,9999,0
1653434981305,CSE 293,009,094913,Griswold; William G.,9999,0,9999,0
1653434981305,CSE 293,010,094914,Gymrek; Melissa Ann,9999,0,9999,0
1653434981305,CSE 293,011,094915,Heninger; Nadia A,9999,0,9999,0
1653434981305,CSE 293,012,094916,Impagliazzo; Russell,9999,0,9999,0
1653434981305,CSE 293,013,094917,Jhala; Ranjit,9999,0,9999,0
1653434981305,CSE 293,014,094918,Kahng; Andrew Byun,9999,0,9999,0
1653434981305,CSE 293,015,094919,Kane; Daniel Mertz,9999,0,9999,0
1653434981305,CSE 293,016,094920,Kriegman; David J,9999,0,9999,0
1653434981305,CSE 293,017,094921,Kumar; Arun Kumar,9999,0,9999,0
1653434981305,CSE 293,018,094922,Lerner; Sorin,9999,0,9999,0
1653434981305,CSE 293,019,094923,Lovett; Shachar,9999,0,9999,0
1653434981305,CSE 293,020,094924,McAuley; Julian John,9999,0,9999,0
1653434981305,CSE 293,021,094925,Micciancio; Daniele,9999,0,9999,0
1653434981305,CSE 293,022,094926,Orailoglu; Alex,9999,0,9999,0
1653434981305,CSE 293,023,094927,Paturi; Ramamohan,9999,0,9999,0
1653434981305,CSE 293,024,094928,Polikarpova; Nadezhda,9999,0,9999,0
1653434981305,CSE 293,025,094929,Politz; Joseph Gibbs,9999,0,9999,0
1653434981305,CSE 293,026,094930,Porter; George M,9999,0,9999,0
1653434981305,CSE 293,027,094931,Porter; Leonard Emerson,9999,0,9999,0
1653434981305,CSE 293,028,094932,Ramamoorthi; Ravi,9999,0,9999,0
1653434981305,CSE 293,029,094933,Sahoo; Debashis,9999,0,9999,0
1653434981305,CSE 293,030,094934,Saul; Lawrence,9999,0,9999,0
1653434981305,CSE 293,031,094935,Savage; Stefan,9999,0,9999,0
1653434981305,CSE 293,032,094936,Schulze; Jurgen P.,9999,0,9999,0
1653434981305,CSE 293,033,094937,Snoeren; Alex C.,9999,0,9999,0
1653434981305,CSE 293,034,094938,Shang; Jingbo,9999,0,9999,0
1653434981305,CSE 293,035,094939,Stefan; Deian,9999,0,9999,0
1653434981305,CSE 293,036,094940,Su; Hao,9999,0,9999,0
1653434981305,CSE 293,037,094941,Swanson; Steven James,9999,0,9999,0
1653434981305,CSE 293,038,094942,Tullsen; Dean Michael,9999,0,9999,0
1653434981305,CSE 293,039,094943,Voelker; Geoffrey M.,9999,0,9999,0
1653434981305,CSE 293,040,094944,Zhao; Jishen,9999,0,9999,0
1653434981305,CSE 293,041,094945,Zhou; Yuan-Yuan,9999,0,9999,0
1653434981305,CSE 293,042,094946,Gao; Sicun,9998,0,9999,1
1653434981305,CSE 293,043,094947,Weibel; Nadir,9999,0,9999,0
1653434981305,CSE 293,044,094948,Gupta; Rajesh K.,9999,0,9999,0
1653434981829,CSE 294,A00,090143,Porter; George M,9,0,10,1
1653434982354,DSE 200,A00,091799,Staff,50,0,50,0
1653434982877,DSE 203,A00,091800,Gupta; Amarnath,30,0,30,0
1653434983403,DSE 250,A00,091801,Deutsch; Alin Bernard,30,0,30,0
1653434983926,DSE 290,A00,091802,Altintas De Callaf; Ilkay,50,0,50,0
1653434984467,ECE 200,001,091003,Antipa; Nicholas A,9999,0,9999,0
1653434984467,ECE 200,002,091004,Atanasov; Nikolay A.,9999,0,9999,0
1653434984467,ECE 200,003,091005,Bharadia; Dinesh,9999,0,9999,0
1653434984467,ECE 200,004,091006,Cheng; Chung Kuan,9999,0,9999,0
1653434984467,ECE 200,005,091007,Cosman; Pamela C.,9999,0,9999,0
1653434984467,ECE 200,006,091008,Staff,9999,0,9999,0
1653434984467,ECE 200,007,091009,Dayeh; Shadi Ahmad,9999,0,9999,0
1653434984467,ECE 200,008,091010,Fainman; Yeshaiahu,9999,0,9999,0
1653434984467,ECE 200,009,091011,Ford; Joseph Earl,9999,0,9999,0
1653434984467,ECE 200,010,091012,Franceschetti; Massimo,9999,0,9999,0
1653434984467,ECE 200,011,091013,Fullerton; Eric E,9999,0,9999,0
1653434984467,ECE 200,012,091014,Galton; Ian A,9999,0,9999,0
1653434984467,ECE 200,013,091015,Gilja; Vikash,9999,0,9999,0
1653434984467,ECE 200,014,091016,Hall; Drew A.,9999,0,9999,0
1653434984467,ECE 200,015,091017,Hsueh; Tzu-Chien,9999,0,9999,0
1653434984467,ECE 200,016,091018,Javidi; Tara,9999,0,9999,0
1653434984467,ECE 200,017,091019,Kahng; Andrew Byun,9999,0,9999,0
1653434984467,ECE 200,018,091020,Kim; Young-Han,9999,0,9999,0
1653434984467,ECE 200,019,091021,Koushanfar; Farinaz,9999,0,9999,0
1653434984467,ECE 200,020,091022,Kuzum; Duygu,9999,0,9999,0
1653434984467,ECE 200,021,091023,Le; Hanh-Phuc,9999,0,9999,0
1653434984467,ECE 200,022,091024,Lin; Bill,9999,0,9999,0
1653434984467,ECE 200,023,091025,Liu; Zhaowei,9999,0,9999,0
1653434984467,ECE 200,024,091026,Lo; Yu-Hwa,9999,0,9999,0
1653434984467,ECE 200,025,091027,Lomakin; Vitaliy,9999,0,9999,0
1653434984467,ECE 200,026,091028,Mercier; Patrick Philip,9999,0,9999,0
1653434984467,ECE 200,027,091029,Meyer; Florian,9999,0,9999,0
1653434984467,ECE 200,028,091030,Milstein; Laurence B.,9999,0,9999,0
1653434984467,ECE 200,029,091031,Mir Arabbaygi; Siavash,9999,0,9999,0
1653434984467,ECE 200,030,091032,Mookherjea; Shayan,9999,0,9999,0
1653434984467,ECE 200,031,091033,Morris; Karcher William,9999,0,9999,0
1653434984467,ECE 200,032,091034,Ng; Tse Nga,9999,0,9999,0
1653434984467,ECE 200,033,091035,Nguyen; Truong Quang,9999,0,9999,0
1653434984467,ECE 200,034,091036,Nomura; Kenji,9999,0,9999,0
1653434984467,ECE 200,035,091037,Orlitsky; Alon,9999,0,9999,0
1653434984467,ECE 200,036,091038,Pal; Piya,9999,0,9999,0
1653434984467,ECE 200,037,091039,Papen; George C.,9999,0,9999,0
1653434984467,ECE 200,038,091040,Radic; Stojan,9999,0,9999,0
1653434984467,ECE 200,039,091041,Rao; Bhaskar D.,9999,0,9999,0
1653434984467,ECE 200,040,091042,Rao; Ramesh R,9999,0,9999,0
1653434984467,ECE 200,041,091043,Rebeiz; Gabriel,9999,0,9999,0
1653434984467,ECE 200,042,091044,Sanford; John R,9999,0,9999,0
1653434984467,ECE 200,043,091045,Siegel; Paul H.,9999,0,9999,0
1653434984467,ECE 200,044,091046,Sievenpiper; Daniel F.,9999,0,9999,0
1653434984467,ECE 200,045,091047,Sworder; David D.,9999,0,9999,0
1653434984467,ECE 200,046,091048,Taur; Yuan,9999,0,9999,0
1653434984467,ECE 200,047,091049,Touri; Behrouz,9999,0,9999,0
1653434984467,ECE 200,048,091050,Trivedi; Mohan M.,9999,0,9999,0
1653434984467,ECE 200,049,091051,Vardy; Alexander,9999,0,9999,0
1653434984467,ECE 200,050,091052,Vasconcelos; Nuno,9999,0,9999,0
1653434984467,ECE 200,051,091053,Wang; Xiaolong,9999,0,9999,0
1653434984467,ECE 200,052,091054,Xie; Pengtao,9999,0,9999,0
1653434984467,ECE 200,053,091055,Yip; Michael,9999,0,9999,0
1653434984467,ECE 200,054,091056,Zeger; Kenneth A.,9999,0,9999,0
1653434984467,ECE 200,055,091057,Zhang; Xinyu,9999,0,9999,0
1653434984467,ECE 200,056,091058,Turakhia; Yatish Girish,9999,0,9999,0
1653434984467,ECE 200,057,091059,Kang; Mingu,9999,0,9999,0
1653434984467,ECE 200,058,091060,Shi; Yuanyuan,9999,0,9999,0
1653434984467,ECE 200,059,091061,Wang; Edward Jay,9999,0,9999,0
1653434984467,ECE 200,060,091062,Zheng; Yang,9999,0,9999,0
1653434984997,ECE 203,A00,091065,Mercier; Patrick Philip,0,0,0,0
1653434985523,ECE 207A,A00,091605,Liu; Thomas Tao-Ming,0,0,0,0
1653434986055,ECE 212AN,A00,091068,Nomura; Kenji,0,0,0,0
1653434986590,ECE 222A,A00,091069,Rebeiz; Gabriel,0,0,0,0
1653434987115,ECE 225A,A00,091070,Orlitsky; Alon,0,0,0,0
1653434987650,ECE 230A,A00,091071,Nomura; Kenji,0,0,0,0
1653434988176,ECE 236A,A00,091072,Dayeh; Shadi Ahmad,0,0,0,0
1653434988700,ECE 238A,A00,091073,Luo; Jian,0,0,0,0
1653434988700,ECE 238A,B00,091074,Luo; Jian,0,0,0,0
1653434989226,ECE 240A,A00,091075,Radic; Stojan,0,0,0,0
1653434989752,ECE 247A,A00,091592,Shi; Lingyan,0,0,0,0
1653434990275,ECE 250,A00,091076,Touri; Behrouz,0,0,0,0
1653434990805,ECE 251C,A00,091078,Nguyen; Truong Quang,0,0,0,0
1653434991330,ECE 253,A00,091079,Cosman; Pamela C.,0,0,0,0
1653434991864,ECE 255A,A00,091080,Orlitsky; Alon,0,0,0,0
1653434992405,ECE 257A,A00,091081,Zhang; Xinyu,0,0,0,0
1653434992928,ECE 260A,A01,091084,Eldon; John,0,0,0,0
1653434993474,ECE 264C,A00,091085,Galton; Ian A,0,0,0,0
1653434994015,ECE 265C,A00,094889,Presti; Calogero Davide,0,0,0,9
1653434994543,ECE 266,A01,091087,Hall; Drew A.,0,0,0,0
1653434995595,ECE 271A,A00,091090,Vasconcelos; Nuno,0,0,0,0
1653434996123,ECE 272B,A00,091091,Sworder; David D.,0,0,0,0
1653434996648,ECE 275A,A00,091092,Meyer; Florian,0,0,0,0
1653434997171,ECE 277,A00,091093,An; Cheolhong,0,0,0,0
1653434997694,ECE 283,A00,091094,Le; Hanh-Phuc,0,0,0,0
1653434998217,ECE 284,A00,091095,Kang; Mingu,0,0,0,0
1653434998217,ECE 284,B00,091096,Wang; Edward Jay,0,0,0,0
1653434998740,ECE 285,A00,094334,Touri; Behrouz,0,0,0,0
1653434999263,ECE 289,A00,091097,Whelan; David Arthur,0,0,0,0
1653434999789,MATH 200A,A00,087414,Salehi Golsefidy; Alireza,7,0,8,1
1653435001273,MATH 202A,A00,087415,Gill; Philip E.,3,0,8,5
1653435001798,MATH 203A,A00,087416,Oprea; Dragos N.,6,0,8,2
1653435002331,MATH 204A,A00,087417,Kedlaya; Kiran S.,6,0,8,2
1653435002855,MATH 205,A00,087418,Sorensen; Claus M,6,0,8,2
1653435003504,MATH 206A,A00,087419,Izadi; Elham,7,0,8,1
1653435004028,MATH 207A,A00,087420,Mohammadi; Amir,6,0,8,2
1653435004550,MATH 208,A00,087421,Staff,9,0,10,1
1653435005073,MATH 209,A00,087422,Staff,10,0,10,0
1653435005601,MATH 218,A00,087423,Staff,10,0,10,0
1653435006143,MATH 220A,A00,087424,Novak; Jonathan I,7,0,8,1
1653435006672,MATH 231A,A00,087425,Bejenaru; Ioan,4,0,8,4
1653435007205,MATH 240A,A00,087426,Ebenfelt; Peter F,5,0,8,3
1653435007735,MATH 243,A00,087427,Staff,9,0,10,1
1653435008281,MATH 248,A00,087429,Staff,10,0,10,0
1653435008820,MATH 250A,A00,087430,Spolaor; Luca,5,0,8,3
1653435009362,MATH 257A,A00,087431,Spolaor; Luca,7,0,8,1
1653435009902,MATH 258,A00,087432,Staff,9,0,10,1
1653435010431,MATH 264A,A00,087433,Warnke; Lutz Peter,5,0,8,3
1653435010954,MATH 268,A00,087434,Staff,15,0,15,0
1653435011927,MATH 269,A00,087435,Staff,14,0,15,1
1653435012452,MATH 270A,A00,087436,Nie; Jiawang,0,0,8,8
1653435012982,MATH 272A,A00,087437,Tian; Xiaochuan,1,0,8,7
1653435013506,MATH 274,A01,087439,Cheng; Li-Tien,9,0,10,1
1653435013506,MATH 274,A02,087440,Cheng; Li-Tien,10,0,10,0
1653435014040,MATH 278A,A00,087441,Staff,8,0,10,2
1653435014575,MATH 278B,A00,087442,Staff,8,0,10,2
1653435015107,MATH 278C,A00,087443,Staff,8,0,10,2
1653435015636,MATH 280A,A00,087444,Zheng; Tianyi,0,0,8,8
1653435016165,MATH 281A,A00,087445,Bradic; Jelena,0,0,8,8
1653435016694,MATH 282A,A00,087446,Zhang; Danna,0,0,8,8
1653435017222,MATH 283,A00,087447,Tesler; Glenn,0,0,0,14
1653435017746,MATH 286,A00,087448,Kemp; Todd Aahron,6,0,8,2
1653435018297,MATH 287D,A00,087449,Bradic; Jelena,8,0,8,0
1653435018822,MATH 288,A00,087450,Staff,14,0,15,1
1653435018822,MATH 288,B00,087451,Staff,15,0,15,0
1653435018822,MATH 288,C00,087452,Staff,15,0,15,0
1653435019353,MATH 290A,A00,087453,Xu; Zhouli,7,0,8,1
1653435019885,MATH 291A,A00,087454,Xu; Zhouli,7,0,8,1
1653435020429,MATH 292,A00,087455,Staff,10,0,10,0
1653435020974,MATH 295,A00,087456,Staff,50,0,50,0
1653435021504,MATH 297,001,087457,Staff,998,0,999,1
1653435588549,COGS 200,A01,087991,Staff,47,0,50,3
1653435589083,COGS 201,A01,094504,Rangel; Lara M,17,0,25,8
1653435589628,COGS 203,A00,087992,Coulson; Seana M,18,0,20,2
1653435590184,COGS 210A,001,087993,Greene; Deanna Jacquelyn,9998,0,9999,1
1653435590184,COGS 210A,002,087994,Saygin; Ayse P,9999,0,9999,0
1653435590184,COGS 210A,003,087995,Xia; Haijun,9999,0,9999,0
1653435590184,COGS 210A,004,087996,Nitz; Douglas A.,9999,0,9999,0
1653435590184,COGS 210A,005,087997,Hollan; James D.,9999,0,9999,0
1653435590184,COGS 210A,006,087998,Deak; Gedeon O.,9998,0,9999,1
1653435590184,COGS 210A,007,087999,Rossano; Federico,9999,0,9999,0
1653435590711,COGS 211A,A00,088000,Coulson; Seana M,9997,0,9999,2
1653435591236,COGS 229,A00,088002,Staff,23,0,25,2
1653435591759,COGS 260,B00,094231,Staff,17,0,20,3
1653435591759,COGS 260,A00,088004,Nitz; Douglas A.,9998,0,9999,1
1653435592301,CSE 202,A00,090110,Paturi; Ramamohan,0,0,0,0
1653435592301,CSE 202,B00,090111,Paturi; Ramamohan,0,0,0,0
1653435592834,CSE 207B,A00,090112,Heninger; Nadia A,0,0,0,0
1653435593372,CSE 208,A00,094858,Micciancio; Daniele,0,0,0,0
1653435593896,CSE 210,A00,090113,Powell; Thomas Allan,0,0,0,0
1653435594432,CSE 219,A00,090898,Staff,0,0,0,0
1653435594953,CSE 221,A00,090114,Zhou; Yuan-Yuan,0,0,0,0
1653435595479,CSE 229A,A00,090115,Porter; George M,0,0,0,0
1653435596004,CSE 229C,A00,090116,Savage; Stefan,0,0,0,0
1653435596529,CSE 230,A00,090117,Jhala; Ranjit,0,0,0,0
1653435597056,CSE 232,A00,090118,Papakonstantinou; Yannis,0,0,0,0
1653435597579,CSE 239A,A00,090121,Kumar; Arun Kumar,0,0,0,0
1653435598104,CSE 239B,A00,090122,Jhala; Ranjit,0,0,0,0
1653435598633,CSE 240A,A00,090123,Zhao; Jishen,0,0,189,189
1653435599161,CSE 243A,A00,090124,Orailoglu; Alex,3,0,15,12
1653435599686,CSE 249B,A00,090125,Kahng; Andrew Byun,13,0,20,7
1653435601233,CSE 250A,A00,090126,Berg-Kirkpatrick; Taylor D,0,0,0,0
1653435601773,CSE 252A,A00,090127,Ochoa; Benjamin Lawrence,0,0,0,0
1653435602342,CSE 258,A01,090129,McAuley; Julian John,0,0,0,0
1653435602952,CSE 258R,A01,090131,McAuley; Julian John,0,0,0,0
1653435603492,CSE 274,A00,090132,Ramamoorthi; Ravi,0,0,0,0
1653435604048,CSE 276A,A00,090133,Christensen; Henrik I,0,0,0,0
1653435604589,CSE 276C,A00,090134,Christensen; Henrik I,0,0,0,0
1653435605126,CSE 290,A00,090135,Bafna; Vineet,0,0,0,0
1653435605126,CSE 290,B00,090136,Ramamoorthi; Ravi,0,0,0,0
1653435605126,CSE 290,C00,090137,Li; Tzumao,9,0,10,1
1653435605126,CSE 290,D00,090138,Zhou; Yuan-Yuan,10,0,10,0
1653435605126,CSE 290,E00,090139,Christensen; Henrik I,10,0,10,0
1653435605126,CSE 290,F00,094053,Shalev; Aaron D,0,0,0,0
1653435605662,CSE 291,A00,090140,Munyaka; Imani N. S.,0,0,0,0
1653435605662,CSE 291,B00,094880,Yu; Qi,0,0,0,0
1653435605662,CSE 291,C00,090142,Pannuto; Patrick William,0,0,0,0
1653435605662,CSE 291,D00,094881,Zhang; Yiying,0,0,0,0
1653435605662,CSE 291,E00,095118,Su; Hao,0,0,0,0
1653435606206,CSE 293,001,094905,Bafna; Vineet,9999,0,9999,0
1653435606206,CSE 293,002,094906,Bellare; Mihir,9999,0,9999,0
1653435606206,CSE 293,003,094907,Berg-Kirkpatrick; Taylor D,9999,0,9999,0
1653435606206,CSE 293,004,094908,Christensen; Henrik I,9999,0,9999,0
1653435606206,CSE 293,005,094909,Cottrell; Garrison W,9999,0,9999,0
1653435606206,CSE 293,006,094910,Deutsch; Alin Bernard,9999,0,9999,0
1653435606206,CSE 293,007,094911,Esmaeilzadeh; Hadi,9999,0,9999,0
1653435606206,CSE 293,008,094912,Freund; Yoav,9999,0,9999,0
1653435606206,CSE 293,009,094913,Griswold; William G.,9999,0,9999,0
1653435606206,CSE 293,010,094914,Gymrek; Melissa Ann,9999,0,9999,0
1653435606206,CSE 293,011,094915,Heninger; Nadia A,9999,0,9999,0
1653435606206,CSE 293,012,094916,Impagliazzo; Russell,9999,0,9999,0
1653435606206,CSE 293,013,094917,Jhala; Ranjit,9999,0,9999,0
1653435606206,CSE 293,014,094918,Kahng; Andrew Byun,9999,0,9999,0
1653435606206,CSE 293,015,094919,Kane; Daniel Mertz,9999,0,9999,0
1653435606206,CSE 293,016,094920,Kriegman; David J,9999,0,9999,0
1653435606206,CSE 293,017,094921,Kumar; Arun Kumar,9999,0,9999,0
1653435606206,CSE 293,018,094922,Lerner; Sorin,9999,0,9999,0
1653435606206,CSE 293,019,094923,Lovett; Shachar,9999,0,9999,0
1653435606206,CSE 293,020,094924,McAuley; Julian John,9999,0,9999,0
1653435606206,CSE 293,021,094925,Micciancio; Daniele,9999,0,9999,0
1653435606206,CSE 293,022,094926,Orailoglu; Alex,9999,0,9999,0
1653435606206,CSE 293,023,094927,Paturi; Ramamohan,9999,0,9999,0
1653435606206,CSE 293,024,094928,Polikarpova; Nadezhda,9999,0,9999,0
1653435606206,CSE 293,025,094929,Politz; Joseph Gibbs,9999,0,9999,0
1653435606206,CSE 293,026,094930,Porter; George M,9999,0,9999,0
1653435606206,CSE 293,027,094931,Porter; Leonard Emerson,9999,0,9999,0
1653435606206,CSE 293,028,094932,Ramamoorthi; Ravi,9999,0,9999,0
1653435606206,CSE 293,029,094933,Sahoo; Debashis,9999,0,9999,0
1653435606206,CSE 293,030,094934,Saul; Lawrence,9999,0,9999,0
1653435606206,CSE 293,031,094935,Savage; Stefan,9999,0,9999,0
1653435606206,CSE 293,032,094936,Schulze; Jurgen P.,9999,0,9999,0
1653435606206,CSE 293,033,094937,Snoeren; Alex C.,9999,0,9999,0
1653435606206,CSE 293,034,094938,Shang; Jingbo,9999,0,9999,0
1653435606206,CSE 293,035,094939,Stefan; Deian,9999,0,9999,0
1653435606206,CSE 293,036,094940,Su; Hao,9999,0,9999,0
1653435606206,CSE 293,037,094941,Swanson; Steven James,9999,0,9999,0
1653435606206,CSE 293,038,094942,Tullsen; Dean Michael,9999,0,9999,0
1653435606206,CSE 293,039,094943,Voelker; Geoffrey M.,9999,0,9999,0
1653435606206,CSE 293,040,094944,Zhao; Jishen,9999,0,9999,0
1653435606206,CSE 293,041,094945,Zhou; Yuan-Yuan,9999,0,9999,0
1653435606206,CSE 293,042,094946,Gao; Sicun,9998,0,9999,1
1653435606206,CSE 293,043,094947,Weibel; Nadir,9999,0,9999,0
1653435606206,CSE 293,044,094948,Gupta; Rajesh K.,9999,0,9999,0
1653435606749,CSE 294,A00,090143,Porter; George M,9,0,10,1
1653435607286,DSE 200,A00,091799,Staff,50,0,50,0
1653435607825,DSE 203,A00,091800,Gupta; Amarnath,30,0,30,0
1653435608359,DSE 250,A00,091801,Deutsch; Alin Bernard,30,0,30,0
1653435608881,DSE 290,A00,091802,Altintas De Callaf; Ilkay,50,0,50,0
1653435609431,ECE 200,001,091003,Antipa; Nicholas A,9999,0,9999,0
1653435609431,ECE 200,002,091004,Atanasov; Nikolay A.,9999,0,9999,0
1653435609431,ECE 200,003,091005,Bharadia; Dinesh,9999,0,9999,0
1653435609431,ECE 200,004,091006,Cheng; Chung Kuan,9999,0,9999,0
1653435609431,ECE 200,005,091007,Cosman; Pamela C.,9999,0,9999,0
1653435609431,ECE 200,006,091008,Staff,9999,0,9999,0
1653435609431,ECE 200,007,091009,Dayeh; Shadi Ahmad,9999,0,9999,0
1653435609431,ECE 200,008,091010,Fainman; Yeshaiahu,9999,0,9999,0
1653435609431,ECE 200,009,091011,Ford; Joseph Earl,9999,0,9999,0
1653435609431,ECE 200,010,091012,Franceschetti; Massimo,9999,0,9999,0
1653435609431,ECE 200,011,091013,Fullerton; Eric E,9999,0,9999,0
1653435609431,ECE 200,012,091014,Galton; Ian A,9999,0,9999,0
1653435609431,ECE 200,013,091015,Gilja; Vikash,9999,0,9999,0
1653435609431,ECE 200,014,091016,Hall; Drew A.,9999,0,9999,0
1653435609431,ECE 200,015,091017,Hsueh; Tzu-Chien,9999,0,9999,0
1653435609431,ECE 200,016,091018,Javidi; Tara,9999,0,9999,0
1653435609431,ECE 200,017,091019,Kahng; Andrew Byun,9999,0,9999,0
1653435609431,ECE 200,018,091020,Kim; Young-Han,9999,0,9999,0
1653435609431,ECE 200,019,091021,Koushanfar; Farinaz,9999,0,9999,0
1653435609431,ECE 200,020,091022,Kuzum; Duygu,9999,0,9999,0
1653435609431,ECE 200,021,091023,Le; Hanh-Phuc,9999,0,9999,0
1653435609431,ECE 200,022,091024,Lin; Bill,9999,0,9999,0
1653435609431,ECE 200,023,091025,Liu; Zhaowei,9999,0,9999,0
1653435609431,ECE 200,024,091026,Lo; Yu-Hwa,9999,0,9999,0
1653435609431,ECE 200,025,091027,Lomakin; Vitaliy,9999,0,9999,0
1653435609431,ECE 200,026,091028,Mercier; Patrick Philip,9999,0,9999,0
1653435609431,ECE 200,027,091029,Meyer; Florian,9999,0,9999,0
1653435609431,ECE 200,028,091030,Milstein; Laurence B.,9999,0,9999,0
1653435609431,ECE 200,029,091031,Mir Arabbaygi; Siavash,9999,0,9999,0
1653435609431,ECE 200,030,091032,Mookherjea; Shayan,9999,0,9999,0
1653435609431,ECE 200,031,091033,Morris; Karcher William,9999,0,9999,0
1653435609431,ECE 200,032,091034,Ng; Tse Nga,9999,0,9999,0
1653435609431,ECE 200,033,091035,Nguyen; Truong Quang,9999,0,9999,0
1653435609431,ECE 200,034,091036,Nomura; Kenji,9999,0,9999,0
1653435609431,ECE 200,035,091037,Orlitsky; Alon,9999,0,9999,0
1653435609431,ECE 200,036,091038,Pal; Piya,9999,0,9999,0
1653435609431,ECE 200,037,091039,Papen; George C.,9999,0,9999,0
1653435609431,ECE 200,038,091040,Radic; Stojan,9999,0,9999,0
1653435609431,ECE 200,039,091041,Rao; Bhaskar D.,9999,0,9999,0
1653435609431,ECE 200,040,091042,Rao; Ramesh R,9999,0,9999,0
1653435609431,ECE 200,041,091043,Rebeiz; Gabriel,9999,0,9999,0
1653435609431,ECE 200,042,091044,Sanford; John R,9999,0,9999,0
1653435609431,ECE 200,043,091045,Siegel; Paul H.,9999,0,9999,0
1653435609431,ECE 200,044,091046,Sievenpiper; Daniel F.,9999,0,9999,0
1653435609431,ECE 200,045,091047,Sworder; David D.,9999,0,9999,0
1653435609431,ECE 200,046,091048,Taur; Yuan,9999,0,9999,0
1653435609431,ECE 200,047,091049,Touri; Behrouz,9999,0,9999,0
1653435609431,ECE 200,048,091050,Trivedi; Mohan M.,9999,0,9999,0
1653435609431,ECE 200,049,091051,Vardy; Alexander,9999,0,9999,0
1653435609431,ECE 200,050,091052,Vasconcelos; Nuno,9999,0,9999,0
1653435609431,ECE 200,051,091053,Wang; Xiaolong,9999,0,9999,0
1653435609431,ECE 200,052,091054,Xie; Pengtao,9999,0,9999,0
1653435609431,ECE 200,053,091055,Yip; Michael,9999,0,9999,0
1653435609431,ECE 200,054,091056,Zeger; Kenneth A.,9999,0,9999,0
1653435609431,ECE 200,055,091057,Zhang; Xinyu,9999,0,9999,0
1653435609431,ECE 200,056,091058,Turakhia; Yatish Girish,9999,0,9999,0
1653435609431,ECE 200,057,091059,Kang; Mingu,9999,0,9999,0
1653435609431,ECE 200,058,091060,Shi; Yuanyuan,9999,0,9999,0
1653435609431,ECE 200,059,091061,Wang; Edward Jay,9999,0,9999,0
1653435609431,ECE 200,060,091062,Zheng; Yang,9999,0,9999,0
1653435609961,ECE 203,A00,091065,Mercier; Patrick Philip,0,0,0,0
1653435610588,ECE 207A,A00,091605,Liu; Thomas Tao-Ming,0,0,0,0
1653435611133,ECE 212AN,A00,091068,Nomura; Kenji,0,0,0,0
1653435611679,ECE 222A,A00,091069,Rebeiz; Gabriel,0,0,0,0
1653435612203,ECE 225A,A00,091070,Orlitsky; Alon,0,0,0,0
1653435612728,ECE 230A,A00,091071,Nomura; Kenji,0,0,0,0
1653435613285,ECE 236A,A00,091072,Dayeh; Shadi Ahmad,0,0,0,0
1653435613824,ECE 238A,A00,091073,Luo; Jian,0,0,0,0
1653435613824,ECE 238A,B00,091074,Luo; Jian,0,0,0,0
1653435614368,ECE 240A,A00,091075,Radic; Stojan,0,0,0,0
1653435614891,ECE 247A,A00,091592,Shi; Lingyan,0,0,0,0
1653435615419,ECE 250,A00,091076,Touri; Behrouz,0,0,0,0
1653435615944,ECE 251C,A00,091078,Nguyen; Truong Quang,0,0,0,0
1653435616472,ECE 253,A00,091079,Cosman; Pamela C.,0,0,0,0
1653435616995,ECE 255A,A00,091080,Orlitsky; Alon,0,0,0,0
1653435617526,ECE 257A,A00,091081,Zhang; Xinyu,0,0,0,0
1653435618068,ECE 260A,A01,091084,Eldon; John,0,0,0,0
1653435618594,ECE 264C,A00,091085,Galton; Ian A,0,0,0,0
1653435619120,ECE 265C,A00,094889,Presti; Calogero Davide,0,0,0,9
1653435619644,ECE 266,A01,091087,Hall; Drew A.,0,0,0,0
1653435620711,ECE 271A,A00,091090,Vasconcelos; Nuno,0,0,0,0
1653435621247,ECE 272B,A00,091091,Sworder; David D.,0,0,0,0
1653435621780,ECE 275A,A00,091092,Meyer; Florian,0,0,0,0
1653435622333,ECE 277,A00,091093,An; Cheolhong,0,0,0,0
1653435622879,ECE 283,A00,091094,Le; Hanh-Phuc,0,0,0,0
1653435623427,ECE 284,A00,091095,Kang; Mingu,0,0,0,0
1653435623427,ECE 284,B00,091096,Wang; Edward Jay,0,0,0,0
1653435623956,ECE 285,A00,094334,Touri; Behrouz,0,0,0,0
1653435624511,ECE 289,A00,091097,Whelan; David Arthur,0,0,0,0
1653435625054,MATH 200A,A00,087414,Salehi Golsefidy; Alireza,7,0,8,1
1653435625600,MATH 202A,A00,087415,Gill; Philip E.,3,0,8,5
1653435626138,MATH 203A,A00,087416,Oprea; Dragos N.,6,0,8,2
1653435626685,MATH 204A,A00,087417,Kedlaya; Kiran S.,6,0,8,2
1653435627230,MATH 205,A00,087418,Sorensen; Claus M,6,0,8,2
1653435627796,MATH 206A,A00,087419,Izadi; Elham,7,0,8,1
1653435628334,MATH 207A,A00,087420,Mohammadi; Amir,6,0,8,2
1653435628857,MATH 208,A00,087421,Staff,9,0,10,1
1653435629402,MATH 209,A00,087422,Staff,10,0,10,0
1653435629957,MATH 218,A00,087423,Staff,10,0,10,0
1653435630494,MATH 220A,A00,087424,Novak; Jonathan I,7,0,8,1
1653435631038,MATH 231A,A00,087425,Bejenaru; Ioan,4,0,8,4
1653435631673,MATH 240A,A00,087426,Ebenfelt; Peter F,5,0,8,3
1653435632205,MATH 243,A00,087427,Staff,9,0,10,1
1653435632753,MATH 248,A00,087429,Staff,10,0,10,0
1653435633291,MATH 250A,A00,087430,Spolaor; Luca,5,0,8,3
1653435633881,MATH 257A,A00,087431,Spolaor; Luca,7,0,8,1
1653435634413,MATH 258,A00,087432,Staff,9,0,10,1
1653435634961,MATH 264A,A00,087433,Warnke; Lutz Peter,5,0,8,3
1653435635522,MATH 268,A00,087434,Staff,15,0,15,0
1653435636058,MATH 269,A00,087435,Staff,14,0,15,1
1653435636607,MATH 270A,A00,087436,Nie; Jiawang,0,0,8,8
1653435637146,MATH 272A,A00,087437,Tian; Xiaochuan,1,0,8,7
1653435637679,MATH 274,A01,087439,Cheng; Li-Tien,9,0,10,1
1653435637679,MATH 274,A02,087440,Cheng; Li-Tien,10,0,10,0
1653435638212,MATH 278A,A00,087441,Staff,8,0,10,2
1653435638756,MATH 278B,A00,087442,Staff,8,0,10,2
1653435639281,MATH 278C,A00,087443,Staff,8,0,10,2
1653435639830,MATH 280A,A00,087444,Zheng; Tianyi,0,0,8,8
1653435640381,MATH 281A,A00,087445,Bradic; Jelena,0,0,8,8
1653435640916,MATH 282A,A00,087446,Zhang; Danna,0,0,8,8
1653435641454,MATH 283,A00,087447,Tesler; Glenn,0,0,0,14
1653435641996,MATH 286,A00,087448,Kemp; Todd Aahron,6,0,8,2
1653435642522,MATH 287D,A00,087449,Bradic; Jelena,8,0,8,0
1653435643074,MATH 288,A00,087450,Staff,14,0,15,1
1653435643074,MATH 288,B00,087451,Staff,15,0,15,0
1653435643074,MATH 288,C00,087452,Staff,15,0,15,0
1653435643614,MATH 290A,A00,087453,Xu; Zhouli,7,0,8,1
1653435644152,MATH 291A,A00,087454,Xu; Zhouli,7,0,8,1
1653435644677,MATH 292,A00,087455,Staff,10,0,10,0
1653435645200,MATH 295,A00,087456,Staff,50,0,50,0
1653435645737,MATH 297,001,087457,Staff,998,0,999,1
1653436215146,COGS 200,A01,087991,Staff,47,0,50,3
1653436215672,COGS 201,A01,094504,Rangel; Lara M,17,0,25,8
1653436216206,COGS 203,A00,087992,Coulson; Seana M,18,0,20,2
1653436216737,COGS 210A,001,087993,Greene; Deanna Jacquelyn,9998,0,9999,1
1653436216737,COGS 210A,002,087994,Saygin; Ayse P,9999,0,9999,0
1653436216737,COGS 210A,003,087995,Xia; Haijun,9999,0,9999,0
1653436216737,COGS 210A,004,087996,Nitz; Douglas A.,9999,0,9999,0
1653436216737,COGS 210A,005,087997,Hollan; James D.,9999,0,9999,0
1653436216737,COGS 210A,006,087998,Deak; Gedeon O.,9998,0,9999,1
1653436216737,COGS 210A,007,087999,Rossano; Federico,9999,0,9999,0
1653436217265,COGS 211A,A00,088000,Coulson; Seana M,9997,0,9999,2
1653436217802,COGS 229,A00,088002,Staff,23,0,25,2
1653436218357,COGS 260,B00,094231,Staff,17,0,20,3
1653436218357,COGS 260,A00,088004,Nitz; Douglas A.,9998,0,9999,1
1653436218895,CSE 202,A00,090110,Paturi; Ramamohan,0,0,0,0
1653436218895,CSE 202,B00,090111,Paturi; Ramamohan,0,0,0,0
1653436219420,CSE 207B,A00,090112,Heninger; Nadia A,0,0,0,0
1653436219971,CSE 208,A00,094858,Micciancio; Daniele,0,0,0,0
1653436220509,CSE 210,A00,090113,Powell; Thomas Allan,0,0,0,0
1653436221034,CSE 219,A00,090898,Staff,0,0,0,0
1653436221571,CSE 221,A00,090114,Zhou; Yuan-Yuan,0,0,0,0
1653436222093,CSE 229A,A00,090115,Porter; George M,0,0,0,0
1653436222710,CSE 229C,A00,090116,Savage; Stefan,0,0,0,0
1653436223260,CSE 230,A00,090117,Jhala; Ranjit,0,0,0,0
1653436223784,CSE 232,A00,090118,Papakonstantinou; Yannis,0,0,0,0
1653436224357,CSE 239A,A00,090121,Kumar; Arun Kumar,0,0,0,0
1653436224895,CSE 239B,A00,090122,Jhala; Ranjit,0,0,0,0
1653436225422,CSE 240A,A00,090123,Zhao; Jishen,0,0,189,189
1653436225954,CSE 243A,A00,090124,Orailoglu; Alex,3,0,15,12
1653436226479,CSE 249B,A00,090125,Kahng; Andrew Byun,13,0,20,7
1653436227001,CSE 250A,A00,090126,Berg-Kirkpatrick; Taylor D,0,0,0,0
1653436227526,CSE 252A,A00,090127,Ochoa; Benjamin Lawrence,0,0,0,0
1653436228058,CSE 258,A01,090129,McAuley; Julian John,0,0,0,0
1653436228582,CSE 258R,A01,090131,McAuley; Julian John,0,0,0,0
1653436229192,CSE 274,A00,090132,Ramamoorthi; Ravi,0,0,0,0
1653436229764,CSE 276A,A00,090133,Christensen; Henrik I,0,0,0,0
1653436230291,CSE 276C,A00,090134,Christensen; Henrik I,0,0,0,0
1653436230813,CSE 290,A00,090135,Bafna; Vineet,0,0,0,0
1653436230813,CSE 290,B00,090136,Ramamoorthi; Ravi,0,0,0,0
1653436230813,CSE 290,C00,090137,Li; Tzumao,9,0,10,1
1653436230813,CSE 290,D00,090138,Zhou; Yuan-Yuan,10,0,10,0
1653436230813,CSE 290,E00,090139,Christensen; Henrik I,10,0,10,0
1653436230813,CSE 290,F00,094053,Shalev; Aaron D,0,0,0,0
1653436231349,CSE 291,A00,090140,Munyaka; Imani N. S.,0,0,0,0
1653436231349,CSE 291,B00,094880,Yu; Qi,0,0,0,0
1653436231349,CSE 291,C00,090142,Pannuto; Patrick William,0,0,0,0
1653436231349,CSE 291,D00,094881,Zhang; Yiying,0,0,0,0
1653436231349,CSE 291,E00,095118,Su; Hao,0,0,0,0
1653436231878,CSE 293,001,094905,Bafna; Vineet,9999,0,9999,0
1653436231878,CSE 293,002,094906,Bellare; Mihir,9999,0,9999,0
1653436231878,CSE 293,003,094907,Berg-Kirkpatrick; Taylor D,9999,0,9999,0
1653436231878,CSE 293,004,094908,Christensen; Henrik I,9999,0,9999,0
1653436231878,CSE 293,005,094909,Cottrell; Garrison W,9999,0,9999,0
1653436231878,CSE 293,006,094910,Deutsch; Alin Bernard,9999,0,9999,0
1653436231878,CSE 293,007,094911,Esmaeilzadeh; Hadi,9999,0,9999,0
1653436231878,CSE 293,008,094912,Freund; Yoav,9999,0,9999,0
1653436231878,CSE 293,009,094913,Griswold; William G.,9999,0,9999,0
1653436231878,CSE 293,010,094914,Gymrek; Melissa Ann,9999,0,9999,0
1653436231878,CSE 293,011,094915,Heninger; Nadia A,9999,0,9999,0
1653436231878,CSE 293,012,094916,Impagliazzo; Russell,9999,0,9999,0
1653436231878,CSE 293,013,094917,Jhala; Ranjit,9999,0,9999,0
1653436231878,CSE 293,014,094918,Kahng; Andrew Byun,9999,0,9999,0
1653436231878,CSE 293,015,094919,Kane; Daniel Mertz,9999,0,9999,0
1653436231878,CSE 293,016,094920,Kriegman; David J,9999,0,9999,0
1653436231878,CSE 293,017,094921,Kumar; Arun Kumar,9999,0,9999,0
1653436231878,CSE 293,018,094922,Lerner; Sorin,9999,0,9999,0
1653436231878,CSE 293,019,094923,Lovett; Shachar,9999,0,9999,0
1653436231878,CSE 293,020,094924,McAuley; Julian John,9999,0,9999,0
1653436231878,CSE 293,021,094925,Micciancio; Daniele,9999,0,9999,0
1653436231878,CSE 293,022,094926,Orailoglu; Alex,9999,0,9999,0
1653436231878,CSE 293,023,094927,Paturi; Ramamohan,9999,0,9999,0
1653436231878,CSE 293,024,094928,Polikarpova; Nadezhda,9999,0,9999,0
1653436231878,CSE 293,025,094929,Politz; Joseph Gibbs,9999,0,9999,0
1653436231878,CSE 293,026,094930,Porter; George M,9999,0,9999,0
1653436231878,CSE 293,027,094931,Porter; Leonard Emerson,9999,0,9999,0
1653436231878,CSE 293,028,094932,Ramamoorthi; Ravi,9999,0,9999,0
1653436231878,CSE 293,029,094933,Sahoo; Debashis,9999,0,9999,0
1653436231878,CSE 293,030,094934,Saul; Lawrence,9999,0,9999,0
1653436231878,CSE 293,031,094935,Savage; Stefan,9999,0,9999,0
1653436231878,CSE 293,032,094936,Schulze; Jurgen P.,9999,0,9999,0
1653436231878,CSE 293,033,094937,Snoeren; Alex C.,9999,0,9999,0
1653436231878,CSE 293,034,094938,Shang; Jingbo,9999,0,9999,0
1653436231878,CSE 293,035,094939,Stefan; Deian,9999,0,9999,0
1653436231878,CSE 293,036,094940,Su; Hao,9999,0,9999,0
1653436231878,CSE 293,037,094941,Swanson; Steven James,9999,0,9999,0
1653436231878,CSE 293,038,094942,Tullsen; Dean Michael,9999,0,9999,0
1653436231878,CSE 293,039,094943,Voelker; Geoffrey M.,9999,0,9999,0
1653436231878,CSE 293,040,094944,Zhao; Jishen,9999,0,9999,0
1653436231878,CSE 293,041,094945,Zhou; Yuan-Yuan,9999,0,9999,0
1653436231878,CSE 293,042,094946,Gao; Sicun,9998,0,9999,1
1653436231878,CSE 293,043,094947,Weibel; Nadir,9999,0,9999,0
1653436231878,CSE 293,044,094948,Gupta; Rajesh K.,9999,0,9999,0
1653436232418,CSE 294,A00,090143,Porter; George M,9,0,10,1
1653436232970,DSE 200,A00,091799,Staff,50,0,50,0
1653436233527,DSE 203,A00,091800,Gupta; Amarnath,30,0,30,0
1653436234060,DSE 250,A00,091801,Deutsch; Alin Bernard,30,0,30,0
1653436234583,DSE 290,A00,091802,Altintas De Callaf; Ilkay,50,0,50,0
1653436235176,ECE 200,001,091003,Antipa; Nicholas A,9999,0,9999,0
1653436235176,ECE 200,002,091004,Atanasov; Nikolay A.,9999,0,9999,0
1653436235176,ECE 200,003,091005,Bharadia; Dinesh,9999,0,9999,0
1653436235176,ECE 200,004,091006,Cheng; Chung Kuan,9999,0,9999,0
1653436235176,ECE 200,005,091007,Cosman; Pamela C.,9999,0,9999,0
1653436235176,ECE 200,006,091008,Staff,9999,0,9999,0
1653436235176,ECE 200,007,091009,Dayeh; Shadi Ahmad,9999,0,9999,0
1653436235176,ECE 200,008,091010,Fainman; Yeshaiahu,9999,0,9999,0
1653436235176,ECE 200,009,091011,Ford; Joseph Earl,9999,0,9999,0
1653436235176,ECE 200,010,091012,Franceschetti; Massimo,9999,0,9999,0
1653436235176,ECE 200,011,091013,Fullerton; Eric E,9999,0,9999,0
1653436235176,ECE 200,012,091014,Galton; Ian A,9999,0,9999,0
1653436235176,ECE 200,013,091015,Gilja; Vikash,9999,0,9999,0
1653436235176,ECE 200,014,091016,Hall; Drew A.,9999,0,9999,0
1653436235176,ECE 200,015,091017,Hsueh; Tzu-Chien,9999,0,9999,0
1653436235176,ECE 200,016,091018,Javidi; Tara,9999,0,9999,0
1653436235176,ECE 200,017,091019,Kahng; Andrew Byun,9999,0,9999,0
1653436235176,ECE 200,018,091020,Kim; Young-Han,9999,0,9999,0
1653436235176,ECE 200,019,091021,Koushanfar; Farinaz,9999,0,9999,0
1653436235176,ECE 200,020,091022,Kuzum; Duygu,9999,0,9999,0
1653436235176,ECE 200,021,091023,Le; Hanh-Phuc,9999,0,9999,0
1653436235176,ECE 200,022,091024,Lin; Bill,9999,0,9999,0
1653436235176,ECE 200,023,091025,Liu; Zhaowei,9999,0,9999,0
1653436235176,ECE 200,024,091026,Lo; Yu-Hwa,9999,0,9999,0
1653436235176,ECE 200,025,091027,Lomakin; Vitaliy,9999,0,9999,0
1653436235176,ECE 200,026,091028,Mercier; Patrick Philip,9999,0,9999,0
1653436235176,ECE 200,027,091029,Meyer; Florian,9999,0,9999,0
1653436235176,ECE 200,028,091030,Milstein; Laurence B.,9999,0,9999,0
1653436235176,ECE 200,029,091031,Mir Arabbaygi; Siavash,9999,0,9999,0
1653436235176,ECE 200,030,091032,Mookherjea; Shayan,9999,0,9999,0
1653436235176,ECE 200,031,091033,Morris; Karcher William,9999,0,9999,0
1653436235176,ECE 200,032,091034,Ng; Tse Nga,9999,0,9999,0
1653436235176,ECE 200,033,091035,Nguyen; Truong Quang,9999,0,9999,0
1653436235176,ECE 200,034,091036,Nomura; Kenji,9999,0,9999,0
1653436235176,ECE 200,035,091037,Orlitsky; Alon,9999,0,9999,0
1653436235176,ECE 200,036,091038,Pal; Piya,9999,0,9999,0
1653436235176,ECE 200,037,091039,Papen; George C.,9999,0,9999,0
1653436235176,ECE 200,038,091040,Radic; Stojan,9999,0,9999,0
1653436235176,ECE 200,039,091041,Rao; Bhaskar D.,9999,0,9999,0
1653436235176,ECE 200,040,091042,Rao; Ramesh R,9999,0,9999,0
1653436235176,ECE 200,041,091043,Rebeiz; Gabriel,9999,0,9999,0
1653436235176,ECE 200,042,091044,Sanford; John R,9999,0,9999,0
1653436235176,ECE 200,043,091045,Siegel; Paul H.,9999,0,9999,0
1653436235176,ECE 200,044,091046,Sievenpiper; Daniel F.,9999,0,9999,0
1653436235176,ECE 200,045,091047,Sworder; David D.,9999,0,9999,0
1653436235176,ECE 200,046,091048,Taur; Yuan,9999,0,9999,0
1653436235176,ECE 200,047,091049,Touri; Behrouz,9999,0,9999,0
1653436235176,ECE 200,048,091050,Trivedi; Mohan M.,9999,0,9999,0
1653436235176,ECE 200,049,091051,Vardy; Alexander,9999,0,9999,0
1653436235176,ECE 200,050,091052,Vasconcelos; Nuno,9999,0,9999,0
1653436235176,ECE 200,051,091053,Wang; Xiaolong,9999,0,9999,0
1653436235176,ECE 200,052,091054,Xie; Pengtao,9999,0,9999,0
1653436235176,ECE 200,053,091055,Yip; Michael,9999,0,9999,0
1653436235176,ECE 200,054,091056,Zeger; Kenneth A.,9999,0,9999,0
1653436235176,ECE 200,055,091057,Zhang; Xinyu,9999,0,9999,0
1653436235176,ECE 200,056,091058,Turakhia; Yatish Girish,9999,0,9999,0
1653436235176,ECE 200,057,091059,Kang; Mingu,9999,0,9999,0
1653436235176,ECE 200,058,091060,Shi; Yuanyuan,9999,0,9999,0
1653436235176,ECE 200,059,091061,Wang; Edward Jay,9999,0,9999,0
1653436235176,ECE 200,060,091062,Zheng; Yang,9999,0,9999,0
1653436235734,ECE 203,A00,091065,Mercier; Patrick Philip,0,0,0,0
1653436236287,ECE 207A,A00,091605,Liu; Thomas Tao-Ming,0,0,0,0
1653436236834,ECE 212AN,A00,091068,Nomura; Kenji,0,0,0,0
1653436237371,ECE 222A,A00,091069,Rebeiz; Gabriel,0,0,0,0
1653436237898,ECE 225A,A00,091070,Orlitsky; Alon,0,0,0,0
1653436238450,ECE 230A,A00,091071,Nomura; Kenji,0,0,0,0
1653436238994,ECE 236A,A00,091072,Dayeh; Shadi Ahmad,0,0,0,0
1653436239535,ECE 238A,A00,091073,Luo; Jian,0,0,0,0
1653436239535,ECE 238A,B00,091074,Luo; Jian,0,0,0,0
1653436240071,ECE 240A,A00,091075,Radic; Stojan,0,0,0,0
1653436240608,ECE 247A,A00,091592,Shi; Lingyan,0,0,0,0
1653436241131,ECE 250,A00,091076,Touri; Behrouz,0,0,0,0
1653436241654,ECE 251C,A00,091078,Nguyen; Truong Quang,0,0,0,0
1653436242183,ECE 253,A00,091079,Cosman; Pamela C.,0,0,0,0
1653436242741,ECE 255A,A00,091080,Orlitsky; Alon,0,0,0,0
1653436243269,ECE 257A,A00,091081,Zhang; Xinyu,0,0,0,0
1653436243819,ECE 260A,A01,091084,Eldon; John,0,0,0,0
1653436244343,ECE 264C,A00,091085,Galton; Ian A,0,0,0,0
1653436244881,ECE 265C,A00,094889,Presti; Calogero Davide,0,0,0,9
1653436245405,ECE 266,A01,091087,Hall; Drew A.,0,0,0,0
1653436246486,ECE 271A,A00,091090,Vasconcelos; Nuno,0,0,0,0
1653436247028,ECE 272B,A00,091091,Sworder; David D.,0,0,0,0
1653436247575,ECE 275A,A00,091092,Meyer; Florian,0,0,0,0
1653436248115,ECE 277,A00,091093,An; Cheolhong,0,0,0,0
1653436248648,ECE 283,A00,091094,Le; Hanh-Phuc,0,0,0,0
1653436249199,ECE 284,A00,091095,Kang; Mingu,0,0,0,0
1653436249199,ECE 284,B00,091096,Wang; Edward Jay,0,0,0,0
1653436249748,ECE 285,A00,094334,Touri; Behrouz,0,0,0,0
1653436250271,ECE 289,A00,091097,Whelan; David Arthur,0,0,0,0
1653436250804,MATH 200A,A00,087414,Salehi Golsefidy; Alireza,7,0,8,1
1653436251329,MATH 202A,A00,087415,Gill; Philip E.,3,0,8,5
1653436251852,MATH 203A,A00,087416,Oprea; Dragos N.,6,0,8,2
1653436252378,MATH 204A,A00,087417,Kedlaya; Kiran S.,6,0,8,2
1653436252908,MATH 205,A00,087418,Sorensen; Claus M,6,0,8,2
1653436253441,MATH 206A,A00,087419,Izadi; Elham,7,0,8,1
1653436254031,MATH 207A,A00,087420,Mohammadi; Amir,6,0,8,2
1653436254553,MATH 208,A00,087421,Staff,9,0,10,1
1653436255085,MATH 209,A00,087422,Staff,10,0,10,0
1653436255619,MATH 218,A00,087423,Staff,10,0,10,0
1653436256143,MATH 220A,A00,087424,Novak; Jonathan I,7,0,8,1
1653436256691,MATH 231A,A00,087425,Bejenaru; Ioan,4,0,8,4
1653436257213,MATH 240A,A00,087426,Ebenfelt; Peter F,5,0,8,3
1653436257735,MATH 243,A00,087427,Staff,9,0,10,1
1653436258269,MATH 248,A00,087429,Staff,10,0,10,0
1653436258812,MATH 250A,A00,087430,Spolaor; Luca,5,0,8,3
1653436259336,MATH 257A,A00,087431,Spolaor; Luca,7,0,8,1
1653436259875,MATH 258,A00,087432,Staff,9,0,10,1
1653436260406,MATH 264A,A00,087433,Warnke; Lutz Peter,5,0,8,3
1653436260935,MATH 268,A00,087434,Staff,15,0,15,0
1653436261456,MATH 269,A00,087435,Staff,14,0,15,1
1653436261982,MATH 270A,A00,087436,Nie; Jiawang,0,0,8,8
1653436262504,MATH 272A,A00,087437,Tian; Xiaochuan,1,0,8,7
1653436263151,MATH 274,A01,087439,Cheng; Li-Tien,9,0,10,1
1653436263151,MATH 274,A02,087440,Cheng; Li-Tien,10,0,10,0
1653436263681,MATH 278A,A00,087441,Staff,8,0,10,2
1653436264230,MATH 278B,A00,087442,Staff,8,0,10,2
1653436264757,MATH 278C,A00,087443,Staff,8,0,10,2
1653436265280,MATH 280A,A00,087444,Zheng; Tianyi,0,0,8,8
1653436265812,MATH 281A,A00,087445,Bradic; Jelena,0,0,8,8
1653436266336,MATH 282A,A00,087446,Zhang; Danna,0,0,8,8
1653436266866,MATH 283,A00,087447,Tesler; Glenn,0,0,0,14
1653436267416,MATH 286,A00,087448,Kemp; Todd Aahron,6,0,8,2
1653436267939,MATH 287D,A00,087449,Bradic; Jelena,8,0,8,0
1653436268475,MATH 288,A00,087450,Staff,14,0,15,1
1653436268475,MATH 288,B00,087451,Staff,15,0,15,0
1653436268475,MATH 288,C00,087452,Staff,15,0,15,0
1653436269020,MATH 290A,A00,087453,Xu; Zhouli,7,0,8,1
1653436269584,MATH 291A,A00,087454,Xu; Zhouli,7,0,8,1
1653436270119,MATH 292,A00,087455,Staff,10,0,10,0
1653436270742,MATH 295,A00,087456,Staff,50,0,50,0
1653436271304,MATH 297,001,087457,Staff,998,0,999,1
1653436841328,COGS 200,A01,087991,Staff,47,0,50,3
1653436841873,COGS 201,A01,094504,Rangel; Lara M,17,0,25,8
1653436842452,COGS 203,A00,087992,Coulson; Seana M,18,0,20,2
1653436842984,COGS 210A,001,087993,Greene; Deanna Jacquelyn,9998,0,9999,1
1653436842984,COGS 210A,002,087994,Saygin; Ayse P,9999,0,9999,0
1653436842984,COGS 210A,003,087995,Xia; Haijun,9999,0,9999,0
1653436842984,COGS 210A,004,087996,Nitz; Douglas A.,9999,0,9999,0
1653436842984,COGS 210A,005,087997,Hollan; James D.,9999,0,9999,0
1653436842984,COGS 210A,006,087998,Deak; Gedeon O.,9998,0,9999,1
1653436842984,COGS 210A,007,087999,Rossano; Federico,9999,0,9999,0
1653436843525,COGS 211A,A00,088000,Coulson; Seana M,9997,0,9999,2
1653436844053,COGS 229,A00,088002,Staff,23,0,25,2
1653436844603,COGS 260,B00,094231,Staff,17,0,20,3
1653436844603,COGS 260,A00,088004,Nitz; Douglas A.,9998,0,9999,1
1653436845135,CSE 202,A00,090110,Paturi; Ramamohan,0,0,0,0
1653436845135,CSE 202,B00,090111,Paturi; Ramamohan,0,0,0,0
1653436845676,CSE 207B,A00,090112,Heninger; Nadia A,0,0,0,0
1653436846239,CSE 208,A00,094858,Micciancio; Daniele,0,0,0,0
1653436846781,CSE 210,A00,090113,Powell; Thomas Allan,0,0,0,0
1653436847325,CSE 219,A00,090898,Staff,0,0,0,0
1653436847856,CSE 221,A00,090114,Zhou; Yuan-Yuan,0,0,0,0
1653436848398,CSE 229A,A00,090115,Porter; George M,0,0,0,0
1653436848933,CSE 229C,A00,090116,Savage; Stefan,0,0,0,0
1653436849459,CSE 230,A00,090117,Jhala; Ranjit,0,0,0,0
1653436850003,CSE 232,A00,090118,Papakonstantinou; Yannis,0,0,0,0
1653436850536,CSE 239A,A00,090121,Kumar; Arun Kumar,0,0,0,0
1653436851063,CSE 239B,A00,090122,Jhala; Ranjit,0,0,0,0
1653436851587,CSE 240A,A00,090123,Zhao; Jishen,0,0,189,189
1653436852127,CSE 243A,A00,090124,Orailoglu; Alex,3,0,15,12
1653436852692,CSE 249B,A00,090125,Kahng; Andrew Byun,13,0,20,7
1653436853224,CSE 250A,A00,090126,Berg-Kirkpatrick; Taylor D,0,0,0,0
1653436853792,CSE 252A,A00,090127,Ochoa; Benjamin Lawrence,0,0,0,0
1653436854325,CSE 258,A01,090129,McAuley; Julian John,0,0,0,0
1653436854857,CSE 258R,A01,090131,McAuley; Julian John,0,0,0,0
1653436855384,CSE 274,A00,090132,Ramamoorthi; Ravi,0,0,0,0
1653436855921,CSE 276A,A00,090133,Christensen; Henrik I,0,0,0,0
1653436856467,CSE 276C,A00,090134,Christensen; Henrik I,0,0,0,0
1653436857002,CSE 290,A00,090135,Bafna; Vineet,0,0,0,0
1653436857002,CSE 290,B00,090136,Ramamoorthi; Ravi,0,0,0,0
1653436857002,CSE 290,C00,090137,Li; Tzumao,9,0,10,1
1653436857002,CSE 290,D00,090138,Zhou; Yuan-Yuan,10,0,10,0
1653436857002,CSE 290,E00,090139,Christensen; Henrik I,10,0,10,0
1653436857002,CSE 290,F00,094053,Shalev; Aaron D,0,0,0,0
1653436857539,CSE 291,A00,090140,Munyaka; Imani N. S.,0,0,0,0
1653436857539,CSE 291,B00,094880,Yu; Qi,0,0,0,0
1653436857539,CSE 291,C00,090142,Pannuto; Patrick William,0,0,0,0
1653436857539,CSE 291,D00,094881,Zhang; Yiying,0,0,0,0
1653436857539,CSE 291,E00,095118,Su; Hao,0,0,0,0
1653436858102,CSE 293,001,094905,Bafna; Vineet,9999,0,9999,0
1653436858102,CSE 293,002,094906,Bellare; Mihir,9999,0,9999,0
1653436858102,CSE 293,003,094907,Berg-Kirkpatrick; Taylor D,9999,0,9999,0
1653436858102,CSE 293,004,094908,Christensen; Henrik I,9999,0,9999,0
1653436858102,CSE 293,005,094909,Cottrell; Garrison W,9999,0,9999,0
1653436858102,CSE 293,006,094910,Deutsch; Alin Bernard,9999,0,9999,0
1653436858102,CSE 293,007,094911,Esmaeilzadeh; Hadi,9999,0,9999,0
1653436858102,CSE 293,008,094912,Freund; Yoav,9999,0,9999,0
1653436858102,CSE 293,009,094913,Griswold; William G.,9999,0,9999,0
1653436858102,CSE 293,010,094914,Gymrek; Melissa Ann,9999,0,9999,0
1653436858102,CSE 293,011,094915,Heninger; Nadia A,9999,0,9999,0
1653436858102,CSE 293,012,094916,Impagliazzo; Russell,9999,0,9999,0
1653436858102,CSE 293,013,094917,Jhala; Ranjit,9999,0,9999,0
1653436858102,CSE 293,014,094918,Kahng; Andrew Byun,9999,0,9999,0
1653436858102,CSE 293,015,094919,Kane; Daniel Mertz,9999,0,9999,0
1653436858102,CSE 293,016,094920,Kriegman; David J,9999,0,9999,0
1653436858102,CSE 293,017,094921,Kumar; Arun Kumar,9999,0,9999,0
1653436858102,CSE 293,018,094922,Lerner; Sorin,9999,0,9999,0
1653436858102,CSE 293,019,094923,Lovett; Shachar,9999,0,9999,0
1653436858102,CSE 293,020,094924,McAuley; Julian John,9999,0,9999,0
1653436858102,CSE 293,021,094925,Micciancio; Daniele,9999,0,9999,0
1653436858102,CSE 293,022,094926,Orailoglu; Alex,9999,0,9999,0
1653436858102,CSE 293,023,094927,Paturi; Ramamohan,9999,0,9999,0
1653436858102,CSE 293,024,094928,Polikarpova; Nadezhda,9999,0,9999,0
1653436858102,CSE 293,025,094929,Politz; Joseph Gibbs,9999,0,9999,0
1653436858102,CSE 293,026,094930,Porter; George M,9999,0,9999,0
1653436858102,CSE 293,027,094931,Porter; Leonard Emerson,9999,0,9999,0
1653436858102,CSE 293,028,094932,Ramamoorthi; Ravi,9999,0,9999,0
1653436858102,CSE 293,029,094933,Sahoo; Debashis,9999,0,9999,0
1653436858102,CSE 293,030,094934,Saul; Lawrence,9999,0,9999,0
1653436858102,CSE 293,031,094935,Savage; Stefan,9999,0,9999,0
1653436858102,CSE 293,032,094936,Schulze; Jurgen P.,9999,0,9999,0
1653436858102,CSE 293,033,094937,Snoeren; Alex C.,9999,0,9999,0
1653436858102,CSE 293,034,094938,Shang; Jingbo,9999,0,9999,0
1653436858102,CSE 293,035,094939,Stefan; Deian,9999,0,9999,0
1653436858102,CSE 293,036,094940,Su; Hao,9999,0,9999,0
1653436858102,CSE 293,037,094941,Swanson; Steven James,9999,0,9999,0
1653436858102,CSE 293,038,094942,Tullsen; Dean Michael,9999,0,9999,0
1653436858102,CSE 293,039,094943,Voelker; Geoffrey M.,9999,0,9999,0
1653436858102,CSE 293,040,094944,Zhao; Jishen,9999,0,9999,0
1653436858102,CSE 293,041,094945,Zhou; Yuan-Yuan,9999,0,9999,0
1653436858102,CSE 293,042,094946,Gao; Sicun,9998,0,9999,1
1653436858102,CSE 293,043,094947,Weibel; Nadir,9999,0,9999,0
1653436858102,CSE 293,044,094948,Gupta; Rajesh K.,9999,0,9999,0
1653436858635,CSE 294,A00,090143,Porter; George M,9,0,10,1
1653436859158,DSE 200,A00,091799,Staff,50,0,50,0
1653436859704,DSE 203,A00,091800,Gupta; Amarnath,30,0,30,0
1653436860243,DSE 250,A00,091801,Deutsch; Alin Bernard,30,0,30,0
1653436860823,DSE 290,A00,091802,Altintas De Callaf; Ilkay,50,0,50,0
1653436861396,ECE 200,001,091003,Antipa; Nicholas A,9999,0,9999,0
1653436861396,ECE 200,002,091004,Atanasov; Nikolay A.,9999,0,9999,0
1653436861396,ECE 200,003,091005,Bharadia; Dinesh,9999,0,9999,0
1653436861396,ECE 200,004,091006,Cheng; Chung Kuan,9999,0,9999,0
1653436861396,ECE 200,005,091007,Cosman; Pamela C.,9999,0,9999,0
1653436861396,ECE 200,006,091008,Staff,9999,0,9999,0
1653436861396,ECE 200,007,091009,Dayeh; Shadi Ahmad,9999,0,9999,0
1653436861396,ECE 200,008,091010,Fainman; Yeshaiahu,9999,0,9999,0
1653436861396,ECE 200,009,091011,Ford; Joseph Earl,9999,0,9999,0
1653436861396,ECE 200,010,091012,Franceschetti; Massimo,9999,0,9999,0
1653436861396,ECE 200,011,091013,Fullerton; Eric E,9999,0,9999,0
1653436861396,ECE 200,012,091014,Galton; Ian A,9999,0,9999,0
1653436861396,ECE 200,013,091015,Gilja; Vikash,9999,0,9999,0
1653436861396,ECE 200,014,091016,Hall; Drew A.,9999,0,9999,0
1653436861396,ECE 200,015,091017,Hsueh; Tzu-Chien,9999,0,9999,0
1653436861396,ECE 200,016,091018,Javidi; Tara,9999,0,9999,0
1653436861396,ECE 200,017,091019,Kahng; Andrew Byun,9999,0,9999,0
1653436861396,ECE 200,018,091020,Kim; Young-Han,9999,0,9999,0
1653436861396,ECE 200,019,091021,Koushanfar; Farinaz,9999,0,9999,0
1653436861396,ECE 200,020,091022,Kuzum; Duygu,9999,0,9999,0
1653436861396,ECE 200,021,091023,Le; Hanh-Phuc,9999,0,9999,0
1653436861396,ECE 200,022,091024,Lin; Bill,9999,0,9999,0
1653436861396,ECE 200,023,091025,Liu; Zhaowei,9999,0,9999,0
1653436861396,ECE 200,024,091026,Lo; Yu-Hwa,9999,0,9999,0
1653436861396,ECE 200,025,091027,Lomakin; Vitaliy,9999,0,9999,0
1653436861396,ECE 200,026,091028,Mercier; Patrick Philip,9999,0,9999,0
1653436861396,ECE 200,027,091029,Meyer; Florian,9999,0,9999,0
1653436861396,ECE 200,028,091030,Milstein; Laurence B.,9999,0,9999,0
1653436861396,ECE 200,029,091031,Mir Arabbaygi; Siavash,9999,0,9999,0
1653436861396,ECE 200,030,091032,Mookherjea; Shayan,9999,0,9999,0
1653436861396,ECE 200,031,091033,Morris; Karcher William,9999,0,9999,0
1653436861396,ECE 200,032,091034,Ng; Tse Nga,9999,0,9999,0
1653436861396,ECE 200,033,091035,Nguyen; Truong Quang,9999,0,9999,0
1653436861396,ECE 200,034,091036,Nomura; Kenji,9999,0,9999,0
1653436861396,ECE 200,035,091037,Orlitsky; Alon,9999,0,9999,0
1653436861396,ECE 200,036,091038,Pal; Piya,9999,0,9999,0
1653436861396,ECE 200,037,091039,Papen; George C.,9999,0,9999,0
1653436861396,ECE 200,038,091040,Radic; Stojan,9999,0,9999,0
1653436861396,ECE 200,039,091041,Rao; Bhaskar D.,9999,0,9999,0
1653436861396,ECE 200,040,091042,Rao; Ramesh R,9999,0,9999,0
1653436861396,ECE 200,041,091043,Rebeiz; Gabriel,9999,0,9999,0
1653436861396,ECE 200,042,091044,Sanford; John R,9999,0,9999,0
1653436861396,ECE 200,043,091045,Siegel; Paul H.,9999,0,9999,0
1653436861396,ECE 200,044,091046,Sievenpiper; Daniel F.,9999,0,9999,0
1653436861396,ECE 200,045,091047,Sworder; David D.,9999,0,9999,0
1653436861396,ECE 200,046,091048,Taur; Yuan,9999,0,9999,0
1653436861396,ECE 200,047,091049,Touri; Behrouz,9999,0,9999,0
1653436861396,ECE 200,048,091050,Trivedi; Mohan M.,9999,0,9999,0
1653436861396,ECE 200,049,091051,Vardy; Alexander,9999,0,9999,0
1653436861396,ECE 200,050,091052,Vasconcelos; Nuno,9999,0,9999,0
1653436861396,ECE 200,051,091053,Wang; Xiaolong,9999,0,9999,0
1653436861396,ECE 200,052,091054,Xie; Pengtao,9999,0,9999,0
1653436861396,ECE 200,053,091055,Yip; Michael,9999,0,9999,0
1653436861396,ECE 200,054,091056,Zeger; Kenneth A.,9999,0,9999,0
1653436861396,ECE 200,055,091057,Zhang; Xinyu,9999,0,9999,0
1653436861396,ECE 200,056,091058,Turakhia; Yatish Girish,9999,0,9999,0
1653436861396,ECE 200,057,091059,Kang; Mingu,9999,0,9999,0
1653436861396,ECE 200,058,091060,Shi; Yuanyuan,9999,0,9999,0
1653436861396,ECE 200,059,091061,Wang; Edward Jay,9999,0,9999,0
1653436861396,ECE 200,060,091062,Zheng; Yang,9999,0,9999,0
1653436861952,ECE 203,A00,091065,Mercier; Patrick Philip,0,0,0,0
1653436862508,ECE 207A,A00,091605,Liu; Thomas Tao-Ming,0,0,0,0
1653436863128,ECE 212AN,A00,091068,Nomura; Kenji,0,0,0,0
1653436863676,ECE 222A,A00,091069,Rebeiz; Gabriel,0,0,0,0
1653436864204,ECE 225A,A00,091070,Orlitsky; Alon,0,0,0,0
1653436864741,ECE 230A,A00,091071,Nomura; Kenji,0,0,0,0
1653436865275,ECE 236A,A00,091072,Dayeh; Shadi Ahmad,0,0,0,0
1653436865824,ECE 238A,A00,091073,Luo; Jian,0,0,0,0
1653436865824,ECE 238A,B00,091074,Luo; Jian,0,0,0,0
1653436866346,ECE 240A,A00,091075,Radic; Stojan,0,0,0,0
1653436866900,ECE 247A,A00,091592,Shi; Lingyan,0,0,0,0
1653436867445,ECE 250,A00,091076,Touri; Behrouz,0,0,0,0
1653436867971,ECE 251C,A00,091078,Nguyen; Truong Quang,0,0,0,0
1653436868493,ECE 253,A00,091079,Cosman; Pamela C.,0,0,0,0
1653436869048,ECE 255A,A00,091080,Orlitsky; Alon,0,0,0,0
1653436869614,ECE 257A,A00,091081,Zhang; Xinyu,0,0,0,0
1653436870229,ECE 260A,A01,091084,Eldon; John,0,0,0,0
1653436870773,ECE 264C,A00,091085,Galton; Ian A,0,0,0,0
1653436871327,ECE 265C,A00,094889,Presti; Calogero Davide,0,0,0,9
1653436871853,ECE 266,A01,091087,Hall; Drew A.,0,0,0,0
1653436873571,ECE 271A,A00,091090,Vasconcelos; Nuno,0,0,0,0
1653436874102,ECE 272B,A00,091091,Sworder; David D.,0,0,0,0
1653436874925,ECE 275A,A00,091092,Meyer; Florian,0,0,0,0
1653436875454,ECE 277,A00,091093,An; Cheolhong,0,0,0,0
1653436875987,ECE 283,A00,091094,Le; Hanh-Phuc,0,0,0,0
1653436876536,ECE 284,A00,091095,Kang; Mingu,0,0,0,0
1653436876536,ECE 284,B00,091096,Wang; Edward Jay,0,0,0,0
1653436877082,ECE 285,A00,094334,Touri; Behrouz,0,0,0,0
1653436877634,ECE 289,A00,091097,Whelan; David Arthur,0,0,0,0
1653436878438,MATH 200A,A00,087414,Salehi Golsefidy; Alireza,7,0,8,1
1653436878968,MATH 202A,A00,087415,Gill; Philip E.,3,0,8,5
1653436879519,MATH 203A,A00,087416,Oprea; Dragos N.,6,0,8,2
1653436880048,MATH 204A,A00,087417,Kedlaya; Kiran S.,6,0,8,2
1653436880714,MATH 205,A00,087418,Sorensen; Claus M,6,0,8,2
1653436881298,MATH 206A,A00,087419,Izadi; Elham,7,0,8,1
1653436881846,MATH 207A,A00,087420,Mohammadi; Amir,6,0,8,2
1653436882647,MATH 208,A00,087421,Staff,9,0,10,1
1653436883196,MATH 209,A00,087422,Staff,10,0,10,0
1653436883837,MATH 218,A00,087423,Staff,10,0,10,0
1653436884499,MATH 220A,A00,087424,Novak; Jonathan I,7,0,8,1
1653436885022,MATH 231A,A00,087425,Bejenaru; Ioan,4,0,8,4
1653436885599,MATH 240A,A00,087426,Ebenfelt; Peter F,5,0,8,3
1653436886122,MATH 243,A00,087427,Staff,9,0,10,1
1653436886685,MATH 248,A00,087429,Staff,10,0,10,0
1653436887230,MATH 250A,A00,087430,Spolaor; Luca,5,0,8,3
1653436887796,MATH 257A,A00,087431,Spolaor; Luca,7,0,8,1
1653436888319,MATH 258,A00,087432,Staff,9,0,10,1
1653436888867,MATH 264A,A00,087433,Warnke; Lutz Peter,5,0,8,3
1653436889389,MATH 268,A00,087434,Staff,15,0,15,0
1653436889935,MATH 269,A00,087435,Staff,14,0,15,1
1653436890575,MATH 270A,A00,087436,Nie; Jiawang,0,0,8,8
1653436891130,MATH 272A,A00,087437,Tian; Xiaochuan,1,0,8,7
1653436891671,MATH 274,A01,087439,Cheng; Li-Tien,9,0,10,1
1653436891671,MATH 274,A02,087440,Cheng; Li-Tien,10,0,10,0
1653436892194,MATH 278A,A00,087441,Staff,8,0,10,2
1653436892726,MATH 278B,A00,087442,Staff,8,0,10,2
1653436893256,MATH 278C,A00,087443,Staff,8,0,10,2
1653436893801,MATH 280A,A00,087444,Zheng; Tianyi,0,0,8,8
1653436894334,MATH 281A,A00,087445,Bradic; Jelena,0,0,8,8
1653436894880,MATH 282A,A00,087446,Zhang; Danna,0,0,8,8
1653436895431,MATH 283,A00,087447,Tesler; Glenn,0,0,0,14
1653436895976,MATH 286,A00,087448,Kemp; Todd Aahron,6,0,8,2
1653436896528,MATH 287D,A00,087449,Bradic; Jelena,8,0,8,0
1653436897063,MATH 288,A00,087450,Staff,14,0,15,1
1653436897063,MATH 288,B00,087451,Staff,15,0,15,0
1653436897063,MATH 288,C00,087452,Staff,15,0,15,0
1653436897591,MATH 290A,A00,087453,Xu; Zhouli,7,0,8,1
1653436898117,MATH 291A,A00,087454,Xu; Zhouli,7,0,8,1
1653436898643,MATH 292,A00,087455,Staff,10,0,10,0
1653436899188,MATH 295,A00,087456,Staff,50,0,50,0
1653436899720,MATH 297,001,087457,Staff,998,0,999,1
1653437482918,COGS 200,A01,087991,Staff,47,0,50,3
1653437483441,COGS 201,A01,094504,Rangel; Lara M,17,0,25,8
1653437483969,COGS 203,A00,087992,Coulson; Seana M,18,0,20,2
1653437484494,COGS 210A,001,087993,Greene; Deanna Jacquelyn,9998,0,9999,1
1653437484494,COGS 210A,002,087994,Saygin; Ayse P,9999,0,9999,0
1653437484494,COGS 210A,003,087995,Xia; Haijun,9999,0,9999,0
1653437484494,COGS 210A,004,087996,Nitz; Douglas A.,9999,0,9999,0
1653437484494,COGS 210A,005,087997,Hollan; James D.,9999,0,9999,0
1653437484494,COGS 210A,006,087998,Deak; Gedeon O.,9998,0,9999,1
1653437484494,COGS 210A,007,087999,Rossano; Federico,9999,0,9999,0
1653437485024,COGS 211A,A00,088000,Coulson; Seana M,9997,0,9999,2
1653437485548,COGS 229,A00,088002,Staff,23,0,25,2
1653437486136,COGS 260,B00,094231,Staff,17,0,20,3
1653437486136,COGS 260,A00,088004,Nitz; Douglas A.,9998,0,9999,1
1653437486679,CSE 202,A00,090110,Paturi; Ramamohan,0,0,0,0
1653437486679,CSE 202,B00,090111,Paturi; Ramamohan,0,0,0,0
1653437487204,CSE 207B,A00,090112,Heninger; Nadia A,0,0,0,0
1653437487921,CSE 208,A00,094858,Micciancio; Daniele,0,0,0,0
1653437488445,CSE 210,A00,090113,Powell; Thomas Allan,0,0,0,0
1653437488976,CSE 219,A00,090898,Staff,0,0,0,0
1653437489538,CSE 221,A00,090114,Zhou; Yuan-Yuan,0,0,0,0
1653437490070,CSE 229A,A00,090115,Porter; George M,0,0,0,0
1653437490604,CSE 229C,A00,090116,Savage; Stefan,0,0,0,0
1653437491134,CSE 230,A00,090117,Jhala; Ranjit,0,0,0,0
1653437491665,CSE 232,A00,090118,Papakonstantinou; Yannis,0,0,0,0
1653437492188,CSE 239A,A00,090121,Kumar; Arun Kumar,0,0,0,0
1653437492719,CSE 239B,A00,090122,Jhala; Ranjit,0,0,0,0
1653437493259,CSE 240A,A00,090123,Zhao; Jishen,0,0,189,189
1653437493785,CSE 243A,A00,090124,Orailoglu; Alex,3,0,15,12
1653437494344,CSE 249B,A00,090125,Kahng; Andrew Byun,13,0,20,7
1653437494868,CSE 250A,A00,090126,Berg-Kirkpatrick; Taylor D,0,0,0,0
1653437495504,CSE 252A,A00,090127,Ochoa; Benjamin Lawrence,0,0,0,0
1653437496031,CSE 258,A01,090129,McAuley; Julian John,0,0,0,0
1653437496558,CSE 258R,A01,090131,McAuley; Julian John,0,0,0,0
1653437497083,CSE 274,A00,090132,Ramamoorthi; Ravi,0,0,0,0
1653437497606,CSE 276A,A00,090133,Christensen; Henrik I,0,0,0,0
1653437498151,CSE 276C,A00,090134,Christensen; Henrik I,0,0,0,0
1653437498686,CSE 290,A00,090135,Bafna; Vineet,0,0,0,0
1653437498686,CSE 290,B00,090136,Ramamoorthi; Ravi,0,0,0,0
1653437498686,CSE 290,C00,090137,Li; Tzumao,9,0,10,1
1653437498686,CSE 290,D00,090138,Zhou; Yuan-Yuan,10,0,10,0
1653437498686,CSE 290,E00,090139,Christensen; Henrik I,10,0,10,0
1653437498686,CSE 290,F00,094053,Shalev; Aaron D,0,0,0,0
1653437499219,CSE 291,A00,090140,Munyaka; Imani N. S.,0,0,0,0
1653437499219,CSE 291,B00,094880,Yu; Qi,0,0,0,0
1653437499219,CSE 291,C00,090142,Pannuto; Patrick William,0,0,0,0
1653437499219,CSE 291,D00,094881,Zhang; Yiying,0,0,0,0
1653437499219,CSE 291,E00,095118,Su; Hao,0,0,0,0
1653437499801,CSE 293,001,094905,Bafna; Vineet,9999,0,9999,0
1653437499801,CSE 293,002,094906,Bellare; Mihir,9999,0,9999,0
1653437499801,CSE 293,003,094907,Berg-Kirkpatrick; Taylor D,9999,0,9999,0
1653437499801,CSE 293,004,094908,Christensen; Henrik I,9999,0,9999,0
1653437499801,CSE 293,005,094909,Cottrell; Garrison W,9999,0,9999,0
1653437499801,CSE 293,006,094910,Deutsch; Alin Bernard,9999,0,9999,0
1653437499801,CSE 293,007,094911,Esmaeilzadeh; Hadi,9999,0,9999,0
1653437499801,CSE 293,008,094912,Freund; Yoav,9999,0,9999,0
1653437499801,CSE 293,009,094913,Griswold; William G.,9999,0,9999,0
1653437499801,CSE 293,010,094914,Gymrek; Melissa Ann,9999,0,9999,0
1653437499801,CSE 293,011,094915,Heninger; Nadia A,9999,0,9999,0
1653437499801,CSE 293,012,094916,Impagliazzo; Russell,9999,0,9999,0
1653437499801,CSE 293,013,094917,Jhala; Ranjit,9999,0,9999,0
1653437499801,CSE 293,014,094918,Kahng; Andrew Byun,9999,0,9999,0
1653437499801,CSE 293,015,094919,Kane; Daniel Mertz,9999,0,9999,0
1653437499801,CSE 293,016,094920,Kriegman; David J,9999,0,9999,0
1653437499801,CSE 293,017,094921,Kumar; Arun Kumar,9999,0,9999,0
1653437499801,CSE 293,018,094922,Lerner; Sorin,9999,0,9999,0
1653437499801,CSE 293,019,094923,Lovett; Shachar,9999,0,9999,0
1653437499801,CSE 293,020,094924,McAuley; Julian John,9999,0,9999,0
1653437499801,CSE 293,021,094925,Micciancio; Daniele,9999,0,9999,0
1653437499801,CSE 293,022,094926,Orailoglu; Alex,9999,0,9999,0
1653437499801,CSE 293,023,094927,Paturi; Ramamohan,9999,0,9999,0
1653437499801,CSE 293,024,094928,Polikarpova; Nadezhda,9999,0,9999,0
1653437499801,CSE 293,025,094929,Politz; Joseph Gibbs,9999,0,9999,0
1653437499801,CSE 293,026,094930,Porter; George M,9999,0,9999,0
1653437499801,CSE 293,027,094931,Porter; Leonard Emerson,9999,0,9999,0
1653437499801,CSE 293,028,094932,Ramamoorthi; Ravi,9999,0,9999,0
1653437499801,CSE 293,029,094933,Sahoo; Debashis,9999,0,9999,0
1653437499801,CSE 293,030,094934,Saul; Lawrence,9999,0,9999,0
1653437499801,CSE 293,031,094935,Savage; Stefan,9999,0,9999,0
1653437499801,CSE 293,032,094936,Schulze; Jurgen P.,9999,0,9999,0
1653437499801,CSE 293,033,094937,Snoeren; Alex C.,9999,0,9999,0
1653437499801,CSE 293,034,094938,Shang; Jingbo,9999,0,9999,0
1653437499801,CSE 293,035,094939,Stefan; Deian,9999,0,9999,0
1653437499801,CSE 293,036,094940,Su; Hao,9999,0,9999,0
1653437499801,CSE 293,037,094941,Swanson; Steven James,9999,0,9999,0
1653437499801,CSE 293,038,094942,Tullsen; Dean Michael,9999,0,9999,0
1653437499801,CSE 293,039,094943,Voelker; Geoffrey M.,9999,0,9999,0
1653437499801,CSE 293,040,094944,Zhao; Jishen,9999,0,9999,0
1653437499801,CSE 293,041,094945,Zhou; Yuan-Yuan,9999,0,9999,0
1653437499801,CSE 293,042,094946,Gao; Sicun,9998,0,9999,1
1653437499801,CSE 293,043,094947,Weibel; Nadir,9999,0,9999,0
1653437499801,CSE 293,044,094948,Gupta; Rajesh K.,9999,0,9999,0
1653437500349,CSE 294,A00,090143,Porter; George M,9,0,10,1
1653437500884,DSE 200,A00,091799,Staff,50,0,50,0
1653437501405,DSE 203,A00,091800,Gupta; Amarnath,30,0,30,0
1653437501934,DSE 250,A00,091801,Deutsch; Alin Bernard,30,0,30,0
1653437502472,DSE 290,A00,091802,Altintas De Callaf; Ilkay,50,0,50,0
1653437503018,ECE 200,001,091003,Antipa; Nicholas A,9999,0,9999,0
1653437503018,ECE 200,002,091004,Atanasov; Nikolay A.,9999,0,9999,0
1653437503018,ECE 200,003,091005,Bharadia; Dinesh,9999,0,9999,0
1653437503018,ECE 200,004,091006,Cheng; Chung Kuan,9999,0,9999,0
1653437503018,ECE 200,005,091007,Cosman; Pamela C.,9999,0,9999,0
1653437503018,ECE 200,006,091008,Staff,9999,0,9999,0
1653437503018,ECE 200,007,091009,Dayeh; Shadi Ahmad,9999,0,9999,0
1653437503018,ECE 200,008,091010,Fainman; Yeshaiahu,9999,0,9999,0
1653437503018,ECE 200,009,091011,Ford; Joseph Earl,9999,0,9999,0
1653437503018,ECE 200,010,091012,Franceschetti; Massimo,9999,0,9999,0
1653437503018,ECE 200,011,091013,Fullerton; Eric E,9999,0,9999,0
1653437503018,ECE 200,012,091014,Galton; Ian A,9999,0,9999,0
1653437503018,ECE 200,013,091015,Gilja; Vikash,9999,0,9999,0
1653437503018,ECE 200,014,091016,Hall; Drew A.,9999,0,9999,0
1653437503018,ECE 200,015,091017,Hsueh; Tzu-Chien,9999,0,9999,0
1653437503018,ECE 200,016,091018,Javidi; Tara,9999,0,9999,0
1653437503018,ECE 200,017,091019,Kahng; Andrew Byun,9999,0,9999,0
1653437503018,ECE 200,018,091020,Kim; Young-Han,9999,0,9999,0
1653437503018,ECE 200,019,091021,Koushanfar; Farinaz,9999,0,9999,0
1653437503018,ECE 200,020,091022,Kuzum; Duygu,9999,0,9999,0
1653437503018,ECE 200,021,091023,Le; Hanh-Phuc,9999,0,9999,0
1653437503018,ECE 200,022,091024,Lin; Bill,9999,0,9999,0
1653437503018,ECE 200,023,091025,Liu; Zhaowei,9999,0,9999,0
1653437503018,ECE 200,024,091026,Lo; Yu-Hwa,9999,0,9999,0
1653437503018,ECE 200,025,091027,Lomakin; Vitaliy,9999,0,9999,0
1653437503018,ECE 200,026,091028,Mercier; Patrick Philip,9999,0,9999,0
1653437503018,ECE 200,027,091029,Meyer; Florian,9999,0,9999,0
1653437503018,ECE 200,028,091030,Milstein; Laurence B.,9999,0,9999,0
1653437503018,ECE 200,029,091031,Mir Arabbaygi; Siavash,9999,0,9999,0
1653437503018,ECE 200,030,091032,Mookherjea; Shayan,9999,0,9999,0
1653437503018,ECE 200,031,091033,Morris; Karcher William,9999,0,9999,0
1653437503018,ECE 200,032,091034,Ng; Tse Nga,9999,0,9999,0
1653437503018,ECE 200,033,091035,Nguyen; Truong Quang,9999,0,9999,0
1653437503018,ECE 200,034,091036,Nomura; Kenji,9999,0,9999,0
1653437503018,ECE 200,035,091037,Orlitsky; Alon,9999,0,9999,0
1653437503018,ECE 200,036,091038,Pal; Piya,9999,0,9999,0
1653437503018,ECE 200,037,091039,Papen; George C.,9999,0,9999,0
1653437503018,ECE 200,038,091040,Radic; Stojan,9999,0,9999,0
1653437503018,ECE 200,039,091041,Rao; Bhaskar D.,9999,0,9999,0
1653437503018,ECE 200,040,091042,Rao; Ramesh R,9999,0,9999,0
1653437503018,ECE 200,041,091043,Rebeiz; Gabriel,9999,0,9999,0
1653437503018,ECE 200,042,091044,Sanford; John R,9999,0,9999,0
1653437503018,ECE 200,043,091045,Siegel; Paul H.,9999,0,9999,0
1653437503018,ECE 200,044,091046,Sievenpiper; Daniel F.,9999,0,9999,0
1653437503018,ECE 200,045,091047,Sworder; David D.,9999,0,9999,0
1653437503018,ECE 200,046,091048,Taur; Yuan,9999,0,9999,0
1653437503018,ECE 200,047,091049,Touri; Behrouz,9999,0,9999,0
1653437503018,ECE 200,048,091050,Trivedi; Mohan M.,9999,0,9999,0
1653437503018,ECE 200,049,091051,Vardy; Alexander,9999,0,9999,0
1653437503018,ECE 200,050,091052,Vasconcelos; Nuno,9999,0,9999,0
1653437503018,ECE 200,051,091053,Wang; Xiaolong,9999,0,9999,0
1653437503018,ECE 200,052,091054,Xie; Pengtao,9999,0,9999,0
1653437503018,ECE 200,053,091055,Yip; Michael,9999,0,9999,0
1653437503018,ECE 200,054,091056,Zeger; Kenneth A.,9999,0,9999,0
1653437503018,ECE 200,055,091057,Zhang; Xinyu,9999,0,9999,0
1653437503018,ECE 200,056,091058,Turakhia; Yatish Girish,9999,0,9999,0
1653437503018,ECE 200,057,091059,Kang; Mingu,9999,0,9999,0
1653437503018,ECE 200,058,091060,Shi; Yuanyuan,9999,0,9999,0
1653437503018,ECE 200,059,091061,Wang; Edward Jay,9999,0,9999,0
1653437503018,ECE 200,060,091062,Zheng; Yang,9999,0,9999,0
1653437503559,ECE 203,A00,091065,Mercier; Patrick Philip,0,0,0,0
1653437504101,ECE 207A,A00,091605,Liu; Thomas Tao-Ming,0,0,0,0
1653437504638,ECE 212AN,A00,091068,Nomura; Kenji,0,0,0,0
1653437505161,ECE 222A,A00,091069,Rebeiz; Gabriel,0,0,0,0
1653437505700,ECE 225A,A00,091070,Orlitsky; Alon,0,0,0,0
1653437506252,ECE 230A,A00,091071,Nomura; Kenji,0,0,0,0
1653437506808,ECE 236A,A00,091072,Dayeh; Shadi Ahmad,0,0,0,0
1653437507365,ECE 238A,A00,091073,Luo; Jian,0,0,0,0
1653437507365,ECE 238A,B00,091074,Luo; Jian,0,0,0,0
1653437507887,ECE 240A,A00,091075,Radic; Stojan,0,0,0,0
1653437508418,ECE 247A,A00,091592,Shi; Lingyan,0,0,0,0
1653437508956,ECE 250,A00,091076,Touri; Behrouz,0,0,0,0
1653437509478,ECE 251C,A00,091078,Nguyen; Truong Quang,0,0,0,0
1653437510013,ECE 253,A00,091079,Cosman; Pamela C.,0,0,0,0
1653437510539,ECE 255A,A00,091080,Orlitsky; Alon,0,0,0,0
1653437511067,ECE 257A,A00,091081,Zhang; Xinyu,0,0,0,0
1653437511597,ECE 260A,A01,091084,Eldon; John,0,0,0,0
1653437512128,ECE 264C,A00,091085,Galton; Ian A,0,0,0,0
1653437512655,ECE 265C,A00,094889,Presti; Calogero Davide,0,0,0,9
1653437513196,ECE 266,A01,091087,Hall; Drew A.,0,0,0,0
1653437514274,ECE 271A,A00,091090,Vasconcelos; Nuno,0,0,0,0
1653437514806,ECE 272B,A00,091091,Sworder; David D.,0,0,0,0
1653437515351,ECE 275A,A00,091092,Meyer; Florian,0,0,0,0
1653437515896,ECE 277,A00,091093,An; Cheolhong,0,0,0,0
1653437516439,ECE 283,A00,091094,Le; Hanh-Phuc,0,0,0,0
1653437516970,ECE 284,A00,091095,Kang; Mingu,0,0,0,0
1653437516970,ECE 284,B00,091096,Wang; Edward Jay,0,0,0,0
1653437517513,ECE 285,A00,094334,Touri; Behrouz,0,0,0,0
1653437518041,ECE 289,A00,091097,Whelan; David Arthur,0,0,0,0
1653437518564,MATH 200A,A00,087414,Salehi Golsefidy; Alireza,7,0,8,1
1653437519105,MATH 202A,A00,087415,Gill; Philip E.,3,0,8,5
1653437519653,MATH 203A,A00,087416,Oprea; Dragos N.,6,0,8,2
1653437520176,MATH 204A,A00,087417,Kedlaya; Kiran S.,6,0,8,2
1653437520726,MATH 205,A00,087418,Sorensen; Claus M,6,0,8,2
1653437521272,MATH 206A,A00,087419,Izadi; Elham,7,0,8,1
1653437521806,MATH 207A,A00,087420,Mohammadi; Amir,6,0,8,2
1653437522328,MATH 208,A00,087421,Staff,9,0,10,1
1653437522856,MATH 209,A00,087422,Staff,10,0,10,0
1653437523449,MATH 218,A00,087423,Staff,10,0,10,0
1653437523972,MATH 220A,A00,087424,Novak; Jonathan I,7,0,8,1
1653437524503,MATH 231A,A00,087425,Bejenaru; Ioan,4,0,8,4
1653437525066,MATH 240A,A00,087426,Ebenfelt; Peter F,5,0,8,3
1653437525590,MATH 243,A00,087427,Staff,9,0,10,1
1653437526112,MATH 248,A00,087429,Staff,10,0,10,0
1653437526636,MATH 250A,A00,087430,Spolaor; Luca,5,0,8,3
1653437527169,MATH 257A,A00,087431,Spolaor; Luca,7,0,8,1
1653437527707,MATH 258,A00,087432,Staff,9,0,10,1
1653437528233,MATH 264A,A00,087433,Warnke; Lutz Peter,5,0,8,3
1653437528758,MATH 268,A00,087434,Staff,15,0,15,0
1653437529303,MATH 269,A00,087435,Staff,14,0,15,1
1653437529824,MATH 270A,A00,087436,Nie; Jiawang,0,0,8,8
1653437530389,MATH 272A,A00,087437,Tian; Xiaochuan,1,0,8,7
1653437530915,MATH 274,A01,087439,Cheng; Li-Tien,9,0,10,1
1653437530915,MATH 274,A02,087440,Cheng; Li-Tien,10,0,10,0
1653437531471,MATH 278A,A00,087441,Staff,8,0,10,2
1653437532008,MATH 278B,A00,087442,Staff,8,0,10,2
1653437532531,MATH 278C,A00,087443,Staff,8,0,10,2
1653437533053,MATH 280A,A00,087444,Zheng; Tianyi,0,0,8,8
1653437533710,MATH 281A,A00,087445,Bradic; Jelena,0,0,8,8
1653437534258,MATH 282A,A00,087446,Zhang; Danna,0,0,8,8
1653437534857,MATH 283,A00,087447,Tesler; Glenn,0,0,0,14
1653437535398,MATH 286,A00,087448,Kemp; Todd Aahron,6,0,8,2
1653437535921,MATH 287D,A00,087449,Bradic; Jelena,8,0,8,0
1653437536468,MATH 288,A00,087450,Staff,14,0,15,1
1653437536468,MATH 288,B00,087451,Staff,15,0,15,0
1653437536468,MATH 288,C00,087452,Staff,15,0,15,0
1653437536993,MATH 290A,A00,087453,Xu; Zhouli,7,0,8,1
1653437537525,MATH 291A,A00,087454,Xu; Zhouli,7,0,8,1
1653437538403,MATH 292,A00,087455,Staff,10,0,10,0
1653437539386,MATH 295,A00,087456,Staff,50,0,50,0
1653437539908,MATH 297,001,087457,Staff,998,0,999,1
1653438111773,COGS 200,A01,087991,Staff,47,0,50,3
1653438112305,COGS 201,A01,094504,Rangel; Lara M,17,0,25,8
1653438112841,COGS 203,A00,087992,Coulson; Seana M,18,0,20,2
1653438113373,COGS 210A,001,087993,Greene; Deanna Jacquelyn,9998,0,9999,1
1653438113373,COGS 210A,002,087994,Saygin; Ayse P,9999,0,9999,0
1653438113373,COGS 210A,003,087995,Xia; Haijun,9999,0,9999,0
1653438113373,COGS 210A,004,087996,Nitz; Douglas A.,9999,0,9999,0
1653438113373,COGS 210A,005,087997,Hollan; James D.,9999,0,9999,0
1653438113373,COGS 210A,006,087998,Deak; Gedeon O.,9998,0,9999,1
1653438113373,COGS 210A,007,087999,Rossano; Federico,9999,0,9999,0
1653438113910,COGS 211A,A00,088000,Coulson; Seana M,9997,0,9999,2
1653438114432,COGS 229,A00,088002,Staff,23,0,25,2
1653438114977,COGS 260,B00,094231,Staff,17,0,20,3
1653438114977,COGS 260,A00,088004,Nitz; Douglas A.,9998,0,9999,1
1653438115506,CSE 202,A00,090110,Paturi; Ramamohan,0,0,0,0
1653438115506,CSE 202,B00,090111,Paturi; Ramamohan,0,0,0,0
1653438116042,CSE 207B,A00,090112,Heninger; Nadia A,0,0,0,0
1653438116590,CSE 208,A00,094858,Micciancio; Daniele,0,0,0,0
1653438117131,CSE 210,A00,090113,Powell; Thomas Allan,0,0,0,0
1653438117659,CSE 219,A00,090898,Staff,0,0,0,0
1653438118195,CSE 221,A00,090114,Zhou; Yuan-Yuan,0,0,0,0
1653438118745,CSE 229A,A00,090115,Porter; George M,0,0,0,0
1653438119268,CSE 229C,A00,090116,Savage; Stefan,0,0,0,0
1653438119792,CSE 230,A00,090117,Jhala; Ranjit,0,0,0,0
1653438120318,CSE 232,A00,090118,Papakonstantinou; Yannis,0,0,0,0
1653438120842,CSE 239A,A00,090121,Kumar; Arun Kumar,0,0,0,0
1653438121368,CSE 239B,A00,090122,Jhala; Ranjit,0,0,0,0
1653438121891,CSE 240A,A00,090123,Zhao; Jishen,0,0,189,189
1653438122423,CSE 243A,A00,090124,Orailoglu; Alex,3,0,15,12
1653438122950,CSE 249B,A00,090125,Kahng; Andrew Byun,13,0,20,7
1653438123485,CSE 250A,A00,090126,Berg-Kirkpatrick; Taylor D,0,0,0,0
1653438124007,CSE 252A,A00,090127,Ochoa; Benjamin Lawrence,0,0,0,0
1653438124540,CSE 258,A01,090129,McAuley; Julian John,0,0,0,0
1653438125065,CSE 258R,A01,090131,McAuley; Julian John,0,0,0,0
1653438125596,CSE 274,A00,090132,Ramamoorthi; Ravi,0,0,0,0
1653438126128,CSE 276A,A00,090133,Christensen; Henrik I,0,0,0,0
1653438126651,CSE 276C,A00,090134,Christensen; Henrik I,0,0,0,0
1653438127173,CSE 290,A00,090135,Bafna; Vineet,0,0,0,0
1653438127173,CSE 290,B00,090136,Ramamoorthi; Ravi,0,0,0,0
1653438127173,CSE 290,C00,090137,Li; Tzumao,9,0,10,1
1653438127173,CSE 290,D00,090138,Zhou; Yuan-Yuan,10,0,10,0
1653438127173,CSE 290,E00,090139,Christensen; Henrik I,10,0,10,0
1653438127173,CSE 290,F00,094053,Shalev; Aaron D,0,0,0,0
1653438127718,CSE 291,A00,090140,Munyaka; Imani N. S.,0,0,0,0
1653438127718,CSE 291,B00,094880,Yu; Qi,0,0,0,0
1653438127718,CSE 291,C00,090142,Pannuto; Patrick William,0,0,0,0
1653438127718,CSE 291,D00,094881,Zhang; Yiying,0,0,0,0
1653438127718,CSE 291,E00,095118,Su; Hao,0,0,0,0
1653438128249,CSE 293,001,094905,Bafna; Vineet,9999,0,9999,0
1653438128249,CSE 293,002,094906,Bellare; Mihir,9999,0,9999,0
1653438128249,CSE 293,003,094907,Berg-Kirkpatrick; Taylor D,9999,0,9999,0
1653438128249,CSE 293,004,094908,Christensen; Henrik I,9999,0,9999,0
1653438128249,CSE 293,005,094909,Cottrell; Garrison W,9999,0,9999,0
1653438128249,CSE 293,006,094910,Deutsch; Alin Bernard,9999,0,9999,0
1653438128249,CSE 293,007,094911,Esmaeilzadeh; Hadi,9999,0,9999,0
1653438128249,CSE 293,008,094912,Freund; Yoav,9999,0,9999,0
1653438128249,CSE 293,009,094913,Griswold; William G.,9999,0,9999,0
1653438128249,CSE 293,010,094914,Gymrek; Melissa Ann,9999,0,9999,0
1653438128249,CSE 293,011,094915,Heninger; Nadia A,9999,0,9999,0
1653438128249,CSE 293,012,094916,Impagliazzo; Russell,9999,0,9999,0
1653438128249,CSE 293,013,094917,Jhala; Ranjit,9999,0,9999,0
1653438128249,CSE 293,014,094918,Kahng; Andrew Byun,9999,0,9999,0
1653438128249,CSE 293,015,094919,Kane; Daniel Mertz,9999,0,9999,0
1653438128249,CSE 293,016,094920,Kriegman; David J,9999,0,9999,0
1653438128249,CSE 293,017,094921,Kumar; Arun Kumar,9999,0,9999,0
1653438128249,CSE 293,018,094922,Lerner; Sorin,9999,0,9999,0
1653438128249,CSE 293,019,094923,Lovett; Shachar,9999,0,9999,0
1653438128249,CSE 293,020,094924,McAuley; Julian John,9999,0,9999,0
1653438128249,CSE 293,021,094925,Micciancio; Daniele,9999,0,9999,0
1653438128249,CSE 293,022,094926,Orailoglu; Alex,9999,0,9999,0
1653438128249,CSE 293,023,094927,Paturi; Ramamohan,9999,0,9999,0
1653438128249,CSE 293,024,094928,Polikarpova; Nadezhda,9999,0,9999,0
1653438128249,CSE 293,025,094929,Politz; Joseph Gibbs,9999,0,9999,0
1653438128249,CSE 293,026,094930,Porter; George M,9999,0,9999,0
1653438128249,CSE 293,027,094931,Porter; Leonard Emerson,9999,0,9999,0
1653438128249,CSE 293,028,094932,Ramamoorthi; Ravi,9999,0,9999,0
1653438128249,CSE 293,029,094933,Sahoo; Debashis,9999,0,9999,0
1653438128249,CSE 293,030,094934,Saul; Lawrence,9999,0,9999,0
1653438128249,CSE 293,031,094935,Savage; Stefan,9999,0,9999,0
1653438128249,CSE 293,032,094936,Schulze; Jurgen P.,9999,0,9999,0
1653438128249,CSE 293,033,094937,Snoeren; Alex C.,9999,0,9999,0
1653438128249,CSE 293,034,094938,Shang; Jingbo,9999,0,9999,0
1653438128249,CSE 293,035,094939,Stefan; Deian,9999,0,9999,0
1653438128249,CSE 293,036,094940,Su; Hao,9999,0,9999,0
1653438128249,CSE 293,037,094941,Swanson; Steven James,9999,0,9999,0
1653438128249,CSE 293,038,094942,Tullsen; Dean Michael,9999,0,9999,0
1653438128249,CSE 293,039,094943,Voelker; Geoffrey M.,9999,0,9999,0
1653438128249,CSE 293,040,094944,Zhao; Jishen,9999,0,9999,0
1653438128249,CSE 293,041,094945,Zhou; Yuan-Yuan,9999,0,9999,0
1653438128249,CSE 293,042,094946,Gao; Sicun,9998,0,9999,1
1653438128249,CSE 293,043,094947,Weibel; Nadir,9999,0,9999,0
1653438128249,CSE 293,044,094948,Gupta; Rajesh K.,9999,0,9999,0
1653438128792,CSE 294,A00,090143,Porter; George M,9,0,10,1
1653438129323,DSE 200,A00,091799,Staff,50,0,50,0
1653438129850,DSE 203,A00,091800,Gupta; Amarnath,30,0,30,0
1653438130383,DSE 250,A00,091801,Deutsch; Alin Bernard,30,0,30,0
1653438130905,DSE 290,A00,091802,Altintas De Callaf; Ilkay,50,0,50,0
1653438131466,ECE 200,001,091003,Antipa; Nicholas A,9999,0,9999,0
1653438131466,ECE 200,002,091004,Atanasov; Nikolay A.,9999,0,9999,0
1653438131466,ECE 200,003,091005,Bharadia; Dinesh,9999,0,9999,0
1653438131466,ECE 200,004,091006,Cheng; Chung Kuan,9999,0,9999,0
1653438131466,ECE 200,005,091007,Cosman; Pamela C.,9999,0,9999,0
1653438131466,ECE 200,006,091008,Staff,9999,0,9999,0
1653438131466,ECE 200,007,091009,Dayeh; Shadi Ahmad,9999,0,9999,0
1653438131466,ECE 200,008,091010,Fainman; Yeshaiahu,9999,0,9999,0
1653438131466,ECE 200,009,091011,Ford; Joseph Earl,9999,0,9999,0
1653438131466,ECE 200,010,091012,Franceschetti; Massimo,9999,0,9999,0
1653438131466,ECE 200,011,091013,Fullerton; Eric E,9999,0,9999,0
1653438131466,ECE 200,012,091014,Galton; Ian A,9999,0,9999,0
1653438131466,ECE 200,013,091015,Gilja; Vikash,9999,0,9999,0
1653438131466,ECE 200,014,091016,Hall; Drew A.,9999,0,9999,0
1653438131466,ECE 200,015,091017,Hsueh; Tzu-Chien,9999,0,9999,0
1653438131466,ECE 200,016,091018,Javidi; Tara,9999,0,9999,0
1653438131466,ECE 200,017,091019,Kahng; Andrew Byun,9999,0,9999,0
1653438131466,ECE 200,018,091020,Kim; Young-Han,9999,0,9999,0
1653438131466,ECE 200,019,091021,Koushanfar; Farinaz,9999,0,9999,0
1653438131466,ECE 200,020,091022,Kuzum; Duygu,9999,0,9999,0
1653438131466,ECE 200,021,091023,Le; Hanh-Phuc,9999,0,9999,0
1653438131466,ECE 200,022,091024,Lin; Bill,9999,0,9999,0
1653438131466,ECE 200,023,091025,Liu; Zhaowei,9999,0,9999,0
1653438131466,ECE 200,024,091026,Lo; Yu-Hwa,9999,0,9999,0
1653438131466,ECE 200,025,091027,Lomakin; Vitaliy,9999,0,9999,0
1653438131466,ECE 200,026,091028,Mercier; Patrick Philip,9999,0,9999,0
1653438131466,ECE 200,027,091029,Meyer; Florian,9999,0,9999,0
1653438131466,ECE 200,028,091030,Milstein; Laurence B.,9999,0,9999,0
1653438131466,ECE 200,029,091031,Mir Arabbaygi; Siavash,9999,0,9999,0
1653438131466,ECE 200,030,091032,Mookherjea; Shayan,9999,0,9999,0
1653438131466,ECE 200,031,091033,Morris; Karcher William,9999,0,9999,0
1653438131466,ECE 200,032,091034,Ng; Tse Nga,9999,0,9999,0
1653438131466,ECE 200,033,091035,Nguyen; Truong Quang,9999,0,9999,0
1653438131466,ECE 200,034,091036,Nomura; Kenji,9999,0,9999,0
1653438131466,ECE 200,035,091037,Orlitsky; Alon,9999,0,9999,0
1653438131466,ECE 200,036,091038,Pal; Piya,9999,0,9999,0
1653438131466,ECE 200,037,091039,Papen; George C.,9999,0,9999,0
1653438131466,ECE 200,038,091040,Radic; Stojan,9999,0,9999,0
1653438131466,ECE 200,039,091041,Rao; Bhaskar D.,9999,0,9999,0
1653438131466,ECE 200,040,091042,Rao; Ramesh R,9999,0,9999,0
1653438131466,ECE 200,041,091043,Rebeiz; Gabriel,9999,0,9999,0
1653438131466,ECE 200,042,091044,Sanford; John R,9999,0,9999,0
1653438131466,ECE 200,043,091045,Siegel; Paul H.,9999,0,9999,0
1653438131466,ECE 200,044,091046,Sievenpiper; Daniel F.,9999,0,9999,0
1653438131466,ECE 200,045,091047,Sworder; David D.,9999,0,9999,0
1653438131466,ECE 200,046,091048,Taur; Yuan,9999,0,9999,0
1653438131466,ECE 200,047,091049,Touri; Behrouz,9999,0,9999,0
1653438131466,ECE 200,048,091050,Trivedi; Mohan M.,9999,0,9999,0
1653438131466,ECE 200,049,091051,Vardy; Alexander,9999,0,9999,0
1653438131466,ECE 200,050,091052,Vasconcelos; Nuno,9999,0,9999,0
1653438131466,ECE 200,051,091053,Wang; Xiaolong,9999,0,9999,0
1653438131466,ECE 200,052,091054,Xie; Pengtao,9999,0,9999,0
1653438131466,ECE 200,053,091055,Yip; Michael,9999,0,9999,0
1653438131466,ECE 200,054,091056,Zeger; Kenneth A.,9999,0,9999,0
1653438131466,ECE 200,055,091057,Zhang; Xinyu,9999,0,9999,0
1653438131466,ECE 200,056,091058,Turakhia; Yatish Girish,9999,0,9999,0
1653438131466,ECE 200,057,091059,Kang; Mingu,9999,0,9999,0
1653438131466,ECE 200,058,091060,Shi; Yuanyuan,9999,0,9999,0
1653438131466,ECE 200,059,091061,Wang; Edward Jay,9999,0,9999,0
1653438131466,ECE 200,060,091062,Zheng; Yang,9999,0,9999,0
1653438131993,ECE 203,A00,091065,Mercier; Patrick Philip,0,0,0,0
1653438132516,ECE 207A,A00,091605,Liu; Thomas Tao-Ming,0,0,0,0
1653438133060,ECE 212AN,A00,091068,Nomura; Kenji,0,0,0,0
1653438133606,ECE 222A,A00,091069,Rebeiz; Gabriel,0,0,0,0
1653438134128,ECE 225A,A00,091070,Orlitsky; Alon,0,0,0,0
1653438134667,ECE 230A,A00,091071,Nomura; Kenji,0,0,0,0
1653438135204,ECE 236A,A00,091072,Dayeh; Shadi Ahmad,0,0,0,0
1653438135728,ECE 238A,A00,091073,Luo; Jian,0,0,0,0
1653438135728,ECE 238A,B00,091074,Luo; Jian,0,0,0,0
1653438136250,ECE 240A,A00,091075,Radic; Stojan,0,0,0,0
1653438136772,ECE 247A,A00,091592,Shi; Lingyan,0,0,0,0
1653438137297,ECE 250,A00,091076,Touri; Behrouz,0,0,0,0
1653438137833,ECE 251C,A00,091078,Nguyen; Truong Quang,0,0,0,0
1653438138359,ECE 253,A00,091079,Cosman; Pamela C.,0,0,0,0
1653438138888,ECE 255A,A00,091080,Orlitsky; Alon,0,0,0,0
1653438139415,ECE 257A,A00,091081,Zhang; Xinyu,0,0,0,0
1653438139953,ECE 260A,A01,091084,Eldon; John,0,0,0,0
1653438140475,ECE 264C,A00,091085,Galton; Ian A,0,0,0,0
1653438141122,ECE 265C,A00,094889,Presti; Calogero Davide,0,0,0,9
1653438141645,ECE 266,A01,091087,Hall; Drew A.,0,0,0,0
1653438142721,ECE 271A,A00,091090,Vasconcelos; Nuno,0,0,0,0
1653438143267,ECE 272B,A00,091091,Sworder; David D.,0,0,0,0
1653438143790,ECE 275A,A00,091092,Meyer; Florian,0,0,0,0
1653438144325,ECE 277,A00,091093,An; Cheolhong,0,0,0,0
1653438144868,ECE 283,A00,091094,Le; Hanh-Phuc,0,0,0,0
1653438145414,ECE 284,A00,091095,Kang; Mingu,0,0,0,0
1653438145414,ECE 284,B00,091096,Wang; Edward Jay,0,0,0,0
1653438145949,ECE 285,A00,094334,Touri; Behrouz,0,0,0,0
1653438146488,ECE 289,A00,091097,Whelan; David Arthur,0,0,0,0
1653438147020,MATH 200A,A00,087414,Salehi Golsefidy; Alireza,7,0,8,1
1653438147573,MATH 202A,A00,087415,Gill; Philip E.,3,0,8,5
1653438148107,MATH 203A,A00,087416,Oprea; Dragos N.,6,0,8,2
1653438148663,MATH 204A,A00,087417,Kedlaya; Kiran S.,6,0,8,2
1653438149194,MATH 205,A00,087418,Sorensen; Claus M,6,0,8,2
1653438149799,MATH 206A,A00,087419,Izadi; Elham,7,0,8,1
1653438150437,MATH 207A,A00,087420,Mohammadi; Amir,6,0,8,2
1653438150960,MATH 208,A00,087421,Staff,9,0,10,1
1653438151488,MATH 209,A00,087422,Staff,10,0,10,0
1653438152035,MATH 218,A00,087423,Staff,10,0,10,0
1653438152578,MATH 220A,A00,087424,Novak; Jonathan I,7,0,8,1
1653438153104,MATH 231A,A00,087425,Bejenaru; Ioan,4,0,8,4
1653438153643,MATH 240A,A00,087426,Ebenfelt; Peter F,5,0,8,3
1653438154171,MATH 243,A00,087427,Staff,9,0,10,1
1653438154722,MATH 248,A00,087429,Staff,10,0,10,0
1653438155254,MATH 250A,A00,087430,Spolaor; Luca,4,0,8,4
1653438155791,MATH 257A,A00,087431,Spolaor; Luca,7,0,8,1
1653438156315,MATH 258,A00,087432,Staff,9,0,10,1
1653438156859,MATH 264A,A00,087433,Warnke; Lutz Peter,5,0,8,3
1653438157396,MATH 268,A00,087434,Staff,15,0,15,0
1653438157935,MATH 269,A00,087435,Staff,14,0,15,1
1653438158467,MATH 270A,A00,087436,Nie; Jiawang,0,0,8,8
1653438159004,MATH 272A,A00,087437,Tian; Xiaochuan,1,0,8,7
1653438159529,MATH 274,A01,087439,Cheng; Li-Tien,9,0,10,1
1653438159529,MATH 274,A02,087440,Cheng; Li-Tien,10,0,10,0
1653438160052,MATH 278A,A00,087441,Staff,8,0,10,2
1653438160574,MATH 278B,A00,087442,Staff,8,0,10,2
1653438161100,MATH 278C,A00,087443,Staff,8,0,10,2
1653438161621,MATH 280A,A00,087444,Zheng; Tianyi,0,0,8,8
1653438162158,MATH 281A,A00,087445,Bradic; Jelena,0,0,8,8
1653438162685,MATH 282A,A00,087446,Zhang; Danna,0,0,8,8
1653438163208,MATH 283,A00,087447,Tesler; Glenn,0,0,0,14
1653438163732,MATH 286,A00,087448,Kemp; Todd Aahron,6,0,8,2
1653438164254,MATH 287D,A00,087449,Bradic; Jelena,8,0,8,0
1653438164801,MATH 288,A00,087450,Staff,14,0,15,1
1653438164801,MATH 288,B00,087451,Staff,15,0,15,0
1653438164801,MATH 288,C00,087452,Staff,15,0,15,0
1653438165324,MATH 290A,A00,087453,Xu; Zhouli,7,0,8,1
1653438165848,MATH 291A,A00,087454,Xu; Zhouli,7,0,8,1
1653438166377,MATH 292,A00,087455,Staff,10,0,10,0
1653438166923,MATH 295,A00,087456,Staff,50,0,50,0
1653438167457,MATH 297,001,087457,Staff,998,0,999,1
1653438735782,COGS 200,A01,087991,Staff,47,0,50,3
1653438736326,COGS 201,A01,094504,Rangel; Lara M,17,0,25,8
1653438736866,COGS 203,A00,087992,Coulson; Seana M,18,0,20,2
1653438737400,COGS 210A,001,087993,Greene; Deanna Jacquelyn,9998,0,9999,1
1653438737400,COGS 210A,002,087994,Saygin; Ayse P,9999,0,9999,0
1653438737400,COGS 210A,003,087995,Xia; Haijun,9999,0,9999,0
1653438737400,COGS 210A,004,087996,Nitz; Douglas A.,9999,0,9999,0
1653438737400,COGS 210A,005,087997,Hollan; James D.,9999,0,9999,0
1653438737400,COGS 210A,006,087998,Deak; Gedeon O.,9998,0,9999,1
1653438737400,COGS 210A,007,087999,Rossano; Federico,9999,0,9999,0
1653438737927,COGS 211A,A00,088000,Coulson; Seana M,9997,0,9999,2
1653438738475,COGS 229,A00,088002,Staff,23,0,25,2
1653438739003,COGS 260,B00,094231,Staff,17,0,20,3
1653438739003,COGS 260,A00,088004,Nitz; Douglas A.,9998,0,9999,1
1653438739526,CSE 202,A00,090110,Paturi; Ramamohan,0,0,0,0
1653438739526,CSE 202,B00,090111,Paturi; Ramamohan,0,0,0,0
1653438740080,CSE 207B,A00,090112,Heninger; Nadia A,0,0,0,0
1653438740605,CSE 208,A00,094858,Micciancio; Daniele,0,0,0,0
1653438741142,CSE 210,A00,090113,Powell; Thomas Allan,0,0,0,0
1653438741666,CSE 219,A00,090898,Staff,0,0,0,0
1653438742203,CSE 221,A00,090114,Zhou; Yuan-Yuan,0,0,0,0
1653438742752,CSE 229A,A00,090115,Porter; George M,0,0,0,0
1653438743275,CSE 229C,A00,090116,Savage; Stefan,0,0,0,0
1653438743821,CSE 230,A00,090117,Jhala; Ranjit,0,0,0,0
1653438744345,CSE 232,A00,090118,Papakonstantinou; Yannis,0,0,0,0
1653438744878,CSE 239A,A00,090121,Kumar; Arun Kumar,0,0,0,0
1653438745400,CSE 239B,A00,090122,Jhala; Ranjit,0,0,0,0
1653438745922,CSE 240A,A00,090123,Zhao; Jishen,0,0,189,189
1653438746577,CSE 243A,A00,090124,Orailoglu; Alex,3,0,15,12
1653438747100,CSE 249B,A00,090125,Kahng; Andrew Byun,13,0,20,7
1653438747624,CSE 250A,A00,090126,Berg-Kirkpatrick; Taylor D,0,0,0,0
1653438748161,CSE 252A,A00,090127,Ochoa; Benjamin Lawrence,0,0,0,0
1653438748694,CSE 258,A01,090129,McAuley; Julian John,0,0,0,0
1653438749238,CSE 258R,A01,090131,McAuley; Julian John,0,0,0,0
1653438749780,CSE 274,A00,090132,Ramamoorthi; Ravi,0,0,0,0
1653438750304,CSE 276A,A00,090133,Christensen; Henrik I,0,0,0,0
1653438750827,CSE 276C,A00,090134,Christensen; Henrik I,0,0,0,0
1653438751373,CSE 290,A00,090135,Bafna; Vineet,0,0,0,0
1653438751373,CSE 290,B00,090136,Ramamoorthi; Ravi,0,0,0,0
1653438751373,CSE 290,C00,090137,Li; Tzumao,9,0,10,1
1653438751373,CSE 290,D00,090138,Zhou; Yuan-Yuan,10,0,10,0
1653438751373,CSE 290,E00,090139,Christensen; Henrik I,10,0,10,0
1653438751373,CSE 290,F00,094053,Shalev; Aaron D,0,0,0,0
1653438751899,CSE 291,A00,090140,Munyaka; Imani N. S.,0,0,0,0
1653438751899,CSE 291,B00,094880,Yu; Qi,0,0,0,0
1653438751899,CSE 291,C00,090142,Pannuto; Patrick William,0,0,0,0
1653438751899,CSE 291,D00,094881,Zhang; Yiying,0,0,0,0
1653438751899,CSE 291,E00,095118,Su; Hao,0,0,0,0
1653438752463,CSE 293,001,094905,Bafna; Vineet,9999,0,9999,0
1653438752463,CSE 293,002,094906,Bellare; Mihir,9999,0,9999,0
1653438752463,CSE 293,003,094907,Berg-Kirkpatrick; Taylor D,9999,0,9999,0
1653438752463,CSE 293,004,094908,Christensen; Henrik I,9999,0,9999,0
1653438752463,CSE 293,005,094909,Cottrell; Garrison W,9999,0,9999,0
1653438752463,CSE 293,006,094910,Deutsch; Alin Bernard,9999,0,9999,0
1653438752463,CSE 293,007,094911,Esmaeilzadeh; Hadi,9999,0,9999,0
1653438752463,CSE 293,008,094912,Freund; Yoav,9999,0,9999,0
1653438752463,CSE 293,009,094913,Griswold; William G.,9999,0,9999,0
1653438752463,CSE 293,010,094914,Gymrek; Melissa Ann,9999,0,9999,0
1653438752463,CSE 293,011,094915,Heninger; Nadia A,9999,0,9999,0
1653438752463,CSE 293,012,094916,Impagliazzo; Russell,9999,0,9999,0
1653438752463,CSE 293,013,094917,Jhala; Ranjit,9999,0,9999,0
1653438752463,CSE 293,014,094918,Kahng; Andrew Byun,9999,0,9999,0
1653438752463,CSE 293,015,094919,Kane; Daniel Mertz,9999,0,9999,0
1653438752463,CSE 293,016,094920,Kriegman; David J,9999,0,9999,0
1653438752463,CSE 293,017,094921,Kumar; Arun Kumar,9999,0,9999,0
1653438752463,CSE 293,018,094922,Lerner; Sorin,9999,0,9999,0
1653438752463,CSE 293,019,094923,Lovett; Shachar,9999,0,9999,0
1653438752463,CSE 293,020,094924,McAuley; Julian John,9999,0,9999,0
1653438752463,CSE 293,021,094925,Micciancio; Daniele,9999,0,9999,0
1653438752463,CSE 293,022,094926,Orailoglu; Alex,9999,0,9999,0
1653438752463,CSE 293,023,094927,Paturi; Ramamohan,9999,0,9999,0
1653438752463,CSE 293,024,094928,Polikarpova; Nadezhda,9999,0,9999,0
1653438752463,CSE 293,025,094929,Politz; Joseph Gibbs,9999,0,9999,0
1653438752463,CSE 293,026,094930,Porter; George M,9999,0,9999,0
1653438752463,CSE 293,027,094931,Porter; Leonard Emerson,9999,0,9999,0
1653438752463,CSE 293,028,094932,Ramamoorthi; Ravi,9999,0,9999,0
1653438752463,CSE 293,029,094933,Sahoo; Debashis,9999,0,9999,0
1653438752463,CSE 293,030,094934,Saul; Lawrence,9999,0,9999,0
1653438752463,CSE 293,031,094935,Savage; Stefan,9999,0,9999,0
1653438752463,CSE 293,032,094936,Schulze; Jurgen P.,9999,0,9999,0
1653438752463,CSE 293,033,094937,Snoeren; Alex C.,9999,0,9999,0
1653438752463,CSE 293,034,094938,Shang; Jingbo,9999,0,9999,0
1653438752463,CSE 293,035,094939,Stefan; Deian,9999,0,9999,0
1653438752463,CSE 293,036,094940,Su; Hao,9999,0,9999,0
1653438752463,CSE 293,037,094941,Swanson; Steven James,9999,0,9999,0
1653438752463,CSE 293,038,094942,Tullsen; Dean Michael,9999,0,9999,0
1653438752463,CSE 293,039,094943,Voelker; Geoffrey M.,9999,0,9999,0
1653438752463,CSE 293,040,094944,Zhao; Jishen,9999,0,9999,0
1653438752463,CSE 293,041,094945,Zhou; Yuan-Yuan,9999,0,9999,0
1653438752463,CSE 293,042,094946,Gao; Sicun,9998,0,9999,1
1653438752463,CSE 293,043,094947,Weibel; Nadir,9999,0,9999,0
1653438752463,CSE 293,044,094948,Gupta; Rajesh K.,9999,0,9999,0
1653438752990,CSE 294,A00,090143,Porter; George M,9,0,10,1
1653438753638,DSE 200,A00,091799,Staff,50,0,50,0
1653438754163,DSE 203,A00,091800,Gupta; Amarnath,30,0,30,0
1653438754685,DSE 250,A00,091801,Deutsch; Alin Bernard,30,0,30,0
1653438755210,DSE 290,A00,091802,Altintas De Callaf; Ilkay,50,0,50,0
1653438755768,ECE 200,001,091003,Antipa; Nicholas A,9999,0,9999,0
1653438755768,ECE 200,002,091004,Atanasov; Nikolay A.,9999,0,9999,0
1653438755768,ECE 200,003,091005,Bharadia; Dinesh,9999,0,9999,0
1653438755768,ECE 200,004,091006,Cheng; Chung Kuan,9999,0,9999,0
1653438755768,ECE 200,005,091007,Cosman; Pamela C.,9999,0,9999,0
1653438755768,ECE 200,006,091008,Staff,9999,0,9999,0
1653438755768,ECE 200,007,091009,Dayeh; Shadi Ahmad,9999,0,9999,0
1653438755768,ECE 200,008,091010,Fainman; Yeshaiahu,9999,0,9999,0
1653438755768,ECE 200,009,091011,Ford; Joseph Earl,9999,0,9999,0
1653438755768,ECE 200,010,091012,Franceschetti; Massimo,9999,0,9999,0
1653438755768,ECE 200,011,091013,Fullerton; Eric E,9999,0,9999,0
1653438755768,ECE 200,012,091014,Galton; Ian A,9999,0,9999,0
1653438755768,ECE 200,013,091015,Gilja; Vikash,9999,0,9999,0
1653438755768,ECE 200,014,091016,Hall; Drew A.,9999,0,9999,0
1653438755768,ECE 200,015,091017,Hsueh; Tzu-Chien,9999,0,9999,0
1653438755768,ECE 200,016,091018,Javidi; Tara,9999,0,9999,0
1653438755768,ECE 200,017,091019,Kahng; Andrew Byun,9999,0,9999,0
1653438755768,ECE 200,018,091020,Kim; Young-Han,9999,0,9999,0
1653438755768,ECE 200,019,091021,Koushanfar; Farinaz,9999,0,9999,0
1653438755768,ECE 200,020,091022,Kuzum; Duygu,9999,0,9999,0
1653438755768,ECE 200,021,091023,Le; Hanh-Phuc,9999,0,9999,0
1653438755768,ECE 200,022,091024,Lin; Bill,9999,0,9999,0
1653438755768,ECE 200,023,091025,Liu; Zhaowei,9999,0,9999,0
1653438755768,ECE 200,024,091026,Lo; Yu-Hwa,9999,0,9999,0
1653438755768,ECE 200,025,091027,Lomakin; Vitaliy,9999,0,9999,0
1653438755768,ECE 200,026,091028,Mercier; Patrick Philip,9999,0,9999,0
1653438755768,ECE 200,027,091029,Meyer; Florian,9999,0,9999,0
1653438755768,ECE 200,028,091030,Milstein; Laurence B.,9999,0,9999,0
1653438755768,ECE 200,029,091031,Mir Arabbaygi; Siavash,9999,0,9999,0
1653438755768,ECE 200,030,091032,Mookherjea; Shayan,9999,0,9999,0
1653438755768,ECE 200,031,091033,Morris; Karcher William,9999,0,9999,0
1653438755768,ECE 200,032,091034,Ng; Tse Nga,9999,0,9999,0
1653438755768,ECE 200,033,091035,Nguyen; Truong Quang,9999,0,9999,0
1653438755768,ECE 200,034,091036,Nomura; Kenji,9999,0,9999,0
1653438755768,ECE 200,035,091037,Orlitsky; Alon,9999,0,9999,0
1653438755768,ECE 200,036,091038,Pal; Piya,9999,0,9999,0
1653438755768,ECE 200,037,091039,Papen; George C.,9999,0,9999,0
1653438755768,ECE 200,038,091040,Radic; Stojan,9999,0,9999,0
1653438755768,ECE 200,039,091041,Rao; Bhaskar D.,9999,0,9999,0
1653438755768,ECE 200,040,091042,Rao; Ramesh R,9999,0,9999,0
1653438755768,ECE 200,041,091043,Rebeiz; Gabriel,9999,0,9999,0
1653438755768,ECE 200,042,091044,Sanford; John R,9999,0,9999,0
1653438755768,ECE 200,043,091045,Siegel; Paul H.,9999,0,9999,0
1653438755768,ECE 200,044,091046,Sievenpiper; Daniel F.,9999,0,9999,0
1653438755768,ECE 200,045,091047,Sworder; David D.,9999,0,9999,0
1653438755768,ECE 200,046,091048,Taur; Yuan,9999,0,9999,0
1653438755768,ECE 200,047,091049,Touri; Behrouz,9999,0,9999,0
1653438755768,ECE 200,048,091050,Trivedi; Mohan M.,9999,0,9999,0
1653438755768,ECE 200,049,091051,Vardy; Alexander,9999,0,9999,0
1653438755768,ECE 200,050,091052,Vasconcelos; Nuno,9999,0,9999,0
1653438755768,ECE 200,051,091053,Wang; Xiaolong,9999,0,9999,0
1653438755768,ECE 200,052,091054,Xie; Pengtao,9999,0,9999,0
1653438755768,ECE 200,053,091055,Yip; Michael,9999,0,9999,0
1653438755768,ECE 200,054,091056,Zeger; Kenneth A.,9999,0,9999,0
1653438755768,ECE 200,055,091057,Zhang; Xinyu,9999,0,9999,0
1653438755768,ECE 200,056,091058,Turakhia; Yatish Girish,9999,0,9999,0
1653438755768,ECE 200,057,091059,Kang; Mingu,9999,0,9999,0
1653438755768,ECE 200,058,091060,Shi; Yuanyuan,9999,0,9999,0
1653438755768,ECE 200,059,091061,Wang; Edward Jay,9999,0,9999,0
1653438755768,ECE 200,060,091062,Zheng; Yang,9999,0,9999,0
1653438756309,ECE 203,A00,091065,Mercier; Patrick Philip,0,0,0,0
1653438756833,ECE 207A,A00,091605,Liu; Thomas Tao-Ming,0,0,0,0
1653438757362,ECE 212AN,A00,091068,Nomura; Kenji,0,0,0,0
1653438757889,ECE 222A,A00,091069,Rebeiz; Gabriel,0,0,0,0
1653438758429,ECE 225A,A00,091070,Orlitsky; Alon,0,0,0,0
1653438758957,ECE 230A,A00,091071,Nomura; Kenji,0,0,0,0
1653438759514,ECE 236A,A00,091072,Dayeh; Shadi Ahmad,0,0,0,0
1653438760062,ECE 238A,A00,091073,Luo; Jian,0,0,0,0
1653438760062,ECE 238A,B00,091074,Luo; Jian,0,0,0,0
1653438760588,ECE 240A,A00,091075,Radic; Stojan,0,0,0,0
1653438761127,ECE 247A,A00,091592,Shi; Lingyan,0,0,0,0
1653438761676,ECE 250,A00,091076,Touri; Behrouz,0,0,0,0
1653438762199,ECE 251C,A00,091078,Nguyen; Truong Quang,0,0,0,0
1653438762726,ECE 253,A00,091079,Cosman; Pamela C.,0,0,0,0
1653438763308,ECE 255A,A00,091080,Orlitsky; Alon,0,0,0,0
1653438763845,ECE 257A,A00,091081,Zhang; Xinyu,0,0,0,0
1653438764377,ECE 260A,A01,091084,Eldon; John,0,0,0,0
1653438764899,ECE 264C,A00,091085,Galton; Ian A,0,0,0,0
1653438765440,ECE 265C,A00,094889,Presti; Calogero Davide,0,0,0,9
1653438765979,ECE 266,A01,091087,Hall; Drew A.,0,0,0,0
1653438767039,ECE 271A,A00,091090,Vasconcelos; Nuno,0,0,0,0
1653438767573,ECE 272B,A00,091091,Sworder; David D.,0,0,0,0
1653438768095,ECE 275A,A00,091092,Meyer; Florian,0,0,0,0
1653438768630,ECE 277,A00,091093,An; Cheolhong,0,0,0,0
1653438769152,ECE 283,A00,091094,Le; Hanh-Phuc,0,0,0,0
1653438769687,ECE 284,A00,091095,Kang; Mingu,0,0,0,0
1653438769687,ECE 284,B00,091096,Wang; Edward Jay,0,0,0,0
1653438770210,ECE 285,A00,094334,Touri; Behrouz,0,0,0,0
1653438770751,ECE 289,A00,091097,Whelan; David Arthur,0,0,0,0
1653438771279,MATH 200A,A00,087414,Salehi Golsefidy; Alireza,7,0,8,1
1653438771812,MATH 202A,A00,087415,Gill; Philip E.,3,0,8,5
1653438772335,MATH 203A,A00,087416,Oprea; Dragos N.,6,0,8,2
1653438772872,MATH 204A,A00,087417,Kedlaya; Kiran S.,6,0,8,2
1653438773423,MATH 205,A00,087418,Sorensen; Claus M,6,0,8,2
1653438773956,MATH 206A,A00,087419,Izadi; Elham,7,0,8,1
1653438774492,MATH 207A,A00,087420,Mohammadi; Amir,6,0,8,2
1653438775018,MATH 208,A00,087421,Staff,9,0,10,1
1653438775540,MATH 209,A00,087422,Staff,10,0,10,0
1653438776083,MATH 218,A00,087423,Staff,10,0,10,0
1653438776629,MATH 220A,A00,087424,Novak; Jonathan I,7,0,8,1
1653438777185,MATH 231A,A00,087425,Bejenaru; Ioan,4,0,8,4
1653438777722,MATH 240A,A00,087426,Ebenfelt; Peter F,5,0,8,3
1653438778245,MATH 243,A00,087427,Staff,9,0,10,1
1653438778768,MATH 248,A00,087429,Staff,10,0,10,0
1653438779301,MATH 250A,A00,087430,Spolaor; Luca,4,0,8,4
1653438779844,MATH 257A,A00,087431,Spolaor; Luca,7,0,8,1
1653438780390,MATH 258,A00,087432,Staff,9,0,10,1
1653438780936,MATH 264A,A00,087433,Warnke; Lutz Peter,5,0,8,3
1653438781473,MATH 268,A00,087434,Staff,15,0,15,0
1653438782008,MATH 269,A00,087435,Staff,14,0,15,1
1653438782536,MATH 270A,A00,087436,Nie; Jiawang,0,0,8,8
1653438783071,MATH 272A,A00,087437,Tian; Xiaochuan,1,0,8,7
1653438783612,MATH 274,A01,087439,Cheng; Li-Tien,9,0,10,1
1653438783612,MATH 274,A02,087440,Cheng; Li-Tien,10,0,10,0
1653438784161,MATH 278A,A00,087441,Staff,8,0,10,2
1653438784694,MATH 278B,A00,087442,Staff,8,0,10,2
1653438785241,MATH 278C,A00,087443,Staff,8,0,10,2
1653438785798,MATH 280A,A00,087444,Zheng; Tianyi,0,0,8,8
1653438786325,MATH 281A,A00,087445,Bradic; Jelena,0,0,8,8
1653438786861,MATH 282A,A00,087446,Zhang; Danna,0,0,8,8
1653438787393,MATH 283,A00,087447,Tesler; Glenn,0,0,0,14
1653438787918,MATH 286,A00,087448,Kemp; Todd Aahron,6,0,8,2
1653438788446,MATH 287D,A00,087449,Bradic; Jelena,8,0,8,0
1653438788968,MATH 288,A00,087450,Staff,14,0,15,1
1653438788968,MATH 288,B00,087451,Staff,15,0,15,0
1653438788968,MATH 288,C00,087452,Staff,15,0,15,0
1653438789494,MATH 290A,A00,087453,Xu; Zhouli,7,0,8,1
1653438790016,MATH 291A,A00,087454,Xu; Zhouli,7,0,8,1
1653438790540,MATH 292,A00,087455,Staff,10,0,10,0
1653438791061,MATH 295,A00,087456,Staff,50,0,50,0
1653438791586,MATH 297,001,087457,Staff,998,0,999,1
1653439363027,COGS 200,A01,087991,Staff,47,0,50,3
1653439363555,COGS 201,A01,094504,Rangel; Lara M,17,0,25,8
1653439364092,COGS 203,A00,087992,Coulson; Seana M,18,0,20,2
1653439364666,COGS 210A,001,087993,Greene; Deanna Jacquelyn,9998,0,9999,1
1653439364666,COGS 210A,002,087994,Saygin; Ayse P,9999,0,9999,0
1653439364666,COGS 210A,003,087995,Xia; Haijun,9999,0,9999,0
1653439364666,COGS 210A,004,087996,Nitz; Douglas A.,9999,0,9999,0
1653439364666,COGS 210A,005,087997,Hollan; James D.,9999,0,9999,0
1653439364666,COGS 210A,006,087998,Deak; Gedeon O.,9998,0,9999,1
1653439364666,COGS 210A,007,087999,Rossano; Federico,9999,0,9999,0
1653439365213,COGS 211A,A00,088000,Coulson; Seana M,9997,0,9999,2
1653439365762,COGS 229,A00,088002,Staff,23,0,25,2
1653439366308,COGS 260,B00,094231,Staff,17,0,20,3
1653439366308,COGS 260,A00,088004,Nitz; Douglas A.,9998,0,9999,1
1653439366851,CSE 202,A00,090110,Paturi; Ramamohan,0,0,0,0
1653439366851,CSE 202,B00,090111,Paturi; Ramamohan,0,0,0,0
1653439367377,CSE 207B,A00,090112,Heninger; Nadia A,0,0,0,0
1653439367922,CSE 208,A00,094858,Micciancio; Daniele,0,0,0,0
1653439368448,CSE 210,A00,090113,Powell; Thomas Allan,0,0,0,0
1653439368970,CSE 219,A00,090898,Staff,0,0,0,0
1653439369492,CSE 221,A00,090114,Zhou; Yuan-Yuan,0,0,0,0
1653439370017,CSE 229A,A00,090115,Porter; George M,0,0,0,0
1653439370547,CSE 229C,A00,090116,Savage; Stefan,0,0,0,0
1653439371101,CSE 230,A00,090117,Jhala; Ranjit,0,0,0,0
1653439371657,CSE 232,A00,090118,Papakonstantinou; Yannis,0,0,0,0
1653439372192,CSE 239A,A00,090121,Kumar; Arun Kumar,0,0,0,0
1653439372742,CSE 239B,A00,090122,Jhala; Ranjit,0,0,0,0
1653439373265,CSE 240A,A00,090123,Zhao; Jishen,0,0,189,189
1653439373800,CSE 243A,A00,090124,Orailoglu; Alex,3,0,15,12
1653439374323,CSE 249B,A00,090125,Kahng; Andrew Byun,13,0,20,7
1653439374853,CSE 250A,A00,090126,Berg-Kirkpatrick; Taylor D,0,0,0,0
1653439375376,CSE 252A,A00,090127,Ochoa; Benjamin Lawrence,0,0,0,0
1653439375899,CSE 258,A01,090129,McAuley; Julian John,0,0,0,0
1653439376422,CSE 258R,A01,090131,McAuley; Julian John,0,0,0,0
1653439376947,CSE 274,A00,090132,Ramamoorthi; Ravi,0,0,0,0
1653439377472,CSE 276A,A00,090133,Christensen; Henrik I,0,0,0,0
1653439378005,CSE 276C,A00,090134,Christensen; Henrik I,0,0,0,0
1653439378530,CSE 290,A00,090135,Bafna; Vineet,0,0,0,0
1653439378530,CSE 290,B00,090136,Ramamoorthi; Ravi,0,0,0,0
1653439378530,CSE 290,C00,090137,Li; Tzumao,9,0,10,1
1653439378530,CSE 290,D00,090138,Zhou; Yuan-Yuan,10,0,10,0
1653439378530,CSE 290,E00,090139,Christensen; Henrik I,10,0,10,0
1653439378530,CSE 290,F00,094053,Shalev; Aaron D,0,0,0,0
1653439379058,CSE 291,A00,090140,Munyaka; Imani N. S.,0,0,0,0
1653439379058,CSE 291,B00,094880,Yu; Qi,0,0,0,0
1653439379058,CSE 291,C00,090142,Pannuto; Patrick William,0,0,0,0
1653439379058,CSE 291,D00,094881,Zhang; Yiying,0,0,0,0
1653439379058,CSE 291,E00,095118,Su; Hao,0,0,0,0
1653439379583,CSE 293,001,094905,Bafna; Vineet,9999,0,9999,0
1653439379583,CSE 293,002,094906,Bellare; Mihir,9999,0,9999,0
1653439379583,CSE 293,003,094907,Berg-Kirkpatrick; Taylor D,9999,0,9999,0
1653439379583,CSE 293,004,094908,Christensen; Henrik I,9999,0,9999,0
1653439379583,CSE 293,005,094909,Cottrell; Garrison W,9999,0,9999,0
1653439379583,CSE 293,006,094910,Deutsch; Alin Bernard,9999,0,9999,0
1653439379583,CSE 293,007,094911,Esmaeilzadeh; Hadi,9999,0,9999,0
1653439379583,CSE 293,008,094912,Freund; Yoav,9999,0,9999,0
1653439379583,CSE 293,009,094913,Griswold; William G.,9999,0,9999,0
1653439379583,CSE 293,010,094914,Gymrek; Melissa Ann,9999,0,9999,0
1653439379583,CSE 293,011,094915,Heninger; Nadia A,9999,0,9999,0
1653439379583,CSE 293,012,094916,Impagliazzo; Russell,9999,0,9999,0
1653439379583,CSE 293,013,094917,Jhala; Ranjit,9999,0,9999,0
1653439379583,CSE 293,014,094918,Kahng; Andrew Byun,9999,0,9999,0
1653439379583,CSE 293,015,094919,Kane; Daniel Mertz,9999,0,9999,0
1653439379583,CSE 293,016,094920,Kriegman; David J,9999,0,9999,0
1653439379583,CSE 293,017,094921,Kumar; Arun Kumar,9999,0,9999,0
1653439379583,CSE 293,018,094922,Lerner; Sorin,9999,0,9999,0
1653439379583,CSE 293,019,094923,Lovett; Shachar,9999,0,9999,0
1653439379583,CSE 293,020,094924,McAuley; Julian John,9999,0,9999,0
1653439379583,CSE 293,021,094925,Micciancio; Daniele,9999,0,9999,0
1653439379583,CSE 293,022,094926,Orailoglu; Alex,9999,0,9999,0
1653439379583,CSE 293,023,094927,Paturi; Ramamohan,9999,0,9999,0
1653439379583,CSE 293,024,094928,Polikarpova; Nadezhda,9999,0,9999,0
1653439379583,CSE 293,025,094929,Politz; Joseph Gibbs,9999,0,9999,0
1653439379583,CSE 293,026,094930,Porter; George M,9999,0,9999,0
1653439379583,CSE 293,027,094931,Porter; Leonard Emerson,9999,0,9999,0
1653439379583,CSE 293,028,094932,Ramamoorthi; Ravi,9999,0,9999,0
1653439379583,CSE 293,029,094933,Sahoo; Debashis,9999,0,9999,0
1653439379583,CSE 293,030,094934,Saul; Lawrence,9999,0,9999,0
1653439379583,CSE 293,031,094935,Savage; Stefan,9999,0,9999,0
1653439379583,CSE 293,032,094936,Schulze; Jurgen P.,9999,0,9999,0
1653439379583,CSE 293,033,094937,Snoeren; Alex C.,9999,0,9999,0
1653439379583,CSE 293,034,094938,Shang; Jingbo,9999,0,9999,0
1653439379583,CSE 293,035,094939,Stefan; Deian,9999,0,9999,0
1653439379583,CSE 293,036,094940,Su; Hao,9999,0,9999,0
1653439379583,CSE 293,037,094941,Swanson; Steven James,9999,0,9999,0
1653439379583,CSE 293,038,094942,Tullsen; Dean Michael,9999,0,9999,0
1653439379583,CSE 293,039,094943,Voelker; Geoffrey M.,9999,0,9999,0
1653439379583,CSE 293,040,094944,Zhao; Jishen,9999,0,9999,0
1653439379583,CSE 293,041,094945,Zhou; Yuan-Yuan,9999,0,9999,0
1653439379583,CSE 293,042,094946,Gao; Sicun,9998,0,9999,1
1653439379583,CSE 293,043,094947,Weibel; Nadir,9999,0,9999,0
1653439379583,CSE 293,044,094948,Gupta; Rajesh K.,9999,0,9999,0
1653439380122,CSE 294,A00,090143,Porter; George M,9,0,10,1
1653439380645,DSE 200,A00,091799,Staff,50,0,50,0
1653439381182,DSE 203,A00,091800,Gupta; Amarnath,30,0,30,0
1653439381719,DSE 250,A00,091801,Deutsch; Alin Bernard,30,0,30,0
1653439382276,DSE 290,A00,091802,Altintas De Callaf; Ilkay,50,0,50,0
1653439382871,ECE 200,001,091003,Antipa; Nicholas A,9999,0,9999,0
1653439382871,ECE 200,002,091004,Atanasov; Nikolay A.,9999,0,9999,0
1653439382871,ECE 200,003,091005,Bharadia; Dinesh,9999,0,9999,0
1653439382871,ECE 200,004,091006,Cheng; Chung Kuan,9999,0,9999,0
1653439382871,ECE 200,005,091007,Cosman; Pamela C.,9999,0,9999,0
1653439382871,ECE 200,006,091008,Staff,9999,0,9999,0
1653439382871,ECE 200,007,091009,Dayeh; Shadi Ahmad,9999,0,9999,0
1653439382871,ECE 200,008,091010,Fainman; Yeshaiahu,9999,0,9999,0
1653439382871,ECE 200,009,091011,Ford; Joseph Earl,9999,0,9999,0
1653439382871,ECE 200,010,091012,Franceschetti; Massimo,9999,0,9999,0
1653439382871,ECE 200,011,091013,Fullerton; Eric E,9999,0,9999,0
1653439382871,ECE 200,012,091014,Galton; Ian A,9999,0,9999,0
1653439382871,ECE 200,013,091015,Gilja; Vikash,9999,0,9999,0
1653439382871,ECE 200,014,091016,Hall; Drew A.,9999,0,9999,0
1653439382871,ECE 200,015,091017,Hsueh; Tzu-Chien,9999,0,9999,0
1653439382871,ECE 200,016,091018,Javidi; Tara,9999,0,9999,0
1653439382871,ECE 200,017,091019,Kahng; Andrew Byun,9999,0,9999,0
1653439382871,ECE 200,018,091020,Kim; Young-Han,9999,0,9999,0
1653439382871,ECE 200,019,091021,Koushanfar; Farinaz,9999,0,9999,0
1653439382871,ECE 200,020,091022,Kuzum; Duygu,9999,0,9999,0
1653439382871,ECE 200,021,091023,Le; Hanh-Phuc,9999,0,9999,0
1653439382871,ECE 200,022,091024,Lin; Bill,9999,0,9999,0
1653439382871,ECE 200,023,091025,Liu; Zhaowei,9999,0,9999,0
1653439382871,ECE 200,024,091026,Lo; Yu-Hwa,9999,0,9999,0
1653439382871,ECE 200,025,091027,Lomakin; Vitaliy,9999,0,9999,0
1653439382871,ECE 200,026,091028,Mercier; Patrick Philip,9999,0,9999,0
1653439382871,ECE 200,027,091029,Meyer; Florian,9999,0,9999,0
1653439382871,ECE 200,028,091030,Milstein; Laurence B.,9999,0,9999,0
1653439382871,ECE 200,029,091031,Mir Arabbaygi; Siavash,9999,0,9999,0
1653439382871,ECE 200,030,091032,Mookherjea; Shayan,9999,0,9999,0
1653439382871,ECE 200,031,091033,Morris; Karcher William,9999,0,9999,0
1653439382871,ECE 200,032,091034,Ng; Tse Nga,9999,0,9999,0
1653439382871,ECE 200,033,091035,Nguyen; Truong Quang,9999,0,9999,0
1653439382871,ECE 200,034,091036,Nomura; Kenji,9999,0,9999,0
1653439382871,ECE 200,035,091037,Orlitsky; Alon,9999,0,9999,0
1653439382871,ECE 200,036,091038,Pal; Piya,9999,0,9999,0
1653439382871,ECE 200,037,091039,Papen; George C.,9999,0,9999,0
1653439382871,ECE 200,038,091040,Radic; Stojan,9999,0,9999,0
1653439382871,ECE 200,039,091041,Rao; Bhaskar D.,9999,0,9999,0
1653439382871,ECE 200,040,091042,Rao; Ramesh R,9999,0,9999,0
1653439382871,ECE 200,041,091043,Rebeiz; Gabriel,9999,0,9999,0
1653439382871,ECE 200,042,091044,Sanford; John R,9999,0,9999,0
1653439382871,ECE 200,043,091045,Siegel; Paul H.,9999,0,9999,0
1653439382871,ECE 200,044,091046,Sievenpiper; Daniel F.,9999,0,9999,0
1653439382871,ECE 200,045,091047,Sworder; David D.,9999,0,9999,0
1653439382871,ECE 200,046,091048,Taur; Yuan,9999,0,9999,0
1653439382871,ECE 200,047,091049,Touri; Behrouz,9999,0,9999,0
1653439382871,ECE 200,048,091050,Trivedi; Mohan M.,9999,0,9999,0
1653439382871,ECE 200,049,091051,Vardy; Alexander,9999,0,9999,0
1653439382871,ECE 200,050,091052,Vasconcelos; Nuno,9999,0,9999,0
1653439382871,ECE 200,051,091053,Wang; Xiaolong,9999,0,9999,0
1653439382871,ECE 200,052,091054,Xie; Pengtao,9999,0,9999,0
1653439382871,ECE 200,053,091055,Yip; Michael,9999,0,9999,0
1653439382871,ECE 200,054,091056,Zeger; Kenneth A.,9999,0,9999,0
1653439382871,ECE 200,055,091057,Zhang; Xinyu,9999,0,9999,0
1653439382871,ECE 200,056,091058,Turakhia; Yatish Girish,9999,0,9999,0
1653439382871,ECE 200,057,091059,Kang; Mingu,9999,0,9999,0
1653439382871,ECE 200,058,091060,Shi; Yuanyuan,9999,0,9999,0
1653439382871,ECE 200,059,091061,Wang; Edward Jay,9999,0,9999,0
1653439382871,ECE 200,060,091062,Zheng; Yang,9999,0,9999,0
1653439383410,ECE 203,A00,091065,Mercier; Patrick Philip,0,0,0,0
1653439383938,ECE 207A,A00,091605,Liu; Thomas Tao-Ming,0,0,0,0
1653439384462,ECE 212AN,A00,091068,Nomura; Kenji,0,0,0,0
1653439385008,ECE 222A,A00,091069,Rebeiz; Gabriel,0,0,0,0
1653439385539,ECE 225A,A00,091070,Orlitsky; Alon,0,0,0,0
1653439386075,ECE 230A,A00,091071,Nomura; Kenji,0,0,0,0
1653439386605,ECE 236A,A00,091072,Dayeh; Shadi Ahmad,0,0,0,0
1653439387157,ECE 238A,A00,091073,Luo; Jian,0,0,0,0
1653439387157,ECE 238A,B00,091074,Luo; Jian,0,0,0,0
1653439387704,ECE 240A,A00,091075,Radic; Stojan,0,0,0,0
1653439388254,ECE 247A,A00,091592,Shi; Lingyan,0,0,0,0
1653439388786,ECE 250,A00,091076,Touri; Behrouz,0,0,0,0
1653439389321,ECE 251C,A00,091078,Nguyen; Truong Quang,0,0,0,0
1653439389845,ECE 253,A00,091079,Cosman; Pamela C.,0,0,0,0
1653439390385,ECE 255A,A00,091080,Orlitsky; Alon,0,0,0,0
1653439390919,ECE 257A,A00,091081,Zhang; Xinyu,0,0,0,0
1653439391446,ECE 260A,A01,091084,Eldon; John,0,0,0,0
1653439391969,ECE 264C,A00,091085,Galton; Ian A,0,0,0,0
1653439392493,ECE 265C,A00,094889,Presti; Calogero Davide,0,0,0,9
1653439393022,ECE 266,A01,091087,Hall; Drew A.,0,0,0,0
1653439394079,ECE 271A,A00,091090,Vasconcelos; Nuno,0,0,0,0
1653439394602,ECE 272B,A00,091091,Sworder; David D.,0,0,0,0
1653439395125,ECE 275A,A00,091092,Meyer; Florian,0,0,0,0
1653439395654,ECE 277,A00,091093,An; Cheolhong,0,0,0,0
1653439396176,ECE 283,A00,091094,Le; Hanh-Phuc,0,0,0,0
1653439396716,ECE 284,A00,091095,Kang; Mingu,0,0,0,0
1653439396716,ECE 284,B00,091096,Wang; Edward Jay,0,0,0,0
1653439397257,ECE 285,A00,094334,Touri; Behrouz,0,0,0,0
1653439397798,ECE 289,A00,091097,Whelan; David Arthur,0,0,0,0
1653439398329,MATH 200A,A00,087414,Salehi Golsefidy; Alireza,7,0,8,1
1653439398869,MATH 202A,A00,087415,Gill; Philip E.,3,0,8,5
1653439399393,MATH 203A,A00,087416,Oprea; Dragos N.,6,0,8,2
1653439400038,MATH 204A,A00,087417,Kedlaya; Kiran S.,6,0,8,2
1653439400585,MATH 205,A00,087418,Sorensen; Claus M,6,0,8,2
1653439401118,MATH 206A,A00,087419,Izadi; Elham,7,0,8,1
1653439401659,MATH 207A,A00,087420,Mohammadi; Amir,6,0,8,2
1653439402214,MATH 208,A00,087421,Staff,9,0,10,1
1653439402751,MATH 209,A00,087422,Staff,10,0,10,0
1653439403297,MATH 218,A00,087423,Staff,10,0,10,0
1653439403833,MATH 220A,A00,087424,Novak; Jonathan I,7,0,8,1
1653439404360,MATH 231A,A00,087425,Bejenaru; Ioan,4,0,8,4
1653439404896,MATH 240A,A00,087426,Ebenfelt; Peter F,5,0,8,3
1653439405425,MATH 243,A00,087427,Staff,9,0,10,1
1653439405973,MATH 248,A00,087429,Staff,10,0,10,0
1653439406494,MATH 250A,A00,087430,Spolaor; Luca,4,0,8,4
1653439407042,MATH 257A,A00,087431,Spolaor; Luca,7,0,8,1
1653439407578,MATH 258,A00,087432,Staff,9,0,10,1
1653439408111,MATH 264A,A00,087433,Warnke; Lutz Peter,5,0,8,3
1653439408652,MATH 268,A00,087434,Staff,15,0,15,0
1653439409183,MATH 269,A00,087435,Staff,14,0,15,1
1653439409719,MATH 270A,A00,087436,Nie; Jiawang,0,0,8,8
1653439410283,MATH 272A,A00,087437,Tian; Xiaochuan,1,0,8,7
1653439410825,MATH 274,A01,087439,Cheng; Li-Tien,9,0,10,1
1653439410825,MATH 274,A02,087440,Cheng; Li-Tien,10,0,10,0
1653439411362,MATH 278A,A00,087441,Staff,8,0,10,2
1653439411902,MATH 278B,A00,087442,Staff,8,0,10,2
1653439412438,MATH 278C,A00,087443,Staff,8,0,10,2
1653439412983,MATH 280A,A00,087444,Zheng; Tianyi,0,0,8,8
1653439413525,MATH 281A,A00,087445,Bradic; Jelena,0,0,8,8
1653439414051,MATH 282A,A00,087446,Zhang; Danna,0,0,8,8
1653439414595,MATH 283,A00,087447,Tesler; Glenn,0,0,0,14
1653439415124,MATH 286,A00,087448,Kemp; Todd Aahron,6,0,8,2
1653439415654,MATH 287D,A00,087449,Bradic; Jelena,8,0,8,0
1653439416176,MATH 288,A00,087450,Staff,14,0,15,1
1653439416176,MATH 288,B00,087451,Staff,15,0,15,0
1653439416176,MATH 288,C00,087452,Staff,15,0,15,0
1653439416713,MATH 290A,A00,087453,Xu; Zhouli,7,0,8,1
1653439417240,MATH 291A,A00,087454,Xu; Zhouli,7,0,8,1
1653439417765,MATH 292,A00,087455,Staff,10,0,10,0
1653439418287,MATH 295,A00,087456,Staff,50,0,50,0
1653439418811,MATH 297,001,087457,Staff,998,0,999,1
1653439998887,COGS 200,A01,087991,Staff,47,0,50,3
1653439999418,COGS 201,A01,094504,Rangel; Lara M,17,0,25,8
1653439999946,COGS 203,A00,087992,Coulson; Seana M,18,0,20,2
1653440000513,COGS 210A,001,087993,Greene; Deanna Jacquelyn,9998,0,9999,1
1653440000513,COGS 210A,002,087994,Saygin; Ayse P,9999,0,9999,0
1653440000513,COGS 210A,003,087995,Xia; Haijun,9999,0,9999,0
1653440000513,COGS 210A,004,087996,Nitz; Douglas A.,9999,0,9999,0
1653440000513,COGS 210A,005,087997,Hollan; James D.,9999,0,9999,0
1653440000513,COGS 210A,006,087998,Deak; Gedeon O.,9998,0,9999,1
1653440000513,COGS 210A,007,087999,Rossano; Federico,9999,0,9999,0
1653440001035,COGS 211A,A00,088000,Coulson; Seana M,9997,0,9999,2
1653440001564,COGS 229,A00,088002,Staff,23,0,25,2
1653440002089,COGS 260,B00,094231,Staff,17,0,20,3
1653440002089,COGS 260,A00,088004,Nitz; Douglas A.,9998,0,9999,1
1653440002617,CSE 202,A00,090110,Paturi; Ramamohan,0,0,0,0
1653440002617,CSE 202,B00,090111,Paturi; Ramamohan,0,0,0,0
1653440003142,CSE 207B,A00,090112,Heninger; Nadia A,0,0,0,0
1653440003675,CSE 208,A00,094858,Micciancio; Daniele,0,0,0,0
1653440004196,CSE 210,A00,090113,Powell; Thomas Allan,0,0,0,0
1653440004718,CSE 219,A00,090898,Staff,0,0,0,0
1653440005253,CSE 221,A00,090114,Zhou; Yuan-Yuan,0,0,0,0
1653440005793,CSE 229A,A00,090115,Porter; George M,0,0,0,0
1653440006323,CSE 229C,A00,090116,Savage; Stefan,0,0,0,0
1653440006847,CSE 230,A00,090117,Jhala; Ranjit,0,0,0,0
1653440007371,CSE 232,A00,090118,Papakonstantinou; Yannis,0,0,0,0
1653440007973,CSE 239A,A00,090121,Kumar; Arun Kumar,0,0,0,0
1653440008503,CSE 239B,A00,090122,Jhala; Ranjit,0,0,0,0
1653440009035,CSE 240A,A00,090123,Zhao; Jishen,0,0,189,189
1653440009586,CSE 243A,A00,090124,Orailoglu; Alex,2,0,15,13
1653440010112,CSE 249B,A00,090125,Kahng; Andrew Byun,13,0,20,7
1653440010645,CSE 250A,A00,090126,Berg-Kirkpatrick; Taylor D,0,0,0,0
1653440011168,CSE 252A,A00,090127,Ochoa; Benjamin Lawrence,0,0,0,0
1653440011699,CSE 258,A01,090129,McAuley; Julian John,0,0,0,0
1653440012254,CSE 258R,A01,090131,McAuley; Julian John,0,0,0,0
1653440012782,CSE 274,A00,090132,Ramamoorthi; Ravi,0,0,0,0
1653440013304,CSE 276A,A00,090133,Christensen; Henrik I,0,0,0,0
1653440013831,CSE 276C,A00,090134,Christensen; Henrik I,0,0,0,0
1653440014369,CSE 290,A00,090135,Bafna; Vineet,0,0,0,0
1653440014369,CSE 290,B00,090136,Ramamoorthi; Ravi,0,0,0,0
1653440014369,CSE 290,C00,090137,Li; Tzumao,9,0,10,1
1653440014369,CSE 290,D00,090138,Zhou; Yuan-Yuan,10,0,10,0
1653440014369,CSE 290,E00,090139,Christensen; Henrik I,10,0,10,0
1653440014369,CSE 290,F00,094053,Shalev; Aaron D,0,0,0,0
1653440014912,CSE 291,A00,090140,Munyaka; Imani N. S.,0,0,0,0
1653440014912,CSE 291,B00,094880,Yu; Qi,0,0,0,0
1653440014912,CSE 291,C00,090142,Pannuto; Patrick William,0,0,0,0
1653440014912,CSE 291,D00,094881,Zhang; Yiying,0,0,0,0
1653440014912,CSE 291,E00,095118,Su; Hao,0,0,0,0
1653440015451,CSE 293,001,094905,Bafna; Vineet,9999,0,9999,0
1653440015451,CSE 293,002,094906,Bellare; Mihir,9999,0,9999,0
1653440015451,CSE 293,003,094907,Berg-Kirkpatrick; Taylor D,9999,0,9999,0
1653440015451,CSE 293,004,094908,Christensen; Henrik I,9999,0,9999,0
1653440015451,CSE 293,005,094909,Cottrell; Garrison W,9999,0,9999,0
1653440015451,CSE 293,006,094910,Deutsch; Alin Bernard,9999,0,9999,0
1653440015451,CSE 293,007,094911,Esmaeilzadeh; Hadi,9999,0,9999,0
1653440015451,CSE 293,008,094912,Freund; Yoav,9999,0,9999,0
1653440015451,CSE 293,009,094913,Griswold; William G.,9999,0,9999,0
1653440015451,CSE 293,010,094914,Gymrek; Melissa Ann,9999,0,9999,0
1653440015451,CSE 293,011,094915,Heninger; Nadia A,9999,0,9999,0
1653440015451,CSE 293,012,094916,Impagliazzo; Russell,9999,0,9999,0
1653440015451,CSE 293,013,094917,Jhala; Ranjit,9999,0,9999,0
1653440015451,CSE 293,014,094918,Kahng; Andrew Byun,9999,0,9999,0
1653440015451,CSE 293,015,094919,Kane; Daniel Mertz,9999,0,9999,0
1653440015451,CSE 293,016,094920,Kriegman; David J,9999,0,9999,0
1653440015451,CSE 293,017,094921,Kumar; Arun Kumar,9999,0,9999,0
1653440015451,CSE 293,018,094922,Lerner; Sorin,9999,0,9999,0
1653440015451,CSE 293,019,094923,Lovett; Shachar,9999,0,9999,0
1653440015451,CSE 293,020,094924,McAuley; Julian John,9999,0,9999,0
1653440015451,CSE 293,021,094925,Micciancio; Daniele,9999,0,9999,0
1653440015451,CSE 293,022,094926,Orailoglu; Alex,9999,0,9999,0
1653440015451,CSE 293,023,094927,Paturi; Ramamohan,9999,0,9999,0
1653440015451,CSE 293,024,094928,Polikarpova; Nadezhda,9999,0,9999,0
1653440015451,CSE 293,025,094929,Politz; Joseph Gibbs,9999,0,9999,0
1653440015451,CSE 293,026,094930,Porter; George M,9999,0,9999,0
1653440015451,CSE 293,027,094931,Porter; Leonard Emerson,9999,0,9999,0
1653440015451,CSE 293,028,094932,Ramamoorthi; Ravi,9999,0,9999,0
1653440015451,CSE 293,029,094933,Sahoo; Debashis,9999,0,9999,0
1653440015451,CSE 293,030,094934,Saul; Lawrence,9999,0,9999,0
1653440015451,CSE 293,031,094935,Savage; Stefan,9999,0,9999,0
1653440015451,CSE 293,032,094936,Schulze; Jurgen P.,9999,0,9999,0
1653440015451,CSE 293,033,094937,Snoeren; Alex C.,9999,0,9999,0
1653440015451,CSE 293,034,094938,Shang; Jingbo,9999,0,9999,0
1653440015451,CSE 293,035,094939,Stefan; Deian,9999,0,9999,0
1653440015451,CSE 293,036,094940,Su; Hao,9999,0,9999,0
1653440015451,CSE 293,037,094941,Swanson; Steven James,9999,0,9999,0
1653440015451,CSE 293,038,094942,Tullsen; Dean Michael,9999,0,9999,0
1653440015451,CSE 293,039,094943,Voelker; Geoffrey M.,9999,0,9999,0
1653440015451,CSE 293,040,094944,Zhao; Jishen,9999,0,9999,0
1653440015451,CSE 293,041,094945,Zhou; Yuan-Yuan,9999,0,9999,0
1653440015451,CSE 293,042,094946,Gao; Sicun,9998,0,9999,1
1653440015451,CSE 293,043,094947,Weibel; Nadir,9999,0,9999,0
1653440015451,CSE 293,044,094948,Gupta; Rajesh K.,9999,0,9999,0
1653440015990,CSE 294,A00,090143,Porter; George M,9,0,10,1
1653440016518,DSE 200,A00,091799,Staff,50,0,50,0
1653440017042,DSE 203,A00,091800,Gupta; Amarnath,30,0,30,0
1653440017589,DSE 250,A00,091801,Deutsch; Alin Bernard,30,0,30,0
1653440018122,DSE 290,A00,091802,Altintas De Callaf; Ilkay,50,0,50,0
1653440018675,ECE 200,001,091003,Antipa; Nicholas A,9999,0,9999,0
1653440018675,ECE 200,002,091004,Atanasov; Nikolay A.,9999,0,9999,0
1653440018675,ECE 200,003,091005,Bharadia; Dinesh,9999,0,9999,0
1653440018675,ECE 200,004,091006,Cheng; Chung Kuan,9999,0,9999,0
1653440018675,ECE 200,005,091007,Cosman; Pamela C.,9999,0,9999,0
1653440018675,ECE 200,006,091008,Staff,9999,0,9999,0
1653440018675,ECE 200,007,091009,Dayeh; Shadi Ahmad,9999,0,9999,0
1653440018675,ECE 200,008,091010,Fainman; Yeshaiahu,9999,0,9999,0
1653440018675,ECE 200,009,091011,Ford; Joseph Earl,9999,0,9999,0
1653440018675,ECE 200,010,091012,Franceschetti; Massimo,9999,0,9999,0
1653440018675,ECE 200,011,091013,Fullerton; Eric E,9999,0,9999,0
1653440018675,ECE 200,012,091014,Galton; Ian A,9999,0,9999,0
1653440018675,ECE 200,013,091015,Gilja; Vikash,9999,0,9999,0
1653440018675,ECE 200,014,091016,Hall; Drew A.,9999,0,9999,0
1653440018675,ECE 200,015,091017,Hsueh; Tzu-Chien,9999,0,9999,0
1653440018675,ECE 200,016,091018,Javidi; Tara,9999,0,9999,0
1653440018675,ECE 200,017,091019,Kahng; Andrew Byun,9999,0,9999,0
1653440018675,ECE 200,018,091020,Kim; Young-Han,9999,0,9999,0
1653440018675,ECE 200,019,091021,Koushanfar; Farinaz,9999,0,9999,0
1653440018675,ECE 200,020,091022,Kuzum; Duygu,9999,0,9999,0
1653440018675,ECE 200,021,091023,Le; Hanh-Phuc,9999,0,9999,0
1653440018675,ECE 200,022,091024,Lin; Bill,9999,0,9999,0
1653440018675,ECE 200,023,091025,Liu; Zhaowei,9999,0,9999,0
1653440018675,ECE 200,024,091026,Lo; Yu-Hwa,9999,0,9999,0
1653440018675,ECE 200,025,091027,Lomakin; Vitaliy,9999,0,9999,0
1653440018675,ECE 200,026,091028,Mercier; Patrick Philip,9999,0,9999,0
1653440018675,ECE 200,027,091029,Meyer; Florian,9999,0,9999,0
1653440018675,ECE 200,028,091030,Milstein; Laurence B.,9999,0,9999,0
1653440018675,ECE 200,029,091031,Mir Arabbaygi; Siavash,9999,0,9999,0
1653440018675,ECE 200,030,091032,Mookherjea; Shayan,9999,0,9999,0
1653440018675,ECE 200,031,091033,Morris; Karcher William,9999,0,9999,0
1653440018675,ECE 200,032,091034,Ng; Tse Nga,9999,0,9999,0
1653440018675,ECE 200,033,091035,Nguyen; Truong Quang,9999,0,9999,0
1653440018675,ECE 200,034,091036,Nomura; Kenji,9999,0,9999,0
1653440018675,ECE 200,035,091037,Orlitsky; Alon,9999,0,9999,0
1653440018675,ECE 200,036,091038,Pal; Piya,9999,0,9999,0
1653440018675,ECE 200,037,091039,Papen; George C.,9999,0,9999,0
1653440018675,ECE 200,038,091040,Radic; Stojan,9999,0,9999,0
1653440018675,ECE 200,039,091041,Rao; Bhaskar D.,9999,0,9999,0
1653440018675,ECE 200,040,091042,Rao; Ramesh R,9999,0,9999,0
1653440018675,ECE 200,041,091043,Rebeiz; Gabriel,9999,0,9999,0
1653440018675,ECE 200,042,091044,Sanford; John R,9999,0,9999,0
1653440018675,ECE 200,043,091045,Siegel; Paul H.,9999,0,9999,0
1653440018675,ECE 200,044,091046,Sievenpiper; Daniel F.,9999,0,9999,0
1653440018675,ECE 200,045,091047,Sworder; David D.,9999,0,9999,0
1653440018675,ECE 200,046,091048,Taur; Yuan,9999,0,9999,0
1653440018675,ECE 200,047,091049,Touri; Behrouz,9999,0,9999,0
1653440018675,ECE 200,048,091050,Trivedi; Mohan M.,9999,0,9999,0
1653440018675,ECE 200,049,091051,Vardy; Alexander,9999,0,9999,0
1653440018675,ECE 200,050,091052,Vasconcelos; Nuno,9999,0,9999,0
1653440018675,ECE 200,051,091053,Wang; Xiaolong,9999,0,9999,0
1653440018675,ECE 200,052,091054,Xie; Pengtao,9999,0,9999,0
1653440018675,ECE 200,053,091055,Yip; Michael,9999,0,9999,0
1653440018675,ECE 200,054,091056,Zeger; Kenneth A.,9999,0,9999,0
1653440018675,ECE 200,055,091057,Zhang; Xinyu,9999,0,9999,0
1653440018675,ECE 200,056,091058,Turakhia; Yatish Girish,9999,0,9999,0
1653440018675,ECE 200,057,091059,Kang; Mingu,9999,0,9999,0
1653440018675,ECE 200,058,091060,Shi; Yuanyuan,9999,0,9999,0
1653440018675,ECE 200,059,091061,Wang; Edward Jay,9999,0,9999,0
1653440018675,ECE 200,060,091062,Zheng; Yang,9999,0,9999,0
1653440019200,ECE 203,A00,091065,Mercier; Patrick Philip,0,0,0,0
1653440019734,ECE 207A,A00,091605,Liu; Thomas Tao-Ming,0,0,0,0
1653440020262,ECE 212AN,A00,091068,Nomura; Kenji,0,0,0,0
1653440020794,ECE 222A,A00,091069,Rebeiz; Gabriel,0,0,0,0
1653440021339,ECE 225A,A00,091070,Orlitsky; Alon,0,0,0,0
1653440021866,ECE 230A,A00,091071,Nomura; Kenji,0,0,0,0
1653440022403,ECE 236A,A00,091072,Dayeh; Shadi Ahmad,0,0,0,0
1653440022930,ECE 238A,A00,091073,Luo; Jian,0,0,0,0
1653440022930,ECE 238A,B00,091074,Luo; Jian,0,0,0,0
1653440023459,ECE 240A,A00,091075,Radic; Stojan,0,0,0,0
1653440023998,ECE 247A,A00,091592,Shi; Lingyan,0,0,0,0
1653440024522,ECE 250,A00,091076,Touri; Behrouz,0,0,0,0
1653440025045,ECE 251C,A00,091078,Nguyen; Truong Quang,0,0,0,0
1653440025568,ECE 253,A00,091079,Cosman; Pamela C.,0,0,0,0
1653440026089,ECE 255A,A00,091080,Orlitsky; Alon,0,0,0,0
1653440026613,ECE 257A,A00,091081,Zhang; Xinyu,0,0,0,0
1653440027139,ECE 260A,A01,091084,Eldon; John,0,0,0,0
1653440027665,ECE 264C,A00,091085,Galton; Ian A,0,0,0,0
1653440028195,ECE 265C,A00,094889,Presti; Calogero Davide,0,0,0,9
1653440028718,ECE 266,A01,091087,Hall; Drew A.,0,0,0,0
1653440029784,ECE 271A,A00,091090,Vasconcelos; Nuno,0,0,0,0
1653440030308,ECE 272B,A00,091091,Sworder; David D.,0,0,0,0
1653440030845,ECE 275A,A00,091092,Meyer; Florian,0,0,0,0
1653440031388,ECE 277,A00,091093,An; Cheolhong,0,0,0,0
1653440031944,ECE 283,A00,091094,Le; Hanh-Phuc,0,0,0,0
1653440032489,ECE 284,A00,091095,Kang; Mingu,0,0,0,0
1653440032489,ECE 284,B00,091096,Wang; Edward Jay,0,0,0,0
1653440033017,ECE 285,A00,094334,Touri; Behrouz,0,0,0,0
1653440033543,ECE 289,A00,091097,Whelan; David Arthur,0,0,0,0
1653440034076,MATH 200A,A00,087414,Salehi Golsefidy; Alireza,7,0,8,1
1653440034597,MATH 202A,A00,087415,Gill; Philip E.,3,0,8,5
1653440035124,MATH 203A,A00,087416,Oprea; Dragos N.,6,0,8,2
1653440035652,MATH 204A,A00,087417,Kedlaya; Kiran S.,6,0,8,2
1653440036185,MATH 205,A00,087418,Sorensen; Claus M,6,0,8,2
1653440036710,MATH 206A,A00,087419,Izadi; Elham,7,0,8,1
1653440037233,MATH 207A,A00,087420,Mohammadi; Amir,6,0,8,2
1653440037762,MATH 208,A00,087421,Staff,9,0,10,1
1653440038285,MATH 209,A00,087422,Staff,10,0,10,0
1653440038808,MATH 218,A00,087423,Staff,10,0,10,0
1653440039336,MATH 220A,A00,087424,Novak; Jonathan I,7,0,8,1
1653440039877,MATH 231A,A00,087425,Bejenaru; Ioan,4,0,8,4
1653440040421,MATH 240A,A00,087426,Ebenfelt; Peter F,5,0,8,3
1653440040961,MATH 243,A00,087427,Staff,9,0,10,1
1653440041494,MATH 248,A00,087429,Staff,10,0,10,0
1653440042029,MATH 250A,A00,087430,Spolaor; Luca,4,0,8,4
1653440042568,MATH 257A,A00,087431,Spolaor; Luca,7,0,8,1
1653440043091,MATH 258,A00,087432,Staff,9,0,10,1
1653440043625,MATH 264A,A00,087433,Warnke; Lutz Peter,5,0,8,3
1653440044149,MATH 268,A00,087434,Staff,15,0,15,0
1653440044670,MATH 269,A00,087435,Staff,14,0,15,1
1653440045199,MATH 270A,A00,087436,Nie; Jiawang,0,0,8,8
1653440045736,MATH 272A,A00,087437,Tian; Xiaochuan,1,0,8,7
1653440046266,MATH 274,A01,087439,Cheng; Li-Tien,9,0,10,1
1653440046266,MATH 274,A02,087440,Cheng; Li-Tien,10,0,10,0
1653440046796,MATH 278A,A00,087441,Staff,8,0,10,2
1653440047320,MATH 278B,A00,087442,Staff,8,0,10,2
1653440047978,MATH 278C,A00,087443,Staff,8,0,10,2
1653440048510,MATH 280A,A00,087444,Zheng; Tianyi,0,0,8,8
1653440049033,MATH 281A,A00,087445,Bradic; Jelena,0,0,8,8
1653440049576,MATH 282A,A00,087446,Zhang; Danna,0,0,8,8
1653440050105,MATH 283,A00,087447,Tesler; Glenn,0,0,0,14
1653440050633,MATH 286,A00,087448,Kemp; Todd Aahron,6,0,8,2
1653440051159,MATH 287D,A00,087449,Bradic; Jelena,8,0,8,0
1653440051683,MATH 288,A00,087450,Staff,14,0,15,1
1653440051683,MATH 288,B00,087451,Staff,15,0,15,0
1653440051683,MATH 288,C00,087452,Staff,15,0,15,0
1653440052206,MATH 290A,A00,087453,Xu; Zhouli,7,0,8,1
1653440052728,MATH 291A,A00,087454,Xu; Zhouli,7,0,8,1
1653440053249,MATH 292,A00,087455,Staff,10,0,10,0
1653440053772,MATH 295,A00,087456,Staff,50,0,50,0
1653440054304,MATH 297,001,087457,Staff,998,0,999,1
1653440631618,COGS 200,A01,087991,Staff,47,0,50,3
1653440632144,COGS 201,A01,094504,Rangel; Lara M,17,0,25,8
1653440632684,COGS 203,A00,087992,Coulson; Seana M,18,0,20,2
1653440633209,COGS 210A,001,087993,Greene; Deanna Jacquelyn,9998,0,9999,1
1653440633209,COGS 210A,002,087994,Saygin; Ayse P,9999,0,9999,0
1653440633209,COGS 210A,003,087995,Xia; Haijun,9999,0,9999,0
1653440633209,COGS 210A,004,087996,Nitz; Douglas A.,9999,0,9999,0
1653440633209,COGS 210A,005,087997,Hollan; James D.,9999,0,9999,0
1653440633209,COGS 210A,006,087998,Deak; Gedeon O.,9998,0,9999,1
1653440633209,COGS 210A,007,087999,Rossano; Federico,9999,0,9999,0
1653440633738,COGS 211A,A00,088000,Coulson; Seana M,9997,0,9999,2
1653440634277,COGS 229,A00,088002,Staff,23,0,25,2
1653440634815,COGS 260,B00,094231,Staff,17,0,20,3
1653440634815,COGS 260,A00,088004,Nitz; Douglas A.,9998,0,9999,1
1653440635348,CSE 202,A00,090110,Paturi; Ramamohan,0,0,0,0
1653440635348,CSE 202,B00,090111,Paturi; Ramamohan,0,0,0,0
1653440635886,CSE 207B,A00,090112,Heninger; Nadia A,0,0,0,0
1653440636424,CSE 208,A00,094858,Micciancio; Daniele,0,0,0,0
1653440636956,CSE 210,A00,090113,Powell; Thomas Allan,0,0,0,0
1653440637479,CSE 219,A00,090898,Staff,0,0,0,0
1653440638008,CSE 221,A00,090114,Zhou; Yuan-Yuan,0,0,0,0
1653440638533,CSE 229A,A00,090115,Porter; George M,0,0,0,0
1653440639070,CSE 229C,A00,090116,Savage; Stefan,0,0,0,0
1653440639627,CSE 230,A00,090117,Jhala; Ranjit,0,0,0,0
1653440640167,CSE 232,A00,090118,Papakonstantinou; Yannis,0,0,0,0
1653440640703,CSE 239A,A00,090121,Kumar; Arun Kumar,0,0,0,0
1653440641229,CSE 239B,A00,090122,Jhala; Ranjit,0,0,0,0
1653440641788,CSE 240A,A00,090123,Zhao; Jishen,0,0,189,189
1653440642332,CSE 243A,A00,090124,Orailoglu; Alex,2,0,15,13
1653440642869,CSE 249B,A00,090125,Kahng; Andrew Byun,13,0,20,7
1653440643397,CSE 250A,A00,090126,Berg-Kirkpatrick; Taylor D,0,0,0,0
1653440643920,CSE 252A,A00,090127,Ochoa; Benjamin Lawrence,0,0,0,0
1653440644444,CSE 258,A01,090129,McAuley; Julian John,0,0,0,0
1653440644976,CSE 258R,A01,090131,McAuley; Julian John,0,0,0,0
1653440645518,CSE 274,A00,090132,Ramamoorthi; Ravi,0,0,0,0
1653440646057,CSE 276A,A00,090133,Christensen; Henrik I,0,0,0,0
1653440646591,CSE 276C,A00,090134,Christensen; Henrik I,0,0,0,0
1653440647114,CSE 290,A00,090135,Bafna; Vineet,0,0,0,0
1653440647114,CSE 290,B00,090136,Ramamoorthi; Ravi,0,0,0,0
1653440647114,CSE 290,C00,090137,Li; Tzumao,9,0,10,1
1653440647114,CSE 290,D00,090138,Zhou; Yuan-Yuan,10,0,10,0
1653440647114,CSE 290,E00,090139,Christensen; Henrik I,10,0,10,0
1653440647114,CSE 290,F00,094053,Shalev; Aaron D,0,0,0,0
1653440647658,CSE 291,A00,090140,Munyaka; Imani N. S.,0,0,0,0
1653440647658,CSE 291,B00,094880,Yu; Qi,0,0,0,0
1653440647658,CSE 291,C00,090142,Pannuto; Patrick William,0,0,0,0
1653440647658,CSE 291,D00,094881,Zhang; Yiying,0,0,0,0
1653440647658,CSE 291,E00,095118,Su; Hao,0,0,0,0
1653440648202,CSE 293,001,094905,Bafna; Vineet,9999,0,9999,0
1653440648202,CSE 293,002,094906,Bellare; Mihir,9999,0,9999,0
1653440648202,CSE 293,003,094907,Berg-Kirkpatrick; Taylor D,9999,0,9999,0
1653440648202,CSE 293,004,094908,Christensen; Henrik I,9999,0,9999,0
1653440648202,CSE 293,005,094909,Cottrell; Garrison W,9999,0,9999,0
1653440648202,CSE 293,006,094910,Deutsch; Alin Bernard,9999,0,9999,0
1653440648202,CSE 293,007,094911,Esmaeilzadeh; Hadi,9999,0,9999,0
1653440648202,CSE 293,008,094912,Freund; Yoav,9999,0,9999,0
1653440648202,CSE 293,009,094913,Griswold; William G.,9999,0,9999,0
1653440648202,CSE 293,010,094914,Gymrek; Melissa Ann,9999,0,9999,0
1653440648202,CSE 293,011,094915,Heninger; Nadia A,9999,0,9999,0
1653440648202,CSE 293,012,094916,Impagliazzo; Russell,9999,0,9999,0
1653440648202,CSE 293,013,094917,Jhala; Ranjit,9999,0,9999,0
1653440648202,CSE 293,014,094918,Kahng; Andrew Byun,9999,0,9999,0
1653440648202,CSE 293,015,094919,Kane; Daniel Mertz,9999,0,9999,0
1653440648202,CSE 293,016,094920,Kriegman; David J,9999,0,9999,0
1653440648202,CSE 293,017,094921,Kumar; Arun Kumar,9999,0,9999,0
1653440648202,CSE 293,018,094922,Lerner; Sorin,9999,0,9999,0
1653440648202,CSE 293,019,094923,Lovett; Shachar,9999,0,9999,0
1653440648202,CSE 293,020,094924,McAuley; Julian John,9999,0,9999,0
1653440648202,CSE 293,021,094925,Micciancio; Daniele,9999,0,9999,0
1653440648202,CSE 293,022,094926,Orailoglu; Alex,9999,0,9999,0
1653440648202,CSE 293,023,094927,Paturi; Ramamohan,9999,0,9999,0
1653440648202,CSE 293,024,094928,Polikarpova; Nadezhda,9999,0,9999,0
1653440648202,CSE 293,025,094929,Politz; Joseph Gibbs,9999,0,9999,0
1653440648202,CSE 293,026,094930,Porter; George M,9999,0,9999,0
1653440648202,CSE 293,027,094931,Porter; Leonard Emerson,9999,0,9999,0
1653440648202,CSE 293,028,094932,Ramamoorthi; Ravi,9999,0,9999,0
1653440648202,CSE 293,029,094933,Sahoo; Debashis,9999,0,9999,0
1653440648202,CSE 293,030,094934,Saul; Lawrence,9999,0,9999,0
1653440648202,CSE 293,031,094935,Savage; Stefan,9999,0,9999,0
1653440648202,CSE 293,032,094936,Schulze; Jurgen P.,9999,0,9999,0
1653440648202,CSE 293,033,094937,Snoeren; Alex C.,9999,0,9999,0
1653440648202,CSE 293,034,094938,Shang; Jingbo,9999,0,9999,0
1653440648202,CSE 293,035,094939,Stefan; Deian,9999,0,9999,0
1653440648202,CSE 293,036,094940,Su; Hao,9999,0,9999,0
1653440648202,CSE 293,037,094941,Swanson; Steven James,9999,0,9999,0
1653440648202,CSE 293,038,094942,Tullsen; Dean Michael,9999,0,9999,0
1653440648202,CSE 293,039,094943,Voelker; Geoffrey M.,9999,0,9999,0
1653440648202,CSE 293,040,094944,Zhao; Jishen,9999,0,9999,0
1653440648202,CSE 293,041,094945,Zhou; Yuan-Yuan,9999,0,9999,0
1653440648202,CSE 293,042,094946,Gao; Sicun,9998,0,9999,1
1653440648202,CSE 293,043,094947,Weibel; Nadir,9999,0,9999,0
1653440648202,CSE 293,044,094948,Gupta; Rajesh K.,9999,0,9999,0
1653440648726,CSE 294,A00,090143,Porter; George M,9,0,10,1
1653440649249,DSE 200,A00,091799,Staff,50,0,50,0
1653440649774,DSE 203,A00,091800,Gupta; Amarnath,30,0,30,0
1653440650296,DSE 250,A00,091801,Deutsch; Alin Bernard,30,0,30,0
1653440650832,DSE 290,A00,091802,Altintas De Callaf; Ilkay,50,0,50,0
1653440651381,ECE 200,001,091003,Antipa; Nicholas A,9999,0,9999,0
1653440651381,ECE 200,002,091004,Atanasov; Nikolay A.,9999,0,9999,0
1653440651381,ECE 200,003,091005,Bharadia; Dinesh,9999,0,9999,0
1653440651381,ECE 200,004,091006,Cheng; Chung Kuan,9999,0,9999,0
1653440651381,ECE 200,005,091007,Cosman; Pamela C.,9999,0,9999,0
1653440651381,ECE 200,006,091008,Staff,9999,0,9999,0
1653440651381,ECE 200,007,091009,Dayeh; Shadi Ahmad,9999,0,9999,0
1653440651381,ECE 200,008,091010,Fainman; Yeshaiahu,9999,0,9999,0
1653440651381,ECE 200,009,091011,Ford; Joseph Earl,9999,0,9999,0
1653440651381,ECE 200,010,091012,Franceschetti; Massimo,9999,0,9999,0
1653440651381,ECE 200,011,091013,Fullerton; Eric E,9999,0,9999,0
1653440651381,ECE 200,012,091014,Galton; Ian A,9999,0,9999,0
1653440651381,ECE 200,013,091015,Gilja; Vikash,9999,0,9999,0
1653440651381,ECE 200,014,091016,Hall; Drew A.,9999,0,9999,0
1653440651381,ECE 200,015,091017,Hsueh; Tzu-Chien,9999,0,9999,0
1653440651381,ECE 200,016,091018,Javidi; Tara,9999,0,9999,0
1653440651381,ECE 200,017,091019,Kahng; Andrew Byun,9999,0,9999,0
1653440651381,ECE 200,018,091020,Kim; Young-Han,9999,0,9999,0
1653440651381,ECE 200,019,091021,Koushanfar; Farinaz,9999,0,9999,0
1653440651381,ECE 200,020,091022,Kuzum; Duygu,9999,0,9999,0
1653440651381,ECE 200,021,091023,Le; Hanh-Phuc,9999,0,9999,0
1653440651381,ECE 200,022,091024,Lin; Bill,9999,0,9999,0
1653440651381,ECE 200,023,091025,Liu; Zhaowei,9999,0,9999,0
1653440651381,ECE 200,024,091026,Lo; Yu-Hwa,9999,0,9999,0
1653440651381,ECE 200,025,091027,Lomakin; Vitaliy,9999,0,9999,0
1653440651381,ECE 200,026,091028,Mercier; Patrick Philip,9999,0,9999,0
1653440651381,ECE 200,027,091029,Meyer; Florian,9999,0,9999,0
1653440651381,ECE 200,028,091030,Milstein; Laurence B.,9999,0,9999,0
1653440651381,ECE 200,029,091031,Mir Arabbaygi; Siavash,9999,0,9999,0
1653440651381,ECE 200,030,091032,Mookherjea; Shayan,9999,0,9999,0
1653440651381,ECE 200,031,091033,Morris; Karcher William,9999,0,9999,0
1653440651381,ECE 200,032,091034,Ng; Tse Nga,9999,0,9999,0
1653440651381,ECE 200,033,091035,Nguyen; Truong Quang,9999,0,9999,0
1653440651381,ECE 200,034,091036,Nomura; Kenji,9999,0,9999,0
1653440651381,ECE 200,035,091037,Orlitsky; Alon,9999,0,9999,0
1653440651381,ECE 200,036,091038,Pal; Piya,9999,0,9999,0
1653440651381,ECE 200,037,091039,Papen; George C.,9999,0,9999,0
1653440651381,ECE 200,038,091040,Radic; Stojan,9999,0,9999,0
1653440651381,ECE 200,039,091041,Rao; Bhaskar D.,9999,0,9999,0
1653440651381,ECE 200,040,091042,Rao; Ramesh R,9999,0,9999,0
1653440651381,ECE 200,041,091043,Rebeiz; Gabriel,9999,0,9999,0
1653440651381,ECE 200,042,091044,Sanford; John R,9999,0,9999,0
1653440651381,ECE 200,043,091045,Siegel; Paul H.,9999,0,9999,0
1653440651381,ECE 200,044,091046,Sievenpiper; Daniel F.,9999,0,9999,0
1653440651381,ECE 200,045,091047,Sworder; David D.,9999,0,9999,0
1653440651381,ECE 200,046,091048,Taur; Yuan,9999,0,9999,0
1653440651381,ECE 200,047,091049,Touri; Behrouz,9999,0,9999,0
1653440651381,ECE 200,048,091050,Trivedi; Mohan M.,9999,0,9999,0
1653440651381,ECE 200,049,091051,Vardy; Alexander,9999,0,9999,0
1653440651381,ECE 200,050,091052,Vasconcelos; Nuno,9999,0,9999,0
1653440651381,ECE 200,051,091053,Wang; Xiaolong,9999,0,9999,0
1653440651381,ECE 200,052,091054,Xie; Pengtao,9999,0,9999,0
1653440651381,ECE 200,053,091055,Yip; Michael,9999,0,9999,0
1653440651381,ECE 200,054,091056,Zeger; Kenneth A.,9999,0,9999,0
1653440651381,ECE 200,055,091057,Zhang; Xinyu,9999,0,9999,0
1653440651381,ECE 200,056,091058,Turakhia; Yatish Girish,9999,0,9999,0
1653440651381,ECE 200,057,091059,Kang; Mingu,9999,0,9999,0
1653440651381,ECE 200,058,091060,Shi; Yuanyuan,9999,0,9999,0
1653440651381,ECE 200,059,091061,Wang; Edward Jay,9999,0,9999,0
1653440651381,ECE 200,060,091062,Zheng; Yang,9999,0,9999,0
1653440651916,ECE 203,A00,091065,Mercier; Patrick Philip,0,0,0,0
1653440652453,ECE 207A,A00,091605,Liu; Thomas Tao-Ming,0,0,0,0
1653440652976,ECE 212AN,A00,091068,Nomura; Kenji,0,0,0,0
1653440653521,ECE 222A,A00,091069,Rebeiz; Gabriel,0,0,0,0
1653440654068,ECE 225A,A00,091070,Orlitsky; Alon,0,0,0,0
1653440654592,ECE 230A,A00,091071,Nomura; Kenji,0,0,0,0
1653440655115,ECE 236A,A00,091072,Dayeh; Shadi Ahmad,0,0,0,0
1653440655659,ECE 238A,A00,091073,Luo; Jian,0,0,0,0
1653440655659,ECE 238A,B00,091074,Luo; Jian,0,0,0,0
1653440656188,ECE 240A,A00,091075,Radic; Stojan,0,0,0,0
1653440656734,ECE 247A,A00,091592,Shi; Lingyan,0,0,0,0
1653440657262,ECE 250,A00,091076,Touri; Behrouz,0,0,0,0
1653440657805,ECE 251C,A00,091078,Nguyen; Truong Quang,0,0,0,0
1653440658328,ECE 253,A00,091079,Cosman; Pamela C.,0,0,0,0
1653440658852,ECE 255A,A00,091080,Orlitsky; Alon,0,0,0,0
1653440659375,ECE 257A,A00,091081,Zhang; Xinyu,0,0,0,0
1653440659926,ECE 260A,A01,091084,Eldon; John,0,0,0,0
1653440660451,ECE 264C,A00,091085,Galton; Ian A,0,0,0,0
1653440660984,ECE 265C,A00,094889,Presti; Calogero Davide,0,0,0,9
1653440661515,ECE 266,A01,091087,Hall; Drew A.,0,0,0,0
1653440662580,ECE 271A,A00,091090,Vasconcelos; Nuno,0,0,0,0
1653440663115,ECE 272B,A00,091091,Sworder; David D.,0,0,0,0
1653440663645,ECE 275A,A00,091092,Meyer; Florian,0,0,0,0
1653440664168,ECE 277,A00,091093,An; Cheolhong,0,0,0,0
1653440664701,ECE 283,A00,091094,Le; Hanh-Phuc,0,0,0,0
1653440665235,ECE 284,A00,091095,Kang; Mingu,0,0,0,0
1653440665235,ECE 284,B00,091096,Wang; Edward Jay,0,0,0,0
1653440665765,ECE 285,A00,094334,Touri; Behrouz,0,0,0,0
1653440666295,ECE 289,A00,091097,Whelan; David Arthur,0,0,0,0
1653440666935,MATH 200A,A00,087414,Salehi Golsefidy; Alireza,7,0,8,1
1653440667476,MATH 202A,A00,087415,Gill; Philip E.,3,0,8,5
1653440668004,MATH 203A,A00,087416,Oprea; Dragos N.,6,0,8,2
1653440668528,MATH 204A,A00,087417,Kedlaya; Kiran S.,6,0,8,2
1653440669061,MATH 205,A00,087418,Sorensen; Claus M,6,0,8,2
1653440669585,MATH 206A,A00,087419,Izadi; Elham,7,0,8,1
1653440670114,MATH 207A,A00,087420,Mohammadi; Amir,6,0,8,2
1653440670644,MATH 208,A00,087421,Staff,9,0,10,1
1653440671170,MATH 209,A00,087422,Staff,10,0,10,0
1653440671700,MATH 218,A00,087423,Staff,10,0,10,0
1653440672250,MATH 220A,A00,087424,Novak; Jonathan I,7,0,8,1
1653440672773,MATH 231A,A00,087425,Bejenaru; Ioan,4,0,8,4
1653440673325,MATH 240A,A00,087426,Ebenfelt; Peter F,5,0,8,3
1653440673880,MATH 243,A00,087427,Staff,9,0,10,1
1653440674424,MATH 248,A00,087429,Staff,10,0,10,0
1653440674975,MATH 250A,A00,087430,Spolaor; Luca,4,0,8,4
1653440675511,MATH 257A,A00,087431,Spolaor; Luca,7,0,8,1
1653440676126,MATH 258,A00,087432,Staff,9,0,10,1
1653440676664,MATH 264A,A00,087433,Warnke; Lutz Peter,5,0,8,3
1653440677216,MATH 268,A00,087434,Staff,15,0,15,0
1653440677753,MATH 269,A00,087435,Staff,14,0,15,1
1653440678274,MATH 270A,A00,087436,Nie; Jiawang,0,0,8,8
1653440678811,MATH 272A,A00,087437,Tian; Xiaochuan,1,0,8,7
1653440679361,MATH 274,A01,087439,Cheng; Li-Tien,9,0,10,1
1653440679361,MATH 274,A02,087440,Cheng; Li-Tien,10,0,10,0
1653440679883,MATH 278A,A00,087441,Staff,8,0,10,2
1653440680417,MATH 278B,A00,087442,Staff,8,0,10,2
1653440680941,MATH 278C,A00,087443,Staff,8,0,10,2
1653440681497,MATH 280A,A00,087444,Zheng; Tianyi,0,0,8,8
1653440682039,MATH 281A,A00,087445,Bradic; Jelena,0,0,8,8
1653440682563,MATH 282A,A00,087446,Zhang; Danna,0,0,8,8
1653440683098,MATH 283,A00,087447,Tesler; Glenn,0,0,0,14
1653440683621,MATH 286,A00,087448,Kemp; Todd Aahron,6,0,8,2
1653440684164,MATH 287D,A00,087449,Bradic; Jelena,8,0,8,0
1653440684704,MATH 288,A00,087450,Staff,14,0,15,1
1653440684704,MATH 288,B00,087451,Staff,15,0,15,0
1653440684704,MATH 288,C00,087452,Staff,15,0,15,0
1653440685245,MATH 290A,A00,087453,Xu; Zhouli,7,0,8,1
1653440685785,MATH 291A,A00,087454,Xu; Zhouli,7,0,8,1
1653440686310,MATH 292,A00,087455,Staff,10,0,10,0
1653440686852,MATH 295,A00,087456,Staff,50,0,50,0
1653440687396,MATH 297,001,087457,Staff,998,0,999,1
1653441252240,COGS 200,A01,087991,Staff,47,0,50,3
1653441252792,COGS 201,A01,094504,Rangel; Lara M,17,0,25,8
1653441253321,COGS 203,A00,087992,Coulson; Seana M,18,0,20,2
1653441253844,COGS 210A,001,087993,Greene; Deanna Jacquelyn,9998,0,9999,1
1653441253844,COGS 210A,002,087994,Saygin; Ayse P,9999,0,9999,0
1653441253844,COGS 210A,003,087995,Xia; Haijun,9999,0,9999,0
1653441253844,COGS 210A,004,087996,Nitz; Douglas A.,9999,0,9999,0
1653441253844,COGS 210A,005,087997,Hollan; James D.,9999,0,9999,0
1653441253844,COGS 210A,006,087998,Deak; Gedeon O.,9998,0,9999,1
1653441253844,COGS 210A,007,087999,Rossano; Federico,9999,0,9999,0
1653441254373,COGS 211A,A00,088000,Coulson; Seana M,9997,0,9999,2
1653441254896,COGS 229,A00,088002,Staff,23,0,25,2
1653441255421,COGS 260,B00,094231,Staff,17,0,20,3
1653441255421,COGS 260,A00,088004,Nitz; Douglas A.,9998,0,9999,1
1653441255953,CSE 202,A00,090110,Paturi; Ramamohan,0,0,0,0
1653441255953,CSE 202,B00,090111,Paturi; Ramamohan,0,0,0,0
1653441256490,CSE 207B,A00,090112,Heninger; Nadia A,0,0,0,0
1653441257021,CSE 208,A00,094858,Micciancio; Daniele,0,0,0,0
1653441257543,CSE 210,A00,090113,Powell; Thomas Allan,0,0,0,0
1653441258071,CSE 219,A00,090898,Staff,0,0,0,0
1653441258596,CSE 221,A00,090114,Zhou; Yuan-Yuan,0,0,0,0
1653441259121,CSE 229A,A00,090115,Porter; George M,0,0,0,0
1653441259748,CSE 229C,A00,090116,Savage; Stefan,0,0,0,0
1653441260274,CSE 230,A00,090117,Jhala; Ranjit,0,0,0,0
1653441260810,CSE 232,A00,090118,Papakonstantinou; Yannis,0,0,0,0
1653441261343,CSE 239A,A00,090121,Kumar; Arun Kumar,0,0,0,0
1653441261870,CSE 239B,A00,090122,Jhala; Ranjit,0,0,0,0
1653441262407,CSE 240A,A00,090123,Zhao; Jishen,0,0,189,189
1653441262930,CSE 243A,A00,090124,Orailoglu; Alex,1,0,15,14
1653441263456,CSE 249B,A00,090125,Kahng; Andrew Byun,13,0,20,7
1653441263985,CSE 250A,A00,090126,Berg-Kirkpatrick; Taylor D,0,0,0,0
1653441264507,CSE 252A,A00,090127,Ochoa; Benjamin Lawrence,0,0,0,0
1653441265073,CSE 258,A01,090129,McAuley; Julian John,0,0,0,0
1653441265598,CSE 258R,A01,090131,McAuley; Julian John,0,0,0,0
1653441266119,CSE 274,A00,090132,Ramamoorthi; Ravi,0,0,0,0
1653441266653,CSE 276A,A00,090133,Christensen; Henrik I,0,0,0,0
1653441267184,CSE 276C,A00,090134,Christensen; Henrik I,0,0,0,0
1653441267710,CSE 290,A00,090135,Bafna; Vineet,0,0,0,0
1653441267710,CSE 290,B00,090136,Ramamoorthi; Ravi,0,0,0,0
1653441267710,CSE 290,C00,090137,Li; Tzumao,9,0,10,1
1653441267710,CSE 290,D00,090138,Zhou; Yuan-Yuan,10,0,10,0
1653441267710,CSE 290,E00,090139,Christensen; Henrik I,10,0,10,0
1653441267710,CSE 290,F00,094053,Shalev; Aaron D,0,0,0,0
1653441268238,CSE 291,A00,090140,Munyaka; Imani N. S.,0,0,0,0
1653441268238,CSE 291,B00,094880,Yu; Qi,0,0,0,0
1653441268238,CSE 291,C00,090142,Pannuto; Patrick William,0,0,0,0
1653441268238,CSE 291,D00,094881,Zhang; Yiying,0,0,0,0
1653441268238,CSE 291,E00,095118,Su; Hao,0,0,0,0
1653441268783,CSE 293,001,094905,Bafna; Vineet,9999,0,9999,0
1653441268783,CSE 293,002,094906,Bellare; Mihir,9999,0,9999,0
1653441268783,CSE 293,003,094907,Berg-Kirkpatrick; Taylor D,9999,0,9999,0
1653441268783,CSE 293,004,094908,Christensen; Henrik I,9999,0,9999,0
1653441268783,CSE 293,005,094909,Cottrell; Garrison W,9999,0,9999,0
1653441268783,CSE 293,006,094910,Deutsch; Alin Bernard,9999,0,9999,0
1653441268783,CSE 293,007,094911,Esmaeilzadeh; Hadi,9999,0,9999,0
1653441268783,CSE 293,008,094912,Freund; Yoav,9999,0,9999,0
1653441268783,CSE 293,009,094913,Griswold; William G.,9999,0,9999,0
1653441268783,CSE 293,010,094914,Gymrek; Melissa Ann,9999,0,9999,0
1653441268783,CSE 293,011,094915,Heninger; Nadia A,9999,0,9999,0
1653441268783,CSE 293,012,094916,Impagliazzo; Russell,9999,0,9999,0
1653441268783,CSE 293,013,094917,Jhala; Ranjit,9999,0,9999,0
1653441268783,CSE 293,014,094918,Kahng; Andrew Byun,9999,0,9999,0
1653441268783,CSE 293,015,094919,Kane; Daniel Mertz,9999,0,9999,0
1653441268783,CSE 293,016,094920,Kriegman; David J,9999,0,9999,0
1653441268783,CSE 293,017,094921,Kumar; Arun Kumar,9999,0,9999,0
1653441268783,CSE 293,018,094922,Lerner; Sorin,9999,0,9999,0
1653441268783,CSE 293,019,094923,Lovett; Shachar,9999,0,9999,0
1653441268783,CSE 293,020,094924,McAuley; Julian John,9999,0,9999,0
1653441268783,CSE 293,021,094925,Micciancio; Daniele,9999,0,9999,0
1653441268783,CSE 293,022,094926,Orailoglu; Alex,9999,0,9999,0
1653441268783,CSE 293,023,094927,Paturi; Ramamohan,9999,0,9999,0
1653441268783,CSE 293,024,094928,Polikarpova; Nadezhda,9999,0,9999,0
1653441268783,CSE 293,025,094929,Politz; Joseph Gibbs,9999,0,9999,0
1653441268783,CSE 293,026,094930,Porter; George M,9999,0,9999,0
1653441268783,CSE 293,027,094931,Porter; Leonard Emerson,9999,0,9999,0
1653441268783,CSE 293,028,094932,Ramamoorthi; Ravi,9999,0,9999,0
1653441268783,CSE 293,029,094933,Sahoo; Debashis,9999,0,9999,0
1653441268783,CSE 293,030,094934,Saul; Lawrence,9999,0,9999,0
1653441268783,CSE 293,031,094935,Savage; Stefan,9999,0,9999,0
1653441268783,CSE 293,032,094936,Schulze; Jurgen P.,9999,0,9999,0
1653441268783,CSE 293,033,094937,Snoeren; Alex C.,9999,0,9999,0
1653441268783,CSE 293,034,094938,Shang; Jingbo,9999,0,9999,0
1653441268783,CSE 293,035,094939,Stefan; Deian,9999,0,9999,0
1653441268783,CSE 293,036,094940,Su; Hao,9999,0,9999,0
1653441268783,CSE 293,037,094941,Swanson; Steven James,9999,0,9999,0
1653441268783,CSE 293,038,094942,Tullsen; Dean Michael,9999,0,9999,0
1653441268783,CSE 293,039,094943,Voelker; Geoffrey M.,9999,0,9999,0
1653441268783,CSE 293,040,094944,Zhao; Jishen,9999,0,9999,0
1653441268783,CSE 293,041,094945,Zhou; Yuan-Yuan,9999,0,9999,0
1653441268783,CSE 293,042,094946,Gao; Sicun,9998,0,9999,1
1653441268783,CSE 293,043,094947,Weibel; Nadir,9999,0,9999,0
1653441268783,CSE 293,044,094948,Gupta; Rajesh K.,9999,0,9999,0
1653441269308,CSE 294,A00,090143,Porter; George M,9,0,10,1
1653441269842,DSE 200,A00,091799,Staff,50,0,50,0
1653441270367,DSE 203,A00,091800,Gupta; Amarnath,30,0,30,0
1653441270892,DSE 250,A00,091801,Deutsch; Alin Bernard,30,0,30,0
1653441271420,DSE 290,A00,091802,Altintas De Callaf; Ilkay,50,0,50,0
1653441271952,ECE 200,001,091003,Antipa; Nicholas A,9999,0,9999,0
1653441271952,ECE 200,002,091004,Atanasov; Nikolay A.,9999,0,9999,0
1653441271952,ECE 200,003,091005,Bharadia; Dinesh,9999,0,9999,0
1653441271952,ECE 200,004,091006,Cheng; Chung Kuan,9999,0,9999,0
1653441271952,ECE 200,005,091007,Cosman; Pamela C.,9999,0,9999,0
1653441271952,ECE 200,006,091008,Staff,9999,0,9999,0
1653441271952,ECE 200,007,091009,Dayeh; Shadi Ahmad,9999,0,9999,0
1653441271952,ECE 200,008,091010,Fainman; Yeshaiahu,9999,0,9999,0
1653441271952,ECE 200,009,091011,Ford; Joseph Earl,9999,0,9999,0
1653441271952,ECE 200,010,091012,Franceschetti; Massimo,9999,0,9999,0
1653441271952,ECE 200,011,091013,Fullerton; Eric E,9999,0,9999,0
1653441271952,ECE 200,012,091014,Galton; Ian A,9999,0,9999,0
1653441271952,ECE 200,013,091015,Gilja; Vikash,9999,0,9999,0
1653441271952,ECE 200,014,091016,Hall; Drew A.,9999,0,9999,0
1653441271952,ECE 200,015,091017,Hsueh; Tzu-Chien,9999,0,9999,0
1653441271952,ECE 200,016,091018,Javidi; Tara,9999,0,9999,0
1653441271952,ECE 200,017,091019,Kahng; Andrew Byun,9999,0,9999,0
1653441271952,ECE 200,018,091020,Kim; Young-Han,9999,0,9999,0
1653441271952,ECE 200,019,091021,Koushanfar; Farinaz,9999,0,9999,0
1653441271952,ECE 200,020,091022,Kuzum; Duygu,9999,0,9999,0
1653441271952,ECE 200,021,091023,Le; Hanh-Phuc,9999,0,9999,0
1653441271952,ECE 200,022,091024,Lin; Bill,9999,0,9999,0
1653441271952,ECE 200,023,091025,Liu; Zhaowei,9999,0,9999,0
1653441271952,ECE 200,024,091026,Lo; Yu-Hwa,9999,0,9999,0
1653441271952,ECE 200,025,091027,Lomakin; Vitaliy,9999,0,9999,0
1653441271952,ECE 200,026,091028,Mercier; Patrick Philip,9999,0,9999,0
1653441271952,ECE 200,027,091029,Meyer; Florian,9999,0,9999,0
1653441271952,ECE 200,028,091030,Milstein; Laurence B.,9999,0,9999,0
1653441271952,ECE 200,029,091031,Mir Arabbaygi; Siavash,9999,0,9999,0
1653441271952,ECE 200,030,091032,Mookherjea; Shayan,9999,0,9999,0
1653441271952,ECE 200,031,091033,Morris; Karcher William,9999,0,9999,0
1653441271952,ECE 200,032,091034,Ng; Tse Nga,9999,0,9999,0
1653441271952,ECE 200,033,091035,Nguyen; Truong Quang,9999,0,9999,0
1653441271952,ECE 200,034,091036,Nomura; Kenji,9999,0,9999,0
1653441271952,ECE 200,035,091037,Orlitsky; Alon,9999,0,9999,0
1653441271952,ECE 200,036,091038,Pal; Piya,9999,0,9999,0
1653441271952,ECE 200,037,091039,Papen; George C.,9999,0,9999,0
1653441271952,ECE 200,038,091040,Radic; Stojan,9999,0,9999,0
1653441271952,ECE 200,039,091041,Rao; Bhaskar D.,9999,0,9999,0
1653441271952,ECE 200,040,091042,Rao; Ramesh R,9999,0,9999,0
1653441271952,ECE 200,041,091043,Rebeiz; Gabriel,9999,0,9999,0
1653441271952,ECE 200,042,091044,Sanford; John R,9999,0,9999,0
1653441271952,ECE 200,043,091045,Siegel; Paul H.,9999,0,9999,0
1653441271952,ECE 200,044,091046,Sievenpiper; Daniel F.,9999,0,9999,0
1653441271952,ECE 200,045,091047,Sworder; David D.,9999,0,9999,0
1653441271952,ECE 200,046,091048,Taur; Yuan,9999,0,9999,0
1653441271952,ECE 200,047,091049,Touri; Behrouz,9999,0,9999,0
1653441271952,ECE 200,048,091050,Trivedi; Mohan M.,9999,0,9999,0
1653441271952,ECE 200,049,091051,Vardy; Alexander,9999,0,9999,0
1653441271952,ECE 200,050,091052,Vasconcelos; Nuno,9999,0,9999,0
1653441271952,ECE 200,051,091053,Wang; Xiaolong,9999,0,9999,0
1653441271952,ECE 200,052,091054,Xie; Pengtao,9999,0,9999,0
1653441271952,ECE 200,053,091055,Yip; Michael,9999,0,9999,0
1653441271952,ECE 200,054,091056,Zeger; Kenneth A.,9999,0,9999,0
1653441271952,ECE 200,055,091057,Zhang; Xinyu,9999,0,9999,0
1653441271952,ECE 200,056,091058,Turakhia; Yatish Girish,9999,0,9999,0
1653441271952,ECE 200,057,091059,Kang; Mingu,9999,0,9999,0
1653441271952,ECE 200,058,091060,Shi; Yuanyuan,9999,0,9999,0
1653441271952,ECE 200,059,091061,Wang; Edward Jay,9999,0,9999,0
1653441271952,ECE 200,060,091062,Zheng; Yang,9999,0,9999,0
1653441272485,ECE 203,A00,091065,Mercier; Patrick Philip,0,0,0,0
1653441273017,ECE 207A,A00,091605,Liu; Thomas Tao-Ming,0,0,0,0
1653441273539,ECE 212AN,A00,091068,Nomura; Kenji,0,0,0,0
1653441274072,ECE 222A,A00,091069,Rebeiz; Gabriel,0,0,0,0
1653441274610,ECE 225A,A00,091070,Orlitsky; Alon,0,0,0,0
1653441275135,ECE 230A,A00,091071,Nomura; Kenji,0,0,0,0
1653441275658,ECE 236A,A00,091072,Dayeh; Shadi Ahmad,0,0,0,0
1653441276195,ECE 238A,A00,091073,Luo; Jian,0,0,0,0
1653441276195,ECE 238A,B00,091074,Luo; Jian,0,0,0,0
1653441276720,ECE 240A,A00,091075,Radic; Stojan,0,0,0,0
1653441277248,ECE 247A,A00,091592,Shi; Lingyan,0,0,0,0
1653441277774,ECE 250,A00,091076,Touri; Behrouz,0,0,0,0
1653441278297,ECE 251C,A00,091078,Nguyen; Truong Quang,0,0,0,0
1653441278831,ECE 253,A00,091079,Cosman; Pamela C.,0,0,0,0
1653441279357,ECE 255A,A00,091080,Orlitsky; Alon,0,0,0,0
1653441279881,ECE 257A,A00,091081,Zhang; Xinyu,0,0,0,0
1653441280405,ECE 260A,A01,091084,Eldon; John,0,0,0,0
1653441280936,ECE 264C,A00,091085,Galton; Ian A,0,0,0,0
1653441281471,ECE 265C,A00,094889,Presti; Calogero Davide,0,0,0,9
1653441281995,ECE 266,A01,091087,Hall; Drew A.,0,0,0,0
1653441283049,ECE 271A,A00,091090,Vasconcelos; Nuno,0,0,0,0
1653441283583,ECE 272B,A00,091091,Sworder; David D.,0,0,0,0
1653441284111,ECE 275A,A00,091092,Meyer; Florian,0,0,0,0
1653441284645,ECE 277,A00,091093,An; Cheolhong,0,0,0,0
1653441285187,ECE 283,A00,091094,Le; Hanh-Phuc,0,0,0,0
1653441285721,ECE 284,A00,091095,Kang; Mingu,0,0,0,0
1653441285721,ECE 284,B00,091096,Wang; Edward Jay,0,0,0,0
1653441286243,ECE 285,A00,094334,Touri; Behrouz,0,0,0,0
1653441286771,ECE 289,A00,091097,Whelan; David Arthur,0,0,0,0
1653441287296,MATH 200A,A00,087414,Salehi Golsefidy; Alireza,7,0,8,1
1653441287828,MATH 202A,A00,087415,Gill; Philip E.,3,0,8,5
1653441288352,MATH 203A,A00,087416,Oprea; Dragos N.,6,0,8,2
1653441288885,MATH 204A,A00,087417,Kedlaya; Kiran S.,6,0,8,2
1653441289407,MATH 205,A00,087418,Sorensen; Claus M,6,0,8,2
1653441289929,MATH 206A,A00,087419,Izadi; Elham,7,0,8,1
1653441290455,MATH 207A,A00,087420,Mohammadi; Amir,6,0,8,2
1653441290982,MATH 208,A00,087421,Staff,9,0,10,1
1653441291520,MATH 209,A00,087422,Staff,10,0,10,0
1653441292042,MATH 218,A00,087423,Staff,10,0,10,0
1653441292564,MATH 220A,A00,087424,Novak; Jonathan I,7,0,8,1
1653441293094,MATH 231A,A00,087425,Bejenaru; Ioan,4,0,8,4
1653441293620,MATH 240A,A00,087426,Ebenfelt; Peter F,5,0,8,3
1653441294143,MATH 243,A00,087427,Staff,9,0,10,1
1653441294675,MATH 248,A00,087429,Staff,10,0,10,0
1653441295202,MATH 250A,A00,087430,Spolaor; Luca,4,0,8,4
1653441295728,MATH 257A,A00,087431,Spolaor; Luca,7,0,8,1
1653441296254,MATH 258,A00,087432,Staff,9,0,10,1
1653441296784,MATH 264A,A00,087433,Warnke; Lutz Peter,5,0,8,3
1653441297322,MATH 268,A00,087434,Staff,15,0,15,0
1653441297844,MATH 269,A00,087435,Staff,14,0,15,1
1653441298375,MATH 270A,A00,087436,Nie; Jiawang,0,0,8,8
1653441298907,MATH 272A,A00,087437,Tian; Xiaochuan,1,0,8,7
1653441299432,MATH 274,A01,087439,Cheng; Li-Tien,9,0,10,1
1653441299432,MATH 274,A02,087440,Cheng; Li-Tien,10,0,10,0
1653441299957,MATH 278A,A00,087441,Staff,8,0,10,2
1653441300485,MATH 278B,A00,087442,Staff,8,0,10,2
1653441301009,MATH 278C,A00,087443,Staff,8,0,10,2
1653441301531,MATH 280A,A00,087444,Zheng; Tianyi,0,0,8,8
1653441302054,MATH 281A,A00,087445,Bradic; Jelena,0,0,8,8
1653441302576,MATH 282A,A00,087446,Zhang; Danna,0,0,8,8
1653441303108,MATH 283,A00,087447,Tesler; Glenn,0,0,0,14
1653441303635,MATH 286,A00,087448,Kemp; Todd Aahron,6,0,8,2
1653441304165,MATH 287D,A00,087449,Bradic; Jelena,8,0,8,0
1653441304714,MATH 288,A00,087450,Staff,14,0,15,1
1653441304714,MATH 288,B00,087451,Staff,15,0,15,0
1653441304714,MATH 288,C00,087452,Staff,15,0,15,0
1653441305245,MATH 290A,A00,087453,Xu; Zhouli,7,0,8,1
1653441305769,MATH 291A,A00,087454,Xu; Zhouli,7,0,8,1
1653441306293,MATH 292,A00,087455,Staff,10,0,10,0
1653441306823,MATH 295,A00,087456,Staff,50,0,50,0
1653441307347,MATH 297,001,087457,Staff,998,0,999,1
1653441875734,COGS 200,A01,087991,Staff,47,0,50,3
1653441876259,COGS 201,A01,094504,Rangel; Lara M,17,0,25,8
1653441876781,COGS 203,A00,087992,Coulson; Seana M,18,0,20,2
1653441877304,COGS 210A,001,087993,Greene; Deanna Jacquelyn,9998,0,9999,1
1653441877304,COGS 210A,002,087994,Saygin; Ayse P,9999,0,9999,0
1653441877304,COGS 210A,003,087995,Xia; Haijun,9999,0,9999,0
1653441877304,COGS 210A,004,087996,Nitz; Douglas A.,9999,0,9999,0
1653441877304,COGS 210A,005,087997,Hollan; James D.,9999,0,9999,0
1653441877304,COGS 210A,006,087998,Deak; Gedeon O.,9998,0,9999,1
1653441877304,COGS 210A,007,087999,Rossano; Federico,9999,0,9999,0
1653441877838,COGS 211A,A00,088000,Coulson; Seana M,9997,0,9999,2
1653441878362,COGS 229,A00,088002,Staff,23,0,25,2
1653441878896,COGS 260,B00,094231,Staff,17,0,20,3
1653441878896,COGS 260,A00,088004,Nitz; Douglas A.,9998,0,9999,1
1653441879423,CSE 202,A00,090110,Paturi; Ramamohan,0,0,0,0
1653441879423,CSE 202,B00,090111,Paturi; Ramamohan,0,0,0,0
1653441879945,CSE 207B,A00,090112,Heninger; Nadia A,0,0,0,0
1653441880468,CSE 208,A00,094858,Micciancio; Daniele,0,0,0,0
1653441880999,CSE 210,A00,090113,Powell; Thomas Allan,0,0,0,0
1653441881528,CSE 219,A00,090898,Staff,0,0,0,0
1653441882050,CSE 221,A00,090114,Zhou; Yuan-Yuan,0,0,0,0
1653441882571,CSE 229A,A00,090115,Porter; George M,0,0,0,0
1653441883097,CSE 229C,A00,090116,Savage; Stefan,0,0,0,0
1653441883632,CSE 230,A00,090117,Jhala; Ranjit,0,0,0,0
1653441884170,CSE 232,A00,090118,Papakonstantinou; Yannis,0,0,0,0
1653441884701,CSE 239A,A00,090121,Kumar; Arun Kumar,0,0,0,0
1653441885232,CSE 239B,A00,090122,Jhala; Ranjit,0,0,0,0
1653441885766,CSE 240A,A00,090123,Zhao; Jishen,0,0,189,189
1653441886292,CSE 243A,A00,090124,Orailoglu; Alex,1,0,15,14
1653441886839,CSE 249B,A00,090125,Kahng; Andrew Byun,13,0,20,7
1653441887370,CSE 250A,A00,090126,Berg-Kirkpatrick; Taylor D,0,0,0,0
1653441887913,CSE 252A,A00,090127,Ochoa; Benjamin Lawrence,0,0,0,0
1653441888439,CSE 258,A01,090129,McAuley; Julian John,0,0,0,0
1653441888961,CSE 258R,A01,090131,McAuley; Julian John,0,0,0,0
1653441889493,CSE 274,A00,090132,Ramamoorthi; Ravi,0,0,0,0
1653441890026,CSE 276A,A00,090133,Christensen; Henrik I,0,0,0,0
1653441890550,CSE 276C,A00,090134,Christensen; Henrik I,0,0,0,0
1653441891077,CSE 290,A00,090135,Bafna; Vineet,0,0,0,0
1653441891077,CSE 290,B00,090136,Ramamoorthi; Ravi,0,0,0,0
1653441891077,CSE 290,C00,090137,Li; Tzumao,9,0,10,1
1653441891077,CSE 290,D00,090138,Zhou; Yuan-Yuan,10,0,10,0
1653441891077,CSE 290,E00,090139,Christensen; Henrik I,10,0,10,0
1653441891077,CSE 290,F00,094053,Shalev; Aaron D,0,0,0,0
1653441891607,CSE 291,A00,090140,Munyaka; Imani N. S.,0,0,0,0
1653441891607,CSE 291,B00,094880,Yu; Qi,0,0,0,0
1653441891607,CSE 291,C00,090142,Pannuto; Patrick William,0,0,0,0
1653441891607,CSE 291,D00,094881,Zhang; Yiying,0,0,0,0
1653441891607,CSE 291,E00,095118,Su; Hao,0,0,0,0
1653441892133,CSE 293,001,094905,Bafna; Vineet,9999,0,9999,0
1653441892133,CSE 293,002,094906,Bellare; Mihir,9999,0,9999,0
1653441892133,CSE 293,003,094907,Berg-Kirkpatrick; Taylor D,9999,0,9999,0
1653441892133,CSE 293,004,094908,Christensen; Henrik I,9999,0,9999,0
1653441892133,CSE 293,005,094909,Cottrell; Garrison W,9999,0,9999,0
1653441892133,CSE 293,006,094910,Deutsch; Alin Bernard,9999,0,9999,0
1653441892133,CSE 293,007,094911,Esmaeilzadeh; Hadi,9999,0,9999,0
1653441892133,CSE 293,008,094912,Freund; Yoav,9999,0,9999,0
1653441892133,CSE 293,009,094913,Griswold; William G.,9999,0,9999,0
1653441892133,CSE 293,010,094914,Gymrek; Melissa Ann,9999,0,9999,0
1653441892133,CSE 293,011,094915,Heninger; Nadia A,9999,0,9999,0
1653441892133,CSE 293,012,094916,Impagliazzo; Russell,9999,0,9999,0
1653441892133,CSE 293,013,094917,Jhala; Ranjit,9999,0,9999,0
1653441892133,CSE 293,014,094918,Kahng; Andrew Byun,9999,0,9999,0
1653441892133,CSE 293,015,094919,Kane; Daniel Mertz,9999,0,9999,0
1653441892133,CSE 293,016,094920,Kriegman; David J,9999,0,9999,0
1653441892133,CSE 293,017,094921,Kumar; Arun Kumar,9999,0,9999,0
1653441892133,CSE 293,018,094922,Lerner; Sorin,9999,0,9999,0
1653441892133,CSE 293,019,094923,Lovett; Shachar,9999,0,9999,0
1653441892133,CSE 293,020,094924,McAuley; Julian John,9999,0,9999,0
1653441892133,CSE 293,021,094925,Micciancio; Daniele,9999,0,9999,0
1653441892133,CSE 293,022,094926,Orailoglu; Alex,9999,0,9999,0
1653441892133,CSE 293,023,094927,Paturi; Ramamohan,9999,0,9999,0
1653441892133,CSE 293,024,094928,Polikarpova; Nadezhda,9999,0,9999,0
1653441892133,CSE 293,025,094929,Politz; Joseph Gibbs,9999,0,9999,0
1653441892133,CSE 293,026,094930,Porter; George M,9999,0,9999,0
1653441892133,CSE 293,027,094931,Porter; Leonard Emerson,9999,0,9999,0
1653441892133,CSE 293,028,094932,Ramamoorthi; Ravi,9999,0,9999,0
1653441892133,CSE 293,029,094933,Sahoo; Debashis,9999,0,9999,0
1653441892133,CSE 293,030,094934,Saul; Lawrence,9999,0,9999,0
1653441892133,CSE 293,031,094935,Savage; Stefan,9999,0,9999,0
1653441892133,CSE 293,032,094936,Schulze; Jurgen P.,9999,0,9999,0
1653441892133,CSE 293,033,094937,Snoeren; Alex C.,9999,0,9999,0
1653441892133,CSE 293,034,094938,Shang; Jingbo,9999,0,9999,0
1653441892133,CSE 293,035,094939,Stefan; Deian,9999,0,9999,0
1653441892133,CSE 293,036,094940,Su; Hao,9999,0,9999,0
1653441892133,CSE 293,037,094941,Swanson; Steven James,9999,0,9999,0
1653441892133,CSE 293,038,094942,Tullsen; Dean Michael,9999,0,9999,0
1653441892133,CSE 293,039,094943,Voelker; Geoffrey M.,9999,0,9999,0
1653441892133,CSE 293,040,094944,Zhao; Jishen,9999,0,9999,0
1653441892133,CSE 293,041,094945,Zhou; Yuan-Yuan,9999,0,9999,0
1653441892133,CSE 293,042,094946,Gao; Sicun,9998,0,9999,1
1653441892133,CSE 293,043,094947,Weibel; Nadir,9999,0,9999,0
1653441892133,CSE 293,044,094948,Gupta; Rajesh K.,9999,0,9999,0
1653441892656,CSE 294,A00,090143,Porter; George M,9,0,10,1
1653441893177,DSE 200,A00,091799,Staff,50,0,50,0
1653441893707,DSE 203,A00,091800,Gupta; Amarnath,30,0,30,0
1653441894235,DSE 250,A00,091801,Deutsch; Alin Bernard,30,0,30,0
1653441894779,DSE 290,A00,091802,Altintas De Callaf; Ilkay,50,0,50,0
1653441895337,ECE 200,001,091003,Antipa; Nicholas A,9999,0,9999,0
1653441895337,ECE 200,002,091004,Atanasov; Nikolay A.,9999,0,9999,0
1653441895337,ECE 200,003,091005,Bharadia; Dinesh,9999,0,9999,0
1653441895337,ECE 200,004,091006,Cheng; Chung Kuan,9999,0,9999,0
1653441895337,ECE 200,005,091007,Cosman; Pamela C.,9999,0,9999,0
1653441895337,ECE 200,006,091008,Staff,9999,0,9999,0
1653441895337,ECE 200,007,091009,Dayeh; Shadi Ahmad,9999,0,9999,0
1653441895337,ECE 200,008,091010,Fainman; Yeshaiahu,9999,0,9999,0
1653441895337,ECE 200,009,091011,Ford; Joseph Earl,9999,0,9999,0
1653441895337,ECE 200,010,091012,Franceschetti; Massimo,9999,0,9999,0
1653441895337,ECE 200,011,091013,Fullerton; Eric E,9999,0,9999,0
1653441895337,ECE 200,012,091014,Galton; Ian A,9999,0,9999,0
1653441895337,ECE 200,013,091015,Gilja; Vikash,9999,0,9999,0
1653441895337,ECE 200,014,091016,Hall; Drew A.,9999,0,9999,0
1653441895337,ECE 200,015,091017,Hsueh; Tzu-Chien,9999,0,9999,0
1653441895337,ECE 200,016,091018,Javidi; Tara,9999,0,9999,0
1653441895337,ECE 200,017,091019,Kahng; Andrew Byun,9999,0,9999,0
1653441895337,ECE 200,018,091020,Kim; Young-Han,9999,0,9999,0
1653441895337,ECE 200,019,091021,Koushanfar; Farinaz,9999,0,9999,0
1653441895337,ECE 200,020,091022,Kuzum; Duygu,9999,0,9999,0
1653441895337,ECE 200,021,091023,Le; Hanh-Phuc,9999,0,9999,0
1653441895337,ECE 200,022,091024,Lin; Bill,9999,0,9999,0
1653441895337,ECE 200,023,091025,Liu; Zhaowei,9999,0,9999,0
1653441895337,ECE 200,024,091026,Lo; Yu-Hwa,9999,0,9999,0
1653441895337,ECE 200,025,091027,Lomakin; Vitaliy,9999,0,9999,0
1653441895337,ECE 200,026,091028,Mercier; Patrick Philip,9999,0,9999,0
1653441895337,ECE 200,027,091029,Meyer; Florian,9999,0,9999,0
1653441895337,ECE 200,028,091030,Milstein; Laurence B.,9999,0,9999,0
1653441895337,ECE 200,029,091031,Mir Arabbaygi; Siavash,9999,0,9999,0
1653441895337,ECE 200,030,091032,Mookherjea; Shayan,9999,0,9999,0
1653441895337,ECE 200,031,091033,Morris; Karcher William,9999,0,9999,0
1653441895337,ECE 200,032,091034,Ng; Tse Nga,9999,0,9999,0
1653441895337,ECE 200,033,091035,Nguyen; Truong Quang,9999,0,9999,0
1653441895337,ECE 200,034,091036,Nomura; Kenji,9999,0,9999,0
1653441895337,ECE 200,035,091037,Orlitsky; Alon,9999,0,9999,0
1653441895337,ECE 200,036,091038,Pal; Piya,9999,0,9999,0
1653441895337,ECE 200,037,091039,Papen; George C.,9999,0,9999,0
1653441895337,ECE 200,038,091040,Radic; Stojan,9999,0,9999,0
1653441895337,ECE 200,039,091041,Rao; Bhaskar D.,9999,0,9999,0
1653441895337,ECE 200,040,091042,Rao; Ramesh R,9999,0,9999,0
1653441895337,ECE 200,041,091043,Rebeiz; Gabriel,9999,0,9999,0
1653441895337,ECE 200,042,091044,Sanford; John R,9999,0,9999,0
1653441895337,ECE 200,043,091045,Siegel; Paul H.,9999,0,9999,0
1653441895337,ECE 200,044,091046,Sievenpiper; Daniel F.,9999,0,9999,0
1653441895337,ECE 200,045,091047,Sworder; David D.,9999,0,9999,0
1653441895337,ECE 200,046,091048,Taur; Yuan,9999,0,9999,0
1653441895337,ECE 200,047,091049,Touri; Behrouz,9999,0,9999,0
1653441895337,ECE 200,048,091050,Trivedi; Mohan M.,9999,0,9999,0
1653441895337,ECE 200,049,091051,Vardy; Alexander,9999,0,9999,0
1653441895337,ECE 200,050,091052,Vasconcelos; Nuno,9999,0,9999,0
1653441895337,ECE 200,051,091053,Wang; Xiaolong,9999,0,9999,0
1653441895337,ECE 200,052,091054,Xie; Pengtao,9999,0,9999,0
1653441895337,ECE 200,053,091055,Yip; Michael,9999,0,9999,0
1653441895337,ECE 200,054,091056,Zeger; Kenneth A.,9999,0,9999,0
1653441895337,ECE 200,055,091057,Zhang; Xinyu,9999,0,9999,0
1653441895337,ECE 200,056,091058,Turakhia; Yatish Girish,9999,0,9999,0
1653441895337,ECE 200,057,091059,Kang; Mingu,9999,0,9999,0
1653441895337,ECE 200,058,091060,Shi; Yuanyuan,9999,0,9999,0
1653441895337,ECE 200,059,091061,Wang; Edward Jay,9999,0,9999,0
1653441895337,ECE 200,060,091062,Zheng; Yang,9999,0,9999,0
1653441895862,ECE 203,A00,091065,Mercier; Patrick Philip,0,0,0,0
1653441896388,ECE 207A,A00,091605,Liu; Thomas Tao-Ming,0,0,0,0
1653441896919,ECE 212AN,A00,091068,Nomura; Kenji,0,0,0,0
1653441897449,ECE 222A,A00,091069,Rebeiz; Gabriel,0,0,0,0
1653441897975,ECE 225A,A00,091070,Orlitsky; Alon,0,0,0,0
1653441898497,ECE 230A,A00,091071,Nomura; Kenji,0,0,0,0
1653441899023,ECE 236A,A00,091072,Dayeh; Shadi Ahmad,0,0,0,0
1653441899545,ECE 238A,A00,091073,Luo; Jian,0,0,0,0
1653441899545,ECE 238A,B00,091074,Luo; Jian,0,0,0,0
1653441900069,ECE 240A,A00,091075,Radic; Stojan,0,0,0,0
1653441900612,ECE 247A,A00,091592,Shi; Lingyan,0,0,0,0
1653441901139,ECE 250,A00,091076,Touri; Behrouz,0,0,0,0
1653441901666,ECE 251C,A00,091078,Nguyen; Truong Quang,0,0,0,0
1653441902190,ECE 253,A00,091079,Cosman; Pamela C.,0,0,0,0
1653441902720,ECE 255A,A00,091080,Orlitsky; Alon,0,0,0,0
1653441903243,ECE 257A,A00,091081,Zhang; Xinyu,0,0,0,0
1653441903774,ECE 260A,A01,091084,Eldon; John,0,0,0,0
1653441904300,ECE 264C,A00,091085,Galton; Ian A,0,0,0,0
1653441904822,ECE 265C,A00,094889,Presti; Calogero Davide,0,0,0,9
1653441905344,ECE 266,A01,091087,Hall; Drew A.,0,0,0,0
1653441906409,ECE 271A,A00,091090,Vasconcelos; Nuno,0,0,0,0
1653441906944,ECE 272B,A00,091091,Sworder; David D.,0,0,0,0
1653441907476,ECE 275A,A00,091092,Meyer; Florian,0,0,0,0
1653441907999,ECE 277,A00,091093,An; Cheolhong,0,0,0,0
1653441908529,ECE 283,A00,091094,Le; Hanh-Phuc,0,0,0,0
1653441909163,ECE 284,A00,091095,Kang; Mingu,0,0,0,0
1653441909163,ECE 284,B00,091096,Wang; Edward Jay,0,0,0,0
1653441909693,ECE 285,A00,094334,Touri; Behrouz,0,0,0,0
1653441910223,ECE 289,A00,091097,Whelan; David Arthur,0,0,0,0
1653441910748,MATH 200A,A00,087414,Salehi Golsefidy; Alireza,7,0,8,1
1653441911270,MATH 202A,A00,087415,Gill; Philip E.,3,0,8,5
1653441911793,MATH 203A,A00,087416,Oprea; Dragos N.,6,0,8,2
1653441912313,MATH 204A,A00,087417,Kedlaya; Kiran S.,6,0,8,2
1653441912837,MATH 205,A00,087418,Sorensen; Claus M,6,0,8,2
1653441913368,MATH 206A,A00,087419,Izadi; Elham,7,0,8,1
1653441913904,MATH 207A,A00,087420,Mohammadi; Amir,6,0,8,2
1653441914429,MATH 208,A00,087421,Staff,9,0,10,1
1653441914979,MATH 209,A00,087422,Staff,10,0,10,0
1653441915504,MATH 218,A00,087423,Staff,10,0,10,0
1653441916039,MATH 220A,A00,087424,Novak; Jonathan I,7,0,8,1
1653441916564,MATH 231A,A00,087425,Bejenaru; Ioan,4,0,8,4
1653441917091,MATH 240A,A00,087426,Ebenfelt; Peter F,5,0,8,3
1653441917623,MATH 243,A00,087427,Staff,9,0,10,1
1653441918157,MATH 248,A00,087429,Staff,10,0,10,0
1653441918679,MATH 250A,A00,087430,Spolaor; Luca,4,0,8,4
1653441919202,MATH 257A,A00,087431,Spolaor; Luca,7,0,8,1
1653441919736,MATH 258,A00,087432,Staff,9,0,10,1
1653441920264,MATH 264A,A00,087433,Warnke; Lutz Peter,5,0,8,3
1653441920788,MATH 268,A00,087434,Staff,15,0,15,0
1653441921318,MATH 269,A00,087435,Staff,14,0,15,1
1653441921840,MATH 270A,A00,087436,Nie; Jiawang,0,0,8,8
1653441922363,MATH 272A,A00,087437,Tian; Xiaochuan,1,0,8,7
1653441922891,MATH 274,A01,087439,Cheng; Li-Tien,9,0,10,1
1653441922891,MATH 274,A02,087440,Cheng; Li-Tien,10,0,10,0
1653441923412,MATH 278A,A00,087441,Staff,8,0,10,2
1653441923935,MATH 278B,A00,087442,Staff,8,0,10,2
1653441924456,MATH 278C,A00,087443,Staff,8,0,10,2
1653441924979,MATH 280A,A00,087444,Zheng; Tianyi,0,0,8,8
1653441925506,MATH 281A,A00,087445,Bradic; Jelena,0,0,8,8
1653441926036,MATH 282A,A00,087446,Zhang; Danna,0,0,8,8
1653441926558,MATH 283,A00,087447,Tesler; Glenn,0,0,0,14
1653441927080,MATH 286,A00,087448,Kemp; Todd Aahron,6,0,8,2
1653441927603,MATH 287D,A00,087449,Bradic; Jelena,8,0,8,0
1653441928128,MATH 288,A00,087450,Staff,14,0,15,1
1653441928128,MATH 288,B00,087451,Staff,15,0,15,0
1653441928128,MATH 288,C00,087452,Staff,15,0,15,0
1653441928663,MATH 290A,A00,087453,Xu; Zhouli,7,0,8,1
1653441929188,MATH 291A,A00,087454,Xu; Zhouli,7,0,8,1
1653441929710,MATH 292,A00,087455,Staff,10,0,10,0
1653441930240,MATH 295,A00,087456,Staff,50,0,50,0
1653441930766,MATH 297,001,087457,Staff,998,0,999,1
1653442507192,COGS 200,A01,087991,Staff,47,0,50,3
1653442507715,COGS 201,A01,094504,Rangel; Lara M,17,0,25,8
1653442508238,COGS 203,A00,087992,Coulson; Seana M,18,0,20,2
1653442508769,COGS 210A,001,087993,Greene; Deanna Jacquelyn,9998,0,9999,1
1653442508769,COGS 210A,002,087994,Saygin; Ayse P,9999,0,9999,0
1653442508769,COGS 210A,003,087995,Xia; Haijun,9999,0,9999,0
1653442508769,COGS 210A,004,087996,Nitz; Douglas A.,9999,0,9999,0
1653442508769,COGS 210A,005,087997,Hollan; James D.,9999,0,9999,0
1653442508769,COGS 210A,006,087998,Deak; Gedeon O.,9998,0,9999,1
1653442508769,COGS 210A,007,087999,Rossano; Federico,9999,0,9999,0
1653442509294,COGS 211A,A00,088000,Coulson; Seana M,9997,0,9999,2
1653442509818,COGS 229,A00,088002,Staff,23,0,25,2
1653442510343,COGS 260,B00,094231,Staff,17,0,20,3
1653442510343,COGS 260,A00,088004,Nitz; Douglas A.,9998,0,9999,1
1653442510865,CSE 202,A00,090110,Paturi; Ramamohan,0,0,0,0
1653442510865,CSE 202,B00,090111,Paturi; Ramamohan,0,0,0,0
1653442511388,CSE 207B,A00,090112,Heninger; Nadia A,0,0,0,0
1653442511922,CSE 208,A00,094858,Micciancio; Daniele,0,0,0,0
1653442512445,CSE 210,A00,090113,Powell; Thomas Allan,0,0,0,0
1653442513042,CSE 219,A00,090898,Staff,0,0,0,0
1653442513568,CSE 221,A00,090114,Zhou; Yuan-Yuan,0,0,0,0
1653442514093,CSE 229A,A00,090115,Porter; George M,0,0,0,0
1653442514622,CSE 229C,A00,090116,Savage; Stefan,0,0,0,0
1653442515144,CSE 230,A00,090117,Jhala; Ranjit,0,0,0,0
1653442515671,CSE 232,A00,090118,Papakonstantinou; Yannis,0,0,0,0
1653442516193,CSE 239A,A00,090121,Kumar; Arun Kumar,0,0,0,0
1653442516721,CSE 239B,A00,090122,Jhala; Ranjit,0,0,0,0
1653442517244,CSE 240A,A00,090123,Zhao; Jishen,0,0,189,189
1653442517765,CSE 243A,A00,090124,Orailoglu; Alex,1,0,15,14
1653442518288,CSE 249B,A00,090125,Kahng; Andrew Byun,13,0,20,7
1653442518814,CSE 250A,A00,090126,Berg-Kirkpatrick; Taylor D,0,0,0,0
1653442519340,CSE 252A,A00,090127,Ochoa; Benjamin Lawrence,0,0,0,0
1653442519863,CSE 258,A01,090129,McAuley; Julian John,0,0,0,0
1653442520388,CSE 258R,A01,090131,McAuley; Julian John,0,0,0,0
1653442520914,CSE 274,A00,090132,Ramamoorthi; Ravi,0,0,0,0
1653442521437,CSE 276A,A00,090133,Christensen; Henrik I,0,0,0,0
1653442521959,CSE 276C,A00,090134,Christensen; Henrik I,0,0,0,0
1653442522487,CSE 290,A00,090135,Bafna; Vineet,0,0,0,0
1653442522487,CSE 290,B00,090136,Ramamoorthi; Ravi,0,0,0,0
1653442522487,CSE 290,C00,090137,Li; Tzumao,9,0,10,1
1653442522487,CSE 290,D00,090138,Zhou; Yuan-Yuan,10,0,10,0
1653442522487,CSE 290,E00,090139,Christensen; Henrik I,10,0,10,0
1653442522487,CSE 290,F00,094053,Shalev; Aaron D,0,0,0,0
1653442523016,CSE 291,A00,090140,Munyaka; Imani N. S.,0,0,0,0
1653442523016,CSE 291,B00,094880,Yu; Qi,0,0,0,0
1653442523016,CSE 291,C00,090142,Pannuto; Patrick William,0,0,0,0
1653442523016,CSE 291,D00,094881,Zhang; Yiying,0,0,0,0
1653442523016,CSE 291,E00,095118,Su; Hao,0,0,0,0
1653442523542,CSE 293,001,094905,Bafna; Vineet,9999,0,9999,0
1653442523542,CSE 293,002,094906,Bellare; Mihir,9999,0,9999,0
1653442523542,CSE 293,003,094907,Berg-Kirkpatrick; Taylor D,9999,0,9999,0
1653442523542,CSE 293,004,094908,Christensen; Henrik I,9999,0,9999,0
1653442523542,CSE 293,005,094909,Cottrell; Garrison W,9999,0,9999,0
1653442523542,CSE 293,006,094910,Deutsch; Alin Bernard,9999,0,9999,0
1653442523542,CSE 293,007,094911,Esmaeilzadeh; Hadi,9999,0,9999,0
1653442523542,CSE 293,008,094912,Freund; Yoav,9999,0,9999,0
1653442523542,CSE 293,009,094913,Griswold; William G.,9999,0,9999,0
1653442523542,CSE 293,010,094914,Gymrek; Melissa Ann,9999,0,9999,0
1653442523542,CSE 293,011,094915,Heninger; Nadia A,9999,0,9999,0
1653442523542,CSE 293,012,094916,Impagliazzo; Russell,9999,0,9999,0
1653442523542,CSE 293,013,094917,Jhala; Ranjit,9999,0,9999,0
1653442523542,CSE 293,014,094918,Kahng; Andrew Byun,9999,0,9999,0
1653442523542,CSE 293,015,094919,Kane; Daniel Mertz,9999,0,9999,0
1653442523542,CSE 293,016,094920,Kriegman; David J,9999,0,9999,0
1653442523542,CSE 293,017,094921,Kumar; Arun Kumar,9999,0,9999,0
1653442523542,CSE 293,018,094922,Lerner; Sorin,9999,0,9999,0
1653442523542,CSE 293,019,094923,Lovett; Shachar,9999,0,9999,0
1653442523542,CSE 293,020,094924,McAuley; Julian John,9999,0,9999,0
1653442523542,CSE 293,021,094925,Micciancio; Daniele,9999,0,9999,0
1653442523542,CSE 293,022,094926,Orailoglu; Alex,9999,0,9999,0
1653442523542,CSE 293,023,094927,Paturi; Ramamohan,9999,0,9999,0
1653442523542,CSE 293,024,094928,Polikarpova; Nadezhda,9999,0,9999,0
1653442523542,CSE 293,025,094929,Politz; Joseph Gibbs,9999,0,9999,0
1653442523542,CSE 293,026,094930,Porter; George M,9999,0,9999,0
1653442523542,CSE 293,027,094931,Porter; Leonard Emerson,9999,0,9999,0
1653442523542,CSE 293,028,094932,Ramamoorthi; Ravi,9999,0,9999,0
1653442523542,CSE 293,029,094933,Sahoo; Debashis,9999,0,9999,0
1653442523542,CSE 293,030,094934,Saul; Lawrence,9999,0,9999,0
1653442523542,CSE 293,031,094935,Savage; Stefan,9999,0,9999,0
1653442523542,CSE 293,032,094936,Schulze; Jurgen P.,9999,0,9999,0
1653442523542,CSE 293,033,094937,Snoeren; Alex C.,9999,0,9999,0
1653442523542,CSE 293,034,094938,Shang; Jingbo,9999,0,9999,0
1653442523542,CSE 293,035,094939,Stefan; Deian,9999,0,9999,0
1653442523542,CSE 293,036,094940,Su; Hao,9999,0,9999,0
1653442523542,CSE 293,037,094941,Swanson; Steven James,9999,0,9999,0
1653442523542,CSE 293,038,094942,Tullsen; Dean Michael,9999,0,9999,0
1653442523542,CSE 293,039,094943,Voelker; Geoffrey M.,9999,0,9999,0
1653442523542,CSE 293,040,094944,Zhao; Jishen,9999,0,9999,0
1653442523542,CSE 293,041,094945,Zhou; Yuan-Yuan,9999,0,9999,0
1653442523542,CSE 293,042,094946,Gao; Sicun,9998,0,9999,1
1653442523542,CSE 293,043,094947,Weibel; Nadir,9999,0,9999,0
1653442523542,CSE 293,044,094948,Gupta; Rajesh K.,9999,0,9999,0
1653442524072,CSE 294,A00,090143,Porter; George M,9,0,10,1
1653442524596,DSE 200,A00,091799,Staff,50,0,50,0
1653442525119,DSE 203,A00,091800,Gupta; Amarnath,30,0,30,0
1653442525645,DSE 250,A00,091801,Deutsch; Alin Bernard,30,0,30,0
1653442526169,DSE 290,A00,091802,Altintas De Callaf; Ilkay,50,0,50,0
1653442526697,ECE 200,001,091003,Antipa; Nicholas A,9999,0,9999,0
1653442526697,ECE 200,002,091004,Atanasov; Nikolay A.,9999,0,9999,0
1653442526697,ECE 200,003,091005,Bharadia; Dinesh,9999,0,9999,0
1653442526697,ECE 200,004,091006,Cheng; Chung Kuan,9999,0,9999,0
1653442526697,ECE 200,005,091007,Cosman; Pamela C.,9999,0,9999,0
1653442526697,ECE 200,006,091008,Staff,9999,0,9999,0
1653442526697,ECE 200,007,091009,Dayeh; Shadi Ahmad,9999,0,9999,0
1653442526697,ECE 200,008,091010,Fainman; Yeshaiahu,9999,0,9999,0
1653442526697,ECE 200,009,091011,Ford; Joseph Earl,9999,0,9999,0
1653442526697,ECE 200,010,091012,Franceschetti; Massimo,9999,0,9999,0
1653442526697,ECE 200,011,091013,Fullerton; Eric E,9999,0,9999,0
1653442526697,ECE 200,012,091014,Galton; Ian A,9999,0,9999,0
1653442526697,ECE 200,013,091015,Gilja; Vikash,9999,0,9999,0
1653442526697,ECE 200,014,091016,Hall; Drew A.,9999,0,9999,0
1653442526697,ECE 200,015,091017,Hsueh; Tzu-Chien,9999,0,9999,0
1653442526697,ECE 200,016,091018,Javidi; Tara,9999,0,9999,0
1653442526697,ECE 200,017,091019,Kahng; Andrew Byun,9999,0,9999,0
1653442526697,ECE 200,018,091020,Kim; Young-Han,9999,0,9999,0
1653442526697,ECE 200,019,091021,Koushanfar; Farinaz,9999,0,9999,0
1653442526697,ECE 200,020,091022,Kuzum; Duygu,9999,0,9999,0
1653442526697,ECE 200,021,091023,Le; Hanh-Phuc,9999,0,9999,0
1653442526697,ECE 200,022,091024,Lin; Bill,9999,0,9999,0
1653442526697,ECE 200,023,091025,Liu; Zhaowei,9999,0,9999,0
1653442526697,ECE 200,024,091026,Lo; Yu-Hwa,9999,0,9999,0
1653442526697,ECE 200,025,091027,Lomakin; Vitaliy,9999,0,9999,0
1653442526697,ECE 200,026,091028,Mercier; Patrick Philip,9999,0,9999,0
1653442526697,ECE 200,027,091029,Meyer; Florian,9999,0,9999,0
1653442526697,ECE 200,028,091030,Milstein; Laurence B.,9999,0,9999,0
1653442526697,ECE 200,029,091031,Mir Arabbaygi; Siavash,9999,0,9999,0
1653442526697,ECE 200,030,091032,Mookherjea; Shayan,9999,0,9999,0
1653442526697,ECE 200,031,091033,Morris; Karcher William,9999,0,9999,0
1653442526697,ECE 200,032,091034,Ng; Tse Nga,9999,0,9999,0
1653442526697,ECE 200,033,091035,Nguyen; Truong Quang,9999,0,9999,0
1653442526697,ECE 200,034,091036,Nomura; Kenji,9999,0,9999,0
1653442526697,ECE 200,035,091037,Orlitsky; Alon,9999,0,9999,0
1653442526697,ECE 200,036,091038,Pal; Piya,9999,0,9999,0
1653442526697,ECE 200,037,091039,Papen; George C.,9999,0,9999,0
1653442526697,ECE 200,038,091040,Radic; Stojan,9999,0,9999,0
1653442526697,ECE 200,039,091041,Rao; Bhaskar D.,9999,0,9999,0
1653442526697,ECE 200,040,091042,Rao; Ramesh R,9999,0,9999,0
1653442526697,ECE 200,041,091043,Rebeiz; Gabriel,9999,0,9999,0
1653442526697,ECE 200,042,091044,Sanford; John R,9999,0,9999,0
1653442526697,ECE 200,043,091045,Siegel; Paul H.,9999,0,9999,0
1653442526697,ECE 200,044,091046,Sievenpiper; Daniel F.,9999,0,9999,0
1653442526697,ECE 200,045,091047,Sworder; David D.,9999,0,9999,0
1653442526697,ECE 200,046,091048,Taur; Yuan,9999,0,9999,0
1653442526697,ECE 200,047,091049,Touri; Behrouz,9999,0,9999,0
1653442526697,ECE 200,048,091050,Trivedi; Mohan M.,9999,0,9999,0
1653442526697,ECE 200,049,091051,Vardy; Alexander,9999,0,9999,0
1653442526697,ECE 200,050,091052,Vasconcelos; Nuno,9999,0,9999,0
1653442526697,ECE 200,051,091053,Wang; Xiaolong,9999,0,9999,0
1653442526697,ECE 200,052,091054,Xie; Pengtao,9999,0,9999,0
1653442526697,ECE 200,053,091055,Yip; Michael,9999,0,9999,0
1653442526697,ECE 200,054,091056,Zeger; Kenneth A.,9999,0,9999,0
1653442526697,ECE 200,055,091057,Zhang; Xinyu,9999,0,9999,0
1653442526697,ECE 200,056,091058,Turakhia; Yatish Girish,9999,0,9999,0
1653442526697,ECE 200,057,091059,Kang; Mingu,9999,0,9999,0
1653442526697,ECE 200,058,091060,Shi; Yuanyuan,9999,0,9999,0
1653442526697,ECE 200,059,091061,Wang; Edward Jay,9999,0,9999,0
1653442526697,ECE 200,060,091062,Zheng; Yang,9999,0,9999,0
1653442527222,ECE 203,A00,091065,Mercier; Patrick Philip,0,0,0,0
1653442527744,ECE 207A,A00,091605,Liu; Thomas Tao-Ming,0,0,0,0
1653442528270,ECE 212AN,A00,091068,Nomura; Kenji,0,0,0,0
1653442528796,ECE 222A,A00,091069,Rebeiz; Gabriel,0,0,0,0
1653442529329,ECE 225A,A00,091070,Orlitsky; Alon,0,0,0,0
1653442529852,ECE 230A,A00,091071,Nomura; Kenji,0,0,0,0
1653442530382,ECE 236A,A00,091072,Dayeh; Shadi Ahmad,0,0,0,0
1653442530905,ECE 238A,A00,091073,Luo; Jian,0,0,0,0
1653442530905,ECE 238A,B00,091074,Luo; Jian,0,0,0,0
1653442531431,ECE 240A,A00,091075,Radic; Stojan,0,0,0,0
1653442531955,ECE 247A,A00,091592,Shi; Lingyan,0,0,0,0
1653442532479,ECE 250,A00,091076,Touri; Behrouz,0,0,0,0
1653442533007,ECE 251C,A00,091078,Nguyen; Truong Quang,0,0,0,0
1653442533544,ECE 253,A00,091079,Cosman; Pamela C.,0,0,0,0
1653442534069,ECE 255A,A00,091080,Orlitsky; Alon,0,0,0,0
1653442534592,ECE 257A,A00,091081,Zhang; Xinyu,0,0,0,0
1653442535118,ECE 260A,A01,091084,Eldon; John,0,0,0,0
1653442535645,ECE 264C,A00,091085,Galton; Ian A,0,0,0,0
1653442536178,ECE 265C,A00,094889,Presti; Calogero Davide,0,0,0,9
1653442536703,ECE 266,A01,091087,Hall; Drew A.,0,0,0,0
1653442537752,ECE 271A,A00,091090,Vasconcelos; Nuno,0,0,0,0
1653442538278,ECE 272B,A00,091091,Sworder; David D.,0,0,0,0
1653442538799,ECE 275A,A00,091092,Meyer; Florian,0,0,0,0
1653442539329,ECE 277,A00,091093,An; Cheolhong,0,0,0,0
1653442539851,ECE 283,A00,091094,Le; Hanh-Phuc,0,0,0,0
1653442540382,ECE 284,A00,091095,Kang; Mingu,0,0,0,0
1653442540382,ECE 284,B00,091096,Wang; Edward Jay,0,0,0,0
1653442540904,ECE 285,A00,094334,Touri; Behrouz,0,0,0,0
1653442541428,ECE 289,A00,091097,Whelan; David Arthur,0,0,0,0
1653442541955,MATH 200A,A00,087414,Salehi Golsefidy; Alireza,7,0,8,1
1653442542487,MATH 202A,A00,087415,Gill; Philip E.,3,0,8,5
1653442543009,MATH 203A,A00,087416,Oprea; Dragos N.,6,0,8,2
1653442543545,MATH 204A,A00,087417,Kedlaya; Kiran S.,6,0,8,2
1653442544069,MATH 205,A00,087418,Sorensen; Claus M,6,0,8,2
1653442544591,MATH 206A,A00,087419,Izadi; Elham,7,0,8,1
1653442545117,MATH 207A,A00,087420,Mohammadi; Amir,6,0,8,2
1653442545643,MATH 208,A00,087421,Staff,9,0,10,1
1653442546165,MATH 209,A00,087422,Staff,10,0,10,0
1653442546689,MATH 218,A00,087423,Staff,10,0,10,0
1653442547211,MATH 220A,A00,087424,Novak; Jonathan I,7,0,8,1
1653442547733,MATH 231A,A00,087425,Bejenaru; Ioan,4,0,8,4
1653442548261,MATH 240A,A00,087426,Ebenfelt; Peter F,5,0,8,3
1653442548782,MATH 243,A00,087427,Staff,9,0,10,1
1653442549304,MATH 248,A00,087429,Staff,10,0,10,0
1653442549830,MATH 250A,A00,087430,Spolaor; Luca,4,0,8,4
1653442550357,MATH 257A,A00,087431,Spolaor; Luca,7,0,8,1
1653442550881,MATH 258,A00,087432,Staff,9,0,10,1
1653442551406,MATH 264A,A00,087433,Warnke; Lutz Peter,5,0,8,3
1653442551928,MATH 268,A00,087434,Staff,15,0,15,0
1653442552455,MATH 269,A00,087435,Staff,14,0,15,1
1653442552977,MATH 270A,A00,087436,Nie; Jiawang,0,0,8,8
1653442553499,MATH 272A,A00,087437,Tian; Xiaochuan,1,0,8,7
1653442554034,MATH 274,A01,087439,Cheng; Li-Tien,9,0,10,1
1653442554034,MATH 274,A02,087440,Cheng; Li-Tien,10,0,10,0
1653442554563,MATH 278A,A00,087441,Staff,8,0,10,2
1653442555085,MATH 278B,A00,087442,Staff,8,0,10,2
1653442555608,MATH 278C,A00,087443,Staff,8,0,10,2
1653442556131,MATH 280A,A00,087444,Zheng; Tianyi,0,0,8,8
1653442556652,MATH 281A,A00,087445,Bradic; Jelena,0,0,8,8
1653442557184,MATH 282A,A00,087446,Zhang; Danna,0,0,8,8
1653442557707,MATH 283,A00,087447,Tesler; Glenn,0,0,0,14
1653442558230,MATH 286,A00,087448,Kemp; Todd Aahron,6,0,8,2
1653442558753,MATH 287D,A00,087449,Bradic; Jelena,8,0,8,0
1653442559277,MATH 288,A00,087450,Staff,14,0,15,1
1653442559277,MATH 288,B00,087451,Staff,15,0,15,0
1653442559277,MATH 288,C00,087452,Staff,15,0,15,0
1653442559803,MATH 290A,A00,087453,Xu; Zhouli,7,0,8,1
1653442560333,MATH 291A,A00,087454,Xu; Zhouli,7,0,8,1
1653442560855,MATH 292,A00,087455,Staff,10,0,10,0
1653442561384,MATH 295,A00,087456,Staff,50,0,50,0
1653442561913,MATH 297,001,087457,Staff,998,0,999,1
1653443124461,COGS 200,A01,087991,Staff,47,0,50,3
1653443125001,COGS 201,A01,094504,Rangel; Lara M,17,0,25,8
1653443125526,COGS 203,A00,087992,Coulson; Seana M,18,0,20,2
1653443126050,COGS 210A,001,087993,Greene; Deanna Jacquelyn,9998,0,9999,1
1653443126050,COGS 210A,002,087994,Saygin; Ayse P,9999,0,9999,0
1653443126050,COGS 210A,003,087995,Xia; Haijun,9999,0,9999,0
1653443126050,COGS 210A,004,087996,Nitz; Douglas A.,9999,0,9999,0
1653443126050,COGS 210A,005,087997,Hollan; James D.,9999,0,9999,0
1653443126050,COGS 210A,006,087998,Deak; Gedeon O.,9998,0,9999,1
1653443126050,COGS 210A,007,087999,Rossano; Federico,9999,0,9999,0
1653443126584,COGS 211A,A00,088000,Coulson; Seana M,9997,0,9999,2
1653443127106,COGS 229,A00,088002,Staff,23,0,25,2
1653443127634,COGS 260,B00,094231,Staff,17,0,20,3
1653443127634,COGS 260,A00,088004,Nitz; Douglas A.,9998,0,9999,1
1653443128164,CSE 202,A00,090110,Paturi; Ramamohan,0,0,0,0
1653443128164,CSE 202,B00,090111,Paturi; Ramamohan,0,0,0,0
1653443128689,CSE 207B,A00,090112,Heninger; Nadia A,0,0,0,0
1653443129213,CSE 208,A00,094858,Micciancio; Daniele,0,0,0,0
1653443129734,CSE 210,A00,090113,Powell; Thomas Allan,0,0,0,0
1653443130257,CSE 219,A00,090898,Staff,0,0,0,0
1653443130782,CSE 221,A00,090114,Zhou; Yuan-Yuan,0,0,0,0
1653443131304,CSE 229A,A00,090115,Porter; George M,0,0,0,0
1653443131832,CSE 229C,A00,090116,Savage; Stefan,0,0,0,0
1653443132377,CSE 230,A00,090117,Jhala; Ranjit,0,0,0,0
1653443132902,CSE 232,A00,090118,Papakonstantinou; Yannis,0,0,0,0
1653443133426,CSE 239A,A00,090121,Kumar; Arun Kumar,0,0,0,0
1653443133950,CSE 239B,A00,090122,Jhala; Ranjit,0,0,0,0
1653443134472,CSE 240A,A00,090123,Zhao; Jishen,0,0,189,189
1653443134998,CSE 243A,A00,090124,Orailoglu; Alex,1,0,15,14
1653443135519,CSE 249B,A00,090125,Kahng; Andrew Byun,13,0,20,7
1653443136045,CSE 250A,A00,090126,Berg-Kirkpatrick; Taylor D,0,0,0,0
1653443136573,CSE 252A,A00,090127,Ochoa; Benjamin Lawrence,0,0,0,0
1653443137100,CSE 258,A01,090129,McAuley; Julian John,0,0,0,0
1653443137627,CSE 258R,A01,090131,McAuley; Julian John,0,0,0,0
1653443138150,CSE 274,A00,090132,Ramamoorthi; Ravi,0,0,0,0
1653443138696,CSE 276A,A00,090133,Christensen; Henrik I,0,0,0,0
1653443139219,CSE 276C,A00,090134,Christensen; Henrik I,0,0,0,0
1653443139743,CSE 290,A00,090135,Bafna; Vineet,0,0,0,0
1653443139743,CSE 290,B00,090136,Ramamoorthi; Ravi,0,0,0,0
1653443139743,CSE 290,C00,090137,Li; Tzumao,9,0,10,1
1653443139743,CSE 290,D00,090138,Zhou; Yuan-Yuan,10,0,10,0
1653443139743,CSE 290,E00,090139,Christensen; Henrik I,10,0,10,0
1653443139743,CSE 290,F00,094053,Shalev; Aaron D,0,0,0,0
1653443140280,CSE 291,A00,090140,Munyaka; Imani N. S.,0,0,0,0
1653443140280,CSE 291,B00,094880,Yu; Qi,0,0,0,0
1653443140280,CSE 291,C00,090142,Pannuto; Patrick William,0,0,0,0
1653443140280,CSE 291,D00,094881,Zhang; Yiying,0,0,0,0
1653443140280,CSE 291,E00,095118,Su; Hao,0,0,0,0
1653443140818,CSE 293,001,094905,Bafna; Vineet,9999,0,9999,0
1653443140818,CSE 293,002,094906,Bellare; Mihir,9999,0,9999,0
1653443140818,CSE 293,003,094907,Berg-Kirkpatrick; Taylor D,9999,0,9999,0
1653443140818,CSE 293,004,094908,Christensen; Henrik I,9999,0,9999,0
1653443140818,CSE 293,005,094909,Cottrell; Garrison W,9999,0,9999,0
1653443140818,CSE 293,006,094910,Deutsch; Alin Bernard,9999,0,9999,0
1653443140818,CSE 293,007,094911,Esmaeilzadeh; Hadi,9999,0,9999,0
1653443140818,CSE 293,008,094912,Freund; Yoav,9999,0,9999,0
1653443140818,CSE 293,009,094913,Griswold; William G.,9999,0,9999,0
1653443140818,CSE 293,010,094914,Gymrek; Melissa Ann,9999,0,9999,0
1653443140818,CSE 293,011,094915,Heninger; Nadia A,9999,0,9999,0
1653443140818,CSE 293,012,094916,Impagliazzo; Russell,9999,0,9999,0
1653443140818,CSE 293,013,094917,Jhala; Ranjit,9999,0,9999,0
1653443140818,CSE 293,014,094918,Kahng; Andrew Byun,9999,0,9999,0
1653443140818,CSE 293,015,094919,Kane; Daniel Mertz,9999,0,9999,0
1653443140818,CSE 293,016,094920,Kriegman; David J,9999,0,9999,0
1653443140818,CSE 293,017,094921,Kumar; Arun Kumar,9999,0,9999,0
1653443140818,CSE 293,018,094922,Lerner; Sorin,9999,0,9999,0
1653443140818,CSE 293,019,094923,Lovett; Shachar,9999,0,9999,0
1653443140818,CSE 293,020,094924,McAuley; Julian John,9999,0,9999,0
1653443140818,CSE 293,021,094925,Micciancio; Daniele,9999,0,9999,0
1653443140818,CSE 293,022,094926,Orailoglu; Alex,9999,0,9999,0
1653443140818,CSE 293,023,094927,Paturi; Ramamohan,9999,0,9999,0
1653443140818,CSE 293,024,094928,Polikarpova; Nadezhda,9999,0,9999,0
1653443140818,CSE 293,025,094929,Politz; Joseph Gibbs,9999,0,9999,0
1653443140818,CSE 293,026,094930,Porter; George M,9999,0,9999,0
1653443140818,CSE 293,027,094931,Porter; Leonard Emerson,9999,0,9999,0
1653443140818,CSE 293,028,094932,Ramamoorthi; Ravi,9999,0,9999,0
1653443140818,CSE 293,029,094933,Sahoo; Debashis,9999,0,9999,0
1653443140818,CSE 293,030,094934,Saul; Lawrence,9999,0,9999,0
1653443140818,CSE 293,031,094935,Savage; Stefan,9999,0,9999,0
1653443140818,CSE 293,032,094936,Schulze; Jurgen P.,9999,0,9999,0
1653443140818,CSE 293,033,094937,Snoeren; Alex C.,9999,0,9999,0
1653443140818,CSE 293,034,094938,Shang; Jingbo,9999,0,9999,0
1653443140818,CSE 293,035,094939,Stefan; Deian,9999,0,9999,0
1653443140818,CSE 293,036,094940,Su; Hao,9999,0,9999,0
1653443140818,CSE 293,037,094941,Swanson; Steven James,9999,0,9999,0
1653443140818,CSE 293,038,094942,Tullsen; Dean Michael,9999,0,9999,0
1653443140818,CSE 293,039,094943,Voelker; Geoffrey M.,9999,0,9999,0
1653443140818,CSE 293,040,094944,Zhao; Jishen,9999,0,9999,0
1653443140818,CSE 293,041,094945,Zhou; Yuan-Yuan,9999,0,9999,0
1653443140818,CSE 293,042,094946,Gao; Sicun,9998,0,9999,1
1653443140818,CSE 293,043,094947,Weibel; Nadir,9999,0,9999,0
1653443140818,CSE 293,044,094948,Gupta; Rajesh K.,9999,0,9999,0
1653443141342,CSE 294,A00,090143,Porter; George M,9,0,10,1
1653443141865,DSE 200,A00,091799,Staff,50,0,50,0
1653443142387,DSE 203,A00,091800,Gupta; Amarnath,30,0,30,0
1653443142909,DSE 250,A00,091801,Deutsch; Alin Bernard,30,0,30,0
1653443143436,DSE 290,A00,091802,Altintas De Callaf; Ilkay,50,0,50,0
1653443143975,ECE 200,001,091003,Antipa; Nicholas A,9999,0,9999,0
1653443143975,ECE 200,002,091004,Atanasov; Nikolay A.,9999,0,9999,0
1653443143975,ECE 200,003,091005,Bharadia; Dinesh,9999,0,9999,0
1653443143975,ECE 200,004,091006,Cheng; Chung Kuan,9999,0,9999,0
1653443143975,ECE 200,005,091007,Cosman; Pamela C.,9999,0,9999,0
1653443143975,ECE 200,006,091008,Staff,9999,0,9999,0
1653443143975,ECE 200,007,091009,Dayeh; Shadi Ahmad,9999,0,9999,0
1653443143975,ECE 200,008,091010,Fainman; Yeshaiahu,9999,0,9999,0
1653443143975,ECE 200,009,091011,Ford; Joseph Earl,9999,0,9999,0
1653443143975,ECE 200,010,091012,Franceschetti; Massimo,9999,0,9999,0
1653443143975,ECE 200,011,091013,Fullerton; Eric E,9999,0,9999,0
1653443143975,ECE 200,012,091014,Galton; Ian A,9999,0,9999,0
1653443143975,ECE 200,013,091015,Gilja; Vikash,9999,0,9999,0
1653443143975,ECE 200,014,091016,Hall; Drew A.,9999,0,9999,0
1653443143975,ECE 200,015,091017,Hsueh; Tzu-Chien,9999,0,9999,0
1653443143975,ECE 200,016,091018,Javidi; Tara,9999,0,9999,0
1653443143975,ECE 200,017,091019,Kahng; Andrew Byun,9999,0,9999,0
1653443143975,ECE 200,018,091020,Kim; Young-Han,9999,0,9999,0
1653443143975,ECE 200,019,091021,Koushanfar; Farinaz,9999,0,9999,0
1653443143975,ECE 200,020,091022,Kuzum; Duygu,9999,0,9999,0
1653443143975,ECE 200,021,091023,Le; Hanh-Phuc,9999,0,9999,0
1653443143975,ECE 200,022,091024,Lin; Bill,9999,0,9999,0
1653443143975,ECE 200,023,091025,Liu; Zhaowei,9999,0,9999,0
1653443143975,ECE 200,024,091026,Lo; Yu-Hwa,9999,0,9999,0
1653443143975,ECE 200,025,091027,Lomakin; Vitaliy,9999,0,9999,0
1653443143975,ECE 200,026,091028,Mercier; Patrick Philip,9999,0,9999,0
1653443143975,ECE 200,027,091029,Meyer; Florian,9999,0,9999,0
1653443143975,ECE 200,028,091030,Milstein; Laurence B.,9999,0,9999,0
1653443143975,ECE 200,029,091031,Mir Arabbaygi; Siavash,9999,0,9999,0
1653443143975,ECE 200,030,091032,Mookherjea; Shayan,9999,0,9999,0
1653443143975,ECE 200,031,091033,Morris; Karcher William,9999,0,9999,0
1653443143975,ECE 200,032,091034,Ng; Tse Nga,9999,0,9999,0
1653443143975,ECE 200,033,091035,Nguyen; Truong Quang,9999,0,9999,0
1653443143975,ECE 200,034,091036,Nomura; Kenji,9999,0,9999,0
1653443143975,ECE 200,035,091037,Orlitsky; Alon,9999,0,9999,0
1653443143975,ECE 200,036,091038,Pal; Piya,9999,0,9999,0
1653443143975,ECE 200,037,091039,Papen; George C.,9999,0,9999,0
1653443143975,ECE 200,038,091040,Radic; Stojan,9999,0,9999,0
1653443143975,ECE 200,039,091041,Rao; Bhaskar D.,9999,0,9999,0
1653443143975,ECE 200,040,091042,Rao; Ramesh R,9999,0,9999,0
1653443143975,ECE 200,041,091043,Rebeiz; Gabriel,9999,0,9999,0
1653443143975,ECE 200,042,091044,Sanford; John R,9999,0,9999,0
1653443143975,ECE 200,043,091045,Siegel; Paul H.,9999,0,9999,0
1653443143975,ECE 200,044,091046,Sievenpiper; Daniel F.,9999,0,9999,0
1653443143975,ECE 200,045,091047,Sworder; David D.,9999,0,9999,0
1653443143975,ECE 200,046,091048,Taur; Yuan,9999,0,9999,0
1653443143975,ECE 200,047,091049,Touri; Behrouz,9999,0,9999,0
1653443143975,ECE 200,048,091050,Trivedi; Mohan M.,9999,0,9999,0
1653443143975,ECE 200,049,091051,Vardy; Alexander,9999,0,9999,0
1653443143975,ECE 200,050,091052,Vasconcelos; Nuno,9999,0,9999,0
1653443143975,ECE 200,051,091053,Wang; Xiaolong,9999,0,9999,0
1653443143975,ECE 200,052,091054,Xie; Pengtao,9999,0,9999,0
1653443143975,ECE 200,053,091055,Yip; Michael,9999,0,9999,0
1653443143975,ECE 200,054,091056,Zeger; Kenneth A.,9999,0,9999,0
1653443143975,ECE 200,055,091057,Zhang; Xinyu,9999,0,9999,0
1653443143975,ECE 200,056,091058,Turakhia; Yatish Girish,9999,0,9999,0
1653443143975,ECE 200,057,091059,Kang; Mingu,9999,0,9999,0
1653443143975,ECE 200,058,091060,Shi; Yuanyuan,9999,0,9999,0
1653443143975,ECE 200,059,091061,Wang; Edward Jay,9999,0,9999,0
1653443143975,ECE 200,060,091062,Zheng; Yang,9999,0,9999,0
1653443144507,ECE 203,A00,091065,Mercier; Patrick Philip,0,0,0,0
1653443145035,ECE 207A,A00,091605,Liu; Thomas Tao-Ming,0,0,0,0
1653443145561,ECE 212AN,A00,091068,Nomura; Kenji,0,0,0,0
1653443146087,ECE 222A,A00,091069,Rebeiz; Gabriel,0,0,0,0
1653443146618,ECE 225A,A00,091070,Orlitsky; Alon,0,0,0,0
1653443147141,ECE 230A,A00,091071,Nomura; Kenji,0,0,0,0
1653443147679,ECE 236A,A00,091072,Dayeh; Shadi Ahmad,0,0,0,0
1653443148202,ECE 238A,A00,091073,Luo; Jian,0,0,0,0
1653443148202,ECE 238A,B00,091074,Luo; Jian,0,0,0,0
1653443148729,ECE 240A,A00,091075,Radic; Stojan,0,0,0,0
1653443149254,ECE 247A,A00,091592,Shi; Lingyan,0,0,0,0
1653443149777,ECE 250,A00,091076,Touri; Behrouz,0,0,0,0
1653443150302,ECE 251C,A00,091078,Nguyen; Truong Quang,0,0,0,0
1653443150836,ECE 253,A00,091079,Cosman; Pamela C.,0,0,0,0
1653443151359,ECE 255A,A00,091080,Orlitsky; Alon,0,0,0,0
1653443151881,ECE 257A,A00,091081,Zhang; Xinyu,0,0,0,0
1653443152416,ECE 260A,A01,091084,Eldon; John,0,0,0,0
1653443152940,ECE 264C,A00,091085,Galton; Ian A,0,0,0,0
1653443153462,ECE 265C,A00,094889,Presti; Calogero Davide,0,0,0,9
1653443153987,ECE 266,A01,091087,Hall; Drew A.,0,0,0,0
1653443155043,ECE 271A,A00,091090,Vasconcelos; Nuno,0,0,0,0
1653443155579,ECE 272B,A00,091091,Sworder; David D.,0,0,0,0
1653443156193,ECE 275A,A00,091092,Meyer; Florian,0,0,0,0
1653443156718,ECE 277,A00,091093,An; Cheolhong,0,0,0,0
1653443157240,ECE 283,A00,091094,Le; Hanh-Phuc,0,0,0,0
1653443157762,ECE 284,A00,091095,Kang; Mingu,0,0,0,0
1653443157762,ECE 284,B00,091096,Wang; Edward Jay,0,0,0,0
1653443158288,ECE 285,A00,094334,Touri; Behrouz,0,0,0,0
1653443158811,ECE 289,A00,091097,Whelan; David Arthur,0,0,0,0
1653443159333,MATH 200A,A00,087414,Salehi Golsefidy; Alireza,7,0,8,1
1653443159870,MATH 202A,A00,087415,Gill; Philip E.,3,0,8,5
1653443160392,MATH 203A,A00,087416,Oprea; Dragos N.,6,0,8,2
1653443160915,MATH 204A,A00,087417,Kedlaya; Kiran S.,6,0,8,2
1653443161439,MATH 205,A00,087418,Sorensen; Claus M,6,0,8,2
1653443161975,MATH 206A,A00,087419,Izadi; Elham,7,0,8,1
1653443162501,MATH 207A,A00,087420,Mohammadi; Amir,6,0,8,2
1653443163026,MATH 208,A00,087421,Staff,9,0,10,1
1653443163552,MATH 209,A00,087422,Staff,10,0,10,0
1653443164075,MATH 218,A00,087423,Staff,10,0,10,0
1653443164602,MATH 220A,A00,087424,Novak; Jonathan I,7,0,8,1
1653443165138,MATH 231A,A00,087425,Bejenaru; Ioan,4,0,8,4
1653443165663,MATH 240A,A00,087426,Ebenfelt; Peter F,5,0,8,3
1653443166185,MATH 243,A00,087427,Staff,9,0,10,1
1653443166710,MATH 248,A00,087429,Staff,10,0,10,0
1653443167246,MATH 250A,A00,087430,Spolaor; Luca,4,0,8,4
1653443167769,MATH 257A,A00,087431,Spolaor; Luca,7,0,8,1
1653443168294,MATH 258,A00,087432,Staff,9,0,10,1
1653443168820,MATH 264A,A00,087433,Warnke; Lutz Peter,5,0,8,3
1653443169342,MATH 268,A00,087434,Staff,15,0,15,0
1653443169864,MATH 269,A00,087435,Staff,14,0,15,1
1653443170403,MATH 270A,A00,087436,Nie; Jiawang,0,0,8,8
1653443170931,MATH 272A,A00,087437,Tian; Xiaochuan,1,0,8,7
1653443171455,MATH 274,A01,087439,Cheng; Li-Tien,9,0,10,1
1653443171455,MATH 274,A02,087440,Cheng; Li-Tien,10,0,10,0
1653443171980,MATH 278A,A00,087441,Staff,8,0,10,2
1653443172504,MATH 278B,A00,087442,Staff,8,0,10,2
1653443173029,MATH 278C,A00,087443,Staff,8,0,10,2
1653443173552,MATH 280A,A00,087444,Zheng; Tianyi,0,0,8,8
1653443174076,MATH 281A,A00,087445,Bradic; Jelena,0,0,8,8
1653443174599,MATH 282A,A00,087446,Zhang; Danna,0,0,8,8
1653443175120,MATH 283,A00,087447,Tesler; Glenn,0,0,0,14
1653443175644,MATH 286,A00,087448,Kemp; Todd Aahron,6,0,8,2
1653443176172,MATH 287D,A00,087449,Bradic; Jelena,8,0,8,0
1653443176695,MATH 288,A00,087450,Staff,14,0,15,1
1653443176695,MATH 288,B00,087451,Staff,15,0,15,0
1653443176695,MATH 288,C00,087452,Staff,15,0,15,0
1653443177221,MATH 290A,A00,087453,Xu; Zhouli,7,0,8,1
1653443177747,MATH 291A,A00,087454,Xu; Zhouli,7,0,8,1
1653443178270,MATH 292,A00,087455,Staff,10,0,10,0
1653443178792,MATH 295,A00,087456,Staff,50,0,50,0
1653443179319,MATH 297,001,087457,Staff,998,0,999,1
1653443742088,COGS 200,A01,087991,Staff,47,0,50,3
1653443742614,COGS 201,A01,094504,Rangel; Lara M,17,0,25,8
1653443743146,COGS 203,A00,087992,Coulson; Seana M,18,0,20,2
1653443743669,COGS 210A,001,087993,Greene; Deanna Jacquelyn,9998,0,9999,1
1653443743669,COGS 210A,002,087994,Saygin; Ayse P,9999,0,9999,0
1653443743669,COGS 210A,003,087995,Xia; Haijun,9999,0,9999,0
1653443743669,COGS 210A,004,087996,Nitz; Douglas A.,9999,0,9999,0
1653443743669,COGS 210A,005,087997,Hollan; James D.,9999,0,9999,0
1653443743669,COGS 210A,006,087998,Deak; Gedeon O.,9998,0,9999,1
1653443743669,COGS 210A,007,087999,Rossano; Federico,9999,0,9999,0
1653443744198,COGS 211A,A00,088000,Coulson; Seana M,9997,0,9999,2
1653443744735,COGS 229,A00,088002,Staff,23,0,25,2
1653443745261,COGS 260,B00,094231,Staff,17,0,20,3
1653443745261,COGS 260,A00,088004,Nitz; Douglas A.,9998,0,9999,1
1653443745795,CSE 202,A00,090110,Paturi; Ramamohan,0,0,0,0
1653443745795,CSE 202,B00,090111,Paturi; Ramamohan,0,0,0,0
1653443746397,CSE 207B,A00,090112,Heninger; Nadia A,0,0,0,0
1653443746919,CSE 208,A00,094858,Micciancio; Daniele,0,0,0,0
1653443747442,CSE 210,A00,090113,Powell; Thomas Allan,0,0,0,0
1653443747965,CSE 219,A00,090898,Staff,0,0,0,0
1653443748496,CSE 221,A00,090114,Zhou; Yuan-Yuan,0,0,0,0
1653443749018,CSE 229A,A00,090115,Porter; George M,0,0,0,0
1653443749544,CSE 229C,A00,090116,Savage; Stefan,0,0,0,0
1653443750070,CSE 230,A00,090117,Jhala; Ranjit,0,0,0,0
1653443750593,CSE 232,A00,090118,Papakonstantinou; Yannis,0,0,0,0
1653443751116,CSE 239A,A00,090121,Kumar; Arun Kumar,0,0,0,0
1653443751650,CSE 239B,A00,090122,Jhala; Ranjit,0,0,0,0
1653443752173,CSE 240A,A00,090123,Zhao; Jishen,0,0,189,189
1653443752704,CSE 243A,A00,090124,Orailoglu; Alex,1,0,15,14
1653443753228,CSE 249B,A00,090125,Kahng; Andrew Byun,13,0,20,7
1653443753754,CSE 250A,A00,090126,Berg-Kirkpatrick; Taylor D,0,0,0,0
1653443754281,CSE 252A,A00,090127,Ochoa; Benjamin Lawrence,0,0,0,0
1653443754807,CSE 258,A01,090129,McAuley; Julian John,0,0,0,0
1653443755338,CSE 258R,A01,090131,McAuley; Julian John,0,0,0,0
1653443755865,CSE 274,A00,090132,Ramamoorthi; Ravi,0,0,0,0
1653443756394,CSE 276A,A00,090133,Christensen; Henrik I,0,0,0,0
1653443756917,CSE 276C,A00,090134,Christensen; Henrik I,0,0,0,0
1653443757439,CSE 290,A00,090135,Bafna; Vineet,0,0,0,0
1653443757439,CSE 290,B00,090136,Ramamoorthi; Ravi,0,0,0,0
1653443757439,CSE 290,C00,090137,Li; Tzumao,9,0,10,1
1653443757439,CSE 290,D00,090138,Zhou; Yuan-Yuan,10,0,10,0
1653443757439,CSE 290,E00,090139,Christensen; Henrik I,10,0,10,0
1653443757439,CSE 290,F00,094053,Shalev; Aaron D,0,0,0,0
1653443757967,CSE 291,A00,090140,Munyaka; Imani N. S.,0,0,0,0
1653443757967,CSE 291,B00,094880,Yu; Qi,0,0,0,0
1653443757967,CSE 291,C00,090142,Pannuto; Patrick William,0,0,0,0
1653443757967,CSE 291,D00,094881,Zhang; Yiying,0,0,0,0
1653443757967,CSE 291,E00,095118,Su; Hao,0,0,0,0
1653443758498,CSE 293,001,094905,Bafna; Vineet,9999,0,9999,0
1653443758498,CSE 293,002,094906,Bellare; Mihir,9999,0,9999,0
1653443758498,CSE 293,003,094907,Berg-Kirkpatrick; Taylor D,9999,0,9999,0
1653443758498,CSE 293,004,094908,Christensen; Henrik I,9999,0,9999,0
1653443758498,CSE 293,005,094909,Cottrell; Garrison W,9999,0,9999,0
1653443758498,CSE 293,006,094910,Deutsch; Alin Bernard,9999,0,9999,0
1653443758498,CSE 293,007,094911,Esmaeilzadeh; Hadi,9999,0,9999,0
1653443758498,CSE 293,008,094912,Freund; Yoav,9999,0,9999,0
1653443758498,CSE 293,009,094913,Griswold; William G.,9999,0,9999,0
1653443758498,CSE 293,010,094914,Gymrek; Melissa Ann,9999,0,9999,0
1653443758498,CSE 293,011,094915,Heninger; Nadia A,9999,0,9999,0
1653443758498,CSE 293,012,094916,Impagliazzo; Russell,9999,0,9999,0
1653443758498,CSE 293,013,094917,Jhala; Ranjit,9999,0,9999,0
1653443758498,CSE 293,014,094918,Kahng; Andrew Byun,9999,0,9999,0
1653443758498,CSE 293,015,094919,Kane; Daniel Mertz,9999,0,9999,0
1653443758498,CSE 293,016,094920,Kriegman; David J,9999,0,9999,0
1653443758498,CSE 293,017,094921,Kumar; Arun Kumar,9999,0,9999,0
1653443758498,CSE 293,018,094922,Lerner; Sorin,9999,0,9999,0
1653443758498,CSE 293,019,094923,Lovett; Shachar,9999,0,9999,0
1653443758498,CSE 293,020,094924,McAuley; Julian John,9999,0,9999,0
1653443758498,CSE 293,021,094925,Micciancio; Daniele,9999,0,9999,0
1653443758498,CSE 293,022,094926,Orailoglu; Alex,9999,0,9999,0
1653443758498,CSE 293,023,094927,Paturi; Ramamohan,9999,0,9999,0
1653443758498,CSE 293,024,094928,Polikarpova; Nadezhda,9999,0,9999,0
1653443758498,CSE 293,025,094929,Politz; Joseph Gibbs,9999,0,9999,0
1653443758498,CSE 293,026,094930,Porter; George M,9999,0,9999,0
1653443758498,CSE 293,027,094931,Porter; Leonard Emerson,9999,0,9999,0
1653443758498,CSE 293,028,094932,Ramamoorthi; Ravi,9999,0,9999,0
1653443758498,CSE 293,029,094933,Sahoo; Debashis,9999,0,9999,0
1653443758498,CSE 293,030,094934,Saul; Lawrence,9999,0,9999,0
1653443758498,CSE 293,031,094935,Savage; Stefan,9999,0,9999,0
1653443758498,CSE 293,032,094936,Schulze; Jurgen P.,9999,0,9999,0
1653443758498,CSE 293,033,094937,Snoeren; Alex C.,9999,0,9999,0
1653443758498,CSE 293,034,094938,Shang; Jingbo,9999,0,9999,0
1653443758498,CSE 293,035,094939,Stefan; Deian,9999,0,9999,0
1653443758498,CSE 293,036,094940,Su; Hao,9999,0,9999,0
1653443758498,CSE 293,037,094941,Swanson; Steven James,9999,0,9999,0
1653443758498,CSE 293,038,094942,Tullsen; Dean Michael,9999,0,9999,0
1653443758498,CSE 293,039,094943,Voelker; Geoffrey M.,9999,0,9999,0
1653443758498,CSE 293,040,094944,Zhao; Jishen,9999,0,9999,0
1653443758498,CSE 293,041,094945,Zhou; Yuan-Yuan,9999,0,9999,0
1653443758498,CSE 293,042,094946,Gao; Sicun,9998,0,9999,1
1653443758498,CSE 293,043,094947,Weibel; Nadir,9999,0,9999,0
1653443758498,CSE 293,044,094948,Gupta; Rajesh K.,9999,0,9999,0
1653443759029,CSE 294,A00,090143,Porter; George M,9,0,10,1
1653443759554,DSE 200,A00,091799,Staff,50,0,50,0
1653443760082,DSE 203,A00,091800,Gupta; Amarnath,30,0,30,0
1653443760610,DSE 250,A00,091801,Deutsch; Alin Bernard,30,0,30,0
1653443761133,DSE 290,A00,091802,Altintas De Callaf; Ilkay,50,0,50,0
1653443761677,ECE 200,001,091003,Antipa; Nicholas A,9999,0,9999,0
1653443761677,ECE 200,002,091004,Atanasov; Nikolay A.,9999,0,9999,0
1653443761677,ECE 200,003,091005,Bharadia; Dinesh,9999,0,9999,0
1653443761677,ECE 200,004,091006,Cheng; Chung Kuan,9999,0,9999,0
1653443761677,ECE 200,005,091007,Cosman; Pamela C.,9999,0,9999,0
1653443761677,ECE 200,006,091008,Staff,9999,0,9999,0
1653443761677,ECE 200,007,091009,Dayeh; Shadi Ahmad,9999,0,9999,0
1653443761677,ECE 200,008,091010,Fainman; Yeshaiahu,9999,0,9999,0
1653443761677,ECE 200,009,091011,Ford; Joseph Earl,9999,0,9999,0
1653443761677,ECE 200,010,091012,Franceschetti; Massimo,9999,0,9999,0
1653443761677,ECE 200,011,091013,Fullerton; Eric E,9999,0,9999,0
1653443761677,ECE 200,012,091014,Galton; Ian A,9999,0,9999,0
1653443761677,ECE 200,013,091015,Gilja; Vikash,9999,0,9999,0
1653443761677,ECE 200,014,091016,Hall; Drew A.,9999,0,9999,0
1653443761677,ECE 200,015,091017,Hsueh; Tzu-Chien,9999,0,9999,0
1653443761677,ECE 200,016,091018,Javidi; Tara,9999,0,9999,0
1653443761677,ECE 200,017,091019,Kahng; Andrew Byun,9999,0,9999,0
1653443761677,ECE 200,018,091020,Kim; Young-Han,9999,0,9999,0
1653443761677,ECE 200,019,091021,Koushanfar; Farinaz,9999,0,9999,0
1653443761677,ECE 200,020,091022,Kuzum; Duygu,9999,0,9999,0
1653443761677,ECE 200,021,091023,Le; Hanh-Phuc,9999,0,9999,0
1653443761677,ECE 200,022,091024,Lin; Bill,9999,0,9999,0
1653443761677,ECE 200,023,091025,Liu; Zhaowei,9999,0,9999,0
1653443761677,ECE 200,024,091026,Lo; Yu-Hwa,9999,0,9999,0
1653443761677,ECE 200,025,091027,Lomakin; Vitaliy,9999,0,9999,0
1653443761677,ECE 200,026,091028,Mercier; Patrick Philip,9999,0,9999,0
1653443761677,ECE 200,027,091029,Meyer; Florian,9999,0,9999,0
1653443761677,ECE 200,028,091030,Milstein; Laurence B.,9999,0,9999,0
1653443761677,ECE 200,029,091031,Mir Arabbaygi; Siavash,9999,0,9999,0
1653443761677,ECE 200,030,091032,Mookherjea; Shayan,9999,0,9999,0
1653443761677,ECE 200,031,091033,Morris; Karcher William,9999,0,9999,0
1653443761677,ECE 200,032,091034,Ng; Tse Nga,9999,0,9999,0
1653443761677,ECE 200,033,091035,Nguyen; Truong Quang,9999,0,9999,0
1653443761677,ECE 200,034,091036,Nomura; Kenji,9999,0,9999,0
1653443761677,ECE 200,035,091037,Orlitsky; Alon,9999,0,9999,0
1653443761677,ECE 200,036,091038,Pal; Piya,9999,0,9999,0
1653443761677,ECE 200,037,091039,Papen; George C.,9999,0,9999,0
1653443761677,ECE 200,038,091040,Radic; Stojan,9999,0,9999,0
1653443761677,ECE 200,039,091041,Rao; Bhaskar D.,9999,0,9999,0
1653443761677,ECE 200,040,091042,Rao; Ramesh R,9999,0,9999,0
1653443761677,ECE 200,041,091043,Rebeiz; Gabriel,9999,0,9999,0
1653443761677,ECE 200,042,091044,Sanford; John R,9999,0,9999,0
1653443761677,ECE 200,043,091045,Siegel; Paul H.,9999,0,9999,0
1653443761677,ECE 200,044,091046,Sievenpiper; Daniel F.,9999,0,9999,0
1653443761677,ECE 200,045,091047,Sworder; David D.,9999,0,9999,0
1653443761677,ECE 200,046,091048,Taur; Yuan,9999,0,9999,0
1653443761677,ECE 200,047,091049,Touri; Behrouz,9999,0,9999,0
1653443761677,ECE 200,048,091050,Trivedi; Mohan M.,9999,0,9999,0
1653443761677,ECE 200,049,091051,Vardy; Alexander,9999,0,9999,0
1653443761677,ECE 200,050,091052,Vasconcelos; Nuno,9999,0,9999,0
1653443761677,ECE 200,051,091053,Wang; Xiaolong,9999,0,9999,0
1653443761677,ECE 200,052,091054,Xie; Pengtao,9999,0,9999,0
1653443761677,ECE 200,053,091055,Yip; Michael,9999,0,9999,0
1653443761677,ECE 200,054,091056,Zeger; Kenneth A.,9999,0,9999,0
1653443761677,ECE 200,055,091057,Zhang; Xinyu,9999,0,9999,0
1653443761677,ECE 200,056,091058,Turakhia; Yatish Girish,9999,0,9999,0
1653443761677,ECE 200,057,091059,Kang; Mingu,9999,0,9999,0
1653443761677,ECE 200,058,091060,Shi; Yuanyuan,9999,0,9999,0
1653443761677,ECE 200,059,091061,Wang; Edward Jay,9999,0,9999,0
1653443761677,ECE 200,060,091062,Zheng; Yang,9999,0,9999,0
1653443762203,ECE 203,A00,091065,Mercier; Patrick Philip,0,0,0,0
1653443762726,ECE 207A,A00,091605,Liu; Thomas Tao-Ming,0,0,0,0
1653443763248,ECE 212AN,A00,091068,Nomura; Kenji,0,0,0,0
1653443763777,ECE 222A,A00,091069,Rebeiz; Gabriel,0,0,0,0
1653443764304,ECE 225A,A00,091070,Orlitsky; Alon,0,0,0,0
1653443764839,ECE 230A,A00,091071,Nomura; Kenji,0,0,0,0
1653443765361,ECE 236A,A00,091072,Dayeh; Shadi Ahmad,0,0,0,0
1653443765890,ECE 238A,A00,091073,Luo; Jian,0,0,0,0
1653443765890,ECE 238A,B00,091074,Luo; Jian,0,0,0,0
1653443766414,ECE 240A,A00,091075,Radic; Stojan,0,0,0,0
1653443766936,ECE 247A,A00,091592,Shi; Lingyan,0,0,0,0
1653443767462,ECE 250,A00,091076,Touri; Behrouz,0,0,0,0
1653443767986,ECE 251C,A00,091078,Nguyen; Truong Quang,0,0,0,0
1653443768515,ECE 253,A00,091079,Cosman; Pamela C.,0,0,0,0
1653443769037,ECE 255A,A00,091080,Orlitsky; Alon,0,0,0,0
1653443769569,ECE 257A,A00,091081,Zhang; Xinyu,0,0,0,0
1653443770095,ECE 260A,A01,091084,Eldon; John,0,0,0,0
1653443770638,ECE 264C,A00,091085,Galton; Ian A,0,0,0,0
1653443771165,ECE 265C,A00,094889,Presti; Calogero Davide,0,0,0,9
1653443771690,ECE 266,A01,091087,Hall; Drew A.,0,0,0,0
1653443772737,ECE 271A,A00,091090,Vasconcelos; Nuno,0,0,0,0
1653443773264,ECE 272B,A00,091091,Sworder; David D.,0,0,0,0
1653443773786,ECE 275A,A00,091092,Meyer; Florian,0,0,0,0
1653443774312,ECE 277,A00,091093,An; Cheolhong,0,0,0,0
1653443774836,ECE 283,A00,091094,Le; Hanh-Phuc,0,0,0,0
1653443775363,ECE 284,A00,091095,Kang; Mingu,0,0,0,0
1653443775363,ECE 284,B00,091096,Wang; Edward Jay,0,0,0,0
1653443775885,ECE 285,A00,094334,Touri; Behrouz,0,0,0,0
1653443776413,ECE 289,A00,091097,Whelan; David Arthur,0,0,0,0
1653443776940,MATH 200A,A00,087414,Salehi Golsefidy; Alireza,7,0,8,1
1653443777474,MATH 202A,A00,087415,Gill; Philip E.,3,0,8,5
1653443778012,MATH 203A,A00,087416,Oprea; Dragos N.,6,0,8,2
1653443778538,MATH 204A,A00,087417,Kedlaya; Kiran S.,6,0,8,2
1653443779095,MATH 205,A00,087418,Sorensen; Claus M,6,0,8,2
1653443779617,MATH 206A,A00,087419,Izadi; Elham,7,0,8,1
1653443780142,MATH 207A,A00,087420,Mohammadi; Amir,6,0,8,2
1653443780665,MATH 208,A00,087421,Staff,9,0,10,1
1653443781187,MATH 209,A00,087422,Staff,10,0,10,0
1653443781711,MATH 218,A00,087423,Staff,10,0,10,0
1653443782235,MATH 220A,A00,087424,Novak; Jonathan I,7,0,8,1
1653443782761,MATH 231A,A00,087425,Bejenaru; Ioan,4,0,8,4
1653443783295,MATH 240A,A00,087426,Ebenfelt; Peter F,5,0,8,3
1653443783817,MATH 243,A00,087427,Staff,9,0,10,1
1653443784340,MATH 248,A00,087429,Staff,10,0,10,0
1653443784862,MATH 250A,A00,087430,Spolaor; Luca,4,0,8,4
1653443785385,MATH 257A,A00,087431,Spolaor; Luca,7,0,8,1
1653443785911,MATH 258,A00,087432,Staff,9,0,10,1
1653443786438,MATH 264A,A00,087433,Warnke; Lutz Peter,5,0,8,3
1653443786966,MATH 268,A00,087434,Staff,15,0,15,0
1653443787490,MATH 269,A00,087435,Staff,14,0,15,1
1653443788018,MATH 270A,A00,087436,Nie; Jiawang,0,0,8,8
1653443788545,MATH 272A,A00,087437,Tian; Xiaochuan,1,0,8,7
1653443789072,MATH 274,A01,087439,Cheng; Li-Tien,9,0,10,1
1653443789072,MATH 274,A02,087440,Cheng; Li-Tien,10,0,10,0
1653443789597,MATH 278A,A00,087441,Staff,8,0,10,2
1653443790131,MATH 278B,A00,087442,Staff,8,0,10,2
1653443790656,MATH 278C,A00,087443,Staff,8,0,10,2
1653443791189,MATH 280A,A00,087444,Zheng; Tianyi,0,0,8,8
1653443791711,MATH 281A,A00,087445,Bradic; Jelena,0,0,8,8
1653443792235,MATH 282A,A00,087446,Zhang; Danna,0,0,8,8
1653443792756,MATH 283,A00,087447,Tesler; Glenn,0,0,0,14
1653443793282,MATH 286,A00,087448,Kemp; Todd Aahron,6,0,8,2
1653443793805,MATH 287D,A00,087449,Bradic; Jelena,8,0,8,0
1653443794328,MATH 288,A00,087450,Staff,14,0,15,1
1653443794328,MATH 288,B00,087451,Staff,15,0,15,0
1653443794328,MATH 288,C00,087452,Staff,15,0,15,0
1653443794854,MATH 290A,A00,087453,Xu; Zhouli,7,0,8,1
1653443795376,MATH 291A,A00,087454,Xu; Zhouli,7,0,8,1
1653443795899,MATH 292,A00,087455,Staff,10,0,10,0
1653443796423,MATH 295,A00,087456,Staff,50,0,50,0
1653443796952,MATH 297,001,087457,Staff,998,0,999,1
1653444359473,COGS 200,A01,087991,Staff,47,0,50,3
1653444360001,COGS 201,A01,094504,Rangel; Lara M,17,0,25,8
1653444360523,COGS 203,A00,087992,Coulson; Seana M,18,0,20,2
1653444361073,COGS 210A,001,087993,Greene; Deanna Jacquelyn,9998,0,9999,1
1653444361073,COGS 210A,002,087994,Saygin; Ayse P,9999,0,9999,0
1653444361073,COGS 210A,003,087995,Xia; Haijun,9999,0,9999,0
1653444361073,COGS 210A,004,087996,Nitz; Douglas A.,9999,0,9999,0
1653444361073,COGS 210A,005,087997,Hollan; James D.,9999,0,9999,0
1653444361073,COGS 210A,006,087998,Deak; Gedeon O.,9998,0,9999,1
1653444361073,COGS 210A,007,087999,Rossano; Federico,9999,0,9999,0
1653444361603,COGS 211A,A00,088000,Coulson; Seana M,9997,0,9999,2
1653444362130,COGS 229,A00,088002,Staff,23,0,25,2
1653444362653,COGS 260,B00,094231,Staff,17,0,20,3
1653444362653,COGS 260,A00,088004,Nitz; Douglas A.,9998,0,9999,1
1653444363178,CSE 202,A00,090110,Paturi; Ramamohan,0,0,0,0
1653444363178,CSE 202,B00,090111,Paturi; Ramamohan,0,0,0,0
1653444363701,CSE 207B,A00,090112,Heninger; Nadia A,0,0,0,0
1653444364224,CSE 208,A00,094858,Micciancio; Daniele,0,0,0,0
1653444364748,CSE 210,A00,090113,Powell; Thomas Allan,0,0,0,0
1653444365366,CSE 219,A00,090898,Staff,0,0,0,0
1653444365895,CSE 221,A00,090114,Zhou; Yuan-Yuan,0,0,0,0
1653444366420,CSE 229A,A00,090115,Porter; George M,0,0,0,0
1653444366943,CSE 229C,A00,090116,Savage; Stefan,0,0,0,0
1653444367469,CSE 230,A00,090117,Jhala; Ranjit,0,0,0,0
1653444367990,CSE 232,A00,090118,Papakonstantinou; Yannis,0,0,0,0
1653444368512,CSE 239A,A00,090121,Kumar; Arun Kumar,0,0,0,0
1653444369039,CSE 239B,A00,090122,Jhala; Ranjit,0,0,0,0
1653444369566,CSE 240A,A00,090123,Zhao; Jishen,0,0,189,189
1653444370093,CSE 243A,A00,090124,Orailoglu; Alex,1,0,15,14
1653444370622,CSE 249B,A00,090125,Kahng; Andrew Byun,13,0,20,7
1653444371143,CSE 250A,A00,090126,Berg-Kirkpatrick; Taylor D,0,0,0,0
1653444371671,CSE 252A,A00,090127,Ochoa; Benjamin Lawrence,0,0,0,0
1653444372199,CSE 258,A01,090129,McAuley; Julian John,0,0,0,0
1653444372722,CSE 258R,A01,090131,McAuley; Julian John,0,0,0,0
1653444373244,CSE 274,A00,090132,Ramamoorthi; Ravi,0,0,0,0
1653444373770,CSE 276A,A00,090133,Christensen; Henrik I,0,0,0,0
1653444374292,CSE 276C,A00,090134,Christensen; Henrik I,0,0,0,0
1653444374815,CSE 290,A00,090135,Bafna; Vineet,0,0,0,0
1653444374815,CSE 290,B00,090136,Ramamoorthi; Ravi,0,0,0,0
1653444374815,CSE 290,C00,090137,Li; Tzumao,9,0,10,1
1653444374815,CSE 290,D00,090138,Zhou; Yuan-Yuan,10,0,10,0
1653444374815,CSE 290,E00,090139,Christensen; Henrik I,10,0,10,0
1653444374815,CSE 290,F00,094053,Shalev; Aaron D,0,0,0,0
1653444375342,CSE 291,A00,090140,Munyaka; Imani N. S.,0,0,0,0
1653444375342,CSE 291,B00,094880,Yu; Qi,0,0,0,0
1653444375342,CSE 291,C00,090142,Pannuto; Patrick William,0,0,0,0
1653444375342,CSE 291,D00,094881,Zhang; Yiying,0,0,0,0
1653444375342,CSE 291,E00,095118,Su; Hao,0,0,0,0
1653444375878,CSE 293,001,094905,Bafna; Vineet,9999,0,9999,0
1653444375878,CSE 293,002,094906,Bellare; Mihir,9999,0,9999,0
1653444375878,CSE 293,003,094907,Berg-Kirkpatrick; Taylor D,9999,0,9999,0
1653444375878,CSE 293,004,094908,Christensen; Henrik I,9999,0,9999,0
1653444375878,CSE 293,005,094909,Cottrell; Garrison W,9999,0,9999,0
1653444375878,CSE 293,006,094910,Deutsch; Alin Bernard,9999,0,9999,0
1653444375878,CSE 293,007,094911,Esmaeilzadeh; Hadi,9999,0,9999,0
1653444375878,CSE 293,008,094912,Freund; Yoav,9999,0,9999,0
1653444375878,CSE 293,009,094913,Griswold; William G.,9999,0,9999,0
1653444375878,CSE 293,010,094914,Gymrek; Melissa Ann,9999,0,9999,0
1653444375878,CSE 293,011,094915,Heninger; Nadia A,9999,0,9999,0
1653444375878,CSE 293,012,094916,Impagliazzo; Russell,9999,0,9999,0
1653444375878,CSE 293,013,094917,Jhala; Ranjit,9999,0,9999,0
1653444375878,CSE 293,014,094918,Kahng; Andrew Byun,9999,0,9999,0
1653444375878,CSE 293,015,094919,Kane; Daniel Mertz,9999,0,9999,0
1653444375878,CSE 293,016,094920,Kriegman; David J,9999,0,9999,0
1653444375878,CSE 293,017,094921,Kumar; Arun Kumar,9999,0,9999,0
1653444375878,CSE 293,018,094922,Lerner; Sorin,9999,0,9999,0
1653444375878,CSE 293,019,094923,Lovett; Shachar,9999,0,9999,0
1653444375878,CSE 293,020,094924,McAuley; Julian John,9999,0,9999,0
1653444375878,CSE 293,021,094925,Micciancio; Daniele,9999,0,9999,0
1653444375878,CSE 293,022,094926,Orailoglu; Alex,9999,0,9999,0
1653444375878,CSE 293,023,094927,Paturi; Ramamohan,9999,0,9999,0
1653444375878,CSE 293,024,094928,Polikarpova; Nadezhda,9999,0,9999,0
1653444375878,CSE 293,025,094929,Politz; Joseph Gibbs,9999,0,9999,0
1653444375878,CSE 293,026,094930,Porter; George M,9999,0,9999,0
1653444375878,CSE 293,027,094931,Porter; Leonard Emerson,9999,0,9999,0
1653444375878,CSE 293,028,094932,Ramamoorthi; Ravi,9999,0,9999,0
1653444375878,CSE 293,029,094933,Sahoo; Debashis,9999,0,9999,0
1653444375878,CSE 293,030,094934,Saul; Lawrence,9999,0,9999,0
1653444375878,CSE 293,031,094935,Savage; Stefan,9999,0,9999,0
1653444375878,CSE 293,032,094936,Schulze; Jurgen P.,9999,0,9999,0
1653444375878,CSE 293,033,094937,Snoeren; Alex C.,9999,0,9999,0
1653444375878,CSE 293,034,094938,Shang; Jingbo,9999,0,9999,0
1653444375878,CSE 293,035,094939,Stefan; Deian,9999,0,9999,0
1653444375878,CSE 293,036,094940,Su; Hao,9999,0,9999,0
1653444375878,CSE 293,037,094941,Swanson; Steven James,9999,0,9999,0
1653444375878,CSE 293,038,094942,Tullsen; Dean Michael,9999,0,9999,0
1653444375878,CSE 293,039,094943,Voelker; Geoffrey M.,9999,0,9999,0
1653444375878,CSE 293,040,094944,Zhao; Jishen,9999,0,9999,0
1653444375878,CSE 293,041,094945,Zhou; Yuan-Yuan,9999,0,9999,0
1653444375878,CSE 293,042,094946,Gao; Sicun,9998,0,9999,1
1653444375878,CSE 293,043,094947,Weibel; Nadir,9999,0,9999,0
1653444375878,CSE 293,044,094948,Gupta; Rajesh K.,9999,0,9999,0
1653444376400,CSE 294,A00,090143,Porter; George M,9,0,10,1
1653444376932,DSE 200,A00,091799,Staff,50,0,50,0
1653444377460,DSE 203,A00,091800,Gupta; Amarnath,30,0,30,0
1653444377982,DSE 250,A00,091801,Deutsch; Alin Bernard,30,0,30,0
1653444378504,DSE 290,A00,091802,Altintas De Callaf; Ilkay,50,0,50,0
1653444379041,ECE 200,001,091003,Antipa; Nicholas A,9999,0,9999,0
1653444379041,ECE 200,002,091004,Atanasov; Nikolay A.,9999,0,9999,0
1653444379041,ECE 200,003,091005,Bharadia; Dinesh,9999,0,9999,0
1653444379041,ECE 200,004,091006,Cheng; Chung Kuan,9999,0,9999,0
1653444379041,ECE 200,005,091007,Cosman; Pamela C.,9999,0,9999,0
1653444379041,ECE 200,006,091008,Staff,9999,0,9999,0
1653444379041,ECE 200,007,091009,Dayeh; Shadi Ahmad,9999,0,9999,0
1653444379041,ECE 200,008,091010,Fainman; Yeshaiahu,9999,0,9999,0
1653444379041,ECE 200,009,091011,Ford; Joseph Earl,9999,0,9999,0
1653444379041,ECE 200,010,091012,Franceschetti; Massimo,9999,0,9999,0
1653444379041,ECE 200,011,091013,Fullerton; Eric E,9999,0,9999,0
1653444379041,ECE 200,012,091014,Galton; Ian A,9999,0,9999,0
1653444379041,ECE 200,013,091015,Gilja; Vikash,9999,0,9999,0
1653444379041,ECE 200,014,091016,Hall; Drew A.,9999,0,9999,0
1653444379041,ECE 200,015,091017,Hsueh; Tzu-Chien,9999,0,9999,0
1653444379041,ECE 200,016,091018,Javidi; Tara,9999,0,9999,0
1653444379041,ECE 200,017,091019,Kahng; Andrew Byun,9999,0,9999,0
1653444379041,ECE 200,018,091020,Kim; Young-Han,9999,0,9999,0
1653444379041,ECE 200,019,091021,Koushanfar; Farinaz,9999,0,9999,0
1653444379041,ECE 200,020,091022,Kuzum; Duygu,9999,0,9999,0
1653444379041,ECE 200,021,091023,Le; Hanh-Phuc,9999,0,9999,0
1653444379041,ECE 200,022,091024,Lin; Bill,9999,0,9999,0
1653444379041,ECE 200,023,091025,Liu; Zhaowei,9999,0,9999,0
1653444379041,ECE 200,024,091026,Lo; Yu-Hwa,9999,0,9999,0
1653444379041,ECE 200,025,091027,Lomakin; Vitaliy,9999,0,9999,0
1653444379041,ECE 200,026,091028,Mercier; Patrick Philip,9999,0,9999,0
1653444379041,ECE 200,027,091029,Meyer; Florian,9999,0,9999,0
1653444379041,ECE 200,028,091030,Milstein; Laurence B.,9999,0,9999,0
1653444379041,ECE 200,029,091031,Mir Arabbaygi; Siavash,9999,0,9999,0
1653444379041,ECE 200,030,091032,Mookherjea; Shayan,9999,0,9999,0
1653444379041,ECE 200,031,091033,Morris; Karcher William,9999,0,9999,0
1653444379041,ECE 200,032,091034,Ng; Tse Nga,9999,0,9999,0
1653444379041,ECE 200,033,091035,Nguyen; Truong Quang,9999,0,9999,0
1653444379041,ECE 200,034,091036,Nomura; Kenji,9999,0,9999,0
1653444379041,ECE 200,035,091037,Orlitsky; Alon,9999,0,9999,0
1653444379041,ECE 200,036,091038,Pal; Piya,9999,0,9999,0
1653444379041,ECE 200,037,091039,Papen; George C.,9999,0,9999,0
1653444379041,ECE 200,038,091040,Radic; Stojan,9999,0,9999,0
1653444379041,ECE 200,039,091041,Rao; Bhaskar D.,9999,0,9999,0
1653444379041,ECE 200,040,091042,Rao; Ramesh R,9999,0,9999,0
1653444379041,ECE 200,041,091043,Rebeiz; Gabriel,9999,0,9999,0
1653444379041,ECE 200,042,091044,Sanford; John R,9999,0,9999,0
1653444379041,ECE 200,043,091045,Siegel; Paul H.,9999,0,9999,0
1653444379041,ECE 200,044,091046,Sievenpiper; Daniel F.,9999,0,9999,0
1653444379041,ECE 200,045,091047,Sworder; David D.,9999,0,9999,0
1653444379041,ECE 200,046,091048,Taur; Yuan,9999,0,9999,0
1653444379041,ECE 200,047,091049,Touri; Behrouz,9999,0,9999,0
1653444379041,ECE 200,048,091050,Trivedi; Mohan M.,9999,0,9999,0
1653444379041,ECE 200,049,091051,Vardy; Alexander,9999,0,9999,0
1653444379041,ECE 200,050,091052,Vasconcelos; Nuno,9999,0,9999,0
1653444379041,ECE 200,051,091053,Wang; Xiaolong,9999,0,9999,0
1653444379041,ECE 200,052,091054,Xie; Pengtao,9999,0,9999,0
1653444379041,ECE 200,053,091055,Yip; Michael,9999,0,9999,0
1653444379041,ECE 200,054,091056,Zeger; Kenneth A.,9999,0,9999,0
1653444379041,ECE 200,055,091057,Zhang; Xinyu,9999,0,9999,0
1653444379041,ECE 200,056,091058,Turakhia; Yatish Girish,9999,0,9999,0
1653444379041,ECE 200,057,091059,Kang; Mingu,9999,0,9999,0
1653444379041,ECE 200,058,091060,Shi; Yuanyuan,9999,0,9999,0
1653444379041,ECE 200,059,091061,Wang; Edward Jay,9999,0,9999,0
1653444379041,ECE 200,060,091062,Zheng; Yang,9999,0,9999,0
1653444379565,ECE 203,A00,091065,Mercier; Patrick Philip,0,0,0,0
1653444380099,ECE 207A,A00,091605,Liu; Thomas Tao-Ming,0,0,0,0
1653444380622,ECE 212AN,A00,091068,Nomura; Kenji,0,0,0,0
1653444381148,ECE 222A,A00,091069,Rebeiz; Gabriel,0,0,0,0
1653444381669,ECE 225A,A00,091070,Orlitsky; Alon,0,0,0,0
1653444382192,ECE 230A,A00,091071,Nomura; Kenji,0,0,0,0
1653444382713,ECE 236A,A00,091072,Dayeh; Shadi Ahmad,0,0,0,0
1653444383246,ECE 238A,A00,091073,Luo; Jian,0,0,0,0
1653444383246,ECE 238A,B00,091074,Luo; Jian,0,0,0,0
1653444383769,ECE 240A,A00,091075,Radic; Stojan,0,0,0,0
1653444384297,ECE 247A,A00,091592,Shi; Lingyan,0,0,0,0
1653444384819,ECE 250,A00,091076,Touri; Behrouz,0,0,0,0
1653444385342,ECE 251C,A00,091078,Nguyen; Truong Quang,0,0,0,0
1653444385864,ECE 253,A00,091079,Cosman; Pamela C.,0,0,0,0
1653444386387,ECE 255A,A00,091080,Orlitsky; Alon,0,0,0,0
1653444386910,ECE 257A,A00,091081,Zhang; Xinyu,0,0,0,0
1653444387437,ECE 260A,A01,091084,Eldon; John,0,0,0,0
1653444387960,ECE 264C,A00,091085,Galton; Ian A,0,0,0,0
1653444388483,ECE 265C,A00,094889,Presti; Calogero Davide,0,0,0,9
1653444389006,ECE 266,A01,091087,Hall; Drew A.,0,0,0,0
1653444390170,ECE 271A,A00,091090,Vasconcelos; Nuno,0,0,0,0
1653444390706,ECE 272B,A00,091091,Sworder; David D.,0,0,0,0
1653444391231,ECE 275A,A00,091092,Meyer; Florian,0,0,0,0
1653444391763,ECE 277,A00,091093,An; Cheolhong,0,0,0,0
1653444392287,ECE 283,A00,091094,Le; Hanh-Phuc,0,0,0,0
1653444392822,ECE 284,A00,091095,Kang; Mingu,0,0,0,0
1653444392822,ECE 284,B00,091096,Wang; Edward Jay,0,0,0,0
1653444393363,ECE 285,A00,094334,Touri; Behrouz,0,0,0,0
1653444393886,ECE 289,A00,091097,Whelan; David Arthur,0,0,0,0
1653444394410,MATH 200A,A00,087414,Salehi Golsefidy; Alireza,7,0,8,1
1653444394933,MATH 202A,A00,087415,Gill; Philip E.,3,0,8,5
1653444395461,MATH 203A,A00,087416,Oprea; Dragos N.,6,0,8,2
1653444395984,MATH 204A,A00,087417,Kedlaya; Kiran S.,6,0,8,2
1653444396506,MATH 205,A00,087418,Sorensen; Claus M,6,0,8,2
1653444397032,MATH 206A,A00,087419,Izadi; Elham,7,0,8,1
1653444397556,MATH 207A,A00,087420,Mohammadi; Amir,6,0,8,2
1653444398079,MATH 208,A00,087421,Staff,9,0,10,1
1653444398601,MATH 209,A00,087422,Staff,10,0,10,0
1653444399122,MATH 218,A00,087423,Staff,10,0,10,0
1653444399645,MATH 220A,A00,087424,Novak; Jonathan I,7,0,8,1
1653444400170,MATH 231A,A00,087425,Bejenaru; Ioan,4,0,8,4
1653444400693,MATH 240A,A00,087426,Ebenfelt; Peter F,5,0,8,3
1653444401215,MATH 243,A00,087427,Staff,9,0,10,1
1653444401740,MATH 248,A00,087429,Staff,10,0,10,0
1653444402262,MATH 250A,A00,087430,Spolaor; Luca,4,0,8,4
1653444402787,MATH 257A,A00,087431,Spolaor; Luca,7,0,8,1
1653444403317,MATH 258,A00,087432,Staff,9,0,10,1
1653444403842,MATH 264A,A00,087433,Warnke; Lutz Peter,5,0,8,3
1653444404379,MATH 268,A00,087434,Staff,15,0,15,0
1653444404903,MATH 269,A00,087435,Staff,14,0,15,1
1653444405439,MATH 270A,A00,087436,Nie; Jiawang,0,0,8,8
1653444405973,MATH 272A,A00,087437,Tian; Xiaochuan,1,0,8,7
1653444406497,MATH 274,A01,087439,Cheng; Li-Tien,9,0,10,1
1653444406497,MATH 274,A02,087440,Cheng; Li-Tien,10,0,10,0
1653444407025,MATH 278A,A00,087441,Staff,8,0,10,2
1653444407545,MATH 278B,A00,087442,Staff,8,0,10,2
1653444408072,MATH 278C,A00,087443,Staff,8,0,10,2
1653444408595,MATH 280A,A00,087444,Zheng; Tianyi,0,0,8,8
1653444409119,MATH 281A,A00,087445,Bradic; Jelena,0,0,8,8
1653444409641,MATH 282A,A00,087446,Zhang; Danna,0,0,8,8
1653444410164,MATH 283,A00,087447,Tesler; Glenn,0,0,0,14
1653444410689,MATH 286,A00,087448,Kemp; Todd Aahron,6,0,8,2
1653444411212,MATH 287D,A00,087449,Bradic; Jelena,8,0,8,0
1653444411734,MATH 288,A00,087450,Staff,14,0,15,1
1653444411734,MATH 288,B00,087451,Staff,15,0,15,0
1653444411734,MATH 288,C00,087452,Staff,15,0,15,0
1653444412259,MATH 290A,A00,087453,Xu; Zhouli,7,0,8,1
1653444412783,MATH 291A,A00,087454,Xu; Zhouli,7,0,8,1
1653444413304,MATH 292,A00,087455,Staff,10,0,10,0
1653444413826,MATH 295,A00,087456,Staff,50,0,50,0
1653444414352,MATH 297,001,087457,Staff,998,0,999,1
1653444976413,COGS 200,A01,087991,Staff,47,0,50,3
1653444976936,COGS 201,A01,094504,Rangel; Lara M,17,0,25,8
1653444977459,COGS 203,A00,087992,Coulson; Seana M,18,0,20,2
1653444977982,COGS 210A,001,087993,Greene; Deanna Jacquelyn,9998,0,9999,1
1653444977982,COGS 210A,002,087994,Saygin; Ayse P,9999,0,9999,0
1653444977982,COGS 210A,003,087995,Xia; Haijun,9999,0,9999,0
1653444977982,COGS 210A,004,087996,Nitz; Douglas A.,9999,0,9999,0
1653444977982,COGS 210A,005,087997,Hollan; James D.,9999,0,9999,0
1653444977982,COGS 210A,006,087998,Deak; Gedeon O.,9998,0,9999,1
1653444977982,COGS 210A,007,087999,Rossano; Federico,9999,0,9999,0
1653444978508,COGS 211A,A00,088000,Coulson; Seana M,9997,0,9999,2
1653444979103,COGS 229,A00,088002,Staff,23,0,25,2
1653444979628,COGS 260,B00,094231,Staff,17,0,20,3
1653444979628,COGS 260,A00,088004,Nitz; Douglas A.,9998,0,9999,1
1653444980152,CSE 202,A00,090110,Paturi; Ramamohan,0,0,0,0
1653444980152,CSE 202,B00,090111,Paturi; Ramamohan,0,0,0,0
1653444980677,CSE 207B,A00,090112,Heninger; Nadia A,0,0,0,0
1653444981200,CSE 208,A00,094858,Micciancio; Daniele,0,0,0,0
1653444981725,CSE 210,A00,090113,Powell; Thomas Allan,0,0,0,0
1653444982252,CSE 219,A00,090898,Staff,0,0,0,0
1653444982777,CSE 221,A00,090114,Zhou; Yuan-Yuan,0,0,0,0
1653444983302,CSE 229A,A00,090115,Porter; George M,0,0,0,0
1653444983830,CSE 229C,A00,090116,Savage; Stefan,0,0,0,0
1653444984369,CSE 230,A00,090117,Jhala; Ranjit,0,0,0,0
1653444984891,CSE 232,A00,090118,Papakonstantinou; Yannis,0,0,0,0
1653444985415,CSE 239A,A00,090121,Kumar; Arun Kumar,0,0,0,0
1653444985938,CSE 239B,A00,090122,Jhala; Ranjit,0,0,0,0
1653444986461,CSE 240A,A00,090123,Zhao; Jishen,0,0,189,189
1653444986989,CSE 243A,A00,090124,Orailoglu; Alex,1,0,15,14
1653444987513,CSE 249B,A00,090125,Kahng; Andrew Byun,13,0,20,7
1653444988034,CSE 250A,A00,090126,Berg-Kirkpatrick; Taylor D,0,0,0,0
1653444988561,CSE 252A,A00,090127,Ochoa; Benjamin Lawrence,0,0,0,0
1653444989082,CSE 258,A01,090129,McAuley; Julian John,0,0,0,0
1653444989607,CSE 258R,A01,090131,McAuley; Julian John,0,0,0,0
1653444990139,CSE 274,A00,090132,Ramamoorthi; Ravi,0,0,0,0
1653444990661,CSE 276A,A00,090133,Christensen; Henrik I,0,0,0,0
1653444991186,CSE 276C,A00,090134,Christensen; Henrik I,0,0,0,0
1653444991716,CSE 290,A00,090135,Bafna; Vineet,0,0,0,0
1653444991716,CSE 290,B00,090136,Ramamoorthi; Ravi,0,0,0,0
1653444991716,CSE 290,C00,090137,Li; Tzumao,9,0,10,1
1653444991716,CSE 290,D00,090138,Zhou; Yuan-Yuan,10,0,10,0
1653444991716,CSE 290,E00,090139,Christensen; Henrik I,10,0,10,0
1653444991716,CSE 290,F00,094053,Shalev; Aaron D,0,0,0,0
1653444992241,CSE 291,A00,090140,Munyaka; Imani N. S.,0,0,0,0
1653444992241,CSE 291,B00,094880,Yu; Qi,0,0,0,0
1653444992241,CSE 291,C00,090142,Pannuto; Patrick William,0,0,0,0
1653444992241,CSE 291,D00,094881,Zhang; Yiying,0,0,0,0
1653444992241,CSE 291,E00,095118,Su; Hao,0,0,0,0
1653444992767,CSE 293,001,094905,Bafna; Vineet,9999,0,9999,0
1653444992767,CSE 293,002,094906,Bellare; Mihir,9999,0,9999,0
1653444992767,CSE 293,003,094907,Berg-Kirkpatrick; Taylor D,9999,0,9999,0
1653444992767,CSE 293,004,094908,Christensen; Henrik I,9999,0,9999,0
1653444992767,CSE 293,005,094909,Cottrell; Garrison W,9999,0,9999,0
1653444992767,CSE 293,006,094910,Deutsch; Alin Bernard,9999,0,9999,0
1653444992767,CSE 293,007,094911,Esmaeilzadeh; Hadi,9999,0,9999,0
1653444992767,CSE 293,008,094912,Freund; Yoav,9999,0,9999,0
1653444992767,CSE 293,009,094913,Griswold; William G.,9999,0,9999,0
1653444992767,CSE 293,010,094914,Gymrek; Melissa Ann,9999,0,9999,0
1653444992767,CSE 293,011,094915,Heninger; Nadia A,9999,0,9999,0
1653444992767,CSE 293,012,094916,Impagliazzo; Russell,9999,0,9999,0
1653444992767,CSE 293,013,094917,Jhala; Ranjit,9999,0,9999,0
1653444992767,CSE 293,014,094918,Kahng; Andrew Byun,9999,0,9999,0
1653444992767,CSE 293,015,094919,Kane; Daniel Mertz,9999,0,9999,0
1653444992767,CSE 293,016,094920,Kriegman; David J,9999,0,9999,0
1653444992767,CSE 293,017,094921,Kumar; Arun Kumar,9999,0,9999,0
1653444992767,CSE 293,018,094922,Lerner; Sorin,9999,0,9999,0
1653444992767,CSE 293,019,094923,Lovett; Shachar,9999,0,9999,0
1653444992767,CSE 293,020,094924,McAuley; Julian John,9999,0,9999,0
1653444992767,CSE 293,021,094925,Micciancio; Daniele,9999,0,9999,0
1653444992767,CSE 293,022,094926,Orailoglu; Alex,9999,0,9999,0
1653444992767,CSE 293,023,094927,Paturi; Ramamohan,9999,0,9999,0
1653444992767,CSE 293,024,094928,Polikarpova; Nadezhda,9999,0,9999,0
1653444992767,CSE 293,025,094929,Politz; Joseph Gibbs,9999,0,9999,0
1653444992767,CSE 293,026,094930,Porter; George M,9999,0,9999,0
1653444992767,CSE 293,027,094931,Porter; Leonard Emerson,9999,0,9999,0
1653444992767,CSE 293,028,094932,Ramamoorthi; Ravi,9999,0,9999,0
1653444992767,CSE 293,029,094933,Sahoo; Debashis,9999,0,9999,0
1653444992767,CSE 293,030,094934,Saul; Lawrence,9999,0,9999,0
1653444992767,CSE 293,031,094935,Savage; Stefan,9999,0,9999,0
1653444992767,CSE 293,032,094936,Schulze; Jurgen P.,9999,0,9999,0
1653444992767,CSE 293,033,094937,Snoeren; Alex C.,9999,0,9999,0
1653444992767,CSE 293,034,094938,Shang; Jingbo,9999,0,9999,0
1653444992767,CSE 293,035,094939,Stefan; Deian,9999,0,9999,0
1653444992767,CSE 293,036,094940,Su; Hao,9999,0,9999,0
1653444992767,CSE 293,037,094941,Swanson; Steven James,9999,0,9999,0
1653444992767,CSE 293,038,094942,Tullsen; Dean Michael,9999,0,9999,0
1653444992767,CSE 293,039,094943,Voelker; Geoffrey M.,9999,0,9999,0
1653444992767,CSE 293,040,094944,Zhao; Jishen,9999,0,9999,0
1653444992767,CSE 293,041,094945,Zhou; Yuan-Yuan,9999,0,9999,0
1653444992767,CSE 293,042,094946,Gao; Sicun,9998,0,9999,1
1653444992767,CSE 293,043,094947,Weibel; Nadir,9999,0,9999,0
1653444992767,CSE 293,044,094948,Gupta; Rajesh K.,9999,0,9999,0
1653444993298,CSE 294,A00,090143,Porter; George M,9,0,10,1
1653444993821,DSE 200,A00,091799,Staff,50,0,50,0
1653444994350,DSE 203,A00,091800,Gupta; Amarnath,30,0,30,0
1653444994872,DSE 250,A00,091801,Deutsch; Alin Bernard,30,0,30,0
1653444995398,DSE 290,A00,091802,Altintas De Callaf; Ilkay,50,0,50,0
1653444995937,ECE 200,001,091003,Antipa; Nicholas A,9999,0,9999,0
1653444995937,ECE 200,002,091004,Atanasov; Nikolay A.,9999,0,9999,0
1653444995937,ECE 200,003,091005,Bharadia; Dinesh,9999,0,9999,0
1653444995937,ECE 200,004,091006,Cheng; Chung Kuan,9999,0,9999,0
1653444995937,ECE 200,005,091007,Cosman; Pamela C.,9999,0,9999,0
1653444995937,ECE 200,006,091008,Staff,9999,0,9999,0
1653444995937,ECE 200,007,091009,Dayeh; Shadi Ahmad,9999,0,9999,0
1653444995937,ECE 200,008,091010,Fainman; Yeshaiahu,9999,0,9999,0
1653444995937,ECE 200,009,091011,Ford; Joseph Earl,9999,0,9999,0
1653444995937,ECE 200,010,091012,Franceschetti; Massimo,9999,0,9999,0
1653444995937,ECE 200,011,091013,Fullerton; Eric E,9999,0,9999,0
1653444995937,ECE 200,012,091014,Galton; Ian A,9999,0,9999,0
1653444995937,ECE 200,013,091015,Gilja; Vikash,9999,0,9999,0
1653444995937,ECE 200,014,091016,Hall; Drew A.,9999,0,9999,0
1653444995937,ECE 200,015,091017,Hsueh; Tzu-Chien,9999,0,9999,0
1653444995937,ECE 200,016,091018,Javidi; Tara,9999,0,9999,0
1653444995937,ECE 200,017,091019,Kahng; Andrew Byun,9999,0,9999,0
1653444995937,ECE 200,018,091020,Kim; Young-Han,9999,0,9999,0
1653444995937,ECE 200,019,091021,Koushanfar; Farinaz,9999,0,9999,0
1653444995937,ECE 200,020,091022,Kuzum; Duygu,9999,0,9999,0
1653444995937,ECE 200,021,091023,Le; Hanh-Phuc,9999,0,9999,0
1653444995937,ECE 200,022,091024,Lin; Bill,9999,0,9999,0
1653444995937,ECE 200,023,091025,Liu; Zhaowei,9999,0,9999,0
1653444995937,ECE 200,024,091026,Lo; Yu-Hwa,9999,0,9999,0
1653444995937,ECE 200,025,091027,Lomakin; Vitaliy,9999,0,9999,0
1653444995937,ECE 200,026,091028,Mercier; Patrick Philip,9999,0,9999,0
1653444995937,ECE 200,027,091029,Meyer; Florian,9999,0,9999,0
1653444995937,ECE 200,028,091030,Milstein; Laurence B.,9999,0,9999,0
1653444995937,ECE 200,029,091031,Mir Arabbaygi; Siavash,9999,0,9999,0
1653444995937,ECE 200,030,091032,Mookherjea; Shayan,9999,0,9999,0
1653444995937,ECE 200,031,091033,Morris; Karcher William,9999,0,9999,0
1653444995937,ECE 200,032,091034,Ng; Tse Nga,9999,0,9999,0
1653444995937,ECE 200,033,091035,Nguyen; Truong Quang,9999,0,9999,0
1653444995937,ECE 200,034,091036,Nomura; Kenji,9999,0,9999,0
1653444995937,ECE 200,035,091037,Orlitsky; Alon,9999,0,9999,0
1653444995937,ECE 200,036,091038,Pal; Piya,9999,0,9999,0
1653444995937,ECE 200,037,091039,Papen; George C.,9999,0,9999,0
1653444995937,ECE 200,038,091040,Radic; Stojan,9999,0,9999,0
1653444995937,ECE 200,039,091041,Rao; Bhaskar D.,9999,0,9999,0
1653444995937,ECE 200,040,091042,Rao; Ramesh R,9999,0,9999,0
1653444995937,ECE 200,041,091043,Rebeiz; Gabriel,9999,0,9999,0
1653444995937,ECE 200,042,091044,Sanford; John R,9999,0,9999,0
1653444995937,ECE 200,043,091045,Siegel; Paul H.,9999,0,9999,0
1653444995937,ECE 200,044,091046,Sievenpiper; Daniel F.,9999,0,9999,0
1653444995937,ECE 200,045,091047,Sworder; David D.,9999,0,9999,0
1653444995937,ECE 200,046,091048,Taur; Yuan,9999,0,9999,0
1653444995937,ECE 200,047,091049,Touri; Behrouz,9999,0,9999,0
1653444995937,ECE 200,048,091050,Trivedi; Mohan M.,9999,0,9999,0
1653444995937,ECE 200,049,091051,Vardy; Alexander,9999,0,9999,0
1653444995937,ECE 200,050,091052,Vasconcelos; Nuno,9999,0,9999,0
1653444995937,ECE 200,051,091053,Wang; Xiaolong,9999,0,9999,0
1653444995937,ECE 200,052,091054,Xie; Pengtao,9999,0,9999,0
1653444995937,ECE 200,053,091055,Yip; Michael,9999,0,9999,0
1653444995937,ECE 200,054,091056,Zeger; Kenneth A.,9999,0,9999,0
1653444995937,ECE 200,055,091057,Zhang; Xinyu,9999,0,9999,0
1653444995937,ECE 200,056,091058,Turakhia; Yatish Girish,9999,0,9999,0
1653444995937,ECE 200,057,091059,Kang; Mingu,9999,0,9999,0
1653444995937,ECE 200,058,091060,Shi; Yuanyuan,9999,0,9999,0
1653444995937,ECE 200,059,091061,Wang; Edward Jay,9999,0,9999,0
1653444995937,ECE 200,060,091062,Zheng; Yang,9999,0,9999,0
1653444996463,ECE 203,A00,091065,Mercier; Patrick Philip,0,0,0,0
1653444996987,ECE 207A,A00,091605,Liu; Thomas Tao-Ming,0,0,0,0
1653444997524,ECE 212AN,A00,091068,Nomura; Kenji,0,0,0,0
1653444998047,ECE 222A,A00,091069,Rebeiz; Gabriel,0,0,0,0
1653444998588,ECE 225A,A00,091070,Orlitsky; Alon,0,0,0,0
1653444999119,ECE 230A,A00,091071,Nomura; Kenji,0,0,0,0
1653444999645,ECE 236A,A00,091072,Dayeh; Shadi Ahmad,0,0,0,0
1653445000168,ECE 238A,A00,091073,Luo; Jian,0,0,0,0
1653445000168,ECE 238A,B00,091074,Luo; Jian,0,0,0,0
1653445000690,ECE 240A,A00,091075,Radic; Stojan,0,0,0,0
1653445001264,ECE 247A,A00,091592,Shi; Lingyan,0,0,0,0
1653445001787,ECE 250,A00,091076,Touri; Behrouz,0,0,0,0
1653445002314,ECE 251C,A00,091078,Nguyen; Truong Quang,0,0,0,0
1653445002837,ECE 253,A00,091079,Cosman; Pamela C.,0,0,0,0
1653445003366,ECE 255A,A00,091080,Orlitsky; Alon,0,0,0,0
1653445003889,ECE 257A,A00,091081,Zhang; Xinyu,0,0,0,0
1653445004410,ECE 260A,A01,091084,Eldon; John,0,0,0,0
1653445004933,ECE 264C,A00,091085,Galton; Ian A,0,0,0,0
1653445005458,ECE 265C,A00,094889,Presti; Calogero Davide,0,0,0,9
1653445005985,ECE 266,A01,091087,Hall; Drew A.,0,0,0,0
1653445007030,ECE 271A,A00,091090,Vasconcelos; Nuno,0,0,0,0
1653445007574,ECE 272B,A00,091091,Sworder; David D.,0,0,0,0
1653445008097,ECE 275A,A00,091092,Meyer; Florian,0,0,0,0
1653445008623,ECE 277,A00,091093,An; Cheolhong,0,0,0,0
1653445009150,ECE 283,A00,091094,Le; Hanh-Phuc,0,0,0,0
1653445009672,ECE 284,A00,091095,Kang; Mingu,0,0,0,0
1653445009672,ECE 284,B00,091096,Wang; Edward Jay,0,0,0,0
1653445010198,ECE 285,A00,094334,Touri; Behrouz,0,0,0,0
1653445010725,ECE 289,A00,091097,Whelan; David Arthur,0,0,0,0
1653445011247,MATH 200A,A00,087414,Salehi Golsefidy; Alireza,7,0,8,1
1653445011770,MATH 202A,A00,087415,Gill; Philip E.,3,0,8,5
1653445012296,MATH 203A,A00,087416,Oprea; Dragos N.,6,0,8,2
1653445012823,MATH 204A,A00,087417,Kedlaya; Kiran S.,6,0,8,2
1653445013355,MATH 205,A00,087418,Sorensen; Claus M,6,0,8,2
1653445013877,MATH 206A,A00,087419,Izadi; Elham,7,0,8,1
1653445014402,MATH 207A,A00,087420,Mohammadi; Amir,6,0,8,2
1653445014925,MATH 208,A00,087421,Staff,9,0,10,1
1653445015451,MATH 209,A00,087422,Staff,10,0,10,0
1653445015978,MATH 218,A00,087423,Staff,10,0,10,0
1653445016500,MATH 220A,A00,087424,Novak; Jonathan I,7,0,8,1
1653445017023,MATH 231A,A00,087425,Bejenaru; Ioan,4,0,8,4
1653445017549,MATH 240A,A00,087426,Ebenfelt; Peter F,5,0,8,3
1653445018074,MATH 243,A00,087427,Staff,9,0,10,1
1653445018603,MATH 248,A00,087429,Staff,10,0,10,0
1653445019126,MATH 250A,A00,087430,Spolaor; Luca,4,0,8,4
1653445019648,MATH 257A,A00,087431,Spolaor; Luca,7,0,8,1
1653445020172,MATH 258,A00,087432,Staff,9,0,10,1
1653445020698,MATH 264A,A00,087433,Warnke; Lutz Peter,5,0,8,3
1653445021220,MATH 268,A00,087434,Staff,15,0,15,0
1653445021747,MATH 269,A00,087435,Staff,14,0,15,1
1653445022275,MATH 270A,A00,087436,Nie; Jiawang,0,0,8,8
1653445022797,MATH 272A,A00,087437,Tian; Xiaochuan,1,0,8,7
1653445023328,MATH 274,A01,087439,Cheng; Li-Tien,9,0,10,1
1653445023328,MATH 274,A02,087440,Cheng; Li-Tien,10,0,10,0
1653445023861,MATH 278A,A00,087441,Staff,8,0,10,2
1653445024386,MATH 278B,A00,087442,Staff,8,0,10,2
1653445024917,MATH 278C,A00,087443,Staff,8,0,10,2
1653445025454,MATH 280A,A00,087444,Zheng; Tianyi,0,0,8,8
1653445025981,MATH 281A,A00,087445,Bradic; Jelena,0,0,8,8
1653445026504,MATH 282A,A00,087446,Zhang; Danna,0,0,8,8
1653445027027,MATH 283,A00,087447,Tesler; Glenn,0,0,0,14
1653445027550,MATH 286,A00,087448,Kemp; Todd Aahron,6,0,8,2
1653445028082,MATH 287D,A00,087449,Bradic; Jelena,8,0,8,0
1653445028604,MATH 288,A00,087450,Staff,14,0,15,1
1653445028604,MATH 288,B00,087451,Staff,15,0,15,0
1653445028604,MATH 288,C00,087452,Staff,15,0,15,0
1653445029127,MATH 290A,A00,087453,Xu; Zhouli,7,0,8,1
1653445029652,MATH 291A,A00,087454,Xu; Zhouli,7,0,8,1
1653445030174,MATH 292,A00,087455,Staff,10,0,10,0
1653445030697,MATH 295,A00,087456,Staff,50,0,50,0
1653445031220,MATH 297,001,087457,Staff,998,0,999,1
1653445592709,COGS 200,A01,087991,Staff,47,0,50,3
1653445593231,COGS 201,A01,094504,Rangel; Lara M,17,0,25,8
1653445593771,COGS 203,A00,087992,Coulson; Seana M,18,0,20,2
1653445594294,COGS 210A,001,087993,Greene; Deanna Jacquelyn,9998,0,9999,1
1653445594294,COGS 210A,002,087994,Saygin; Ayse P,9999,0,9999,0
1653445594294,COGS 210A,003,087995,Xia; Haijun,9999,0,9999,0
1653445594294,COGS 210A,004,087996,Nitz; Douglas A.,9999,0,9999,0
1653445594294,COGS 210A,005,087997,Hollan; James D.,9999,0,9999,0
1653445594294,COGS 210A,006,087998,Deak; Gedeon O.,9998,0,9999,1
1653445594294,COGS 210A,007,087999,Rossano; Federico,9999,0,9999,0
1653445594817,COGS 211A,A00,088000,Coulson; Seana M,9997,0,9999,2
1653445595363,COGS 229,A00,088002,Staff,23,0,25,2
1653445595887,COGS 260,B00,094231,Staff,17,0,20,3
1653445595887,COGS 260,A00,088004,Nitz; Douglas A.,9998,0,9999,1
1653445596411,CSE 202,A00,090110,Paturi; Ramamohan,0,0,0,0
1653445596411,CSE 202,B00,090111,Paturi; Ramamohan,0,0,0,0
1653445596932,CSE 207B,A00,090112,Heninger; Nadia A,0,0,0,0
1653445597454,CSE 208,A00,094858,Micciancio; Daniele,0,0,0,0
1653445597985,CSE 210,A00,090113,Powell; Thomas Allan,0,0,0,0
1653445598508,CSE 219,A00,090898,Staff,0,0,0,0
1653445599030,CSE 221,A00,090114,Zhou; Yuan-Yuan,0,0,0,0
1653445599560,CSE 229A,A00,090115,Porter; George M,0,0,0,0
1653445600083,CSE 229C,A00,090116,Savage; Stefan,0,0,0,0
1653445600606,CSE 230,A00,090117,Jhala; Ranjit,0,0,0,0
1653445601129,CSE 232,A00,090118,Papakonstantinou; Yannis,0,0,0,0
1653445601650,CSE 239A,A00,090121,Kumar; Arun Kumar,0,0,0,0
1653445602173,CSE 239B,A00,090122,Jhala; Ranjit,0,0,0,0
1653445602696,CSE 240A,A00,090123,Zhao; Jishen,0,0,189,189
1653445603219,CSE 243A,A00,090124,Orailoglu; Alex,1,0,15,14
1653445603744,CSE 249B,A00,090125,Kahng; Andrew Byun,13,0,20,7
1653445604270,CSE 250A,A00,090126,Berg-Kirkpatrick; Taylor D,0,0,0,0
1653445604798,CSE 252A,A00,090127,Ochoa; Benjamin Lawrence,0,0,0,0
1653445605324,CSE 258,A01,090129,McAuley; Julian John,0,0,0,0
1653445605846,CSE 258R,A01,090131,McAuley; Julian John,0,0,0,0
1653445606367,CSE 274,A00,090132,Ramamoorthi; Ravi,0,0,0,0
1653445606889,CSE 276A,A00,090133,Christensen; Henrik I,0,0,0,0
1653445607414,CSE 276C,A00,090134,Christensen; Henrik I,0,0,0,0
1653445607937,CSE 290,A00,090135,Bafna; Vineet,0,0,0,0
1653445607937,CSE 290,B00,090136,Ramamoorthi; Ravi,0,0,0,0
1653445607937,CSE 290,C00,090137,Li; Tzumao,9,0,10,1
1653445607937,CSE 290,D00,090138,Zhou; Yuan-Yuan,10,0,10,0
1653445607937,CSE 290,E00,090139,Christensen; Henrik I,10,0,10,0
1653445607937,CSE 290,F00,094053,Shalev; Aaron D,0,0,0,0
1653445608462,CSE 291,A00,090140,Munyaka; Imani N. S.,0,0,0,0
1653445608462,CSE 291,B00,094880,Yu; Qi,0,0,0,0
1653445608462,CSE 291,C00,090142,Pannuto; Patrick William,0,0,0,0
1653445608462,CSE 291,D00,094881,Zhang; Yiying,0,0,0,0
1653445608462,CSE 291,E00,095118,Su; Hao,0,0,0,0
1653445609016,CSE 293,001,094905,Bafna; Vineet,9999,0,9999,0
1653445609016,CSE 293,002,094906,Bellare; Mihir,9999,0,9999,0
1653445609016,CSE 293,003,094907,Berg-Kirkpatrick; Taylor D,9999,0,9999,0
1653445609016,CSE 293,004,094908,Christensen; Henrik I,9999,0,9999,0
1653445609016,CSE 293,005,094909,Cottrell; Garrison W,9999,0,9999,0
1653445609016,CSE 293,006,094910,Deutsch; Alin Bernard,9999,0,9999,0
1653445609016,CSE 293,007,094911,Esmaeilzadeh; Hadi,9999,0,9999,0
1653445609016,CSE 293,008,094912,Freund; Yoav,9999,0,9999,0
1653445609016,CSE 293,009,094913,Griswold; William G.,9999,0,9999,0
1653445609016,CSE 293,010,094914,Gymrek; Melissa Ann,9999,0,9999,0
1653445609016,CSE 293,011,094915,Heninger; Nadia A,9999,0,9999,0
1653445609016,CSE 293,012,094916,Impagliazzo; Russell,9999,0,9999,0
1653445609016,CSE 293,013,094917,Jhala; Ranjit,9999,0,9999,0
1653445609016,CSE 293,014,094918,Kahng; Andrew Byun,9999,0,9999,0
1653445609016,CSE 293,015,094919,Kane; Daniel Mertz,9999,0,9999,0
1653445609016,CSE 293,016,094920,Kriegman; David J,9999,0,9999,0
1653445609016,CSE 293,017,094921,Kumar; Arun Kumar,9999,0,9999,0
1653445609016,CSE 293,018,094922,Lerner; Sorin,9999,0,9999,0
1653445609016,CSE 293,019,094923,Lovett; Shachar,9999,0,9999,0
1653445609016,CSE 293,020,094924,McAuley; Julian John,9999,0,9999,0
1653445609016,CSE 293,021,094925,Micciancio; Daniele,9999,0,9999,0
1653445609016,CSE 293,022,094926,Orailoglu; Alex,9999,0,9999,0
1653445609016,CSE 293,023,094927,Paturi; Ramamohan,9999,0,9999,0
1653445609016,CSE 293,024,094928,Polikarpova; Nadezhda,9999,0,9999,0
1653445609016,CSE 293,025,094929,Politz; Joseph Gibbs,9999,0,9999,0
1653445609016,CSE 293,026,094930,Porter; George M,9999,0,9999,0
1653445609016,CSE 293,027,094931,Porter; Leonard Emerson,9999,0,9999,0
1653445609016,CSE 293,028,094932,Ramamoorthi; Ravi,9999,0,9999,0
1653445609016,CSE 293,029,094933,Sahoo; Debashis,9999,0,9999,0
1653445609016,CSE 293,030,094934,Saul; Lawrence,9999,0,9999,0
1653445609016,CSE 293,031,094935,Savage; Stefan,9999,0,9999,0
1653445609016,CSE 293,032,094936,Schulze; Jurgen P.,9999,0,9999,0
1653445609016,CSE 293,033,094937,Snoeren; Alex C.,9999,0,9999,0
1653445609016,CSE 293,034,094938,Shang; Jingbo,9999,0,9999,0
1653445609016,CSE 293,035,094939,Stefan; Deian,9999,0,9999,0
1653445609016,CSE 293,036,094940,Su; Hao,9999,0,9999,0
1653445609016,CSE 293,037,094941,Swanson; Steven James,9999,0,9999,0
1653445609016,CSE 293,038,094942,Tullsen; Dean Michael,9999,0,9999,0
1653445609016,CSE 293,039,094943,Voelker; Geoffrey M.,9999,0,9999,0
1653445609016,CSE 293,040,094944,Zhao; Jishen,9999,0,9999,0
1653445609016,CSE 293,041,094945,Zhou; Yuan-Yuan,9999,0,9999,0
1653445609016,CSE 293,042,094946,Gao; Sicun,9998,0,9999,1
1653445609016,CSE 293,043,094947,Weibel; Nadir,9999,0,9999,0
1653445609016,CSE 293,044,094948,Gupta; Rajesh K.,9999,0,9999,0
1653445609541,CSE 294,A00,090143,Porter; George M,9,0,10,1
1653445610073,DSE 200,A00,091799,Staff,50,0,50,0
1653445610601,DSE 203,A00,091800,Gupta; Amarnath,30,0,30,0
1653445611124,DSE 250,A00,091801,Deutsch; Alin Bernard,30,0,30,0
1653445611647,DSE 290,A00,091802,Altintas De Callaf; Ilkay,50,0,50,0
1653445612179,ECE 200,001,091003,Antipa; Nicholas A,9999,0,9999,0
1653445612179,ECE 200,002,091004,Atanasov; Nikolay A.,9999,0,9999,0
1653445612179,ECE 200,003,091005,Bharadia; Dinesh,9999,0,9999,0
1653445612179,ECE 200,004,091006,Cheng; Chung Kuan,9999,0,9999,0
1653445612179,ECE 200,005,091007,Cosman; Pamela C.,9999,0,9999,0
1653445612179,ECE 200,006,091008,Staff,9999,0,9999,0
1653445612179,ECE 200,007,091009,Dayeh; Shadi Ahmad,9999,0,9999,0
1653445612179,ECE 200,008,091010,Fainman; Yeshaiahu,9999,0,9999,0
1653445612179,ECE 200,009,091011,Ford; Joseph Earl,9999,0,9999,0
1653445612179,ECE 200,010,091012,Franceschetti; Massimo,9999,0,9999,0
1653445612179,ECE 200,011,091013,Fullerton; Eric E,9999,0,9999,0
1653445612179,ECE 200,012,091014,Galton; Ian A,9999,0,9999,0
1653445612179,ECE 200,013,091015,Gilja; Vikash,9999,0,9999,0
1653445612179,ECE 200,014,091016,Hall; Drew A.,9999,0,9999,0
1653445612179,ECE 200,015,091017,Hsueh; Tzu-Chien,9999,0,9999,0
1653445612179,ECE 200,016,091018,Javidi; Tara,9999,0,9999,0
1653445612179,ECE 200,017,091019,Kahng; Andrew Byun,9999,0,9999,0
1653445612179,ECE 200,018,091020,Kim; Young-Han,9999,0,9999,0
1653445612179,ECE 200,019,091021,Koushanfar; Farinaz,9999,0,9999,0
1653445612179,ECE 200,020,091022,Kuzum; Duygu,9999,0,9999,0
1653445612179,ECE 200,021,091023,Le; Hanh-Phuc,9999,0,9999,0
1653445612179,ECE 200,022,091024,Lin; Bill,9999,0,9999,0
1653445612179,ECE 200,023,091025,Liu; Zhaowei,9999,0,9999,0
1653445612179,ECE 200,024,091026,Lo; Yu-Hwa,9999,0,9999,0
1653445612179,ECE 200,025,091027,Lomakin; Vitaliy,9999,0,9999,0
1653445612179,ECE 200,026,091028,Mercier; Patrick Philip,9999,0,9999,0
1653445612179,ECE 200,027,091029,Meyer; Florian,9999,0,9999,0
1653445612179,ECE 200,028,091030,Milstein; Laurence B.,9999,0,9999,0
1653445612179,ECE 200,029,091031,Mir Arabbaygi; Siavash,9999,0,9999,0
1653445612179,ECE 200,030,091032,Mookherjea; Shayan,9999,0,9999,0
1653445612179,ECE 200,031,091033,Morris; Karcher William,9999,0,9999,0
1653445612179,ECE 200,032,091034,Ng; Tse Nga,9999,0,9999,0
1653445612179,ECE 200,033,091035,Nguyen; Truong Quang,9999,0,9999,0
1653445612179,ECE 200,034,091036,Nomura; Kenji,9999,0,9999,0
1653445612179,ECE 200,035,091037,Orlitsky; Alon,9999,0,9999,0
1653445612179,ECE 200,036,091038,Pal; Piya,9999,0,9999,0
1653445612179,ECE 200,037,091039,Papen; George C.,9999,0,9999,0
1653445612179,ECE 200,038,091040,Radic; Stojan,9999,0,9999,0
1653445612179,ECE 200,039,091041,Rao; Bhaskar D.,9999,0,9999,0
1653445612179,ECE 200,040,091042,Rao; Ramesh R,9999,0,9999,0
1653445612179,ECE 200,041,091043,Rebeiz; Gabriel,9999,0,9999,0
1653445612179,ECE 200,042,091044,Sanford; John R,9999,0,9999,0
1653445612179,ECE 200,043,091045,Siegel; Paul H.,9999,0,9999,0
1653445612179,ECE 200,044,091046,Sievenpiper; Daniel F.,9999,0,9999,0
1653445612179,ECE 200,045,091047,Sworder; David D.,9999,0,9999,0
1653445612179,ECE 200,046,091048,Taur; Yuan,9999,0,9999,0
1653445612179,ECE 200,047,091049,Touri; Behrouz,9999,0,9999,0
1653445612179,ECE 200,048,091050,Trivedi; Mohan M.,9999,0,9999,0
1653445612179,ECE 200,049,091051,Vardy; Alexander,9999,0,9999,0
1653445612179,ECE 200,050,091052,Vasconcelos; Nuno,9999,0,9999,0
1653445612179,ECE 200,051,091053,Wang; Xiaolong,9999,0,9999,0
1653445612179,ECE 200,052,091054,Xie; Pengtao,9999,0,9999,0
1653445612179,ECE 200,053,091055,Yip; Michael,9999,0,9999,0
1653445612179,ECE 200,054,091056,Zeger; Kenneth A.,9999,0,9999,0
1653445612179,ECE 200,055,091057,Zhang; Xinyu,9999,0,9999,0
1653445612179,ECE 200,056,091058,Turakhia; Yatish Girish,9999,0,9999,0
1653445612179,ECE 200,057,091059,Kang; Mingu,9999,0,9999,0
1653445612179,ECE 200,058,091060,Shi; Yuanyuan,9999,0,9999,0
1653445612179,ECE 200,059,091061,Wang; Edward Jay,9999,0,9999,0
1653445612179,ECE 200,060,091062,Zheng; Yang,9999,0,9999,0
1653445612706,ECE 203,A00,091065,Mercier; Patrick Philip,0,0,0,0
1653445613228,ECE 207A,A00,091605,Liu; Thomas Tao-Ming,0,0,0,0
1653445613760,ECE 212AN,A00,091068,Nomura; Kenji,0,0,0,0
1653445614285,ECE 222A,A00,091069,Rebeiz; Gabriel,0,0,0,0
1653445614808,ECE 225A,A00,091070,Orlitsky; Alon,0,0,0,0
1653445615333,ECE 230A,A00,091071,Nomura; Kenji,0,0,0,0
1653445615856,ECE 236A,A00,091072,Dayeh; Shadi Ahmad,0,0,0,0
1653445616379,ECE 238A,A00,091073,Luo; Jian,0,0,0,0
1653445616379,ECE 238A,B00,091074,Luo; Jian,0,0,0,0
1653445616908,ECE 240A,A00,091075,Radic; Stojan,0,0,0,0
1653445617429,ECE 247A,A00,091592,Shi; Lingyan,0,0,0,0
1653445617969,ECE 250,A00,091076,Touri; Behrouz,0,0,0,0
1653445618500,ECE 251C,A00,091078,Nguyen; Truong Quang,0,0,0,0
1653445619024,ECE 253,A00,091079,Cosman; Pamela C.,0,0,0,0
1653445619560,ECE 255A,A00,091080,Orlitsky; Alon,0,0,0,0
1653445620091,ECE 257A,A00,091081,Zhang; Xinyu,0,0,0,0
1653445620620,ECE 260A,A01,091084,Eldon; John,0,0,0,0
1653445621224,ECE 264C,A00,091085,Galton; Ian A,0,0,0,0
1653445621746,ECE 265C,A00,094889,Presti; Calogero Davide,0,0,0,9
1653445622273,ECE 266,A01,091087,Hall; Drew A.,0,0,0,0
1653445623337,ECE 271A,A00,091090,Vasconcelos; Nuno,0,0,0,0
1653445623894,ECE 272B,A00,091091,Sworder; David D.,0,0,0,0
1653445624421,ECE 275A,A00,091092,Meyer; Florian,0,0,0,0
1653445624948,ECE 277,A00,091093,An; Cheolhong,0,0,0,0
1653445625470,ECE 283,A00,091094,Le; Hanh-Phuc,0,0,0,0
1653445625993,ECE 284,A00,091095,Kang; Mingu,0,0,0,0
1653445625993,ECE 284,B00,091096,Wang; Edward Jay,0,0,0,0
1653445626519,ECE 285,A00,094334,Touri; Behrouz,0,0,0,0
1653445627043,ECE 289,A00,091097,Whelan; David Arthur,0,0,0,0
1653445627566,MATH 200A,A00,087414,Salehi Golsefidy; Alireza,7,0,8,1
1653445628090,MATH 202A,A00,087415,Gill; Philip E.,3,0,8,5
1653445628612,MATH 203A,A00,087416,Oprea; Dragos N.,6,0,8,2
1653445629134,MATH 204A,A00,087417,Kedlaya; Kiran S.,6,0,8,2
1653445629661,MATH 205,A00,087418,Sorensen; Claus M,6,0,8,2
1653445630183,MATH 206A,A00,087419,Izadi; Elham,7,0,8,1
1653445630708,MATH 207A,A00,087420,Mohammadi; Amir,6,0,8,2
1653445631232,MATH 208,A00,087421,Staff,9,0,10,1
1653445631755,MATH 209,A00,087422,Staff,10,0,10,0
1653445632279,MATH 218,A00,087423,Staff,10,0,10,0
1653445632806,MATH 220A,A00,087424,Novak; Jonathan I,7,0,8,1
1653445633335,MATH 231A,A00,087425,Bejenaru; Ioan,4,0,8,4
1653445633860,MATH 240A,A00,087426,Ebenfelt; Peter F,5,0,8,3
1653445634380,MATH 243,A00,087427,Staff,9,0,10,1
1653445634902,MATH 248,A00,087429,Staff,10,0,10,0
1653445635423,MATH 250A,A00,087430,Spolaor; Luca,4,0,8,4
1653445635945,MATH 257A,A00,087431,Spolaor; Luca,7,0,8,1
1653445636480,MATH 258,A00,087432,Staff,9,0,10,1
1653445637003,MATH 264A,A00,087433,Warnke; Lutz Peter,5,0,8,3
1653445637526,MATH 268,A00,087434,Staff,15,0,15,0
1653445638050,MATH 269,A00,087435,Staff,14,0,15,1
1653445638575,MATH 270A,A00,087436,Nie; Jiawang,0,0,8,8
1653445639108,MATH 272A,A00,087437,Tian; Xiaochuan,1,0,8,7
1653445639634,MATH 274,A01,087439,Cheng; Li-Tien,9,0,10,1
1653445639634,MATH 274,A02,087440,Cheng; Li-Tien,10,0,10,0
1653445640165,MATH 278A,A00,087441,Staff,8,0,10,2
1653445640687,MATH 278B,A00,087442,Staff,8,0,10,2
1653445641210,MATH 278C,A00,087443,Staff,8,0,10,2
1653445641734,MATH 280A,A00,087444,Zheng; Tianyi,0,0,8,8
1653445642257,MATH 281A,A00,087445,Bradic; Jelena,0,0,8,8
1653445642780,MATH 282A,A00,087446,Zhang; Danna,0,0,8,8
1653445643304,MATH 283,A00,087447,Tesler; Glenn,0,0,0,14
1653445643841,MATH 286,A00,087448,Kemp; Todd Aahron,6,0,8,2
1653445644363,MATH 287D,A00,087449,Bradic; Jelena,8,0,8,0
1653445644893,MATH 288,A00,087450,Staff,14,0,15,1
1653445644893,MATH 288,B00,087451,Staff,15,0,15,0
1653445644893,MATH 288,C00,087452,Staff,15,0,15,0
1653445645416,MATH 290A,A00,087453,Xu; Zhouli,7,0,8,1
1653445645942,MATH 291A,A00,087454,Xu; Zhouli,7,0,8,1
1653445646465,MATH 292,A00,087455,Staff,10,0,10,0
1653445646992,MATH 295,A00,087456,Staff,50,0,50,0
1653445647514,MATH 297,001,087457,Staff,998,0,999,1
1653446220726,COGS 200,A01,087991,Staff,47,0,50,3
1653446221258,COGS 201,A01,094504,Rangel; Lara M,17,0,25,8
1653446221863,COGS 203,A00,087992,Coulson; Seana M,18,0,20,2
1653446222387,COGS 210A,001,087993,Greene; Deanna Jacquelyn,9998,0,9999,1
1653446222387,COGS 210A,002,087994,Saygin; Ayse P,9999,0,9999,0
1653446222387,COGS 210A,003,087995,Xia; Haijun,9999,0,9999,0
1653446222387,COGS 210A,004,087996,Nitz; Douglas A.,9999,0,9999,0
1653446222387,COGS 210A,005,087997,Hollan; James D.,9999,0,9999,0
1653446222387,COGS 210A,006,087998,Deak; Gedeon O.,9998,0,9999,1
1653446222387,COGS 210A,007,087999,Rossano; Federico,9999,0,9999,0
1653446222920,COGS 211A,A00,088000,Coulson; Seana M,9997,0,9999,2
1653446223460,COGS 229,A00,088002,Staff,23,0,25,2
1653446223983,COGS 260,B00,094231,Staff,17,0,20,3
1653446223983,COGS 260,A00,088004,Nitz; Douglas A.,9998,0,9999,1
1653446224519,CSE 202,A00,090110,Paturi; Ramamohan,0,0,0,0
1653446224519,CSE 202,B00,090111,Paturi; Ramamohan,0,0,0,0
1653446225045,CSE 207B,A00,090112,Heninger; Nadia A,0,0,0,0
1653446225572,CSE 208,A00,094858,Micciancio; Daniele,0,0,0,0
1653446226095,CSE 210,A00,090113,Powell; Thomas Allan,0,0,0,0
1653446226620,CSE 219,A00,090898,Staff,0,0,0,0
1653446227143,CSE 221,A00,090114,Zhou; Yuan-Yuan,0,0,0,0
1653446227665,CSE 229A,A00,090115,Porter; George M,0,0,0,0
1653446228188,CSE 229C,A00,090116,Savage; Stefan,0,0,0,0
1653446228714,CSE 230,A00,090117,Jhala; Ranjit,0,0,0,0
1653446229245,CSE 232,A00,090118,Papakonstantinou; Yannis,0,0,0,0
1653446229771,CSE 239A,A00,090121,Kumar; Arun Kumar,0,0,0,0
1653446230296,CSE 239B,A00,090122,Jhala; Ranjit,0,0,0,0
1653446230819,CSE 240A,A00,090123,Zhao; Jishen,0,0,189,189
1653446231342,CSE 243A,A00,090124,Orailoglu; Alex,1,0,15,14
1653446231868,CSE 249B,A00,090125,Kahng; Andrew Byun,13,0,20,7
1653446232391,CSE 250A,A00,090126,Berg-Kirkpatrick; Taylor D,0,0,0,0
1653446232928,CSE 252A,A00,090127,Ochoa; Benjamin Lawrence,0,0,0,0
1653446233453,CSE 258,A01,090129,McAuley; Julian John,0,0,0,0
1653446233975,CSE 258R,A01,090131,McAuley; Julian John,0,0,0,0
1653446234500,CSE 274,A00,090132,Ramamoorthi; Ravi,0,0,0,0
1653446235027,CSE 276A,A00,090133,Christensen; Henrik I,0,0,0,0
1653446235550,CSE 276C,A00,090134,Christensen; Henrik I,0,0,0,0
1653446236078,CSE 290,A00,090135,Bafna; Vineet,0,0,0,0
1653446236078,CSE 290,B00,090136,Ramamoorthi; Ravi,0,0,0,0
1653446236078,CSE 290,C00,090137,Li; Tzumao,9,0,10,1
1653446236078,CSE 290,D00,090138,Zhou; Yuan-Yuan,10,0,10,0
1653446236078,CSE 290,E00,090139,Christensen; Henrik I,10,0,10,0
1653446236078,CSE 290,F00,094053,Shalev; Aaron D,0,0,0,0
1653446236605,CSE 291,A00,090140,Munyaka; Imani N. S.,0,0,0,0
1653446236605,CSE 291,B00,094880,Yu; Qi,0,0,0,0
1653446236605,CSE 291,C00,090142,Pannuto; Patrick William,0,0,0,0
1653446236605,CSE 291,D00,094881,Zhang; Yiying,0,0,0,0
1653446236605,CSE 291,E00,095118,Su; Hao,0,0,0,0
1653446237130,CSE 293,001,094905,Bafna; Vineet,9999,0,9999,0
1653446237130,CSE 293,002,094906,Bellare; Mihir,9999,0,9999,0
1653446237130,CSE 293,003,094907,Berg-Kirkpatrick; Taylor D,9999,0,9999,0
1653446237130,CSE 293,004,094908,Christensen; Henrik I,9999,0,9999,0
1653446237130,CSE 293,005,094909,Cottrell; Garrison W,9999,0,9999,0
1653446237130,CSE 293,006,094910,Deutsch; Alin Bernard,9999,0,9999,0
1653446237130,CSE 293,007,094911,Esmaeilzadeh; Hadi,9999,0,9999,0
1653446237130,CSE 293,008,094912,Freund; Yoav,9999,0,9999,0
1653446237130,CSE 293,009,094913,Griswold; William G.,9999,0,9999,0
1653446237130,CSE 293,010,094914,Gymrek; Melissa Ann,9999,0,9999,0
1653446237130,CSE 293,011,094915,Heninger; Nadia A,9999,0,9999,0
1653446237130,CSE 293,012,094916,Impagliazzo; Russell,9999,0,9999,0
1653446237130,CSE 293,013,094917,Jhala; Ranjit,9999,0,9999,0
1653446237130,CSE 293,014,094918,Kahng; Andrew Byun,9999,0,9999,0
1653446237130,CSE 293,015,094919,Kane; Daniel Mertz,9999,0,9999,0
1653446237130,CSE 293,016,094920,Kriegman; David J,9999,0,9999,0
1653446237130,CSE 293,017,094921,Kumar; Arun Kumar,9999,0,9999,0
1653446237130,CSE 293,018,094922,Lerner; Sorin,9999,0,9999,0
1653446237130,CSE 293,019,094923,Lovett; Shachar,9999,0,9999,0
1653446237130,CSE 293,020,094924,McAuley; Julian John,9999,0,9999,0
1653446237130,CSE 293,021,094925,Micciancio; Daniele,9999,0,9999,0
1653446237130,CSE 293,022,094926,Orailoglu; Alex,9999,0,9999,0
1653446237130,CSE 293,023,094927,Paturi; Ramamohan,9999,0,9999,0
1653446237130,CSE 293,024,094928,Polikarpova; Nadezhda,9999,0,9999,0
1653446237130,CSE 293,025,094929,Politz; Joseph Gibbs,9999,0,9999,0
1653446237130,CSE 293,026,094930,Porter; George M,9999,0,9999,0
1653446237130,CSE 293,027,094931,Porter; Leonard Emerson,9999,0,9999,0
1653446237130,CSE 293,028,094932,Ramamoorthi; Ravi,9999,0,9999,0
1653446237130,CSE 293,029,094933,Sahoo; Debashis,9999,0,9999,0
1653446237130,CSE 293,030,094934,Saul; Lawrence,9999,0,9999,0
1653446237130,CSE 293,031,094935,Savage; Stefan,9999,0,9999,0
1653446237130,CSE 293,032,094936,Schulze; Jurgen P.,9999,0,9999,0
1653446237130,CSE 293,033,094937,Snoeren; Alex C.,9999,0,9999,0
1653446237130,CSE 293,034,094938,Shang; Jingbo,9999,0,9999,0
1653446237130,CSE 293,035,094939,Stefan; Deian,9999,0,9999,0
1653446237130,CSE 293,036,094940,Su; Hao,9999,0,9999,0
1653446237130,CSE 293,037,094941,Swanson; Steven James,9999,0,9999,0
1653446237130,CSE 293,038,094942,Tullsen; Dean Michael,9999,0,9999,0
1653446237130,CSE 293,039,094943,Voelker; Geoffrey M.,9999,0,9999,0
1653446237130,CSE 293,040,094944,Zhao; Jishen,9999,0,9999,0
1653446237130,CSE 293,041,094945,Zhou; Yuan-Yuan,9999,0,9999,0
1653446237130,CSE 293,042,094946,Gao; Sicun,9998,0,9999,1
1653446237130,CSE 293,043,094947,Weibel; Nadir,9999,0,9999,0
1653446237130,CSE 293,044,094948,Gupta; Rajesh K.,9999,0,9999,0
1653446237655,CSE 294,A00,090143,Porter; George M,9,0,10,1
1653446238185,DSE 200,A00,091799,Staff,50,0,50,0
1653446238709,DSE 203,A00,091800,Gupta; Amarnath,30,0,30,0
1653446239238,DSE 250,A00,091801,Deutsch; Alin Bernard,30,0,30,0
1653446239760,DSE 290,A00,091802,Altintas De Callaf; Ilkay,50,0,50,0
1653446240287,ECE 200,001,091003,Antipa; Nicholas A,9999,0,9999,0
1653446240287,ECE 200,002,091004,Atanasov; Nikolay A.,9999,0,9999,0
1653446240287,ECE 200,003,091005,Bharadia; Dinesh,9999,0,9999,0
1653446240287,ECE 200,004,091006,Cheng; Chung Kuan,9999,0,9999,0
1653446240287,ECE 200,005,091007,Cosman; Pamela C.,9999,0,9999,0
1653446240287,ECE 200,006,091008,Staff,9999,0,9999,0
1653446240287,ECE 200,007,091009,Dayeh; Shadi Ahmad,9999,0,9999,0
1653446240287,ECE 200,008,091010,Fainman; Yeshaiahu,9999,0,9999,0
1653446240287,ECE 200,009,091011,Ford; Joseph Earl,9999,0,9999,0
1653446240287,ECE 200,010,091012,Franceschetti; Massimo,9999,0,9999,0
1653446240287,ECE 200,011,091013,Fullerton; Eric E,9999,0,9999,0
1653446240287,ECE 200,012,091014,Galton; Ian A,9999,0,9999,0
1653446240287,ECE 200,013,091015,Gilja; Vikash,9999,0,9999,0
1653446240287,ECE 200,014,091016,Hall; Drew A.,9999,0,9999,0
1653446240287,ECE 200,015,091017,Hsueh; Tzu-Chien,9999,0,9999,0
1653446240287,ECE 200,016,091018,Javidi; Tara,9999,0,9999,0
1653446240287,ECE 200,017,091019,Kahng; Andrew Byun,9999,0,9999,0
1653446240287,ECE 200,018,091020,Kim; Young-Han,9999,0,9999,0
1653446240287,ECE 200,019,091021,Koushanfar; Farinaz,9999,0,9999,0
1653446240287,ECE 200,020,091022,Kuzum; Duygu,9999,0,9999,0
1653446240287,ECE 200,021,091023,Le; Hanh-Phuc,9999,0,9999,0
1653446240287,ECE 200,022,091024,Lin; Bill,9999,0,9999,0
1653446240287,ECE 200,023,091025,Liu; Zhaowei,9999,0,9999,0
1653446240287,ECE 200,024,091026,Lo; Yu-Hwa,9999,0,9999,0
1653446240287,ECE 200,025,091027,Lomakin; Vitaliy,9999,0,9999,0
1653446240287,ECE 200,026,091028,Mercier; Patrick Philip,9999,0,9999,0
1653446240287,ECE 200,027,091029,Meyer; Florian,9999,0,9999,0
1653446240287,ECE 200,028,091030,Milstein; Laurence B.,9999,0,9999,0
1653446240287,ECE 200,029,091031,Mir Arabbaygi; Siavash,9999,0,9999,0
1653446240287,ECE 200,030,091032,Mookherjea; Shayan,9999,0,9999,0
1653446240287,ECE 200,031,091033,Morris; Karcher William,9999,0,9999,0
1653446240287,ECE 200,032,091034,Ng; Tse Nga,9999,0,9999,0
1653446240287,ECE 200,033,091035,Nguyen; Truong Quang,9999,0,9999,0
1653446240287,ECE 200,034,091036,Nomura; Kenji,9999,0,9999,0
1653446240287,ECE 200,035,091037,Orlitsky; Alon,9999,0,9999,0
1653446240287,ECE 200,036,091038,Pal; Piya,9999,0,9999,0
1653446240287,ECE 200,037,091039,Papen; George C.,9999,0,9999,0
1653446240287,ECE 200,038,091040,Radic; Stojan,9999,0,9999,0
1653446240287,ECE 200,039,091041,Rao; Bhaskar D.,9999,0,9999,0
1653446240287,ECE 200,040,091042,Rao; Ramesh R,9999,0,9999,0
1653446240287,ECE 200,041,091043,Rebeiz; Gabriel,9999,0,9999,0
1653446240287,ECE 200,042,091044,Sanford; John R,9999,0,9999,0
1653446240287,ECE 200,043,091045,Siegel; Paul H.,9999,0,9999,0
1653446240287,ECE 200,044,091046,Sievenpiper; Daniel F.,9999,0,9999,0
1653446240287,ECE 200,045,091047,Sworder; David D.,9999,0,9999,0
1653446240287,ECE 200,046,091048,Taur; Yuan,9999,0,9999,0
1653446240287,ECE 200,047,091049,Touri; Behrouz,9999,0,9999,0
1653446240287,ECE 200,048,091050,Trivedi; Mohan M.,9999,0,9999,0
1653446240287,ECE 200,049,091051,Vardy; Alexander,9999,0,9999,0
1653446240287,ECE 200,050,091052,Vasconcelos; Nuno,9999,0,9999,0
1653446240287,ECE 200,051,091053,Wang; Xiaolong,9999,0,9999,0
1653446240287,ECE 200,052,091054,Xie; Pengtao,9999,0,9999,0
1653446240287,ECE 200,053,091055,Yip; Michael,9999,0,9999,0
1653446240287,ECE 200,054,091056,Zeger; Kenneth A.,9999,0,9999,0
1653446240287,ECE 200,055,091057,Zhang; Xinyu,9999,0,9999,0
1653446240287,ECE 200,056,091058,Turakhia; Yatish Girish,9999,0,9999,0
1653446240287,ECE 200,057,091059,Kang; Mingu,9999,0,9999,0
1653446240287,ECE 200,058,091060,Shi; Yuanyuan,9999,0,9999,0
1653446240287,ECE 200,059,091061,Wang; Edward Jay,9999,0,9999,0
1653446240287,ECE 200,060,091062,Zheng; Yang,9999,0,9999,0
1653446240811,ECE 203,A00,091065,Mercier; Patrick Philip,0,0,0,0
1653446241339,ECE 207A,A00,091605,Liu; Thomas Tao-Ming,0,0,0,0
1653446241871,ECE 212AN,A00,091068,Nomura; Kenji,0,0,0,0
1653446242396,ECE 222A,A00,091069,Rebeiz; Gabriel,0,0,0,0
1653446242930,ECE 225A,A00,091070,Orlitsky; Alon,0,0,0,0
1653446243458,ECE 230A,A00,091071,Nomura; Kenji,0,0,0,0
1653446243989,ECE 236A,A00,091072,Dayeh; Shadi Ahmad,0,0,0,0
1653446244514,ECE 238A,A00,091073,Luo; Jian,0,0,0,0
1653446244514,ECE 238A,B00,091074,Luo; Jian,0,0,0,0
1653446245050,ECE 240A,A00,091075,Radic; Stojan,0,0,0,0
1653446245572,ECE 247A,A00,091592,Shi; Lingyan,0,0,0,0
1653446246095,ECE 250,A00,091076,Touri; Behrouz,0,0,0,0
1653446246645,ECE 251C,A00,091078,Nguyen; Truong Quang,0,0,0,0
1653446247185,ECE 253,A00,091079,Cosman; Pamela C.,0,0,0,0
1653446247714,ECE 255A,A00,091080,Orlitsky; Alon,0,0,0,0
1653446248239,ECE 257A,A00,091081,Zhang; Xinyu,0,0,0,0
1653446248762,ECE 260A,A01,091084,Eldon; John,0,0,0,0
1653446249286,ECE 264C,A00,091085,Galton; Ian A,0,0,0,0
1653446249810,ECE 265C,A00,094889,Presti; Calogero Davide,0,0,0,9
1653446250332,ECE 266,A01,091087,Hall; Drew A.,0,0,0,0
1653446251384,ECE 271A,A00,091090,Vasconcelos; Nuno,0,0,0,0
1653446251907,ECE 272B,A00,091091,Sworder; David D.,0,0,0,0
1653446252435,ECE 275A,A00,091092,Meyer; Florian,0,0,0,0
1653446252957,ECE 277,A00,091093,An; Cheolhong,0,0,0,0
1653446253484,ECE 283,A00,091094,Le; Hanh-Phuc,0,0,0,0
1653446254007,ECE 284,A00,091095,Kang; Mingu,0,0,0,0
1653446254007,ECE 284,B00,091096,Wang; Edward Jay,0,0,0,0
1653446254530,ECE 285,A00,094334,Touri; Behrouz,0,0,0,0
1653446255058,ECE 289,A00,091097,Whelan; David Arthur,0,0,0,0
1653446255594,MATH 200A,A00,087414,Salehi Golsefidy; Alireza,7,0,8,1
1653446256120,MATH 202A,A00,087415,Gill; Philip E.,3,0,8,5
1653446256652,MATH 203A,A00,087416,Oprea; Dragos N.,6,0,8,2
1653446257177,MATH 204A,A00,087417,Kedlaya; Kiran S.,6,0,8,2
1653446257703,MATH 205,A00,087418,Sorensen; Claus M,6,0,8,2
1653446258233,MATH 206A,A00,087419,Izadi; Elham,7,0,8,1
1653446258775,MATH 207A,A00,087420,Mohammadi; Amir,6,0,8,2
1653446259303,MATH 208,A00,087421,Staff,9,0,10,1
1653446259825,MATH 209,A00,087422,Staff,10,0,10,0
1653446260348,MATH 218,A00,087423,Staff,10,0,10,0
1653446260874,MATH 220A,A00,087424,Novak; Jonathan I,7,0,8,1
1653446261398,MATH 231A,A00,087425,Bejenaru; Ioan,4,0,8,4
1653446261922,MATH 240A,A00,087426,Ebenfelt; Peter F,5,0,8,3
1653446262448,MATH 243,A00,087427,Staff,9,0,10,1
1653446262970,MATH 248,A00,087429,Staff,10,0,10,0
1653446263496,MATH 250A,A00,087430,Spolaor; Luca,4,0,8,4
1653446264025,MATH 257A,A00,087431,Spolaor; Luca,7,0,8,1
1653446264550,MATH 258,A00,087432,Staff,9,0,10,1
1653446265086,MATH 264A,A00,087433,Warnke; Lutz Peter,5,0,8,3
1653446265610,MATH 268,A00,087434,Staff,15,0,15,0
1653446266132,MATH 269,A00,087435,Staff,14,0,15,1
1653446266655,MATH 270A,A00,087436,Nie; Jiawang,0,0,8,8
1653446267179,MATH 272A,A00,087437,Tian; Xiaochuan,1,0,8,7
1653446267703,MATH 274,A01,087439,Cheng; Li-Tien,9,0,10,1
1653446267703,MATH 274,A02,087440,Cheng; Li-Tien,10,0,10,0
1653446268227,MATH 278A,A00,087441,Staff,8,0,10,2
1653446268750,MATH 278B,A00,087442,Staff,8,0,10,2
1653446269275,MATH 278C,A00,087443,Staff,8,0,10,2
1653446269799,MATH 280A,A00,087444,Zheng; Tianyi,0,0,8,8
1653446270325,MATH 281A,A00,087445,Bradic; Jelena,0,0,8,8
1653446270846,MATH 282A,A00,087446,Zhang; Danna,0,0,8,8
1653446271369,MATH 283,A00,087447,Tesler; Glenn,0,0,0,14
1653446271902,MATH 286,A00,087448,Kemp; Todd Aahron,6,0,8,2
1653446272432,MATH 287D,A00,087449,Bradic; Jelena,8,0,8,0
1653446272954,MATH 288,A00,087450,Staff,14,0,15,1
1653446272954,MATH 288,B00,087451,Staff,15,0,15,0
1653446272954,MATH 288,C00,087452,Staff,15,0,15,0
1653446273484,MATH 290A,A00,087453,Xu; Zhouli,7,0,8,1
1653446274029,MATH 291A,A00,087454,Xu; Zhouli,7,0,8,1
1653446274555,MATH 292,A00,087455,Staff,10,0,10,0
1653446275174,MATH 295,A00,087456,Staff,50,0,50,0
1653446275699,MATH 297,001,087457,Staff,998,0,999,1
1653446837424,COGS 200,A01,087991,Staff,47,0,50,3
1653446837946,COGS 201,A01,094504,Rangel; Lara M,17,0,25,8
1653446838469,COGS 203,A00,087992,Coulson; Seana M,18,0,20,2
1653446838996,COGS 210A,001,087993,Greene; Deanna Jacquelyn,9998,0,9999,1
1653446838996,COGS 210A,002,087994,Saygin; Ayse P,9999,0,9999,0
1653446838996,COGS 210A,003,087995,Xia; Haijun,9999,0,9999,0
1653446838996,COGS 210A,004,087996,Nitz; Douglas A.,9999,0,9999,0
1653446838996,COGS 210A,005,087997,Hollan; James D.,9999,0,9999,0
1653446838996,COGS 210A,006,087998,Deak; Gedeon O.,9998,0,9999,1
1653446838996,COGS 210A,007,087999,Rossano; Federico,9999,0,9999,0
1653446839518,COGS 211A,A00,088000,Coulson; Seana M,9997,0,9999,2
1653446840041,COGS 229,A00,088002,Staff,23,0,25,2
1653446840564,COGS 260,B00,094231,Staff,17,0,20,3
1653446840564,COGS 260,A00,088004,Nitz; Douglas A.,9998,0,9999,1
1653446841090,CSE 202,A00,090110,Paturi; Ramamohan,0,0,0,0
1653446841090,CSE 202,B00,090111,Paturi; Ramamohan,0,0,0,0
1653446841624,CSE 207B,A00,090112,Heninger; Nadia A,0,0,0,0
1653446842150,CSE 208,A00,094858,Micciancio; Daniele,0,0,0,0
1653446842674,CSE 210,A00,090113,Powell; Thomas Allan,0,0,0,0
1653446843198,CSE 219,A00,090898,Staff,0,0,0,0
1653446843722,CSE 221,A00,090114,Zhou; Yuan-Yuan,0,0,0,0
1653446844252,CSE 229A,A00,090115,Porter; George M,0,0,0,0
1653446844773,CSE 229C,A00,090116,Savage; Stefan,0,0,0,0
1653446845299,CSE 230,A00,090117,Jhala; Ranjit,0,0,0,0
1653446845834,CSE 232,A00,090118,Papakonstantinou; Yannis,0,0,0,0
1653446846356,CSE 239A,A00,090121,Kumar; Arun Kumar,0,0,0,0
1653446846881,CSE 239B,A00,090122,Jhala; Ranjit,0,0,0,0
1653446847404,CSE 240A,A00,090123,Zhao; Jishen,0,0,189,189
1653446847932,CSE 243A,A00,090124,Orailoglu; Alex,1,0,15,14
1653446848471,CSE 249B,A00,090125,Kahng; Andrew Byun,13,0,20,7
1653446849007,CSE 250A,A00,090126,Berg-Kirkpatrick; Taylor D,0,0,0,0
1653446849537,CSE 252A,A00,090127,Ochoa; Benjamin Lawrence,0,0,0,0
1653446850065,CSE 258,A01,090129,McAuley; Julian John,0,0,0,0
1653446850588,CSE 258R,A01,090131,McAuley; Julian John,0,0,0,0
1653446851114,CSE 274,A00,090132,Ramamoorthi; Ravi,0,0,0,0
1653446851637,CSE 276A,A00,090133,Christensen; Henrik I,0,0,0,0
1653446852159,CSE 276C,A00,090134,Christensen; Henrik I,0,0,0,0
1653446852681,CSE 290,A00,090135,Bafna; Vineet,0,0,0,0
1653446852681,CSE 290,B00,090136,Ramamoorthi; Ravi,0,0,0,0
1653446852681,CSE 290,C00,090137,Li; Tzumao,9,0,10,1
1653446852681,CSE 290,D00,090138,Zhou; Yuan-Yuan,10,0,10,0
1653446852681,CSE 290,E00,090139,Christensen; Henrik I,10,0,10,0
1653446852681,CSE 290,F00,094053,Shalev; Aaron D,0,0,0,0
1653446853230,CSE 291,A00,090140,Munyaka; Imani N. S.,0,0,0,0
1653446853230,CSE 291,B00,094880,Yu; Qi,0,0,0,0
1653446853230,CSE 291,C00,090142,Pannuto; Patrick William,0,0,0,0
1653446853230,CSE 291,D00,094881,Zhang; Yiying,0,0,0,0
1653446853230,CSE 291,E00,095118,Su; Hao,0,0,0,0
1653446853763,CSE 293,001,094905,Bafna; Vineet,9999,0,9999,0
1653446853763,CSE 293,002,094906,Bellare; Mihir,9999,0,9999,0
1653446853763,CSE 293,003,094907,Berg-Kirkpatrick; Taylor D,9999,0,9999,0
1653446853763,CSE 293,004,094908,Christensen; Henrik I,9999,0,9999,0
1653446853763,CSE 293,005,094909,Cottrell; Garrison W,9999,0,9999,0
1653446853763,CSE 293,006,094910,Deutsch; Alin Bernard,9999,0,9999,0
1653446853763,CSE 293,007,094911,Esmaeilzadeh; Hadi,9999,0,9999,0
1653446853763,CSE 293,008,094912,Freund; Yoav,9999,0,9999,0
1653446853763,CSE 293,009,094913,Griswold; William G.,9999,0,9999,0
1653446853763,CSE 293,010,094914,Gymrek; Melissa Ann,9999,0,9999,0
1653446853763,CSE 293,011,094915,Heninger; Nadia A,9999,0,9999,0
1653446853763,CSE 293,012,094916,Impagliazzo; Russell,9999,0,9999,0
1653446853763,CSE 293,013,094917,Jhala; Ranjit,9999,0,9999,0
1653446853763,CSE 293,014,094918,Kahng; Andrew Byun,9999,0,9999,0
1653446853763,CSE 293,015,094919,Kane; Daniel Mertz,9999,0,9999,0
1653446853763,CSE 293,016,094920,Kriegman; David J,9999,0,9999,0
1653446853763,CSE 293,017,094921,Kumar; Arun Kumar,9999,0,9999,0
1653446853763,CSE 293,018,094922,Lerner; Sorin,9999,0,9999,0
1653446853763,CSE 293,019,094923,Lovett; Shachar,9999,0,9999,0
1653446853763,CSE 293,020,094924,McAuley; Julian John,9999,0,9999,0
1653446853763,CSE 293,021,094925,Micciancio; Daniele,9999,0,9999,0
1653446853763,CSE 293,022,094926,Orailoglu; Alex,9999,0,9999,0
1653446853763,CSE 293,023,094927,Paturi; Ramamohan,9999,0,9999,0
1653446853763,CSE 293,024,094928,Polikarpova; Nadezhda,9999,0,9999,0
1653446853763,CSE 293,025,094929,Politz; Joseph Gibbs,9999,0,9999,0
1653446853763,CSE 293,026,094930,Porter; George M,9999,0,9999,0
1653446853763,CSE 293,027,094931,Porter; Leonard Emerson,9999,0,9999,0
1653446853763,CSE 293,028,094932,Ramamoorthi; Ravi,9999,0,9999,0
1653446853763,CSE 293,029,094933,Sahoo; Debashis,9999,0,9999,0
1653446853763,CSE 293,030,094934,Saul; Lawrence,9999,0,9999,0
1653446853763,CSE 293,031,094935,Savage; Stefan,9999,0,9999,0
1653446853763,CSE 293,032,094936,Schulze; Jurgen P.,9999,0,9999,0
1653446853763,CSE 293,033,094937,Snoeren; Alex C.,9999,0,9999,0
1653446853763,CSE 293,034,094938,Shang; Jingbo,9999,0,9999,0
1653446853763,CSE 293,035,094939,Stefan; Deian,9999,0,9999,0
1653446853763,CSE 293,036,094940,Su; Hao,9999,0,9999,0
1653446853763,CSE 293,037,094941,Swanson; Steven James,9999,0,9999,0
1653446853763,CSE 293,038,094942,Tullsen; Dean Michael,9999,0,9999,0
1653446853763,CSE 293,039,094943,Voelker; Geoffrey M.,9999,0,9999,0
1653446853763,CSE 293,040,094944,Zhao; Jishen,9999,0,9999,0
1653446853763,CSE 293,041,094945,Zhou; Yuan-Yuan,9999,0,9999,0
1653446853763,CSE 293,042,094946,Gao; Sicun,9998,0,9999,1
1653446853763,CSE 293,043,094947,Weibel; Nadir,9999,0,9999,0
1653446853763,CSE 293,044,094948,Gupta; Rajesh K.,9999,0,9999,0
1653446854289,CSE 294,A00,090143,Porter; George M,9,0,10,1
1653446854812,DSE 200,A00,091799,Staff,50,0,50,0
1653446855335,DSE 203,A00,091800,Gupta; Amarnath,30,0,30,0
1653446855857,DSE 250,A00,091801,Deutsch; Alin Bernard,30,0,30,0
1653446856398,DSE 290,A00,091802,Altintas De Callaf; Ilkay,50,0,50,0
1653446856925,ECE 200,001,091003,Antipa; Nicholas A,9999,0,9999,0
1653446856925,ECE 200,002,091004,Atanasov; Nikolay A.,9999,0,9999,0
1653446856925,ECE 200,003,091005,Bharadia; Dinesh,9999,0,9999,0
1653446856925,ECE 200,004,091006,Cheng; Chung Kuan,9999,0,9999,0
1653446856925,ECE 200,005,091007,Cosman; Pamela C.,9999,0,9999,0
1653446856925,ECE 200,006,091008,Staff,9999,0,9999,0
1653446856925,ECE 200,007,091009,Dayeh; Shadi Ahmad,9999,0,9999,0
1653446856925,ECE 200,008,091010,Fainman; Yeshaiahu,9999,0,9999,0
1653446856925,ECE 200,009,091011,Ford; Joseph Earl,9999,0,9999,0
1653446856925,ECE 200,010,091012,Franceschetti; Massimo,9999,0,9999,0
1653446856925,ECE 200,011,091013,Fullerton; Eric E,9999,0,9999,0
1653446856925,ECE 200,012,091014,Galton; Ian A,9999,0,9999,0
1653446856925,ECE 200,013,091015,Gilja; Vikash,9999,0,9999,0
1653446856925,ECE 200,014,091016,Hall; Drew A.,9999,0,9999,0
1653446856925,ECE 200,015,091017,Hsueh; Tzu-Chien,9999,0,9999,0
1653446856925,ECE 200,016,091018,Javidi; Tara,9999,0,9999,0
1653446856925,ECE 200,017,091019,Kahng; Andrew Byun,9999,0,9999,0
1653446856925,ECE 200,018,091020,Kim; Young-Han,9999,0,9999,0
1653446856925,ECE 200,019,091021,Koushanfar; Farinaz,9999,0,9999,0
1653446856925,ECE 200,020,091022,Kuzum; Duygu,9999,0,9999,0
1653446856925,ECE 200,021,091023,Le; Hanh-Phuc,9999,0,9999,0
1653446856925,ECE 200,022,091024,Lin; Bill,9999,0,9999,0
1653446856925,ECE 200,023,091025,Liu; Zhaowei,9999,0,9999,0
1653446856925,ECE 200,024,091026,Lo; Yu-Hwa,9999,0,9999,0
1653446856925,ECE 200,025,091027,Lomakin; Vitaliy,9999,0,9999,0
1653446856925,ECE 200,026,091028,Mercier; Patrick Philip,9999,0,9999,0
1653446856925,ECE 200,027,091029,Meyer; Florian,9999,0,9999,0
1653446856925,ECE 200,028,091030,Milstein; Laurence B.,9999,0,9999,0
1653446856925,ECE 200,029,091031,Mir Arabbaygi; Siavash,9999,0,9999,0
1653446856925,ECE 200,030,091032,Mookherjea; Shayan,9999,0,9999,0
1653446856925,ECE 200,031,091033,Morris; Karcher William,9999,0,9999,0
1653446856925,ECE 200,032,091034,Ng; Tse Nga,9999,0,9999,0
1653446856925,ECE 200,033,091035,Nguyen; Truong Quang,9999,0,9999,0
1653446856925,ECE 200,034,091036,Nomura; Kenji,9999,0,9999,0
1653446856925,ECE 200,035,091037,Orlitsky; Alon,9999,0,9999,0
1653446856925,ECE 200,036,091038,Pal; Piya,9999,0,9999,0
1653446856925,ECE 200,037,091039,Papen; George C.,9999,0,9999,0
1653446856925,ECE 200,038,091040,Radic; Stojan,9999,0,9999,0
1653446856925,ECE 200,039,091041,Rao; Bhaskar D.,9999,0,9999,0
1653446856925,ECE 200,040,091042,Rao; Ramesh R,9999,0,9999,0
1653446856925,ECE 200,041,091043,Rebeiz; Gabriel,9999,0,9999,0
1653446856925,ECE 200,042,091044,Sanford; John R,9999,0,9999,0
1653446856925,ECE 200,043,091045,Siegel; Paul H.,9999,0,9999,0
1653446856925,ECE 200,044,091046,Sievenpiper; Daniel F.,9999,0,9999,0
1653446856925,ECE 200,045,091047,Sworder; David D.,9999,0,9999,0
1653446856925,ECE 200,046,091048,Taur; Yuan,9999,0,9999,0
1653446856925,ECE 200,047,091049,Touri; Behrouz,9999,0,9999,0
1653446856925,ECE 200,048,091050,Trivedi; Mohan M.,9999,0,9999,0
1653446856925,ECE 200,049,091051,Vardy; Alexander,9999,0,9999,0
1653446856925,ECE 200,050,091052,Vasconcelos; Nuno,9999,0,9999,0
1653446856925,ECE 200,051,091053,Wang; Xiaolong,9999,0,9999,0
1653446856925,ECE 200,052,091054,Xie; Pengtao,9999,0,9999,0
1653446856925,ECE 200,053,091055,Yip; Michael,9999,0,9999,0
1653446856925,ECE 200,054,091056,Zeger; Kenneth A.,9999,0,9999,0
1653446856925,ECE 200,055,091057,Zhang; Xinyu,9999,0,9999,0
1653446856925,ECE 200,056,091058,Turakhia; Yatish Girish,9999,0,9999,0
1653446856925,ECE 200,057,091059,Kang; Mingu,9999,0,9999,0
1653446856925,ECE 200,058,091060,Shi; Yuanyuan,9999,0,9999,0
1653446856925,ECE 200,059,091061,Wang; Edward Jay,9999,0,9999,0
1653446856925,ECE 200,060,091062,Zheng; Yang,9999,0,9999,0
1653446857460,ECE 203,A00,091065,Mercier; Patrick Philip,0,0,0,0
1653446857982,ECE 207A,A00,091605,Liu; Thomas Tao-Ming,0,0,0,0
1653446858505,ECE 212AN,A00,091068,Nomura; Kenji,0,0,0,0
1653446859028,ECE 222A,A00,091069,Rebeiz; Gabriel,0,0,0,0
1653446859564,ECE 225A,A00,091070,Orlitsky; Alon,0,0,0,0
1653446860086,ECE 230A,A00,091071,Nomura; Kenji,0,0,0,0
1653446860619,ECE 236A,A00,091072,Dayeh; Shadi Ahmad,0,0,0,0
1653446861141,ECE 238A,A00,091073,Luo; Jian,0,0,0,0
1653446861141,ECE 238A,B00,091074,Luo; Jian,0,0,0,0
1653446861666,ECE 240A,A00,091075,Radic; Stojan,0,0,0,0
1653446862193,ECE 247A,A00,091592,Shi; Lingyan,0,0,0,0
1653446862719,ECE 250,A00,091076,Touri; Behrouz,0,0,0,0
1653446863245,ECE 251C,A00,091078,Nguyen; Truong Quang,0,0,0,0
1653446863767,ECE 253,A00,091079,Cosman; Pamela C.,0,0,0,0
1653446864363,ECE 255A,A00,091080,Orlitsky; Alon,0,0,0,0
1653446864885,ECE 257A,A00,091081,Zhang; Xinyu,0,0,0,0
1653446865416,ECE 260A,A01,091084,Eldon; John,0,0,0,0
1653446865943,ECE 264C,A00,091085,Galton; Ian A,0,0,0,0
1653446866468,ECE 265C,A00,094889,Presti; Calogero Davide,0,0,0,9
1653446866995,ECE 266,A01,091087,Hall; Drew A.,0,0,0,0
1653446868044,ECE 271A,A00,091090,Vasconcelos; Nuno,0,0,0,0
1653446868570,ECE 272B,A00,091091,Sworder; David D.,0,0,0,0
1653446869092,ECE 275A,A00,091092,Meyer; Florian,0,0,0,0
1653446869614,ECE 277,A00,091093,An; Cheolhong,0,0,0,0
1653446870139,ECE 283,A00,091094,Le; Hanh-Phuc,0,0,0,0
1653446870663,ECE 284,A00,091095,Kang; Mingu,0,0,0,0
1653446870663,ECE 284,B00,091096,Wang; Edward Jay,0,0,0,0
1653446871184,ECE 285,A00,094334,Touri; Behrouz,0,0,0,0
1653446871713,ECE 289,A00,091097,Whelan; David Arthur,0,0,0,0
1653446872237,MATH 200A,A00,087414,Salehi Golsefidy; Alireza,7,0,8,1
1653446872766,MATH 202A,A00,087415,Gill; Philip E.,3,0,8,5
1653446873293,MATH 203A,A00,087416,Oprea; Dragos N.,6,0,8,2
1653446873816,MATH 204A,A00,087417,Kedlaya; Kiran S.,6,0,8,2
1653446874339,MATH 205,A00,087418,Sorensen; Claus M,6,0,8,2
1653446874865,MATH 206A,A00,087419,Izadi; Elham,7,0,8,1
1653446875391,MATH 207A,A00,087420,Mohammadi; Amir,6,0,8,2
1653446875915,MATH 208,A00,087421,Staff,9,0,10,1
1653446876441,MATH 209,A00,087422,Staff,10,0,10,0
1653446876967,MATH 218,A00,087423,Staff,10,0,10,0
1653446877493,MATH 220A,A00,087424,Novak; Jonathan I,7,0,8,1
1653446878028,MATH 231A,A00,087425,Bejenaru; Ioan,3,0,8,5
1653446878552,MATH 240A,A00,087426,Ebenfelt; Peter F,5,0,8,3
1653446879077,MATH 243,A00,087427,Staff,9,0,10,1
1653446879601,MATH 248,A00,087429,Staff,10,0,10,0
1653446880131,MATH 250A,A00,087430,Spolaor; Luca,4,0,8,4
1653446880669,MATH 257A,A00,087431,Spolaor; Luca,7,0,8,1
1653446881197,MATH 258,A00,087432,Staff,9,0,10,1
1653446881723,MATH 264A,A00,087433,Warnke; Lutz Peter,5,0,8,3
1653446882246,MATH 268,A00,087434,Staff,15,0,15,0
1653446882777,MATH 269,A00,087435,Staff,14,0,15,1
1653446883311,MATH 270A,A00,087436,Nie; Jiawang,0,0,8,8
1653446883836,MATH 272A,A00,087437,Tian; Xiaochuan,1,0,8,7
1653446884362,MATH 274,A01,087439,Cheng; Li-Tien,9,0,10,1
1653446884362,MATH 274,A02,087440,Cheng; Li-Tien,10,0,10,0
1653446884887,MATH 278A,A00,087441,Staff,8,0,10,2
1653446885412,MATH 278B,A00,087442,Staff,8,0,10,2
1653446885946,MATH 278C,A00,087443,Staff,8,0,10,2
1653446886469,MATH 280A,A00,087444,Zheng; Tianyi,0,0,8,8
1653446886995,MATH 281A,A00,087445,Bradic; Jelena,0,0,8,8
1653446887515,MATH 282A,A00,087446,Zhang; Danna,0,0,8,8
1653446888037,MATH 283,A00,087447,Tesler; Glenn,0,0,0,14
1653446888559,MATH 286,A00,087448,Kemp; Todd Aahron,5,0,8,3
1653446889082,MATH 287D,A00,087449,Bradic; Jelena,8,0,8,0
1653446889609,MATH 288,A00,087450,Staff,14,0,15,1
1653446889609,MATH 288,B00,087451,Staff,15,0,15,0
1653446889609,MATH 288,C00,087452,Staff,15,0,15,0
1653446890132,MATH 290A,A00,087453,Xu; Zhouli,7,0,8,1
1653446890656,MATH 291A,A00,087454,Xu; Zhouli,7,0,8,1
1653446891179,MATH 292,A00,087455,Staff,10,0,10,0
1653446891702,MATH 295,A00,087456,Staff,50,0,50,0
1653446892224,MATH 297,001,087457,Staff,998,0,999,1
1653447454070,COGS 200,A01,087991,Staff,47,0,50,3
1653447454597,COGS 201,A01,094504,Rangel; Lara M,17,0,25,8
1653447455119,COGS 203,A00,087992,Coulson; Seana M,18,0,20,2
1653447455647,COGS 210A,001,087993,Greene; Deanna Jacquelyn,9998,0,9999,1
1653447455647,COGS 210A,002,087994,Saygin; Ayse P,9999,0,9999,0
1653447455647,COGS 210A,003,087995,Xia; Haijun,9999,0,9999,0
1653447455647,COGS 210A,004,087996,Nitz; Douglas A.,9999,0,9999,0
1653447455647,COGS 210A,005,087997,Hollan; James D.,9999,0,9999,0
1653447455647,COGS 210A,006,087998,Deak; Gedeon O.,9998,0,9999,1
1653447455647,COGS 210A,007,087999,Rossano; Federico,9999,0,9999,0
1653447456170,COGS 211A,A00,088000,Coulson; Seana M,9997,0,9999,2
1653447456699,COGS 229,A00,088002,Staff,23,0,25,2
1653447457223,COGS 260,B00,094231,Staff,17,0,20,3
1653447457223,COGS 260,A00,088004,Nitz; Douglas A.,9998,0,9999,1
1653447457746,CSE 202,A00,090110,Paturi; Ramamohan,0,0,0,0
1653447457746,CSE 202,B00,090111,Paturi; Ramamohan,0,0,0,0
1653447458269,CSE 207B,A00,090112,Heninger; Nadia A,0,0,0,0
1653447458794,CSE 208,A00,094858,Micciancio; Daniele,0,0,0,0
1653447459322,CSE 210,A00,090113,Powell; Thomas Allan,0,0,0,0
1653447459846,CSE 219,A00,090898,Staff,0,0,0,0
1653447460376,CSE 221,A00,090114,Zhou; Yuan-Yuan,0,0,0,0
1653447460898,CSE 229A,A00,090115,Porter; George M,0,0,0,0
1653447461423,CSE 229C,A00,090116,Savage; Stefan,0,0,0,0
1653447461949,CSE 230,A00,090117,Jhala; Ranjit,0,0,0,0
1653447462471,CSE 232,A00,090118,Papakonstantinou; Yannis,0,0,0,0
1653447462997,CSE 239A,A00,090121,Kumar; Arun Kumar,0,0,0,0
1653447463521,CSE 239B,A00,090122,Jhala; Ranjit,0,0,0,0
1653447464046,CSE 240A,A00,090123,Zhao; Jishen,0,0,189,189
1653447464580,CSE 243A,A00,090124,Orailoglu; Alex,1,0,15,14
1653447465114,CSE 249B,A00,090125,Kahng; Andrew Byun,13,0,20,7
1653447465657,CSE 250A,A00,090126,Berg-Kirkpatrick; Taylor D,0,0,0,0
1653447466180,CSE 252A,A00,090127,Ochoa; Benjamin Lawrence,0,0,0,0
1653447466705,CSE 258,A01,090129,McAuley; Julian John,0,0,0,0
1653447467229,CSE 258R,A01,090131,McAuley; Julian John,0,0,0,0
1653447467754,CSE 274,A00,090132,Ramamoorthi; Ravi,0,0,0,0
1653447468281,CSE 276A,A00,090133,Christensen; Henrik I,0,0,0,0
1653447468808,CSE 276C,A00,090134,Christensen; Henrik I,0,0,0,0
1653447469333,CSE 290,A00,090135,Bafna; Vineet,0,0,0,0
1653447469333,CSE 290,B00,090136,Ramamoorthi; Ravi,0,0,0,0
1653447469333,CSE 290,C00,090137,Li; Tzumao,9,0,10,1
1653447469333,CSE 290,D00,090138,Zhou; Yuan-Yuan,10,0,10,0
1653447469333,CSE 290,E00,090139,Christensen; Henrik I,10,0,10,0
1653447469333,CSE 290,F00,094053,Shalev; Aaron D,0,0,0,0
1653447469860,CSE 291,A00,090140,Munyaka; Imani N. S.,0,0,0,0
1653447469860,CSE 291,B00,094880,Yu; Qi,0,0,0,0
1653447469860,CSE 291,C00,090142,Pannuto; Patrick William,0,0,0,0
1653447469860,CSE 291,D00,094881,Zhang; Yiying,0,0,0,0
1653447469860,CSE 291,E00,095118,Su; Hao,0,0,0,0
1653447470384,CSE 293,001,094905,Bafna; Vineet,9999,0,9999,0
1653447470384,CSE 293,002,094906,Bellare; Mihir,9999,0,9999,0
1653447470384,CSE 293,003,094907,Berg-Kirkpatrick; Taylor D,9999,0,9999,0
1653447470384,CSE 293,004,094908,Christensen; Henrik I,9999,0,9999,0
1653447470384,CSE 293,005,094909,Cottrell; Garrison W,9999,0,9999,0
1653447470384,CSE 293,006,094910,Deutsch; Alin Bernard,9999,0,9999,0
1653447470384,CSE 293,007,094911,Esmaeilzadeh; Hadi,9999,0,9999,0
1653447470384,CSE 293,008,094912,Freund; Yoav,9999,0,9999,0
1653447470384,CSE 293,009,094913,Griswold; William G.,9999,0,9999,0
1653447470384,CSE 293,010,094914,Gymrek; Melissa Ann,9999,0,9999,0
1653447470384,CSE 293,011,094915,Heninger; Nadia A,9999,0,9999,0
1653447470384,CSE 293,012,094916,Impagliazzo; Russell,9999,0,9999,0
1653447470384,CSE 293,013,094917,Jhala; Ranjit,9999,0,9999,0
1653447470384,CSE 293,014,094918,Kahng; Andrew Byun,9999,0,9999,0
1653447470384,CSE 293,015,094919,Kane; Daniel Mertz,9999,0,9999,0
1653447470384,CSE 293,016,094920,Kriegman; David J,9999,0,9999,0
1653447470384,CSE 293,017,094921,Kumar; Arun Kumar,9999,0,9999,0
1653447470384,CSE 293,018,094922,Lerner; Sorin,9999,0,9999,0
1653447470384,CSE 293,019,094923,Lovett; Shachar,9999,0,9999,0
1653447470384,CSE 293,020,094924,McAuley; Julian John,9999,0,9999,0
1653447470384,CSE 293,021,094925,Micciancio; Daniele,9999,0,9999,0
1653447470384,CSE 293,022,094926,Orailoglu; Alex,9999,0,9999,0
1653447470384,CSE 293,023,094927,Paturi; Ramamohan,9999,0,9999,0
1653447470384,CSE 293,024,094928,Polikarpova; Nadezhda,9999,0,9999,0
1653447470384,CSE 293,025,094929,Politz; Joseph Gibbs,9999,0,9999,0
1653447470384,CSE 293,026,094930,Porter; George M,9999,0,9999,0
1653447470384,CSE 293,027,094931,Porter; Leonard Emerson,9999,0,9999,0
1653447470384,CSE 293,028,094932,Ramamoorthi; Ravi,9999,0,9999,0
1653447470384,CSE 293,029,094933,Sahoo; Debashis,9999,0,9999,0
1653447470384,CSE 293,030,094934,Saul; Lawrence,9999,0,9999,0
1653447470384,CSE 293,031,094935,Savage; Stefan,9999,0,9999,0
1653447470384,CSE 293,032,094936,Schulze; Jurgen P.,9999,0,9999,0
1653447470384,CSE 293,033,094937,Snoeren; Alex C.,9999,0,9999,0
1653447470384,CSE 293,034,094938,Shang; Jingbo,9999,0,9999,0
1653447470384,CSE 293,035,094939,Stefan; Deian,9999,0,9999,0
1653447470384,CSE 293,036,094940,Su; Hao,9999,0,9999,0
1653447470384,CSE 293,037,094941,Swanson; Steven James,9999,0,9999,0
1653447470384,CSE 293,038,094942,Tullsen; Dean Michael,9999,0,9999,0
1653447470384,CSE 293,039,094943,Voelker; Geoffrey M.,9999,0,9999,0
1653447470384,CSE 293,040,094944,Zhao; Jishen,9999,0,9999,0
1653447470384,CSE 293,041,094945,Zhou; Yuan-Yuan,9999,0,9999,0
1653447470384,CSE 293,042,094946,Gao; Sicun,9998,0,9999,1
1653447470384,CSE 293,043,094947,Weibel; Nadir,9999,0,9999,0
1653447470384,CSE 293,044,094948,Gupta; Rajesh K.,9999,0,9999,0
1653447470910,CSE 294,A00,090143,Porter; George M,9,0,10,1
1653447471434,DSE 200,A00,091799,Staff,50,0,50,0
1653447471959,DSE 203,A00,091800,Gupta; Amarnath,30,0,30,0
1653447472482,DSE 250,A00,091801,Deutsch; Alin Bernard,30,0,30,0
1653447473015,DSE 290,A00,091802,Altintas De Callaf; Ilkay,50,0,50,0
1653447473553,ECE 200,001,091003,Antipa; Nicholas A,9999,0,9999,0
1653447473553,ECE 200,002,091004,Atanasov; Nikolay A.,9999,0,9999,0
1653447473553,ECE 200,003,091005,Bharadia; Dinesh,9999,0,9999,0
1653447473553,ECE 200,004,091006,Cheng; Chung Kuan,9999,0,9999,0
1653447473553,ECE 200,005,091007,Cosman; Pamela C.,9999,0,9999,0
1653447473553,ECE 200,006,091008,Staff,9999,0,9999,0
1653447473553,ECE 200,007,091009,Dayeh; Shadi Ahmad,9999,0,9999,0
1653447473553,ECE 200,008,091010,Fainman; Yeshaiahu,9999,0,9999,0
1653447473553,ECE 200,009,091011,Ford; Joseph Earl,9999,0,9999,0
1653447473553,ECE 200,010,091012,Franceschetti; Massimo,9999,0,9999,0
1653447473553,ECE 200,011,091013,Fullerton; Eric E,9999,0,9999,0
1653447473553,ECE 200,012,091014,Galton; Ian A,9999,0,9999,0
1653447473553,ECE 200,013,091015,Gilja; Vikash,9999,0,9999,0
1653447473553,ECE 200,014,091016,Hall; Drew A.,9999,0,9999,0
1653447473553,ECE 200,015,091017,Hsueh; Tzu-Chien,9999,0,9999,0
1653447473553,ECE 200,016,091018,Javidi; Tara,9999,0,9999,0
1653447473553,ECE 200,017,091019,Kahng; Andrew Byun,9999,0,9999,0
1653447473553,ECE 200,018,091020,Kim; Young-Han,9999,0,9999,0
1653447473553,ECE 200,019,091021,Koushanfar; Farinaz,9999,0,9999,0
1653447473553,ECE 200,020,091022,Kuzum; Duygu,9999,0,9999,0
1653447473553,ECE 200,021,091023,Le; Hanh-Phuc,9999,0,9999,0
1653447473553,ECE 200,022,091024,Lin; Bill,9999,0,9999,0
1653447473553,ECE 200,023,091025,Liu; Zhaowei,9999,0,9999,0
1653447473553,ECE 200,024,091026,Lo; Yu-Hwa,9999,0,9999,0
1653447473553,ECE 200,025,091027,Lomakin; Vitaliy,9999,0,9999,0
1653447473553,ECE 200,026,091028,Mercier; Patrick Philip,9999,0,9999,0
1653447473553,ECE 200,027,091029,Meyer; Florian,9999,0,9999,0
1653447473553,ECE 200,028,091030,Milstein; Laurence B.,9999,0,9999,0
1653447473553,ECE 200,029,091031,Mir Arabbaygi; Siavash,9999,0,9999,0
1653447473553,ECE 200,030,091032,Mookherjea; Shayan,9999,0,9999,0
1653447473553,ECE 200,031,091033,Morris; Karcher William,9999,0,9999,0
1653447473553,ECE 200,032,091034,Ng; Tse Nga,9999,0,9999,0
1653447473553,ECE 200,033,091035,Nguyen; Truong Quang,9999,0,9999,0
1653447473553,ECE 200,034,091036,Nomura; Kenji,9999,0,9999,0
1653447473553,ECE 200,035,091037,Orlitsky; Alon,9999,0,9999,0
1653447473553,ECE 200,036,091038,Pal; Piya,9999,0,9999,0
1653447473553,ECE 200,037,091039,Papen; George C.,9999,0,9999,0
1653447473553,ECE 200,038,091040,Radic; Stojan,9999,0,9999,0
1653447473553,ECE 200,039,091041,Rao; Bhaskar D.,9999,0,9999,0
1653447473553,ECE 200,040,091042,Rao; Ramesh R,9999,0,9999,0
1653447473553,ECE 200,041,091043,Rebeiz; Gabriel,9999,0,9999,0
1653447473553,ECE 200,042,091044,Sanford; John R,9999,0,9999,0
1653447473553,ECE 200,043,091045,Siegel; Paul H.,9999,0,9999,0
1653447473553,ECE 200,044,091046,Sievenpiper; Daniel F.,9999,0,9999,0
1653447473553,ECE 200,045,091047,Sworder; David D.,9999,0,9999,0
1653447473553,ECE 200,046,091048,Taur; Yuan,9999,0,9999,0
1653447473553,ECE 200,047,091049,Touri; Behrouz,9999,0,9999,0
1653447473553,ECE 200,048,091050,Trivedi; Mohan M.,9999,0,9999,0
1653447473553,ECE 200,049,091051,Vardy; Alexander,9999,0,9999,0
1653447473553,ECE 200,050,091052,Vasconcelos; Nuno,9999,0,9999,0
1653447473553,ECE 200,051,091053,Wang; Xiaolong,9999,0,9999,0
1653447473553,ECE 200,052,091054,Xie; Pengtao,9999,0,9999,0
1653447473553,ECE 200,053,091055,Yip; Michael,9999,0,9999,0
1653447473553,ECE 200,054,091056,Zeger; Kenneth A.,9999,0,9999,0
1653447473553,ECE 200,055,091057,Zhang; Xinyu,9999,0,9999,0
1653447473553,ECE 200,056,091058,Turakhia; Yatish Girish,9999,0,9999,0
1653447473553,ECE 200,057,091059,Kang; Mingu,9999,0,9999,0
1653447473553,ECE 200,058,091060,Shi; Yuanyuan,9999,0,9999,0
1653447473553,ECE 200,059,091061,Wang; Edward Jay,9999,0,9999,0
1653447473553,ECE 200,060,091062,Zheng; Yang,9999,0,9999,0
1653447474084,ECE 203,A00,091065,Mercier; Patrick Philip,0,0,0,0
1653447474611,ECE 207A,A00,091605,Liu; Thomas Tao-Ming,0,0,0,0
1653447475134,ECE 212AN,A00,091068,Nomura; Kenji,0,0,0,0
1653447475655,ECE 222A,A00,091069,Rebeiz; Gabriel,0,0,0,0
1653447476178,ECE 225A,A00,091070,Orlitsky; Alon,0,0,0,0
1653447476701,ECE 230A,A00,091071,Nomura; Kenji,0,0,0,0
1653447477227,ECE 236A,A00,091072,Dayeh; Shadi Ahmad,0,0,0,0
1653447477753,ECE 238A,A00,091073,Luo; Jian,0,0,0,0
1653447477753,ECE 238A,B00,091074,Luo; Jian,0,0,0,0
1653447478275,ECE 240A,A00,091075,Radic; Stojan,0,0,0,0
1653447478806,ECE 247A,A00,091592,Shi; Lingyan,0,0,0,0
1653447479332,ECE 250,A00,091076,Touri; Behrouz,0,0,0,0
1653447479869,ECE 251C,A00,091078,Nguyen; Truong Quang,0,0,0,0
1653447480397,ECE 253,A00,091079,Cosman; Pamela C.,0,0,0,0
1653447480923,ECE 255A,A00,091080,Orlitsky; Alon,0,0,0,0
1653447481449,ECE 257A,A00,091081,Zhang; Xinyu,0,0,0,0
1653447481991,ECE 260A,A01,091084,Eldon; John,0,0,0,0
1653447482525,ECE 264C,A00,091085,Galton; Ian A,0,0,0,0
1653447483063,ECE 265C,A00,094889,Presti; Calogero Davide,0,0,0,9
1653447483588,ECE 266,A01,091087,Hall; Drew A.,0,0,0,0
1653447484644,ECE 271A,A00,091090,Vasconcelos; Nuno,0,0,0,0
1653447485167,ECE 272B,A00,091091,Sworder; David D.,0,0,0,0
1653447485692,ECE 275A,A00,091092,Meyer; Florian,0,0,0,0
1653447486214,ECE 277,A00,091093,An; Cheolhong,0,0,0,0
1653447486739,ECE 283,A00,091094,Le; Hanh-Phuc,0,0,0,0
1653447487263,ECE 284,A00,091095,Kang; Mingu,0,0,0,0
1653447487263,ECE 284,B00,091096,Wang; Edward Jay,0,0,0,0
1653447487785,ECE 285,A00,094334,Touri; Behrouz,0,0,0,0
1653447488318,ECE 289,A00,091097,Whelan; David Arthur,0,0,0,0
1653447488845,MATH 200A,A00,087414,Salehi Golsefidy; Alireza,7,0,8,1
1653447489368,MATH 202A,A00,087415,Gill; Philip E.,3,0,8,5
1653447489906,MATH 203A,A00,087416,Oprea; Dragos N.,6,0,8,2
1653447490432,MATH 204A,A00,087417,Kedlaya; Kiran S.,6,0,8,2
1653447490961,MATH 205,A00,087418,Sorensen; Claus M,6,0,8,2
1653447491493,MATH 206A,A00,087419,Izadi; Elham,7,0,8,1
1653447492020,MATH 207A,A00,087420,Mohammadi; Amir,6,0,8,2
1653447492543,MATH 208,A00,087421,Staff,9,0,10,1
1653447493066,MATH 209,A00,087422,Staff,10,0,10,0
1653447493588,MATH 218,A00,087423,Staff,10,0,10,0
1653447494111,MATH 220A,A00,087424,Novak; Jonathan I,7,0,8,1
1653447494637,MATH 231A,A00,087425,Bejenaru; Ioan,3,0,8,5
1653447495166,MATH 240A,A00,087426,Ebenfelt; Peter F,5,0,8,3
1653447495688,MATH 243,A00,087427,Staff,9,0,10,1
1653447496227,MATH 248,A00,087429,Staff,10,0,10,0
1653447496749,MATH 250A,A00,087430,Spolaor; Luca,4,0,8,4
1653447497281,MATH 257A,A00,087431,Spolaor; Luca,7,0,8,1
1653447497804,MATH 258,A00,087432,Staff,9,0,10,1
1653447498328,MATH 264A,A00,087433,Warnke; Lutz Peter,5,0,8,3
1653447498850,MATH 268,A00,087434,Staff,15,0,15,0
1653447499390,MATH 269,A00,087435,Staff,14,0,15,1
1653447499915,MATH 270A,A00,087436,Nie; Jiawang,0,0,8,8
1653447500441,MATH 272A,A00,087437,Tian; Xiaochuan,1,0,8,7
1653447500967,MATH 274,A01,087439,Cheng; Li-Tien,9,0,10,1
1653447500967,MATH 274,A02,087440,Cheng; Li-Tien,10,0,10,0
1653447501489,MATH 278A,A00,087441,Staff,8,0,10,2
1653447502011,MATH 278B,A00,087442,Staff,8,0,10,2
1653447502536,MATH 278C,A00,087443,Staff,8,0,10,2
1653447503061,MATH 280A,A00,087444,Zheng; Tianyi,0,0,8,8
1653447503586,MATH 281A,A00,087445,Bradic; Jelena,0,0,8,8
1653447504109,MATH 282A,A00,087446,Zhang; Danna,0,0,8,8
1653447504634,MATH 283,A00,087447,Tesler; Glenn,0,0,0,14
1653447505160,MATH 286,A00,087448,Kemp; Todd Aahron,5,0,8,3
1653447505683,MATH 287D,A00,087449,Bradic; Jelena,8,0,8,0
1653447506207,MATH 288,A00,087450,Staff,14,0,15,1
1653447506207,MATH 288,B00,087451,Staff,15,0,15,0
1653447506207,MATH 288,C00,087452,Staff,15,0,15,0
1653447506816,MATH 290A,A00,087453,Xu; Zhouli,7,0,8,1
1653447507338,MATH 291A,A00,087454,Xu; Zhouli,7,0,8,1
1653447507862,MATH 292,A00,087455,Staff,10,0,10,0
1653447508384,MATH 295,A00,087456,Staff,50,0,50,0
1653447508912,MATH 297,001,087457,Staff,998,0,999,1
1653448071792,COGS 200,A01,087991,Staff,47,0,50,3
1653448072318,COGS 201,A01,094504,Rangel; Lara M,17,0,25,8
1653448072853,COGS 203,A00,087992,Coulson; Seana M,18,0,20,2
1653448073376,COGS 210A,001,087993,Greene; Deanna Jacquelyn,9998,0,9999,1
1653448073376,COGS 210A,002,087994,Saygin; Ayse P,9999,0,9999,0
1653448073376,COGS 210A,003,087995,Xia; Haijun,9999,0,9999,0
1653448073376,COGS 210A,004,087996,Nitz; Douglas A.,9999,0,9999,0
1653448073376,COGS 210A,005,087997,Hollan; James D.,9999,0,9999,0
1653448073376,COGS 210A,006,087998,Deak; Gedeon O.,9998,0,9999,1
1653448073376,COGS 210A,007,087999,Rossano; Federico,9999,0,9999,0
1653448073901,COGS 211A,A00,088000,Coulson; Seana M,9997,0,9999,2
1653448074426,COGS 229,A00,088002,Staff,23,0,25,2
1653448074949,COGS 260,B00,094231,Staff,17,0,20,3
1653448074949,COGS 260,A00,088004,Nitz; Douglas A.,9998,0,9999,1
1653448075475,CSE 202,A00,090110,Paturi; Ramamohan,0,0,0,0
1653448075475,CSE 202,B00,090111,Paturi; Ramamohan,0,0,0,0
1653448076001,CSE 207B,A00,090112,Heninger; Nadia A,0,0,0,0
1653448076529,CSE 208,A00,094858,Micciancio; Daniele,0,0,0,0
1653448077062,CSE 210,A00,090113,Powell; Thomas Allan,0,0,0,0
1653448077586,CSE 219,A00,090898,Staff,0,0,0,0
1653448078116,CSE 221,A00,090114,Zhou; Yuan-Yuan,0,0,0,0
1653448078640,CSE 229A,A00,090115,Porter; George M,0,0,0,0
1653448079165,CSE 229C,A00,090116,Savage; Stefan,0,0,0,0
1653448079691,CSE 230,A00,090117,Jhala; Ranjit,0,0,0,0
1653448080214,CSE 232,A00,090118,Papakonstantinou; Yannis,0,0,0,0
1653448080737,CSE 239A,A00,090121,Kumar; Arun Kumar,0,0,0,0
1653448081264,CSE 239B,A00,090122,Jhala; Ranjit,0,0,0,0
1653448081786,CSE 240A,A00,090123,Zhao; Jishen,0,0,189,189
1653448082318,CSE 243A,A00,090124,Orailoglu; Alex,1,0,15,14
1653448082851,CSE 249B,A00,090125,Kahng; Andrew Byun,13,0,20,7
1653448083388,CSE 250A,A00,090126,Berg-Kirkpatrick; Taylor D,0,0,0,0
1653448083912,CSE 252A,A00,090127,Ochoa; Benjamin Lawrence,0,0,0,0
1653448084439,CSE 258,A01,090129,McAuley; Julian John,0,0,0,0
1653448084969,CSE 258R,A01,090131,McAuley; Julian John,0,0,0,0
1653448085494,CSE 274,A00,090132,Ramamoorthi; Ravi,0,0,0,0
1653448086023,CSE 276A,A00,090133,Christensen; Henrik I,0,0,0,0
1653448086547,CSE 276C,A00,090134,Christensen; Henrik I,0,0,0,0
1653448087070,CSE 290,A00,090135,Bafna; Vineet,0,0,0,0
1653448087070,CSE 290,B00,090136,Ramamoorthi; Ravi,0,0,0,0
1653448087070,CSE 290,C00,090137,Li; Tzumao,9,0,10,1
1653448087070,CSE 290,D00,090138,Zhou; Yuan-Yuan,10,0,10,0
1653448087070,CSE 290,E00,090139,Christensen; Henrik I,10,0,10,0
1653448087070,CSE 290,F00,094053,Shalev; Aaron D,0,0,0,0
1653448087608,CSE 291,A00,090140,Munyaka; Imani N. S.,0,0,0,0
1653448087608,CSE 291,B00,094880,Yu; Qi,0,0,0,0
1653448087608,CSE 291,C00,090142,Pannuto; Patrick William,0,0,0,0
1653448087608,CSE 291,D00,094881,Zhang; Yiying,0,0,0,0
1653448087608,CSE 291,E00,095118,Su; Hao,0,0,0,0
1653448088144,CSE 293,001,094905,Bafna; Vineet,9999,0,9999,0
1653448088144,CSE 293,002,094906,Bellare; Mihir,9999,0,9999,0
1653448088144,CSE 293,003,094907,Berg-Kirkpatrick; Taylor D,9999,0,9999,0
1653448088144,CSE 293,004,094908,Christensen; Henrik I,9999,0,9999,0
1653448088144,CSE 293,005,094909,Cottrell; Garrison W,9999,0,9999,0
1653448088144,CSE 293,006,094910,Deutsch; Alin Bernard,9999,0,9999,0
1653448088144,CSE 293,007,094911,Esmaeilzadeh; Hadi,9999,0,9999,0
1653448088144,CSE 293,008,094912,Freund; Yoav,9999,0,9999,0
1653448088144,CSE 293,009,094913,Griswold; William G.,9999,0,9999,0
1653448088144,CSE 293,010,094914,Gymrek; Melissa Ann,9999,0,9999,0
1653448088144,CSE 293,011,094915,Heninger; Nadia A,9999,0,9999,0
1653448088144,CSE 293,012,094916,Impagliazzo; Russell,9999,0,9999,0
1653448088144,CSE 293,013,094917,Jhala; Ranjit,9999,0,9999,0
1653448088144,CSE 293,014,094918,Kahng; Andrew Byun,9999,0,9999,0
1653448088144,CSE 293,015,094919,Kane; Daniel Mertz,9999,0,9999,0
1653448088144,CSE 293,016,094920,Kriegman; David J,9999,0,9999,0
1653448088144,CSE 293,017,094921,Kumar; Arun Kumar,9999,0,9999,0
1653448088144,CSE 293,018,094922,Lerner; Sorin,9999,0,9999,0
1653448088144,CSE 293,019,094923,Lovett; Shachar,9999,0,9999,0
1653448088144,CSE 293,020,094924,McAuley; Julian John,9999,0,9999,0
1653448088144,CSE 293,021,094925,Micciancio; Daniele,9999,0,9999,0
1653448088144,CSE 293,022,094926,Orailoglu; Alex,9999,0,9999,0
1653448088144,CSE 293,023,094927,Paturi; Ramamohan,9999,0,9999,0
1653448088144,CSE 293,024,094928,Polikarpova; Nadezhda,9999,0,9999,0
1653448088144,CSE 293,025,094929,Politz; Joseph Gibbs,9999,0,9999,0
1653448088144,CSE 293,026,094930,Porter; George M,9999,0,9999,0
1653448088144,CSE 293,027,094931,Porter; Leonard Emerson,9999,0,9999,0
1653448088144,CSE 293,028,094932,Ramamoorthi; Ravi,9999,0,9999,0
1653448088144,CSE 293,029,094933,Sahoo; Debashis,9999,0,9999,0
1653448088144,CSE 293,030,094934,Saul; Lawrence,9999,0,9999,0
1653448088144,CSE 293,031,094935,Savage; Stefan,9999,0,9999,0
1653448088144,CSE 293,032,094936,Schulze; Jurgen P.,9999,0,9999,0
1653448088144,CSE 293,033,094937,Snoeren; Alex C.,9999,0,9999,0
1653448088144,CSE 293,034,094938,Shang; Jingbo,9999,0,9999,0
1653448088144,CSE 293,035,094939,Stefan; Deian,9999,0,9999,0
1653448088144,CSE 293,036,094940,Su; Hao,9999,0,9999,0
1653448088144,CSE 293,037,094941,Swanson; Steven James,9999,0,9999,0
1653448088144,CSE 293,038,094942,Tullsen; Dean Michael,9999,0,9999,0
1653448088144,CSE 293,039,094943,Voelker; Geoffrey M.,9999,0,9999,0
1653448088144,CSE 293,040,094944,Zhao; Jishen,9999,0,9999,0
1653448088144,CSE 293,041,094945,Zhou; Yuan-Yuan,9999,0,9999,0
1653448088144,CSE 293,042,094946,Gao; Sicun,9998,0,9999,1
1653448088144,CSE 293,043,094947,Weibel; Nadir,9999,0,9999,0
1653448088144,CSE 293,044,094948,Gupta; Rajesh K.,9999,0,9999,0
1653448088670,CSE 294,A00,090143,Porter; George M,9,0,10,1
1653448089195,DSE 200,A00,091799,Staff,50,0,50,0
1653448089718,DSE 203,A00,091800,Gupta; Amarnath,30,0,30,0
1653448090241,DSE 250,A00,091801,Deutsch; Alin Bernard,30,0,30,0
1653448090776,DSE 290,A00,091802,Altintas De Callaf; Ilkay,50,0,50,0
1653448091318,ECE 200,001,091003,Antipa; Nicholas A,9999,0,9999,0
1653448091318,ECE 200,002,091004,Atanasov; Nikolay A.,9999,0,9999,0
1653448091318,ECE 200,003,091005,Bharadia; Dinesh,9999,0,9999,0
1653448091318,ECE 200,004,091006,Cheng; Chung Kuan,9999,0,9999,0
1653448091318,ECE 200,005,091007,Cosman; Pamela C.,9999,0,9999,0
1653448091318,ECE 200,006,091008,Staff,9999,0,9999,0
1653448091318,ECE 200,007,091009,Dayeh; Shadi Ahmad,9999,0,9999,0
1653448091318,ECE 200,008,091010,Fainman; Yeshaiahu,9999,0,9999,0
1653448091318,ECE 200,009,091011,Ford; Joseph Earl,9999,0,9999,0
1653448091318,ECE 200,010,091012,Franceschetti; Massimo,9999,0,9999,0
1653448091318,ECE 200,011,091013,Fullerton; Eric E,9999,0,9999,0
1653448091318,ECE 200,012,091014,Galton; Ian A,9999,0,9999,0
1653448091318,ECE 200,013,091015,Gilja; Vikash,9999,0,9999,0
1653448091318,ECE 200,014,091016,Hall; Drew A.,9999,0,9999,0
1653448091318,ECE 200,015,091017,Hsueh; Tzu-Chien,9999,0,9999,0
1653448091318,ECE 200,016,091018,Javidi; Tara,9999,0,9999,0
1653448091318,ECE 200,017,091019,Kahng; Andrew Byun,9999,0,9999,0
1653448091318,ECE 200,018,091020,Kim; Young-Han,9999,0,9999,0
1653448091318,ECE 200,019,091021,Koushanfar; Farinaz,9999,0,9999,0
1653448091318,ECE 200,020,091022,Kuzum; Duygu,9999,0,9999,0
1653448091318,ECE 200,021,091023,Le; Hanh-Phuc,9999,0,9999,0
1653448091318,ECE 200,022,091024,Lin; Bill,9999,0,9999,0
1653448091318,ECE 200,023,091025,Liu; Zhaowei,9999,0,9999,0
1653448091318,ECE 200,024,091026,Lo; Yu-Hwa,9999,0,9999,0
1653448091318,ECE 200,025,091027,Lomakin; Vitaliy,9999,0,9999,0
1653448091318,ECE 200,026,091028,Mercier; Patrick Philip,9999,0,9999,0
1653448091318,ECE 200,027,091029,Meyer; Florian,9999,0,9999,0
1653448091318,ECE 200,028,091030,Milstein; Laurence B.,9999,0,9999,0
1653448091318,ECE 200,029,091031,Mir Arabbaygi; Siavash,9999,0,9999,0
1653448091318,ECE 200,030,091032,Mookherjea; Shayan,9999,0,9999,0
1653448091318,ECE 200,031,091033,Morris; Karcher William,9999,0,9999,0
1653448091318,ECE 200,032,091034,Ng; Tse Nga,9999,0,9999,0
1653448091318,ECE 200,033,091035,Nguyen; Truong Quang,9999,0,9999,0
1653448091318,ECE 200,034,091036,Nomura; Kenji,9999,0,9999,0
1653448091318,ECE 200,035,091037,Orlitsky; Alon,9999,0,9999,0
1653448091318,ECE 200,036,091038,Pal; Piya,9999,0,9999,0
1653448091318,ECE 200,037,091039,Papen; George C.,9999,0,9999,0
1653448091318,ECE 200,038,091040,Radic; Stojan,9999,0,9999,0
1653448091318,ECE 200,039,091041,Rao; Bhaskar D.,9999,0,9999,0
1653448091318,ECE 200,040,091042,Rao; Ramesh R,9999,0,9999,0
1653448091318,ECE 200,041,091043,Rebeiz; Gabriel,9999,0,9999,0
1653448091318,ECE 200,042,091044,Sanford; John R,9999,0,9999,0
1653448091318,ECE 200,043,091045,Siegel; Paul H.,9999,0,9999,0
1653448091318,ECE 200,044,091046,Sievenpiper; Daniel F.,9999,0,9999,0
1653448091318,ECE 200,045,091047,Sworder; David D.,9999,0,9999,0
1653448091318,ECE 200,046,091048,Taur; Yuan,9999,0,9999,0
1653448091318,ECE 200,047,091049,Touri; Behrouz,9999,0,9999,0
1653448091318,ECE 200,048,091050,Trivedi; Mohan M.,9999,0,9999,0
1653448091318,ECE 200,049,091051,Vardy; Alexander,9999,0,9999,0
1653448091318,ECE 200,050,091052,Vasconcelos; Nuno,9999,0,9999,0
1653448091318,ECE 200,051,091053,Wang; Xiaolong,9999,0,9999,0
1653448091318,ECE 200,052,091054,Xie; Pengtao,9999,0,9999,0
1653448091318,ECE 200,053,091055,Yip; Michael,9999,0,9999,0
1653448091318,ECE 200,054,091056,Zeger; Kenneth A.,9999,0,9999,0
1653448091318,ECE 200,055,091057,Zhang; Xinyu,9999,0,9999,0
1653448091318,ECE 200,056,091058,Turakhia; Yatish Girish,9999,0,9999,0
1653448091318,ECE 200,057,091059,Kang; Mingu,9999,0,9999,0
1653448091318,ECE 200,058,091060,Shi; Yuanyuan,9999,0,9999,0
1653448091318,ECE 200,059,091061,Wang; Edward Jay,9999,0,9999,0
1653448091318,ECE 200,060,091062,Zheng; Yang,9999,0,9999,0
1653448091840,ECE 203,A00,091065,Mercier; Patrick Philip,0,0,0,0
1653448092370,ECE 207A,A00,091605,Liu; Thomas Tao-Ming,0,0,0,0
1653448092894,ECE 212AN,A00,091068,Nomura; Kenji,0,0,0,0
1653448093424,ECE 222A,A00,091069,Rebeiz; Gabriel,0,0,0,0
1653448093952,ECE 225A,A00,091070,Orlitsky; Alon,0,0,0,0
1653448094477,ECE 230A,A00,091071,Nomura; Kenji,0,0,0,0
1653448095003,ECE 236A,A00,091072,Dayeh; Shadi Ahmad,0,0,0,0
1653448095529,ECE 238A,A00,091073,Luo; Jian,0,0,0,0
1653448095529,ECE 238A,B00,091074,Luo; Jian,0,0,0,0
1653448096055,ECE 240A,A00,091075,Radic; Stojan,0,0,0,0
1653448096585,ECE 247A,A00,091592,Shi; Lingyan,0,0,0,0
1653448097199,ECE 250,A00,091076,Touri; Behrouz,0,0,0,0
1653448097722,ECE 251C,A00,091078,Nguyen; Truong Quang,0,0,0,0
1653448098249,ECE 253,A00,091079,Cosman; Pamela C.,0,0,0,0
1653448098774,ECE 255A,A00,091080,Orlitsky; Alon,0,0,0,0
1653448099297,ECE 257A,A00,091081,Zhang; Xinyu,0,0,0,0
1653448099819,ECE 260A,A01,091084,Eldon; John,0,0,0,0
1653448100347,ECE 264C,A00,091085,Galton; Ian A,0,0,0,0
1653448100873,ECE 265C,A00,094889,Presti; Calogero Davide,0,0,0,9
1653448101398,ECE 266,A01,091087,Hall; Drew A.,0,0,0,0
1653448102443,ECE 271A,A00,091090,Vasconcelos; Nuno,0,0,0,0
1653448102966,ECE 272B,A00,091091,Sworder; David D.,0,0,0,0
1653448103491,ECE 275A,A00,091092,Meyer; Florian,0,0,0,0
1653448104018,ECE 277,A00,091093,An; Cheolhong,0,0,0,0
1653448104551,ECE 283,A00,091094,Le; Hanh-Phuc,0,0,0,0
1653448105080,ECE 284,A00,091095,Kang; Mingu,0,0,0,0
1653448105080,ECE 284,B00,091096,Wang; Edward Jay,0,0,0,0
1653448105611,ECE 285,A00,094334,Touri; Behrouz,0,0,0,0
1653448106137,ECE 289,A00,091097,Whelan; David Arthur,0,0,0,0
1653448106659,MATH 200A,A00,087414,Salehi Golsefidy; Alireza,7,0,8,1
1653448107185,MATH 202A,A00,087415,Gill; Philip E.,3,0,8,5
1653448107708,MATH 203A,A00,087416,Oprea; Dragos N.,6,0,8,2
1653448108235,MATH 204A,A00,087417,Kedlaya; Kiran S.,6,0,8,2
1653448108756,MATH 205,A00,087418,Sorensen; Claus M,6,0,8,2
1653448109279,MATH 206A,A00,087419,Izadi; Elham,7,0,8,1
1653448109818,MATH 207A,A00,087420,Mohammadi; Amir,6,0,8,2
1653448110344,MATH 208,A00,087421,Staff,9,0,10,1
1653448110869,MATH 209,A00,087422,Staff,10,0,10,0
1653448111392,MATH 218,A00,087423,Staff,10,0,10,0
1653448111919,MATH 220A,A00,087424,Novak; Jonathan I,7,0,8,1
1653448112452,MATH 231A,A00,087425,Bejenaru; Ioan,3,0,8,5
1653448112975,MATH 240A,A00,087426,Ebenfelt; Peter F,5,0,8,3
1653448113497,MATH 243,A00,087427,Staff,9,0,10,1
1653448114019,MATH 248,A00,087429,Staff,10,0,10,0
1653448114540,MATH 250A,A00,087430,Spolaor; Luca,4,0,8,4
1653448115063,MATH 257A,A00,087431,Spolaor; Luca,7,0,8,1
1653448115586,MATH 258,A00,087432,Staff,9,0,10,1
1653448116111,MATH 264A,A00,087433,Warnke; Lutz Peter,5,0,8,3
1653448116637,MATH 268,A00,087434,Staff,15,0,15,0
1653448117159,MATH 269,A00,087435,Staff,14,0,15,1
1653448117680,MATH 270A,A00,087436,Nie; Jiawang,0,0,8,8
1653448118208,MATH 272A,A00,087437,Tian; Xiaochuan,1,0,8,7
1653448118735,MATH 274,A01,087439,Cheng; Li-Tien,9,0,10,1
1653448118735,MATH 274,A02,087440,Cheng; Li-Tien,10,0,10,0
1653448119257,MATH 278A,A00,087441,Staff,8,0,10,2
1653448119780,MATH 278B,A00,087442,Staff,8,0,10,2
1653448120304,MATH 278C,A00,087443,Staff,8,0,10,2
1653448120826,MATH 280A,A00,087444,Zheng; Tianyi,0,0,8,8
1653448121350,MATH 281A,A00,087445,Bradic; Jelena,0,0,8,8
1653448121873,MATH 282A,A00,087446,Zhang; Danna,0,0,8,8
1653448122400,MATH 283,A00,087447,Tesler; Glenn,0,0,0,14
1653448122920,MATH 286,A00,087448,Kemp; Todd Aahron,5,0,8,3
1653448123445,MATH 287D,A00,087449,Bradic; Jelena,8,0,8,0
1653448123976,MATH 288,A00,087450,Staff,14,0,15,1
1653448123976,MATH 288,B00,087451,Staff,15,0,15,0
1653448123976,MATH 288,C00,087452,Staff,15,0,15,0
1653448124499,MATH 290A,A00,087453,Xu; Zhouli,7,0,8,1
1653448125024,MATH 291A,A00,087454,Xu; Zhouli,7,0,8,1
1653448125549,MATH 292,A00,087455,Staff,10,0,10,0
1653448126080,MATH 295,A00,087456,Staff,50,0,50,0
1653448126611,MATH 297,001,087457,Staff,998,0,999,1
1653448687349,COGS 200,A01,087991,Staff,47,0,50,3
1653448687877,COGS 201,A01,094504,Rangel; Lara M,17,0,25,8
1653448688402,COGS 203,A00,087992,Coulson; Seana M,18,0,20,2
1653448688924,COGS 210A,001,087993,Greene; Deanna Jacquelyn,9998,0,9999,1
1653448688924,COGS 210A,002,087994,Saygin; Ayse P,9999,0,9999,0
1653448688924,COGS 210A,003,087995,Xia; Haijun,9999,0,9999,0
1653448688924,COGS 210A,004,087996,Nitz; Douglas A.,9999,0,9999,0
1653448688924,COGS 210A,005,087997,Hollan; James D.,9999,0,9999,0
1653448688924,COGS 210A,006,087998,Deak; Gedeon O.,9998,0,9999,1
1653448688924,COGS 210A,007,087999,Rossano; Federico,9999,0,9999,0
1653448689447,COGS 211A,A00,088000,Coulson; Seana M,9997,0,9999,2
1653448689972,COGS 229,A00,088002,Staff,23,0,25,2
1653448690495,COGS 260,B00,094231,Staff,17,0,20,3
1653448690495,COGS 260,A00,088004,Nitz; Douglas A.,9998,0,9999,1
1653448691027,CSE 202,A00,090110,Paturi; Ramamohan,0,0,0,0
1653448691027,CSE 202,B00,090111,Paturi; Ramamohan,0,0,0,0
1653448691552,CSE 207B,A00,090112,Heninger; Nadia A,0,0,0,0
1653448692078,CSE 208,A00,094858,Micciancio; Daniele,0,0,0,0
1653448692601,CSE 210,A00,090113,Powell; Thomas Allan,0,0,0,0
1653448693126,CSE 219,A00,090898,Staff,0,0,0,0
1653448693650,CSE 221,A00,090114,Zhou; Yuan-Yuan,0,0,0,0
1653448694179,CSE 229A,A00,090115,Porter; George M,0,0,0,0
1653448694706,CSE 229C,A00,090116,Savage; Stefan,0,0,0,0
1653448695228,CSE 230,A00,090117,Jhala; Ranjit,0,0,0,0
1653448695757,CSE 232,A00,090118,Papakonstantinou; Yannis,0,0,0,0
1653448696279,CSE 239A,A00,090121,Kumar; Arun Kumar,0,0,0,0
1653448696805,CSE 239B,A00,090122,Jhala; Ranjit,0,0,0,0
1653448697338,CSE 240A,A00,090123,Zhao; Jishen,0,0,189,189
1653448697873,CSE 243A,A00,090124,Orailoglu; Alex,1,0,15,14
1653448698413,CSE 249B,A00,090125,Kahng; Andrew Byun,13,0,20,7
1653448698937,CSE 250A,A00,090126,Berg-Kirkpatrick; Taylor D,0,0,0,0
1653448699458,CSE 252A,A00,090127,Ochoa; Benjamin Lawrence,0,0,0,0
1653448699984,CSE 258,A01,090129,McAuley; Julian John,0,0,0,0
1653448700507,CSE 258R,A01,090131,McAuley; Julian John,0,0,0,0
1653448701029,CSE 274,A00,090132,Ramamoorthi; Ravi,0,0,0,0
1653448701556,CSE 276A,A00,090133,Christensen; Henrik I,0,0,0,0
1653448702079,CSE 276C,A00,090134,Christensen; Henrik I,0,0,0,0
1653448702605,CSE 290,A00,090135,Bafna; Vineet,0,0,0,0
1653448702605,CSE 290,B00,090136,Ramamoorthi; Ravi,0,0,0,0
1653448702605,CSE 290,C00,090137,Li; Tzumao,9,0,10,1
1653448702605,CSE 290,D00,090138,Zhou; Yuan-Yuan,10,0,10,0
1653448702605,CSE 290,E00,090139,Christensen; Henrik I,10,0,10,0
1653448702605,CSE 290,F00,094053,Shalev; Aaron D,0,0,0,0
1653448703140,CSE 291,A00,090140,Munyaka; Imani N. S.,0,0,0,0
1653448703140,CSE 291,B00,094880,Yu; Qi,0,0,0,0
1653448703140,CSE 291,C00,090142,Pannuto; Patrick William,0,0,0,0
1653448703140,CSE 291,D00,094881,Zhang; Yiying,0,0,0,0
1653448703140,CSE 291,E00,095118,Su; Hao,0,0,0,0
1653448703674,CSE 293,001,094905,Bafna; Vineet,9999,0,9999,0
1653448703674,CSE 293,002,094906,Bellare; Mihir,9999,0,9999,0
1653448703674,CSE 293,003,094907,Berg-Kirkpatrick; Taylor D,9999,0,9999,0
1653448703674,CSE 293,004,094908,Christensen; Henrik I,9999,0,9999,0
1653448703674,CSE 293,005,094909,Cottrell; Garrison W,9999,0,9999,0
1653448703674,CSE 293,006,094910,Deutsch; Alin Bernard,9999,0,9999,0
1653448703674,CSE 293,007,094911,Esmaeilzadeh; Hadi,9999,0,9999,0
1653448703674,CSE 293,008,094912,Freund; Yoav,9999,0,9999,0
1653448703674,CSE 293,009,094913,Griswold; William G.,9999,0,9999,0
1653448703674,CSE 293,010,094914,Gymrek; Melissa Ann,9999,0,9999,0
1653448703674,CSE 293,011,094915,Heninger; Nadia A,9999,0,9999,0
1653448703674,CSE 293,012,094916,Impagliazzo; Russell,9999,0,9999,0
1653448703674,CSE 293,013,094917,Jhala; Ranjit,9999,0,9999,0
1653448703674,CSE 293,014,094918,Kahng; Andrew Byun,9999,0,9999,0
1653448703674,CSE 293,015,094919,Kane; Daniel Mertz,9999,0,9999,0
1653448703674,CSE 293,016,094920,Kriegman; David J,9999,0,9999,0
1653448703674,CSE 293,017,094921,Kumar; Arun Kumar,9999,0,9999,0
1653448703674,CSE 293,018,094922,Lerner; Sorin,9999,0,9999,0
1653448703674,CSE 293,019,094923,Lovett; Shachar,9999,0,9999,0
1653448703674,CSE 293,020,094924,McAuley; Julian John,9999,0,9999,0
1653448703674,CSE 293,021,094925,Micciancio; Daniele,9999,0,9999,0
1653448703674,CSE 293,022,094926,Orailoglu; Alex,9999,0,9999,0
1653448703674,CSE 293,023,094927,Paturi; Ramamohan,9999,0,9999,0
1653448703674,CSE 293,024,094928,Polikarpova; Nadezhda,9999,0,9999,0
1653448703674,CSE 293,025,094929,Politz; Joseph Gibbs,9999,0,9999,0
1653448703674,CSE 293,026,094930,Porter; George M,9999,0,9999,0
1653448703674,CSE 293,027,094931,Porter; Leonard Emerson,9999,0,9999,0
1653448703674,CSE 293,028,094932,Ramamoorthi; Ravi,9999,0,9999,0
1653448703674,CSE 293,029,094933,Sahoo; Debashis,9999,0,9999,0
1653448703674,CSE 293,030,094934,Saul; Lawrence,9999,0,9999,0
1653448703674,CSE 293,031,094935,Savage; Stefan,9999,0,9999,0
1653448703674,CSE 293,032,094936,Schulze; Jurgen P.,9999,0,9999,0
1653448703674,CSE 293,033,094937,Snoeren; Alex C.,9999,0,9999,0
1653448703674,CSE 293,034,094938,Shang; Jingbo,9999,0,9999,0
1653448703674,CSE 293,035,094939,Stefan; Deian,9999,0,9999,0
1653448703674,CSE 293,036,094940,Su; Hao,9999,0,9999,0
1653448703674,CSE 293,037,094941,Swanson; Steven James,9999,0,9999,0
1653448703674,CSE 293,038,094942,Tullsen; Dean Michael,9999,0,9999,0
1653448703674,CSE 293,039,094943,Voelker; Geoffrey M.,9999,0,9999,0
1653448703674,CSE 293,040,094944,Zhao; Jishen,9999,0,9999,0
1653448703674,CSE 293,041,094945,Zhou; Yuan-Yuan,9999,0,9999,0
1653448703674,CSE 293,042,094946,Gao; Sicun,9998,0,9999,1
1653448703674,CSE 293,043,094947,Weibel; Nadir,9999,0,9999,0
1653448703674,CSE 293,044,094948,Gupta; Rajesh K.,9999,0,9999,0
1653448704196,CSE 294,A00,090143,Porter; George M,9,0,10,1
1653448704726,DSE 200,A00,091799,Staff,50,0,50,0
1653448705253,DSE 203,A00,091800,Gupta; Amarnath,30,0,30,0
1653448705774,DSE 250,A00,091801,Deutsch; Alin Bernard,30,0,30,0
1653448706307,DSE 290,A00,091802,Altintas De Callaf; Ilkay,50,0,50,0
1653448706869,ECE 200,001,091003,Antipa; Nicholas A,9999,0,9999,0
1653448706869,ECE 200,002,091004,Atanasov; Nikolay A.,9999,0,9999,0
1653448706869,ECE 200,003,091005,Bharadia; Dinesh,9999,0,9999,0
1653448706869,ECE 200,004,091006,Cheng; Chung Kuan,9999,0,9999,0
1653448706869,ECE 200,005,091007,Cosman; Pamela C.,9999,0,9999,0
1653448706869,ECE 200,006,091008,Staff,9999,0,9999,0
1653448706869,ECE 200,007,091009,Dayeh; Shadi Ahmad,9999,0,9999,0
1653448706869,ECE 200,008,091010,Fainman; Yeshaiahu,9999,0,9999,0
1653448706869,ECE 200,009,091011,Ford; Joseph Earl,9999,0,9999,0
1653448706869,ECE 200,010,091012,Franceschetti; Massimo,9999,0,9999,0
1653448706869,ECE 200,011,091013,Fullerton; Eric E,9999,0,9999,0
1653448706869,ECE 200,012,091014,Galton; Ian A,9999,0,9999,0
1653448706869,ECE 200,013,091015,Gilja; Vikash,9999,0,9999,0
1653448706869,ECE 200,014,091016,Hall; Drew A.,9999,0,9999,0
1653448706869,ECE 200,015,091017,Hsueh; Tzu-Chien,9999,0,9999,0
1653448706869,ECE 200,016,091018,Javidi; Tara,9999,0,9999,0
1653448706869,ECE 200,017,091019,Kahng; Andrew Byun,9999,0,9999,0
1653448706869,ECE 200,018,091020,Kim; Young-Han,9999,0,9999,0
1653448706869,ECE 200,019,091021,Koushanfar; Farinaz,9999,0,9999,0
1653448706869,ECE 200,020,091022,Kuzum; Duygu,9999,0,9999,0
1653448706869,ECE 200,021,091023,Le; Hanh-Phuc,9999,0,9999,0
1653448706869,ECE 200,022,091024,Lin; Bill,9999,0,9999,0
1653448706869,ECE 200,023,091025,Liu; Zhaowei,9999,0,9999,0
1653448706869,ECE 200,024,091026,Lo; Yu-Hwa,9999,0,9999,0
1653448706869,ECE 200,025,091027,Lomakin; Vitaliy,9999,0,9999,0
1653448706869,ECE 200,026,091028,Mercier; Patrick Philip,9999,0,9999,0
1653448706869,ECE 200,027,091029,Meyer; Florian,9999,0,9999,0
1653448706869,ECE 200,028,091030,Milstein; Laurence B.,9999,0,9999,0
1653448706869,ECE 200,029,091031,Mir Arabbaygi; Siavash,9999,0,9999,0
1653448706869,ECE 200,030,091032,Mookherjea; Shayan,9999,0,9999,0
1653448706869,ECE 200,031,091033,Morris; Karcher William,9999,0,9999,0
1653448706869,ECE 200,032,091034,Ng; Tse Nga,9999,0,9999,0
1653448706869,ECE 200,033,091035,Nguyen; Truong Quang,9999,0,9999,0
1653448706869,ECE 200,034,091036,Nomura; Kenji,9999,0,9999,0
1653448706869,ECE 200,035,091037,Orlitsky; Alon,9999,0,9999,0
1653448706869,ECE 200,036,091038,Pal; Piya,9999,0,9999,0
1653448706869,ECE 200,037,091039,Papen; George C.,9999,0,9999,0
1653448706869,ECE 200,038,091040,Radic; Stojan,9999,0,9999,0
1653448706869,ECE 200,039,091041,Rao; Bhaskar D.,9999,0,9999,0
1653448706869,ECE 200,040,091042,Rao; Ramesh R,9999,0,9999,0
1653448706869,ECE 200,041,091043,Rebeiz; Gabriel,9999,0,9999,0
1653448706869,ECE 200,042,091044,Sanford; John R,9999,0,9999,0
1653448706869,ECE 200,043,091045,Siegel; Paul H.,9999,0,9999,0
1653448706869,ECE 200,044,091046,Sievenpiper; Daniel F.,9999,0,9999,0
1653448706869,ECE 200,045,091047,Sworder; David D.,9999,0,9999,0
1653448706869,ECE 200,046,091048,Taur; Yuan,9999,0,9999,0
1653448706869,ECE 200,047,091049,Touri; Behrouz,9999,0,9999,0
1653448706869,ECE 200,048,091050,Trivedi; Mohan M.,9999,0,9999,0
1653448706869,ECE 200,049,091051,Vardy; Alexander,9999,0,9999,0
1653448706869,ECE 200,050,091052,Vasconcelos; Nuno,9999,0,9999,0
1653448706869,ECE 200,051,091053,Wang; Xiaolong,9999,0,9999,0
1653448706869,ECE 200,052,091054,Xie; Pengtao,9999,0,9999,0
1653448706869,ECE 200,053,091055,Yip; Michael,9999,0,9999,0
1653448706869,ECE 200,054,091056,Zeger; Kenneth A.,9999,0,9999,0
1653448706869,ECE 200,055,091057,Zhang; Xinyu,9999,0,9999,0
1653448706869,ECE 200,056,091058,Turakhia; Yatish Girish,9999,0,9999,0
1653448706869,ECE 200,057,091059,Kang; Mingu,9999,0,9999,0
1653448706869,ECE 200,058,091060,Shi; Yuanyuan,9999,0,9999,0
1653448706869,ECE 200,059,091061,Wang; Edward Jay,9999,0,9999,0
1653448706869,ECE 200,060,091062,Zheng; Yang,9999,0,9999,0
1653448707392,ECE 203,A00,091065,Mercier; Patrick Philip,0,0,0,0
1653448707919,ECE 207A,A00,091605,Liu; Thomas Tao-Ming,0,0,0,0
1653448708447,ECE 212AN,A00,091068,Nomura; Kenji,0,0,0,0
1653448708979,ECE 222A,A00,091069,Rebeiz; Gabriel,0,0,0,0
1653448709503,ECE 225A,A00,091070,Orlitsky; Alon,0,0,0,0
1653448710039,ECE 230A,A00,091071,Nomura; Kenji,0,0,0,0
1653448710564,ECE 236A,A00,091072,Dayeh; Shadi Ahmad,0,0,0,0
1653448711089,ECE 238A,A00,091073,Luo; Jian,0,0,0,0
1653448711089,ECE 238A,B00,091074,Luo; Jian,0,0,0,0
1653448711615,ECE 240A,A00,091075,Radic; Stojan,0,0,0,0
1653448712145,ECE 247A,A00,091592,Shi; Lingyan,0,0,0,0
1653448712668,ECE 250,A00,091076,Touri; Behrouz,0,0,0,0
1653448713191,ECE 251C,A00,091078,Nguyen; Truong Quang,0,0,0,0
1653448713713,ECE 253,A00,091079,Cosman; Pamela C.,0,0,0,0
1653448714236,ECE 255A,A00,091080,Orlitsky; Alon,0,0,0,0
1653448714768,ECE 257A,A00,091081,Zhang; Xinyu,0,0,0,0
1653448715290,ECE 260A,A01,091084,Eldon; John,0,0,0,0
1653448715820,ECE 264C,A00,091085,Galton; Ian A,0,0,0,0
1653448716343,ECE 265C,A00,094889,Presti; Calogero Davide,0,0,0,9
1653448716864,ECE 266,A01,091087,Hall; Drew A.,0,0,0,0
1653448717915,ECE 271A,A00,091090,Vasconcelos; Nuno,0,0,0,0
1653448718437,ECE 272B,A00,091091,Sworder; David D.,0,0,0,0
1653448718959,ECE 275A,A00,091092,Meyer; Florian,0,0,0,0
1653448719482,ECE 277,A00,091093,An; Cheolhong,0,0,0,0
1653448720004,ECE 283,A00,091094,Le; Hanh-Phuc,0,0,0,0
1653448720532,ECE 284,A00,091095,Kang; Mingu,0,0,0,0
1653448720532,ECE 284,B00,091096,Wang; Edward Jay,0,0,0,0
1653448721061,ECE 285,A00,094334,Touri; Behrouz,0,0,0,0
1653448721583,ECE 289,A00,091097,Whelan; David Arthur,0,0,0,0
1653448722113,MATH 200A,A00,087414,Salehi Golsefidy; Alireza,7,0,8,1
1653448722637,MATH 202A,A00,087415,Gill; Philip E.,3,0,8,5
1653448723174,MATH 203A,A00,087416,Oprea; Dragos N.,6,0,8,2
1653448723700,MATH 204A,A00,087417,Kedlaya; Kiran S.,6,0,8,2
1653448724226,MATH 205,A00,087418,Sorensen; Claus M,6,0,8,2
1653448724750,MATH 206A,A00,087419,Izadi; Elham,7,0,8,1
1653448725274,MATH 207A,A00,087420,Mohammadi; Amir,6,0,8,2
1653448725796,MATH 208,A00,087421,Staff,9,0,10,1
1653448726327,MATH 209,A00,087422,Staff,10,0,10,0
1653448726853,MATH 218,A00,087423,Staff,10,0,10,0
1653448727378,MATH 220A,A00,087424,Novak; Jonathan I,7,0,8,1
1653448727901,MATH 231A,A00,087425,Bejenaru; Ioan,3,0,8,5
1653448728430,MATH 240A,A00,087426,Ebenfelt; Peter F,5,0,8,3
1653448728952,MATH 243,A00,087427,Staff,9,0,10,1
1653448729477,MATH 248,A00,087429,Staff,10,0,10,0
1653448730003,MATH 250A,A00,087430,Spolaor; Luca,4,0,8,4
1653448730528,MATH 257A,A00,087431,Spolaor; Luca,7,0,8,1
1653448731053,MATH 258,A00,087432,Staff,9,0,10,1
1653448731576,MATH 264A,A00,087433,Warnke; Lutz Peter,5,0,8,3
1653448732102,MATH 268,A00,087434,Staff,15,0,15,0
1653448732625,MATH 269,A00,087435,Staff,14,0,15,1
1653448733161,MATH 270A,A00,087436,Nie; Jiawang,0,0,8,8
1653448733688,MATH 272A,A00,087437,Tian; Xiaochuan,1,0,8,7
1653448734211,MATH 274,A01,087439,Cheng; Li-Tien,9,0,10,1
1653448734211,MATH 274,A02,087440,Cheng; Li-Tien,10,0,10,0
1653448734737,MATH 278A,A00,087441,Staff,8,0,10,2
1653448735258,MATH 278B,A00,087442,Staff,8,0,10,2
1653448735783,MATH 278C,A00,087443,Staff,8,0,10,2
1653448736305,MATH 280A,A00,087444,Zheng; Tianyi,0,0,8,8
1653448736835,MATH 281A,A00,087445,Bradic; Jelena,0,0,8,8
1653448737357,MATH 282A,A00,087446,Zhang; Danna,0,0,8,8
1653448737894,MATH 283,A00,087447,Tesler; Glenn,0,0,0,14
1653448738487,MATH 286,A00,087448,Kemp; Todd Aahron,5,0,8,3
1653448739017,MATH 287D,A00,087449,Bradic; Jelena,8,0,8,0
1653448739539,MATH 288,A00,087450,Staff,14,0,15,1
1653448739539,MATH 288,B00,087451,Staff,15,0,15,0
1653448739539,MATH 288,C00,087452,Staff,15,0,15,0
1653448740063,MATH 290A,A00,087453,Xu; Zhouli,7,0,8,1
1653448740588,MATH 291A,A00,087454,Xu; Zhouli,7,0,8,1
1653448741111,MATH 292,A00,087455,Staff,10,0,10,0
1653448741637,MATH 295,A00,087456,Staff,50,0,50,0
1653448742165,MATH 297,001,087457,Staff,998,0,999,1
1653449303843,COGS 200,A01,087991,Staff,47,0,50,3
1653449304371,COGS 201,A01,094504,Rangel; Lara M,17,0,25,8
1653449304902,COGS 203,A00,087992,Coulson; Seana M,18,0,20,2
1653449305424,COGS 210A,001,087993,Greene; Deanna Jacquelyn,9998,0,9999,1
1653449305424,COGS 210A,002,087994,Saygin; Ayse P,9999,0,9999,0
1653449305424,COGS 210A,003,087995,Xia; Haijun,9999,0,9999,0
1653449305424,COGS 210A,004,087996,Nitz; Douglas A.,9999,0,9999,0
1653449305424,COGS 210A,005,087997,Hollan; James D.,9999,0,9999,0
1653449305424,COGS 210A,006,087998,Deak; Gedeon O.,9998,0,9999,1
1653449305424,COGS 210A,007,087999,Rossano; Federico,9999,0,9999,0
1653449305949,COGS 211A,A00,088000,Coulson; Seana M,9997,0,9999,2
1653449306471,COGS 229,A00,088002,Staff,23,0,25,2
1653449307002,COGS 260,B00,094231,Staff,17,0,20,3
1653449307002,COGS 260,A00,088004,Nitz; Douglas A.,9998,0,9999,1
1653449307525,CSE 202,A00,090110,Paturi; Ramamohan,0,0,0,0
1653449307525,CSE 202,B00,090111,Paturi; Ramamohan,0,0,0,0
1653449308058,CSE 207B,A00,090112,Heninger; Nadia A,0,0,0,0
1653449308589,CSE 208,A00,094858,Micciancio; Daniele,0,0,0,0
1653449309115,CSE 210,A00,090113,Powell; Thomas Allan,0,0,0,0
1653449309637,CSE 219,A00,090898,Staff,0,0,0,0
1653449310169,CSE 221,A00,090114,Zhou; Yuan-Yuan,0,0,0,0
1653449310691,CSE 229A,A00,090115,Porter; George M,0,0,0,0
1653449311217,CSE 229C,A00,090116,Savage; Stefan,0,0,0,0
1653449311743,CSE 230,A00,090117,Jhala; Ranjit,0,0,0,0
1653449312276,CSE 232,A00,090118,Papakonstantinou; Yannis,0,0,0,0
1653449312799,CSE 239A,A00,090121,Kumar; Arun Kumar,0,0,0,0
1653449313322,CSE 239B,A00,090122,Jhala; Ranjit,0,0,0,0
1653449313845,CSE 240A,A00,090123,Zhao; Jishen,0,0,189,189
1653449314371,CSE 243A,A00,090124,Orailoglu; Alex,1,0,15,14
1653449314893,CSE 249B,A00,090125,Kahng; Andrew Byun,13,0,20,7
1653449315423,CSE 250A,A00,090126,Berg-Kirkpatrick; Taylor D,0,0,0,0
1653449315950,CSE 252A,A00,090127,Ochoa; Benjamin Lawrence,0,0,0,0
1653449316472,CSE 258,A01,090129,McAuley; Julian John,0,0,0,0
1653449316995,CSE 258R,A01,090131,McAuley; Julian John,0,0,0,0
1653449317517,CSE 274,A00,090132,Ramamoorthi; Ravi,0,0,0,0
1653449318044,CSE 276A,A00,090133,Christensen; Henrik I,0,0,0,0
1653449318566,CSE 276C,A00,090134,Christensen; Henrik I,0,0,0,0
1653449319088,CSE 290,A00,090135,Bafna; Vineet,0,0,0,0
1653449319088,CSE 290,B00,090136,Ramamoorthi; Ravi,0,0,0,0
1653449319088,CSE 290,C00,090137,Li; Tzumao,9,0,10,1
1653449319088,CSE 290,D00,090138,Zhou; Yuan-Yuan,10,0,10,0
1653449319088,CSE 290,E00,090139,Christensen; Henrik I,10,0,10,0
1653449319088,CSE 290,F00,094053,Shalev; Aaron D,0,0,0,0
1653449319623,CSE 291,A00,090140,Munyaka; Imani N. S.,0,0,0,0
1653449319623,CSE 291,B00,094880,Yu; Qi,0,0,0,0
1653449319623,CSE 291,C00,090142,Pannuto; Patrick William,0,0,0,0
1653449319623,CSE 291,D00,094881,Zhang; Yiying,0,0,0,0
1653449319623,CSE 291,E00,095118,Su; Hao,0,0,0,0
1653449320160,CSE 293,001,094905,Bafna; Vineet,9999,0,9999,0
1653449320160,CSE 293,002,094906,Bellare; Mihir,9999,0,9999,0
1653449320160,CSE 293,003,094907,Berg-Kirkpatrick; Taylor D,9999,0,9999,0
1653449320160,CSE 293,004,094908,Christensen; Henrik I,9999,0,9999,0
1653449320160,CSE 293,005,094909,Cottrell; Garrison W,9999,0,9999,0
1653449320160,CSE 293,006,094910,Deutsch; Alin Bernard,9999,0,9999,0
1653449320160,CSE 293,007,094911,Esmaeilzadeh; Hadi,9999,0,9999,0
1653449320160,CSE 293,008,094912,Freund; Yoav,9999,0,9999,0
1653449320160,CSE 293,009,094913,Griswold; William G.,9999,0,9999,0
1653449320160,CSE 293,010,094914,Gymrek; Melissa Ann,9999,0,9999,0
1653449320160,CSE 293,011,094915,Heninger; Nadia A,9999,0,9999,0
1653449320160,CSE 293,012,094916,Impagliazzo; Russell,9999,0,9999,0
1653449320160,CSE 293,013,094917,Jhala; Ranjit,9999,0,9999,0
1653449320160,CSE 293,014,094918,Kahng; Andrew Byun,9999,0,9999,0
1653449320160,CSE 293,015,094919,Kane; Daniel Mertz,9999,0,9999,0
1653449320160,CSE 293,016,094920,Kriegman; David J,9999,0,9999,0
1653449320160,CSE 293,017,094921,Kumar; Arun Kumar,9999,0,9999,0
1653449320160,CSE 293,018,094922,Lerner; Sorin,9999,0,9999,0
1653449320160,CSE 293,019,094923,Lovett; Shachar,9999,0,9999,0
1653449320160,CSE 293,020,094924,McAuley; Julian John,9999,0,9999,0
1653449320160,CSE 293,021,094925,Micciancio; Daniele,9999,0,9999,0
1653449320160,CSE 293,022,094926,Orailoglu; Alex,9999,0,9999,0
1653449320160,CSE 293,023,094927,Paturi; Ramamohan,9999,0,9999,0
1653449320160,CSE 293,024,094928,Polikarpova; Nadezhda,9999,0,9999,0
1653449320160,CSE 293,025,094929,Politz; Joseph Gibbs,9999,0,9999,0
1653449320160,CSE 293,026,094930,Porter; George M,9999,0,9999,0
1653449320160,CSE 293,027,094931,Porter; Leonard Emerson,9999,0,9999,0
1653449320160,CSE 293,028,094932,Ramamoorthi; Ravi,9999,0,9999,0
1653449320160,CSE 293,029,094933,Sahoo; Debashis,9999,0,9999,0
1653449320160,CSE 293,030,094934,Saul; Lawrence,9999,0,9999,0
1653449320160,CSE 293,031,094935,Savage; Stefan,9999,0,9999,0
1653449320160,CSE 293,032,094936,Schulze; Jurgen P.,9999,0,9999,0
1653449320160,CSE 293,033,094937,Snoeren; Alex C.,9999,0,9999,0
1653449320160,CSE 293,034,094938,Shang; Jingbo,9999,0,9999,0
1653449320160,CSE 293,035,094939,Stefan; Deian,9999,0,9999,0
1653449320160,CSE 293,036,094940,Su; Hao,9999,0,9999,0
1653449320160,CSE 293,037,094941,Swanson; Steven James,9999,0,9999,0
1653449320160,CSE 293,038,094942,Tullsen; Dean Michael,9999,0,9999,0
1653449320160,CSE 293,039,094943,Voelker; Geoffrey M.,9999,0,9999,0
1653449320160,CSE 293,040,094944,Zhao; Jishen,9999,0,9999,0
1653449320160,CSE 293,041,094945,Zhou; Yuan-Yuan,9999,0,9999,0
1653449320160,CSE 293,042,094946,Gao; Sicun,9998,0,9999,1
1653449320160,CSE 293,043,094947,Weibel; Nadir,9999,0,9999,0
1653449320160,CSE 293,044,094948,Gupta; Rajesh K.,9999,0,9999,0
1653449320686,CSE 294,A00,090143,Porter; George M,9,0,10,1
1653449321215,DSE 200,A00,091799,Staff,50,0,50,0
1653449321738,DSE 203,A00,091800,Gupta; Amarnath,30,0,30,0
1653449322275,DSE 250,A00,091801,Deutsch; Alin Bernard,30,0,30,0
1653449322810,DSE 290,A00,091802,Altintas De Callaf; Ilkay,50,0,50,0
1653449323343,ECE 200,001,091003,Antipa; Nicholas A,9999,0,9999,0
1653449323343,ECE 200,002,091004,Atanasov; Nikolay A.,9999,0,9999,0
1653449323343,ECE 200,003,091005,Bharadia; Dinesh,9999,0,9999,0
1653449323343,ECE 200,004,091006,Cheng; Chung Kuan,9999,0,9999,0
1653449323343,ECE 200,005,091007,Cosman; Pamela C.,9999,0,9999,0
1653449323343,ECE 200,006,091008,Staff,9999,0,9999,0
1653449323343,ECE 200,007,091009,Dayeh; Shadi Ahmad,9999,0,9999,0
1653449323343,ECE 200,008,091010,Fainman; Yeshaiahu,9999,0,9999,0
1653449323343,ECE 200,009,091011,Ford; Joseph Earl,9999,0,9999,0
1653449323343,ECE 200,010,091012,Franceschetti; Massimo,9999,0,9999,0
1653449323343,ECE 200,011,091013,Fullerton; Eric E,9999,0,9999,0
1653449323343,ECE 200,012,091014,Galton; Ian A,9999,0,9999,0
1653449323343,ECE 200,013,091015,Gilja; Vikash,9999,0,9999,0
1653449323343,ECE 200,014,091016,Hall; Drew A.,9999,0,9999,0
1653449323343,ECE 200,015,091017,Hsueh; Tzu-Chien,9999,0,9999,0
1653449323343,ECE 200,016,091018,Javidi; Tara,9999,0,9999,0
1653449323343,ECE 200,017,091019,Kahng; Andrew Byun,9999,0,9999,0
1653449323343,ECE 200,018,091020,Kim; Young-Han,9999,0,9999,0
1653449323343,ECE 200,019,091021,Koushanfar; Farinaz,9999,0,9999,0
1653449323343,ECE 200,020,091022,Kuzum; Duygu,9999,0,9999,0
1653449323343,ECE 200,021,091023,Le; Hanh-Phuc,9999,0,9999,0
1653449323343,ECE 200,022,091024,Lin; Bill,9999,0,9999,0
1653449323343,ECE 200,023,091025,Liu; Zhaowei,9999,0,9999,0
1653449323343,ECE 200,024,091026,Lo; Yu-Hwa,9999,0,9999,0
1653449323343,ECE 200,025,091027,Lomakin; Vitaliy,9999,0,9999,0
1653449323343,ECE 200,026,091028,Mercier; Patrick Philip,9999,0,9999,0
1653449323343,ECE 200,027,091029,Meyer; Florian,9999,0,9999,0
1653449323343,ECE 200,028,091030,Milstein; Laurence B.,9999,0,9999,0
1653449323343,ECE 200,029,091031,Mir Arabbaygi; Siavash,9999,0,9999,0
1653449323343,ECE 200,030,091032,Mookherjea; Shayan,9999,0,9999,0
1653449323343,ECE 200,031,091033,Morris; Karcher William,9999,0,9999,0
1653449323343,ECE 200,032,091034,Ng; Tse Nga,9999,0,9999,0
1653449323343,ECE 200,033,091035,Nguyen; Truong Quang,9999,0,9999,0
1653449323343,ECE 200,034,091036,Nomura; Kenji,9999,0,9999,0
1653449323343,ECE 200,035,091037,Orlitsky; Alon,9999,0,9999,0
1653449323343,ECE 200,036,091038,Pal; Piya,9999,0,9999,0
1653449323343,ECE 200,037,091039,Papen; George C.,9999,0,9999,0
1653449323343,ECE 200,038,091040,Radic; Stojan,9999,0,9999,0
1653449323343,ECE 200,039,091041,Rao; Bhaskar D.,9999,0,9999,0
1653449323343,ECE 200,040,091042,Rao; Ramesh R,9999,0,9999,0
1653449323343,ECE 200,041,091043,Rebeiz; Gabriel,9999,0,9999,0
1653449323343,ECE 200,042,091044,Sanford; John R,9999,0,9999,0
1653449323343,ECE 200,043,091045,Siegel; Paul H.,9999,0,9999,0
1653449323343,ECE 200,044,091046,Sievenpiper; Daniel F.,9999,0,9999,0
1653449323343,ECE 200,045,091047,Sworder; David D.,9999,0,9999,0
1653449323343,ECE 200,046,091048,Taur; Yuan,9999,0,9999,0
1653449323343,ECE 200,047,091049,Touri; Behrouz,9999,0,9999,0
1653449323343,ECE 200,048,091050,Trivedi; Mohan M.,9999,0,9999,0
1653449323343,ECE 200,049,091051,Vardy; Alexander,9999,0,9999,0
1653449323343,ECE 200,050,091052,Vasconcelos; Nuno,9999,0,9999,0
1653449323343,ECE 200,051,091053,Wang; Xiaolong,9999,0,9999,0
1653449323343,ECE 200,052,091054,Xie; Pengtao,9999,0,9999,0
1653449323343,ECE 200,053,091055,Yip; Michael,9999,0,9999,0
1653449323343,ECE 200,054,091056,Zeger; Kenneth A.,9999,0,9999,0
1653449323343,ECE 200,055,091057,Zhang; Xinyu,9999,0,9999,0
1653449323343,ECE 200,056,091058,Turakhia; Yatish Girish,9999,0,9999,0
1653449323343,ECE 200,057,091059,Kang; Mingu,9999,0,9999,0
1653449323343,ECE 200,058,091060,Shi; Yuanyuan,9999,0,9999,0
1653449323343,ECE 200,059,091061,Wang; Edward Jay,9999,0,9999,0
1653449323343,ECE 200,060,091062,Zheng; Yang,9999,0,9999,0
1653449323881,ECE 203,A00,091065,Mercier; Patrick Philip,0,0,0,0
1653449324409,ECE 207A,A00,091605,Liu; Thomas Tao-Ming,0,0,0,0
1653449324930,ECE 212AN,A00,091068,Nomura; Kenji,0,0,0,0
1653449325462,ECE 222A,A00,091069,Rebeiz; Gabriel,0,0,0,0
1653449325985,ECE 225A,A00,091070,Orlitsky; Alon,0,0,0,0
1653449326512,ECE 230A,A00,091071,Nomura; Kenji,0,0,0,0
1653449327035,ECE 236A,A00,091072,Dayeh; Shadi Ahmad,0,0,0,0
1653449327650,ECE 238A,A00,091073,Luo; Jian,0,0,0,0
1653449327650,ECE 238A,B00,091074,Luo; Jian,0,0,0,0
1653449328182,ECE 240A,A00,091075,Radic; Stojan,0,0,0,0
1653449328711,ECE 247A,A00,091592,Shi; Lingyan,0,0,0,0
1653449329234,ECE 250,A00,091076,Touri; Behrouz,0,0,0,0
1653449329757,ECE 251C,A00,091078,Nguyen; Truong Quang,0,0,0,0
1653449330287,ECE 253,A00,091079,Cosman; Pamela C.,0,0,0,0
1653449330814,ECE 255A,A00,091080,Orlitsky; Alon,0,0,0,0
1653449331342,ECE 257A,A00,091081,Zhang; Xinyu,0,0,0,0
1653449331864,ECE 260A,A01,091084,Eldon; John,0,0,0,0
1653449332387,ECE 264C,A00,091085,Galton; Ian A,0,0,0,0
1653449332912,ECE 265C,A00,094889,Presti; Calogero Davide,0,0,0,9
1653449333444,ECE 266,A01,091087,Hall; Drew A.,0,0,0,0
1653449334500,ECE 271A,A00,091090,Vasconcelos; Nuno,0,0,0,0
1653449335023,ECE 272B,A00,091091,Sworder; David D.,0,0,0,0
1653449335545,ECE 275A,A00,091092,Meyer; Florian,0,0,0,0
1653449336071,ECE 277,A00,091093,An; Cheolhong,0,0,0,0
1653449336596,ECE 283,A00,091094,Le; Hanh-Phuc,0,0,0,0
1653449337126,ECE 284,A00,091095,Kang; Mingu,0,0,0,0
1653449337126,ECE 284,B00,091096,Wang; Edward Jay,0,0,0,0
1653449337654,ECE 285,A00,094334,Touri; Behrouz,0,0,0,0
1653449338179,ECE 289,A00,091097,Whelan; David Arthur,0,0,0,0
1653449338703,MATH 200A,A00,087414,Salehi Golsefidy; Alireza,7,0,8,1
1653449339225,MATH 202A,A00,087415,Gill; Philip E.,3,0,8,5
1653449339748,MATH 203A,A00,087416,Oprea; Dragos N.,6,0,8,2
1653449340274,MATH 204A,A00,087417,Kedlaya; Kiran S.,6,0,8,2
1653449340802,MATH 205,A00,087418,Sorensen; Claus M,6,0,8,2
1653449341336,MATH 206A,A00,087419,Izadi; Elham,7,0,8,1
1653449341860,MATH 207A,A00,087420,Mohammadi; Amir,6,0,8,2
1653449342386,MATH 208,A00,087421,Staff,9,0,10,1
1653449342909,MATH 209,A00,087422,Staff,10,0,10,0
1653449343435,MATH 218,A00,087423,Staff,10,0,10,0
1653449343958,MATH 220A,A00,087424,Novak; Jonathan I,7,0,8,1
1653449344481,MATH 231A,A00,087425,Bejenaru; Ioan,3,0,8,5
1653449345004,MATH 240A,A00,087426,Ebenfelt; Peter F,5,0,8,3
1653449345526,MATH 243,A00,087427,Staff,9,0,10,1
1653449346048,MATH 248,A00,087429,Staff,10,0,10,0
1653449346581,MATH 250A,A00,087430,Spolaor; Luca,4,0,8,4
1653449347103,MATH 257A,A00,087431,Spolaor; Luca,7,0,8,1
1653449347628,MATH 258,A00,087432,Staff,9,0,10,1
1653449348151,MATH 264A,A00,087433,Warnke; Lutz Peter,5,0,8,3
1653449348676,MATH 268,A00,087434,Staff,15,0,15,0
1653449349199,MATH 269,A00,087435,Staff,14,0,15,1
1653449349722,MATH 270A,A00,087436,Nie; Jiawang,0,0,8,8
1653449350245,MATH 272A,A00,087437,Tian; Xiaochuan,1,0,8,7
1653449350771,MATH 274,A01,087439,Cheng; Li-Tien,9,0,10,1
1653449350771,MATH 274,A02,087440,Cheng; Li-Tien,10,0,10,0
1653449351292,MATH 278A,A00,087441,Staff,8,0,10,2
1653449351815,MATH 278B,A00,087442,Staff,8,0,10,2
1653449352337,MATH 278C,A00,087443,Staff,8,0,10,2
1653449352863,MATH 280A,A00,087444,Zheng; Tianyi,0,0,8,8
1653449353389,MATH 281A,A00,087445,Bradic; Jelena,0,0,8,8
1653449353912,MATH 282A,A00,087446,Zhang; Danna,0,0,8,8
1653449354439,MATH 283,A00,087447,Tesler; Glenn,0,0,0,14
1653449354963,MATH 286,A00,087448,Kemp; Todd Aahron,5,0,8,3
1653449355487,MATH 287D,A00,087449,Bradic; Jelena,8,0,8,0
1653449356014,MATH 288,A00,087450,Staff,14,0,15,1
1653449356014,MATH 288,B00,087451,Staff,15,0,15,0
1653449356014,MATH 288,C00,087452,Staff,15,0,15,0
1653449356536,MATH 290A,A00,087453,Xu; Zhouli,7,0,8,1
1653449357061,MATH 291A,A00,087454,Xu; Zhouli,7,0,8,1
1653449357590,MATH 292,A00,087455,Staff,10,0,10,0
1653449358123,MATH 295,A00,087456,Staff,50,0,50,0
1653449358654,MATH 297,001,087457,Staff,998,0,999,1
1653449931818,COGS 200,A01,087991,Staff,47,0,50,3
1653449932342,COGS 201,A01,094504,Rangel; Lara M,17,0,25,8
1653449932873,COGS 203,A00,087992,Coulson; Seana M,18,0,20,2
1653449933406,COGS 210A,001,087993,Greene; Deanna Jacquelyn,9998,0,9999,1
1653449933406,COGS 210A,002,087994,Saygin; Ayse P,9999,0,9999,0
1653449933406,COGS 210A,003,087995,Xia; Haijun,9999,0,9999,0
1653449933406,COGS 210A,004,087996,Nitz; Douglas A.,9999,0,9999,0
1653449933406,COGS 210A,005,087997,Hollan; James D.,9999,0,9999,0
1653449933406,COGS 210A,006,087998,Deak; Gedeon O.,9998,0,9999,1
1653449933406,COGS 210A,007,087999,Rossano; Federico,9999,0,9999,0
1653449933929,COGS 211A,A00,088000,Coulson; Seana M,9997,0,9999,2
1653449934454,COGS 229,A00,088002,Staff,23,0,25,2
1653449934978,COGS 260,B00,094231,Staff,17,0,20,3
1653449934978,COGS 260,A00,088004,Nitz; Douglas A.,9998,0,9999,1
1653449935512,CSE 202,A00,090110,Paturi; Ramamohan,0,0,0,0
1653449935512,CSE 202,B00,090111,Paturi; Ramamohan,0,0,0,0
1653449936036,CSE 207B,A00,090112,Heninger; Nadia A,0,0,0,0
1653449936565,CSE 208,A00,094858,Micciancio; Daniele,0,0,0,0
1653449937088,CSE 210,A00,090113,Powell; Thomas Allan,0,0,0,0
1653449937613,CSE 219,A00,090898,Staff,0,0,0,0
1653449938135,CSE 221,A00,090114,Zhou; Yuan-Yuan,0,0,0,0
1653449938661,CSE 229A,A00,090115,Porter; George M,0,0,0,0
1653449939186,CSE 229C,A00,090116,Savage; Stefan,0,0,0,0
1653449939711,CSE 230,A00,090117,Jhala; Ranjit,0,0,0,0
1653449940238,CSE 232,A00,090118,Papakonstantinou; Yannis,0,0,0,0
1653449940763,CSE 239A,A00,090121,Kumar; Arun Kumar,0,0,0,0
1653449941289,CSE 239B,A00,090122,Jhala; Ranjit,0,0,0,0
1653449941815,CSE 240A,A00,090123,Zhao; Jishen,0,0,189,189
1653449942341,CSE 243A,A00,090124,Orailoglu; Alex,1,0,15,14
1653449942863,CSE 249B,A00,090125,Kahng; Andrew Byun,13,0,20,7
1653449943396,CSE 250A,A00,090126,Berg-Kirkpatrick; Taylor D,0,0,0,0
1653449943918,CSE 252A,A00,090127,Ochoa; Benjamin Lawrence,0,0,0,0
1653449944443,CSE 258,A01,090129,McAuley; Julian John,0,0,0,0
1653449944969,CSE 258R,A01,090131,McAuley; Julian John,0,0,0,0
1653449945501,CSE 274,A00,090132,Ramamoorthi; Ravi,0,0,0,0
1653449946036,CSE 276A,A00,090133,Christensen; Henrik I,0,0,0,0
1653449946561,CSE 276C,A00,090134,Christensen; Henrik I,0,0,0,0
1653449947085,CSE 290,A00,090135,Bafna; Vineet,0,0,0,0
1653449947085,CSE 290,B00,090136,Ramamoorthi; Ravi,0,0,0,0
1653449947085,CSE 290,C00,090137,Li; Tzumao,9,0,10,1
1653449947085,CSE 290,D00,090138,Zhou; Yuan-Yuan,10,0,10,0
1653449947085,CSE 290,E00,090139,Christensen; Henrik I,10,0,10,0
1653449947085,CSE 290,F00,094053,Shalev; Aaron D,0,0,0,0
1653449947608,CSE 291,A00,090140,Munyaka; Imani N. S.,0,0,0,0
1653449947608,CSE 291,B00,094880,Yu; Qi,0,0,0,0
1653449947608,CSE 291,C00,090142,Pannuto; Patrick William,0,0,0,0
1653449947608,CSE 291,D00,094881,Zhang; Yiying,0,0,0,0
1653449947608,CSE 291,E00,095118,Su; Hao,0,0,0,0
1653449948144,CSE 293,001,094905,Bafna; Vineet,9999,0,9999,0
1653449948144,CSE 293,002,094906,Bellare; Mihir,9999,0,9999,0
1653449948144,CSE 293,003,094907,Berg-Kirkpatrick; Taylor D,9999,0,9999,0
1653449948144,CSE 293,004,094908,Christensen; Henrik I,9999,0,9999,0
1653449948144,CSE 293,005,094909,Cottrell; Garrison W,9999,0,9999,0
1653449948144,CSE 293,006,094910,Deutsch; Alin Bernard,9999,0,9999,0
1653449948144,CSE 293,007,094911,Esmaeilzadeh; Hadi,9999,0,9999,0
1653449948144,CSE 293,008,094912,Freund; Yoav,9999,0,9999,0
1653449948144,CSE 293,009,094913,Griswold; William G.,9999,0,9999,0
1653449948144,CSE 293,010,094914,Gymrek; Melissa Ann,9999,0,9999,0
1653449948144,CSE 293,011,094915,Heninger; Nadia A,9999,0,9999,0
1653449948144,CSE 293,012,094916,Impagliazzo; Russell,9999,0,9999,0
1653449948144,CSE 293,013,094917,Jhala; Ranjit,9999,0,9999,0
1653449948144,CSE 293,014,094918,Kahng; Andrew Byun,9999,0,9999,0
1653449948144,CSE 293,015,094919,Kane; Daniel Mertz,9999,0,9999,0
1653449948144,CSE 293,016,094920,Kriegman; David J,9999,0,9999,0
1653449948144,CSE 293,017,094921,Kumar; Arun Kumar,9999,0,9999,0
1653449948144,CSE 293,018,094922,Lerner; Sorin,9999,0,9999,0
1653449948144,CSE 293,019,094923,Lovett; Shachar,9999,0,9999,0
1653449948144,CSE 293,020,094924,McAuley; Julian John,9999,0,9999,0
1653449948144,CSE 293,021,094925,Micciancio; Daniele,9999,0,9999,0
1653449948144,CSE 293,022,094926,Orailoglu; Alex,9999,0,9999,0
1653449948144,CSE 293,023,094927,Paturi; Ramamohan,9999,0,9999,0
1653449948144,CSE 293,024,094928,Polikarpova; Nadezhda,9999,0,9999,0
1653449948144,CSE 293,025,094929,Politz; Joseph Gibbs,9999,0,9999,0
1653449948144,CSE 293,026,094930,Porter; George M,9999,0,9999,0
1653449948144,CSE 293,027,094931,Porter; Leonard Emerson,9999,0,9999,0
1653449948144,CSE 293,028,094932,Ramamoorthi; Ravi,9999,0,9999,0
1653449948144,CSE 293,029,094933,Sahoo; Debashis,9999,0,9999,0
1653449948144,CSE 293,030,094934,Saul; Lawrence,9999,0,9999,0
1653449948144,CSE 293,031,094935,Savage; Stefan,9999,0,9999,0
1653449948144,CSE 293,032,094936,Schulze; Jurgen P.,9999,0,9999,0
1653449948144,CSE 293,033,094937,Snoeren; Alex C.,9999,0,9999,0
1653449948144,CSE 293,034,094938,Shang; Jingbo,9999,0,9999,0
1653449948144,CSE 293,035,094939,Stefan; Deian,9999,0,9999,0
1653449948144,CSE 293,036,094940,Su; Hao,9999,0,9999,0
1653449948144,CSE 293,037,094941,Swanson; Steven James,9999,0,9999,0
1653449948144,CSE 293,038,094942,Tullsen; Dean Michael,9999,0,9999,0
1653449948144,CSE 293,039,094943,Voelker; Geoffrey M.,9999,0,9999,0
1653449948144,CSE 293,040,094944,Zhao; Jishen,9999,0,9999,0
1653449948144,CSE 293,041,094945,Zhou; Yuan-Yuan,9999,0,9999,0
1653449948144,CSE 293,042,094946,Gao; Sicun,9998,0,9999,1
1653449948144,CSE 293,043,094947,Weibel; Nadir,9999,0,9999,0
1653449948144,CSE 293,044,094948,Gupta; Rajesh K.,9999,0,9999,0
1653449948667,CSE 294,A00,090143,Porter; George M,9,0,10,1
1653449949195,DSE 200,A00,091799,Staff,50,0,50,0
1653449949724,DSE 203,A00,091800,Gupta; Amarnath,30,0,30,0
1653449950256,DSE 250,A00,091801,Deutsch; Alin Bernard,30,0,30,0
1653449950781,DSE 290,A00,091802,Altintas De Callaf; Ilkay,50,0,50,0
1653449951312,ECE 200,001,091003,Antipa; Nicholas A,9999,0,9999,0
1653449951312,ECE 200,002,091004,Atanasov; Nikolay A.,9999,0,9999,0
1653449951312,ECE 200,003,091005,Bharadia; Dinesh,9999,0,9999,0
1653449951312,ECE 200,004,091006,Cheng; Chung Kuan,9999,0,9999,0
1653449951312,ECE 200,005,091007,Cosman; Pamela C.,9999,0,9999,0
1653449951312,ECE 200,006,091008,Staff,9999,0,9999,0
1653449951312,ECE 200,007,091009,Dayeh; Shadi Ahmad,9999,0,9999,0
1653449951312,ECE 200,008,091010,Fainman; Yeshaiahu,9999,0,9999,0
1653449951312,ECE 200,009,091011,Ford; Joseph Earl,9999,0,9999,0
1653449951312,ECE 200,010,091012,Franceschetti; Massimo,9999,0,9999,0
1653449951312,ECE 200,011,091013,Fullerton; Eric E,9999,0,9999,0
1653449951312,ECE 200,012,091014,Galton; Ian A,9999,0,9999,0
1653449951312,ECE 200,013,091015,Gilja; Vikash,9999,0,9999,0
1653449951312,ECE 200,014,091016,Hall; Drew A.,9999,0,9999,0
1653449951312,ECE 200,015,091017,Hsueh; Tzu-Chien,9999,0,9999,0
1653449951312,ECE 200,016,091018,Javidi; Tara,9999,0,9999,0
1653449951312,ECE 200,017,091019,Kahng; Andrew Byun,9999,0,9999,0
1653449951312,ECE 200,018,091020,Kim; Young-Han,9999,0,9999,0
1653449951312,ECE 200,019,091021,Koushanfar; Farinaz,9999,0,9999,0
1653449951312,ECE 200,020,091022,Kuzum; Duygu,9999,0,9999,0
1653449951312,ECE 200,021,091023,Le; Hanh-Phuc,9999,0,9999,0
1653449951312,ECE 200,022,091024,Lin; Bill,9999,0,9999,0
1653449951312,ECE 200,023,091025,Liu; Zhaowei,9999,0,9999,0
1653449951312,ECE 200,024,091026,Lo; Yu-Hwa,9999,0,9999,0
1653449951312,ECE 200,025,091027,Lomakin; Vitaliy,9999,0,9999,0
1653449951312,ECE 200,026,091028,Mercier; Patrick Philip,9999,0,9999,0
1653449951312,ECE 200,027,091029,Meyer; Florian,9999,0,9999,0
1653449951312,ECE 200,028,091030,Milstein; Laurence B.,9999,0,9999,0
1653449951312,ECE 200,029,091031,Mir Arabbaygi; Siavash,9999,0,9999,0
1653449951312,ECE 200,030,091032,Mookherjea; Shayan,9999,0,9999,0
1653449951312,ECE 200,031,091033,Morris; Karcher William,9999,0,9999,0
1653449951312,ECE 200,032,091034,Ng; Tse Nga,9999,0,9999,0
1653449951312,ECE 200,033,091035,Nguyen; Truong Quang,9999,0,9999,0
1653449951312,ECE 200,034,091036,Nomura; Kenji,9999,0,9999,0
1653449951312,ECE 200,035,091037,Orlitsky; Alon,9999,0,9999,0
1653449951312,ECE 200,036,091038,Pal; Piya,9999,0,9999,0
1653449951312,ECE 200,037,091039,Papen; George C.,9999,0,9999,0
1653449951312,ECE 200,038,091040,Radic; Stojan,9999,0,9999,0
1653449951312,ECE 200,039,091041,Rao; Bhaskar D.,9999,0,9999,0
1653449951312,ECE 200,040,091042,Rao; Ramesh R,9999,0,9999,0
1653449951312,ECE 200,041,091043,Rebeiz; Gabriel,9999,0,9999,0
1653449951312,ECE 200,042,091044,Sanford; John R,9999,0,9999,0
1653449951312,ECE 200,043,091045,Siegel; Paul H.,9999,0,9999,0
1653449951312,ECE 200,044,091046,Sievenpiper; Daniel F.,9999,0,9999,0
1653449951312,ECE 200,045,091047,Sworder; David D.,9999,0,9999,0
1653449951312,ECE 200,046,091048,Taur; Yuan,9999,0,9999,0
1653449951312,ECE 200,047,091049,Touri; Behrouz,9999,0,9999,0
1653449951312,ECE 200,048,091050,Trivedi; Mohan M.,9999,0,9999,0
1653449951312,ECE 200,049,091051,Vardy; Alexander,9999,0,9999,0
1653449951312,ECE 200,050,091052,Vasconcelos; Nuno,9999,0,9999,0
1653449951312,ECE 200,051,091053,Wang; Xiaolong,9999,0,9999,0
1653449951312,ECE 200,052,091054,Xie; Pengtao,9999,0,9999,0
1653449951312,ECE 200,053,091055,Yip; Michael,9999,0,9999,0
1653449951312,ECE 200,054,091056,Zeger; Kenneth A.,9999,0,9999,0
1653449951312,ECE 200,055,091057,Zhang; Xinyu,9999,0,9999,0
1653449951312,ECE 200,056,091058,Turakhia; Yatish Girish,9999,0,9999,0
1653449951312,ECE 200,057,091059,Kang; Mingu,9999,0,9999,0
1653449951312,ECE 200,058,091060,Shi; Yuanyuan,9999,0,9999,0
1653449951312,ECE 200,059,091061,Wang; Edward Jay,9999,0,9999,0
1653449951312,ECE 200,060,091062,Zheng; Yang,9999,0,9999,0
1653449951835,ECE 203,A00,091065,Mercier; Patrick Philip,0,0,0,0
1653449952363,ECE 207A,A00,091605,Liu; Thomas Tao-Ming,0,0,0,0
1653449952893,ECE 212AN,A00,091068,Nomura; Kenji,0,0,0,0
1653449953416,ECE 222A,A00,091069,Rebeiz; Gabriel,0,0,0,0
1653449953944,ECE 225A,A00,091070,Orlitsky; Alon,0,0,0,0
1653449954467,ECE 230A,A00,091071,Nomura; Kenji,0,0,0,0
1653449954990,ECE 236A,A00,091072,Dayeh; Shadi Ahmad,0,0,0,0
1653449955517,ECE 238A,A00,091073,Luo; Jian,0,0,0,0
1653449955517,ECE 238A,B00,091074,Luo; Jian,0,0,0,0
1653449956041,ECE 240A,A00,091075,Radic; Stojan,0,0,0,0
1653449956566,ECE 247A,A00,091592,Shi; Lingyan,0,0,0,0
1653449957098,ECE 250,A00,091076,Touri; Behrouz,0,0,0,0
1653449957623,ECE 251C,A00,091078,Nguyen; Truong Quang,0,0,0,0
1653449958148,ECE 253,A00,091079,Cosman; Pamela C.,0,0,0,0
1653449958674,ECE 255A,A00,091080,Orlitsky; Alon,0,0,0,0
1653449959197,ECE 257A,A00,091081,Zhang; Xinyu,0,0,0,0
1653449959720,ECE 260A,A01,091084,Eldon; John,0,0,0,0
1653449960243,ECE 264C,A00,091085,Galton; Ian A,0,0,0,0
1653449960768,ECE 265C,A00,094889,Presti; Calogero Davide,0,0,0,9
1653449961291,ECE 266,A01,091087,Hall; Drew A.,0,0,0,0
1653449962338,ECE 271A,A00,091090,Vasconcelos; Nuno,0,0,0,0
1653449962869,ECE 272B,A00,091091,Sworder; David D.,0,0,0,0
1653449963395,ECE 275A,A00,091092,Meyer; Florian,0,0,0,0
1653449963920,ECE 277,A00,091093,An; Cheolhong,0,0,0,0
1653449964445,ECE 283,A00,091094,Le; Hanh-Phuc,0,0,0,0
1653449964966,ECE 284,A00,091095,Kang; Mingu,0,0,0,0
1653449964966,ECE 284,B00,091096,Wang; Edward Jay,0,0,0,0
1653449965489,ECE 285,A00,094334,Touri; Behrouz,0,0,0,0
1653449966028,ECE 289,A00,091097,Whelan; David Arthur,0,0,0,0
1653449966554,MATH 200A,A00,087414,Salehi Golsefidy; Alireza,7,0,8,1
1653449967077,MATH 202A,A00,087415,Gill; Philip E.,3,0,8,5
1653449967600,MATH 203A,A00,087416,Oprea; Dragos N.,6,0,8,2
1653449968123,MATH 204A,A00,087417,Kedlaya; Kiran S.,6,0,8,2
1653449968646,MATH 205,A00,087418,Sorensen; Claus M,6,0,8,2
1653449969189,MATH 206A,A00,087419,Izadi; Elham,7,0,8,1
1653449969711,MATH 207A,A00,087420,Mohammadi; Amir,6,0,8,2
1653449970233,MATH 208,A00,087421,Staff,9,0,10,1
1653449970765,MATH 209,A00,087422,Staff,10,0,10,0
1653449971303,MATH 218,A00,087423,Staff,10,0,10,0
1653449971826,MATH 220A,A00,087424,Novak; Jonathan I,7,0,8,1
1653449972347,MATH 231A,A00,087425,Bejenaru; Ioan,3,0,8,5
1653449972870,MATH 240A,A00,087426,Ebenfelt; Peter F,5,0,8,3
1653449973396,MATH 243,A00,087427,Staff,9,0,10,1
1653449973923,MATH 248,A00,087429,Staff,10,0,10,0
1653449974450,MATH 250A,A00,087430,Spolaor; Luca,4,0,8,4
1653449974973,MATH 257A,A00,087431,Spolaor; Luca,7,0,8,1
1653449975497,MATH 258,A00,087432,Staff,9,0,10,1
1653449976019,MATH 264A,A00,087433,Warnke; Lutz Peter,5,0,8,3
1653449976544,MATH 268,A00,087434,Staff,15,0,15,0
1653449977068,MATH 269,A00,087435,Staff,14,0,15,1
1653449977593,MATH 270A,A00,087436,Nie; Jiawang,0,0,8,8
1653449978116,MATH 272A,A00,087437,Tian; Xiaochuan,1,0,8,7
1653449978639,MATH 274,A01,087439,Cheng; Li-Tien,9,0,10,1
1653449978639,MATH 274,A02,087440,Cheng; Li-Tien,10,0,10,0
1653449979161,MATH 278A,A00,087441,Staff,8,0,10,2
1653449979684,MATH 278B,A00,087442,Staff,8,0,10,2
1653449980207,MATH 278C,A00,087443,Staff,8,0,10,2
1653449980730,MATH 280A,A00,087444,Zheng; Tianyi,0,0,8,8
1653449981328,MATH 281A,A00,087445,Bradic; Jelena,0,0,8,8
1653449981873,MATH 282A,A00,087446,Zhang; Danna,0,0,8,8
1653449982398,MATH 283,A00,087447,Tesler; Glenn,0,0,0,14
1653449982923,MATH 286,A00,087448,Kemp; Todd Aahron,5,0,8,3
1653449983448,MATH 287D,A00,087449,Bradic; Jelena,8,0,8,0
1653449983974,MATH 288,A00,087450,Staff,14,0,15,1
1653449983974,MATH 288,B00,087451,Staff,15,0,15,0
1653449983974,MATH 288,C00,087452,Staff,15,0,15,0
1653449984499,MATH 290A,A00,087453,Xu; Zhouli,7,0,8,1
1653449985029,MATH 291A,A00,087454,Xu; Zhouli,7,0,8,1
1653449985554,MATH 292,A00,087455,Staff,10,0,10,0
1653449986081,MATH 295,A00,087456,Staff,50,0,50,0
1653449986606,MATH 297,001,087457,Staff,998,0,999,1
1653450547776,COGS 200,A01,087991,Staff,47,0,50,3
1653450548301,COGS 201,A01,094504,Rangel; Lara M,17,0,25,8
1653450548826,COGS 203,A00,087992,Coulson; Seana M,18,0,20,2
1653450549349,COGS 210A,001,087993,Greene; Deanna Jacquelyn,9998,0,9999,1
1653450549349,COGS 210A,002,087994,Saygin; Ayse P,9999,0,9999,0
1653450549349,COGS 210A,003,087995,Xia; Haijun,9999,0,9999,0
1653450549349,COGS 210A,004,087996,Nitz; Douglas A.,9999,0,9999,0
1653450549349,COGS 210A,005,087997,Hollan; James D.,9999,0,9999,0
1653450549349,COGS 210A,006,087998,Deak; Gedeon O.,9998,0,9999,1
1653450549349,COGS 210A,007,087999,Rossano; Federico,9999,0,9999,0
1653450549871,COGS 211A,A00,088000,Coulson; Seana M,9997,0,9999,2
1653450550396,COGS 229,A00,088002,Staff,23,0,25,2
1653450550926,COGS 260,B00,094231,Staff,17,0,20,3
1653450550926,COGS 260,A00,088004,Nitz; Douglas A.,9998,0,9999,1
1653450551457,CSE 202,A00,090110,Paturi; Ramamohan,0,0,0,0
1653450551457,CSE 202,B00,090111,Paturi; Ramamohan,0,0,0,0
1653450551981,CSE 207B,A00,090112,Heninger; Nadia A,0,0,0,0
1653450552506,CSE 208,A00,094858,Micciancio; Daniele,0,0,0,0
1653450553029,CSE 210,A00,090113,Powell; Thomas Allan,0,0,0,0
1653450553552,CSE 219,A00,090898,Staff,0,0,0,0
1653450554074,CSE 221,A00,090114,Zhou; Yuan-Yuan,0,0,0,0
1653450554597,CSE 229A,A00,090115,Porter; George M,0,0,0,0
1653450555119,CSE 229C,A00,090116,Savage; Stefan,0,0,0,0
1653450555654,CSE 230,A00,090117,Jhala; Ranjit,0,0,0,0
1653450556180,CSE 232,A00,090118,Papakonstantinou; Yannis,0,0,0,0
1653450556705,CSE 239A,A00,090121,Kumar; Arun Kumar,0,0,0,0
1653450557231,CSE 239B,A00,090122,Jhala; Ranjit,0,0,0,0
1653450557762,CSE 240A,A00,090123,Zhao; Jishen,0,0,189,189
1653450558287,CSE 243A,A00,090124,Orailoglu; Alex,1,0,15,14
1653450558812,CSE 249B,A00,090125,Kahng; Andrew Byun,13,0,20,7
1653450559348,CSE 250A,A00,090126,Berg-Kirkpatrick; Taylor D,0,0,0,0
1653450559874,CSE 252A,A00,090127,Ochoa; Benjamin Lawrence,0,0,0,0
1653450560411,CSE 258,A01,090129,McAuley; Julian John,0,0,0,0
1653450560942,CSE 258R,A01,090131,McAuley; Julian John,0,0,0,0
1653450561472,CSE 274,A00,090132,Ramamoorthi; Ravi,0,0,0,0
1653450561995,CSE 276A,A00,090133,Christensen; Henrik I,0,0,0,0
1653450562525,CSE 276C,A00,090134,Christensen; Henrik I,0,0,0,0
1653450563054,CSE 290,A00,090135,Bafna; Vineet,0,0,0,0
1653450563054,CSE 290,B00,090136,Ramamoorthi; Ravi,0,0,0,0
1653450563054,CSE 290,C00,090137,Li; Tzumao,9,0,10,1
1653450563054,CSE 290,D00,090138,Zhou; Yuan-Yuan,10,0,10,0
1653450563054,CSE 290,E00,090139,Christensen; Henrik I,10,0,10,0
1653450563054,CSE 290,F00,094053,Shalev; Aaron D,0,0,0,0
1653450563580,CSE 291,A00,090140,Munyaka; Imani N. S.,0,0,0,0
1653450563580,CSE 291,B00,094880,Yu; Qi,0,0,0,0
1653450563580,CSE 291,C00,090142,Pannuto; Patrick William,0,0,0,0
1653450563580,CSE 291,D00,094881,Zhang; Yiying,0,0,0,0
1653450563580,CSE 291,E00,095118,Su; Hao,0,0,0,0
1653450564106,CSE 293,001,094905,Bafna; Vineet,9999,0,9999,0
1653450564106,CSE 293,002,094906,Bellare; Mihir,9999,0,9999,0
1653450564106,CSE 293,003,094907,Berg-Kirkpatrick; Taylor D,9999,0,9999,0
1653450564106,CSE 293,004,094908,Christensen; Henrik I,9999,0,9999,0
1653450564106,CSE 293,005,094909,Cottrell; Garrison W,9999,0,9999,0
1653450564106,CSE 293,006,094910,Deutsch; Alin Bernard,9999,0,9999,0
1653450564106,CSE 293,007,094911,Esmaeilzadeh; Hadi,9999,0,9999,0
1653450564106,CSE 293,008,094912,Freund; Yoav,9999,0,9999,0
1653450564106,CSE 293,009,094913,Griswold; William G.,9999,0,9999,0
1653450564106,CSE 293,010,094914,Gymrek; Melissa Ann,9999,0,9999,0
1653450564106,CSE 293,011,094915,Heninger; Nadia A,9999,0,9999,0
1653450564106,CSE 293,012,094916,Impagliazzo; Russell,9999,0,9999,0
1653450564106,CSE 293,013,094917,Jhala; Ranjit,9999,0,9999,0
1653450564106,CSE 293,014,094918,Kahng; Andrew Byun,9999,0,9999,0
1653450564106,CSE 293,015,094919,Kane; Daniel Mertz,9999,0,9999,0
1653450564106,CSE 293,016,094920,Kriegman; David J,9999,0,9999,0
1653450564106,CSE 293,017,094921,Kumar; Arun Kumar,9999,0,9999,0
1653450564106,CSE 293,018,094922,Lerner; Sorin,9999,0,9999,0
1653450564106,CSE 293,019,094923,Lovett; Shachar,9999,0,9999,0
1653450564106,CSE 293,020,094924,McAuley; Julian John,9999,0,9999,0
1653450564106,CSE 293,021,094925,Micciancio; Daniele,9999,0,9999,0
1653450564106,CSE 293,022,094926,Orailoglu; Alex,9999,0,9999,0
1653450564106,CSE 293,023,094927,Paturi; Ramamohan,9999,0,9999,0
1653450564106,CSE 293,024,094928,Polikarpova; Nadezhda,9999,0,9999,0
1653450564106,CSE 293,025,094929,Politz; Joseph Gibbs,9999,0,9999,0
1653450564106,CSE 293,026,094930,Porter; George M,9999,0,9999,0
1653450564106,CSE 293,027,094931,Porter; Leonard Emerson,9999,0,9999,0
1653450564106,CSE 293,028,094932,Ramamoorthi; Ravi,9999,0,9999,0
1653450564106,CSE 293,029,094933,Sahoo; Debashis,9999,0,9999,0
1653450564106,CSE 293,030,094934,Saul; Lawrence,9999,0,9999,0
1653450564106,CSE 293,031,094935,Savage; Stefan,9999,0,9999,0
1653450564106,CSE 293,032,094936,Schulze; Jurgen P.,9999,0,9999,0
1653450564106,CSE 293,033,094937,Snoeren; Alex C.,9999,0,9999,0
1653450564106,CSE 293,034,094938,Shang; Jingbo,9999,0,9999,0
1653450564106,CSE 293,035,094939,Stefan; Deian,9999,0,9999,0
1653450564106,CSE 293,036,094940,Su; Hao,9999,0,9999,0
1653450564106,CSE 293,037,094941,Swanson; Steven James,9999,0,9999,0
1653450564106,CSE 293,038,094942,Tullsen; Dean Michael,9999,0,9999,0
1653450564106,CSE 293,039,094943,Voelker; Geoffrey M.,9999,0,9999,0
1653450564106,CSE 293,040,094944,Zhao; Jishen,9999,0,9999,0
1653450564106,CSE 293,041,094945,Zhou; Yuan-Yuan,9999,0,9999,0
1653450564106,CSE 293,042,094946,Gao; Sicun,9998,0,9999,1
1653450564106,CSE 293,043,094947,Weibel; Nadir,9999,0,9999,0
1653450564106,CSE 293,044,094948,Gupta; Rajesh K.,9999,0,9999,0
1653450564630,CSE 294,A00,090143,Porter; George M,9,0,10,1
1653450565153,DSE 200,A00,091799,Staff,50,0,50,0
1653450565675,DSE 203,A00,091800,Gupta; Amarnath,30,0,30,0
1653450566197,DSE 250,A00,091801,Deutsch; Alin Bernard,30,0,30,0
1653450566722,DSE 290,A00,091802,Altintas De Callaf; Ilkay,50,0,50,0
1653450567251,ECE 200,001,091003,Antipa; Nicholas A,9999,0,9999,0
1653450567251,ECE 200,002,091004,Atanasov; Nikolay A.,9999,0,9999,0
1653450567251,ECE 200,003,091005,Bharadia; Dinesh,9999,0,9999,0
1653450567251,ECE 200,004,091006,Cheng; Chung Kuan,9999,0,9999,0
1653450567251,ECE 200,005,091007,Cosman; Pamela C.,9999,0,9999,0
1653450567251,ECE 200,006,091008,Staff,9999,0,9999,0
1653450567251,ECE 200,007,091009,Dayeh; Shadi Ahmad,9999,0,9999,0
1653450567251,ECE 200,008,091010,Fainman; Yeshaiahu,9999,0,9999,0
1653450567251,ECE 200,009,091011,Ford; Joseph Earl,9999,0,9999,0
1653450567251,ECE 200,010,091012,Franceschetti; Massimo,9999,0,9999,0
1653450567251,ECE 200,011,091013,Fullerton; Eric E,9999,0,9999,0
1653450567251,ECE 200,012,091014,Galton; Ian A,9999,0,9999,0
1653450567251,ECE 200,013,091015,Gilja; Vikash,9999,0,9999,0
1653450567251,ECE 200,014,091016,Hall; Drew A.,9999,0,9999,0
1653450567251,ECE 200,015,091017,Hsueh; Tzu-Chien,9999,0,9999,0
1653450567251,ECE 200,016,091018,Javidi; Tara,9999,0,9999,0
1653450567251,ECE 200,017,091019,Kahng; Andrew Byun,9999,0,9999,0
1653450567251,ECE 200,018,091020,Kim; Young-Han,9999,0,9999,0
1653450567251,ECE 200,019,091021,Koushanfar; Farinaz,9999,0,9999,0
1653450567251,ECE 200,020,091022,Kuzum; Duygu,9999,0,9999,0
1653450567251,ECE 200,021,091023,Le; Hanh-Phuc,9999,0,9999,0
1653450567251,ECE 200,022,091024,Lin; Bill,9999,0,9999,0
1653450567251,ECE 200,023,091025,Liu; Zhaowei,9999,0,9999,0
1653450567251,ECE 200,024,091026,Lo; Yu-Hwa,9999,0,9999,0
1653450567251,ECE 200,025,091027,Lomakin; Vitaliy,9999,0,9999,0
1653450567251,ECE 200,026,091028,Mercier; Patrick Philip,9999,0,9999,0
1653450567251,ECE 200,027,091029,Meyer; Florian,9999,0,9999,0
1653450567251,ECE 200,028,091030,Milstein; Laurence B.,9999,0,9999,0
1653450567251,ECE 200,029,091031,Mir Arabbaygi; Siavash,9999,0,9999,0
1653450567251,ECE 200,030,091032,Mookherjea; Shayan,9999,0,9999,0
1653450567251,ECE 200,031,091033,Morris; Karcher William,9999,0,9999,0
1653450567251,ECE 200,032,091034,Ng; Tse Nga,9999,0,9999,0
1653450567251,ECE 200,033,091035,Nguyen; Truong Quang,9999,0,9999,0
1653450567251,ECE 200,034,091036,Nomura; Kenji,9999,0,9999,0
1653450567251,ECE 200,035,091037,Orlitsky; Alon,9999,0,9999,0
1653450567251,ECE 200,036,091038,Pal; Piya,9999,0,9999,0
1653450567251,ECE 200,037,091039,Papen; George C.,9999,0,9999,0
1653450567251,ECE 200,038,091040,Radic; Stojan,9999,0,9999,0
1653450567251,ECE 200,039,091041,Rao; Bhaskar D.,9999,0,9999,0
1653450567251,ECE 200,040,091042,Rao; Ramesh R,9999,0,9999,0
1653450567251,ECE 200,041,091043,Rebeiz; Gabriel,9999,0,9999,0
1653450567251,ECE 200,042,091044,Sanford; John R,9999,0,9999,0
1653450567251,ECE 200,043,091045,Siegel; Paul H.,9999,0,9999,0
1653450567251,ECE 200,044,091046,Sievenpiper; Daniel F.,9999,0,9999,0
1653450567251,ECE 200,045,091047,Sworder; David D.,9999,0,9999,0
1653450567251,ECE 200,046,091048,Taur; Yuan,9999,0,9999,0
1653450567251,ECE 200,047,091049,Touri; Behrouz,9999,0,9999,0
1653450567251,ECE 200,048,091050,Trivedi; Mohan M.,9999,0,9999,0
1653450567251,ECE 200,049,091051,Vardy; Alexander,9999,0,9999,0
1653450567251,ECE 200,050,091052,Vasconcelos; Nuno,9999,0,9999,0
1653450567251,ECE 200,051,091053,Wang; Xiaolong,9999,0,9999,0
1653450567251,ECE 200,052,091054,Xie; Pengtao,9999,0,9999,0
1653450567251,ECE 200,053,091055,Yip; Michael,9999,0,9999,0
1653450567251,ECE 200,054,091056,Zeger; Kenneth A.,9999,0,9999,0
1653450567251,ECE 200,055,091057,Zhang; Xinyu,9999,0,9999,0
1653450567251,ECE 200,056,091058,Turakhia; Yatish Girish,9999,0,9999,0
1653450567251,ECE 200,057,091059,Kang; Mingu,9999,0,9999,0
1653450567251,ECE 200,058,091060,Shi; Yuanyuan,9999,0,9999,0
1653450567251,ECE 200,059,091061,Wang; Edward Jay,9999,0,9999,0
1653450567251,ECE 200,060,091062,Zheng; Yang,9999,0,9999,0
1653450567777,ECE 203,A00,091065,Mercier; Patrick Philip,0,0,0,0
1653450568309,ECE 207A,A00,091605,Liu; Thomas Tao-Ming,0,0,0,0
1653450568836,ECE 212AN,A00,091068,Nomura; Kenji,0,0,0,0
1653450569359,ECE 222A,A00,091069,Rebeiz; Gabriel,0,0,0,0
1653450569984,ECE 225A,A00,091070,Orlitsky; Alon,0,0,0,0
1653450570506,ECE 230A,A00,091071,Nomura; Kenji,0,0,0,0
1653450571028,ECE 236A,A00,091072,Dayeh; Shadi Ahmad,0,0,0,0
1653450571561,ECE 238A,A00,091073,Luo; Jian,0,0,0,0
1653450571561,ECE 238A,B00,091074,Luo; Jian,0,0,0,0
1653450572087,ECE 240A,A00,091075,Radic; Stojan,0,0,0,0
1653450572614,ECE 247A,A00,091592,Shi; Lingyan,0,0,0,0
1653450573142,ECE 250,A00,091076,Touri; Behrouz,0,0,0,0
1653450573672,ECE 251C,A00,091078,Nguyen; Truong Quang,0,0,0,0
1653450574195,ECE 253,A00,091079,Cosman; Pamela C.,0,0,0,0
1653450574717,ECE 255A,A00,091080,Orlitsky; Alon,0,0,0,0
1653450575240,ECE 257A,A00,091081,Zhang; Xinyu,0,0,0,0
1653450575770,ECE 260A,A01,091084,Eldon; John,0,0,0,0
1653450576295,ECE 264C,A00,091085,Galton; Ian A,0,0,0,0
1653450576817,ECE 265C,A00,094889,Presti; Calogero Davide,0,0,0,9
1653450577340,ECE 266,A01,091087,Hall; Drew A.,0,0,0,0
1653450578388,ECE 271A,A00,091090,Vasconcelos; Nuno,0,0,0,0
1653450578911,ECE 272B,A00,091091,Sworder; David D.,0,0,0,0
1653450579435,ECE 275A,A00,091092,Meyer; Florian,0,0,0,0
1653450579969,ECE 277,A00,091093,An; Cheolhong,0,0,0,0
1653450580505,ECE 283,A00,091094,Le; Hanh-Phuc,0,0,0,0
1653450581031,ECE 284,A00,091095,Kang; Mingu,0,0,0,0
1653450581031,ECE 284,B00,091096,Wang; Edward Jay,0,0,0,0
1653450581564,ECE 285,A00,094334,Touri; Behrouz,0,0,0,0
1653450582090,ECE 289,A00,091097,Whelan; David Arthur,0,0,0,0
1653450582614,MATH 200A,A00,087414,Salehi Golsefidy; Alireza,7,0,8,1
1653450583136,MATH 202A,A00,087415,Gill; Philip E.,3,0,8,5
1653450583662,MATH 203A,A00,087416,Oprea; Dragos N.,6,0,8,2
1653450584189,MATH 204A,A00,087417,Kedlaya; Kiran S.,6,0,8,2
1653450584725,MATH 205,A00,087418,Sorensen; Claus M,6,0,8,2
1653450585253,MATH 206A,A00,087419,Izadi; Elham,7,0,8,1
1653450585785,MATH 207A,A00,087420,Mohammadi; Amir,6,0,8,2
1653450586314,MATH 208,A00,087421,Staff,9,0,10,1
1653450586848,MATH 209,A00,087422,Staff,10,0,10,0
1653450587369,MATH 218,A00,087423,Staff,10,0,10,0
1653450587906,MATH 220A,A00,087424,Novak; Jonathan I,7,0,8,1
1653450588431,MATH 231A,A00,087425,Bejenaru; Ioan,3,0,8,5
1653450588954,MATH 240A,A00,087426,Ebenfelt; Peter F,5,0,8,3
1653450589478,MATH 243,A00,087427,Staff,9,0,10,1
1653450590000,MATH 248,A00,087429,Staff,10,0,10,0
1653450590523,MATH 250A,A00,087430,Spolaor; Luca,4,0,8,4
1653450591048,MATH 257A,A00,087431,Spolaor; Luca,7,0,8,1
1653450591570,MATH 258,A00,087432,Staff,9,0,10,1
1653450592094,MATH 264A,A00,087433,Warnke; Lutz Peter,5,0,8,3
1653450592619,MATH 268,A00,087434,Staff,15,0,15,0
1653450593143,MATH 269,A00,087435,Staff,14,0,15,1
1653450593667,MATH 270A,A00,087436,Nie; Jiawang,0,0,8,8
1653450594191,MATH 272A,A00,087437,Tian; Xiaochuan,1,0,8,7
1653450594717,MATH 274,A01,087439,Cheng; Li-Tien,9,0,10,1
1653450594717,MATH 274,A02,087440,Cheng; Li-Tien,10,0,10,0
1653450595239,MATH 278A,A00,087441,Staff,8,0,10,2
1653450595761,MATH 278B,A00,087442,Staff,8,0,10,2
1653450596284,MATH 278C,A00,087443,Staff,8,0,10,2
1653450596808,MATH 280A,A00,087444,Zheng; Tianyi,0,0,8,8
1653450597344,MATH 281A,A00,087445,Bradic; Jelena,0,0,8,8
1653450597873,MATH 282A,A00,087446,Zhang; Danna,0,0,8,8
1653450598402,MATH 283,A00,087447,Tesler; Glenn,0,0,0,14
1653450598928,MATH 286,A00,087448,Kemp; Todd Aahron,5,0,8,3
1653450599449,MATH 287D,A00,087449,Bradic; Jelena,8,0,8,0
1653450599972,MATH 288,A00,087450,Staff,14,0,15,1
1653450599972,MATH 288,B00,087451,Staff,15,0,15,0
1653450599972,MATH 288,C00,087452,Staff,15,0,15,0
1653450600496,MATH 290A,A00,087453,Xu; Zhouli,7,0,8,1
1653450601020,MATH 291A,A00,087454,Xu; Zhouli,7,0,8,1
1653450601543,MATH 292,A00,087455,Staff,10,0,10,0
1653450602070,MATH 295,A00,087456,Staff,50,0,50,0
1653450602841,MATH 297,001,087457,Staff,998,0,999,1
1653451164072,COGS 200,A01,087991,Staff,47,0,50,3
1653451164604,COGS 201,A01,094504,Rangel; Lara M,17,0,25,8
1653451165127,COGS 203,A00,087992,Coulson; Seana M,18,0,20,2
1653451165651,COGS 210A,001,087993,Greene; Deanna Jacquelyn,9998,0,9999,1
1653451165651,COGS 210A,002,087994,Saygin; Ayse P,9999,0,9999,0
1653451165651,COGS 210A,003,087995,Xia; Haijun,9999,0,9999,0
1653451165651,COGS 210A,004,087996,Nitz; Douglas A.,9999,0,9999,0
1653451165651,COGS 210A,005,087997,Hollan; James D.,9999,0,9999,0
1653451165651,COGS 210A,006,087998,Deak; Gedeon O.,9998,0,9999,1
1653451165651,COGS 210A,007,087999,Rossano; Federico,9999,0,9999,0
1653451166174,COGS 211A,A00,088000,Coulson; Seana M,9997,0,9999,2
1653451166698,COGS 229,A00,088002,Staff,23,0,25,2
1653451167220,COGS 260,B00,094231,Staff,17,0,20,3
1653451167220,COGS 260,A00,088004,Nitz; Douglas A.,9998,0,9999,1
1653451167751,CSE 202,A00,090110,Paturi; Ramamohan,0,0,0,0
1653451167751,CSE 202,B00,090111,Paturi; Ramamohan,0,0,0,0
1653451168281,CSE 207B,A00,090112,Heninger; Nadia A,0,0,0,0
1653451168804,CSE 208,A00,094858,Micciancio; Daniele,0,0,0,0
1653451169339,CSE 210,A00,090113,Powell; Thomas Allan,0,0,0,0
1653451169861,CSE 219,A00,090898,Staff,0,0,0,0
1653451170400,CSE 221,A00,090114,Zhou; Yuan-Yuan,0,0,0,0
1653451170923,CSE 229A,A00,090115,Porter; George M,0,0,0,0
1653451171453,CSE 229C,A00,090116,Savage; Stefan,0,0,0,0
1653451171987,CSE 230,A00,090117,Jhala; Ranjit,0,0,0,0
1653451172510,CSE 232,A00,090118,Papakonstantinou; Yannis,0,0,0,0
1653451173033,CSE 239A,A00,090121,Kumar; Arun Kumar,0,0,0,0
1653451173555,CSE 239B,A00,090122,Jhala; Ranjit,0,0,0,0
1653451174081,CSE 240A,A00,090123,Zhao; Jishen,0,0,189,189
1653451174612,CSE 243A,A00,090124,Orailoglu; Alex,1,0,15,14
1653451175153,CSE 249B,A00,090125,Kahng; Andrew Byun,13,0,20,7
1653451175685,CSE 250A,A00,090126,Berg-Kirkpatrick; Taylor D,0,0,0,0
1653451176211,CSE 252A,A00,090127,Ochoa; Benjamin Lawrence,0,0,0,0
1653451176735,CSE 258,A01,090129,McAuley; Julian John,0,0,0,0
1653451177259,CSE 258R,A01,090131,McAuley; Julian John,0,0,0,0
1653451177791,CSE 274,A00,090132,Ramamoorthi; Ravi,0,0,0,0
1653451178313,CSE 276A,A00,090133,Christensen; Henrik I,0,0,0,0
1653451178838,CSE 276C,A00,090134,Christensen; Henrik I,0,0,0,0
1653451179368,CSE 290,A00,090135,Bafna; Vineet,0,0,0,0
1653451179368,CSE 290,B00,090136,Ramamoorthi; Ravi,0,0,0,0
1653451179368,CSE 290,C00,090137,Li; Tzumao,9,0,10,1
1653451179368,CSE 290,D00,090138,Zhou; Yuan-Yuan,10,0,10,0
1653451179368,CSE 290,E00,090139,Christensen; Henrik I,10,0,10,0
1653451179368,CSE 290,F00,094053,Shalev; Aaron D,0,0,0,0
1653451179911,CSE 291,A00,090140,Munyaka; Imani N. S.,0,0,0,0
1653451179911,CSE 291,B00,094880,Yu; Qi,0,0,0,0
1653451179911,CSE 291,C00,090142,Pannuto; Patrick William,0,0,0,0
1653451179911,CSE 291,D00,094881,Zhang; Yiying,0,0,0,0
1653451179911,CSE 291,E00,095118,Su; Hao,0,0,0,0
1653451180437,CSE 293,001,094905,Bafna; Vineet,9999,0,9999,0
1653451180437,CSE 293,002,094906,Bellare; Mihir,9999,0,9999,0
1653451180437,CSE 293,003,094907,Berg-Kirkpatrick; Taylor D,9999,0,9999,0
1653451180437,CSE 293,004,094908,Christensen; Henrik I,9999,0,9999,0
1653451180437,CSE 293,005,094909,Cottrell; Garrison W,9999,0,9999,0
1653451180437,CSE 293,006,094910,Deutsch; Alin Bernard,9999,0,9999,0
1653451180437,CSE 293,007,094911,Esmaeilzadeh; Hadi,9999,0,9999,0
1653451180437,CSE 293,008,094912,Freund; Yoav,9999,0,9999,0
1653451180437,CSE 293,009,094913,Griswold; William G.,9999,0,9999,0
1653451180437,CSE 293,010,094914,Gymrek; Melissa Ann,9999,0,9999,0
1653451180437,CSE 293,011,094915,Heninger; Nadia A,9999,0,9999,0
1653451180437,CSE 293,012,094916,Impagliazzo; Russell,9999,0,9999,0
1653451180437,CSE 293,013,094917,Jhala; Ranjit,9999,0,9999,0
1653451180437,CSE 293,014,094918,Kahng; Andrew Byun,9999,0,9999,0
1653451180437,CSE 293,015,094919,Kane; Daniel Mertz,9999,0,9999,0
1653451180437,CSE 293,016,094920,Kriegman; David J,9999,0,9999,0
1653451180437,CSE 293,017,094921,Kumar; Arun Kumar,9999,0,9999,0
1653451180437,CSE 293,018,094922,Lerner; Sorin,9999,0,9999,0
1653451180437,CSE 293,019,094923,Lovett; Shachar,9999,0,9999,0
1653451180437,CSE 293,020,094924,McAuley; Julian John,9999,0,9999,0
1653451180437,CSE 293,021,094925,Micciancio; Daniele,9999,0,9999,0
1653451180437,CSE 293,022,094926,Orailoglu; Alex,9999,0,9999,0
1653451180437,CSE 293,023,094927,Paturi; Ramamohan,9999,0,9999,0
1653451180437,CSE 293,024,094928,Polikarpova; Nadezhda,9999,0,9999,0
1653451180437,CSE 293,025,094929,Politz; Joseph Gibbs,9999,0,9999,0
1653451180437,CSE 293,026,094930,Porter; George M,9999,0,9999,0
1653451180437,CSE 293,027,094931,Porter; Leonard Emerson,9999,0,9999,0
1653451180437,CSE 293,028,094932,Ramamoorthi; Ravi,9999,0,9999,0
1653451180437,CSE 293,029,094933,Sahoo; Debashis,9999,0,9999,0
1653451180437,CSE 293,030,094934,Saul; Lawrence,9999,0,9999,0
1653451180437,CSE 293,031,094935,Savage; Stefan,9999,0,9999,0
1653451180437,CSE 293,032,094936,Schulze; Jurgen P.,9999,0,9999,0
1653451180437,CSE 293,033,094937,Snoeren; Alex C.,9999,0,9999,0
1653451180437,CSE 293,034,094938,Shang; Jingbo,9999,0,9999,0
1653451180437,CSE 293,035,094939,Stefan; Deian,9999,0,9999,0
1653451180437,CSE 293,036,094940,Su; Hao,9999,0,9999,0
1653451180437,CSE 293,037,094941,Swanson; Steven James,9999,0,9999,0
1653451180437,CSE 293,038,094942,Tullsen; Dean Michael,9999,0,9999,0
1653451180437,CSE 293,039,094943,Voelker; Geoffrey M.,9999,0,9999,0
1653451180437,CSE 293,040,094944,Zhao; Jishen,9999,0,9999,0
1653451180437,CSE 293,041,094945,Zhou; Yuan-Yuan,9999,0,9999,0
1653451180437,CSE 293,042,094946,Gao; Sicun,9998,0,9999,1
1653451180437,CSE 293,043,094947,Weibel; Nadir,9999,0,9999,0
1653451180437,CSE 293,044,094948,Gupta; Rajesh K.,9999,0,9999,0
1653451180968,CSE 294,A00,090143,Porter; George M,9,0,10,1
1653451181491,DSE 200,A00,091799,Staff,50,0,50,0
1653451182013,DSE 203,A00,091800,Gupta; Amarnath,30,0,30,0
1653451182534,DSE 250,A00,091801,Deutsch; Alin Bernard,30,0,30,0
1653451183059,DSE 290,A00,091802,Altintas De Callaf; Ilkay,50,0,50,0
1653451183588,ECE 200,001,091003,Antipa; Nicholas A,9999,0,9999,0
1653451183588,ECE 200,002,091004,Atanasov; Nikolay A.,9999,0,9999,0
1653451183588,ECE 200,003,091005,Bharadia; Dinesh,9999,0,9999,0
1653451183588,ECE 200,004,091006,Cheng; Chung Kuan,9999,0,9999,0
1653451183588,ECE 200,005,091007,Cosman; Pamela C.,9999,0,9999,0
1653451183588,ECE 200,006,091008,Staff,9999,0,9999,0
1653451183588,ECE 200,007,091009,Dayeh; Shadi Ahmad,9999,0,9999,0
1653451183588,ECE 200,008,091010,Fainman; Yeshaiahu,9999,0,9999,0
1653451183588,ECE 200,009,091011,Ford; Joseph Earl,9999,0,9999,0
1653451183588,ECE 200,010,091012,Franceschetti; Massimo,9999,0,9999,0
1653451183588,ECE 200,011,091013,Fullerton; Eric E,9999,0,9999,0
1653451183588,ECE 200,012,091014,Galton; Ian A,9999,0,9999,0
1653451183588,ECE 200,013,091015,Gilja; Vikash,9999,0,9999,0
1653451183588,ECE 200,014,091016,Hall; Drew A.,9999,0,9999,0
1653451183588,ECE 200,015,091017,Hsueh; Tzu-Chien,9999,0,9999,0
1653451183588,ECE 200,016,091018,Javidi; Tara,9999,0,9999,0
1653451183588,ECE 200,017,091019,Kahng; Andrew Byun,9999,0,9999,0
1653451183588,ECE 200,018,091020,Kim; Young-Han,9999,0,9999,0
1653451183588,ECE 200,019,091021,Koushanfar; Farinaz,9999,0,9999,0
1653451183588,ECE 200,020,091022,Kuzum; Duygu,9999,0,9999,0
1653451183588,ECE 200,021,091023,Le; Hanh-Phuc,9999,0,9999,0
1653451183588,ECE 200,022,091024,Lin; Bill,9999,0,9999,0
1653451183588,ECE 200,023,091025,Liu; Zhaowei,9999,0,9999,0
1653451183588,ECE 200,024,091026,Lo; Yu-Hwa,9999,0,9999,0
1653451183588,ECE 200,025,091027,Lomakin; Vitaliy,9999,0,9999,0
1653451183588,ECE 200,026,091028,Mercier; Patrick Philip,9999,0,9999,0
1653451183588,ECE 200,027,091029,Meyer; Florian,9999,0,9999,0
1653451183588,ECE 200,028,091030,Milstein; Laurence B.,9999,0,9999,0
1653451183588,ECE 200,029,091031,Mir Arabbaygi; Siavash,9999,0,9999,0
1653451183588,ECE 200,030,091032,Mookherjea; Shayan,9999,0,9999,0
1653451183588,ECE 200,031,091033,Morris; Karcher William,9999,0,9999,0
1653451183588,ECE 200,032,091034,Ng; Tse Nga,9999,0,9999,0
1653451183588,ECE 200,033,091035,Nguyen; Truong Quang,9999,0,9999,0
1653451183588,ECE 200,034,091036,Nomura; Kenji,9999,0,9999,0
1653451183588,ECE 200,035,091037,Orlitsky; Alon,9999,0,9999,0
1653451183588,ECE 200,036,091038,Pal; Piya,9999,0,9999,0
1653451183588,ECE 200,037,091039,Papen; George C.,9999,0,9999,0
1653451183588,ECE 200,038,091040,Radic; Stojan,9999,0,9999,0
1653451183588,ECE 200,039,091041,Rao; Bhaskar D.,9999,0,9999,0
1653451183588,ECE 200,040,091042,Rao; Ramesh R,9999,0,9999,0
1653451183588,ECE 200,041,091043,Rebeiz; Gabriel,9999,0,9999,0
1653451183588,ECE 200,042,091044,Sanford; John R,9999,0,9999,0
1653451183588,ECE 200,043,091045,Siegel; Paul H.,9999,0,9999,0
1653451183588,ECE 200,044,091046,Sievenpiper; Daniel F.,9999,0,9999,0
1653451183588,ECE 200,045,091047,Sworder; David D.,9999,0,9999,0
1653451183588,ECE 200,046,091048,Taur; Yuan,9999,0,9999,0
1653451183588,ECE 200,047,091049,Touri; Behrouz,9999,0,9999,0
1653451183588,ECE 200,048,091050,Trivedi; Mohan M.,9999,0,9999,0
1653451183588,ECE 200,049,091051,Vardy; Alexander,9999,0,9999,0
1653451183588,ECE 200,050,091052,Vasconcelos; Nuno,9999,0,9999,0
1653451183588,ECE 200,051,091053,Wang; Xiaolong,9999,0,9999,0
1653451183588,ECE 200,052,091054,Xie; Pengtao,9999,0,9999,0
1653451183588,ECE 200,053,091055,Yip; Michael,9999,0,9999,0
1653451183588,ECE 200,054,091056,Zeger; Kenneth A.,9999,0,9999,0
1653451183588,ECE 200,055,091057,Zhang; Xinyu,9999,0,9999,0
1653451183588,ECE 200,056,091058,Turakhia; Yatish Girish,9999,0,9999,0
1653451183588,ECE 200,057,091059,Kang; Mingu,9999,0,9999,0
1653451183588,ECE 200,058,091060,Shi; Yuanyuan,9999,0,9999,0
1653451183588,ECE 200,059,091061,Wang; Edward Jay,9999,0,9999,0
1653451183588,ECE 200,060,091062,Zheng; Yang,9999,0,9999,0
1653451184128,ECE 203,A00,091065,Mercier; Patrick Philip,0,0,0,0
1653451184654,ECE 207A,A00,091605,Liu; Thomas Tao-Ming,0,0,0,0
1653451185176,ECE 212AN,A00,091068,Nomura; Kenji,0,0,0,0
1653451185699,ECE 222A,A00,091069,Rebeiz; Gabriel,0,0,0,0
1653451186221,ECE 225A,A00,091070,Orlitsky; Alon,0,0,0,0
1653451186746,ECE 230A,A00,091071,Nomura; Kenji,0,0,0,0
1653451187270,ECE 236A,A00,091072,Dayeh; Shadi Ahmad,0,0,0,0
1653451187795,ECE 238A,A00,091073,Luo; Jian,0,0,0,0
1653451187795,ECE 238A,B00,091074,Luo; Jian,0,0,0,0
1653451188317,ECE 240A,A00,091075,Radic; Stojan,0,0,0,0
1653451188844,ECE 247A,A00,091592,Shi; Lingyan,0,0,0,0
1653451189379,ECE 250,A00,091076,Touri; Behrouz,0,0,0,0
1653451189908,ECE 251C,A00,091078,Nguyen; Truong Quang,0,0,0,0
1653451190431,ECE 253,A00,091079,Cosman; Pamela C.,0,0,0,0
1653451190958,ECE 255A,A00,091080,Orlitsky; Alon,0,0,0,0
1653451191483,ECE 257A,A00,091081,Zhang; Xinyu,0,0,0,0
1653451192006,ECE 260A,A01,091084,Eldon; John,0,0,0,0
1653451192531,ECE 264C,A00,091085,Galton; Ian A,0,0,0,0
1653451193056,ECE 265C,A00,094889,Presti; Calogero Davide,0,0,0,9
1653451193586,ECE 266,A01,091087,Hall; Drew A.,0,0,0,0
1653451194646,ECE 271A,A00,091090,Vasconcelos; Nuno,0,0,0,0
1653451195168,ECE 272B,A00,091091,Sworder; David D.,0,0,0,0
1653451195691,ECE 275A,A00,091092,Meyer; Florian,0,0,0,0
1653451196228,ECE 277,A00,091093,An; Cheolhong,0,0,0,0
1653451196759,ECE 283,A00,091094,Le; Hanh-Phuc,0,0,0,0
1653451197289,ECE 284,A00,091095,Kang; Mingu,0,0,0,0
1653451197289,ECE 284,B00,091096,Wang; Edward Jay,0,0,0,0
1653451197813,ECE 285,A00,094334,Touri; Behrouz,0,0,0,0
1653451198336,ECE 289,A00,091097,Whelan; David Arthur,0,0,0,0
1653451198858,MATH 200A,A00,087414,Salehi Golsefidy; Alireza,7,0,8,1
1653451199384,MATH 202A,A00,087415,Gill; Philip E.,3,0,8,5
1653451199915,MATH 203A,A00,087416,Oprea; Dragos N.,6,0,8,2
1653451200439,MATH 204A,A00,087417,Kedlaya; Kiran S.,6,0,8,2
1653451200969,MATH 205,A00,087418,Sorensen; Claus M,6,0,8,2
1653451201507,MATH 206A,A00,087419,Izadi; Elham,7,0,8,1
1653451202042,MATH 207A,A00,087420,Mohammadi; Amir,6,0,8,2
1653451202574,MATH 208,A00,087421,Staff,9,0,10,1
1653451203098,MATH 209,A00,087422,Staff,10,0,10,0
1653451203632,MATH 218,A00,087423,Staff,10,0,10,0
1653451204171,MATH 220A,A00,087424,Novak; Jonathan I,7,0,8,1
1653451204699,MATH 231A,A00,087425,Bejenaru; Ioan,3,0,8,5
1653451205222,MATH 240A,A00,087426,Ebenfelt; Peter F,5,0,8,3
1653451205747,MATH 243,A00,087427,Staff,9,0,10,1
1653451206274,MATH 248,A00,087429,Staff,10,0,10,0
1653451206797,MATH 250A,A00,087430,Spolaor; Luca,4,0,8,4
1653451207324,MATH 257A,A00,087431,Spolaor; Luca,7,0,8,1
1653451207852,MATH 258,A00,087432,Staff,9,0,10,1
1653451208377,MATH 264A,A00,087433,Warnke; Lutz Peter,5,0,8,3
1653451208901,MATH 268,A00,087434,Staff,15,0,15,0
1653451209426,MATH 269,A00,087435,Staff,14,0,15,1
1653451209960,MATH 270A,A00,087436,Nie; Jiawang,0,0,8,8
1653451210487,MATH 272A,A00,087437,Tian; Xiaochuan,1,0,8,7
1653451211011,MATH 274,A01,087439,Cheng; Li-Tien,9,0,10,1
1653451211011,MATH 274,A02,087440,Cheng; Li-Tien,10,0,10,0
1653451211538,MATH 278A,A00,087441,Staff,8,0,10,2
1653451212158,MATH 278B,A00,087442,Staff,8,0,10,2
1653451212686,MATH 278C,A00,087443,Staff,8,0,10,2
1653451213208,MATH 280A,A00,087444,Zheng; Tianyi,0,0,8,8
1653451213757,MATH 281A,A00,087445,Bradic; Jelena,0,0,8,8
1653451214294,MATH 282A,A00,087446,Zhang; Danna,0,0,8,8
1653451214817,MATH 283,A00,087447,Tesler; Glenn,0,0,0,14
1653451215343,MATH 286,A00,087448,Kemp; Todd Aahron,5,0,8,3
1653451215866,MATH 287D,A00,087449,Bradic; Jelena,8,0,8,0
1653451216389,MATH 288,A00,087450,Staff,14,0,15,1
1653451216389,MATH 288,B00,087451,Staff,15,0,15,0
1653451216389,MATH 288,C00,087452,Staff,15,0,15,0
1653451216953,MATH 290A,A00,087453,Xu; Zhouli,7,0,8,1
1653451217498,MATH 291A,A00,087454,Xu; Zhouli,7,0,8,1
1653451218022,MATH 292,A00,087455,Staff,10,0,10,0
1653451218546,MATH 295,A00,087456,Staff,50,0,50,0
1653451219080,MATH 297,001,087457,Staff,998,0,999,1
1653451779623,COGS 200,A01,087991,Staff,47,0,50,3
1653451780146,COGS 201,A01,094504,Rangel; Lara M,17,0,25,8
1653451780670,COGS 203,A00,087992,Coulson; Seana M,18,0,20,2
1653451781196,COGS 210A,001,087993,Greene; Deanna Jacquelyn,9998,0,9999,1
1653451781196,COGS 210A,002,087994,Saygin; Ayse P,9999,0,9999,0
1653451781196,COGS 210A,003,087995,Xia; Haijun,9999,0,9999,0
1653451781196,COGS 210A,004,087996,Nitz; Douglas A.,9999,0,9999,0
1653451781196,COGS 210A,005,087997,Hollan; James D.,9999,0,9999,0
1653451781196,COGS 210A,006,087998,Deak; Gedeon O.,9998,0,9999,1
1653451781196,COGS 210A,007,087999,Rossano; Federico,9999,0,9999,0
1653451781741,COGS 211A,A00,088000,Coulson; Seana M,9997,0,9999,2
1653451782266,COGS 229,A00,088002,Staff,23,0,25,2
1653451782788,COGS 260,B00,094231,Staff,17,0,20,3
1653451782788,COGS 260,A00,088004,Nitz; Douglas A.,9998,0,9999,1
1653451783311,CSE 202,A00,090110,Paturi; Ramamohan,0,0,0,0
1653451783311,CSE 202,B00,090111,Paturi; Ramamohan,0,0,0,0
1653451783845,CSE 207B,A00,090112,Heninger; Nadia A,0,0,0,0
1653451784370,CSE 208,A00,094858,Micciancio; Daniele,0,0,0,0
1653451784902,CSE 210,A00,090113,Powell; Thomas Allan,0,0,0,0
1653451785424,CSE 219,A00,090898,Staff,0,0,0,0
1653451785949,CSE 221,A00,090114,Zhou; Yuan-Yuan,0,0,0,0
1653451786475,CSE 229A,A00,090115,Porter; George M,0,0,0,0
1653451787001,CSE 229C,A00,090116,Savage; Stefan,0,0,0,0
1653451787527,CSE 230,A00,090117,Jhala; Ranjit,0,0,0,0
1653451788050,CSE 232,A00,090118,Papakonstantinou; Yannis,0,0,0,0
1653451788572,CSE 239A,A00,090121,Kumar; Arun Kumar,0,0,0,0
1653451789104,CSE 239B,A00,090122,Jhala; Ranjit,0,0,0,0
1653451789629,CSE 240A,A00,090123,Zhao; Jishen,0,0,189,189
1653451790154,CSE 243A,A00,090124,Orailoglu; Alex,1,0,15,14
1653451790679,CSE 249B,A00,090125,Kahng; Andrew Byun,13,0,20,7
1653451791205,CSE 250A,A00,090126,Berg-Kirkpatrick; Taylor D,0,0,0,0
1653451791734,CSE 252A,A00,090127,Ochoa; Benjamin Lawrence,0,0,0,0
1653451792260,CSE 258,A01,090129,McAuley; Julian John,0,0,0,0
1653451792790,CSE 258R,A01,090131,McAuley; Julian John,0,0,0,0
1653451793312,CSE 274,A00,090132,Ramamoorthi; Ravi,0,0,0,0
1653451793842,CSE 276A,A00,090133,Christensen; Henrik I,0,0,0,0
1653451794367,CSE 276C,A00,090134,Christensen; Henrik I,0,0,0,0
1653451794890,CSE 290,A00,090135,Bafna; Vineet,0,0,0,0
1653451794890,CSE 290,B00,090136,Ramamoorthi; Ravi,0,0,0,0
1653451794890,CSE 290,C00,090137,Li; Tzumao,9,0,10,1
1653451794890,CSE 290,D00,090138,Zhou; Yuan-Yuan,10,0,10,0
1653451794890,CSE 290,E00,090139,Christensen; Henrik I,10,0,10,0
1653451794890,CSE 290,F00,094053,Shalev; Aaron D,0,0,0,0
1653451795426,CSE 291,A00,090140,Munyaka; Imani N. S.,0,0,0,0
1653451795426,CSE 291,B00,094880,Yu; Qi,0,0,0,0
1653451795426,CSE 291,C00,090142,Pannuto; Patrick William,0,0,0,0
1653451795426,CSE 291,D00,094881,Zhang; Yiying,0,0,0,0
1653451795426,CSE 291,E00,095118,Su; Hao,0,0,0,0
1653451795961,CSE 293,001,094905,Bafna; Vineet,9999,0,9999,0
1653451795961,CSE 293,002,094906,Bellare; Mihir,9999,0,9999,0
1653451795961,CSE 293,003,094907,Berg-Kirkpatrick; Taylor D,9999,0,9999,0
1653451795961,CSE 293,004,094908,Christensen; Henrik I,9999,0,9999,0
1653451795961,CSE 293,005,094909,Cottrell; Garrison W,9999,0,9999,0
1653451795961,CSE 293,006,094910,Deutsch; Alin Bernard,9999,0,9999,0
1653451795961,CSE 293,007,094911,Esmaeilzadeh; Hadi,9999,0,9999,0
1653451795961,CSE 293,008,094912,Freund; Yoav,9999,0,9999,0
1653451795961,CSE 293,009,094913,Griswold; William G.,9999,0,9999,0
1653451795961,CSE 293,010,094914,Gymrek; Melissa Ann,9999,0,9999,0
1653451795961,CSE 293,011,094915,Heninger; Nadia A,9999,0,9999,0
1653451795961,CSE 293,012,094916,Impagliazzo; Russell,9999,0,9999,0
1653451795961,CSE 293,013,094917,Jhala; Ranjit,9999,0,9999,0
1653451795961,CSE 293,014,094918,Kahng; Andrew Byun,9999,0,9999,0
1653451795961,CSE 293,015,094919,Kane; Daniel Mertz,9999,0,9999,0
1653451795961,CSE 293,016,094920,Kriegman; David J,9999,0,9999,0
1653451795961,CSE 293,017,094921,Kumar; Arun Kumar,9999,0,9999,0
1653451795961,CSE 293,018,094922,Lerner; Sorin,9999,0,9999,0
1653451795961,CSE 293,019,094923,Lovett; Shachar,9999,0,9999,0
1653451795961,CSE 293,020,094924,McAuley; Julian John,9999,0,9999,0
1653451795961,CSE 293,021,094925,Micciancio; Daniele,9999,0,9999,0
1653451795961,CSE 293,022,094926,Orailoglu; Alex,9999,0,9999,0
1653451795961,CSE 293,023,094927,Paturi; Ramamohan,9999,0,9999,0
1653451795961,CSE 293,024,094928,Polikarpova; Nadezhda,9999,0,9999,0
1653451795961,CSE 293,025,094929,Politz; Joseph Gibbs,9999,0,9999,0
1653451795961,CSE 293,026,094930,Porter; George M,9999,0,9999,0
1653451795961,CSE 293,027,094931,Porter; Leonard Emerson,9999,0,9999,0
1653451795961,CSE 293,028,094932,Ramamoorthi; Ravi,9999,0,9999,0
1653451795961,CSE 293,029,094933,Sahoo; Debashis,9999,0,9999,0
1653451795961,CSE 293,030,094934,Saul; Lawrence,9999,0,9999,0
1653451795961,CSE 293,031,094935,Savage; Stefan,9999,0,9999,0
1653451795961,CSE 293,032,094936,Schulze; Jurgen P.,9999,0,9999,0
1653451795961,CSE 293,033,094937,Snoeren; Alex C.,9999,0,9999,0
1653451795961,CSE 293,034,094938,Shang; Jingbo,9999,0,9999,0
1653451795961,CSE 293,035,094939,Stefan; Deian,9999,0,9999,0
1653451795961,CSE 293,036,094940,Su; Hao,9999,0,9999,0
1653451795961,CSE 293,037,094941,Swanson; Steven James,9999,0,9999,0
1653451795961,CSE 293,038,094942,Tullsen; Dean Michael,9999,0,9999,0
1653451795961,CSE 293,039,094943,Voelker; Geoffrey M.,9999,0,9999,0
1653451795961,CSE 293,040,094944,Zhao; Jishen,9999,0,9999,0
1653451795961,CSE 293,041,094945,Zhou; Yuan-Yuan,9999,0,9999,0
1653451795961,CSE 293,042,094946,Gao; Sicun,9998,0,9999,1
1653451795961,CSE 293,043,094947,Weibel; Nadir,9999,0,9999,0
1653451795961,CSE 293,044,094948,Gupta; Rajesh K.,9999,0,9999,0
1653451796483,CSE 294,A00,090143,Porter; George M,9,0,10,1
1653451797016,DSE 200,A00,091799,Staff,50,0,50,0
1653451797538,DSE 203,A00,091800,Gupta; Amarnath,30,0,30,0
1653451798061,DSE 250,A00,091801,Deutsch; Alin Bernard,30,0,30,0
1653451798583,DSE 290,A00,091802,Altintas De Callaf; Ilkay,50,0,50,0
1653451799110,ECE 200,001,091003,Antipa; Nicholas A,9999,0,9999,0
1653451799110,ECE 200,002,091004,Atanasov; Nikolay A.,9999,0,9999,0
1653451799110,ECE 200,003,091005,Bharadia; Dinesh,9999,0,9999,0
1653451799110,ECE 200,004,091006,Cheng; Chung Kuan,9999,0,9999,0
1653451799110,ECE 200,005,091007,Cosman; Pamela C.,9999,0,9999,0
1653451799110,ECE 200,006,091008,Staff,9999,0,9999,0
1653451799110,ECE 200,007,091009,Dayeh; Shadi Ahmad,9999,0,9999,0
1653451799110,ECE 200,008,091010,Fainman; Yeshaiahu,9999,0,9999,0
1653451799110,ECE 200,009,091011,Ford; Joseph Earl,9999,0,9999,0
1653451799110,ECE 200,010,091012,Franceschetti; Massimo,9999,0,9999,0
1653451799110,ECE 200,011,091013,Fullerton; Eric E,9999,0,9999,0
1653451799110,ECE 200,012,091014,Galton; Ian A,9999,0,9999,0
1653451799110,ECE 200,013,091015,Gilja; Vikash,9999,0,9999,0
1653451799110,ECE 200,014,091016,Hall; Drew A.,9999,0,9999,0
1653451799110,ECE 200,015,091017,Hsueh; Tzu-Chien,9999,0,9999,0
1653451799110,ECE 200,016,091018,Javidi; Tara,9999,0,9999,0
1653451799110,ECE 200,017,091019,Kahng; Andrew Byun,9999,0,9999,0
1653451799110,ECE 200,018,091020,Kim; Young-Han,9999,0,9999,0
1653451799110,ECE 200,019,091021,Koushanfar; Farinaz,9999,0,9999,0
1653451799110,ECE 200,020,091022,Kuzum; Duygu,9999,0,9999,0
1653451799110,ECE 200,021,091023,Le; Hanh-Phuc,9999,0,9999,0
1653451799110,ECE 200,022,091024,Lin; Bill,9999,0,9999,0
1653451799110,ECE 200,023,091025,Liu; Zhaowei,9999,0,9999,0
1653451799110,ECE 200,024,091026,Lo; Yu-Hwa,9999,0,9999,0
1653451799110,ECE 200,025,091027,Lomakin; Vitaliy,9999,0,9999,0
1653451799110,ECE 200,026,091028,Mercier; Patrick Philip,9999,0,9999,0
1653451799110,ECE 200,027,091029,Meyer; Florian,9999,0,9999,0
1653451799110,ECE 200,028,091030,Milstein; Laurence B.,9999,0,9999,0
1653451799110,ECE 200,029,091031,Mir Arabbaygi; Siavash,9999,0,9999,0
1653451799110,ECE 200,030,091032,Mookherjea; Shayan,9999,0,9999,0
1653451799110,ECE 200,031,091033,Morris; Karcher William,9999,0,9999,0
1653451799110,ECE 200,032,091034,Ng; Tse Nga,9999,0,9999,0
1653451799110,ECE 200,033,091035,Nguyen; Truong Quang,9999,0,9999,0
1653451799110,ECE 200,034,091036,Nomura; Kenji,9999,0,9999,0
1653451799110,ECE 200,035,091037,Orlitsky; Alon,9999,0,9999,0
1653451799110,ECE 200,036,091038,Pal; Piya,9999,0,9999,0
1653451799110,ECE 200,037,091039,Papen; George C.,9999,0,9999,0
1653451799110,ECE 200,038,091040,Radic; Stojan,9999,0,9999,0
1653451799110,ECE 200,039,091041,Rao; Bhaskar D.,9999,0,9999,0
1653451799110,ECE 200,040,091042,Rao; Ramesh R,9999,0,9999,0
1653451799110,ECE 200,041,091043,Rebeiz; Gabriel,9999,0,9999,0
1653451799110,ECE 200,042,091044,Sanford; John R,9999,0,9999,0
1653451799110,ECE 200,043,091045,Siegel; Paul H.,9999,0,9999,0
1653451799110,ECE 200,044,091046,Sievenpiper; Daniel F.,9999,0,9999,0
1653451799110,ECE 200,045,091047,Sworder; David D.,9999,0,9999,0
1653451799110,ECE 200,046,091048,Taur; Yuan,9999,0,9999,0
1653451799110,ECE 200,047,091049,Touri; Behrouz,9999,0,9999,0
1653451799110,ECE 200,048,091050,Trivedi; Mohan M.,9999,0,9999,0
1653451799110,ECE 200,049,091051,Vardy; Alexander,9999,0,9999,0
1653451799110,ECE 200,050,091052,Vasconcelos; Nuno,9999,0,9999,0
1653451799110,ECE 200,051,091053,Wang; Xiaolong,9999,0,9999,0
1653451799110,ECE 200,052,091054,Xie; Pengtao,9999,0,9999,0
1653451799110,ECE 200,053,091055,Yip; Michael,9999,0,9999,0
1653451799110,ECE 200,054,091056,Zeger; Kenneth A.,9999,0,9999,0
1653451799110,ECE 200,055,091057,Zhang; Xinyu,9999,0,9999,0
1653451799110,ECE 200,056,091058,Turakhia; Yatish Girish,9999,0,9999,0
1653451799110,ECE 200,057,091059,Kang; Mingu,9999,0,9999,0
1653451799110,ECE 200,058,091060,Shi; Yuanyuan,9999,0,9999,0
1653451799110,ECE 200,059,091061,Wang; Edward Jay,9999,0,9999,0
1653451799110,ECE 200,060,091062,Zheng; Yang,9999,0,9999,0
1653451799638,ECE 203,A00,091065,Mercier; Patrick Philip,0,0,0,0
1653451800235,ECE 207A,A00,091605,Liu; Thomas Tao-Ming,0,0,0,0
1653451800762,ECE 212AN,A00,091068,Nomura; Kenji,0,0,0,0
1653451801288,ECE 222A,A00,091069,Rebeiz; Gabriel,0,0,0,0
1653451801811,ECE 225A,A00,091070,Orlitsky; Alon,0,0,0,0
1653451802342,ECE 230A,A00,091071,Nomura; Kenji,0,0,0,0
1653451802878,ECE 236A,A00,091072,Dayeh; Shadi Ahmad,0,0,0,0
1653451803402,ECE 238A,A00,091073,Luo; Jian,0,0,0,0
1653451803402,ECE 238A,B00,091074,Luo; Jian,0,0,0,0
1653451803932,ECE 240A,A00,091075,Radic; Stojan,0,0,0,0
1653451804454,ECE 247A,A00,091592,Shi; Lingyan,0,0,0,0
1653451804980,ECE 250,A00,091076,Touri; Behrouz,0,0,0,0
1653451805512,ECE 251C,A00,091078,Nguyen; Truong Quang,0,0,0,0
1653451806056,ECE 253,A00,091079,Cosman; Pamela C.,0,0,0,0
1653451806584,ECE 255A,A00,091080,Orlitsky; Alon,0,0,0,0
1653451807129,ECE 257A,A00,091081,Zhang; Xinyu,0,0,0,0
1653451807654,ECE 260A,A01,091084,Eldon; John,0,0,0,0
1653451808182,ECE 264C,A00,091085,Galton; Ian A,0,0,0,0
1653451808706,ECE 265C,A00,094889,Presti; Calogero Davide,0,0,0,9
1653451809229,ECE 266,A01,091087,Hall; Drew A.,0,0,0,0
1653451810291,ECE 271A,A00,091090,Vasconcelos; Nuno,0,0,0,0
1653451810817,ECE 272B,A00,091091,Sworder; David D.,0,0,0,0
1653451811486,ECE 275A,A00,091092,Meyer; Florian,0,0,0,0
1653451812090,ECE 277,A00,091093,An; Cheolhong,0,0,0,0
1653451812620,ECE 283,A00,091094,Le; Hanh-Phuc,0,0,0,0
1653451813144,ECE 284,A00,091095,Kang; Mingu,0,0,0,0
1653451813144,ECE 284,B00,091096,Wang; Edward Jay,0,0,0,0
1653451813666,ECE 285,A00,094334,Touri; Behrouz,0,0,0,0
1653451814190,ECE 289,A00,091097,Whelan; David Arthur,0,0,0,0
1653451814723,MATH 200A,A00,087414,Salehi Golsefidy; Alireza,7,0,8,1
1653451815252,MATH 202A,A00,087415,Gill; Philip E.,3,0,8,5
1653451815776,MATH 203A,A00,087416,Oprea; Dragos N.,6,0,8,2
1653451816300,MATH 204A,A00,087417,Kedlaya; Kiran S.,6,0,8,2
1653451816821,MATH 205,A00,087418,Sorensen; Claus M,6,0,8,2
1653451817348,MATH 206A,A00,087419,Izadi; Elham,7,0,8,1
1653451817873,MATH 207A,A00,087420,Mohammadi; Amir,6,0,8,2
1653451818400,MATH 208,A00,087421,Staff,9,0,10,1
1653451818922,MATH 209,A00,087422,Staff,10,0,10,0
1653451819449,MATH 218,A00,087423,Staff,10,0,10,0
1653451819972,MATH 220A,A00,087424,Novak; Jonathan I,7,0,8,1
1653451820502,MATH 231A,A00,087425,Bejenaru; Ioan,3,0,8,5
1653451821031,MATH 240A,A00,087426,Ebenfelt; Peter F,5,0,8,3
1653451821567,MATH 243,A00,087427,Staff,9,0,10,1
1653451822111,MATH 248,A00,087429,Staff,10,0,10,0
1653451822635,MATH 250A,A00,087430,Spolaor; Luca,4,0,8,4
1653451823157,MATH 257A,A00,087431,Spolaor; Luca,7,0,8,1
1653451823681,MATH 258,A00,087432,Staff,9,0,10,1
1653451824201,MATH 264A,A00,087433,Warnke; Lutz Peter,5,0,8,3
1653451824747,MATH 268,A00,087434,Staff,15,0,15,0
1653451825269,MATH 269,A00,087435,Staff,14,0,15,1
1653451825799,MATH 270A,A00,087436,Nie; Jiawang,0,0,8,8
1653451826323,MATH 272A,A00,087437,Tian; Xiaochuan,1,0,8,7
1653451826850,MATH 274,A01,087439,Cheng; Li-Tien,9,0,10,1
1653451826850,MATH 274,A02,087440,Cheng; Li-Tien,10,0,10,0
1653451827374,MATH 278A,A00,087441,Staff,8,0,10,2
1653451827900,MATH 278B,A00,087442,Staff,8,0,10,2
1653451828431,MATH 278C,A00,087443,Staff,8,0,10,2
1653451828967,MATH 280A,A00,087444,Zheng; Tianyi,0,0,8,8
1653451829488,MATH 281A,A00,087445,Bradic; Jelena,0,0,8,8
1653451830011,MATH 282A,A00,087446,Zhang; Danna,0,0,8,8
1653451830534,MATH 283,A00,087447,Tesler; Glenn,0,0,0,14
1653451831063,MATH 286,A00,087448,Kemp; Todd Aahron,5,0,8,3
1653451831594,MATH 287D,A00,087449,Bradic; Jelena,8,0,8,0
1653451832119,MATH 288,A00,087450,Staff,14,0,15,1
1653451832119,MATH 288,B00,087451,Staff,15,0,15,0
1653451832119,MATH 288,C00,087452,Staff,15,0,15,0
1653451832642,MATH 290A,A00,087453,Xu; Zhouli,7,0,8,1
1653451833170,MATH 291A,A00,087454,Xu; Zhouli,7,0,8,1
1653451833692,MATH 292,A00,087455,Staff,10,0,10,0
1653451834214,MATH 295,A00,087456,Staff,50,0,50,0
1653451834742,MATH 297,001,087457,Staff,998,0,999,1
1653452406470,COGS 200,A01,087991,Staff,47,0,50,3
1653452406999,COGS 201,A01,094504,Rangel; Lara M,17,0,25,8
1653452407531,COGS 203,A00,087992,Coulson; Seana M,18,0,20,2
1653452408065,COGS 210A,001,087993,Greene; Deanna Jacquelyn,9998,0,9999,1
1653452408065,COGS 210A,002,087994,Saygin; Ayse P,9999,0,9999,0
1653452408065,COGS 210A,003,087995,Xia; Haijun,9999,0,9999,0
1653452408065,COGS 210A,004,087996,Nitz; Douglas A.,9999,0,9999,0
1653452408065,COGS 210A,005,087997,Hollan; James D.,9999,0,9999,0
1653452408065,COGS 210A,006,087998,Deak; Gedeon O.,9998,0,9999,1
1653452408065,COGS 210A,007,087999,Rossano; Federico,9999,0,9999,0
1653452408590,COGS 211A,A00,088000,Coulson; Seana M,9997,0,9999,2
1653452409114,COGS 229,A00,088002,Staff,23,0,25,2
1653452409636,COGS 260,B00,094231,Staff,17,0,20,3
1653452409636,COGS 260,A00,088004,Nitz; Douglas A.,9998,0,9999,1
1653452410160,CSE 202,A00,090110,Paturi; Ramamohan,0,0,0,0
1653452410160,CSE 202,B00,090111,Paturi; Ramamohan,0,0,0,0
1653452410688,CSE 207B,A00,090112,Heninger; Nadia A,0,0,0,0
1653452411214,CSE 208,A00,094858,Micciancio; Daniele,0,0,0,0
1653452411737,CSE 210,A00,090113,Powell; Thomas Allan,0,0,0,0
1653452412259,CSE 219,A00,090898,Staff,0,0,0,0
1653452412785,CSE 221,A00,090114,Zhou; Yuan-Yuan,0,0,0,0
1653452413307,CSE 229A,A00,090115,Porter; George M,0,0,0,0
1653452413830,CSE 229C,A00,090116,Savage; Stefan,0,0,0,0
1653452414354,CSE 230,A00,090117,Jhala; Ranjit,0,0,0,0
1653452414877,CSE 232,A00,090118,Papakonstantinou; Yannis,0,0,0,0
1653452415408,CSE 239A,A00,090121,Kumar; Arun Kumar,0,0,0,0
1653452415931,CSE 239B,A00,090122,Jhala; Ranjit,0,0,0,0
1653452416467,CSE 240A,A00,090123,Zhao; Jishen,0,0,189,189
1653452416990,CSE 243A,A00,090124,Orailoglu; Alex,1,0,15,14
1653452417512,CSE 249B,A00,090125,Kahng; Andrew Byun,13,0,20,7
1653452418037,CSE 250A,A00,090126,Berg-Kirkpatrick; Taylor D,0,0,0,0
1653452418561,CSE 252A,A00,090127,Ochoa; Benjamin Lawrence,0,0,0,0
1653452419094,CSE 258,A01,090129,McAuley; Julian John,0,0,0,0
1653452419626,CSE 258R,A01,090131,McAuley; Julian John,0,0,0,0
1653452420151,CSE 274,A00,090132,Ramamoorthi; Ravi,0,0,0,0
1653452420690,CSE 276A,A00,090133,Christensen; Henrik I,0,0,0,0
1653452421213,CSE 276C,A00,090134,Christensen; Henrik I,0,0,0,0
1653452421735,CSE 290,A00,090135,Bafna; Vineet,0,0,0,0
1653452421735,CSE 290,B00,090136,Ramamoorthi; Ravi,0,0,0,0
1653452421735,CSE 290,C00,090137,Li; Tzumao,9,0,10,1
1653452421735,CSE 290,D00,090138,Zhou; Yuan-Yuan,10,0,10,0
1653452421735,CSE 290,E00,090139,Christensen; Henrik I,10,0,10,0
1653452421735,CSE 290,F00,094053,Shalev; Aaron D,0,0,0,0
1653452422322,CSE 291,A00,090140,Munyaka; Imani N. S.,0,0,0,0
1653452422322,CSE 291,B00,094880,Yu; Qi,0,0,0,0
1653452422322,CSE 291,C00,090142,Pannuto; Patrick William,0,0,0,0
1653452422322,CSE 291,D00,094881,Zhang; Yiying,0,0,0,0
1653452422322,CSE 291,E00,095118,Su; Hao,0,0,0,0
1653452422866,CSE 293,001,094905,Bafna; Vineet,9999,0,9999,0
1653452422866,CSE 293,002,094906,Bellare; Mihir,9999,0,9999,0
1653452422866,CSE 293,003,094907,Berg-Kirkpatrick; Taylor D,9999,0,9999,0
1653452422866,CSE 293,004,094908,Christensen; Henrik I,9999,0,9999,0
1653452422866,CSE 293,005,094909,Cottrell; Garrison W,9999,0,9999,0
1653452422866,CSE 293,006,094910,Deutsch; Alin Bernard,9999,0,9999,0
1653452422866,CSE 293,007,094911,Esmaeilzadeh; Hadi,9999,0,9999,0
1653452422866,CSE 293,008,094912,Freund; Yoav,9999,0,9999,0
1653452422866,CSE 293,009,094913,Griswold; William G.,9999,0,9999,0
1653452422866,CSE 293,010,094914,Gymrek; Melissa Ann,9999,0,9999,0
1653452422866,CSE 293,011,094915,Heninger; Nadia A,9999,0,9999,0
1653452422866,CSE 293,012,094916,Impagliazzo; Russell,9999,0,9999,0
1653452422866,CSE 293,013,094917,Jhala; Ranjit,9999,0,9999,0
1653452422866,CSE 293,014,094918,Kahng; Andrew Byun,9999,0,9999,0
1653452422866,CSE 293,015,094919,Kane; Daniel Mertz,9999,0,9999,0
1653452422866,CSE 293,016,094920,Kriegman; David J,9999,0,9999,0
1653452422866,CSE 293,017,094921,Kumar; Arun Kumar,9999,0,9999,0
1653452422866,CSE 293,018,094922,Lerner; Sorin,9999,0,9999,0
1653452422866,CSE 293,019,094923,Lovett; Shachar,9999,0,9999,0
1653452422866,CSE 293,020,094924,McAuley; Julian John,9999,0,9999,0
1653452422866,CSE 293,021,094925,Micciancio; Daniele,9999,0,9999,0
1653452422866,CSE 293,022,094926,Orailoglu; Alex,9999,0,9999,0
1653452422866,CSE 293,023,094927,Paturi; Ramamohan,9999,0,9999,0
1653452422866,CSE 293,024,094928,Polikarpova; Nadezhda,9999,0,9999,0
1653452422866,CSE 293,025,094929,Politz; Joseph Gibbs,9999,0,9999,0
1653452422866,CSE 293,026,094930,Porter; George M,9999,0,9999,0
1653452422866,CSE 293,027,094931,Porter; Leonard Emerson,9999,0,9999,0
1653452422866,CSE 293,028,094932,Ramamoorthi; Ravi,9999,0,9999,0
1653452422866,CSE 293,029,094933,Sahoo; Debashis,9999,0,9999,0
1653452422866,CSE 293,030,094934,Saul; Lawrence,9999,0,9999,0
1653452422866,CSE 293,031,094935,Savage; Stefan,9999,0,9999,0
1653452422866,CSE 293,032,094936,Schulze; Jurgen P.,9999,0,9999,0
1653452422866,CSE 293,033,094937,Snoeren; Alex C.,9999,0,9999,0
1653452422866,CSE 293,034,094938,Shang; Jingbo,9999,0,9999,0
1653452422866,CSE 293,035,094939,Stefan; Deian,9999,0,9999,0
1653452422866,CSE 293,036,094940,Su; Hao,9999,0,9999,0
1653452422866,CSE 293,037,094941,Swanson; Steven James,9999,0,9999,0
1653452422866,CSE 293,038,094942,Tullsen; Dean Michael,9999,0,9999,0
1653452422866,CSE 293,039,094943,Voelker; Geoffrey M.,9999,0,9999,0
1653452422866,CSE 293,040,094944,Zhao; Jishen,9999,0,9999,0
1653452422866,CSE 293,041,094945,Zhou; Yuan-Yuan,9999,0,9999,0
1653452422866,CSE 293,042,094946,Gao; Sicun,9998,0,9999,1
1653452422866,CSE 293,043,094947,Weibel; Nadir,9999,0,9999,0
1653452422866,CSE 293,044,094948,Gupta; Rajesh K.,9999,0,9999,0
1653452423388,CSE 294,A00,090143,Porter; George M,9,0,10,1
1653452423911,DSE 200,A00,091799,Staff,50,0,50,0
1653452424438,DSE 203,A00,091800,Gupta; Amarnath,30,0,30,0
1653452424960,DSE 250,A00,091801,Deutsch; Alin Bernard,30,0,30,0
1653452425482,DSE 290,A00,091802,Altintas De Callaf; Ilkay,50,0,50,0
1653452426029,ECE 200,001,091003,Antipa; Nicholas A,9999,0,9999,0
1653452426029,ECE 200,002,091004,Atanasov; Nikolay A.,9999,0,9999,0
1653452426029,ECE 200,003,091005,Bharadia; Dinesh,9999,0,9999,0
1653452426029,ECE 200,004,091006,Cheng; Chung Kuan,9999,0,9999,0
1653452426029,ECE 200,005,091007,Cosman; Pamela C.,9999,0,9999,0
1653452426029,ECE 200,006,091008,Staff,9999,0,9999,0
1653452426029,ECE 200,007,091009,Dayeh; Shadi Ahmad,9999,0,9999,0
1653452426029,ECE 200,008,091010,Fainman; Yeshaiahu,9999,0,9999,0
1653452426029,ECE 200,009,091011,Ford; Joseph Earl,9999,0,9999,0
1653452426029,ECE 200,010,091012,Franceschetti; Massimo,9999,0,9999,0
1653452426029,ECE 200,011,091013,Fullerton; Eric E,9999,0,9999,0
1653452426029,ECE 200,012,091014,Galton; Ian A,9999,0,9999,0
1653452426029,ECE 200,013,091015,Gilja; Vikash,9999,0,9999,0
1653452426029,ECE 200,014,091016,Hall; Drew A.,9999,0,9999,0
1653452426029,ECE 200,015,091017,Hsueh; Tzu-Chien,9999,0,9999,0
1653452426029,ECE 200,016,091018,Javidi; Tara,9999,0,9999,0
1653452426029,ECE 200,017,091019,Kahng; Andrew Byun,9999,0,9999,0
1653452426029,ECE 200,018,091020,Kim; Young-Han,9999,0,9999,0
1653452426029,ECE 200,019,091021,Koushanfar; Farinaz,9999,0,9999,0
1653452426029,ECE 200,020,091022,Kuzum; Duygu,9999,0,9999,0
1653452426029,ECE 200,021,091023,Le; Hanh-Phuc,9999,0,9999,0
1653452426029,ECE 200,022,091024,Lin; Bill,9999,0,9999,0
1653452426029,ECE 200,023,091025,Liu; Zhaowei,9999,0,9999,0
1653452426029,ECE 200,024,091026,Lo; Yu-Hwa,9999,0,9999,0
1653452426029,ECE 200,025,091027,Lomakin; Vitaliy,9999,0,9999,0
1653452426029,ECE 200,026,091028,Mercier; Patrick Philip,9999,0,9999,0
1653452426029,ECE 200,027,091029,Meyer; Florian,9999,0,9999,0
1653452426029,ECE 200,028,091030,Milstein; Laurence B.,9999,0,9999,0
1653452426029,ECE 200,029,091031,Mir Arabbaygi; Siavash,9999,0,9999,0
1653452426029,ECE 200,030,091032,Mookherjea; Shayan,9999,0,9999,0
1653452426029,ECE 200,031,091033,Morris; Karcher William,9999,0,9999,0
1653452426029,ECE 200,032,091034,Ng; Tse Nga,9999,0,9999,0
1653452426029,ECE 200,033,091035,Nguyen; Truong Quang,9999,0,9999,0
1653452426029,ECE 200,034,091036,Nomura; Kenji,9999,0,9999,0
1653452426029,ECE 200,035,091037,Orlitsky; Alon,9999,0,9999,0
1653452426029,ECE 200,036,091038,Pal; Piya,9999,0,9999,0
1653452426029,ECE 200,037,091039,Papen; George C.,9999,0,9999,0
1653452426029,ECE 200,038,091040,Radic; Stojan,9999,0,9999,0
1653452426029,ECE 200,039,091041,Rao; Bhaskar D.,9999,0,9999,0
1653452426029,ECE 200,040,091042,Rao; Ramesh R,9999,0,9999,0
1653452426029,ECE 200,041,091043,Rebeiz; Gabriel,9999,0,9999,0
1653452426029,ECE 200,042,091044,Sanford; John R,9999,0,9999,0
1653452426029,ECE 200,043,091045,Siegel; Paul H.,9999,0,9999,0
1653452426029,ECE 200,044,091046,Sievenpiper; Daniel F.,9999,0,9999,0
1653452426029,ECE 200,045,091047,Sworder; David D.,9999,0,9999,0
1653452426029,ECE 200,046,091048,Taur; Yuan,9999,0,9999,0
1653452426029,ECE 200,047,091049,Touri; Behrouz,9999,0,9999,0
1653452426029,ECE 200,048,091050,Trivedi; Mohan M.,9999,0,9999,0
1653452426029,ECE 200,049,091051,Vardy; Alexander,9999,0,9999,0
1653452426029,ECE 200,050,091052,Vasconcelos; Nuno,9999,0,9999,0
1653452426029,ECE 200,051,091053,Wang; Xiaolong,9999,0,9999,0
1653452426029,ECE 200,052,091054,Xie; Pengtao,9999,0,9999,0
1653452426029,ECE 200,053,091055,Yip; Michael,9999,0,9999,0
1653452426029,ECE 200,054,091056,Zeger; Kenneth A.,9999,0,9999,0
1653452426029,ECE 200,055,091057,Zhang; Xinyu,9999,0,9999,0
1653452426029,ECE 200,056,091058,Turakhia; Yatish Girish,9999,0,9999,0
1653452426029,ECE 200,057,091059,Kang; Mingu,9999,0,9999,0
1653452426029,ECE 200,058,091060,Shi; Yuanyuan,9999,0,9999,0
1653452426029,ECE 200,059,091061,Wang; Edward Jay,9999,0,9999,0
1653452426029,ECE 200,060,091062,Zheng; Yang,9999,0,9999,0
1653452426583,ECE 203,A00,091065,Mercier; Patrick Philip,0,0,0,0
1653452427104,ECE 207A,A00,091605,Liu; Thomas Tao-Ming,0,0,0,0
1653452427635,ECE 212AN,A00,091068,Nomura; Kenji,0,0,0,0
1653452428161,ECE 222A,A00,091069,Rebeiz; Gabriel,0,0,0,0
1653452428690,ECE 225A,A00,091070,Orlitsky; Alon,0,0,0,0
1653452429212,ECE 230A,A00,091071,Nomura; Kenji,0,0,0,0
1653452429740,ECE 236A,A00,091072,Dayeh; Shadi Ahmad,0,0,0,0
1653452430268,ECE 238A,A00,091073,Luo; Jian,0,0,0,0
1653452430268,ECE 238A,B00,091074,Luo; Jian,0,0,0,0
1653452430794,ECE 240A,A00,091075,Radic; Stojan,0,0,0,0
1653452431320,ECE 247A,A00,091592,Shi; Lingyan,0,0,0,0
1653452431864,ECE 250,A00,091076,Touri; Behrouz,0,0,0,0
1653452432393,ECE 251C,A00,091078,Nguyen; Truong Quang,0,0,0,0
1653452432932,ECE 253,A00,091079,Cosman; Pamela C.,0,0,0,0
1653452433467,ECE 255A,A00,091080,Orlitsky; Alon,0,0,0,0
1653452433990,ECE 257A,A00,091081,Zhang; Xinyu,0,0,0,0
1653452434511,ECE 260A,A01,091084,Eldon; John,0,0,0,0
1653452435043,ECE 264C,A00,091085,Galton; Ian A,0,0,0,0
1653452435578,ECE 265C,A00,094889,Presti; Calogero Davide,0,0,0,9
1653452436110,ECE 266,A01,091087,Hall; Drew A.,0,0,0,0
1653452437169,ECE 271A,A00,091090,Vasconcelos; Nuno,0,0,0,0
1653452437693,ECE 272B,A00,091091,Sworder; David D.,0,0,0,0
1653452438216,ECE 275A,A00,091092,Meyer; Florian,0,0,0,0
1653452438755,ECE 277,A00,091093,An; Cheolhong,0,0,0,0
1653452439277,ECE 283,A00,091094,Le; Hanh-Phuc,0,0,0,0
1653452439809,ECE 284,A00,091095,Kang; Mingu,0,0,0,0
1653452439809,ECE 284,B00,091096,Wang; Edward Jay,0,0,0,0
1653452440335,ECE 285,A00,094334,Touri; Behrouz,0,0,0,0
1653452440860,ECE 289,A00,091097,Whelan; David Arthur,0,0,0,0
1653452441392,MATH 200A,A00,087414,Salehi Golsefidy; Alireza,7,0,8,1
1653452441927,MATH 202A,A00,087415,Gill; Philip E.,3,0,8,5
1653452442453,MATH 203A,A00,087416,Oprea; Dragos N.,6,0,8,2
1653452442978,MATH 204A,A00,087417,Kedlaya; Kiran S.,6,0,8,2
1653452443501,MATH 205,A00,087418,Sorensen; Claus M,6,0,8,2
1653452444026,MATH 206A,A00,087419,Izadi; Elham,7,0,8,1
1653452444553,MATH 207A,A00,087420,Mohammadi; Amir,6,0,8,2
1653452445083,MATH 208,A00,087421,Staff,9,0,10,1
1653452445606,MATH 209,A00,087422,Staff,10,0,10,0
1653452446138,MATH 218,A00,087423,Staff,10,0,10,0
1653452446672,MATH 220A,A00,087424,Novak; Jonathan I,7,0,8,1
1653452447196,MATH 231A,A00,087425,Bejenaru; Ioan,3,0,8,5
1653452447720,MATH 240A,A00,087426,Ebenfelt; Peter F,5,0,8,3
1653452448242,MATH 243,A00,087427,Staff,9,0,10,1
1653452448772,MATH 248,A00,087429,Staff,10,0,10,0
1653452449295,MATH 250A,A00,087430,Spolaor; Luca,4,0,8,4
1653452449818,MATH 257A,A00,087431,Spolaor; Luca,7,0,8,1
1653452450343,MATH 258,A00,087432,Staff,9,0,10,1
1653452450902,MATH 264A,A00,087433,Warnke; Lutz Peter,5,0,8,3
1653452451440,MATH 268,A00,087434,Staff,15,0,15,0
1653452451971,MATH 269,A00,087435,Staff,14,0,15,1
1653452452494,MATH 270A,A00,087436,Nie; Jiawang,0,0,8,8
1653452453118,MATH 272A,A00,087437,Tian; Xiaochuan,1,0,8,7
1653452453639,MATH 274,A01,087439,Cheng; Li-Tien,9,0,10,1
1653452453639,MATH 274,A02,087440,Cheng; Li-Tien,10,0,10,0
1653452454161,MATH 278A,A00,087441,Staff,8,0,10,2
1653452454706,MATH 278B,A00,087442,Staff,8,0,10,2
1653452455231,MATH 278C,A00,087443,Staff,8,0,10,2
1653452455753,MATH 280A,A00,087444,Zheng; Tianyi,0,0,8,8
1653452456278,MATH 281A,A00,087445,Bradic; Jelena,0,0,8,8
1653452456801,MATH 282A,A00,087446,Zhang; Danna,0,0,8,8
1653452457324,MATH 283,A00,087447,Tesler; Glenn,0,0,0,14
1653452457847,MATH 286,A00,087448,Kemp; Todd Aahron,5,0,8,3
1653452458370,MATH 287D,A00,087449,Bradic; Jelena,8,0,8,0
1653452458899,MATH 288,A00,087450,Staff,14,0,15,1
1653452458899,MATH 288,B00,087451,Staff,15,0,15,0
1653452458899,MATH 288,C00,087452,Staff,15,0,15,0
1653452459424,MATH 290A,A00,087453,Xu; Zhouli,7,0,8,1
1653452459947,MATH 291A,A00,087454,Xu; Zhouli,7,0,8,1
1653452460479,MATH 292,A00,087455,Staff,10,0,10,0
1653452461004,MATH 295,A00,087456,Staff,50,0,50,0
1653452461532,MATH 297,001,087457,Staff,998,0,999,1
1653453022130,COGS 200,A01,087991,Staff,47,0,50,3
1653453022665,COGS 201,A01,094504,Rangel; Lara M,17,0,25,8
1653453023191,COGS 203,A00,087992,Coulson; Seana M,18,0,20,2
1653453023723,COGS 210A,001,087993,Greene; Deanna Jacquelyn,9998,0,9999,1
1653453023723,COGS 210A,002,087994,Saygin; Ayse P,9999,0,9999,0
1653453023723,COGS 210A,003,087995,Xia; Haijun,9999,0,9999,0
1653453023723,COGS 210A,004,087996,Nitz; Douglas A.,9999,0,9999,0
1653453023723,COGS 210A,005,087997,Hollan; James D.,9999,0,9999,0
1653453023723,COGS 210A,006,087998,Deak; Gedeon O.,9998,0,9999,1
1653453023723,COGS 210A,007,087999,Rossano; Federico,9999,0,9999,0
1653453024258,COGS 211A,A00,088000,Coulson; Seana M,9997,0,9999,2
1653453024793,COGS 229,A00,088002,Staff,23,0,25,2
1653453025317,COGS 260,B00,094231,Staff,17,0,20,3
1653453025317,COGS 260,A00,088004,Nitz; Douglas A.,9998,0,9999,1
1653453025843,CSE 202,A00,090110,Paturi; Ramamohan,0,0,0,0
1653453025843,CSE 202,B00,090111,Paturi; Ramamohan,0,0,0,0
1653453026365,CSE 207B,A00,090112,Heninger; Nadia A,0,0,0,0
1653453026888,CSE 208,A00,094858,Micciancio; Daniele,0,0,0,0
1653453027412,CSE 210,A00,090113,Powell; Thomas Allan,0,0,0,0
1653453027934,CSE 219,A00,090898,Staff,0,0,0,0
1653453028456,CSE 221,A00,090114,Zhou; Yuan-Yuan,0,0,0,0
1653453028977,CSE 229A,A00,090115,Porter; George M,0,0,0,0
1653453029500,CSE 229C,A00,090116,Savage; Stefan,0,0,0,0
1653453030027,CSE 230,A00,090117,Jhala; Ranjit,0,0,0,0
1653453030553,CSE 232,A00,090118,Papakonstantinou; Yannis,0,0,0,0
1653453031080,CSE 239A,A00,090121,Kumar; Arun Kumar,0,0,0,0
1653453031602,CSE 239B,A00,090122,Jhala; Ranjit,0,0,0,0
1653453032130,CSE 240A,A00,090123,Zhao; Jishen,0,0,189,189
1653453032653,CSE 243A,A00,090124,Orailoglu; Alex,1,0,15,14
1653453033177,CSE 249B,A00,090125,Kahng; Andrew Byun,13,0,20,7
1653453033721,CSE 250A,A00,090126,Berg-Kirkpatrick; Taylor D,0,0,0,0
1653453034245,CSE 252A,A00,090127,Ochoa; Benjamin Lawrence,0,0,0,0
1653453034772,CSE 258,A01,090129,McAuley; Julian John,0,0,0,0
1653453035304,CSE 258R,A01,090131,McAuley; Julian John,0,0,0,0
1653453035858,CSE 274,A00,090132,Ramamoorthi; Ravi,0,0,0,0
1653453036387,CSE 276A,A00,090133,Christensen; Henrik I,0,0,0,0
1653453036915,CSE 276C,A00,090134,Christensen; Henrik I,0,0,0,0
1653453037446,CSE 290,A00,090135,Bafna; Vineet,0,0,0,0
1653453037446,CSE 290,B00,090136,Ramamoorthi; Ravi,0,0,0,0
1653453037446,CSE 290,C00,090137,Li; Tzumao,9,0,10,1
1653453037446,CSE 290,D00,090138,Zhou; Yuan-Yuan,10,0,10,0
1653453037446,CSE 290,E00,090139,Christensen; Henrik I,10,0,10,0
1653453037446,CSE 290,F00,094053,Shalev; Aaron D,0,0,0,0
1653453037993,CSE 291,A00,090140,Munyaka; Imani N. S.,0,0,0,0
1653453037993,CSE 291,B00,094880,Yu; Qi,0,0,0,0
1653453037993,CSE 291,C00,090142,Pannuto; Patrick William,0,0,0,0
1653453037993,CSE 291,D00,094881,Zhang; Yiying,0,0,0,0
1653453037993,CSE 291,E00,095118,Su; Hao,0,0,0,0
1653453038540,CSE 293,001,094905,Bafna; Vineet,9999,0,9999,0
1653453038540,CSE 293,002,094906,Bellare; Mihir,9999,0,9999,0
1653453038540,CSE 293,003,094907,Berg-Kirkpatrick; Taylor D,9999,0,9999,0
1653453038540,CSE 293,004,094908,Christensen; Henrik I,9999,0,9999,0
1653453038540,CSE 293,005,094909,Cottrell; Garrison W,9999,0,9999,0
1653453038540,CSE 293,006,094910,Deutsch; Alin Bernard,9999,0,9999,0
1653453038540,CSE 293,007,094911,Esmaeilzadeh; Hadi,9999,0,9999,0
1653453038540,CSE 293,008,094912,Freund; Yoav,9999,0,9999,0
1653453038540,CSE 293,009,094913,Griswold; William G.,9999,0,9999,0
1653453038540,CSE 293,010,094914,Gymrek; Melissa Ann,9999,0,9999,0
1653453038540,CSE 293,011,094915,Heninger; Nadia A,9999,0,9999,0
1653453038540,CSE 293,012,094916,Impagliazzo; Russell,9999,0,9999,0
1653453038540,CSE 293,013,094917,Jhala; Ranjit,9999,0,9999,0
1653453038540,CSE 293,014,094918,Kahng; Andrew Byun,9999,0,9999,0
1653453038540,CSE 293,015,094919,Kane; Daniel Mertz,9999,0,9999,0
1653453038540,CSE 293,016,094920,Kriegman; David J,9999,0,9999,0
1653453038540,CSE 293,017,094921,Kumar; Arun Kumar,9999,0,9999,0
1653453038540,CSE 293,018,094922,Lerner; Sorin,9999,0,9999,0
1653453038540,CSE 293,019,094923,Lovett; Shachar,9999,0,9999,0
1653453038540,CSE 293,020,094924,McAuley; Julian John,9999,0,9999,0
1653453038540,CSE 293,021,094925,Micciancio; Daniele,9999,0,9999,0
1653453038540,CSE 293,022,094926,Orailoglu; Alex,9999,0,9999,0
1653453038540,CSE 293,023,094927,Paturi; Ramamohan,9999,0,9999,0
1653453038540,CSE 293,024,094928,Polikarpova; Nadezhda,9999,0,9999,0
1653453038540,CSE 293,025,094929,Politz; Joseph Gibbs,9999,0,9999,0
1653453038540,CSE 293,026,094930,Porter; George M,9999,0,9999,0
1653453038540,CSE 293,027,094931,Porter; Leonard Emerson,9999,0,9999,0
1653453038540,CSE 293,028,094932,Ramamoorthi; Ravi,9999,0,9999,0
1653453038540,CSE 293,029,094933,Sahoo; Debashis,9999,0,9999,0
1653453038540,CSE 293,030,094934,Saul; Lawrence,9999,0,9999,0
1653453038540,CSE 293,031,094935,Savage; Stefan,9999,0,9999,0
1653453038540,CSE 293,032,094936,Schulze; Jurgen P.,9999,0,9999,0
1653453038540,CSE 293,033,094937,Snoeren; Alex C.,9999,0,9999,0
1653453038540,CSE 293,034,094938,Shang; Jingbo,9999,0,9999,0
1653453038540,CSE 293,035,094939,Stefan; Deian,9999,0,9999,0
1653453038540,CSE 293,036,094940,Su; Hao,9999,0,9999,0
1653453038540,CSE 293,037,094941,Swanson; Steven James,9999,0,9999,0
1653453038540,CSE 293,038,094942,Tullsen; Dean Michael,9999,0,9999,0
1653453038540,CSE 293,039,094943,Voelker; Geoffrey M.,9999,0,9999,0
1653453038540,CSE 293,040,094944,Zhao; Jishen,9999,0,9999,0
1653453038540,CSE 293,041,094945,Zhou; Yuan-Yuan,9999,0,9999,0
1653453038540,CSE 293,042,094946,Gao; Sicun,9998,0,9999,1
1653453038540,CSE 293,043,094947,Weibel; Nadir,9999,0,9999,0
1653453038540,CSE 293,044,094948,Gupta; Rajesh K.,9999,0,9999,0
1653453039069,CSE 294,A00,090143,Porter; George M,9,0,10,1
1653453039591,DSE 200,A00,091799,Staff,50,0,50,0
1653453040120,DSE 203,A00,091800,Gupta; Amarnath,30,0,30,0
1653453040648,DSE 250,A00,091801,Deutsch; Alin Bernard,30,0,30,0
1653453041245,DSE 290,A00,091802,Altintas De Callaf; Ilkay,50,0,50,0
1653453041802,ECE 200,001,091003,Antipa; Nicholas A,9999,0,9999,0
1653453041802,ECE 200,002,091004,Atanasov; Nikolay A.,9999,0,9999,0
1653453041802,ECE 200,003,091005,Bharadia; Dinesh,9999,0,9999,0
1653453041802,ECE 200,004,091006,Cheng; Chung Kuan,9999,0,9999,0
1653453041802,ECE 200,005,091007,Cosman; Pamela C.,9999,0,9999,0
1653453041802,ECE 200,006,091008,Staff,9999,0,9999,0
1653453041802,ECE 200,007,091009,Dayeh; Shadi Ahmad,9999,0,9999,0
1653453041802,ECE 200,008,091010,Fainman; Yeshaiahu,9999,0,9999,0
1653453041802,ECE 200,009,091011,Ford; Joseph Earl,9999,0,9999,0
1653453041802,ECE 200,010,091012,Franceschetti; Massimo,9999,0,9999,0
1653453041802,ECE 200,011,091013,Fullerton; Eric E,9999,0,9999,0
1653453041802,ECE 200,012,091014,Galton; Ian A,9999,0,9999,0
1653453041802,ECE 200,013,091015,Gilja; Vikash,9999,0,9999,0
1653453041802,ECE 200,014,091016,Hall; Drew A.,9999,0,9999,0
1653453041802,ECE 200,015,091017,Hsueh; Tzu-Chien,9999,0,9999,0
1653453041802,ECE 200,016,091018,Javidi; Tara,9999,0,9999,0
1653453041802,ECE 200,017,091019,Kahng; Andrew Byun,9999,0,9999,0
1653453041802,ECE 200,018,091020,Kim; Young-Han,9999,0,9999,0
1653453041802,ECE 200,019,091021,Koushanfar; Farinaz,9999,0,9999,0
1653453041802,ECE 200,020,091022,Kuzum; Duygu,9999,0,9999,0
1653453041802,ECE 200,021,091023,Le; Hanh-Phuc,9999,0,9999,0
1653453041802,ECE 200,022,091024,Lin; Bill,9999,0,9999,0
1653453041802,ECE 200,023,091025,Liu; Zhaowei,9999,0,9999,0
1653453041802,ECE 200,024,091026,Lo; Yu-Hwa,9999,0,9999,0
1653453041802,ECE 200,025,091027,Lomakin; Vitaliy,9999,0,9999,0
1653453041802,ECE 200,026,091028,Mercier; Patrick Philip,9999,0,9999,0
1653453041802,ECE 200,027,091029,Meyer; Florian,9999,0,9999,0
1653453041802,ECE 200,028,091030,Milstein; Laurence B.,9999,0,9999,0
1653453041802,ECE 200,029,091031,Mir Arabbaygi; Siavash,9999,0,9999,0
1653453041802,ECE 200,030,091032,Mookherjea; Shayan,9999,0,9999,0
1653453041802,ECE 200,031,091033,Morris; Karcher William,9999,0,9999,0
1653453041802,ECE 200,032,091034,Ng; Tse Nga,9999,0,9999,0
1653453041802,ECE 200,033,091035,Nguyen; Truong Quang,9999,0,9999,0
1653453041802,ECE 200,034,091036,Nomura; Kenji,9999,0,9999,0
1653453041802,ECE 200,035,091037,Orlitsky; Alon,9999,0,9999,0
1653453041802,ECE 200,036,091038,Pal; Piya,9999,0,9999,0
1653453041802,ECE 200,037,091039,Papen; George C.,9999,0,9999,0
1653453041802,ECE 200,038,091040,Radic; Stojan,9999,0,9999,0
1653453041802,ECE 200,039,091041,Rao; Bhaskar D.,9999,0,9999,0
1653453041802,ECE 200,040,091042,Rao; Ramesh R,9999,0,9999,0
1653453041802,ECE 200,041,091043,Rebeiz; Gabriel,9999,0,9999,0
1653453041802,ECE 200,042,091044,Sanford; John R,9999,0,9999,0
1653453041802,ECE 200,043,091045,Siegel; Paul H.,9999,0,9999,0
1653453041802,ECE 200,044,091046,Sievenpiper; Daniel F.,9999,0,9999,0
1653453041802,ECE 200,045,091047,Sworder; David D.,9999,0,9999,0
1653453041802,ECE 200,046,091048,Taur; Yuan,9999,0,9999,0
1653453041802,ECE 200,047,091049,Touri; Behrouz,9999,0,9999,0
1653453041802,ECE 200,048,091050,Trivedi; Mohan M.,9999,0,9999,0
1653453041802,ECE 200,049,091051,Vardy; Alexander,9999,0,9999,0
1653453041802,ECE 200,050,091052,Vasconcelos; Nuno,9999,0,9999,0
1653453041802,ECE 200,051,091053,Wang; Xiaolong,9999,0,9999,0
1653453041802,ECE 200,052,091054,Xie; Pengtao,9999,0,9999,0
1653453041802,ECE 200,053,091055,Yip; Michael,9999,0,9999,0
1653453041802,ECE 200,054,091056,Zeger; Kenneth A.,9999,0,9999,0
1653453041802,ECE 200,055,091057,Zhang; Xinyu,9999,0,9999,0
1653453041802,ECE 200,056,091058,Turakhia; Yatish Girish,9999,0,9999,0
1653453041802,ECE 200,057,091059,Kang; Mingu,9999,0,9999,0
1653453041802,ECE 200,058,091060,Shi; Yuanyuan,9999,0,9999,0
1653453041802,ECE 200,059,091061,Wang; Edward Jay,9999,0,9999,0
1653453041802,ECE 200,060,091062,Zheng; Yang,9999,0,9999,0
1653453042328,ECE 203,A00,091065,Mercier; Patrick Philip,0,0,0,0
1653453042851,ECE 207A,A00,091605,Liu; Thomas Tao-Ming,0,0,0,0
1653453043378,ECE 212AN,A00,091068,Nomura; Kenji,0,0,0,0
1653453043907,ECE 222A,A00,091069,Rebeiz; Gabriel,0,0,0,0
1653453044441,ECE 225A,A00,091070,Orlitsky; Alon,0,0,0,0
1653453044973,ECE 230A,A00,091071,Nomura; Kenji,0,0,0,0
1653453045499,ECE 236A,A00,091072,Dayeh; Shadi Ahmad,0,0,0,0
1653453046023,ECE 238A,A00,091073,Luo; Jian,0,0,0,0
1653453046023,ECE 238A,B00,091074,Luo; Jian,0,0,0,0
1653453046551,ECE 240A,A00,091075,Radic; Stojan,0,0,0,0
1653453047077,ECE 247A,A00,091592,Shi; Lingyan,0,0,0,0
1653453047622,ECE 250,A00,091076,Touri; Behrouz,0,0,0,0
1653453048154,ECE 251C,A00,091078,Nguyen; Truong Quang,0,0,0,0
1653453048684,ECE 253,A00,091079,Cosman; Pamela C.,0,0,0,0
1653453049206,ECE 255A,A00,091080,Orlitsky; Alon,0,0,0,0
1653453049742,ECE 257A,A00,091081,Zhang; Xinyu,0,0,0,0
1653453050284,ECE 260A,A01,091084,Eldon; John,0,0,0,0
1653453050807,ECE 264C,A00,091085,Galton; Ian A,0,0,0,0
1653453051331,ECE 265C,A00,094889,Presti; Calogero Davide,0,0,0,9
1653453051857,ECE 266,A01,091087,Hall; Drew A.,0,0,0,0
1653453052914,ECE 271A,A00,091090,Vasconcelos; Nuno,0,0,0,0
1653453053449,ECE 272B,A00,091091,Sworder; David D.,0,0,0,0
1653453053975,ECE 275A,A00,091092,Meyer; Florian,0,0,0,0
1653453054498,ECE 277,A00,091093,An; Cheolhong,0,0,0,0
1653453055021,ECE 283,A00,091094,Le; Hanh-Phuc,0,0,0,0
1653453055548,ECE 284,A00,091095,Kang; Mingu,0,0,0,0
1653453055548,ECE 284,B00,091096,Wang; Edward Jay,0,0,0,0
1653453056076,ECE 285,A00,094334,Touri; Behrouz,0,0,0,0
1653453056598,ECE 289,A00,091097,Whelan; David Arthur,0,0,0,0
1653453057137,MATH 200A,A00,087414,Salehi Golsefidy; Alireza,7,0,8,1
1653453057665,MATH 202A,A00,087415,Gill; Philip E.,3,0,8,5
1653453058189,MATH 203A,A00,087416,Oprea; Dragos N.,6,0,8,2
1653453058711,MATH 204A,A00,087417,Kedlaya; Kiran S.,6,0,8,2
1653453059234,MATH 205,A00,087418,Sorensen; Claus M,6,0,8,2
1653453059768,MATH 206A,A00,087419,Izadi; Elham,7,0,8,1
1653453060310,MATH 207A,A00,087420,Mohammadi; Amir,6,0,8,2
1653453060839,MATH 208,A00,087421,Staff,9,0,10,1
1653453061361,MATH 209,A00,087422,Staff,10,0,10,0
1653453061883,MATH 218,A00,087423,Staff,10,0,10,0
1653453062405,MATH 220A,A00,087424,Novak; Jonathan I,7,0,8,1
1653453062936,MATH 231A,A00,087425,Bejenaru; Ioan,3,0,8,5
1653453063485,MATH 240A,A00,087426,Ebenfelt; Peter F,5,0,8,3
1653453064021,MATH 243,A00,087427,Staff,9,0,10,1
1653453064549,MATH 248,A00,087429,Staff,10,0,10,0
1653453065073,MATH 250A,A00,087430,Spolaor; Luca,4,0,8,4
1653453065600,MATH 257A,A00,087431,Spolaor; Luca,7,0,8,1
1653453066136,MATH 258,A00,087432,Staff,9,0,10,1
1653453066669,MATH 264A,A00,087433,Warnke; Lutz Peter,5,0,8,3
1653453067194,MATH 268,A00,087434,Staff,15,0,15,0
1653453067716,MATH 269,A00,087435,Staff,14,0,15,1
1653453068239,MATH 270A,A00,087436,Nie; Jiawang,0,0,8,8
1653453068769,MATH 272A,A00,087437,Tian; Xiaochuan,1,0,8,7
1653453069292,MATH 274,A01,087439,Cheng; Li-Tien,9,0,10,1
1653453069292,MATH 274,A02,087440,Cheng; Li-Tien,10,0,10,0
1653453069822,MATH 278A,A00,087441,Staff,8,0,10,2
1653453070345,MATH 278B,A00,087442,Staff,8,0,10,2
1653453070878,MATH 278C,A00,087443,Staff,8,0,10,2
1653453071400,MATH 280A,A00,087444,Zheng; Tianyi,0,0,8,8
1653453071924,MATH 281A,A00,087445,Bradic; Jelena,0,0,8,8
1653453072447,MATH 282A,A00,087446,Zhang; Danna,0,0,8,8
1653453072970,MATH 283,A00,087447,Tesler; Glenn,0,0,0,14
1653453073502,MATH 286,A00,087448,Kemp; Todd Aahron,5,0,8,3
1653453074027,MATH 287D,A00,087449,Bradic; Jelena,8,0,8,0
1653453074548,MATH 288,A00,087450,Staff,14,0,15,1
1653453074548,MATH 288,B00,087451,Staff,15,0,15,0
1653453074548,MATH 288,C00,087452,Staff,15,0,15,0
1653453075078,MATH 290A,A00,087453,Xu; Zhouli,7,0,8,1
1653453075603,MATH 291A,A00,087454,Xu; Zhouli,7,0,8,1
1653453076126,MATH 292,A00,087455,Staff,10,0,10,0
1653453076648,MATH 295,A00,087456,Staff,50,0,50,0
1653453077170,MATH 297,001,087457,Staff,998,0,999,1
1653453639149,COGS 200,A01,087991,Staff,47,0,50,3
1653453639691,COGS 201,A01,094504,Rangel; Lara M,17,0,25,8
1653453640215,COGS 203,A00,087992,Coulson; Seana M,18,0,20,2
1653453640743,COGS 210A,001,087993,Greene; Deanna Jacquelyn,9998,0,9999,1
1653453640743,COGS 210A,002,087994,Saygin; Ayse P,9999,0,9999,0
1653453640743,COGS 210A,003,087995,Xia; Haijun,9999,0,9999,0
1653453640743,COGS 210A,004,087996,Nitz; Douglas A.,9999,0,9999,0
1653453640743,COGS 210A,005,087997,Hollan; James D.,9999,0,9999,0
1653453640743,COGS 210A,006,087998,Deak; Gedeon O.,9998,0,9999,1
1653453640743,COGS 210A,007,087999,Rossano; Federico,9999,0,9999,0
1653453641272,COGS 211A,A00,088000,Coulson; Seana M,9997,0,9999,2
1653453641813,COGS 229,A00,088002,Staff,23,0,25,2
1653453642352,COGS 260,B00,094231,Staff,17,0,20,3
1653453642352,COGS 260,A00,088004,Nitz; Douglas A.,9998,0,9999,1
1653453642875,CSE 202,A00,090110,Paturi; Ramamohan,0,0,0,0
1653453642875,CSE 202,B00,090111,Paturi; Ramamohan,0,0,0,0
1653453643424,CSE 207B,A00,090112,Heninger; Nadia A,0,0,0,0
1653453643956,CSE 208,A00,094858,Micciancio; Daniele,0,0,0,0
1653453644545,CSE 210,A00,090113,Powell; Thomas Allan,0,0,0,0
1653453645071,CSE 219,A00,090898,Staff,0,0,0,0
1653453645601,CSE 221,A00,090114,Zhou; Yuan-Yuan,0,0,0,0
1653453646123,CSE 229A,A00,090115,Porter; George M,0,0,0,0
1653453646669,CSE 229C,A00,090116,Savage; Stefan,0,0,0,0
1653453647220,CSE 230,A00,090117,Jhala; Ranjit,0,0,0,0
1653453647745,CSE 232,A00,090118,Papakonstantinou; Yannis,0,0,0,0
1653453648271,CSE 239A,A00,090121,Kumar; Arun Kumar,0,0,0,0
1653453648801,CSE 239B,A00,090122,Jhala; Ranjit,0,0,0,0
1653453649326,CSE 240A,A00,090123,Zhao; Jishen,0,0,189,189
1653453649855,CSE 243A,A00,090124,Orailoglu; Alex,1,0,15,14
1653453650381,CSE 249B,A00,090125,Kahng; Andrew Byun,13,0,20,7
1653453650907,CSE 250A,A00,090126,Berg-Kirkpatrick; Taylor D,0,0,0,0
1653453651430,CSE 252A,A00,090127,Ochoa; Benjamin Lawrence,0,0,0,0
1653453651953,CSE 258,A01,090129,McAuley; Julian John,0,0,0,0
1653453652486,CSE 258R,A01,090131,McAuley; Julian John,0,0,0,0
1653453653008,CSE 274,A00,090132,Ramamoorthi; Ravi,0,0,0,0
1653453653535,CSE 276A,A00,090133,Christensen; Henrik I,0,0,0,0
1653453654071,CSE 276C,A00,090134,Christensen; Henrik I,0,0,0,0
1653453654598,CSE 290,A00,090135,Bafna; Vineet,0,0,0,0
1653453654598,CSE 290,B00,090136,Ramamoorthi; Ravi,0,0,0,0
1653453654598,CSE 290,C00,090137,Li; Tzumao,9,0,10,1
1653453654598,CSE 290,D00,090138,Zhou; Yuan-Yuan,10,0,10,0
1653453654598,CSE 290,E00,090139,Christensen; Henrik I,10,0,10,0
1653453654598,CSE 290,F00,094053,Shalev; Aaron D,0,0,0,0
1653453655127,CSE 291,A00,090140,Munyaka; Imani N. S.,0,0,0,0
1653453655127,CSE 291,B00,094880,Yu; Qi,0,0,0,0
1653453655127,CSE 291,C00,090142,Pannuto; Patrick William,0,0,0,0
1653453655127,CSE 291,D00,094881,Zhang; Yiying,0,0,0,0
1653453655127,CSE 291,E00,095118,Su; Hao,0,0,0,0
1653453655655,CSE 293,001,094905,Bafna; Vineet,9999,0,9999,0
1653453655655,CSE 293,002,094906,Bellare; Mihir,9999,0,9999,0
1653453655655,CSE 293,003,094907,Berg-Kirkpatrick; Taylor D,9999,0,9999,0
1653453655655,CSE 293,004,094908,Christensen; Henrik I,9999,0,9999,0
1653453655655,CSE 293,005,094909,Cottrell; Garrison W,9999,0,9999,0
1653453655655,CSE 293,006,094910,Deutsch; Alin Bernard,9999,0,9999,0
1653453655655,CSE 293,007,094911,Esmaeilzadeh; Hadi,9999,0,9999,0
1653453655655,CSE 293,008,094912,Freund; Yoav,9999,0,9999,0
1653453655655,CSE 293,009,094913,Griswold; William G.,9999,0,9999,0
1653453655655,CSE 293,010,094914,Gymrek; Melissa Ann,9999,0,9999,0
1653453655655,CSE 293,011,094915,Heninger; Nadia A,9999,0,9999,0
1653453655655,CSE 293,012,094916,Impagliazzo; Russell,9999,0,9999,0
1653453655655,CSE 293,013,094917,Jhala; Ranjit,9999,0,9999,0
1653453655655,CSE 293,014,094918,Kahng; Andrew Byun,9999,0,9999,0
1653453655655,CSE 293,015,094919,Kane; Daniel Mertz,9999,0,9999,0
1653453655655,CSE 293,016,094920,Kriegman; David J,9999,0,9999,0
1653453655655,CSE 293,017,094921,Kumar; Arun Kumar,9999,0,9999,0
1653453655655,CSE 293,018,094922,Lerner; Sorin,9999,0,9999,0
1653453655655,CSE 293,019,094923,Lovett; Shachar,9999,0,9999,0
1653453655655,CSE 293,020,094924,McAuley; Julian John,9999,0,9999,0
1653453655655,CSE 293,021,094925,Micciancio; Daniele,9999,0,9999,0
1653453655655,CSE 293,022,094926,Orailoglu; Alex,9999,0,9999,0
1653453655655,CSE 293,023,094927,Paturi; Ramamohan,9999,0,9999,0
1653453655655,CSE 293,024,094928,Polikarpova; Nadezhda,9999,0,9999,0
1653453655655,CSE 293,025,094929,Politz; Joseph Gibbs,9999,0,9999,0
1653453655655,CSE 293,026,094930,Porter; George M,9999,0,9999,0
1653453655655,CSE 293,027,094931,Porter; Leonard Emerson,9999,0,9999,0
1653453655655,CSE 293,028,094932,Ramamoorthi; Ravi,9999,0,9999,0
1653453655655,CSE 293,029,094933,Sahoo; Debashis,9999,0,9999,0
1653453655655,CSE 293,030,094934,Saul; Lawrence,9999,0,9999,0
1653453655655,CSE 293,031,094935,Savage; Stefan,9999,0,9999,0
1653453655655,CSE 293,032,094936,Schulze; Jurgen P.,9999,0,9999,0
1653453655655,CSE 293,033,094937,Snoeren; Alex C.,9999,0,9999,0
1653453655655,CSE 293,034,094938,Shang; Jingbo,9999,0,9999,0
1653453655655,CSE 293,035,094939,Stefan; Deian,9999,0,9999,0
1653453655655,CSE 293,036,094940,Su; Hao,9999,0,9999,0
1653453655655,CSE 293,037,094941,Swanson; Steven James,9999,0,9999,0
1653453655655,CSE 293,038,094942,Tullsen; Dean Michael,9999,0,9999,0
1653453655655,CSE 293,039,094943,Voelker; Geoffrey M.,9999,0,9999,0
1653453655655,CSE 293,040,094944,Zhao; Jishen,9999,0,9999,0
1653453655655,CSE 293,041,094945,Zhou; Yuan-Yuan,9999,0,9999,0
1653453655655,CSE 293,042,094946,Gao; Sicun,9998,0,9999,1
1653453655655,CSE 293,043,094947,Weibel; Nadir,9999,0,9999,0
1653453655655,CSE 293,044,094948,Gupta; Rajesh K.,9999,0,9999,0
1653453656186,CSE 294,A00,090143,Porter; George M,9,0,10,1
1653453656708,DSE 200,A00,091799,Staff,50,0,50,0
1653453657237,DSE 203,A00,091800,Gupta; Amarnath,30,0,30,0
1653453657760,DSE 250,A00,091801,Deutsch; Alin Bernard,30,0,30,0
1653453658282,DSE 290,A00,091802,Altintas De Callaf; Ilkay,50,0,50,0
1653453658832,ECE 200,001,091003,Antipa; Nicholas A,9999,0,9999,0
1653453658832,ECE 200,002,091004,Atanasov; Nikolay A.,9999,0,9999,0
1653453658832,ECE 200,003,091005,Bharadia; Dinesh,9999,0,9999,0
1653453658832,ECE 200,004,091006,Cheng; Chung Kuan,9999,0,9999,0
1653453658832,ECE 200,005,091007,Cosman; Pamela C.,9999,0,9999,0
1653453658832,ECE 200,006,091008,Staff,9999,0,9999,0
1653453658832,ECE 200,007,091009,Dayeh; Shadi Ahmad,9999,0,9999,0
1653453658832,ECE 200,008,091010,Fainman; Yeshaiahu,9999,0,9999,0
1653453658832,ECE 200,009,091011,Ford; Joseph Earl,9999,0,9999,0
1653453658832,ECE 200,010,091012,Franceschetti; Massimo,9999,0,9999,0
1653453658832,ECE 200,011,091013,Fullerton; Eric E,9999,0,9999,0
1653453658832,ECE 200,012,091014,Galton; Ian A,9999,0,9999,0
1653453658832,ECE 200,013,091015,Gilja; Vikash,9999,0,9999,0
1653453658832,ECE 200,014,091016,Hall; Drew A.,9999,0,9999,0
1653453658832,ECE 200,015,091017,Hsueh; Tzu-Chien,9999,0,9999,0
1653453658832,ECE 200,016,091018,Javidi; Tara,9999,0,9999,0
1653453658832,ECE 200,017,091019,Kahng; Andrew Byun,9999,0,9999,0
1653453658832,ECE 200,018,091020,Kim; Young-Han,9999,0,9999,0
1653453658832,ECE 200,019,091021,Koushanfar; Farinaz,9999,0,9999,0
1653453658832,ECE 200,020,091022,Kuzum; Duygu,9999,0,9999,0
1653453658832,ECE 200,021,091023,Le; Hanh-Phuc,9999,0,9999,0
1653453658832,ECE 200,022,091024,Lin; Bill,9999,0,9999,0
1653453658832,ECE 200,023,091025,Liu; Zhaowei,9999,0,9999,0
1653453658832,ECE 200,024,091026,Lo; Yu-Hwa,9999,0,9999,0
1653453658832,ECE 200,025,091027,Lomakin; Vitaliy,9999,0,9999,0
1653453658832,ECE 200,026,091028,Mercier; Patrick Philip,9999,0,9999,0
1653453658832,ECE 200,027,091029,Meyer; Florian,9999,0,9999,0
1653453658832,ECE 200,028,091030,Milstein; Laurence B.,9999,0,9999,0
1653453658832,ECE 200,029,091031,Mir Arabbaygi; Siavash,9999,0,9999,0
1653453658832,ECE 200,030,091032,Mookherjea; Shayan,9999,0,9999,0
1653453658832,ECE 200,031,091033,Morris; Karcher William,9999,0,9999,0
1653453658832,ECE 200,032,091034,Ng; Tse Nga,9999,0,9999,0
1653453658832,ECE 200,033,091035,Nguyen; Truong Quang,9999,0,9999,0
1653453658832,ECE 200,034,091036,Nomura; Kenji,9999,0,9999,0
1653453658832,ECE 200,035,091037,Orlitsky; Alon,9999,0,9999,0
1653453658832,ECE 200,036,091038,Pal; Piya,9999,0,9999,0
1653453658832,ECE 200,037,091039,Papen; George C.,9999,0,9999,0
1653453658832,ECE 200,038,091040,Radic; Stojan,9999,0,9999,0
1653453658832,ECE 200,039,091041,Rao; Bhaskar D.,9999,0,9999,0
1653453658832,ECE 200,040,091042,Rao; Ramesh R,9999,0,9999,0
1653453658832,ECE 200,041,091043,Rebeiz; Gabriel,9999,0,9999,0
1653453658832,ECE 200,042,091044,Sanford; John R,9999,0,9999,0
1653453658832,ECE 200,043,091045,Siegel; Paul H.,9999,0,9999,0
1653453658832,ECE 200,044,091046,Sievenpiper; Daniel F.,9999,0,9999,0
1653453658832,ECE 200,045,091047,Sworder; David D.,9999,0,9999,0
1653453658832,ECE 200,046,091048,Taur; Yuan,9999,0,9999,0
1653453658832,ECE 200,047,091049,Touri; Behrouz,9999,0,9999,0
1653453658832,ECE 200,048,091050,Trivedi; Mohan M.,9999,0,9999,0
1653453658832,ECE 200,049,091051,Vardy; Alexander,9999,0,9999,0
1653453658832,ECE 200,050,091052,Vasconcelos; Nuno,9999,0,9999,0
1653453658832,ECE 200,051,091053,Wang; Xiaolong,9999,0,9999,0
1653453658832,ECE 200,052,091054,Xie; Pengtao,9999,0,9999,0
1653453658832,ECE 200,053,091055,Yip; Michael,9999,0,9999,0
1653453658832,ECE 200,054,091056,Zeger; Kenneth A.,9999,0,9999,0
1653453658832,ECE 200,055,091057,Zhang; Xinyu,9999,0,9999,0
1653453658832,ECE 200,056,091058,Turakhia; Yatish Girish,9999,0,9999,0
1653453658832,ECE 200,057,091059,Kang; Mingu,9999,0,9999,0
1653453658832,ECE 200,058,091060,Shi; Yuanyuan,9999,0,9999,0
1653453658832,ECE 200,059,091061,Wang; Edward Jay,9999,0,9999,0
1653453658832,ECE 200,060,091062,Zheng; Yang,9999,0,9999,0
1653453659356,ECE 203,A00,091065,Mercier; Patrick Philip,0,0,0,0
1653453659882,ECE 207A,A00,091605,Liu; Thomas Tao-Ming,0,0,0,0
1653453660408,ECE 212AN,A00,091068,Nomura; Kenji,0,0,0,0
1653453660934,ECE 222A,A00,091069,Rebeiz; Gabriel,0,0,0,0
1653453661462,ECE 225A,A00,091070,Orlitsky; Alon,0,0,0,0
1653453661997,ECE 230A,A00,091071,Nomura; Kenji,0,0,0,0
1653453662526,ECE 236A,A00,091072,Dayeh; Shadi Ahmad,0,0,0,0
1653453663064,ECE 238A,A00,091073,Luo; Jian,0,0,0,0
1653453663064,ECE 238A,B00,091074,Luo; Jian,0,0,0,0
1653453663627,ECE 240A,A00,091075,Radic; Stojan,0,0,0,0
1653453664148,ECE 247A,A00,091592,Shi; Lingyan,0,0,0,0
1653453664670,ECE 250,A00,091076,Touri; Behrouz,0,0,0,0
1653453665192,ECE 251C,A00,091078,Nguyen; Truong Quang,0,0,0,0
1653453665716,ECE 253,A00,091079,Cosman; Pamela C.,0,0,0,0
1653453666247,ECE 255A,A00,091080,Orlitsky; Alon,0,0,0,0
1653453666777,ECE 257A,A00,091081,Zhang; Xinyu,0,0,0,0
1653453667300,ECE 260A,A01,091084,Eldon; John,0,0,0,0
1653453667824,ECE 264C,A00,091085,Galton; Ian A,0,0,0,0
1653453668349,ECE 265C,A00,094889,Presti; Calogero Davide,0,0,0,9
1653453668880,ECE 266,A01,091087,Hall; Drew A.,0,0,0,0
1653453669930,ECE 271A,A00,091090,Vasconcelos; Nuno,0,0,0,0
1653453670454,ECE 272B,A00,091091,Sworder; David D.,0,0,0,0
1653453670977,ECE 275A,A00,091092,Meyer; Florian,0,0,0,0
1653453671503,ECE 277,A00,091093,An; Cheolhong,0,0,0,0
1653453672030,ECE 283,A00,091094,Le; Hanh-Phuc,0,0,0,0
1653453672563,ECE 284,A00,091095,Kang; Mingu,0,0,0,0
1653453672563,ECE 284,B00,091096,Wang; Edward Jay,0,0,0,0
1653453673086,ECE 285,A00,094334,Touri; Behrouz,0,0,0,0
1653453673622,ECE 289,A00,091097,Whelan; David Arthur,0,0,0,0
1653453674160,MATH 200A,A00,087414,Salehi Golsefidy; Alireza,7,0,8,1
1653453674691,MATH 202A,A00,087415,Gill; Philip E.,3,0,8,5
1653453675222,MATH 203A,A00,087416,Oprea; Dragos N.,6,0,8,2
1653453675748,MATH 204A,A00,087417,Kedlaya; Kiran S.,6,0,8,2
1653453676281,MATH 205,A00,087418,Sorensen; Claus M,6,0,8,2
1653453676803,MATH 206A,A00,087419,Izadi; Elham,7,0,8,1
1653453677336,MATH 207A,A00,087420,Mohammadi; Amir,6,0,8,2
1653453677859,MATH 208,A00,087421,Staff,9,0,10,1
1653453678442,MATH 209,A00,087422,Staff,10,0,10,0
1653453678966,MATH 218,A00,087423,Staff,10,0,10,0
1653453679488,MATH 220A,A00,087424,Novak; Jonathan I,7,0,8,1
1653453680061,MATH 231A,A00,087425,Bejenaru; Ioan,3,0,8,5
1653453680588,MATH 240A,A00,087426,Ebenfelt; Peter F,5,0,8,3
1653453681113,MATH 243,A00,087427,Staff,9,0,10,1
1653453681639,MATH 248,A00,087429,Staff,10,0,10,0
1653453682165,MATH 250A,A00,087430,Spolaor; Luca,4,0,8,4
1653453682688,MATH 257A,A00,087431,Spolaor; Luca,7,0,8,1
1653453683219,MATH 258,A00,087432,Staff,9,0,10,1
1653453683742,MATH 264A,A00,087433,Warnke; Lutz Peter,5,0,8,3
1653453684339,MATH 268,A00,087434,Staff,15,0,15,0
1653453684865,MATH 269,A00,087435,Staff,14,0,15,1
1653453685388,MATH 270A,A00,087436,Nie; Jiawang,0,0,8,8
1653453685917,MATH 272A,A00,087437,Tian; Xiaochuan,1,0,8,7
1653453686442,MATH 274,A01,087439,Cheng; Li-Tien,9,0,10,1
1653453686442,MATH 274,A02,087440,Cheng; Li-Tien,10,0,10,0
1653453686968,MATH 278A,A00,087441,Staff,8,0,10,2
1653453687491,MATH 278B,A00,087442,Staff,8,0,10,2
1653453688017,MATH 278C,A00,087443,Staff,8,0,10,2
1653453688539,MATH 280A,A00,087444,Zheng; Tianyi,0,0,8,8
1653453689061,MATH 281A,A00,087445,Bradic; Jelena,0,0,8,8
1653453689583,MATH 282A,A00,087446,Zhang; Danna,0,0,8,8
1653453690110,MATH 283,A00,087447,Tesler; Glenn,0,0,0,14
1653453690636,MATH 286,A00,087448,Kemp; Todd Aahron,5,0,8,3
1653453691164,MATH 287D,A00,087449,Bradic; Jelena,8,0,8,0
1653453691685,MATH 288,A00,087450,Staff,14,0,15,1
1653453691685,MATH 288,B00,087451,Staff,15,0,15,0
1653453691685,MATH 288,C00,087452,Staff,15,0,15,0
1653453692211,MATH 290A,A00,087453,Xu; Zhouli,7,0,8,1
1653453692735,MATH 291A,A00,087454,Xu; Zhouli,7,0,8,1
1653453693260,MATH 292,A00,087455,Staff,10,0,10,0
1653453693786,MATH 295,A00,087456,Staff,50,0,50,0
1653453694311,MATH 297,001,087457,Staff,998,0,999,1
1653454254764,COGS 200,A01,087991,Staff,47,0,50,3
1653454255290,COGS 201,A01,094504,Rangel; Lara M,17,0,25,8
1653454255817,COGS 203,A00,087992,Coulson; Seana M,18,0,20,2
1653454256346,COGS 210A,001,087993,Greene; Deanna Jacquelyn,9998,0,9999,1
1653454256346,COGS 210A,002,087994,Saygin; Ayse P,9999,0,9999,0
1653454256346,COGS 210A,003,087995,Xia; Haijun,9999,0,9999,0
1653454256346,COGS 210A,004,087996,Nitz; Douglas A.,9999,0,9999,0
1653454256346,COGS 210A,005,087997,Hollan; James D.,9999,0,9999,0
1653454256346,COGS 210A,006,087998,Deak; Gedeon O.,9998,0,9999,1
1653454256346,COGS 210A,007,087999,Rossano; Federico,9999,0,9999,0
1653454256871,COGS 211A,A00,088000,Coulson; Seana M,9997,0,9999,2
1653454257395,COGS 229,A00,088002,Staff,23,0,25,2
1653454257920,COGS 260,B00,094231,Staff,17,0,20,3
1653454257920,COGS 260,A00,088004,Nitz; Douglas A.,9998,0,9999,1
1653454258450,CSE 202,A00,090110,Paturi; Ramamohan,0,0,0,0
1653454258450,CSE 202,B00,090111,Paturi; Ramamohan,0,0,0,0
1653454258972,CSE 207B,A00,090112,Heninger; Nadia A,0,0,0,0
1653454259497,CSE 208,A00,094858,Micciancio; Daniele,0,0,0,0
1653454260022,CSE 210,A00,090113,Powell; Thomas Allan,0,0,0,0
1653454260546,CSE 219,A00,090898,Staff,0,0,0,0
1653454261070,CSE 221,A00,090114,Zhou; Yuan-Yuan,0,0,0,0
1653454261604,CSE 229A,A00,090115,Porter; George M,0,0,0,0
1653454262131,CSE 229C,A00,090116,Savage; Stefan,0,0,0,0
1653454262654,CSE 230,A00,090117,Jhala; Ranjit,0,0,0,0
1653454263187,CSE 232,A00,090118,Papakonstantinou; Yannis,0,0,0,0
1653454263709,CSE 239A,A00,090121,Kumar; Arun Kumar,0,0,0,0
1653454264238,CSE 239B,A00,090122,Jhala; Ranjit,0,0,0,0
1653454264761,CSE 240A,A00,090123,Zhao; Jishen,0,0,189,189
1653454265295,CSE 243A,A00,090124,Orailoglu; Alex,1,0,15,14
1653454265819,CSE 249B,A00,090125,Kahng; Andrew Byun,13,0,20,7
1653454266357,CSE 250A,A00,090126,Berg-Kirkpatrick; Taylor D,0,0,0,0
1653454266879,CSE 252A,A00,090127,Ochoa; Benjamin Lawrence,0,0,0,0
1653454267410,CSE 258,A01,090129,McAuley; Julian John,0,0,0,0
1653454267933,CSE 258R,A01,090131,McAuley; Julian John,0,0,0,0
1653454268479,CSE 274,A00,090132,Ramamoorthi; Ravi,0,0,0,0
1653454269007,CSE 276A,A00,090133,Christensen; Henrik I,0,0,0,0
1653454269543,CSE 276C,A00,090134,Christensen; Henrik I,0,0,0,0
1653454270067,CSE 290,A00,090135,Bafna; Vineet,0,0,0,0
1653454270067,CSE 290,B00,090136,Ramamoorthi; Ravi,0,0,0,0
1653454270067,CSE 290,C00,090137,Li; Tzumao,9,0,10,1
1653454270067,CSE 290,D00,090138,Zhou; Yuan-Yuan,10,0,10,0
1653454270067,CSE 290,E00,090139,Christensen; Henrik I,10,0,10,0
1653454270067,CSE 290,F00,094053,Shalev; Aaron D,0,0,0,0
1653454270595,CSE 291,A00,090140,Munyaka; Imani N. S.,0,0,0,0
1653454270595,CSE 291,B00,094880,Yu; Qi,0,0,0,0
1653454270595,CSE 291,C00,090142,Pannuto; Patrick William,0,0,0,0
1653454270595,CSE 291,D00,094881,Zhang; Yiying,0,0,0,0
1653454270595,CSE 291,E00,095118,Su; Hao,0,0,0,0
1653454271130,CSE 293,001,094905,Bafna; Vineet,9999,0,9999,0
1653454271130,CSE 293,002,094906,Bellare; Mihir,9999,0,9999,0
1653454271130,CSE 293,003,094907,Berg-Kirkpatrick; Taylor D,9999,0,9999,0
1653454271130,CSE 293,004,094908,Christensen; Henrik I,9999,0,9999,0
1653454271130,CSE 293,005,094909,Cottrell; Garrison W,9999,0,9999,0
1653454271130,CSE 293,006,094910,Deutsch; Alin Bernard,9999,0,9999,0
1653454271130,CSE 293,007,094911,Esmaeilzadeh; Hadi,9999,0,9999,0
1653454271130,CSE 293,008,094912,Freund; Yoav,9999,0,9999,0
1653454271130,CSE 293,009,094913,Griswold; William G.,9999,0,9999,0
1653454271130,CSE 293,010,094914,Gymrek; Melissa Ann,9999,0,9999,0
1653454271130,CSE 293,011,094915,Heninger; Nadia A,9999,0,9999,0
1653454271130,CSE 293,012,094916,Impagliazzo; Russell,9999,0,9999,0
1653454271130,CSE 293,013,094917,Jhala; Ranjit,9999,0,9999,0
1653454271130,CSE 293,014,094918,Kahng; Andrew Byun,9999,0,9999,0
1653454271130,CSE 293,015,094919,Kane; Daniel Mertz,9999,0,9999,0
1653454271130,CSE 293,016,094920,Kriegman; David J,9999,0,9999,0
1653454271130,CSE 293,017,094921,Kumar; Arun Kumar,9999,0,9999,0
1653454271130,CSE 293,018,094922,Lerner; Sorin,9999,0,9999,0
1653454271130,CSE 293,019,094923,Lovett; Shachar,9999,0,9999,0
1653454271130,CSE 293,020,094924,McAuley; Julian John,9999,0,9999,0
1653454271130,CSE 293,021,094925,Micciancio; Daniele,9999,0,9999,0
1653454271130,CSE 293,022,094926,Orailoglu; Alex,9999,0,9999,0
1653454271130,CSE 293,023,094927,Paturi; Ramamohan,9999,0,9999,0
1653454271130,CSE 293,024,094928,Polikarpova; Nadezhda,9999,0,9999,0
1653454271130,CSE 293,025,094929,Politz; Joseph Gibbs,9999,0,9999,0
1653454271130,CSE 293,026,094930,Porter; George M,9999,0,9999,0
1653454271130,CSE 293,027,094931,Porter; Leonard Emerson,9999,0,9999,0
1653454271130,CSE 293,028,094932,Ramamoorthi; Ravi,9999,0,9999,0
1653454271130,CSE 293,029,094933,Sahoo; Debashis,9999,0,9999,0
1653454271130,CSE 293,030,094934,Saul; Lawrence,9999,0,9999,0
1653454271130,CSE 293,031,094935,Savage; Stefan,9999,0,9999,0
1653454271130,CSE 293,032,094936,Schulze; Jurgen P.,9999,0,9999,0
1653454271130,CSE 293,033,094937,Snoeren; Alex C.,9999,0,9999,0
1653454271130,CSE 293,034,094938,Shang; Jingbo,9999,0,9999,0
1653454271130,CSE 293,035,094939,Stefan; Deian,9999,0,9999,0
1653454271130,CSE 293,036,094940,Su; Hao,9999,0,9999,0
1653454271130,CSE 293,037,094941,Swanson; Steven James,9999,0,9999,0
1653454271130,CSE 293,038,094942,Tullsen; Dean Michael,9999,0,9999,0
1653454271130,CSE 293,039,094943,Voelker; Geoffrey M.,9999,0,9999,0
1653454271130,CSE 293,040,094944,Zhao; Jishen,9999,0,9999,0
1653454271130,CSE 293,041,094945,Zhou; Yuan-Yuan,9999,0,9999,0
1653454271130,CSE 293,042,094946,Gao; Sicun,9998,0,9999,1
1653454271130,CSE 293,043,094947,Weibel; Nadir,9999,0,9999,0
1653454271130,CSE 293,044,094948,Gupta; Rajesh K.,9999,0,9999,0
1653454271652,CSE 294,A00,090143,Porter; George M,9,0,10,1
1653454272270,DSE 200,A00,091799,Staff,50,0,50,0
1653454272796,DSE 203,A00,091800,Gupta; Amarnath,30,0,30,0
1653454273330,DSE 250,A00,091801,Deutsch; Alin Bernard,30,0,30,0
1653454273857,DSE 290,A00,091802,Altintas De Callaf; Ilkay,50,0,50,0
1653454274401,ECE 200,001,091003,Antipa; Nicholas A,9999,0,9999,0
1653454274401,ECE 200,002,091004,Atanasov; Nikolay A.,9999,0,9999,0
1653454274401,ECE 200,003,091005,Bharadia; Dinesh,9999,0,9999,0
1653454274401,ECE 200,004,091006,Cheng; Chung Kuan,9999,0,9999,0
1653454274401,ECE 200,005,091007,Cosman; Pamela C.,9999,0,9999,0
1653454274401,ECE 200,006,091008,Staff,9999,0,9999,0
1653454274401,ECE 200,007,091009,Dayeh; Shadi Ahmad,9999,0,9999,0
1653454274401,ECE 200,008,091010,Fainman; Yeshaiahu,9999,0,9999,0
1653454274401,ECE 200,009,091011,Ford; Joseph Earl,9999,0,9999,0
1653454274401,ECE 200,010,091012,Franceschetti; Massimo,9999,0,9999,0
1653454274401,ECE 200,011,091013,Fullerton; Eric E,9999,0,9999,0
1653454274401,ECE 200,012,091014,Galton; Ian A,9999,0,9999,0
1653454274401,ECE 200,013,091015,Gilja; Vikash,9999,0,9999,0
1653454274401,ECE 200,014,091016,Hall; Drew A.,9999,0,9999,0
1653454274401,ECE 200,015,091017,Hsueh; Tzu-Chien,9999,0,9999,0
1653454274401,ECE 200,016,091018,Javidi; Tara,9999,0,9999,0
1653454274401,ECE 200,017,091019,Kahng; Andrew Byun,9999,0,9999,0
1653454274401,ECE 200,018,091020,Kim; Young-Han,9999,0,9999,0
1653454274401,ECE 200,019,091021,Koushanfar; Farinaz,9999,0,9999,0
1653454274401,ECE 200,020,091022,Kuzum; Duygu,9999,0,9999,0
1653454274401,ECE 200,021,091023,Le; Hanh-Phuc,9999,0,9999,0
1653454274401,ECE 200,022,091024,Lin; Bill,9999,0,9999,0
1653454274401,ECE 200,023,091025,Liu; Zhaowei,9999,0,9999,0
1653454274401,ECE 200,024,091026,Lo; Yu-Hwa,9999,0,9999,0
1653454274401,ECE 200,025,091027,Lomakin; Vitaliy,9999,0,9999,0
1653454274401,ECE 200,026,091028,Mercier; Patrick Philip,9999,0,9999,0
1653454274401,ECE 200,027,091029,Meyer; Florian,9999,0,9999,0
1653454274401,ECE 200,028,091030,Milstein; Laurence B.,9999,0,9999,0
1653454274401,ECE 200,029,091031,Mir Arabbaygi; Siavash,9999,0,9999,0
1653454274401,ECE 200,030,091032,Mookherjea; Shayan,9999,0,9999,0
1653454274401,ECE 200,031,091033,Morris; Karcher William,9999,0,9999,0
1653454274401,ECE 200,032,091034,Ng; Tse Nga,9999,0,9999,0
1653454274401,ECE 200,033,091035,Nguyen; Truong Quang,9999,0,9999,0
1653454274401,ECE 200,034,091036,Nomura; Kenji,9999,0,9999,0
1653454274401,ECE 200,035,091037,Orlitsky; Alon,9999,0,9999,0
1653454274401,ECE 200,036,091038,Pal; Piya,9999,0,9999,0
1653454274401,ECE 200,037,091039,Papen; George C.,9999,0,9999,0
1653454274401,ECE 200,038,091040,Radic; Stojan,9999,0,9999,0
1653454274401,ECE 200,039,091041,Rao; Bhaskar D.,9999,0,9999,0
1653454274401,ECE 200,040,091042,Rao; Ramesh R,9999,0,9999,0
1653454274401,ECE 200,041,091043,Rebeiz; Gabriel,9999,0,9999,0
1653454274401,ECE 200,042,091044,Sanford; John R,9999,0,9999,0
1653454274401,ECE 200,043,091045,Siegel; Paul H.,9999,0,9999,0
1653454274401,ECE 200,044,091046,Sievenpiper; Daniel F.,9999,0,9999,0
1653454274401,ECE 200,045,091047,Sworder; David D.,9999,0,9999,0
1653454274401,ECE 200,046,091048,Taur; Yuan,9999,0,9999,0
1653454274401,ECE 200,047,091049,Touri; Behrouz,9999,0,9999,0
1653454274401,ECE 200,048,091050,Trivedi; Mohan M.,9999,0,9999,0
1653454274401,ECE 200,049,091051,Vardy; Alexander,9999,0,9999,0
1653454274401,ECE 200,050,091052,Vasconcelos; Nuno,9999,0,9999,0
1653454274401,ECE 200,051,091053,Wang; Xiaolong,9999,0,9999,0
1653454274401,ECE 200,052,091054,Xie; Pengtao,9999,0,9999,0
1653454274401,ECE 200,053,091055,Yip; Michael,9999,0,9999,0
1653454274401,ECE 200,054,091056,Zeger; Kenneth A.,9999,0,9999,0
1653454274401,ECE 200,055,091057,Zhang; Xinyu,9999,0,9999,0
1653454274401,ECE 200,056,091058,Turakhia; Yatish Girish,9999,0,9999,0
1653454274401,ECE 200,057,091059,Kang; Mingu,9999,0,9999,0
1653454274401,ECE 200,058,091060,Shi; Yuanyuan,9999,0,9999,0
1653454274401,ECE 200,059,091061,Wang; Edward Jay,9999,0,9999,0
1653454274401,ECE 200,060,091062,Zheng; Yang,9999,0,9999,0
1653454274924,ECE 203,A00,091065,Mercier; Patrick Philip,0,0,0,0
1653454275447,ECE 207A,A00,091605,Liu; Thomas Tao-Ming,0,0,0,0
1653454275975,ECE 212AN,A00,091068,Nomura; Kenji,0,0,0,0
1653454276500,ECE 222A,A00,091069,Rebeiz; Gabriel,0,0,0,0
1653454277025,ECE 225A,A00,091070,Orlitsky; Alon,0,0,0,0
1653454277549,ECE 230A,A00,091071,Nomura; Kenji,0,0,0,0
1653454278072,ECE 236A,A00,091072,Dayeh; Shadi Ahmad,0,0,0,0
1653454278597,ECE 238A,A00,091073,Luo; Jian,0,0,0,0
1653454278597,ECE 238A,B00,091074,Luo; Jian,0,0,0,0
1653454279124,ECE 240A,A00,091075,Radic; Stojan,0,0,0,0
1653454279653,ECE 247A,A00,091592,Shi; Lingyan,0,0,0,0
1653454280180,ECE 250,A00,091076,Touri; Behrouz,0,0,0,0
1653454280703,ECE 251C,A00,091078,Nguyen; Truong Quang,0,0,0,0
1653454281229,ECE 253,A00,091079,Cosman; Pamela C.,0,0,0,0
1653454281756,ECE 255A,A00,091080,Orlitsky; Alon,0,0,0,0
1653454282280,ECE 257A,A00,091081,Zhang; Xinyu,0,0,0,0
1653454282819,ECE 260A,A01,091084,Eldon; John,0,0,0,0
1653454283345,ECE 264C,A00,091085,Galton; Ian A,0,0,0,0
1653454283871,ECE 265C,A00,094889,Presti; Calogero Davide,0,0,0,9
1653454284398,ECE 266,A01,091087,Hall; Drew A.,0,0,0,0
1653454285450,ECE 271A,A00,091090,Vasconcelos; Nuno,0,0,0,0
1653454285973,ECE 272B,A00,091091,Sworder; David D.,0,0,0,0
1653454286497,ECE 275A,A00,091092,Meyer; Florian,0,0,0,0
1653454287018,ECE 277,A00,091093,An; Cheolhong,0,0,0,0
1653454287550,ECE 283,A00,091094,Le; Hanh-Phuc,0,0,0,0
1653454288072,ECE 284,A00,091095,Kang; Mingu,0,0,0,0
1653454288072,ECE 284,B00,091096,Wang; Edward Jay,0,0,0,0
1653454288598,ECE 285,A00,094334,Touri; Behrouz,0,0,0,0
1653454289121,ECE 289,A00,091097,Whelan; David Arthur,0,0,0,0
1653454289644,MATH 200A,A00,087414,Salehi Golsefidy; Alireza,7,0,8,1
1653454290260,MATH 202A,A00,087415,Gill; Philip E.,3,0,8,5
1653454290784,MATH 203A,A00,087416,Oprea; Dragos N.,6,0,8,2
1653454291308,MATH 204A,A00,087417,Kedlaya; Kiran S.,6,0,8,2
1653454291829,MATH 205,A00,087418,Sorensen; Claus M,6,0,8,2
1653454292357,MATH 206A,A00,087419,Izadi; Elham,7,0,8,1
1653454292885,MATH 207A,A00,087420,Mohammadi; Amir,6,0,8,2
1653454293411,MATH 208,A00,087421,Staff,9,0,10,1
1653454293934,MATH 209,A00,087422,Staff,10,0,10,0
1653454294457,MATH 218,A00,087423,Staff,10,0,10,0
1653454294983,MATH 220A,A00,087424,Novak; Jonathan I,7,0,8,1
1653454295511,MATH 231A,A00,087425,Bejenaru; Ioan,3,0,8,5
1653454296036,MATH 240A,A00,087426,Ebenfelt; Peter F,5,0,8,3
1653454296558,MATH 243,A00,087427,Staff,9,0,10,1
1653454297087,MATH 248,A00,087429,Staff,10,0,10,0
1653454297612,MATH 250A,A00,087430,Spolaor; Luca,4,0,8,4
1653454298140,MATH 257A,A00,087431,Spolaor; Luca,7,0,8,1
1653454298664,MATH 258,A00,087432,Staff,9,0,10,1
1653454299186,MATH 264A,A00,087433,Warnke; Lutz Peter,5,0,8,3
1653454299708,MATH 268,A00,087434,Staff,15,0,15,0
1653454300237,MATH 269,A00,087435,Staff,14,0,15,1
1653454300761,MATH 270A,A00,087436,Nie; Jiawang,0,0,8,8
1653454301292,MATH 272A,A00,087437,Tian; Xiaochuan,1,0,8,7
1653454301816,MATH 274,A01,087439,Cheng; Li-Tien,9,0,10,1
1653454301816,MATH 274,A02,087440,Cheng; Li-Tien,10,0,10,0
1653454302339,MATH 278A,A00,087441,Staff,8,0,10,2
1653454302864,MATH 278B,A00,087442,Staff,8,0,10,2
1653454303400,MATH 278C,A00,087443,Staff,8,0,10,2
1653454303923,MATH 280A,A00,087444,Zheng; Tianyi,0,0,8,8
1653454304446,MATH 281A,A00,087445,Bradic; Jelena,0,0,8,8
1653454304969,MATH 282A,A00,087446,Zhang; Danna,0,0,8,8
1653454305490,MATH 283,A00,087447,Tesler; Glenn,0,0,0,14
1653454306018,MATH 286,A00,087448,Kemp; Todd Aahron,5,0,8,3
1653454306541,MATH 287D,A00,087449,Bradic; Jelena,8,0,8,0
1653454307071,MATH 288,A00,087450,Staff,14,0,15,1
1653454307071,MATH 288,B00,087451,Staff,15,0,15,0
1653454307071,MATH 288,C00,087452,Staff,15,0,15,0
1653454307597,MATH 290A,A00,087453,Xu; Zhouli,7,0,8,1
1653454308122,MATH 291A,A00,087454,Xu; Zhouli,7,0,8,1
1653454308645,MATH 292,A00,087455,Staff,10,0,10,0
1653454309176,MATH 295,A00,087456,Staff,50,0,50,0
1653454309698,MATH 297,001,087457,Staff,998,0,999,1
1653454869111,COGS 200,A01,087991,Staff,47,0,50,3
1653454869633,COGS 201,A01,094504,Rangel; Lara M,17,0,25,8
1653454870159,COGS 203,A00,087992,Coulson; Seana M,18,0,20,2
1653454870684,COGS 210A,001,087993,Greene; Deanna Jacquelyn,9998,0,9999,1
1653454870684,COGS 210A,002,087994,Saygin; Ayse P,9999,0,9999,0
1653454870684,COGS 210A,003,087995,Xia; Haijun,9999,0,9999,0
1653454870684,COGS 210A,004,087996,Nitz; Douglas A.,9999,0,9999,0
1653454870684,COGS 210A,005,087997,Hollan; James D.,9999,0,9999,0
1653454870684,COGS 210A,006,087998,Deak; Gedeon O.,9998,0,9999,1
1653454870684,COGS 210A,007,087999,Rossano; Federico,9999,0,9999,0
1653454871206,COGS 211A,A00,088000,Coulson; Seana M,9997,0,9999,2
1653454871728,COGS 229,A00,088002,Staff,23,0,25,2
1653454872254,COGS 260,B00,094231,Staff,17,0,20,3
1653454872254,COGS 260,A00,088004,Nitz; Douglas A.,9998,0,9999,1
1653454872784,CSE 202,A00,090110,Paturi; Ramamohan,0,0,0,0
1653454872784,CSE 202,B00,090111,Paturi; Ramamohan,0,0,0,0
1653454873306,CSE 207B,A00,090112,Heninger; Nadia A,0,0,0,0
1653454873835,CSE 208,A00,094858,Micciancio; Daniele,0,0,0,0
1653454874359,CSE 210,A00,090113,Powell; Thomas Allan,0,0,0,0
1653454874884,CSE 219,A00,090898,Staff,0,0,0,0
1653454875411,CSE 221,A00,090114,Zhou; Yuan-Yuan,0,0,0,0
1653454875934,CSE 229A,A00,090115,Porter; George M,0,0,0,0
1653454876456,CSE 229C,A00,090116,Savage; Stefan,0,0,0,0
1653454876983,CSE 230,A00,090117,Jhala; Ranjit,0,0,0,0
1653454877508,CSE 232,A00,090118,Papakonstantinou; Yannis,0,0,0,0
1653454878033,CSE 239A,A00,090121,Kumar; Arun Kumar,0,0,0,0
1653454878564,CSE 239B,A00,090122,Jhala; Ranjit,0,0,0,0
1653454879087,CSE 240A,A00,090123,Zhao; Jishen,0,0,189,189
1653454879624,CSE 243A,A00,090124,Orailoglu; Alex,1,0,15,14
1653454880147,CSE 249B,A00,090125,Kahng; Andrew Byun,13,0,20,7
1653454880673,CSE 250A,A00,090126,Berg-Kirkpatrick; Taylor D,0,0,0,0
1653454881214,CSE 252A,A00,090127,Ochoa; Benjamin Lawrence,0,0,0,0
1653454881745,CSE 258,A01,090129,McAuley; Julian John,0,0,0,0
1653454882268,CSE 258R,A01,090131,McAuley; Julian John,0,0,0,0
1653454882790,CSE 274,A00,090132,Ramamoorthi; Ravi,0,0,0,0
1653454883313,CSE 276A,A00,090133,Christensen; Henrik I,0,0,0,0
1653454883847,CSE 276C,A00,090134,Christensen; Henrik I,0,0,0,0
1653454884370,CSE 290,A00,090135,Bafna; Vineet,0,0,0,0
1653454884370,CSE 290,B00,090136,Ramamoorthi; Ravi,0,0,0,0
1653454884370,CSE 290,C00,090137,Li; Tzumao,9,0,10,1
1653454884370,CSE 290,D00,090138,Zhou; Yuan-Yuan,10,0,10,0
1653454884370,CSE 290,E00,090139,Christensen; Henrik I,10,0,10,0
1653454884370,CSE 290,F00,094053,Shalev; Aaron D,0,0,0,0
1653454884896,CSE 291,A00,090140,Munyaka; Imani N. S.,0,0,0,0
1653454884896,CSE 291,B00,094880,Yu; Qi,0,0,0,0
1653454884896,CSE 291,C00,090142,Pannuto; Patrick William,0,0,0,0
1653454884896,CSE 291,D00,094881,Zhang; Yiying,0,0,0,0
1653454884896,CSE 291,E00,095118,Su; Hao,0,0,0,0
1653454885433,CSE 293,001,094905,Bafna; Vineet,9999,0,9999,0
1653454885433,CSE 293,002,094906,Bellare; Mihir,9999,0,9999,0
1653454885433,CSE 293,003,094907,Berg-Kirkpatrick; Taylor D,9999,0,9999,0
1653454885433,CSE 293,004,094908,Christensen; Henrik I,9999,0,9999,0
1653454885433,CSE 293,005,094909,Cottrell; Garrison W,9999,0,9999,0
1653454885433,CSE 293,006,094910,Deutsch; Alin Bernard,9999,0,9999,0
1653454885433,CSE 293,007,094911,Esmaeilzadeh; Hadi,9999,0,9999,0
1653454885433,CSE 293,008,094912,Freund; Yoav,9999,0,9999,0
1653454885433,CSE 293,009,094913,Griswold; William G.,9999,0,9999,0
1653454885433,CSE 293,010,094914,Gymrek; Melissa Ann,9999,0,9999,0
1653454885433,CSE 293,011,094915,Heninger; Nadia A,9999,0,9999,0
1653454885433,CSE 293,012,094916,Impagliazzo; Russell,9999,0,9999,0
1653454885433,CSE 293,013,094917,Jhala; Ranjit,9999,0,9999,0
1653454885433,CSE 293,014,094918,Kahng; Andrew Byun,9999,0,9999,0
1653454885433,CSE 293,015,094919,Kane; Daniel Mertz,9999,0,9999,0
1653454885433,CSE 293,016,094920,Kriegman; David J,9999,0,9999,0
1653454885433,CSE 293,017,094921,Kumar; Arun Kumar,9999,0,9999,0
1653454885433,CSE 293,018,094922,Lerner; Sorin,9999,0,9999,0
1653454885433,CSE 293,019,094923,Lovett; Shachar,9999,0,9999,0
1653454885433,CSE 293,020,094924,McAuley; Julian John,9999,0,9999,0
1653454885433,CSE 293,021,094925,Micciancio; Daniele,9999,0,9999,0
1653454885433,CSE 293,022,094926,Orailoglu; Alex,9999,0,9999,0
1653454885433,CSE 293,023,094927,Paturi; Ramamohan,9999,0,9999,0
1653454885433,CSE 293,024,094928,Polikarpova; Nadezhda,9999,0,9999,0
1653454885433,CSE 293,025,094929,Politz; Joseph Gibbs,9999,0,9999,0
1653454885433,CSE 293,026,094930,Porter; George M,9999,0,9999,0
1653454885433,CSE 293,027,094931,Porter; Leonard Emerson,9999,0,9999,0
1653454885433,CSE 293,028,094932,Ramamoorthi; Ravi,9999,0,9999,0
1653454885433,CSE 293,029,094933,Sahoo; Debashis,9999,0,9999,0
1653454885433,CSE 293,030,094934,Saul; Lawrence,9999,0,9999,0
1653454885433,CSE 293,031,094935,Savage; Stefan,9999,0,9999,0
1653454885433,CSE 293,032,094936,Schulze; Jurgen P.,9999,0,9999,0
1653454885433,CSE 293,033,094937,Snoeren; Alex C.,9999,0,9999,0
1653454885433,CSE 293,034,094938,Shang; Jingbo,9999,0,9999,0
1653454885433,CSE 293,035,094939,Stefan; Deian,9999,0,9999,0
1653454885433,CSE 293,036,094940,Su; Hao,9999,0,9999,0
1653454885433,CSE 293,037,094941,Swanson; Steven James,9999,0,9999,0
1653454885433,CSE 293,038,094942,Tullsen; Dean Michael,9999,0,9999,0
1653454885433,CSE 293,039,094943,Voelker; Geoffrey M.,9999,0,9999,0
1653454885433,CSE 293,040,094944,Zhao; Jishen,9999,0,9999,0
1653454885433,CSE 293,041,094945,Zhou; Yuan-Yuan,9999,0,9999,0
1653454885433,CSE 293,042,094946,Gao; Sicun,9998,0,9999,1
1653454885433,CSE 293,043,094947,Weibel; Nadir,9999,0,9999,0
1653454885433,CSE 293,044,094948,Gupta; Rajesh K.,9999,0,9999,0
1653454885958,CSE 294,A00,090143,Porter; George M,9,0,10,1
1653454886479,DSE 200,A00,091799,Staff,50,0,50,0
1653454887002,DSE 203,A00,091800,Gupta; Amarnath,30,0,30,0
1653454887525,DSE 250,A00,091801,Deutsch; Alin Bernard,30,0,30,0
1653454888050,DSE 290,A00,091802,Altintas De Callaf; Ilkay,50,0,50,0
1653454888597,ECE 200,001,091003,Antipa; Nicholas A,9999,0,9999,0
1653454888597,ECE 200,002,091004,Atanasov; Nikolay A.,9999,0,9999,0
1653454888597,ECE 200,003,091005,Bharadia; Dinesh,9999,0,9999,0
1653454888597,ECE 200,004,091006,Cheng; Chung Kuan,9999,0,9999,0
1653454888597,ECE 200,005,091007,Cosman; Pamela C.,9999,0,9999,0
1653454888597,ECE 200,006,091008,Staff,9999,0,9999,0
1653454888597,ECE 200,007,091009,Dayeh; Shadi Ahmad,9999,0,9999,0
1653454888597,ECE 200,008,091010,Fainman; Yeshaiahu,9999,0,9999,0
1653454888597,ECE 200,009,091011,Ford; Joseph Earl,9999,0,9999,0
1653454888597,ECE 200,010,091012,Franceschetti; Massimo,9999,0,9999,0
1653454888597,ECE 200,011,091013,Fullerton; Eric E,9999,0,9999,0
1653454888597,ECE 200,012,091014,Galton; Ian A,9999,0,9999,0
1653454888597,ECE 200,013,091015,Gilja; Vikash,9999,0,9999,0
1653454888597,ECE 200,014,091016,Hall; Drew A.,9999,0,9999,0
1653454888597,ECE 200,015,091017,Hsueh; Tzu-Chien,9999,0,9999,0
1653454888597,ECE 200,016,091018,Javidi; Tara,9999,0,9999,0
1653454888597,ECE 200,017,091019,Kahng; Andrew Byun,9999,0,9999,0
1653454888597,ECE 200,018,091020,Kim; Young-Han,9999,0,9999,0
1653454888597,ECE 200,019,091021,Koushanfar; Farinaz,9999,0,9999,0
1653454888597,ECE 200,020,091022,Kuzum; Duygu,9999,0,9999,0
1653454888597,ECE 200,021,091023,Le; Hanh-Phuc,9999,0,9999,0
1653454888597,ECE 200,022,091024,Lin; Bill,9999,0,9999,0
1653454888597,ECE 200,023,091025,Liu; Zhaowei,9999,0,9999,0
1653454888597,ECE 200,024,091026,Lo; Yu-Hwa,9999,0,9999,0
1653454888597,ECE 200,025,091027,Lomakin; Vitaliy,9999,0,9999,0
1653454888597,ECE 200,026,091028,Mercier; Patrick Philip,9999,0,9999,0
1653454888597,ECE 200,027,091029,Meyer; Florian,9999,0,9999,0
1653454888597,ECE 200,028,091030,Milstein; Laurence B.,9999,0,9999,0
1653454888597,ECE 200,029,091031,Mir Arabbaygi; Siavash,9999,0,9999,0
1653454888597,ECE 200,030,091032,Mookherjea; Shayan,9999,0,9999,0
1653454888597,ECE 200,031,091033,Morris; Karcher William,9999,0,9999,0
1653454888597,ECE 200,032,091034,Ng; Tse Nga,9999,0,9999,0
1653454888597,ECE 200,033,091035,Nguyen; Truong Quang,9999,0,9999,0
1653454888597,ECE 200,034,091036,Nomura; Kenji,9999,0,9999,0
1653454888597,ECE 200,035,091037,Orlitsky; Alon,9999,0,9999,0
1653454888597,ECE 200,036,091038,Pal; Piya,9999,0,9999,0
1653454888597,ECE 200,037,091039,Papen; George C.,9999,0,9999,0
1653454888597,ECE 200,038,091040,Radic; Stojan,9999,0,9999,0
1653454888597,ECE 200,039,091041,Rao; Bhaskar D.,9999,0,9999,0
1653454888597,ECE 200,040,091042,Rao; Ramesh R,9999,0,9999,0
1653454888597,ECE 200,041,091043,Rebeiz; Gabriel,9999,0,9999,0
1653454888597,ECE 200,042,091044,Sanford; John R,9999,0,9999,0
1653454888597,ECE 200,043,091045,Siegel; Paul H.,9999,0,9999,0
1653454888597,ECE 200,044,091046,Sievenpiper; Daniel F.,9999,0,9999,0
1653454888597,ECE 200,045,091047,Sworder; David D.,9999,0,9999,0
1653454888597,ECE 200,046,091048,Taur; Yuan,9999,0,9999,0
1653454888597,ECE 200,047,091049,Touri; Behrouz,9999,0,9999,0
1653454888597,ECE 200,048,091050,Trivedi; Mohan M.,9999,0,9999,0
1653454888597,ECE 200,049,091051,Vardy; Alexander,9999,0,9999,0
1653454888597,ECE 200,050,091052,Vasconcelos; Nuno,9999,0,9999,0
1653454888597,ECE 200,051,091053,Wang; Xiaolong,9999,0,9999,0
1653454888597,ECE 200,052,091054,Xie; Pengtao,9999,0,9999,0
1653454888597,ECE 200,053,091055,Yip; Michael,9999,0,9999,0
1653454888597,ECE 200,054,091056,Zeger; Kenneth A.,9999,0,9999,0
1653454888597,ECE 200,055,091057,Zhang; Xinyu,9999,0,9999,0
1653454888597,ECE 200,056,091058,Turakhia; Yatish Girish,9999,0,9999,0
1653454888597,ECE 200,057,091059,Kang; Mingu,9999,0,9999,0
1653454888597,ECE 200,058,091060,Shi; Yuanyuan,9999,0,9999,0
1653454888597,ECE 200,059,091061,Wang; Edward Jay,9999,0,9999,0
1653454888597,ECE 200,060,091062,Zheng; Yang,9999,0,9999,0
1653454889135,ECE 203,A00,091065,Mercier; Patrick Philip,0,0,0,0
1653454889665,ECE 207A,A00,091605,Liu; Thomas Tao-Ming,0,0,0,0
1653454890188,ECE 212AN,A00,091068,Nomura; Kenji,0,0,0,0
1653454890710,ECE 222A,A00,091069,Rebeiz; Gabriel,0,0,0,0
1653454891236,ECE 225A,A00,091070,Orlitsky; Alon,0,0,0,0
1653454891760,ECE 230A,A00,091071,Nomura; Kenji,0,0,0,0
1653454892283,ECE 236A,A00,091072,Dayeh; Shadi Ahmad,0,0,0,0
1653454892806,ECE 238A,A00,091073,Luo; Jian,0,0,0,0
1653454892806,ECE 238A,B00,091074,Luo; Jian,0,0,0,0
1653454893332,ECE 240A,A00,091075,Radic; Stojan,0,0,0,0
1653454893856,ECE 247A,A00,091592,Shi; Lingyan,0,0,0,0
1653454894380,ECE 250,A00,091076,Touri; Behrouz,0,0,0,0
1653454894902,ECE 251C,A00,091078,Nguyen; Truong Quang,0,0,0,0
1653454895427,ECE 253,A00,091079,Cosman; Pamela C.,0,0,0,0
1653454895957,ECE 255A,A00,091080,Orlitsky; Alon,0,0,0,0
1653454896478,ECE 257A,A00,091081,Zhang; Xinyu,0,0,0,0
1653454897000,ECE 260A,A01,091084,Eldon; John,0,0,0,0
1653454897522,ECE 264C,A00,091085,Galton; Ian A,0,0,0,0
1653454898049,ECE 265C,A00,094889,Presti; Calogero Davide,0,0,0,9
1653454898571,ECE 266,A01,091087,Hall; Drew A.,0,0,0,0
1653454899619,ECE 271A,A00,091090,Vasconcelos; Nuno,0,0,0,0
1653454900150,ECE 272B,A00,091091,Sworder; David D.,0,0,0,0
1653454900683,ECE 275A,A00,091092,Meyer; Florian,0,0,0,0
1653454901218,ECE 277,A00,091093,An; Cheolhong,0,0,0,0
1653454901740,ECE 283,A00,091094,Le; Hanh-Phuc,0,0,0,0
1653454902268,ECE 284,A00,091095,Kang; Mingu,0,0,0,0
1653454902268,ECE 284,B00,091096,Wang; Edward Jay,0,0,0,0
1653454902791,ECE 285,A00,094334,Touri; Behrouz,0,0,0,0
1653454903314,ECE 289,A00,091097,Whelan; David Arthur,0,0,0,0
1653454903846,MATH 200A,A00,087414,Salehi Golsefidy; Alireza,7,0,8,1
1653454904367,MATH 202A,A00,087415,Gill; Philip E.,3,0,8,5
1653454904895,MATH 203A,A00,087416,Oprea; Dragos N.,6,0,8,2
1653454905420,MATH 204A,A00,087417,Kedlaya; Kiran S.,6,0,8,2
1653454905947,MATH 205,A00,087418,Sorensen; Claus M,6,0,8,2
1653454906478,MATH 206A,A00,087419,Izadi; Elham,7,0,8,1
1653454906999,MATH 207A,A00,087420,Mohammadi; Amir,6,0,8,2
1653454907522,MATH 208,A00,087421,Staff,9,0,10,1
1653454908047,MATH 209,A00,087422,Staff,10,0,10,0
1653454908571,MATH 218,A00,087423,Staff,10,0,10,0
1653454909096,MATH 220A,A00,087424,Novak; Jonathan I,7,0,8,1
1653454909620,MATH 231A,A00,087425,Bejenaru; Ioan,3,0,8,5
1653454910151,MATH 240A,A00,087426,Ebenfelt; Peter F,5,0,8,3
1653454910676,MATH 243,A00,087427,Staff,9,0,10,1
1653454911200,MATH 248,A00,087429,Staff,10,0,10,0
1653454911725,MATH 250A,A00,087430,Spolaor; Luca,4,0,8,4
1653454912347,MATH 257A,A00,087431,Spolaor; Luca,7,0,8,1
1653454912870,MATH 258,A00,087432,Staff,9,0,10,1
1653454913400,MATH 264A,A00,087433,Warnke; Lutz Peter,5,0,8,3
1653454913934,MATH 268,A00,087434,Staff,15,0,15,0
1653454914459,MATH 269,A00,087435,Staff,14,0,15,1
1653454914981,MATH 270A,A00,087436,Nie; Jiawang,0,0,8,8
1653454915506,MATH 272A,A00,087437,Tian; Xiaochuan,1,0,8,7
1653454916034,MATH 274,A01,087439,Cheng; Li-Tien,9,0,10,1
1653454916034,MATH 274,A02,087440,Cheng; Li-Tien,10,0,10,0
1653454916557,MATH 278A,A00,087441,Staff,8,0,10,2
1653454917082,MATH 278B,A00,087442,Staff,8,0,10,2
1653454917605,MATH 278C,A00,087443,Staff,8,0,10,2
1653454918129,MATH 280A,A00,087444,Zheng; Tianyi,0,0,8,8
1653454918672,MATH 281A,A00,087445,Bradic; Jelena,0,0,8,8
1653454919204,MATH 282A,A00,087446,Zhang; Danna,0,0,8,8
1653454919735,MATH 283,A00,087447,Tesler; Glenn,0,0,0,14
1653454920258,MATH 286,A00,087448,Kemp; Todd Aahron,5,0,8,3
1653454920781,MATH 287D,A00,087449,Bradic; Jelena,8,0,8,0
1653454921305,MATH 288,A00,087450,Staff,14,0,15,1
1653454921305,MATH 288,B00,087451,Staff,15,0,15,0
1653454921305,MATH 288,C00,087452,Staff,15,0,15,0
1653454921830,MATH 290A,A00,087453,Xu; Zhouli,7,0,8,1
1653454922351,MATH 291A,A00,087454,Xu; Zhouli,7,0,8,1
1653454922883,MATH 292,A00,087455,Staff,10,0,10,0
1653454923419,MATH 295,A00,087456,Staff,50,0,50,0
1653454923945,MATH 297,001,087457,Staff,998,0,999,1
1653455483337,COGS 200,A01,087991,Staff,47,0,50,3
1653455483859,COGS 201,A01,094504,Rangel; Lara M,17,0,25,8
1653455484386,COGS 203,A00,087992,Coulson; Seana M,18,0,20,2
1653455484918,COGS 210A,001,087993,Greene; Deanna Jacquelyn,9998,0,9999,1
1653455484918,COGS 210A,002,087994,Saygin; Ayse P,9999,0,9999,0
1653455484918,COGS 210A,003,087995,Xia; Haijun,9999,0,9999,0
1653455484918,COGS 210A,004,087996,Nitz; Douglas A.,9999,0,9999,0
1653455484918,COGS 210A,005,087997,Hollan; James D.,9999,0,9999,0
1653455484918,COGS 210A,006,087998,Deak; Gedeon O.,9998,0,9999,1
1653455484918,COGS 210A,007,087999,Rossano; Federico,9999,0,9999,0
1653455485440,COGS 211A,A00,088000,Coulson; Seana M,9997,0,9999,2
1653455485963,COGS 229,A00,088002,Staff,23,0,25,2
1653455486499,COGS 260,B00,094231,Staff,17,0,20,3
1653455486499,COGS 260,A00,088004,Nitz; Douglas A.,9998,0,9999,1
1653455487027,CSE 202,A00,090110,Paturi; Ramamohan,0,0,0,0
1653455487027,CSE 202,B00,090111,Paturi; Ramamohan,0,0,0,0
1653455487554,CSE 207B,A00,090112,Heninger; Nadia A,0,0,0,0
1653455488078,CSE 208,A00,094858,Micciancio; Daniele,0,0,0,0
1653455488601,CSE 210,A00,090113,Powell; Thomas Allan,0,0,0,0
1653455489124,CSE 219,A00,090898,Staff,0,0,0,0
1653455489650,CSE 221,A00,090114,Zhou; Yuan-Yuan,0,0,0,0
1653455490173,CSE 229A,A00,090115,Porter; George M,0,0,0,0
1653455490696,CSE 229C,A00,090116,Savage; Stefan,0,0,0,0
1653455491218,CSE 230,A00,090117,Jhala; Ranjit,0,0,0,0
1653455491741,CSE 232,A00,090118,Papakonstantinou; Yannis,0,0,0,0
1653455492263,CSE 239A,A00,090121,Kumar; Arun Kumar,0,0,0,0
1653455492792,CSE 239B,A00,090122,Jhala; Ranjit,0,0,0,0
1653455493325,CSE 240A,A00,090123,Zhao; Jishen,0,0,189,189
1653455493851,CSE 243A,A00,090124,Orailoglu; Alex,1,0,15,14
1653455494377,CSE 249B,A00,090125,Kahng; Andrew Byun,13,0,20,7
1653455494900,CSE 250A,A00,090126,Berg-Kirkpatrick; Taylor D,0,0,0,0
1653455495422,CSE 252A,A00,090127,Ochoa; Benjamin Lawrence,0,0,0,0
1653455495954,CSE 258,A01,090129,McAuley; Julian John,0,0,0,0
1653455496477,CSE 258R,A01,090131,McAuley; Julian John,0,0,0,0
1653455497001,CSE 274,A00,090132,Ramamoorthi; Ravi,0,0,0,0
1653455497524,CSE 276A,A00,090133,Christensen; Henrik I,0,0,0,0
1653455498046,CSE 276C,A00,090134,Christensen; Henrik I,0,0,0,0
1653455498569,CSE 290,A00,090135,Bafna; Vineet,0,0,0,0
1653455498569,CSE 290,B00,090136,Ramamoorthi; Ravi,0,0,0,0
1653455498569,CSE 290,C00,090137,Li; Tzumao,9,0,10,1
1653455498569,CSE 290,D00,090138,Zhou; Yuan-Yuan,10,0,10,0
1653455498569,CSE 290,E00,090139,Christensen; Henrik I,10,0,10,0
1653455498569,CSE 290,F00,094053,Shalev; Aaron D,0,0,0,0
1653455499171,CSE 291,A00,090140,Munyaka; Imani N. S.,0,0,0,0
1653455499171,CSE 291,B00,094880,Yu; Qi,0,0,0,0
1653455499171,CSE 291,C00,090142,Pannuto; Patrick William,0,0,0,0
1653455499171,CSE 291,D00,094881,Zhang; Yiying,0,0,0,0
1653455499171,CSE 291,E00,095118,Su; Hao,0,0,0,0
1653455499731,CSE 293,001,094905,Bafna; Vineet,9999,0,9999,0
1653455499731,CSE 293,002,094906,Bellare; Mihir,9999,0,9999,0
1653455499731,CSE 293,003,094907,Berg-Kirkpatrick; Taylor D,9999,0,9999,0
1653455499731,CSE 293,004,094908,Christensen; Henrik I,9999,0,9999,0
1653455499731,CSE 293,005,094909,Cottrell; Garrison W,9999,0,9999,0
1653455499731,CSE 293,006,094910,Deutsch; Alin Bernard,9999,0,9999,0
1653455499731,CSE 293,007,094911,Esmaeilzadeh; Hadi,9999,0,9999,0
1653455499731,CSE 293,008,094912,Freund; Yoav,9999,0,9999,0
1653455499731,CSE 293,009,094913,Griswold; William G.,9999,0,9999,0
1653455499731,CSE 293,010,094914,Gymrek; Melissa Ann,9999,0,9999,0
1653455499731,CSE 293,011,094915,Heninger; Nadia A,9999,0,9999,0
1653455499731,CSE 293,012,094916,Impagliazzo; Russell,9999,0,9999,0
1653455499731,CSE 293,013,094917,Jhala; Ranjit,9999,0,9999,0
1653455499731,CSE 293,014,094918,Kahng; Andrew Byun,9999,0,9999,0
1653455499731,CSE 293,015,094919,Kane; Daniel Mertz,9999,0,9999,0
1653455499731,CSE 293,016,094920,Kriegman; David J,9999,0,9999,0
1653455499731,CSE 293,017,094921,Kumar; Arun Kumar,9999,0,9999,0
1653455499731,CSE 293,018,094922,Lerner; Sorin,9999,0,9999,0
1653455499731,CSE 293,019,094923,Lovett; Shachar,9999,0,9999,0
1653455499731,CSE 293,020,094924,McAuley; Julian John,9999,0,9999,0
1653455499731,CSE 293,021,094925,Micciancio; Daniele,9999,0,9999,0
1653455499731,CSE 293,022,094926,Orailoglu; Alex,9999,0,9999,0
1653455499731,CSE 293,023,094927,Paturi; Ramamohan,9999,0,9999,0
1653455499731,CSE 293,024,094928,Polikarpova; Nadezhda,9999,0,9999,0
1653455499731,CSE 293,025,094929,Politz; Joseph Gibbs,9999,0,9999,0
1653455499731,CSE 293,026,094930,Porter; George M,9999,0,9999,0
1653455499731,CSE 293,027,094931,Porter; Leonard Emerson,9999,0,9999,0
1653455499731,CSE 293,028,094932,Ramamoorthi; Ravi,9999,0,9999,0
1653455499731,CSE 293,029,094933,Sahoo; Debashis,9999,0,9999,0
1653455499731,CSE 293,030,094934,Saul; Lawrence,9999,0,9999,0
1653455499731,CSE 293,031,094935,Savage; Stefan,9999,0,9999,0
1653455499731,CSE 293,032,094936,Schulze; Jurgen P.,9999,0,9999,0
1653455499731,CSE 293,033,094937,Snoeren; Alex C.,9999,0,9999,0
1653455499731,CSE 293,034,094938,Shang; Jingbo,9999,0,9999,0
1653455499731,CSE 293,035,094939,Stefan; Deian,9999,0,9999,0
1653455499731,CSE 293,036,094940,Su; Hao,9999,0,9999,0
1653455499731,CSE 293,037,094941,Swanson; Steven James,9999,0,9999,0
1653455499731,CSE 293,038,094942,Tullsen; Dean Michael,9999,0,9999,0
1653455499731,CSE 293,039,094943,Voelker; Geoffrey M.,9999,0,9999,0
1653455499731,CSE 293,040,094944,Zhao; Jishen,9999,0,9999,0
1653455499731,CSE 293,041,094945,Zhou; Yuan-Yuan,9999,0,9999,0
1653455499731,CSE 293,042,094946,Gao; Sicun,9998,0,9999,1
1653455499731,CSE 293,043,094947,Weibel; Nadir,9999,0,9999,0
1653455499731,CSE 293,044,094948,Gupta; Rajesh K.,9999,0,9999,0
1653455500254,CSE 294,A00,090143,Porter; George M,9,0,10,1
1653455500781,DSE 200,A00,091799,Staff,50,0,50,0
1653455501305,DSE 203,A00,091800,Gupta; Amarnath,30,0,30,0
1653455501834,DSE 250,A00,091801,Deutsch; Alin Bernard,30,0,30,0
1653455502356,DSE 290,A00,091802,Altintas De Callaf; Ilkay,50,0,50,0
1653455502896,ECE 200,001,091003,Antipa; Nicholas A,9999,0,9999,0
1653455502896,ECE 200,002,091004,Atanasov; Nikolay A.,9999,0,9999,0
1653455502896,ECE 200,003,091005,Bharadia; Dinesh,9999,0,9999,0
1653455502896,ECE 200,004,091006,Cheng; Chung Kuan,9999,0,9999,0
1653455502896,ECE 200,005,091007,Cosman; Pamela C.,9999,0,9999,0
1653455502896,ECE 200,006,091008,Staff,9999,0,9999,0
1653455502896,ECE 200,007,091009,Dayeh; Shadi Ahmad,9999,0,9999,0
1653455502896,ECE 200,008,091010,Fainman; Yeshaiahu,9999,0,9999,0
1653455502896,ECE 200,009,091011,Ford; Joseph Earl,9999,0,9999,0
1653455502896,ECE 200,010,091012,Franceschetti; Massimo,9999,0,9999,0
1653455502896,ECE 200,011,091013,Fullerton; Eric E,9999,0,9999,0
1653455502896,ECE 200,012,091014,Galton; Ian A,9999,0,9999,0
1653455502896,ECE 200,013,091015,Gilja; Vikash,9999,0,9999,0
1653455502896,ECE 200,014,091016,Hall; Drew A.,9999,0,9999,0
1653455502896,ECE 200,015,091017,Hsueh; Tzu-Chien,9999,0,9999,0
1653455502896,ECE 200,016,091018,Javidi; Tara,9999,0,9999,0
1653455502896,ECE 200,017,091019,Kahng; Andrew Byun,9999,0,9999,0
1653455502896,ECE 200,018,091020,Kim; Young-Han,9999,0,9999,0
1653455502896,ECE 200,019,091021,Koushanfar; Farinaz,9999,0,9999,0
1653455502896,ECE 200,020,091022,Kuzum; Duygu,9999,0,9999,0
1653455502896,ECE 200,021,091023,Le; Hanh-Phuc,9999,0,9999,0
1653455502896,ECE 200,022,091024,Lin; Bill,9999,0,9999,0
1653455502896,ECE 200,023,091025,Liu; Zhaowei,9999,0,9999,0
1653455502896,ECE 200,024,091026,Lo; Yu-Hwa,9999,0,9999,0
1653455502896,ECE 200,025,091027,Lomakin; Vitaliy,9999,0,9999,0
1653455502896,ECE 200,026,091028,Mercier; Patrick Philip,9999,0,9999,0
1653455502896,ECE 200,027,091029,Meyer; Florian,9999,0,9999,0
1653455502896,ECE 200,028,091030,Milstein; Laurence B.,9999,0,9999,0
1653455502896,ECE 200,029,091031,Mir Arabbaygi; Siavash,9999,0,9999,0
1653455502896,ECE 200,030,091032,Mookherjea; Shayan,9999,0,9999,0
1653455502896,ECE 200,031,091033,Morris; Karcher William,9999,0,9999,0
1653455502896,ECE 200,032,091034,Ng; Tse Nga,9999,0,9999,0
1653455502896,ECE 200,033,091035,Nguyen; Truong Quang,9999,0,9999,0
1653455502896,ECE 200,034,091036,Nomura; Kenji,9999,0,9999,0
1653455502896,ECE 200,035,091037,Orlitsky; Alon,9999,0,9999,0
1653455502896,ECE 200,036,091038,Pal; Piya,9999,0,9999,0
1653455502896,ECE 200,037,091039,Papen; George C.,9999,0,9999,0
1653455502896,ECE 200,038,091040,Radic; Stojan,9999,0,9999,0
1653455502896,ECE 200,039,091041,Rao; Bhaskar D.,9999,0,9999,0
1653455502896,ECE 200,040,091042,Rao; Ramesh R,9999,0,9999,0
1653455502896,ECE 200,041,091043,Rebeiz; Gabriel,9999,0,9999,0
1653455502896,ECE 200,042,091044,Sanford; John R,9999,0,9999,0
1653455502896,ECE 200,043,091045,Siegel; Paul H.,9999,0,9999,0
1653455502896,ECE 200,044,091046,Sievenpiper; Daniel F.,9999,0,9999,0
1653455502896,ECE 200,045,091047,Sworder; David D.,9999,0,9999,0
1653455502896,ECE 200,046,091048,Taur; Yuan,9999,0,9999,0
1653455502896,ECE 200,047,091049,Touri; Behrouz,9999,0,9999,0
1653455502896,ECE 200,048,091050,Trivedi; Mohan M.,9999,0,9999,0
1653455502896,ECE 200,049,091051,Vardy; Alexander,9999,0,9999,0
1653455502896,ECE 200,050,091052,Vasconcelos; Nuno,9999,0,9999,0
1653455502896,ECE 200,051,091053,Wang; Xiaolong,9999,0,9999,0
1653455502896,ECE 200,052,091054,Xie; Pengtao,9999,0,9999,0
1653455502896,ECE 200,053,091055,Yip; Michael,9999,0,9999,0
1653455502896,ECE 200,054,091056,Zeger; Kenneth A.,9999,0,9999,0
1653455502896,ECE 200,055,091057,Zhang; Xinyu,9999,0,9999,0
1653455502896,ECE 200,056,091058,Turakhia; Yatish Girish,9999,0,9999,0
1653455502896,ECE 200,057,091059,Kang; Mingu,9999,0,9999,0
1653455502896,ECE 200,058,091060,Shi; Yuanyuan,9999,0,9999,0
1653455502896,ECE 200,059,091061,Wang; Edward Jay,9999,0,9999,0
1653455502896,ECE 200,060,091062,Zheng; Yang,9999,0,9999,0
1653455503420,ECE 203,A00,091065,Mercier; Patrick Philip,0,0,0,0
1653455503943,ECE 207A,A00,091605,Liu; Thomas Tao-Ming,0,0,0,0
1653455504470,ECE 212AN,A00,091068,Nomura; Kenji,0,0,0,0
1653455504998,ECE 222A,A00,091069,Rebeiz; Gabriel,0,0,0,0
1653455505522,ECE 225A,A00,091070,Orlitsky; Alon,0,0,0,0
1653455506047,ECE 230A,A00,091071,Nomura; Kenji,0,0,0,0
1653455506569,ECE 236A,A00,091072,Dayeh; Shadi Ahmad,0,0,0,0
1653455507092,ECE 238A,A00,091073,Luo; Jian,0,0,0,0
1653455507092,ECE 238A,B00,091074,Luo; Jian,0,0,0,0
1653455507613,ECE 240A,A00,091075,Radic; Stojan,0,0,0,0
1653455508138,ECE 247A,A00,091592,Shi; Lingyan,0,0,0,0
1653455508664,ECE 250,A00,091076,Touri; Behrouz,0,0,0,0
1653455509189,ECE 251C,A00,091078,Nguyen; Truong Quang,0,0,0,0
1653455509714,ECE 253,A00,091079,Cosman; Pamela C.,0,0,0,0
1653455510239,ECE 255A,A00,091080,Orlitsky; Alon,0,0,0,0
1653455510764,ECE 257A,A00,091081,Zhang; Xinyu,0,0,0,0
1653455511291,ECE 260A,A01,091084,Eldon; John,0,0,0,0
1653455511816,ECE 264C,A00,091085,Galton; Ian A,0,0,0,0
1653455512339,ECE 265C,A00,094889,Presti; Calogero Davide,0,0,0,9
1653455512859,ECE 266,A01,091087,Hall; Drew A.,0,0,0,0
1653455513914,ECE 271A,A00,091090,Vasconcelos; Nuno,0,0,0,0
1653455514436,ECE 272B,A00,091091,Sworder; David D.,0,0,0,0
1653455514965,ECE 275A,A00,091092,Meyer; Florian,0,0,0,0
1653455515489,ECE 277,A00,091093,An; Cheolhong,0,0,0,0
1653455516014,ECE 283,A00,091094,Le; Hanh-Phuc,0,0,0,0
1653455516569,ECE 284,A00,091095,Kang; Mingu,0,0,0,0
1653455516569,ECE 284,B00,091096,Wang; Edward Jay,0,0,0,0
1653455517095,ECE 285,A00,094334,Touri; Behrouz,0,0,0,0
1653455517617,ECE 289,A00,091097,Whelan; David Arthur,0,0,0,0
1653455518138,MATH 200A,A00,087414,Salehi Golsefidy; Alireza,7,0,8,1
1653455518661,MATH 202A,A00,087415,Gill; Philip E.,3,0,8,5
1653455519189,MATH 203A,A00,087416,Oprea; Dragos N.,6,0,8,2
1653455519712,MATH 204A,A00,087417,Kedlaya; Kiran S.,6,0,8,2
1653455520233,MATH 205,A00,087418,Sorensen; Claus M,6,0,8,2
1653455520759,MATH 206A,A00,087419,Izadi; Elham,7,0,8,1
1653455521282,MATH 207A,A00,087420,Mohammadi; Amir,6,0,8,2
1653455521803,MATH 208,A00,087421,Staff,9,0,10,1
1653455522333,MATH 209,A00,087422,Staff,10,0,10,0
1653455522857,MATH 218,A00,087423,Staff,10,0,10,0
1653455523379,MATH 220A,A00,087424,Novak; Jonathan I,7,0,8,1
1653455523902,MATH 231A,A00,087425,Bejenaru; Ioan,3,0,8,5
1653455524427,MATH 240A,A00,087426,Ebenfelt; Peter F,5,0,8,3
1653455524948,MATH 243,A00,087427,Staff,9,0,10,1
1653455525472,MATH 248,A00,087429,Staff,10,0,10,0
1653455526011,MATH 250A,A00,087430,Spolaor; Luca,4,0,8,4
1653455526536,MATH 257A,A00,087431,Spolaor; Luca,7,0,8,1
1653455527058,MATH 258,A00,087432,Staff,9,0,10,1
1653455527582,MATH 264A,A00,087433,Warnke; Lutz Peter,5,0,8,3
1653455528104,MATH 268,A00,087434,Staff,15,0,15,0
1653455528628,MATH 269,A00,087435,Staff,14,0,15,1
1653455529154,MATH 270A,A00,087436,Nie; Jiawang,0,0,8,8
1653455529678,MATH 272A,A00,087437,Tian; Xiaochuan,1,0,8,7
1653455530200,MATH 274,A01,087439,Cheng; Li-Tien,9,0,10,1
1653455530200,MATH 274,A02,087440,Cheng; Li-Tien,10,0,10,0
1653455530732,MATH 278A,A00,087441,Staff,8,0,10,2
1653455531254,MATH 278B,A00,087442,Staff,8,0,10,2
1653455531777,MATH 278C,A00,087443,Staff,8,0,10,2
1653455532299,MATH 280A,A00,087444,Zheng; Tianyi,0,0,8,8
1653455532822,MATH 281A,A00,087445,Bradic; Jelena,0,0,8,8
1653455533347,MATH 282A,A00,087446,Zhang; Danna,0,0,8,8
1653455533870,MATH 283,A00,087447,Tesler; Glenn,0,0,0,14
1653455534403,MATH 286,A00,087448,Kemp; Todd Aahron,5,0,8,3
1653455534926,MATH 287D,A00,087449,Bradic; Jelena,8,0,8,0
1653455535451,MATH 288,A00,087450,Staff,14,0,15,1
1653455535451,MATH 288,B00,087451,Staff,15,0,15,0
1653455535451,MATH 288,C00,087452,Staff,15,0,15,0
1653455535975,MATH 290A,A00,087453,Xu; Zhouli,7,0,8,1
1653455536497,MATH 291A,A00,087454,Xu; Zhouli,7,0,8,1
1653455537020,MATH 292,A00,087455,Staff,10,0,10,0
1653455537541,MATH 295,A00,087456,Staff,50,0,50,0
1653455538063,MATH 297,001,087457,Staff,998,0,999,1
1653456107678,COGS 200,A01,087991,Staff,47,0,50,3
1653456108203,COGS 201,A01,094504,Rangel; Lara M,17,0,25,8
1653456108725,COGS 203,A00,087992,Coulson; Seana M,18,0,20,2
1653456109251,COGS 210A,001,087993,Greene; Deanna Jacquelyn,9998,0,9999,1
1653456109251,COGS 210A,002,087994,Saygin; Ayse P,9999,0,9999,0
1653456109251,COGS 210A,003,087995,Xia; Haijun,9999,0,9999,0
1653456109251,COGS 210A,004,087996,Nitz; Douglas A.,9999,0,9999,0
1653456109251,COGS 210A,005,087997,Hollan; James D.,9999,0,9999,0
1653456109251,COGS 210A,006,087998,Deak; Gedeon O.,9998,0,9999,1
1653456109251,COGS 210A,007,087999,Rossano; Federico,9999,0,9999,0
1653456109776,COGS 211A,A00,088000,Coulson; Seana M,9997,0,9999,2
1653456110299,COGS 229,A00,088002,Staff,23,0,25,2
1653456110830,COGS 260,B00,094231,Staff,17,0,20,3
1653456110830,COGS 260,A00,088004,Nitz; Douglas A.,9998,0,9999,1
1653456111358,CSE 202,A00,090110,Paturi; Ramamohan,0,0,0,0
1653456111358,CSE 202,B00,090111,Paturi; Ramamohan,0,0,0,0
1653456111888,CSE 207B,A00,090112,Heninger; Nadia A,0,0,0,0
1653456112414,CSE 208,A00,094858,Micciancio; Daniele,0,0,0,0
1653456112949,CSE 210,A00,090113,Powell; Thomas Allan,0,0,0,0
1653456113470,CSE 219,A00,090898,Staff,0,0,0,0
1653456113992,CSE 221,A00,090114,Zhou; Yuan-Yuan,0,0,0,0
1653456114515,CSE 229A,A00,090115,Porter; George M,0,0,0,0
1653456115038,CSE 229C,A00,090116,Savage; Stefan,0,0,0,0
1653456115560,CSE 230,A00,090117,Jhala; Ranjit,0,0,0,0
1653456116083,CSE 232,A00,090118,Papakonstantinou; Yannis,0,0,0,0
1653456116614,CSE 239A,A00,090121,Kumar; Arun Kumar,0,0,0,0
1653456117137,CSE 239B,A00,090122,Jhala; Ranjit,0,0,0,0
1653456117663,CSE 240A,A00,090123,Zhao; Jishen,0,0,189,189
1653456118188,CSE 243A,A00,090124,Orailoglu; Alex,1,0,15,14
1653456118713,CSE 249B,A00,090125,Kahng; Andrew Byun,13,0,20,7
1653456119243,CSE 250A,A00,090126,Berg-Kirkpatrick; Taylor D,0,0,0,0
1653456119775,CSE 252A,A00,090127,Ochoa; Benjamin Lawrence,0,0,0,0
1653456120307,CSE 258,A01,090129,McAuley; Julian John,0,0,0,0
1653456120829,CSE 258R,A01,090131,McAuley; Julian John,0,0,0,0
1653456121363,CSE 274,A00,090132,Ramamoorthi; Ravi,0,0,0,0
1653456121886,CSE 276A,A00,090133,Christensen; Henrik I,0,0,0,0
1653456122415,CSE 276C,A00,090134,Christensen; Henrik I,0,0,0,0
1653456122938,CSE 290,A00,090135,Bafna; Vineet,0,0,0,0
1653456122938,CSE 290,B00,090136,Ramamoorthi; Ravi,0,0,0,0
1653456122938,CSE 290,C00,090137,Li; Tzumao,9,0,10,1
1653456122938,CSE 290,D00,090138,Zhou; Yuan-Yuan,10,0,10,0
1653456122938,CSE 290,E00,090139,Christensen; Henrik I,10,0,10,0
1653456122938,CSE 290,F00,094053,Shalev; Aaron D,0,0,0,0
1653456123462,CSE 291,A00,090140,Munyaka; Imani N. S.,0,0,0,0
1653456123462,CSE 291,B00,094880,Yu; Qi,0,0,0,0
1653456123462,CSE 291,C00,090142,Pannuto; Patrick William,0,0,0,0
1653456123462,CSE 291,D00,094881,Zhang; Yiying,0,0,0,0
1653456123462,CSE 291,E00,095118,Su; Hao,0,0,0,0
1653456123988,CSE 293,001,094905,Bafna; Vineet,9999,0,9999,0
1653456123988,CSE 293,002,094906,Bellare; Mihir,9999,0,9999,0
1653456123988,CSE 293,003,094907,Berg-Kirkpatrick; Taylor D,9999,0,9999,0
1653456123988,CSE 293,004,094908,Christensen; Henrik I,9999,0,9999,0
1653456123988,CSE 293,005,094909,Cottrell; Garrison W,9999,0,9999,0
1653456123988,CSE 293,006,094910,Deutsch; Alin Bernard,9999,0,9999,0
1653456123988,CSE 293,007,094911,Esmaeilzadeh; Hadi,9999,0,9999,0
1653456123988,CSE 293,008,094912,Freund; Yoav,9999,0,9999,0
1653456123988,CSE 293,009,094913,Griswold; William G.,9999,0,9999,0
1653456123988,CSE 293,010,094914,Gymrek; Melissa Ann,9999,0,9999,0
1653456123988,CSE 293,011,094915,Heninger; Nadia A,9999,0,9999,0
1653456123988,CSE 293,012,094916,Impagliazzo; Russell,9999,0,9999,0
1653456123988,CSE 293,013,094917,Jhala; Ranjit,9999,0,9999,0
1653456123988,CSE 293,014,094918,Kahng; Andrew Byun,9999,0,9999,0
1653456123988,CSE 293,015,094919,Kane; Daniel Mertz,9999,0,9999,0
1653456123988,CSE 293,016,094920,Kriegman; David J,9999,0,9999,0
1653456123988,CSE 293,017,094921,Kumar; Arun Kumar,9999,0,9999,0
1653456123988,CSE 293,018,094922,Lerner; Sorin,9999,0,9999,0
1653456123988,CSE 293,019,094923,Lovett; Shachar,9999,0,9999,0
1653456123988,CSE 293,020,094924,McAuley; Julian John,9999,0,9999,0
1653456123988,CSE 293,021,094925,Micciancio; Daniele,9999,0,9999,0
1653456123988,CSE 293,022,094926,Orailoglu; Alex,9999,0,9999,0
1653456123988,CSE 293,023,094927,Paturi; Ramamohan,9999,0,9999,0
1653456123988,CSE 293,024,094928,Polikarpova; Nadezhda,9999,0,9999,0
1653456123988,CSE 293,025,094929,Politz; Joseph Gibbs,9999,0,9999,0
1653456123988,CSE 293,026,094930,Porter; George M,9999,0,9999,0
1653456123988,CSE 293,027,094931,Porter; Leonard Emerson,9999,0,9999,0
1653456123988,CSE 293,028,094932,Ramamoorthi; Ravi,9999,0,9999,0
1653456123988,CSE 293,029,094933,Sahoo; Debashis,9999,0,9999,0
1653456123988,CSE 293,030,094934,Saul; Lawrence,9999,0,9999,0
1653456123988,CSE 293,031,094935,Savage; Stefan,9999,0,9999,0
1653456123988,CSE 293,032,094936,Schulze; Jurgen P.,9999,0,9999,0
1653456123988,CSE 293,033,094937,Snoeren; Alex C.,9999,0,9999,0
1653456123988,CSE 293,034,094938,Shang; Jingbo,9999,0,9999,0
1653456123988,CSE 293,035,094939,Stefan; Deian,9999,0,9999,0
1653456123988,CSE 293,036,094940,Su; Hao,9999,0,9999,0
1653456123988,CSE 293,037,094941,Swanson; Steven James,9999,0,9999,0
1653456123988,CSE 293,038,094942,Tullsen; Dean Michael,9999,0,9999,0
1653456123988,CSE 293,039,094943,Voelker; Geoffrey M.,9999,0,9999,0
1653456123988,CSE 293,040,094944,Zhao; Jishen,9999,0,9999,0
1653456123988,CSE 293,041,094945,Zhou; Yuan-Yuan,9999,0,9999,0
1653456123988,CSE 293,042,094946,Gao; Sicun,9998,0,9999,1
1653456123988,CSE 293,043,094947,Weibel; Nadir,9999,0,9999,0
1653456123988,CSE 293,044,094948,Gupta; Rajesh K.,9999,0,9999,0
1653456124510,CSE 294,A00,090143,Porter; George M,9,0,10,1
1653456125035,DSE 200,A00,091799,Staff,50,0,50,0
1653456125556,DSE 203,A00,091800,Gupta; Amarnath,30,0,30,0
1653456126078,DSE 250,A00,091801,Deutsch; Alin Bernard,30,0,30,0
1653456126600,DSE 290,A00,091802,Altintas De Callaf; Ilkay,50,0,50,0
1653456127164,ECE 200,001,091003,Antipa; Nicholas A,9999,0,9999,0
1653456127164,ECE 200,002,091004,Atanasov; Nikolay A.,9999,0,9999,0
1653456127164,ECE 200,003,091005,Bharadia; Dinesh,9999,0,9999,0
1653456127164,ECE 200,004,091006,Cheng; Chung Kuan,9999,0,9999,0
1653456127164,ECE 200,005,091007,Cosman; Pamela C.,9999,0,9999,0
1653456127164,ECE 200,006,091008,Staff,9999,0,9999,0
1653456127164,ECE 200,007,091009,Dayeh; Shadi Ahmad,9999,0,9999,0
1653456127164,ECE 200,008,091010,Fainman; Yeshaiahu,9999,0,9999,0
1653456127164,ECE 200,009,091011,Ford; Joseph Earl,9999,0,9999,0
1653456127164,ECE 200,010,091012,Franceschetti; Massimo,9999,0,9999,0
1653456127164,ECE 200,011,091013,Fullerton; Eric E,9999,0,9999,0
1653456127164,ECE 200,012,091014,Galton; Ian A,9999,0,9999,0
1653456127164,ECE 200,013,091015,Gilja; Vikash,9999,0,9999,0
1653456127164,ECE 200,014,091016,Hall; Drew A.,9999,0,9999,0
1653456127164,ECE 200,015,091017,Hsueh; Tzu-Chien,9999,0,9999,0
1653456127164,ECE 200,016,091018,Javidi; Tara,9999,0,9999,0
1653456127164,ECE 200,017,091019,Kahng; Andrew Byun,9999,0,9999,0
1653456127164,ECE 200,018,091020,Kim; Young-Han,9999,0,9999,0
1653456127164,ECE 200,019,091021,Koushanfar; Farinaz,9999,0,9999,0
1653456127164,ECE 200,020,091022,Kuzum; Duygu,9999,0,9999,0
1653456127164,ECE 200,021,091023,Le; Hanh-Phuc,9999,0,9999,0
1653456127164,ECE 200,022,091024,Lin; Bill,9999,0,9999,0
1653456127164,ECE 200,023,091025,Liu; Zhaowei,9999,0,9999,0
1653456127164,ECE 200,024,091026,Lo; Yu-Hwa,9999,0,9999,0
1653456127164,ECE 200,025,091027,Lomakin; Vitaliy,9999,0,9999,0
1653456127164,ECE 200,026,091028,Mercier; Patrick Philip,9999,0,9999,0
1653456127164,ECE 200,027,091029,Meyer; Florian,9999,0,9999,0
1653456127164,ECE 200,028,091030,Milstein; Laurence B.,9999,0,9999,0
1653456127164,ECE 200,029,091031,Mir Arabbaygi; Siavash,9999,0,9999,0
1653456127164,ECE 200,030,091032,Mookherjea; Shayan,9999,0,9999,0
1653456127164,ECE 200,031,091033,Morris; Karcher William,9999,0,9999,0
1653456127164,ECE 200,032,091034,Ng; Tse Nga,9999,0,9999,0
1653456127164,ECE 200,033,091035,Nguyen; Truong Quang,9999,0,9999,0
1653456127164,ECE 200,034,091036,Nomura; Kenji,9999,0,9999,0
1653456127164,ECE 200,035,091037,Orlitsky; Alon,9999,0,9999,0
1653456127164,ECE 200,036,091038,Pal; Piya,9999,0,9999,0
1653456127164,ECE 200,037,091039,Papen; George C.,9999,0,9999,0
1653456127164,ECE 200,038,091040,Radic; Stojan,9999,0,9999,0
1653456127164,ECE 200,039,091041,Rao; Bhaskar D.,9999,0,9999,0
1653456127164,ECE 200,040,091042,Rao; Ramesh R,9999,0,9999,0
1653456127164,ECE 200,041,091043,Rebeiz; Gabriel,9999,0,9999,0
1653456127164,ECE 200,042,091044,Sanford; John R,9999,0,9999,0
1653456127164,ECE 200,043,091045,Siegel; Paul H.,9999,0,9999,0
1653456127164,ECE 200,044,091046,Sievenpiper; Daniel F.,9999,0,9999,0
1653456127164,ECE 200,045,091047,Sworder; David D.,9999,0,9999,0
1653456127164,ECE 200,046,091048,Taur; Yuan,9999,0,9999,0
1653456127164,ECE 200,047,091049,Touri; Behrouz,9999,0,9999,0
1653456127164,ECE 200,048,091050,Trivedi; Mohan M.,9999,0,9999,0
1653456127164,ECE 200,049,091051,Vardy; Alexander,9999,0,9999,0
1653456127164,ECE 200,050,091052,Vasconcelos; Nuno,9999,0,9999,0
1653456127164,ECE 200,051,091053,Wang; Xiaolong,9999,0,9999,0
1653456127164,ECE 200,052,091054,Xie; Pengtao,9999,0,9999,0
1653456127164,ECE 200,053,091055,Yip; Michael,9999,0,9999,0
1653456127164,ECE 200,054,091056,Zeger; Kenneth A.,9999,0,9999,0
1653456127164,ECE 200,055,091057,Zhang; Xinyu,9999,0,9999,0
1653456127164,ECE 200,056,091058,Turakhia; Yatish Girish,9999,0,9999,0
1653456127164,ECE 200,057,091059,Kang; Mingu,9999,0,9999,0
1653456127164,ECE 200,058,091060,Shi; Yuanyuan,9999,0,9999,0
1653456127164,ECE 200,059,091061,Wang; Edward Jay,9999,0,9999,0
1653456127164,ECE 200,060,091062,Zheng; Yang,9999,0,9999,0
1653456127687,ECE 203,A00,091065,Mercier; Patrick Philip,0,0,0,0
1653456128211,ECE 207A,A00,091605,Liu; Thomas Tao-Ming,0,0,0,0
1653456128733,ECE 212AN,A00,091068,Nomura; Kenji,0,0,0,0
1653456129257,ECE 222A,A00,091069,Rebeiz; Gabriel,0,0,0,0
1653456129779,ECE 225A,A00,091070,Orlitsky; Alon,0,0,0,0
1653456130307,ECE 230A,A00,091071,Nomura; Kenji,0,0,0,0
1653456130836,ECE 236A,A00,091072,Dayeh; Shadi Ahmad,0,0,0,0
1653456131357,ECE 238A,A00,091073,Luo; Jian,0,0,0,0
1653456131357,ECE 238A,B00,091074,Luo; Jian,0,0,0,0
1653456131882,ECE 240A,A00,091075,Radic; Stojan,0,0,0,0
1653456132408,ECE 247A,A00,091592,Shi; Lingyan,0,0,0,0
1653456132930,ECE 250,A00,091076,Touri; Behrouz,0,0,0,0
1653456133453,ECE 251C,A00,091078,Nguyen; Truong Quang,0,0,0,0
1653456133978,ECE 253,A00,091079,Cosman; Pamela C.,0,0,0,0
1653456134503,ECE 255A,A00,091080,Orlitsky; Alon,0,0,0,0
1653456135034,ECE 257A,A00,091081,Zhang; Xinyu,0,0,0,0
1653456135556,ECE 260A,A01,091084,Eldon; John,0,0,0,0
1653456136087,ECE 264C,A00,091085,Galton; Ian A,0,0,0,0
1653456136617,ECE 265C,A00,094889,Presti; Calogero Davide,0,0,0,9
1653456137146,ECE 266,A01,091087,Hall; Drew A.,0,0,0,0
1653456138205,ECE 271A,A00,091090,Vasconcelos; Nuno,0,0,0,0
1653456138735,ECE 272B,A00,091091,Sworder; David D.,0,0,0,0
1653456139257,ECE 275A,A00,091092,Meyer; Florian,0,0,0,0
1653456139780,ECE 277,A00,091093,An; Cheolhong,0,0,0,0
1653456140305,ECE 283,A00,091094,Le; Hanh-Phuc,0,0,0,0
1653456140829,ECE 284,A00,091095,Kang; Mingu,0,0,0,0
1653456140829,ECE 284,B00,091096,Wang; Edward Jay,0,0,0,0
1653456141352,ECE 285,A00,094334,Touri; Behrouz,0,0,0,0
1653456141877,ECE 289,A00,091097,Whelan; David Arthur,0,0,0,0
1653456142402,MATH 200A,A00,087414,Salehi Golsefidy; Alireza,7,0,8,1
1653456142925,MATH 202A,A00,087415,Gill; Philip E.,3,0,8,5
1653456143469,MATH 203A,A00,087416,Oprea; Dragos N.,6,0,8,2
1653456143996,MATH 204A,A00,087417,Kedlaya; Kiran S.,6,0,8,2
1653456144543,MATH 205,A00,087418,Sorensen; Claus M,6,0,8,2
1653456145069,MATH 206A,A00,087419,Izadi; Elham,7,0,8,1
1653456145619,MATH 207A,A00,087420,Mohammadi; Amir,6,0,8,2
1653456146142,MATH 208,A00,087421,Staff,9,0,10,1
1653456146663,MATH 209,A00,087422,Staff,10,0,10,0
1653456147209,MATH 218,A00,087423,Staff,10,0,10,0
1653456147732,MATH 220A,A00,087424,Novak; Jonathan I,7,0,8,1
1653456148254,MATH 231A,A00,087425,Bejenaru; Ioan,3,0,8,5
1653456148792,MATH 240A,A00,087426,Ebenfelt; Peter F,5,0,8,3
1653456149454,MATH 243,A00,087427,Staff,9,0,10,1
1653456149993,MATH 248,A00,087429,Staff,10,0,10,0
1653456150518,MATH 250A,A00,087430,Spolaor; Luca,4,0,8,4
1653456151044,MATH 257A,A00,087431,Spolaor; Luca,7,0,8,1
1653456151573,MATH 258,A00,087432,Staff,9,0,10,1
1653456152114,MATH 264A,A00,087433,Warnke; Lutz Peter,5,0,8,3
1653456152651,MATH 268,A00,087434,Staff,15,0,15,0
1653456153177,MATH 269,A00,087435,Staff,14,0,15,1
1653456153702,MATH 270A,A00,087436,Nie; Jiawang,0,0,8,8
1653456154226,MATH 272A,A00,087437,Tian; Xiaochuan,1,0,8,7
1653456154756,MATH 274,A01,087439,Cheng; Li-Tien,9,0,10,1
1653456154756,MATH 274,A02,087440,Cheng; Li-Tien,10,0,10,0
1653456155282,MATH 278A,A00,087441,Staff,8,0,10,2
1653456155804,MATH 278B,A00,087442,Staff,8,0,10,2
1653456156334,MATH 278C,A00,087443,Staff,8,0,10,2
1653456156857,MATH 280A,A00,087444,Zheng; Tianyi,0,0,8,8
1653456157385,MATH 281A,A00,087445,Bradic; Jelena,0,0,8,8
1653456157918,MATH 282A,A00,087446,Zhang; Danna,0,0,8,8
1653456158441,MATH 283,A00,087447,Tesler; Glenn,0,0,0,14
1653456158974,MATH 286,A00,087448,Kemp; Todd Aahron,5,0,8,3
1653456159496,MATH 287D,A00,087449,Bradic; Jelena,8,0,8,0
1653456160029,MATH 288,A00,087450,Staff,14,0,15,1
1653456160029,MATH 288,B00,087451,Staff,15,0,15,0
1653456160029,MATH 288,C00,087452,Staff,15,0,15,0
1653456160553,MATH 290A,A00,087453,Xu; Zhouli,7,0,8,1
1653456161077,MATH 291A,A00,087454,Xu; Zhouli,7,0,8,1
1653456161601,MATH 292,A00,087455,Staff,10,0,10,0
1653456162135,MATH 295,A00,087456,Staff,50,0,50,0
1653456162670,MATH 297,001,087457,Staff,998,0,999,1
1653456722365,COGS 200,A01,087991,Staff,47,0,50,3
1653456722890,COGS 201,A01,094504,Rangel; Lara M,17,0,25,8
1653456723417,COGS 203,A00,087992,Coulson; Seana M,18,0,20,2
1653456723941,COGS 210A,001,087993,Greene; Deanna Jacquelyn,9998,0,9999,1
1653456723941,COGS 210A,002,087994,Saygin; Ayse P,9999,0,9999,0
1653456723941,COGS 210A,003,087995,Xia; Haijun,9999,0,9999,0
1653456723941,COGS 210A,004,087996,Nitz; Douglas A.,9999,0,9999,0
1653456723941,COGS 210A,005,087997,Hollan; James D.,9999,0,9999,0
1653456723941,COGS 210A,006,087998,Deak; Gedeon O.,9998,0,9999,1
1653456723941,COGS 210A,007,087999,Rossano; Federico,9999,0,9999,0
1653456724465,COGS 211A,A00,088000,Coulson; Seana M,9997,0,9999,2
1653456724990,COGS 229,A00,088002,Staff,23,0,25,2
1653456725517,COGS 260,B00,094231,Staff,17,0,20,3
1653456725517,COGS 260,A00,088004,Nitz; Douglas A.,9998,0,9999,1
1653456726045,CSE 202,A00,090110,Paturi; Ramamohan,0,0,0,0
1653456726045,CSE 202,B00,090111,Paturi; Ramamohan,0,0,0,0
1653456726570,CSE 207B,A00,090112,Heninger; Nadia A,0,0,0,0
1653456727093,CSE 208,A00,094858,Micciancio; Daniele,0,0,0,0
1653456727617,CSE 210,A00,090113,Powell; Thomas Allan,0,0,0,0
1653456728140,CSE 219,A00,090898,Staff,0,0,0,0
1653456728669,CSE 221,A00,090114,Zhou; Yuan-Yuan,0,0,0,0
1653456729194,CSE 229A,A00,090115,Porter; George M,0,0,0,0
1653456729720,CSE 229C,A00,090116,Savage; Stefan,0,0,0,0
1653456730246,CSE 230,A00,090117,Jhala; Ranjit,0,0,0,0
1653456730772,CSE 232,A00,090118,Papakonstantinou; Yannis,0,0,0,0
1653456731300,CSE 239A,A00,090121,Kumar; Arun Kumar,0,0,0,0
1653456731823,CSE 239B,A00,090122,Jhala; Ranjit,0,0,0,0
1653456732352,CSE 240A,A00,090123,Zhao; Jishen,0,0,189,189
1653456732877,CSE 243A,A00,090124,Orailoglu; Alex,1,0,15,14
1653456733411,CSE 249B,A00,090125,Kahng; Andrew Byun,13,0,20,7
1653456733937,CSE 250A,A00,090126,Berg-Kirkpatrick; Taylor D,0,0,0,0
1653456734459,CSE 252A,A00,090127,Ochoa; Benjamin Lawrence,0,0,0,0
1653456734981,CSE 258,A01,090129,McAuley; Julian John,0,0,0,0
1653456735504,CSE 258R,A01,090131,McAuley; Julian John,0,0,0,0
1653456736027,CSE 274,A00,090132,Ramamoorthi; Ravi,0,0,0,0
1653456736620,CSE 276A,A00,090133,Christensen; Henrik I,0,0,0,0
1653456737169,CSE 276C,A00,090134,Christensen; Henrik I,0,0,0,0
1653456737692,CSE 290,A00,090135,Bafna; Vineet,0,0,0,0
1653456737692,CSE 290,B00,090136,Ramamoorthi; Ravi,0,0,0,0
1653456737692,CSE 290,C00,090137,Li; Tzumao,9,0,10,1
1653456737692,CSE 290,D00,090138,Zhou; Yuan-Yuan,10,0,10,0
1653456737692,CSE 290,E00,090139,Christensen; Henrik I,10,0,10,0
1653456737692,CSE 290,F00,094053,Shalev; Aaron D,0,0,0,0
1653456738220,CSE 291,A00,090140,Munyaka; Imani N. S.,0,0,0,0
1653456738220,CSE 291,B00,094880,Yu; Qi,0,0,0,0
1653456738220,CSE 291,C00,090142,Pannuto; Patrick William,0,0,0,0
1653456738220,CSE 291,D00,094881,Zhang; Yiying,0,0,0,0
1653456738220,CSE 291,E00,095118,Su; Hao,0,0,0,0
1653456738751,CSE 293,001,094905,Bafna; Vineet,9999,0,9999,0
1653456738751,CSE 293,002,094906,Bellare; Mihir,9999,0,9999,0
1653456738751,CSE 293,003,094907,Berg-Kirkpatrick; Taylor D,9999,0,9999,0
1653456738751,CSE 293,004,094908,Christensen; Henrik I,9999,0,9999,0
1653456738751,CSE 293,005,094909,Cottrell; Garrison W,9999,0,9999,0
1653456738751,CSE 293,006,094910,Deutsch; Alin Bernard,9999,0,9999,0
1653456738751,CSE 293,007,094911,Esmaeilzadeh; Hadi,9999,0,9999,0
1653456738751,CSE 293,008,094912,Freund; Yoav,9999,0,9999,0
1653456738751,CSE 293,009,094913,Griswold; William G.,9999,0,9999,0
1653456738751,CSE 293,010,094914,Gymrek; Melissa Ann,9999,0,9999,0
1653456738751,CSE 293,011,094915,Heninger; Nadia A,9999,0,9999,0
1653456738751,CSE 293,012,094916,Impagliazzo; Russell,9999,0,9999,0
1653456738751,CSE 293,013,094917,Jhala; Ranjit,9999,0,9999,0
1653456738751,CSE 293,014,094918,Kahng; Andrew Byun,9999,0,9999,0
1653456738751,CSE 293,015,094919,Kane; Daniel Mertz,9999,0,9999,0
1653456738751,CSE 293,016,094920,Kriegman; David J,9999,0,9999,0
1653456738751,CSE 293,017,094921,Kumar; Arun Kumar,9999,0,9999,0
1653456738751,CSE 293,018,094922,Lerner; Sorin,9999,0,9999,0
1653456738751,CSE 293,019,094923,Lovett; Shachar,9999,0,9999,0
1653456738751,CSE 293,020,094924,McAuley; Julian John,9999,0,9999,0
1653456738751,CSE 293,021,094925,Micciancio; Daniele,9999,0,9999,0
1653456738751,CSE 293,022,094926,Orailoglu; Alex,9999,0,9999,0
1653456738751,CSE 293,023,094927,Paturi; Ramamohan,9999,0,9999,0
1653456738751,CSE 293,024,094928,Polikarpova; Nadezhda,9999,0,9999,0
1653456738751,CSE 293,025,094929,Politz; Joseph Gibbs,9999,0,9999,0
1653456738751,CSE 293,026,094930,Porter; George M,9999,0,9999,0
1653456738751,CSE 293,027,094931,Porter; Leonard Emerson,9999,0,9999,0
1653456738751,CSE 293,028,094932,Ramamoorthi; Ravi,9999,0,9999,0
1653456738751,CSE 293,029,094933,Sahoo; Debashis,9999,0,9999,0
1653456738751,CSE 293,030,094934,Saul; Lawrence,9999,0,9999,0
1653456738751,CSE 293,031,094935,Savage; Stefan,9999,0,9999,0
1653456738751,CSE 293,032,094936,Schulze; Jurgen P.,9999,0,9999,0
1653456738751,CSE 293,033,094937,Snoeren; Alex C.,9999,0,9999,0
1653456738751,CSE 293,034,094938,Shang; Jingbo,9999,0,9999,0
1653456738751,CSE 293,035,094939,Stefan; Deian,9999,0,9999,0
1653456738751,CSE 293,036,094940,Su; Hao,9999,0,9999,0
1653456738751,CSE 293,037,094941,Swanson; Steven James,9999,0,9999,0
1653456738751,CSE 293,038,094942,Tullsen; Dean Michael,9999,0,9999,0
1653456738751,CSE 293,039,094943,Voelker; Geoffrey M.,9999,0,9999,0
1653456738751,CSE 293,040,094944,Zhao; Jishen,9999,0,9999,0
1653456738751,CSE 293,041,094945,Zhou; Yuan-Yuan,9999,0,9999,0
1653456738751,CSE 293,042,094946,Gao; Sicun,9998,0,9999,1
1653456738751,CSE 293,043,094947,Weibel; Nadir,9999,0,9999,0
1653456738751,CSE 293,044,094948,Gupta; Rajesh K.,9999,0,9999,0
1653456739276,CSE 294,A00,090143,Porter; George M,9,0,10,1
1653456739802,DSE 200,A00,091799,Staff,50,0,50,0
1653456740334,DSE 203,A00,091800,Gupta; Amarnath,30,0,30,0
1653456740864,DSE 250,A00,091801,Deutsch; Alin Bernard,30,0,30,0
1653456741396,DSE 290,A00,091802,Altintas De Callaf; Ilkay,50,0,50,0
1653456741928,ECE 200,001,091003,Antipa; Nicholas A,9999,0,9999,0
1653456741928,ECE 200,002,091004,Atanasov; Nikolay A.,9999,0,9999,0
1653456741928,ECE 200,003,091005,Bharadia; Dinesh,9999,0,9999,0
1653456741928,ECE 200,004,091006,Cheng; Chung Kuan,9999,0,9999,0
1653456741928,ECE 200,005,091007,Cosman; Pamela C.,9999,0,9999,0
1653456741928,ECE 200,006,091008,Staff,9999,0,9999,0
1653456741928,ECE 200,007,091009,Dayeh; Shadi Ahmad,9999,0,9999,0
1653456741928,ECE 200,008,091010,Fainman; Yeshaiahu,9999,0,9999,0
1653456741928,ECE 200,009,091011,Ford; Joseph Earl,9999,0,9999,0
1653456741928,ECE 200,010,091012,Franceschetti; Massimo,9999,0,9999,0
1653456741928,ECE 200,011,091013,Fullerton; Eric E,9999,0,9999,0
1653456741928,ECE 200,012,091014,Galton; Ian A,9999,0,9999,0
1653456741928,ECE 200,013,091015,Gilja; Vikash,9999,0,9999,0
1653456741928,ECE 200,014,091016,Hall; Drew A.,9999,0,9999,0
1653456741928,ECE 200,015,091017,Hsueh; Tzu-Chien,9999,0,9999,0
1653456741928,ECE 200,016,091018,Javidi; Tara,9999,0,9999,0
1653456741928,ECE 200,017,091019,Kahng; Andrew Byun,9999,0,9999,0
1653456741928,ECE 200,018,091020,Kim; Young-Han,9999,0,9999,0
1653456741928,ECE 200,019,091021,Koushanfar; Farinaz,9999,0,9999,0
1653456741928,ECE 200,020,091022,Kuzum; Duygu,9999,0,9999,0
1653456741928,ECE 200,021,091023,Le; Hanh-Phuc,9999,0,9999,0
1653456741928,ECE 200,022,091024,Lin; Bill,9999,0,9999,0
1653456741928,ECE 200,023,091025,Liu; Zhaowei,9999,0,9999,0
1653456741928,ECE 200,024,091026,Lo; Yu-Hwa,9999,0,9999,0
1653456741928,ECE 200,025,091027,Lomakin; Vitaliy,9999,0,9999,0
1653456741928,ECE 200,026,091028,Mercier; Patrick Philip,9999,0,9999,0
1653456741928,ECE 200,027,091029,Meyer; Florian,9999,0,9999,0
1653456741928,ECE 200,028,091030,Milstein; Laurence B.,9999,0,9999,0
1653456741928,ECE 200,029,091031,Mir Arabbaygi; Siavash,9999,0,9999,0
1653456741928,ECE 200,030,091032,Mookherjea; Shayan,9999,0,9999,0
1653456741928,ECE 200,031,091033,Morris; Karcher William,9999,0,9999,0
1653456741928,ECE 200,032,091034,Ng; Tse Nga,9999,0,9999,0
1653456741928,ECE 200,033,091035,Nguyen; Truong Quang,9999,0,9999,0
1653456741928,ECE 200,034,091036,Nomura; Kenji,9999,0,9999,0
1653456741928,ECE 200,035,091037,Orlitsky; Alon,9999,0,9999,0
1653456741928,ECE 200,036,091038,Pal; Piya,9999,0,9999,0
1653456741928,ECE 200,037,091039,Papen; George C.,9999,0,9999,0
1653456741928,ECE 200,038,091040,Radic; Stojan,9999,0,9999,0
1653456741928,ECE 200,039,091041,Rao; Bhaskar D.,9999,0,9999,0
1653456741928,ECE 200,040,091042,Rao; Ramesh R,9999,0,9999,0
1653456741928,ECE 200,041,091043,Rebeiz; Gabriel,9999,0,9999,0
1653456741928,ECE 200,042,091044,Sanford; John R,9999,0,9999,0
1653456741928,ECE 200,043,091045,Siegel; Paul H.,9999,0,9999,0
1653456741928,ECE 200,044,091046,Sievenpiper; Daniel F.,9999,0,9999,0
1653456741928,ECE 200,045,091047,Sworder; David D.,9999,0,9999,0
1653456741928,ECE 200,046,091048,Taur; Yuan,9999,0,9999,0
1653456741928,ECE 200,047,091049,Touri; Behrouz,9999,0,9999,0
1653456741928,ECE 200,048,091050,Trivedi; Mohan M.,9999,0,9999,0
1653456741928,ECE 200,049,091051,Vardy; Alexander,9999,0,9999,0
1653456741928,ECE 200,050,091052,Vasconcelos; Nuno,9999,0,9999,0
1653456741928,ECE 200,051,091053,Wang; Xiaolong,9999,0,9999,0
1653456741928,ECE 200,052,091054,Xie; Pengtao,9999,0,9999,0
1653456741928,ECE 200,053,091055,Yip; Michael,9999,0,9999,0
1653456741928,ECE 200,054,091056,Zeger; Kenneth A.,9999,0,9999,0
1653456741928,ECE 200,055,091057,Zhang; Xinyu,9999,0,9999,0
1653456741928,ECE 200,056,091058,Turakhia; Yatish Girish,9999,0,9999,0
1653456741928,ECE 200,057,091059,Kang; Mingu,9999,0,9999,0
1653456741928,ECE 200,058,091060,Shi; Yuanyuan,9999,0,9999,0
1653456741928,ECE 200,059,091061,Wang; Edward Jay,9999,0,9999,0
1653456741928,ECE 200,060,091062,Zheng; Yang,9999,0,9999,0
1653456742451,ECE 203,A00,091065,Mercier; Patrick Philip,0,0,0,0
1653456742975,ECE 207A,A00,091605,Liu; Thomas Tao-Ming,0,0,0,0
1653456743505,ECE 212AN,A00,091068,Nomura; Kenji,0,0,0,0
1653456744028,ECE 222A,A00,091069,Rebeiz; Gabriel,0,0,0,0
1653456744558,ECE 225A,A00,091070,Orlitsky; Alon,0,0,0,0
1653456745084,ECE 230A,A00,091071,Nomura; Kenji,0,0,0,0
1653456745606,ECE 236A,A00,091072,Dayeh; Shadi Ahmad,0,0,0,0
1653456746140,ECE 238A,A00,091073,Luo; Jian,0,0,0,0
1653456746140,ECE 238A,B00,091074,Luo; Jian,0,0,0,0
1653456746663,ECE 240A,A00,091075,Radic; Stojan,0,0,0,0
1653456747188,ECE 247A,A00,091592,Shi; Lingyan,0,0,0,0
1653456747712,ECE 250,A00,091076,Touri; Behrouz,0,0,0,0
1653456748247,ECE 251C,A00,091078,Nguyen; Truong Quang,0,0,0,0
1653456748773,ECE 253,A00,091079,Cosman; Pamela C.,0,0,0,0
1653456749295,ECE 255A,A00,091080,Orlitsky; Alon,0,0,0,0
1653456749821,ECE 257A,A00,091081,Zhang; Xinyu,0,0,0,0
1653456750349,ECE 260A,A01,091084,Eldon; John,0,0,0,0
1653456750872,ECE 264C,A00,091085,Galton; Ian A,0,0,0,0
1653456751399,ECE 265C,A00,094889,Presti; Calogero Davide,0,0,0,9
1653456751925,ECE 266,A01,091087,Hall; Drew A.,0,0,0,0
1653456752973,ECE 271A,A00,091090,Vasconcelos; Nuno,0,0,0,0
1653456753509,ECE 272B,A00,091091,Sworder; David D.,0,0,0,0
1653456754043,ECE 275A,A00,091092,Meyer; Florian,0,0,0,0
1653456754571,ECE 277,A00,091093,An; Cheolhong,0,0,0,0
1653456755093,ECE 283,A00,091094,Le; Hanh-Phuc,0,0,0,0
1653456755617,ECE 284,A00,091095,Kang; Mingu,0,0,0,0
1653456755617,ECE 284,B00,091096,Wang; Edward Jay,0,0,0,0
1653456756150,ECE 285,A00,094334,Touri; Behrouz,0,0,0,0
1653456756673,ECE 289,A00,091097,Whelan; David Arthur,0,0,0,0
1653456757210,MATH 200A,A00,087414,Salehi Golsefidy; Alireza,7,0,8,1
1653456757733,MATH 202A,A00,087415,Gill; Philip E.,3,0,8,5
1653456758263,MATH 203A,A00,087416,Oprea; Dragos N.,6,0,8,2
1653456758789,MATH 204A,A00,087417,Kedlaya; Kiran S.,6,0,8,2
1653456759312,MATH 205,A00,087418,Sorensen; Claus M,6,0,8,2
1653456759846,MATH 206A,A00,087419,Izadi; Elham,7,0,8,1
1653456760372,MATH 207A,A00,087420,Mohammadi; Amir,6,0,8,2
1653456760893,MATH 208,A00,087421,Staff,9,0,10,1
1653456761414,MATH 209,A00,087422,Staff,10,0,10,0
1653456761935,MATH 218,A00,087423,Staff,10,0,10,0
1653456762458,MATH 220A,A00,087424,Novak; Jonathan I,7,0,8,1
1653456762984,MATH 231A,A00,087425,Bejenaru; Ioan,3,0,8,5
1653456763511,MATH 240A,A00,087426,Ebenfelt; Peter F,5,0,8,3
1653456764033,MATH 243,A00,087427,Staff,9,0,10,1
1653456764558,MATH 248,A00,087429,Staff,10,0,10,0
1653456765084,MATH 250A,A00,087430,Spolaor; Luca,4,0,8,4
1653456765606,MATH 257A,A00,087431,Spolaor; Luca,7,0,8,1
1653456766129,MATH 258,A00,087432,Staff,9,0,10,1
1653456766652,MATH 264A,A00,087433,Warnke; Lutz Peter,5,0,8,3
1653456767177,MATH 268,A00,087434,Staff,15,0,15,0
1653456767702,MATH 269,A00,087435,Staff,14,0,15,1
1653456768227,MATH 270A,A00,087436,Nie; Jiawang,0,0,8,8
1653456768750,MATH 272A,A00,087437,Tian; Xiaochuan,1,0,8,7
1653456769277,MATH 274,A01,087439,Cheng; Li-Tien,9,0,10,1
1653456769277,MATH 274,A02,087440,Cheng; Li-Tien,10,0,10,0
1653456769812,MATH 278A,A00,087441,Staff,8,0,10,2
1653456770334,MATH 278B,A00,087442,Staff,8,0,10,2
1653456770862,MATH 278C,A00,087443,Staff,8,0,10,2
1653456771392,MATH 280A,A00,087444,Zheng; Tianyi,0,0,8,8
1653456771918,MATH 281A,A00,087445,Bradic; Jelena,0,0,8,8
1653456772441,MATH 282A,A00,087446,Zhang; Danna,0,0,8,8
1653456772967,MATH 283,A00,087447,Tesler; Glenn,0,0,0,14
1653456773490,MATH 286,A00,087448,Kemp; Todd Aahron,5,0,8,3
1653456774012,MATH 287D,A00,087449,Bradic; Jelena,8,0,8,0
1653456774535,MATH 288,A00,087450,Staff,14,0,15,1
1653456774535,MATH 288,B00,087451,Staff,15,0,15,0
1653456774535,MATH 288,C00,087452,Staff,15,0,15,0
1653456775065,MATH 290A,A00,087453,Xu; Zhouli,7,0,8,1
1653456775590,MATH 291A,A00,087454,Xu; Zhouli,7,0,8,1
1653456776114,MATH 292,A00,087455,Staff,10,0,10,0
1653456776637,MATH 295,A00,087456,Staff,50,0,50,0
1653456777165,MATH 297,001,087457,Staff,998,0,999,1
1653457337915,COGS 200,A01,087991,Staff,47,0,50,3
1653457338438,COGS 201,A01,094504,Rangel; Lara M,17,0,25,8
1653457338959,COGS 203,A00,087992,Coulson; Seana M,18,0,20,2
1653457339483,COGS 210A,001,087993,Greene; Deanna Jacquelyn,9998,0,9999,1
1653457339483,COGS 210A,002,087994,Saygin; Ayse P,9999,0,9999,0
1653457339483,COGS 210A,003,087995,Xia; Haijun,9999,0,9999,0
1653457339483,COGS 210A,004,087996,Nitz; Douglas A.,9999,0,9999,0
1653457339483,COGS 210A,005,087997,Hollan; James D.,9999,0,9999,0
1653457339483,COGS 210A,006,087998,Deak; Gedeon O.,9998,0,9999,1
1653457339483,COGS 210A,007,087999,Rossano; Federico,9999,0,9999,0
1653457340003,COGS 211A,A00,088000,Coulson; Seana M,9997,0,9999,2
1653457340525,COGS 229,A00,088002,Staff,23,0,25,2
1653457341050,COGS 260,B00,094231,Staff,17,0,20,3
1653457341050,COGS 260,A00,088004,Nitz; Douglas A.,9998,0,9999,1
1653457341574,CSE 202,A00,090110,Paturi; Ramamohan,0,0,0,0
1653457341574,CSE 202,B00,090111,Paturi; Ramamohan,0,0,0,0
1653457342101,CSE 207B,A00,090112,Heninger; Nadia A,0,0,0,0
1653457342624,CSE 208,A00,094858,Micciancio; Daniele,0,0,0,0
1653457343150,CSE 210,A00,090113,Powell; Thomas Allan,0,0,0,0
1653457343673,CSE 219,A00,090898,Staff,0,0,0,0
1653457344196,CSE 221,A00,090114,Zhou; Yuan-Yuan,0,0,0,0
1653457344725,CSE 229A,A00,090115,Porter; George M,0,0,0,0
1653457345248,CSE 229C,A00,090116,Savage; Stefan,0,0,0,0
1653457345774,CSE 230,A00,090117,Jhala; Ranjit,0,0,0,0
1653457346303,CSE 232,A00,090118,Papakonstantinou; Yannis,0,0,0,0
1653457346828,CSE 239A,A00,090121,Kumar; Arun Kumar,0,0,0,0
1653457347351,CSE 239B,A00,090122,Jhala; Ranjit,0,0,0,0
1653457347876,CSE 240A,A00,090123,Zhao; Jishen,0,0,189,189
1653457348398,CSE 243A,A00,090124,Orailoglu; Alex,1,0,15,14
1653457348935,CSE 249B,A00,090125,Kahng; Andrew Byun,13,0,20,7
1653457349459,CSE 250A,A00,090126,Berg-Kirkpatrick; Taylor D,0,0,0,0
1653457349985,CSE 252A,A00,090127,Ochoa; Benjamin Lawrence,0,0,0,0
1653457350506,CSE 258,A01,090129,McAuley; Julian John,0,0,0,0
1653457351028,CSE 258R,A01,090131,McAuley; Julian John,0,0,0,0
1653457351559,CSE 274,A00,090132,Ramamoorthi; Ravi,0,0,0,0
1653457352088,CSE 276A,A00,090133,Christensen; Henrik I,0,0,0,0
1653457352613,CSE 276C,A00,090134,Christensen; Henrik I,0,0,0,0
1653457353136,CSE 290,A00,090135,Bafna; Vineet,0,0,0,0
1653457353136,CSE 290,B00,090136,Ramamoorthi; Ravi,0,0,0,0
1653457353136,CSE 290,C00,090137,Li; Tzumao,9,0,10,1
1653457353136,CSE 290,D00,090138,Zhou; Yuan-Yuan,10,0,10,0
1653457353136,CSE 290,E00,090139,Christensen; Henrik I,10,0,10,0
1653457353136,CSE 290,F00,094053,Shalev; Aaron D,0,0,0,0
1653457353665,CSE 291,A00,090140,Munyaka; Imani N. S.,0,0,0,0
1653457353665,CSE 291,B00,094880,Yu; Qi,0,0,0,0
1653457353665,CSE 291,C00,090142,Pannuto; Patrick William,0,0,0,0
1653457353665,CSE 291,D00,094881,Zhang; Yiying,0,0,0,0
1653457353665,CSE 291,E00,095118,Su; Hao,0,0,0,0
1653457354200,CSE 293,001,094905,Bafna; Vineet,9999,0,9999,0
1653457354200,CSE 293,002,094906,Bellare; Mihir,9999,0,9999,0
1653457354200,CSE 293,003,094907,Berg-Kirkpatrick; Taylor D,9999,0,9999,0
1653457354200,CSE 293,004,094908,Christensen; Henrik I,9999,0,9999,0
1653457354200,CSE 293,005,094909,Cottrell; Garrison W,9999,0,9999,0
1653457354200,CSE 293,006,094910,Deutsch; Alin Bernard,9999,0,9999,0
1653457354200,CSE 293,007,094911,Esmaeilzadeh; Hadi,9999,0,9999,0
1653457354200,CSE 293,008,094912,Freund; Yoav,9999,0,9999,0
1653457354200,CSE 293,009,094913,Griswold; William G.,9999,0,9999,0
1653457354200,CSE 293,010,094914,Gymrek; Melissa Ann,9999,0,9999,0
1653457354200,CSE 293,011,094915,Heninger; Nadia A,9999,0,9999,0
1653457354200,CSE 293,012,094916,Impagliazzo; Russell,9999,0,9999,0
1653457354200,CSE 293,013,094917,Jhala; Ranjit,9999,0,9999,0
1653457354200,CSE 293,014,094918,Kahng; Andrew Byun,9999,0,9999,0
1653457354200,CSE 293,015,094919,Kane; Daniel Mertz,9999,0,9999,0
1653457354200,CSE 293,016,094920,Kriegman; David J,9999,0,9999,0
1653457354200,CSE 293,017,094921,Kumar; Arun Kumar,9999,0,9999,0
1653457354200,CSE 293,018,094922,Lerner; Sorin,9999,0,9999,0
1653457354200,CSE 293,019,094923,Lovett; Shachar,9999,0,9999,0
1653457354200,CSE 293,020,094924,McAuley; Julian John,9999,0,9999,0
1653457354200,CSE 293,021,094925,Micciancio; Daniele,9999,0,9999,0
1653457354200,CSE 293,022,094926,Orailoglu; Alex,9999,0,9999,0
1653457354200,CSE 293,023,094927,Paturi; Ramamohan,9999,0,9999,0
1653457354200,CSE 293,024,094928,Polikarpova; Nadezhda,9999,0,9999,0
1653457354200,CSE 293,025,094929,Politz; Joseph Gibbs,9999,0,9999,0
1653457354200,CSE 293,026,094930,Porter; George M,9999,0,9999,0
1653457354200,CSE 293,027,094931,Porter; Leonard Emerson,9999,0,9999,0
1653457354200,CSE 293,028,094932,Ramamoorthi; Ravi,9999,0,9999,0
1653457354200,CSE 293,029,094933,Sahoo; Debashis,9999,0,9999,0
1653457354200,CSE 293,030,094934,Saul; Lawrence,9999,0,9999,0
1653457354200,CSE 293,031,094935,Savage; Stefan,9999,0,9999,0
1653457354200,CSE 293,032,094936,Schulze; Jurgen P.,9999,0,9999,0
1653457354200,CSE 293,033,094937,Snoeren; Alex C.,9999,0,9999,0
1653457354200,CSE 293,034,094938,Shang; Jingbo,9999,0,9999,0
1653457354200,CSE 293,035,094939,Stefan; Deian,9999,0,9999,0
1653457354200,CSE 293,036,094940,Su; Hao,9999,0,9999,0
1653457354200,CSE 293,037,094941,Swanson; Steven James,9999,0,9999,0
1653457354200,CSE 293,038,094942,Tullsen; Dean Michael,9999,0,9999,0
1653457354200,CSE 293,039,094943,Voelker; Geoffrey M.,9999,0,9999,0
1653457354200,CSE 293,040,094944,Zhao; Jishen,9999,0,9999,0
1653457354200,CSE 293,041,094945,Zhou; Yuan-Yuan,9999,0,9999,0
1653457354200,CSE 293,042,094946,Gao; Sicun,9998,0,9999,1
1653457354200,CSE 293,043,094947,Weibel; Nadir,9999,0,9999,0
1653457354200,CSE 293,044,094948,Gupta; Rajesh K.,9999,0,9999,0
1653457354723,CSE 294,A00,090143,Porter; George M,9,0,10,1
1653457355248,DSE 200,A00,091799,Staff,50,0,50,0
1653457355782,DSE 203,A00,091800,Gupta; Amarnath,30,0,30,0
1653457356308,DSE 250,A00,091801,Deutsch; Alin Bernard,30,0,30,0
1653457356831,DSE 290,A00,091802,Altintas De Callaf; Ilkay,50,0,50,0
1653457357363,ECE 200,001,091003,Antipa; Nicholas A,9999,0,9999,0
1653457357363,ECE 200,002,091004,Atanasov; Nikolay A.,9999,0,9999,0
1653457357363,ECE 200,003,091005,Bharadia; Dinesh,9999,0,9999,0
1653457357363,ECE 200,004,091006,Cheng; Chung Kuan,9999,0,9999,0
1653457357363,ECE 200,005,091007,Cosman; Pamela C.,9999,0,9999,0
1653457357363,ECE 200,006,091008,Staff,9999,0,9999,0
1653457357363,ECE 200,007,091009,Dayeh; Shadi Ahmad,9999,0,9999,0
1653457357363,ECE 200,008,091010,Fainman; Yeshaiahu,9999,0,9999,0
1653457357363,ECE 200,009,091011,Ford; Joseph Earl,9999,0,9999,0
1653457357363,ECE 200,010,091012,Franceschetti; Massimo,9999,0,9999,0
1653457357363,ECE 200,011,091013,Fullerton; Eric E,9999,0,9999,0
1653457357363,ECE 200,012,091014,Galton; Ian A,9999,0,9999,0
1653457357363,ECE 200,013,091015,Gilja; Vikash,9999,0,9999,0
1653457357363,ECE 200,014,091016,Hall; Drew A.,9999,0,9999,0
1653457357363,ECE 200,015,091017,Hsueh; Tzu-Chien,9999,0,9999,0
1653457357363,ECE 200,016,091018,Javidi; Tara,9999,0,9999,0
1653457357363,ECE 200,017,091019,Kahng; Andrew Byun,9999,0,9999,0
1653457357363,ECE 200,018,091020,Kim; Young-Han,9999,0,9999,0
1653457357363,ECE 200,019,091021,Koushanfar; Farinaz,9999,0,9999,0
1653457357363,ECE 200,020,091022,Kuzum; Duygu,9999,0,9999,0
1653457357363,ECE 200,021,091023,Le; Hanh-Phuc,9999,0,9999,0
1653457357363,ECE 200,022,091024,Lin; Bill,9999,0,9999,0
1653457357363,ECE 200,023,091025,Liu; Zhaowei,9999,0,9999,0
1653457357363,ECE 200,024,091026,Lo; Yu-Hwa,9999,0,9999,0
1653457357363,ECE 200,025,091027,Lomakin; Vitaliy,9999,0,9999,0
1653457357363,ECE 200,026,091028,Mercier; Patrick Philip,9999,0,9999,0
1653457357363,ECE 200,027,091029,Meyer; Florian,9999,0,9999,0
1653457357363,ECE 200,028,091030,Milstein; Laurence B.,9999,0,9999,0
1653457357363,ECE 200,029,091031,Mir Arabbaygi; Siavash,9999,0,9999,0
1653457357363,ECE 200,030,091032,Mookherjea; Shayan,9999,0,9999,0
1653457357363,ECE 200,031,091033,Morris; Karcher William,9999,0,9999,0
1653457357363,ECE 200,032,091034,Ng; Tse Nga,9999,0,9999,0
1653457357363,ECE 200,033,091035,Nguyen; Truong Quang,9999,0,9999,0
1653457357363,ECE 200,034,091036,Nomura; Kenji,9999,0,9999,0
1653457357363,ECE 200,035,091037,Orlitsky; Alon,9999,0,9999,0
1653457357363,ECE 200,036,091038,Pal; Piya,9999,0,9999,0
1653457357363,ECE 200,037,091039,Papen; George C.,9999,0,9999,0
1653457357363,ECE 200,038,091040,Radic; Stojan,9999,0,9999,0
1653457357363,ECE 200,039,091041,Rao; Bhaskar D.,9999,0,9999,0
1653457357363,ECE 200,040,091042,Rao; Ramesh R,9999,0,9999,0
1653457357363,ECE 200,041,091043,Rebeiz; Gabriel,9999,0,9999,0
1653457357363,ECE 200,042,091044,Sanford; John R,9999,0,9999,0
1653457357363,ECE 200,043,091045,Siegel; Paul H.,9999,0,9999,0
1653457357363,ECE 200,044,091046,Sievenpiper; Daniel F.,9999,0,9999,0
1653457357363,ECE 200,045,091047,Sworder; David D.,9999,0,9999,0
1653457357363,ECE 200,046,091048,Taur; Yuan,9999,0,9999,0
1653457357363,ECE 200,047,091049,Touri; Behrouz,9999,0,9999,0
1653457357363,ECE 200,048,091050,Trivedi; Mohan M.,9999,0,9999,0
1653457357363,ECE 200,049,091051,Vardy; Alexander,9999,0,9999,0
1653457357363,ECE 200,050,091052,Vasconcelos; Nuno,9999,0,9999,0
1653457357363,ECE 200,051,091053,Wang; Xiaolong,9999,0,9999,0
1653457357363,ECE 200,052,091054,Xie; Pengtao,9999,0,9999,0
1653457357363,ECE 200,053,091055,Yip; Michael,9999,0,9999,0
1653457357363,ECE 200,054,091056,Zeger; Kenneth A.,9999,0,9999,0
1653457357363,ECE 200,055,091057,Zhang; Xinyu,9999,0,9999,0
1653457357363,ECE 200,056,091058,Turakhia; Yatish Girish,9999,0,9999,0
1653457357363,ECE 200,057,091059,Kang; Mingu,9999,0,9999,0
1653457357363,ECE 200,058,091060,Shi; Yuanyuan,9999,0,9999,0
1653457357363,ECE 200,059,091061,Wang; Edward Jay,9999,0,9999,0
1653457357363,ECE 200,060,091062,Zheng; Yang,9999,0,9999,0
1653457357886,ECE 203,A00,091065,Mercier; Patrick Philip,0,0,0,0
1653457358414,ECE 207A,A00,091605,Liu; Thomas Tao-Ming,0,0,0,0
1653457358948,ECE 212AN,A00,091068,Nomura; Kenji,0,0,0,0
1653457359471,ECE 222A,A00,091069,Rebeiz; Gabriel,0,0,0,0
1653457359996,ECE 225A,A00,091070,Orlitsky; Alon,0,0,0,0
1653457360519,ECE 230A,A00,091071,Nomura; Kenji,0,0,0,0
1653457361044,ECE 236A,A00,091072,Dayeh; Shadi Ahmad,0,0,0,0
1653457361577,ECE 238A,A00,091073,Luo; Jian,0,0,0,0
1653457361577,ECE 238A,B00,091074,Luo; Jian,0,0,0,0
1653457362099,ECE 240A,A00,091075,Radic; Stojan,0,0,0,0
1653457362622,ECE 247A,A00,091592,Shi; Lingyan,0,0,0,0
1653457363148,ECE 250,A00,091076,Touri; Behrouz,0,0,0,0
1653457363670,ECE 251C,A00,091078,Nguyen; Truong Quang,0,0,0,0
1653457364199,ECE 253,A00,091079,Cosman; Pamela C.,0,0,0,0
1653457364722,ECE 255A,A00,091080,Orlitsky; Alon,0,0,0,0
1653457365245,ECE 257A,A00,091081,Zhang; Xinyu,0,0,0,0
1653457365768,ECE 260A,A01,091084,Eldon; John,0,0,0,0
1653457366303,ECE 264C,A00,091085,Galton; Ian A,0,0,0,0
1653457366827,ECE 265C,A00,094889,Presti; Calogero Davide,0,0,0,9
1653457367349,ECE 266,A01,091087,Hall; Drew A.,0,0,0,0
1653457368400,ECE 271A,A00,091090,Vasconcelos; Nuno,0,0,0,0
1653457368921,ECE 272B,A00,091091,Sworder; David D.,0,0,0,0
1653457369444,ECE 275A,A00,091092,Meyer; Florian,0,0,0,0
1653457369968,ECE 277,A00,091093,An; Cheolhong,0,0,0,0
1653457370493,ECE 283,A00,091094,Le; Hanh-Phuc,0,0,0,0
1653457371022,ECE 284,A00,091095,Kang; Mingu,0,0,0,0
1653457371022,ECE 284,B00,091096,Wang; Edward Jay,0,0,0,0
1653457371546,ECE 285,A00,094334,Touri; Behrouz,0,0,0,0
1653457372086,ECE 289,A00,091097,Whelan; David Arthur,0,0,0,0
1653457372617,MATH 200A,A00,087414,Salehi Golsefidy; Alireza,7,0,8,1
1653457373145,MATH 202A,A00,087415,Gill; Philip E.,3,0,8,5
1653457373668,MATH 203A,A00,087416,Oprea; Dragos N.,6,0,8,2
1653457374206,MATH 204A,A00,087417,Kedlaya; Kiran S.,6,0,8,2
1653457374730,MATH 205,A00,087418,Sorensen; Claus M,6,0,8,2
1653457375252,MATH 206A,A00,087419,Izadi; Elham,7,0,8,1
1653457375775,MATH 207A,A00,087420,Mohammadi; Amir,6,0,8,2
1653457376305,MATH 208,A00,087421,Staff,9,0,10,1
1653457376834,MATH 209,A00,087422,Staff,10,0,10,0
1653457377357,MATH 218,A00,087423,Staff,10,0,10,0
1653457377957,MATH 220A,A00,087424,Novak; Jonathan I,7,0,8,1
1653457378482,MATH 231A,A00,087425,Bejenaru; Ioan,3,0,8,5
1653457379014,MATH 240A,A00,087426,Ebenfelt; Peter F,5,0,8,3
1653457379538,MATH 243,A00,087427,Staff,9,0,10,1
1653457380061,MATH 248,A00,087429,Staff,10,0,10,0
1653457380592,MATH 250A,A00,087430,Spolaor; Luca,4,0,8,4
1653457381118,MATH 257A,A00,087431,Spolaor; Luca,7,0,8,1
1653457381645,MATH 258,A00,087432,Staff,9,0,10,1
1653457382168,MATH 264A,A00,087433,Warnke; Lutz Peter,5,0,8,3
1653457382710,MATH 268,A00,087434,Staff,15,0,15,0
1653457383233,MATH 269,A00,087435,Staff,14,0,15,1
1653457383763,MATH 270A,A00,087436,Nie; Jiawang,0,0,8,8
1653457384286,MATH 272A,A00,087437,Tian; Xiaochuan,1,0,8,7
1653457384809,MATH 274,A01,087439,Cheng; Li-Tien,9,0,10,1
1653457384809,MATH 274,A02,087440,Cheng; Li-Tien,10,0,10,0
1653457385340,MATH 278A,A00,087441,Staff,8,0,10,2
1653457385872,MATH 278B,A00,087442,Staff,8,0,10,2
1653457386396,MATH 278C,A00,087443,Staff,8,0,10,2
1653457386921,MATH 280A,A00,087444,Zheng; Tianyi,0,0,8,8
1653457387454,MATH 281A,A00,087445,Bradic; Jelena,0,0,8,8
1653457387977,MATH 282A,A00,087446,Zhang; Danna,0,0,8,8
1653457388501,MATH 283,A00,087447,Tesler; Glenn,0,0,0,14
1653457389027,MATH 286,A00,087448,Kemp; Todd Aahron,5,0,8,3
1653457389555,MATH 287D,A00,087449,Bradic; Jelena,8,0,8,0
1653457390082,MATH 288,A00,087450,Staff,14,0,15,1
1653457390082,MATH 288,B00,087451,Staff,15,0,15,0
1653457390082,MATH 288,C00,087452,Staff,15,0,15,0
1653457390613,MATH 290A,A00,087453,Xu; Zhouli,7,0,8,1
1653457391136,MATH 291A,A00,087454,Xu; Zhouli,7,0,8,1
1653457391660,MATH 292,A00,087455,Staff,10,0,10,0
1653457392184,MATH 295,A00,087456,Staff,50,0,50,0
1653457392710,MATH 297,001,087457,Staff,998,0,999,1
1653457952081,COGS 200,A01,087991,Staff,47,0,50,3
1653457952608,COGS 201,A01,094504,Rangel; Lara M,17,0,25,8
1653457953130,COGS 203,A00,087992,Coulson; Seana M,18,0,20,2
1653457953653,COGS 210A,001,087993,Greene; Deanna Jacquelyn,9998,0,9999,1
1653457953653,COGS 210A,002,087994,Saygin; Ayse P,9999,0,9999,0
1653457953653,COGS 210A,003,087995,Xia; Haijun,9999,0,9999,0
1653457953653,COGS 210A,004,087996,Nitz; Douglas A.,9999,0,9999,0
1653457953653,COGS 210A,005,087997,Hollan; James D.,9999,0,9999,0
1653457953653,COGS 210A,006,087998,Deak; Gedeon O.,9998,0,9999,1
1653457953653,COGS 210A,007,087999,Rossano; Federico,9999,0,9999,0
1653457954176,COGS 211A,A00,088000,Coulson; Seana M,9997,0,9999,2
1653457954698,COGS 229,A00,088002,Staff,23,0,25,2
1653457955226,COGS 260,B00,094231,Staff,17,0,20,3
1653457955226,COGS 260,A00,088004,Nitz; Douglas A.,9998,0,9999,1
1653457955748,CSE 202,A00,090110,Paturi; Ramamohan,0,0,0,0
1653457955748,CSE 202,B00,090111,Paturi; Ramamohan,0,0,0,0
1653457956270,CSE 207B,A00,090112,Heninger; Nadia A,0,0,0,0
1653457956800,CSE 208,A00,094858,Micciancio; Daniele,0,0,0,0
1653457957327,CSE 210,A00,090113,Powell; Thomas Allan,0,0,0,0
1653457957851,CSE 219,A00,090898,Staff,0,0,0,0
1653457958378,CSE 221,A00,090114,Zhou; Yuan-Yuan,0,0,0,0
1653457958900,CSE 229A,A00,090115,Porter; George M,0,0,0,0
1653457959423,CSE 229C,A00,090116,Savage; Stefan,0,0,0,0
1653457959949,CSE 230,A00,090117,Jhala; Ranjit,0,0,0,0
1653457960474,CSE 232,A00,090118,Papakonstantinou; Yannis,0,0,0,0
1653457960998,CSE 239A,A00,090121,Kumar; Arun Kumar,0,0,0,0
1653457961522,CSE 239B,A00,090122,Jhala; Ranjit,0,0,0,0
1653457962046,CSE 240A,A00,090123,Zhao; Jishen,0,0,189,189
1653457962569,CSE 243A,A00,090124,Orailoglu; Alex,1,0,15,14
1653457963091,CSE 249B,A00,090125,Kahng; Andrew Byun,13,0,20,7
1653457963614,CSE 250A,A00,090126,Berg-Kirkpatrick; Taylor D,0,0,0,0
1653457964139,CSE 252A,A00,090127,Ochoa; Benjamin Lawrence,0,0,0,0
1653457964754,CSE 258,A01,090129,McAuley; Julian John,0,0,0,0
1653457965285,CSE 258R,A01,090131,McAuley; Julian John,0,0,0,0
1653457965815,CSE 274,A00,090132,Ramamoorthi; Ravi,0,0,0,0
1653457966338,CSE 276A,A00,090133,Christensen; Henrik I,0,0,0,0
1653457966867,CSE 276C,A00,090134,Christensen; Henrik I,0,0,0,0
1653457967389,CSE 290,A00,090135,Bafna; Vineet,0,0,0,0
1653457967389,CSE 290,B00,090136,Ramamoorthi; Ravi,0,0,0,0
1653457967389,CSE 290,C00,090137,Li; Tzumao,9,0,10,1
1653457967389,CSE 290,D00,090138,Zhou; Yuan-Yuan,10,0,10,0
1653457967389,CSE 290,E00,090139,Christensen; Henrik I,10,0,10,0
1653457967389,CSE 290,F00,094053,Shalev; Aaron D,0,0,0,0
1653457967913,CSE 291,A00,090140,Munyaka; Imani N. S.,0,0,0,0
1653457967913,CSE 291,B00,094880,Yu; Qi,0,0,0,0
1653457967913,CSE 291,C00,090142,Pannuto; Patrick William,0,0,0,0
1653457967913,CSE 291,D00,094881,Zhang; Yiying,0,0,0,0
1653457967913,CSE 291,E00,095118,Su; Hao,0,0,0,0
1653457968453,CSE 293,001,094905,Bafna; Vineet,9999,0,9999,0
1653457968453,CSE 293,002,094906,Bellare; Mihir,9999,0,9999,0
1653457968453,CSE 293,003,094907,Berg-Kirkpatrick; Taylor D,9999,0,9999,0
1653457968453,CSE 293,004,094908,Christensen; Henrik I,9999,0,9999,0
1653457968453,CSE 293,005,094909,Cottrell; Garrison W,9999,0,9999,0
1653457968453,CSE 293,006,094910,Deutsch; Alin Bernard,9999,0,9999,0
1653457968453,CSE 293,007,094911,Esmaeilzadeh; Hadi,9999,0,9999,0
1653457968453,CSE 293,008,094912,Freund; Yoav,9999,0,9999,0
1653457968453,CSE 293,009,094913,Griswold; William G.,9999,0,9999,0
1653457968453,CSE 293,010,094914,Gymrek; Melissa Ann,9999,0,9999,0
1653457968453,CSE 293,011,094915,Heninger; Nadia A,9999,0,9999,0
1653457968453,CSE 293,012,094916,Impagliazzo; Russell,9999,0,9999,0
1653457968453,CSE 293,013,094917,Jhala; Ranjit,9999,0,9999,0
1653457968453,CSE 293,014,094918,Kahng; Andrew Byun,9999,0,9999,0
1653457968453,CSE 293,015,094919,Kane; Daniel Mertz,9999,0,9999,0
1653457968453,CSE 293,016,094920,Kriegman; David J,9999,0,9999,0
1653457968453,CSE 293,017,094921,Kumar; Arun Kumar,9999,0,9999,0
1653457968453,CSE 293,018,094922,Lerner; Sorin,9999,0,9999,0
1653457968453,CSE 293,019,094923,Lovett; Shachar,9999,0,9999,0
1653457968453,CSE 293,020,094924,McAuley; Julian John,9999,0,9999,0
1653457968453,CSE 293,021,094925,Micciancio; Daniele,9999,0,9999,0
1653457968453,CSE 293,022,094926,Orailoglu; Alex,9999,0,9999,0
1653457968453,CSE 293,023,094927,Paturi; Ramamohan,9999,0,9999,0
1653457968453,CSE 293,024,094928,Polikarpova; Nadezhda,9999,0,9999,0
1653457968453,CSE 293,025,094929,Politz; Joseph Gibbs,9999,0,9999,0
1653457968453,CSE 293,026,094930,Porter; George M,9999,0,9999,0
1653457968453,CSE 293,027,094931,Porter; Leonard Emerson,9999,0,9999,0
1653457968453,CSE 293,028,094932,Ramamoorthi; Ravi,9999,0,9999,0
1653457968453,CSE 293,029,094933,Sahoo; Debashis,9999,0,9999,0
1653457968453,CSE 293,030,094934,Saul; Lawrence,9999,0,9999,0
1653457968453,CSE 293,031,094935,Savage; Stefan,9999,0,9999,0
1653457968453,CSE 293,032,094936,Schulze; Jurgen P.,9999,0,9999,0
1653457968453,CSE 293,033,094937,Snoeren; Alex C.,9999,0,9999,0
1653457968453,CSE 293,034,094938,Shang; Jingbo,9999,0,9999,0
1653457968453,CSE 293,035,094939,Stefan; Deian,9999,0,9999,0
1653457968453,CSE 293,036,094940,Su; Hao,9999,0,9999,0
1653457968453,CSE 293,037,094941,Swanson; Steven James,9999,0,9999,0
1653457968453,CSE 293,038,094942,Tullsen; Dean Michael,9999,0,9999,0
1653457968453,CSE 293,039,094943,Voelker; Geoffrey M.,9999,0,9999,0
1653457968453,CSE 293,040,094944,Zhao; Jishen,9999,0,9999,0
1653457968453,CSE 293,041,094945,Zhou; Yuan-Yuan,9999,0,9999,0
1653457968453,CSE 293,042,094946,Gao; Sicun,9998,0,9999,1
1653457968453,CSE 293,043,094947,Weibel; Nadir,9999,0,9999,0
1653457968453,CSE 293,044,094948,Gupta; Rajesh K.,9999,0,9999,0
1653457968975,CSE 294,A00,090143,Porter; George M,9,0,10,1
1653457969506,DSE 200,A00,091799,Staff,50,0,50,0
1653457970032,DSE 203,A00,091800,Gupta; Amarnath,30,0,30,0
1653457970557,DSE 250,A00,091801,Deutsch; Alin Bernard,30,0,30,0
1653457971079,DSE 290,A00,091802,Altintas De Callaf; Ilkay,50,0,50,0
1653457971619,ECE 200,001,091003,Antipa; Nicholas A,9999,0,9999,0
1653457971619,ECE 200,002,091004,Atanasov; Nikolay A.,9999,0,9999,0
1653457971619,ECE 200,003,091005,Bharadia; Dinesh,9999,0,9999,0
1653457971619,ECE 200,004,091006,Cheng; Chung Kuan,9999,0,9999,0
1653457971619,ECE 200,005,091007,Cosman; Pamela C.,9999,0,9999,0
1653457971619,ECE 200,006,091008,Staff,9999,0,9999,0
1653457971619,ECE 200,007,091009,Dayeh; Shadi Ahmad,9999,0,9999,0
1653457971619,ECE 200,008,091010,Fainman; Yeshaiahu,9999,0,9999,0
1653457971619,ECE 200,009,091011,Ford; Joseph Earl,9999,0,9999,0
1653457971619,ECE 200,010,091012,Franceschetti; Massimo,9999,0,9999,0
1653457971619,ECE 200,011,091013,Fullerton; Eric E,9999,0,9999,0
1653457971619,ECE 200,012,091014,Galton; Ian A,9999,0,9999,0
1653457971619,ECE 200,013,091015,Gilja; Vikash,9999,0,9999,0
1653457971619,ECE 200,014,091016,Hall; Drew A.,9999,0,9999,0
1653457971619,ECE 200,015,091017,Hsueh; Tzu-Chien,9999,0,9999,0
1653457971619,ECE 200,016,091018,Javidi; Tara,9999,0,9999,0
1653457971619,ECE 200,017,091019,Kahng; Andrew Byun,9999,0,9999,0
1653457971619,ECE 200,018,091020,Kim; Young-Han,9999,0,9999,0
1653457971619,ECE 200,019,091021,Koushanfar; Farinaz,9999,0,9999,0
1653457971619,ECE 200,020,091022,Kuzum; Duygu,9999,0,9999,0
1653457971619,ECE 200,021,091023,Le; Hanh-Phuc,9999,0,9999,0
1653457971619,ECE 200,022,091024,Lin; Bill,9999,0,9999,0
1653457971619,ECE 200,023,091025,Liu; Zhaowei,9999,0,9999,0
1653457971619,ECE 200,024,091026,Lo; Yu-Hwa,9999,0,9999,0
1653457971619,ECE 200,025,091027,Lomakin; Vitaliy,9999,0,9999,0
1653457971619,ECE 200,026,091028,Mercier; Patrick Philip,9999,0,9999,0
1653457971619,ECE 200,027,091029,Meyer; Florian,9999,0,9999,0
1653457971619,ECE 200,028,091030,Milstein; Laurence B.,9999,0,9999,0
1653457971619,ECE 200,029,091031,Mir Arabbaygi; Siavash,9999,0,9999,0
1653457971619,ECE 200,030,091032,Mookherjea; Shayan,9999,0,9999,0
1653457971619,ECE 200,031,091033,Morris; Karcher William,9999,0,9999,0
1653457971619,ECE 200,032,091034,Ng; Tse Nga,9999,0,9999,0
1653457971619,ECE 200,033,091035,Nguyen; Truong Quang,9999,0,9999,0
1653457971619,ECE 200,034,091036,Nomura; Kenji,9999,0,9999,0
1653457971619,ECE 200,035,091037,Orlitsky; Alon,9999,0,9999,0
1653457971619,ECE 200,036,091038,Pal; Piya,9999,0,9999,0
1653457971619,ECE 200,037,091039,Papen; George C.,9999,0,9999,0
1653457971619,ECE 200,038,091040,Radic; Stojan,9999,0,9999,0
1653457971619,ECE 200,039,091041,Rao; Bhaskar D.,9999,0,9999,0
1653457971619,ECE 200,040,091042,Rao; Ramesh R,9999,0,9999,0
1653457971619,ECE 200,041,091043,Rebeiz; Gabriel,9999,0,9999,0
1653457971619,ECE 200,042,091044,Sanford; John R,9999,0,9999,0
1653457971619,ECE 200,043,091045,Siegel; Paul H.,9999,0,9999,0
1653457971619,ECE 200,044,091046,Sievenpiper; Daniel F.,9999,0,9999,0
1653457971619,ECE 200,045,091047,Sworder; David D.,9999,0,9999,0
1653457971619,ECE 200,046,091048,Taur; Yuan,9999,0,9999,0
1653457971619,ECE 200,047,091049,Touri; Behrouz,9999,0,9999,0
1653457971619,ECE 200,048,091050,Trivedi; Mohan M.,9999,0,9999,0
1653457971619,ECE 200,049,091051,Vardy; Alexander,9999,0,9999,0
1653457971619,ECE 200,050,091052,Vasconcelos; Nuno,9999,0,9999,0
1653457971619,ECE 200,051,091053,Wang; Xiaolong,9999,0,9999,0
1653457971619,ECE 200,052,091054,Xie; Pengtao,9999,0,9999,0
1653457971619,ECE 200,053,091055,Yip; Michael,9999,0,9999,0
1653457971619,ECE 200,054,091056,Zeger; Kenneth A.,9999,0,9999,0
1653457971619,ECE 200,055,091057,Zhang; Xinyu,9999,0,9999,0
1653457971619,ECE 200,056,091058,Turakhia; Yatish Girish,9999,0,9999,0
1653457971619,ECE 200,057,091059,Kang; Mingu,9999,0,9999,0
1653457971619,ECE 200,058,091060,Shi; Yuanyuan,9999,0,9999,0
1653457971619,ECE 200,059,091061,Wang; Edward Jay,9999,0,9999,0
1653457971619,ECE 200,060,091062,Zheng; Yang,9999,0,9999,0
1653457972145,ECE 203,A00,091065,Mercier; Patrick Philip,0,0,0,0
1653457972671,ECE 207A,A00,091605,Liu; Thomas Tao-Ming,0,0,0,0
1653457973194,ECE 212AN,A00,091068,Nomura; Kenji,0,0,0,0
1653457973728,ECE 222A,A00,091069,Rebeiz; Gabriel,0,0,0,0
1653457974249,ECE 225A,A00,091070,Orlitsky; Alon,0,0,0,0
1653457974771,ECE 230A,A00,091071,Nomura; Kenji,0,0,0,0
1653457975294,ECE 236A,A00,091072,Dayeh; Shadi Ahmad,0,0,0,0
1653457975820,ECE 238A,A00,091073,Luo; Jian,0,0,0,0
1653457975820,ECE 238A,B00,091074,Luo; Jian,0,0,0,0
1653457976347,ECE 240A,A00,091075,Radic; Stojan,0,0,0,0
1653457976895,ECE 247A,A00,091592,Shi; Lingyan,0,0,0,0
1653457977416,ECE 250,A00,091076,Touri; Behrouz,0,0,0,0
1653457977939,ECE 251C,A00,091078,Nguyen; Truong Quang,0,0,0,0
1653457978462,ECE 253,A00,091079,Cosman; Pamela C.,0,0,0,0
1653457978987,ECE 255A,A00,091080,Orlitsky; Alon,0,0,0,0
1653457979511,ECE 257A,A00,091081,Zhang; Xinyu,0,0,0,0
1653457980042,ECE 260A,A01,091084,Eldon; John,0,0,0,0
1653457980575,ECE 264C,A00,091085,Galton; Ian A,0,0,0,0
1653457981097,ECE 265C,A00,094889,Presti; Calogero Davide,0,0,0,9
1653457981624,ECE 266,A01,091087,Hall; Drew A.,0,0,0,0
1653457982673,ECE 271A,A00,091090,Vasconcelos; Nuno,0,0,0,0
1653457983196,ECE 272B,A00,091091,Sworder; David D.,0,0,0,0
1653457983718,ECE 275A,A00,091092,Meyer; Florian,0,0,0,0
1653457984245,ECE 277,A00,091093,An; Cheolhong,0,0,0,0
1653457984768,ECE 283,A00,091094,Le; Hanh-Phuc,0,0,0,0
1653457985291,ECE 284,A00,091095,Kang; Mingu,0,0,0,0
1653457985291,ECE 284,B00,091096,Wang; Edward Jay,0,0,0,0
1653457985814,ECE 285,A00,094334,Touri; Behrouz,0,0,0,0
1653457986338,ECE 289,A00,091097,Whelan; David Arthur,0,0,0,0
1653457986862,MATH 200A,A00,087414,Salehi Golsefidy; Alireza,7,0,8,1
1653457987386,MATH 202A,A00,087415,Gill; Philip E.,3,0,8,5
1653457987909,MATH 203A,A00,087416,Oprea; Dragos N.,6,0,8,2
1653457988430,MATH 204A,A00,087417,Kedlaya; Kiran S.,6,0,8,2
1653457988953,MATH 205,A00,087418,Sorensen; Claus M,6,0,8,2
1653457989479,MATH 206A,A00,087419,Izadi; Elham,7,0,8,1
1653457990005,MATH 207A,A00,087420,Mohammadi; Amir,6,0,8,2
1653457990527,MATH 208,A00,087421,Staff,9,0,10,1
1653457991050,MATH 209,A00,087422,Staff,10,0,10,0
1653457991583,MATH 218,A00,087423,Staff,10,0,10,0
1653457992109,MATH 220A,A00,087424,Novak; Jonathan I,7,0,8,1
1653457992631,MATH 231A,A00,087425,Bejenaru; Ioan,3,0,8,5
1653457993157,MATH 240A,A00,087426,Ebenfelt; Peter F,5,0,8,3
1653457993706,MATH 243,A00,087427,Staff,9,0,10,1
1653457994233,MATH 248,A00,087429,Staff,10,0,10,0
1653457994756,MATH 250A,A00,087430,Spolaor; Luca,4,0,8,4
1653457995281,MATH 257A,A00,087431,Spolaor; Luca,7,0,8,1
1653457995814,MATH 258,A00,087432,Staff,9,0,10,1
1653457996341,MATH 264A,A00,087433,Warnke; Lutz Peter,5,0,8,3
1653457996875,MATH 268,A00,087434,Staff,15,0,15,0
1653457997406,MATH 269,A00,087435,Staff,14,0,15,1
1653457997932,MATH 270A,A00,087436,Nie; Jiawang,0,0,8,8
1653457998458,MATH 272A,A00,087437,Tian; Xiaochuan,1,0,8,7
1653457998980,MATH 274,A01,087439,Cheng; Li-Tien,9,0,10,1
1653457998980,MATH 274,A02,087440,Cheng; Li-Tien,10,0,10,0
1653457999514,MATH 278A,A00,087441,Staff,8,0,10,2
1653458000045,MATH 278B,A00,087442,Staff,8,0,10,2
1653458000567,MATH 278C,A00,087443,Staff,8,0,10,2
1653458001092,MATH 280A,A00,087444,Zheng; Tianyi,0,0,8,8
1653458001615,MATH 281A,A00,087445,Bradic; Jelena,0,0,8,8
1653458002137,MATH 282A,A00,087446,Zhang; Danna,0,0,8,8
1653458002674,MATH 283,A00,087447,Tesler; Glenn,0,0,0,14
1653458003201,MATH 286,A00,087448,Kemp; Todd Aahron,5,0,8,3
1653458003728,MATH 287D,A00,087449,Bradic; Jelena,8,0,8,0
1653458004260,MATH 288,A00,087450,Staff,14,0,15,1
1653458004260,MATH 288,B00,087451,Staff,15,0,15,0
1653458004260,MATH 288,C00,087452,Staff,15,0,15,0
1653458004795,MATH 290A,A00,087453,Xu; Zhouli,7,0,8,1
1653458005322,MATH 291A,A00,087454,Xu; Zhouli,7,0,8,1
1653458005850,MATH 292,A00,087455,Staff,10,0,10,0
1653458006373,MATH 295,A00,087456,Staff,50,0,50,0
1653458006896,MATH 297,001,087457,Staff,998,0,999,1
1653458567347,COGS 200,A01,087991,Staff,47,0,50,3
1653458567873,COGS 201,A01,094504,Rangel; Lara M,17,0,25,8
1653458568403,COGS 203,A00,087992,Coulson; Seana M,18,0,20,2
1653458568933,COGS 210A,001,087993,Greene; Deanna Jacquelyn,9998,0,9999,1
1653458568933,COGS 210A,002,087994,Saygin; Ayse P,9999,0,9999,0
1653458568933,COGS 210A,003,087995,Xia; Haijun,9999,0,9999,0
1653458568933,COGS 210A,004,087996,Nitz; Douglas A.,9999,0,9999,0
1653458568933,COGS 210A,005,087997,Hollan; James D.,9999,0,9999,0
1653458568933,COGS 210A,006,087998,Deak; Gedeon O.,9998,0,9999,1
1653458568933,COGS 210A,007,087999,Rossano; Federico,9999,0,9999,0
1653458569459,COGS 211A,A00,088000,Coulson; Seana M,9997,0,9999,2
1653458569981,COGS 229,A00,088002,Staff,23,0,25,2
1653458570510,COGS 260,B00,094231,Staff,17,0,20,3
1653458570510,COGS 260,A00,088004,Nitz; Douglas A.,9998,0,9999,1
1653458571038,CSE 202,A00,090110,Paturi; Ramamohan,0,0,0,0
1653458571038,CSE 202,B00,090111,Paturi; Ramamohan,0,0,0,0
1653458571563,CSE 207B,A00,090112,Heninger; Nadia A,0,0,0,0
1653458572087,CSE 208,A00,094858,Micciancio; Daniele,0,0,0,0
1653458572613,CSE 210,A00,090113,Powell; Thomas Allan,0,0,0,0
1653458573140,CSE 219,A00,090898,Staff,0,0,0,0
1653458573670,CSE 221,A00,090114,Zhou; Yuan-Yuan,0,0,0,0
1653458574207,CSE 229A,A00,090115,Porter; George M,0,0,0,0
1653458574733,CSE 229C,A00,090116,Savage; Stefan,0,0,0,0
1653458575255,CSE 230,A00,090117,Jhala; Ranjit,0,0,0,0
1653458575777,CSE 232,A00,090118,Papakonstantinou; Yannis,0,0,0,0
1653458576308,CSE 239A,A00,090121,Kumar; Arun Kumar,0,0,0,0
1653458576832,CSE 239B,A00,090122,Jhala; Ranjit,0,0,0,0
1653458577354,CSE 240A,A00,090123,Zhao; Jishen,0,0,189,189
1653458577882,CSE 243A,A00,090124,Orailoglu; Alex,1,0,15,14
1653458578417,CSE 249B,A00,090125,Kahng; Andrew Byun,13,0,20,7
1653458578939,CSE 250A,A00,090126,Berg-Kirkpatrick; Taylor D,0,0,0,0
1653458579465,CSE 252A,A00,090127,Ochoa; Benjamin Lawrence,0,0,0,0
1653458579987,CSE 258,A01,090129,McAuley; Julian John,0,0,0,0
1653458580510,CSE 258R,A01,090131,McAuley; Julian John,0,0,0,0
1653458581045,CSE 274,A00,090132,Ramamoorthi; Ravi,0,0,0,0
1653458581568,CSE 276A,A00,090133,Christensen; Henrik I,0,0,0,0
1653458582096,CSE 276C,A00,090134,Christensen; Henrik I,0,0,0,0
1653458582619,CSE 290,A00,090135,Bafna; Vineet,0,0,0,0
1653458582619,CSE 290,B00,090136,Ramamoorthi; Ravi,0,0,0,0
1653458582619,CSE 290,C00,090137,Li; Tzumao,9,0,10,1
1653458582619,CSE 290,D00,090138,Zhou; Yuan-Yuan,10,0,10,0
1653458582619,CSE 290,E00,090139,Christensen; Henrik I,10,0,10,0
1653458582619,CSE 290,F00,094053,Shalev; Aaron D,0,0,0,0
1653458583142,CSE 291,A00,090140,Munyaka; Imani N. S.,0,0,0,0
1653458583142,CSE 291,B00,094880,Yu; Qi,0,0,0,0
1653458583142,CSE 291,C00,090142,Pannuto; Patrick William,0,0,0,0
1653458583142,CSE 291,D00,094881,Zhang; Yiying,0,0,0,0
1653458583142,CSE 291,E00,095118,Su; Hao,0,0,0,0
1653458583708,CSE 293,001,094905,Bafna; Vineet,9999,0,9999,0
1653458583708,CSE 293,002,094906,Bellare; Mihir,9999,0,9999,0
1653458583708,CSE 293,003,094907,Berg-Kirkpatrick; Taylor D,9999,0,9999,0
1653458583708,CSE 293,004,094908,Christensen; Henrik I,9999,0,9999,0
1653458583708,CSE 293,005,094909,Cottrell; Garrison W,9999,0,9999,0
1653458583708,CSE 293,006,094910,Deutsch; Alin Bernard,9999,0,9999,0
1653458583708,CSE 293,007,094911,Esmaeilzadeh; Hadi,9999,0,9999,0
1653458583708,CSE 293,008,094912,Freund; Yoav,9999,0,9999,0
1653458583708,CSE 293,009,094913,Griswold; William G.,9999,0,9999,0
1653458583708,CSE 293,010,094914,Gymrek; Melissa Ann,9999,0,9999,0
1653458583708,CSE 293,011,094915,Heninger; Nadia A,9999,0,9999,0
1653458583708,CSE 293,012,094916,Impagliazzo; Russell,9999,0,9999,0
1653458583708,CSE 293,013,094917,Jhala; Ranjit,9999,0,9999,0
1653458583708,CSE 293,014,094918,Kahng; Andrew Byun,9999,0,9999,0
1653458583708,CSE 293,015,094919,Kane; Daniel Mertz,9999,0,9999,0
1653458583708,CSE 293,016,094920,Kriegman; David J,9999,0,9999,0
1653458583708,CSE 293,017,094921,Kumar; Arun Kumar,9999,0,9999,0
1653458583708,CSE 293,018,094922,Lerner; Sorin,9999,0,9999,0
1653458583708,CSE 293,019,094923,Lovett; Shachar,9999,0,9999,0
1653458583708,CSE 293,020,094924,McAuley; Julian John,9999,0,9999,0
1653458583708,CSE 293,021,094925,Micciancio; Daniele,9999,0,9999,0
1653458583708,CSE 293,022,094926,Orailoglu; Alex,9999,0,9999,0
1653458583708,CSE 293,023,094927,Paturi; Ramamohan,9999,0,9999,0
1653458583708,CSE 293,024,094928,Polikarpova; Nadezhda,9999,0,9999,0
1653458583708,CSE 293,025,094929,Politz; Joseph Gibbs,9999,0,9999,0
1653458583708,CSE 293,026,094930,Porter; George M,9999,0,9999,0
1653458583708,CSE 293,027,094931,Porter; Leonard Emerson,9999,0,9999,0
1653458583708,CSE 293,028,094932,Ramamoorthi; Ravi,9999,0,9999,0
1653458583708,CSE 293,029,094933,Sahoo; Debashis,9999,0,9999,0
1653458583708,CSE 293,030,094934,Saul; Lawrence,9999,0,9999,0
1653458583708,CSE 293,031,094935,Savage; Stefan,9999,0,9999,0
1653458583708,CSE 293,032,094936,Schulze; Jurgen P.,9999,0,9999,0
1653458583708,CSE 293,033,094937,Snoeren; Alex C.,9999,0,9999,0
1653458583708,CSE 293,034,094938,Shang; Jingbo,9999,0,9999,0
1653458583708,CSE 293,035,094939,Stefan; Deian,9999,0,9999,0
1653458583708,CSE 293,036,094940,Su; Hao,9999,0,9999,0
1653458583708,CSE 293,037,094941,Swanson; Steven James,9999,0,9999,0
1653458583708,CSE 293,038,094942,Tullsen; Dean Michael,9999,0,9999,0
1653458583708,CSE 293,039,094943,Voelker; Geoffrey M.,9999,0,9999,0
1653458583708,CSE 293,040,094944,Zhao; Jishen,9999,0,9999,0
1653458583708,CSE 293,041,094945,Zhou; Yuan-Yuan,9999,0,9999,0
1653458583708,CSE 293,042,094946,Gao; Sicun,9998,0,9999,1
1653458583708,CSE 293,043,094947,Weibel; Nadir,9999,0,9999,0
1653458583708,CSE 293,044,094948,Gupta; Rajesh K.,9999,0,9999,0
1653458584230,CSE 294,A00,090143,Porter; George M,9,0,10,1
1653458584757,DSE 200,A00,091799,Staff,50,0,50,0
1653458585294,DSE 203,A00,091800,Gupta; Amarnath,30,0,30,0
1653458585818,DSE 250,A00,091801,Deutsch; Alin Bernard,30,0,30,0
1653458586339,DSE 290,A00,091802,Altintas De Callaf; Ilkay,50,0,50,0
1653458586869,ECE 200,001,091003,Antipa; Nicholas A,9999,0,9999,0
1653458586869,ECE 200,002,091004,Atanasov; Nikolay A.,9999,0,9999,0
1653458586869,ECE 200,003,091005,Bharadia; Dinesh,9999,0,9999,0
1653458586869,ECE 200,004,091006,Cheng; Chung Kuan,9999,0,9999,0
1653458586869,ECE 200,005,091007,Cosman; Pamela C.,9999,0,9999,0
1653458586869,ECE 200,006,091008,Staff,9999,0,9999,0
1653458586869,ECE 200,007,091009,Dayeh; Shadi Ahmad,9999,0,9999,0
1653458586869,ECE 200,008,091010,Fainman; Yeshaiahu,9999,0,9999,0
1653458586869,ECE 200,009,091011,Ford; Joseph Earl,9999,0,9999,0
1653458586869,ECE 200,010,091012,Franceschetti; Massimo,9999,0,9999,0
1653458586869,ECE 200,011,091013,Fullerton; Eric E,9999,0,9999,0
1653458586869,ECE 200,012,091014,Galton; Ian A,9999,0,9999,0
1653458586869,ECE 200,013,091015,Gilja; Vikash,9999,0,9999,0
1653458586869,ECE 200,014,091016,Hall; Drew A.,9999,0,9999,0
1653458586869,ECE 200,015,091017,Hsueh; Tzu-Chien,9999,0,9999,0
1653458586869,ECE 200,016,091018,Javidi; Tara,9999,0,9999,0
1653458586869,ECE 200,017,091019,Kahng; Andrew Byun,9999,0,9999,0
1653458586869,ECE 200,018,091020,Kim; Young-Han,9999,0,9999,0
1653458586869,ECE 200,019,091021,Koushanfar; Farinaz,9999,0,9999,0
1653458586869,ECE 200,020,091022,Kuzum; Duygu,9999,0,9999,0
1653458586869,ECE 200,021,091023,Le; Hanh-Phuc,9999,0,9999,0
1653458586869,ECE 200,022,091024,Lin; Bill,9999,0,9999,0
1653458586869,ECE 200,023,091025,Liu; Zhaowei,9999,0,9999,0
1653458586869,ECE 200,024,091026,Lo; Yu-Hwa,9999,0,9999,0
1653458586869,ECE 200,025,091027,Lomakin; Vitaliy,9999,0,9999,0
1653458586869,ECE 200,026,091028,Mercier; Patrick Philip,9999,0,9999,0
1653458586869,ECE 200,027,091029,Meyer; Florian,9999,0,9999,0
1653458586869,ECE 200,028,091030,Milstein; Laurence B.,9999,0,9999,0
1653458586869,ECE 200,029,091031,Mir Arabbaygi; Siavash,9999,0,9999,0
1653458586869,ECE 200,030,091032,Mookherjea; Shayan,9999,0,9999,0
1653458586869,ECE 200,031,091033,Morris; Karcher William,9999,0,9999,0
1653458586869,ECE 200,032,091034,Ng; Tse Nga,9999,0,9999,0
1653458586869,ECE 200,033,091035,Nguyen; Truong Quang,9999,0,9999,0
1653458586869,ECE 200,034,091036,Nomura; Kenji,9999,0,9999,0
1653458586869,ECE 200,035,091037,Orlitsky; Alon,9999,0,9999,0
1653458586869,ECE 200,036,091038,Pal; Piya,9999,0,9999,0
1653458586869,ECE 200,037,091039,Papen; George C.,9999,0,9999,0
1653458586869,ECE 200,038,091040,Radic; Stojan,9999,0,9999,0
1653458586869,ECE 200,039,091041,Rao; Bhaskar D.,9999,0,9999,0
1653458586869,ECE 200,040,091042,Rao; Ramesh R,9999,0,9999,0
1653458586869,ECE 200,041,091043,Rebeiz; Gabriel,9999,0,9999,0
1653458586869,ECE 200,042,091044,Sanford; John R,9999,0,9999,0
1653458586869,ECE 200,043,091045,Siegel; Paul H.,9999,0,9999,0
1653458586869,ECE 200,044,091046,Sievenpiper; Daniel F.,9999,0,9999,0
1653458586869,ECE 200,045,091047,Sworder; David D.,9999,0,9999,0
1653458586869,ECE 200,046,091048,Taur; Yuan,9999,0,9999,0
1653458586869,ECE 200,047,091049,Touri; Behrouz,9999,0,9999,0
1653458586869,ECE 200,048,091050,Trivedi; Mohan M.,9999,0,9999,0
1653458586869,ECE 200,049,091051,Vardy; Alexander,9999,0,9999,0
1653458586869,ECE 200,050,091052,Vasconcelos; Nuno,9999,0,9999,0
1653458586869,ECE 200,051,091053,Wang; Xiaolong,9999,0,9999,0
1653458586869,ECE 200,052,091054,Xie; Pengtao,9999,0,9999,0
1653458586869,ECE 200,053,091055,Yip; Michael,9999,0,9999,0
1653458586869,ECE 200,054,091056,Zeger; Kenneth A.,9999,0,9999,0
1653458586869,ECE 200,055,091057,Zhang; Xinyu,9999,0,9999,0
1653458586869,ECE 200,056,091058,Turakhia; Yatish Girish,9999,0,9999,0
1653458586869,ECE 200,057,091059,Kang; Mingu,9999,0,9999,0
1653458586869,ECE 200,058,091060,Shi; Yuanyuan,9999,0,9999,0
1653458586869,ECE 200,059,091061,Wang; Edward Jay,9999,0,9999,0
1653458586869,ECE 200,060,091062,Zheng; Yang,9999,0,9999,0
1653458587392,ECE 203,A00,091065,Mercier; Patrick Philip,0,0,0,0
1653458587916,ECE 207A,A00,091605,Liu; Thomas Tao-Ming,0,0,0,0
1653458588442,ECE 212AN,A00,091068,Nomura; Kenji,0,0,0,0
1653458588967,ECE 222A,A00,091069,Rebeiz; Gabriel,0,0,0,0
1653458589492,ECE 225A,A00,091070,Orlitsky; Alon,0,0,0,0
1653458590026,ECE 230A,A00,091071,Nomura; Kenji,0,0,0,0
1653458590566,ECE 236A,A00,091072,Dayeh; Shadi Ahmad,0,0,0,0
1653458591090,ECE 238A,A00,091073,Luo; Jian,0,0,0,0
1653458591090,ECE 238A,B00,091074,Luo; Jian,0,0,0,0
1653458591622,ECE 240A,A00,091075,Radic; Stojan,0,0,0,0
1653458592146,ECE 247A,A00,091592,Shi; Lingyan,0,0,0,0
1653458592674,ECE 250,A00,091076,Touri; Behrouz,0,0,0,0
1653458593197,ECE 251C,A00,091078,Nguyen; Truong Quang,0,0,0,0
1653458593725,ECE 253,A00,091079,Cosman; Pamela C.,0,0,0,0
1653458594248,ECE 255A,A00,091080,Orlitsky; Alon,0,0,0,0
1653458594771,ECE 257A,A00,091081,Zhang; Xinyu,0,0,0,0
1653458595292,ECE 260A,A01,091084,Eldon; John,0,0,0,0
1653458595815,ECE 264C,A00,091085,Galton; Ian A,0,0,0,0
1653458596342,ECE 265C,A00,094889,Presti; Calogero Davide,0,0,0,9
1653458596871,ECE 266,A01,091087,Hall; Drew A.,0,0,0,0
1653458597918,ECE 271A,A00,091090,Vasconcelos; Nuno,0,0,0,0
1653458598446,ECE 272B,A00,091091,Sworder; David D.,0,0,0,0
1653458598978,ECE 275A,A00,091092,Meyer; Florian,0,0,0,0
1653458599502,ECE 277,A00,091093,An; Cheolhong,0,0,0,0
1653458600024,ECE 283,A00,091094,Le; Hanh-Phuc,0,0,0,0
1653458600546,ECE 284,A00,091095,Kang; Mingu,0,0,0,0
1653458600546,ECE 284,B00,091096,Wang; Edward Jay,0,0,0,0
1653458601074,ECE 285,A00,094334,Touri; Behrouz,0,0,0,0
1653458601598,ECE 289,A00,091097,Whelan; David Arthur,0,0,0,0
1653458602121,MATH 200A,A00,087414,Salehi Golsefidy; Alireza,7,0,8,1
1653458602644,MATH 202A,A00,087415,Gill; Philip E.,3,0,8,5
1653458603174,MATH 203A,A00,087416,Oprea; Dragos N.,6,0,8,2
1653458603700,MATH 204A,A00,087417,Kedlaya; Kiran S.,6,0,8,2
1653458604224,MATH 205,A00,087418,Sorensen; Claus M,6,0,8,2
1653458604746,MATH 206A,A00,087419,Izadi; Elham,7,0,8,1
1653458605269,MATH 207A,A00,087420,Mohammadi; Amir,6,0,8,2
1653458605873,MATH 208,A00,087421,Staff,9,0,10,1
1653458606398,MATH 209,A00,087422,Staff,10,0,10,0
1653458606925,MATH 218,A00,087423,Staff,10,0,10,0
1653458607450,MATH 220A,A00,087424,Novak; Jonathan I,7,0,8,1
1653458607973,MATH 231A,A00,087425,Bejenaru; Ioan,3,0,8,5
1653458608505,MATH 240A,A00,087426,Ebenfelt; Peter F,5,0,8,3
1653458609027,MATH 243,A00,087427,Staff,9,0,10,1
1653458609549,MATH 248,A00,087429,Staff,10,0,10,0
1653458610075,MATH 250A,A00,087430,Spolaor; Luca,4,0,8,4
1653458610598,MATH 257A,A00,087431,Spolaor; Luca,7,0,8,1
1653458611124,MATH 258,A00,087432,Staff,9,0,10,1
1653458611647,MATH 264A,A00,087433,Warnke; Lutz Peter,5,0,8,3
1653458612173,MATH 268,A00,087434,Staff,15,0,15,0
1653458612700,MATH 269,A00,087435,Staff,14,0,15,1
1653458613224,MATH 270A,A00,087436,Nie; Jiawang,0,0,8,8
1653458613748,MATH 272A,A00,087437,Tian; Xiaochuan,1,0,8,7
1653458614274,MATH 274,A01,087439,Cheng; Li-Tien,9,0,10,1
1653458614274,MATH 274,A02,087440,Cheng; Li-Tien,10,0,10,0
1653458614797,MATH 278A,A00,087441,Staff,8,0,10,2
1653458615321,MATH 278B,A00,087442,Staff,8,0,10,2
1653458615843,MATH 278C,A00,087443,Staff,8,0,10,2
1653458616370,MATH 280A,A00,087444,Zheng; Tianyi,0,0,8,8
1653458616896,MATH 281A,A00,087445,Bradic; Jelena,0,0,8,8
1653458617419,MATH 282A,A00,087446,Zhang; Danna,0,0,8,8
1653458617954,MATH 283,A00,087447,Tesler; Glenn,0,0,0,14
1653458618475,MATH 286,A00,087448,Kemp; Todd Aahron,5,0,8,3
1653458618998,MATH 287D,A00,087449,Bradic; Jelena,8,0,8,0
1653458619530,MATH 288,A00,087450,Staff,14,0,15,1
1653458619530,MATH 288,B00,087451,Staff,15,0,15,0
1653458619530,MATH 288,C00,087452,Staff,15,0,15,0
1653458620061,MATH 290A,A00,087453,Xu; Zhouli,7,0,8,1
1653458620584,MATH 291A,A00,087454,Xu; Zhouli,7,0,8,1
1653458621107,MATH 292,A00,087455,Staff,10,0,10,0
1653458621627,MATH 295,A00,087456,Staff,50,0,50,0
1653458622150,MATH 297,001,087457,Staff,998,0,999,1
1653459181808,COGS 200,A01,087991,Staff,47,0,50,3
1653459182330,COGS 201,A01,094504,Rangel; Lara M,17,0,25,8
1653459182857,COGS 203,A00,087992,Coulson; Seana M,18,0,20,2
1653459183387,COGS 210A,001,087993,Greene; Deanna Jacquelyn,9998,0,9999,1
1653459183387,COGS 210A,002,087994,Saygin; Ayse P,9999,0,9999,0
1653459183387,COGS 210A,003,087995,Xia; Haijun,9999,0,9999,0
1653459183387,COGS 210A,004,087996,Nitz; Douglas A.,9999,0,9999,0
1653459183387,COGS 210A,005,087997,Hollan; James D.,9999,0,9999,0
1653459183387,COGS 210A,006,087998,Deak; Gedeon O.,9998,0,9999,1
1653459183387,COGS 210A,007,087999,Rossano; Federico,9999,0,9999,0
1653459183912,COGS 211A,A00,088000,Coulson; Seana M,9997,0,9999,2
1653459184434,COGS 229,A00,088002,Staff,23,0,25,2
1653459184963,COGS 260,B00,094231,Staff,17,0,20,3
1653459184963,COGS 260,A00,088004,Nitz; Douglas A.,9998,0,9999,1
1653459185486,CSE 202,A00,090110,Paturi; Ramamohan,0,0,0,0
1653459185486,CSE 202,B00,090111,Paturi; Ramamohan,0,0,0,0
1653459186012,CSE 207B,A00,090112,Heninger; Nadia A,0,0,0,0
1653459186544,CSE 208,A00,094858,Micciancio; Daniele,0,0,0,0
1653459187068,CSE 210,A00,090113,Powell; Thomas Allan,0,0,0,0
1653459187592,CSE 219,A00,090898,Staff,0,0,0,0
1653459188115,CSE 221,A00,090114,Zhou; Yuan-Yuan,0,0,0,0
1653459188640,CSE 229A,A00,090115,Porter; George M,0,0,0,0
1653459189165,CSE 229C,A00,090116,Savage; Stefan,0,0,0,0
1653459189691,CSE 230,A00,090117,Jhala; Ranjit,0,0,0,0
1653459190213,CSE 232,A00,090118,Papakonstantinou; Yannis,0,0,0,0
1653459190735,CSE 239A,A00,090121,Kumar; Arun Kumar,0,0,0,0
1653459191258,CSE 239B,A00,090122,Jhala; Ranjit,0,0,0,0
1653459191783,CSE 240A,A00,090123,Zhao; Jishen,0,0,189,189
1653459192305,CSE 243A,A00,090124,Orailoglu; Alex,1,0,15,14
1653459192941,CSE 249B,A00,090125,Kahng; Andrew Byun,13,0,20,7
1653459193465,CSE 250A,A00,090126,Berg-Kirkpatrick; Taylor D,0,0,0,0
1653459193988,CSE 252A,A00,090127,Ochoa; Benjamin Lawrence,0,0,0,0
1653459194510,CSE 258,A01,090129,McAuley; Julian John,0,0,0,0
1653459195033,CSE 258R,A01,090131,McAuley; Julian John,0,0,0,0
1653459195560,CSE 274,A00,090132,Ramamoorthi; Ravi,0,0,0,0
1653459196083,CSE 276A,A00,090133,Christensen; Henrik I,0,0,0,0
1653459196616,CSE 276C,A00,090134,Christensen; Henrik I,0,0,0,0
1653459197139,CSE 290,A00,090135,Bafna; Vineet,0,0,0,0
1653459197139,CSE 290,B00,090136,Ramamoorthi; Ravi,0,0,0,0
1653459197139,CSE 290,C00,090137,Li; Tzumao,9,0,10,1
1653459197139,CSE 290,D00,090138,Zhou; Yuan-Yuan,10,0,10,0
1653459197139,CSE 290,E00,090139,Christensen; Henrik I,10,0,10,0
1653459197139,CSE 290,F00,094053,Shalev; Aaron D,0,0,0,0
1653459197662,CSE 291,A00,090140,Munyaka; Imani N. S.,0,0,0,0
1653459197662,CSE 291,B00,094880,Yu; Qi,0,0,0,0
1653459197662,CSE 291,C00,090142,Pannuto; Patrick William,0,0,0,0
1653459197662,CSE 291,D00,094881,Zhang; Yiying,0,0,0,0
1653459197662,CSE 291,E00,095118,Su; Hao,0,0,0,0
1653459198188,CSE 293,001,094905,Bafna; Vineet,9999,0,9999,0
1653459198188,CSE 293,002,094906,Bellare; Mihir,9999,0,9999,0
1653459198188,CSE 293,003,094907,Berg-Kirkpatrick; Taylor D,9999,0,9999,0
1653459198188,CSE 293,004,094908,Christensen; Henrik I,9999,0,9999,0
1653459198188,CSE 293,005,094909,Cottrell; Garrison W,9999,0,9999,0
1653459198188,CSE 293,006,094910,Deutsch; Alin Bernard,9999,0,9999,0
1653459198188,CSE 293,007,094911,Esmaeilzadeh; Hadi,9999,0,9999,0
1653459198188,CSE 293,008,094912,Freund; Yoav,9999,0,9999,0
1653459198188,CSE 293,009,094913,Griswold; William G.,9999,0,9999,0
1653459198188,CSE 293,010,094914,Gymrek; Melissa Ann,9999,0,9999,0
1653459198188,CSE 293,011,094915,Heninger; Nadia A,9999,0,9999,0
1653459198188,CSE 293,012,094916,Impagliazzo; Russell,9999,0,9999,0
1653459198188,CSE 293,013,094917,Jhala; Ranjit,9999,0,9999,0
1653459198188,CSE 293,014,094918,Kahng; Andrew Byun,9999,0,9999,0
1653459198188,CSE 293,015,094919,Kane; Daniel Mertz,9999,0,9999,0
1653459198188,CSE 293,016,094920,Kriegman; David J,9999,0,9999,0
1653459198188,CSE 293,017,094921,Kumar; Arun Kumar,9999,0,9999,0
1653459198188,CSE 293,018,094922,Lerner; Sorin,9999,0,9999,0
1653459198188,CSE 293,019,094923,Lovett; Shachar,9999,0,9999,0
1653459198188,CSE 293,020,094924,McAuley; Julian John,9999,0,9999,0
1653459198188,CSE 293,021,094925,Micciancio; Daniele,9999,0,9999,0
1653459198188,CSE 293,022,094926,Orailoglu; Alex,9999,0,9999,0
1653459198188,CSE 293,023,094927,Paturi; Ramamohan,9999,0,9999,0
1653459198188,CSE 293,024,094928,Polikarpova; Nadezhda,9999,0,9999,0
1653459198188,CSE 293,025,094929,Politz; Joseph Gibbs,9999,0,9999,0
1653459198188,CSE 293,026,094930,Porter; George M,9999,0,9999,0
1653459198188,CSE 293,027,094931,Porter; Leonard Emerson,9999,0,9999,0
1653459198188,CSE 293,028,094932,Ramamoorthi; Ravi,9999,0,9999,0
1653459198188,CSE 293,029,094933,Sahoo; Debashis,9999,0,9999,0
1653459198188,CSE 293,030,094934,Saul; Lawrence,9999,0,9999,0
1653459198188,CSE 293,031,094935,Savage; Stefan,9999,0,9999,0
1653459198188,CSE 293,032,094936,Schulze; Jurgen P.,9999,0,9999,0
1653459198188,CSE 293,033,094937,Snoeren; Alex C.,9999,0,9999,0
1653459198188,CSE 293,034,094938,Shang; Jingbo,9999,0,9999,0
1653459198188,CSE 293,035,094939,Stefan; Deian,9999,0,9999,0
1653459198188,CSE 293,036,094940,Su; Hao,9999,0,9999,0
1653459198188,CSE 293,037,094941,Swanson; Steven James,9999,0,9999,0
1653459198188,CSE 293,038,094942,Tullsen; Dean Michael,9999,0,9999,0
1653459198188,CSE 293,039,094943,Voelker; Geoffrey M.,9999,0,9999,0
1653459198188,CSE 293,040,094944,Zhao; Jishen,9999,0,9999,0
1653459198188,CSE 293,041,094945,Zhou; Yuan-Yuan,9999,0,9999,0
1653459198188,CSE 293,042,094946,Gao; Sicun,9998,0,9999,1
1653459198188,CSE 293,043,094947,Weibel; Nadir,9999,0,9999,0
1653459198188,CSE 293,044,094948,Gupta; Rajesh K.,9999,0,9999,0
1653459198714,CSE 294,A00,090143,Porter; George M,9,0,10,1
1653459199239,DSE 200,A00,091799,Staff,50,0,50,0
1653459199766,DSE 203,A00,091800,Gupta; Amarnath,30,0,30,0
1653459200294,DSE 250,A00,091801,Deutsch; Alin Bernard,30,0,30,0
1653459200817,DSE 290,A00,091802,Altintas De Callaf; Ilkay,50,0,50,0
1653459201398,ECE 200,001,091003,Antipa; Nicholas A,9999,0,9999,0
1653459201398,ECE 200,002,091004,Atanasov; Nikolay A.,9999,0,9999,0
1653459201398,ECE 200,003,091005,Bharadia; Dinesh,9999,0,9999,0
1653459201398,ECE 200,004,091006,Cheng; Chung Kuan,9999,0,9999,0
1653459201398,ECE 200,005,091007,Cosman; Pamela C.,9999,0,9999,0
1653459201398,ECE 200,006,091008,Staff,9999,0,9999,0
1653459201398,ECE 200,007,091009,Dayeh; Shadi Ahmad,9999,0,9999,0
1653459201398,ECE 200,008,091010,Fainman; Yeshaiahu,9999,0,9999,0
1653459201398,ECE 200,009,091011,Ford; Joseph Earl,9999,0,9999,0
1653459201398,ECE 200,010,091012,Franceschetti; Massimo,9999,0,9999,0
1653459201398,ECE 200,011,091013,Fullerton; Eric E,9999,0,9999,0
1653459201398,ECE 200,012,091014,Galton; Ian A,9999,0,9999,0
1653459201398,ECE 200,013,091015,Gilja; Vikash,9999,0,9999,0
1653459201398,ECE 200,014,091016,Hall; Drew A.,9999,0,9999,0
1653459201398,ECE 200,015,091017,Hsueh; Tzu-Chien,9999,0,9999,0
1653459201398,ECE 200,016,091018,Javidi; Tara,9999,0,9999,0
1653459201398,ECE 200,017,091019,Kahng; Andrew Byun,9999,0,9999,0
1653459201398,ECE 200,018,091020,Kim; Young-Han,9999,0,9999,0
1653459201398,ECE 200,019,091021,Koushanfar; Farinaz,9999,0,9999,0
1653459201398,ECE 200,020,091022,Kuzum; Duygu,9999,0,9999,0
1653459201398,ECE 200,021,091023,Le; Hanh-Phuc,9999,0,9999,0
1653459201398,ECE 200,022,091024,Lin; Bill,9999,0,9999,0
1653459201398,ECE 200,023,091025,Liu; Zhaowei,9999,0,9999,0
1653459201398,ECE 200,024,091026,Lo; Yu-Hwa,9999,0,9999,0
1653459201398,ECE 200,025,091027,Lomakin; Vitaliy,9999,0,9999,0
1653459201398,ECE 200,026,091028,Mercier; Patrick Philip,9999,0,9999,0
1653459201398,ECE 200,027,091029,Meyer; Florian,9999,0,9999,0
1653459201398,ECE 200,028,091030,Milstein; Laurence B.,9999,0,9999,0
1653459201398,ECE 200,029,091031,Mir Arabbaygi; Siavash,9999,0,9999,0
1653459201398,ECE 200,030,091032,Mookherjea; Shayan,9999,0,9999,0
1653459201398,ECE 200,031,091033,Morris; Karcher William,9999,0,9999,0
1653459201398,ECE 200,032,091034,Ng; Tse Nga,9999,0,9999,0
1653459201398,ECE 200,033,091035,Nguyen; Truong Quang,9999,0,9999,0
1653459201398,ECE 200,034,091036,Nomura; Kenji,9999,0,9999,0
1653459201398,ECE 200,035,091037,Orlitsky; Alon,9999,0,9999,0
1653459201398,ECE 200,036,091038,Pal; Piya,9999,0,9999,0
1653459201398,ECE 200,037,091039,Papen; George C.,9999,0,9999,0
1653459201398,ECE 200,038,091040,Radic; Stojan,9999,0,9999,0
1653459201398,ECE 200,039,091041,Rao; Bhaskar D.,9999,0,9999,0
1653459201398,ECE 200,040,091042,Rao; Ramesh R,9999,0,9999,0
1653459201398,ECE 200,041,091043,Rebeiz; Gabriel,9999,0,9999,0
1653459201398,ECE 200,042,091044,Sanford; John R,9999,0,9999,0
1653459201398,ECE 200,043,091045,Siegel; Paul H.,9999,0,9999,0
1653459201398,ECE 200,044,091046,Sievenpiper; Daniel F.,9999,0,9999,0
1653459201398,ECE 200,045,091047,Sworder; David D.,9999,0,9999,0
1653459201398,ECE 200,046,091048,Taur; Yuan,9999,0,9999,0
1653459201398,ECE 200,047,091049,Touri; Behrouz,9999,0,9999,0
1653459201398,ECE 200,048,091050,Trivedi; Mohan M.,9999,0,9999,0
1653459201398,ECE 200,049,091051,Vardy; Alexander,9999,0,9999,0
1653459201398,ECE 200,050,091052,Vasconcelos; Nuno,9999,0,9999,0
1653459201398,ECE 200,051,091053,Wang; Xiaolong,9999,0,9999,0
1653459201398,ECE 200,052,091054,Xie; Pengtao,9999,0,9999,0
1653459201398,ECE 200,053,091055,Yip; Michael,9999,0,9999,0
1653459201398,ECE 200,054,091056,Zeger; Kenneth A.,9999,0,9999,0
1653459201398,ECE 200,055,091057,Zhang; Xinyu,9999,0,9999,0
1653459201398,ECE 200,056,091058,Turakhia; Yatish Girish,9999,0,9999,0
1653459201398,ECE 200,057,091059,Kang; Mingu,9999,0,9999,0
1653459201398,ECE 200,058,091060,Shi; Yuanyuan,9999,0,9999,0
1653459201398,ECE 200,059,091061,Wang; Edward Jay,9999,0,9999,0
1653459201398,ECE 200,060,091062,Zheng; Yang,9999,0,9999,0
1653459201924,ECE 203,A00,091065,Mercier; Patrick Philip,0,0,0,0
1653459202450,ECE 207A,A00,091605,Liu; Thomas Tao-Ming,0,0,0,0
1653459202978,ECE 212AN,A00,091068,Nomura; Kenji,0,0,0,0
1653459203508,ECE 222A,A00,091069,Rebeiz; Gabriel,0,0,0,0
1653459204031,ECE 225A,A00,091070,Orlitsky; Alon,0,0,0,0
1653459204556,ECE 230A,A00,091071,Nomura; Kenji,0,0,0,0
1653459205083,ECE 236A,A00,091072,Dayeh; Shadi Ahmad,0,0,0,0
1653459205606,ECE 238A,A00,091073,Luo; Jian,0,0,0,0
1653459205606,ECE 238A,B00,091074,Luo; Jian,0,0,0,0
1653459206133,ECE 240A,A00,091075,Radic; Stojan,0,0,0,0
1653459206658,ECE 247A,A00,091592,Shi; Lingyan,0,0,0,0
1653459207189,ECE 250,A00,091076,Touri; Behrouz,0,0,0,0
1653459207714,ECE 251C,A00,091078,Nguyen; Truong Quang,0,0,0,0
1653459208236,ECE 253,A00,091079,Cosman; Pamela C.,0,0,0,0
1653459208759,ECE 255A,A00,091080,Orlitsky; Alon,0,0,0,0
1653459209287,ECE 257A,A00,091081,Zhang; Xinyu,0,0,0,0
1653459209810,ECE 260A,A01,091084,Eldon; John,0,0,0,0
1653459210336,ECE 264C,A00,091085,Galton; Ian A,0,0,0,0
1653459210863,ECE 265C,A00,094889,Presti; Calogero Davide,0,0,0,9
1653459211386,ECE 266,A01,091087,Hall; Drew A.,0,0,0,0
1653459212434,ECE 271A,A00,091090,Vasconcelos; Nuno,0,0,0,0
1653459212977,ECE 272B,A00,091091,Sworder; David D.,0,0,0,0
1653459213501,ECE 275A,A00,091092,Meyer; Florian,0,0,0,0
1653459214025,ECE 277,A00,091093,An; Cheolhong,0,0,0,0
1653459214554,ECE 283,A00,091094,Le; Hanh-Phuc,0,0,0,0
1653459215077,ECE 284,A00,091095,Kang; Mingu,0,0,0,0
1653459215077,ECE 284,B00,091096,Wang; Edward Jay,0,0,0,0
1653459215602,ECE 285,A00,094334,Touri; Behrouz,0,0,0,0
1653459216128,ECE 289,A00,091097,Whelan; David Arthur,0,0,0,0
1653459216650,MATH 200A,A00,087414,Salehi Golsefidy; Alireza,7,0,8,1
1653459217175,MATH 202A,A00,087415,Gill; Philip E.,3,0,8,5
1653459217710,MATH 203A,A00,087416,Oprea; Dragos N.,6,0,8,2
1653459218236,MATH 204A,A00,087417,Kedlaya; Kiran S.,6,0,8,2
1653459218760,MATH 205,A00,087418,Sorensen; Claus M,6,0,8,2
1653459219284,MATH 206A,A00,087419,Izadi; Elham,7,0,8,1
1653459219807,MATH 207A,A00,087420,Mohammadi; Amir,6,0,8,2
1653459220329,MATH 208,A00,087421,Staff,9,0,10,1
1653459220851,MATH 209,A00,087422,Staff,10,0,10,0
1653459221375,MATH 218,A00,087423,Staff,10,0,10,0
1653459221899,MATH 220A,A00,087424,Novak; Jonathan I,7,0,8,1
1653459222422,MATH 231A,A00,087425,Bejenaru; Ioan,3,0,8,5
1653459222946,MATH 240A,A00,087426,Ebenfelt; Peter F,5,0,8,3
1653459223473,MATH 243,A00,087427,Staff,9,0,10,1
1653459223998,MATH 248,A00,087429,Staff,10,0,10,0
1653459224522,MATH 250A,A00,087430,Spolaor; Luca,4,0,8,4
1653459225046,MATH 257A,A00,087431,Spolaor; Luca,7,0,8,1
1653459225574,MATH 258,A00,087432,Staff,9,0,10,1
1653459226100,MATH 264A,A00,087433,Warnke; Lutz Peter,5,0,8,3
1653459226623,MATH 268,A00,087434,Staff,15,0,15,0
1653459227145,MATH 269,A00,087435,Staff,14,0,15,1
1653459227668,MATH 270A,A00,087436,Nie; Jiawang,0,0,8,8
1653459228195,MATH 272A,A00,087437,Tian; Xiaochuan,1,0,8,7
1653459228722,MATH 274,A01,087439,Cheng; Li-Tien,9,0,10,1
1653459228722,MATH 274,A02,087440,Cheng; Li-Tien,10,0,10,0
1653459229244,MATH 278A,A00,087441,Staff,8,0,10,2
1653459229768,MATH 278B,A00,087442,Staff,8,0,10,2
1653459230289,MATH 278C,A00,087443,Staff,8,0,10,2
1653459230815,MATH 280A,A00,087444,Zheng; Tianyi,0,0,8,8
1653459231347,MATH 281A,A00,087445,Bradic; Jelena,0,0,8,8
1653459231875,MATH 282A,A00,087446,Zhang; Danna,0,0,8,8
1653459232400,MATH 283,A00,087447,Tesler; Glenn,0,0,0,14
1653459232923,MATH 286,A00,087448,Kemp; Todd Aahron,5,0,8,3
1653459233455,MATH 287D,A00,087449,Bradic; Jelena,8,0,8,0
1653459233982,MATH 288,A00,087450,Staff,14,0,15,1
1653459233982,MATH 288,B00,087451,Staff,15,0,15,0
1653459233982,MATH 288,C00,087452,Staff,15,0,15,0
1653459234514,MATH 290A,A00,087453,Xu; Zhouli,7,0,8,1
1653459235038,MATH 291A,A00,087454,Xu; Zhouli,7,0,8,1
1653459235560,MATH 292,A00,087455,Staff,10,0,10,0
1653459236082,MATH 295,A00,087456,Staff,50,0,50,0
1653459236603,MATH 297,001,087457,Staff,998,0,999,1
1653459807376,COGS 200,A01,087991,Staff,47,0,50,3
1653459807898,COGS 201,A01,094504,Rangel; Lara M,17,0,25,8
1653459808420,COGS 203,A00,087992,Coulson; Seana M,18,0,20,2
1653459808948,COGS 210A,001,087993,Greene; Deanna Jacquelyn,9998,0,9999,1
1653459808948,COGS 210A,002,087994,Saygin; Ayse P,9999,0,9999,0
1653459808948,COGS 210A,003,087995,Xia; Haijun,9999,0,9999,0
1653459808948,COGS 210A,004,087996,Nitz; Douglas A.,9999,0,9999,0
1653459808948,COGS 210A,005,087997,Hollan; James D.,9999,0,9999,0
1653459808948,COGS 210A,006,087998,Deak; Gedeon O.,9998,0,9999,1
1653459808948,COGS 210A,007,087999,Rossano; Federico,9999,0,9999,0
1653459809471,COGS 211A,A00,088000,Coulson; Seana M,9997,0,9999,2
1653459809997,COGS 229,A00,088002,Staff,23,0,25,2
1653459810520,COGS 260,B00,094231,Staff,17,0,20,3
1653459810520,COGS 260,A00,088004,Nitz; Douglas A.,9998,0,9999,1
1653459811048,CSE 202,A00,090110,Paturi; Ramamohan,0,0,0,0
1653459811048,CSE 202,B00,090111,Paturi; Ramamohan,0,0,0,0
1653459811577,CSE 207B,A00,090112,Heninger; Nadia A,0,0,0,0
1653459812099,CSE 208,A00,094858,Micciancio; Daniele,0,0,0,0
1653459812622,CSE 210,A00,090113,Powell; Thomas Allan,0,0,0,0
1653459813152,CSE 219,A00,090898,Staff,0,0,0,0
1653459813678,CSE 221,A00,090114,Zhou; Yuan-Yuan,0,0,0,0
1653459814200,CSE 229A,A00,090115,Porter; George M,0,0,0,0
1653459814723,CSE 229C,A00,090116,Savage; Stefan,0,0,0,0
1653459815249,CSE 230,A00,090117,Jhala; Ranjit,0,0,0,0
1653459815774,CSE 232,A00,090118,Papakonstantinou; Yannis,0,0,0,0
1653459816297,CSE 239A,A00,090121,Kumar; Arun Kumar,0,0,0,0
1653459816821,CSE 239B,A00,090122,Jhala; Ranjit,0,0,0,0
1653459817343,CSE 240A,A00,090123,Zhao; Jishen,0,0,189,189
1653459817872,CSE 243A,A00,090124,Orailoglu; Alex,1,0,15,14
1653459818398,CSE 249B,A00,090125,Kahng; Andrew Byun,13,0,20,7
1653459818923,CSE 250A,A00,090126,Berg-Kirkpatrick; Taylor D,0,0,0,0
1653459819449,CSE 252A,A00,090127,Ochoa; Benjamin Lawrence,0,0,0,0
1653459819977,CSE 258,A01,090129,McAuley; Julian John,0,0,0,0
1653459820504,CSE 258R,A01,090131,McAuley; Julian John,0,0,0,0
1653459821030,CSE 274,A00,090132,Ramamoorthi; Ravi,0,0,0,0
1653459821555,CSE 276A,A00,090133,Christensen; Henrik I,0,0,0,0
1653459822077,CSE 276C,A00,090134,Christensen; Henrik I,0,0,0,0
1653459822600,CSE 290,A00,090135,Bafna; Vineet,0,0,0,0
1653459822600,CSE 290,B00,090136,Ramamoorthi; Ravi,0,0,0,0
1653459822600,CSE 290,C00,090137,Li; Tzumao,9,0,10,1
1653459822600,CSE 290,D00,090138,Zhou; Yuan-Yuan,10,0,10,0
1653459822600,CSE 290,E00,090139,Christensen; Henrik I,10,0,10,0
1653459822600,CSE 290,F00,094053,Shalev; Aaron D,0,0,0,0
1653459823127,CSE 291,A00,090140,Munyaka; Imani N. S.,0,0,0,0
1653459823127,CSE 291,B00,094880,Yu; Qi,0,0,0,0
1653459823127,CSE 291,C00,090142,Pannuto; Patrick William,0,0,0,0
1653459823127,CSE 291,D00,094881,Zhang; Yiying,0,0,0,0
1653459823127,CSE 291,E00,095118,Su; Hao,0,0,0,0
1653459823652,CSE 293,001,094905,Bafna; Vineet,9999,0,9999,0
1653459823652,CSE 293,002,094906,Bellare; Mihir,9999,0,9999,0
1653459823652,CSE 293,003,094907,Berg-Kirkpatrick; Taylor D,9999,0,9999,0
1653459823652,CSE 293,004,094908,Christensen; Henrik I,9999,0,9999,0
1653459823652,CSE 293,005,094909,Cottrell; Garrison W,9999,0,9999,0
1653459823652,CSE 293,006,094910,Deutsch; Alin Bernard,9999,0,9999,0
1653459823652,CSE 293,007,094911,Esmaeilzadeh; Hadi,9999,0,9999,0
1653459823652,CSE 293,008,094912,Freund; Yoav,9999,0,9999,0
1653459823652,CSE 293,009,094913,Griswold; William G.,9999,0,9999,0
1653459823652,CSE 293,010,094914,Gymrek; Melissa Ann,9999,0,9999,0
1653459823652,CSE 293,011,094915,Heninger; Nadia A,9999,0,9999,0
1653459823652,CSE 293,012,094916,Impagliazzo; Russell,9999,0,9999,0
1653459823652,CSE 293,013,094917,Jhala; Ranjit,9999,0,9999,0
1653459823652,CSE 293,014,094918,Kahng; Andrew Byun,9999,0,9999,0
1653459823652,CSE 293,015,094919,Kane; Daniel Mertz,9999,0,9999,0
1653459823652,CSE 293,016,094920,Kriegman; David J,9999,0,9999,0
1653459823652,CSE 293,017,094921,Kumar; Arun Kumar,9999,0,9999,0
1653459823652,CSE 293,018,094922,Lerner; Sorin,9999,0,9999,0
1653459823652,CSE 293,019,094923,Lovett; Shachar,9999,0,9999,0
1653459823652,CSE 293,020,094924,McAuley; Julian John,9999,0,9999,0
1653459823652,CSE 293,021,094925,Micciancio; Daniele,9999,0,9999,0
1653459823652,CSE 293,022,094926,Orailoglu; Alex,9999,0,9999,0
1653459823652,CSE 293,023,094927,Paturi; Ramamohan,9999,0,9999,0
1653459823652,CSE 293,024,094928,Polikarpova; Nadezhda,9999,0,9999,0
1653459823652,CSE 293,025,094929,Politz; Joseph Gibbs,9999,0,9999,0
1653459823652,CSE 293,026,094930,Porter; George M,9999,0,9999,0
1653459823652,CSE 293,027,094931,Porter; Leonard Emerson,9999,0,9999,0
1653459823652,CSE 293,028,094932,Ramamoorthi; Ravi,9999,0,9999,0
1653459823652,CSE 293,029,094933,Sahoo; Debashis,9999,0,9999,0
1653459823652,CSE 293,030,094934,Saul; Lawrence,9999,0,9999,0
1653459823652,CSE 293,031,094935,Savage; Stefan,9999,0,9999,0
1653459823652,CSE 293,032,094936,Schulze; Jurgen P.,9999,0,9999,0
1653459823652,CSE 293,033,094937,Snoeren; Alex C.,9999,0,9999,0
1653459823652,CSE 293,034,094938,Shang; Jingbo,9999,0,9999,0
1653459823652,CSE 293,035,094939,Stefan; Deian,9999,0,9999,0
1653459823652,CSE 293,036,094940,Su; Hao,9999,0,9999,0
1653459823652,CSE 293,037,094941,Swanson; Steven James,9999,0,9999,0
1653459823652,CSE 293,038,094942,Tullsen; Dean Michael,9999,0,9999,0
1653459823652,CSE 293,039,094943,Voelker; Geoffrey M.,9999,0,9999,0
1653459823652,CSE 293,040,094944,Zhao; Jishen,9999,0,9999,0
1653459823652,CSE 293,041,094945,Zhou; Yuan-Yuan,9999,0,9999,0
1653459823652,CSE 293,042,094946,Gao; Sicun,9998,0,9999,1
1653459823652,CSE 293,043,094947,Weibel; Nadir,9999,0,9999,0
1653459823652,CSE 293,044,094948,Gupta; Rajesh K.,9999,0,9999,0
1653459824175,CSE 294,A00,090143,Porter; George M,9,0,10,1
1653459824704,DSE 200,A00,091799,Staff,50,0,50,0
1653459825242,DSE 203,A00,091800,Gupta; Amarnath,30,0,30,0
1653459825773,DSE 250,A00,091801,Deutsch; Alin Bernard,30,0,30,0
1653459826303,DSE 290,A00,091802,Altintas De Callaf; Ilkay,50,0,50,0
1653459826830,ECE 200,001,091003,Antipa; Nicholas A,9999,0,9999,0
1653459826830,ECE 200,002,091004,Atanasov; Nikolay A.,9999,0,9999,0
1653459826830,ECE 200,003,091005,Bharadia; Dinesh,9999,0,9999,0
1653459826830,ECE 200,004,091006,Cheng; Chung Kuan,9999,0,9999,0
1653459826830,ECE 200,005,091007,Cosman; Pamela C.,9999,0,9999,0
1653459826830,ECE 200,006,091008,Staff,9999,0,9999,0
1653459826830,ECE 200,007,091009,Dayeh; Shadi Ahmad,9999,0,9999,0
1653459826830,ECE 200,008,091010,Fainman; Yeshaiahu,9999,0,9999,0
1653459826830,ECE 200,009,091011,Ford; Joseph Earl,9999,0,9999,0
1653459826830,ECE 200,010,091012,Franceschetti; Massimo,9999,0,9999,0
1653459826830,ECE 200,011,091013,Fullerton; Eric E,9999,0,9999,0
1653459826830,ECE 200,012,091014,Galton; Ian A,9999,0,9999,0
1653459826830,ECE 200,013,091015,Gilja; Vikash,9999,0,9999,0
1653459826830,ECE 200,014,091016,Hall; Drew A.,9999,0,9999,0
1653459826830,ECE 200,015,091017,Hsueh; Tzu-Chien,9999,0,9999,0
1653459826830,ECE 200,016,091018,Javidi; Tara,9999,0,9999,0
1653459826830,ECE 200,017,091019,Kahng; Andrew Byun,9999,0,9999,0
1653459826830,ECE 200,018,091020,Kim; Young-Han,9999,0,9999,0
1653459826830,ECE 200,019,091021,Koushanfar; Farinaz,9999,0,9999,0
1653459826830,ECE 200,020,091022,Kuzum; Duygu,9999,0,9999,0
1653459826830,ECE 200,021,091023,Le; Hanh-Phuc,9999,0,9999,0
1653459826830,ECE 200,022,091024,Lin; Bill,9999,0,9999,0
1653459826830,ECE 200,023,091025,Liu; Zhaowei,9999,0,9999,0
1653459826830,ECE 200,024,091026,Lo; Yu-Hwa,9999,0,9999,0
1653459826830,ECE 200,025,091027,Lomakin; Vitaliy,9999,0,9999,0
1653459826830,ECE 200,026,091028,Mercier; Patrick Philip,9999,0,9999,0
1653459826830,ECE 200,027,091029,Meyer; Florian,9999,0,9999,0
1653459826830,ECE 200,028,091030,Milstein; Laurence B.,9999,0,9999,0
1653459826830,ECE 200,029,091031,Mir Arabbaygi; Siavash,9999,0,9999,0
1653459826830,ECE 200,030,091032,Mookherjea; Shayan,9999,0,9999,0
1653459826830,ECE 200,031,091033,Morris; Karcher William,9999,0,9999,0
1653459826830,ECE 200,032,091034,Ng; Tse Nga,9999,0,9999,0
1653459826830,ECE 200,033,091035,Nguyen; Truong Quang,9999,0,9999,0
1653459826830,ECE 200,034,091036,Nomura; Kenji,9999,0,9999,0
1653459826830,ECE 200,035,091037,Orlitsky; Alon,9999,0,9999,0
1653459826830,ECE 200,036,091038,Pal; Piya,9999,0,9999,0
1653459826830,ECE 200,037,091039,Papen; George C.,9999,0,9999,0
1653459826830,ECE 200,038,091040,Radic; Stojan,9999,0,9999,0
1653459826830,ECE 200,039,091041,Rao; Bhaskar D.,9999,0,9999,0
1653459826830,ECE 200,040,091042,Rao; Ramesh R,9999,0,9999,0
1653459826830,ECE 200,041,091043,Rebeiz; Gabriel,9999,0,9999,0
1653459826830,ECE 200,042,091044,Sanford; John R,9999,0,9999,0
1653459826830,ECE 200,043,091045,Siegel; Paul H.,9999,0,9999,0
1653459826830,ECE 200,044,091046,Sievenpiper; Daniel F.,9999,0,9999,0
1653459826830,ECE 200,045,091047,Sworder; David D.,9999,0,9999,0
1653459826830,ECE 200,046,091048,Taur; Yuan,9999,0,9999,0
1653459826830,ECE 200,047,091049,Touri; Behrouz,9999,0,9999,0
1653459826830,ECE 200,048,091050,Trivedi; Mohan M.,9999,0,9999,0
1653459826830,ECE 200,049,091051,Vardy; Alexander,9999,0,9999,0
1653459826830,ECE 200,050,091052,Vasconcelos; Nuno,9999,0,9999,0
1653459826830,ECE 200,051,091053,Wang; Xiaolong,9999,0,9999,0
1653459826830,ECE 200,052,091054,Xie; Pengtao,9999,0,9999,0
1653459826830,ECE 200,053,091055,Yip; Michael,9999,0,9999,0
1653459826830,ECE 200,054,091056,Zeger; Kenneth A.,9999,0,9999,0
1653459826830,ECE 200,055,091057,Zhang; Xinyu,9999,0,9999,0
1653459826830,ECE 200,056,091058,Turakhia; Yatish Girish,9999,0,9999,0
1653459826830,ECE 200,057,091059,Kang; Mingu,9999,0,9999,0
1653459826830,ECE 200,058,091060,Shi; Yuanyuan,9999,0,9999,0
1653459826830,ECE 200,059,091061,Wang; Edward Jay,9999,0,9999,0
1653459826830,ECE 200,060,091062,Zheng; Yang,9999,0,9999,0
1653459827353,ECE 203,A00,091065,Mercier; Patrick Philip,0,0,0,0
1653459827880,ECE 207A,A00,091605,Liu; Thomas Tao-Ming,0,0,0,0
1653459828405,ECE 212AN,A00,091068,Nomura; Kenji,0,0,0,0
1653459828932,ECE 222A,A00,091069,Rebeiz; Gabriel,0,0,0,0
1653459829460,ECE 225A,A00,091070,Orlitsky; Alon,0,0,0,0
1653459829988,ECE 230A,A00,091071,Nomura; Kenji,0,0,0,0
1653459830527,ECE 236A,A00,091072,Dayeh; Shadi Ahmad,0,0,0,0
1653459831064,ECE 238A,A00,091073,Luo; Jian,0,0,0,0
1653459831064,ECE 238A,B00,091074,Luo; Jian,0,0,0,0
1653459831586,ECE 240A,A00,091075,Radic; Stojan,0,0,0,0
1653459832116,ECE 247A,A00,091592,Shi; Lingyan,0,0,0,0
1653459832639,ECE 250,A00,091076,Touri; Behrouz,0,0,0,0
1653459833162,ECE 251C,A00,091078,Nguyen; Truong Quang,0,0,0,0
1653459833687,ECE 253,A00,091079,Cosman; Pamela C.,0,0,0,0
1653459834210,ECE 255A,A00,091080,Orlitsky; Alon,0,0,0,0
1653459834735,ECE 257A,A00,091081,Zhang; Xinyu,0,0,0,0
1653459835258,ECE 260A,A01,091084,Eldon; John,0,0,0,0
1653459835781,ECE 264C,A00,091085,Galton; Ian A,0,0,0,0
1653459836311,ECE 265C,A00,094889,Presti; Calogero Davide,0,0,0,9
1653459836854,ECE 266,A01,091087,Hall; Drew A.,0,0,0,0
1653459837902,ECE 271A,A00,091090,Vasconcelos; Nuno,0,0,0,0
1653459838427,ECE 272B,A00,091091,Sworder; David D.,0,0,0,0
1653459838953,ECE 275A,A00,091092,Meyer; Florian,0,0,0,0
1653459839475,ECE 277,A00,091093,An; Cheolhong,0,0,0,0
1653459839998,ECE 283,A00,091094,Le; Hanh-Phuc,0,0,0,0
1653459840531,ECE 284,A00,091095,Kang; Mingu,0,0,0,0
1653459840531,ECE 284,B00,091096,Wang; Edward Jay,0,0,0,0
1653459841055,ECE 285,A00,094334,Touri; Behrouz,0,0,0,0
1653459841580,ECE 289,A00,091097,Whelan; David Arthur,0,0,0,0
1653459842109,MATH 200A,A00,087414,Salehi Golsefidy; Alireza,7,0,8,1
1653459842633,MATH 202A,A00,087415,Gill; Philip E.,3,0,8,5
1653459843155,MATH 203A,A00,087416,Oprea; Dragos N.,6,0,8,2
1653459843682,MATH 204A,A00,087417,Kedlaya; Kiran S.,6,0,8,2
1653459844303,MATH 205,A00,087418,Sorensen; Claus M,6,0,8,2
1653459844828,MATH 206A,A00,087419,Izadi; Elham,7,0,8,1
1653459845351,MATH 207A,A00,087420,Mohammadi; Amir,6,0,8,2
1653459845879,MATH 208,A00,087421,Staff,9,0,10,1
1653459846401,MATH 209,A00,087422,Staff,10,0,10,0
1653459846923,MATH 218,A00,087423,Staff,10,0,10,0
1653459847447,MATH 220A,A00,087424,Novak; Jonathan I,7,0,8,1
1653459847970,MATH 231A,A00,087425,Bejenaru; Ioan,3,0,8,5
1653459848493,MATH 240A,A00,087426,Ebenfelt; Peter F,5,0,8,3
1653459849022,MATH 243,A00,087427,Staff,9,0,10,1
1653459849546,MATH 248,A00,087429,Staff,10,0,10,0
1653459850073,MATH 250A,A00,087430,Spolaor; Luca,4,0,8,4
1653459850603,MATH 257A,A00,087431,Spolaor; Luca,7,0,8,1
1653459851128,MATH 258,A00,087432,Staff,9,0,10,1
1653459851650,MATH 264A,A00,087433,Warnke; Lutz Peter,5,0,8,3
1653459852178,MATH 268,A00,087434,Staff,15,0,15,0
1653459852704,MATH 269,A00,087435,Staff,14,0,15,1
1653459853230,MATH 270A,A00,087436,Nie; Jiawang,0,0,8,8
1653459853756,MATH 272A,A00,087437,Tian; Xiaochuan,1,0,8,7
1653459854279,MATH 274,A01,087439,Cheng; Li-Tien,9,0,10,1
1653459854279,MATH 274,A02,087440,Cheng; Li-Tien,10,0,10,0
1653459854804,MATH 278A,A00,087441,Staff,8,0,10,2
1653459855330,MATH 278B,A00,087442,Staff,8,0,10,2
1653459855855,MATH 278C,A00,087443,Staff,8,0,10,2
1653459856381,MATH 280A,A00,087444,Zheng; Tianyi,0,0,8,8
1653459856903,MATH 281A,A00,087445,Bradic; Jelena,0,0,8,8
1653459857429,MATH 282A,A00,087446,Zhang; Danna,0,0,8,8
1653459857955,MATH 283,A00,087447,Tesler; Glenn,0,0,0,14
1653459858481,MATH 286,A00,087448,Kemp; Todd Aahron,5,0,8,3
1653459859004,MATH 287D,A00,087449,Bradic; Jelena,8,0,8,0
1653459859527,MATH 288,A00,087450,Staff,14,0,15,1
1653459859527,MATH 288,B00,087451,Staff,15,0,15,0
1653459859527,MATH 288,C00,087452,Staff,15,0,15,0
1653459860051,MATH 290A,A00,087453,Xu; Zhouli,7,0,8,1
1653459860577,MATH 291A,A00,087454,Xu; Zhouli,7,0,8,1
1653459861103,MATH 292,A00,087455,Staff,10,0,10,0
1653459861625,MATH 295,A00,087456,Staff,50,0,50,0
1653459862154,MATH 297,001,087457,Staff,998,0,999,1
1653460422030,COGS 200,A01,087991,Staff,47,0,50,3
1653460422553,COGS 201,A01,094504,Rangel; Lara M,17,0,25,8
1653460423076,COGS 203,A00,087992,Coulson; Seana M,18,0,20,2
1653460423600,COGS 210A,001,087993,Greene; Deanna Jacquelyn,9998,0,9999,1
1653460423600,COGS 210A,002,087994,Saygin; Ayse P,9999,0,9999,0
1653460423600,COGS 210A,003,087995,Xia; Haijun,9999,0,9999,0
1653460423600,COGS 210A,004,087996,Nitz; Douglas A.,9999,0,9999,0
1653460423600,COGS 210A,005,087997,Hollan; James D.,9999,0,9999,0
1653460423600,COGS 210A,006,087998,Deak; Gedeon O.,9998,0,9999,1
1653460423600,COGS 210A,007,087999,Rossano; Federico,9999,0,9999,0
1653460424123,COGS 211A,A00,088000,Coulson; Seana M,9997,0,9999,2
1653460424649,COGS 229,A00,088002,Staff,23,0,25,2
1653460425175,COGS 260,B00,094231,Staff,17,0,20,3
1653460425175,COGS 260,A00,088004,Nitz; Douglas A.,9998,0,9999,1
1653460425705,CSE 202,A00,090110,Paturi; Ramamohan,0,0,0,0
1653460425705,CSE 202,B00,090111,Paturi; Ramamohan,0,0,0,0
1653460426230,CSE 207B,A00,090112,Heninger; Nadia A,0,0,0,0
1653460426753,CSE 208,A00,094858,Micciancio; Daniele,0,0,0,0
1653460427275,CSE 210,A00,090113,Powell; Thomas Allan,0,0,0,0
1653460427805,CSE 219,A00,090898,Staff,0,0,0,0
1653460428327,CSE 221,A00,090114,Zhou; Yuan-Yuan,0,0,0,0
1653460428850,CSE 229A,A00,090115,Porter; George M,0,0,0,0
1653460429377,CSE 229C,A00,090116,Savage; Stefan,0,0,0,0
1653460429904,CSE 230,A00,090117,Jhala; Ranjit,0,0,0,0
1653460430431,CSE 232,A00,090118,Papakonstantinou; Yannis,0,0,0,0
1653460430959,CSE 239A,A00,090121,Kumar; Arun Kumar,0,0,0,0
1653460431554,CSE 239B,A00,090122,Jhala; Ranjit,0,0,0,0
1653460432080,CSE 240A,A00,090123,Zhao; Jishen,0,0,189,189
1653460432611,CSE 243A,A00,090124,Orailoglu; Alex,1,0,15,14
1653460433133,CSE 249B,A00,090125,Kahng; Andrew Byun,13,0,20,7
1653460433656,CSE 250A,A00,090126,Berg-Kirkpatrick; Taylor D,0,0,0,0
1653460434178,CSE 252A,A00,090127,Ochoa; Benjamin Lawrence,0,0,0,0
1653460434704,CSE 258,A01,090129,McAuley; Julian John,0,0,0,0
1653460435246,CSE 258R,A01,090131,McAuley; Julian John,0,0,0,0
1653460435772,CSE 274,A00,090132,Ramamoorthi; Ravi,0,0,0,0
1653460436296,CSE 276A,A00,090133,Christensen; Henrik I,0,0,0,0
1653460436822,CSE 276C,A00,090134,Christensen; Henrik I,0,0,0,0
1653460437352,CSE 290,A00,090135,Bafna; Vineet,0,0,0,0
1653460437352,CSE 290,B00,090136,Ramamoorthi; Ravi,0,0,0,0
1653460437352,CSE 290,C00,090137,Li; Tzumao,9,0,10,1
1653460437352,CSE 290,D00,090138,Zhou; Yuan-Yuan,10,0,10,0
1653460437352,CSE 290,E00,090139,Christensen; Henrik I,10,0,10,0
1653460437352,CSE 290,F00,094053,Shalev; Aaron D,0,0,0,0
1653460437875,CSE 291,A00,090140,Munyaka; Imani N. S.,0,0,0,0
1653460437875,CSE 291,B00,094880,Yu; Qi,0,0,0,0
1653460437875,CSE 291,C00,090142,Pannuto; Patrick William,0,0,0,0
1653460437875,CSE 291,D00,094881,Zhang; Yiying,0,0,0,0
1653460437875,CSE 291,E00,095118,Su; Hao,0,0,0,0
1653460438412,CSE 293,001,094905,Bafna; Vineet,9999,0,9999,0
1653460438412,CSE 293,002,094906,Bellare; Mihir,9999,0,9999,0
1653460438412,CSE 293,003,094907,Berg-Kirkpatrick; Taylor D,9999,0,9999,0
1653460438412,CSE 293,004,094908,Christensen; Henrik I,9999,0,9999,0
1653460438412,CSE 293,005,094909,Cottrell; Garrison W,9999,0,9999,0
1653460438412,CSE 293,006,094910,Deutsch; Alin Bernard,9999,0,9999,0
1653460438412,CSE 293,007,094911,Esmaeilzadeh; Hadi,9999,0,9999,0
1653460438412,CSE 293,008,094912,Freund; Yoav,9999,0,9999,0
1653460438412,CSE 293,009,094913,Griswold; William G.,9999,0,9999,0
1653460438412,CSE 293,010,094914,Gymrek; Melissa Ann,9999,0,9999,0
1653460438412,CSE 293,011,094915,Heninger; Nadia A,9999,0,9999,0
1653460438412,CSE 293,012,094916,Impagliazzo; Russell,9999,0,9999,0
1653460438412,CSE 293,013,094917,Jhala; Ranjit,9999,0,9999,0
1653460438412,CSE 293,014,094918,Kahng; Andrew Byun,9999,0,9999,0
1653460438412,CSE 293,015,094919,Kane; Daniel Mertz,9999,0,9999,0
1653460438412,CSE 293,016,094920,Kriegman; David J,9999,0,9999,0
1653460438412,CSE 293,017,094921,Kumar; Arun Kumar,9999,0,9999,0
1653460438412,CSE 293,018,094922,Lerner; Sorin,9999,0,9999,0
1653460438412,CSE 293,019,094923,Lovett; Shachar,9999,0,9999,0
1653460438412,CSE 293,020,094924,McAuley; Julian John,9999,0,9999,0
1653460438412,CSE 293,021,094925,Micciancio; Daniele,9999,0,9999,0
1653460438412,CSE 293,022,094926,Orailoglu; Alex,9999,0,9999,0
1653460438412,CSE 293,023,094927,Paturi; Ramamohan,9999,0,9999,0
1653460438412,CSE 293,024,094928,Polikarpova; Nadezhda,9999,0,9999,0
1653460438412,CSE 293,025,094929,Politz; Joseph Gibbs,9999,0,9999,0
1653460438412,CSE 293,026,094930,Porter; George M,9999,0,9999,0
1653460438412,CSE 293,027,094931,Porter; Leonard Emerson,9999,0,9999,0
1653460438412,CSE 293,028,094932,Ramamoorthi; Ravi,9999,0,9999,0
1653460438412,CSE 293,029,094933,Sahoo; Debashis,9999,0,9999,0
1653460438412,CSE 293,030,094934,Saul; Lawrence,9999,0,9999,0
1653460438412,CSE 293,031,094935,Savage; Stefan,9999,0,9999,0
1653460438412,CSE 293,032,094936,Schulze; Jurgen P.,9999,0,9999,0
1653460438412,CSE 293,033,094937,Snoeren; Alex C.,9999,0,9999,0
1653460438412,CSE 293,034,094938,Shang; Jingbo,9999,0,9999,0
1653460438412,CSE 293,035,094939,Stefan; Deian,9999,0,9999,0
1653460438412,CSE 293,036,094940,Su; Hao,9999,0,9999,0
1653460438412,CSE 293,037,094941,Swanson; Steven James,9999,0,9999,0
1653460438412,CSE 293,038,094942,Tullsen; Dean Michael,9999,0,9999,0
1653460438412,CSE 293,039,094943,Voelker; Geoffrey M.,9999,0,9999,0
1653460438412,CSE 293,040,094944,Zhao; Jishen,9999,0,9999,0
1653460438412,CSE 293,041,094945,Zhou; Yuan-Yuan,9999,0,9999,0
1653460438412,CSE 293,042,094946,Gao; Sicun,9998,0,9999,1
1653460438412,CSE 293,043,094947,Weibel; Nadir,9999,0,9999,0
1653460438412,CSE 293,044,094948,Gupta; Rajesh K.,9999,0,9999,0
1653460438934,CSE 294,A00,090143,Porter; George M,9,0,10,1
1653460439460,DSE 200,A00,091799,Staff,50,0,50,0
1653460439981,DSE 203,A00,091800,Gupta; Amarnath,30,0,30,0
1653460440506,DSE 250,A00,091801,Deutsch; Alin Bernard,30,0,30,0
1653460441039,DSE 290,A00,091802,Altintas De Callaf; Ilkay,50,0,50,0
1653460441587,ECE 200,001,091003,Antipa; Nicholas A,9999,0,9999,0
1653460441587,ECE 200,002,091004,Atanasov; Nikolay A.,9999,0,9999,0
1653460441587,ECE 200,003,091005,Bharadia; Dinesh,9999,0,9999,0
1653460441587,ECE 200,004,091006,Cheng; Chung Kuan,9999,0,9999,0
1653460441587,ECE 200,005,091007,Cosman; Pamela C.,9999,0,9999,0
1653460441587,ECE 200,006,091008,Staff,9999,0,9999,0
1653460441587,ECE 200,007,091009,Dayeh; Shadi Ahmad,9999,0,9999,0
1653460441587,ECE 200,008,091010,Fainman; Yeshaiahu,9999,0,9999,0
1653460441587,ECE 200,009,091011,Ford; Joseph Earl,9999,0,9999,0
1653460441587,ECE 200,010,091012,Franceschetti; Massimo,9999,0,9999,0
1653460441587,ECE 200,011,091013,Fullerton; Eric E,9999,0,9999,0
1653460441587,ECE 200,012,091014,Galton; Ian A,9999,0,9999,0
1653460441587,ECE 200,013,091015,Gilja; Vikash,9999,0,9999,0
1653460441587,ECE 200,014,091016,Hall; Drew A.,9999,0,9999,0
1653460441587,ECE 200,015,091017,Hsueh; Tzu-Chien,9999,0,9999,0
1653460441587,ECE 200,016,091018,Javidi; Tara,9999,0,9999,0
1653460441587,ECE 200,017,091019,Kahng; Andrew Byun,9999,0,9999,0
1653460441587,ECE 200,018,091020,Kim; Young-Han,9999,0,9999,0
1653460441587,ECE 200,019,091021,Koushanfar; Farinaz,9999,0,9999,0
1653460441587,ECE 200,020,091022,Kuzum; Duygu,9999,0,9999,0
1653460441587,ECE 200,021,091023,Le; Hanh-Phuc,9999,0,9999,0
1653460441587,ECE 200,022,091024,Lin; Bill,9999,0,9999,0
1653460441587,ECE 200,023,091025,Liu; Zhaowei,9999,0,9999,0
1653460441587,ECE 200,024,091026,Lo; Yu-Hwa,9999,0,9999,0
1653460441587,ECE 200,025,091027,Lomakin; Vitaliy,9999,0,9999,0
1653460441587,ECE 200,026,091028,Mercier; Patrick Philip,9999,0,9999,0
1653460441587,ECE 200,027,091029,Meyer; Florian,9999,0,9999,0
1653460441587,ECE 200,028,091030,Milstein; Laurence B.,9999,0,9999,0
1653460441587,ECE 200,029,091031,Mir Arabbaygi; Siavash,9999,0,9999,0
1653460441587,ECE 200,030,091032,Mookherjea; Shayan,9999,0,9999,0
1653460441587,ECE 200,031,091033,Morris; Karcher William,9999,0,9999,0
1653460441587,ECE 200,032,091034,Ng; Tse Nga,9999,0,9999,0
1653460441587,ECE 200,033,091035,Nguyen; Truong Quang,9999,0,9999,0
1653460441587,ECE 200,034,091036,Nomura; Kenji,9999,0,9999,0
1653460441587,ECE 200,035,091037,Orlitsky; Alon,9999,0,9999,0
1653460441587,ECE 200,036,091038,Pal; Piya,9999,0,9999,0
1653460441587,ECE 200,037,091039,Papen; George C.,9999,0,9999,0
1653460441587,ECE 200,038,091040,Radic; Stojan,9999,0,9999,0
1653460441587,ECE 200,039,091041,Rao; Bhaskar D.,9999,0,9999,0
1653460441587,ECE 200,040,091042,Rao; Ramesh R,9999,0,9999,0
1653460441587,ECE 200,041,091043,Rebeiz; Gabriel,9999,0,9999,0
1653460441587,ECE 200,042,091044,Sanford; John R,9999,0,9999,0
1653460441587,ECE 200,043,091045,Siegel; Paul H.,9999,0,9999,0
1653460441587,ECE 200,044,091046,Sievenpiper; Daniel F.,9999,0,9999,0
1653460441587,ECE 200,045,091047,Sworder; David D.,9999,0,9999,0
1653460441587,ECE 200,046,091048,Taur; Yuan,9999,0,9999,0
1653460441587,ECE 200,047,091049,Touri; Behrouz,9999,0,9999,0
1653460441587,ECE 200,048,091050,Trivedi; Mohan M.,9999,0,9999,0
1653460441587,ECE 200,049,091051,Vardy; Alexander,9999,0,9999,0
1653460441587,ECE 200,050,091052,Vasconcelos; Nuno,9999,0,9999,0
1653460441587,ECE 200,051,091053,Wang; Xiaolong,9999,0,9999,0
1653460441587,ECE 200,052,091054,Xie; Pengtao,9999,0,9999,0
1653460441587,ECE 200,053,091055,Yip; Michael,9999,0,9999,0
1653460441587,ECE 200,054,091056,Zeger; Kenneth A.,9999,0,9999,0
1653460441587,ECE 200,055,091057,Zhang; Xinyu,9999,0,9999,0
1653460441587,ECE 200,056,091058,Turakhia; Yatish Girish,9999,0,9999,0
1653460441587,ECE 200,057,091059,Kang; Mingu,9999,0,9999,0
1653460441587,ECE 200,058,091060,Shi; Yuanyuan,9999,0,9999,0
1653460441587,ECE 200,059,091061,Wang; Edward Jay,9999,0,9999,0
1653460441587,ECE 200,060,091062,Zheng; Yang,9999,0,9999,0
1653460442117,ECE 203,A00,091065,Mercier; Patrick Philip,0,0,0,0
1653460442648,ECE 207A,A00,091605,Liu; Thomas Tao-Ming,0,0,0,0
1653460443181,ECE 212AN,A00,091068,Nomura; Kenji,0,0,0,0
1653460443705,ECE 222A,A00,091069,Rebeiz; Gabriel,0,0,0,0
1653460444230,ECE 225A,A00,091070,Orlitsky; Alon,0,0,0,0
1653460444757,ECE 230A,A00,091071,Nomura; Kenji,0,0,0,0
1653460445286,ECE 236A,A00,091072,Dayeh; Shadi Ahmad,0,0,0,0
1653460445828,ECE 238A,A00,091073,Luo; Jian,0,0,0,0
1653460445828,ECE 238A,B00,091074,Luo; Jian,0,0,0,0
1653460446352,ECE 240A,A00,091075,Radic; Stojan,0,0,0,0
1653460446883,ECE 247A,A00,091592,Shi; Lingyan,0,0,0,0
1653460447409,ECE 250,A00,091076,Touri; Behrouz,0,0,0,0
1653460447932,ECE 251C,A00,091078,Nguyen; Truong Quang,0,0,0,0
1653460448454,ECE 253,A00,091079,Cosman; Pamela C.,0,0,0,0
1653460448987,ECE 255A,A00,091080,Orlitsky; Alon,0,0,0,0
1653460449513,ECE 257A,A00,091081,Zhang; Xinyu,0,0,0,0
1653460450035,ECE 260A,A01,091084,Eldon; John,0,0,0,0
1653460450558,ECE 264C,A00,091085,Galton; Ian A,0,0,0,0
1653460451092,ECE 265C,A00,094889,Presti; Calogero Davide,0,0,0,9
1653460451613,ECE 266,A01,091087,Hall; Drew A.,0,0,0,0
1653460452669,ECE 271A,A00,091090,Vasconcelos; Nuno,0,0,0,0
1653460453192,ECE 272B,A00,091091,Sworder; David D.,0,0,0,0
1653460453716,ECE 275A,A00,091092,Meyer; Florian,0,0,0,0
1653460454238,ECE 277,A00,091093,An; Cheolhong,0,0,0,0
1653460454761,ECE 283,A00,091094,Le; Hanh-Phuc,0,0,0,0
1653460455287,ECE 284,A00,091095,Kang; Mingu,0,0,0,0
1653460455287,ECE 284,B00,091096,Wang; Edward Jay,0,0,0,0
1653460455810,ECE 285,A00,094334,Touri; Behrouz,0,0,0,0
1653460456335,ECE 289,A00,091097,Whelan; David Arthur,0,0,0,0
1653460456861,MATH 200A,A00,087414,Salehi Golsefidy; Alireza,7,0,8,1
1653460457387,MATH 202A,A00,087415,Gill; Philip E.,3,0,8,5
1653460457910,MATH 203A,A00,087416,Oprea; Dragos N.,6,0,8,2
1653460458435,MATH 204A,A00,087417,Kedlaya; Kiran S.,6,0,8,2
1653460458959,MATH 205,A00,087418,Sorensen; Claus M,6,0,8,2
1653460459486,MATH 206A,A00,087419,Izadi; Elham,7,0,8,1
1653460460011,MATH 207A,A00,087420,Mohammadi; Amir,6,0,8,2
1653460460538,MATH 208,A00,087421,Staff,9,0,10,1
1653460461062,MATH 209,A00,087422,Staff,10,0,10,0
1653460461587,MATH 218,A00,087423,Staff,10,0,10,0
1653460462113,MATH 220A,A00,087424,Novak; Jonathan I,7,0,8,1
1653460462636,MATH 231A,A00,087425,Bejenaru; Ioan,3,0,8,5
1653460463160,MATH 240A,A00,087426,Ebenfelt; Peter F,5,0,8,3
1653460463691,MATH 243,A00,087427,Staff,9,0,10,1
1653460464213,MATH 248,A00,087429,Staff,10,0,10,0
1653460464736,MATH 250A,A00,087430,Spolaor; Luca,4,0,8,4
1653460465263,MATH 257A,A00,087431,Spolaor; Luca,7,0,8,1
1653460465794,MATH 258,A00,087432,Staff,9,0,10,1
1653460466320,MATH 264A,A00,087433,Warnke; Lutz Peter,5,0,8,3
1653460466843,MATH 268,A00,087434,Staff,15,0,15,0
1653460467366,MATH 269,A00,087435,Staff,14,0,15,1
1653460467889,MATH 270A,A00,087436,Nie; Jiawang,0,0,8,8
1653460468413,MATH 272A,A00,087437,Tian; Xiaochuan,1,0,8,7
1653460468937,MATH 274,A01,087439,Cheng; Li-Tien,9,0,10,1
1653460468937,MATH 274,A02,087440,Cheng; Li-Tien,10,0,10,0
1653460469467,MATH 278A,A00,087441,Staff,8,0,10,2
1653460469990,MATH 278B,A00,087442,Staff,8,0,10,2
1653460470515,MATH 278C,A00,087443,Staff,8,0,10,2
1653460471049,MATH 280A,A00,087444,Zheng; Tianyi,0,0,8,8
1653460471588,MATH 281A,A00,087445,Bradic; Jelena,0,0,8,8
1653460472112,MATH 282A,A00,087446,Zhang; Danna,0,0,8,8
1653460472635,MATH 283,A00,087447,Tesler; Glenn,0,0,0,14
1653460473163,MATH 286,A00,087448,Kemp; Todd Aahron,5,0,8,3
1653460473689,MATH 287D,A00,087449,Bradic; Jelena,8,0,8,0
1653460474215,MATH 288,A00,087450,Staff,14,0,15,1
1653460474215,MATH 288,B00,087451,Staff,15,0,15,0
1653460474215,MATH 288,C00,087452,Staff,15,0,15,0
1653460474740,MATH 290A,A00,087453,Xu; Zhouli,7,0,8,1
1653460475266,MATH 291A,A00,087454,Xu; Zhouli,7,0,8,1
1653460475797,MATH 292,A00,087455,Staff,10,0,10,0
1653460476319,MATH 295,A00,087456,Staff,50,0,50,0
1653460476844,MATH 297,001,087457,Staff,998,0,999,1
1653461036500,COGS 200,A01,087991,Staff,47,0,50,3
1653461037024,COGS 201,A01,094504,Rangel; Lara M,17,0,25,8
1653461037547,COGS 203,A00,087992,Coulson; Seana M,18,0,20,2
1653461038079,COGS 210A,001,087993,Greene; Deanna Jacquelyn,9998,0,9999,1
1653461038079,COGS 210A,002,087994,Saygin; Ayse P,9999,0,9999,0
1653461038079,COGS 210A,003,087995,Xia; Haijun,9999,0,9999,0
1653461038079,COGS 210A,004,087996,Nitz; Douglas A.,9999,0,9999,0
1653461038079,COGS 210A,005,087997,Hollan; James D.,9999,0,9999,0
1653461038079,COGS 210A,006,087998,Deak; Gedeon O.,9998,0,9999,1
1653461038079,COGS 210A,007,087999,Rossano; Federico,9999,0,9999,0
1653461038603,COGS 211A,A00,088000,Coulson; Seana M,9997,0,9999,2
1653461039126,COGS 229,A00,088002,Staff,23,0,25,2
1653461039664,COGS 260,B00,094231,Staff,17,0,20,3
1653461039664,COGS 260,A00,088004,Nitz; Douglas A.,9998,0,9999,1
1653461040195,CSE 202,A00,090110,Paturi; Ramamohan,0,0,0,0
1653461040195,CSE 202,B00,090111,Paturi; Ramamohan,0,0,0,0
1653461040794,CSE 207B,A00,090112,Heninger; Nadia A,0,0,0,0
1653461041326,CSE 208,A00,094858,Micciancio; Daniele,0,0,0,0
1653461041848,CSE 210,A00,090113,Powell; Thomas Allan,0,0,0,0
1653461042372,CSE 219,A00,090898,Staff,0,0,0,0
1653461042912,CSE 221,A00,090114,Zhou; Yuan-Yuan,0,0,0,0
1653461043438,CSE 229A,A00,090115,Porter; George M,0,0,0,0
1653461043963,CSE 229C,A00,090116,Savage; Stefan,0,0,0,0
1653461044488,CSE 230,A00,090117,Jhala; Ranjit,0,0,0,0
1653461045013,CSE 232,A00,090118,Papakonstantinou; Yannis,0,0,0,0
1653461045534,CSE 239A,A00,090121,Kumar; Arun Kumar,0,0,0,0
1653461046066,CSE 239B,A00,090122,Jhala; Ranjit,0,0,0,0
1653461046589,CSE 240A,A00,090123,Zhao; Jishen,0,0,189,189
1653461047112,CSE 243A,A00,090124,Orailoglu; Alex,1,0,15,14
1653461047634,CSE 249B,A00,090125,Kahng; Andrew Byun,13,0,20,7
1653461048161,CSE 250A,A00,090126,Berg-Kirkpatrick; Taylor D,0,0,0,0
1653461048683,CSE 252A,A00,090127,Ochoa; Benjamin Lawrence,0,0,0,0
1653461049205,CSE 258,A01,090129,McAuley; Julian John,0,0,0,0
1653461049740,CSE 258R,A01,090131,McAuley; Julian John,0,0,0,0
1653461050262,CSE 274,A00,090132,Ramamoorthi; Ravi,0,0,0,0
1653461050795,CSE 276A,A00,090133,Christensen; Henrik I,0,0,0,0
1653461051321,CSE 276C,A00,090134,Christensen; Henrik I,0,0,0,0
1653461051847,CSE 290,A00,090135,Bafna; Vineet,0,0,0,0
1653461051847,CSE 290,B00,090136,Ramamoorthi; Ravi,0,0,0,0
1653461051847,CSE 290,C00,090137,Li; Tzumao,9,0,10,1
1653461051847,CSE 290,D00,090138,Zhou; Yuan-Yuan,10,0,10,0
1653461051847,CSE 290,E00,090139,Christensen; Henrik I,10,0,10,0
1653461051847,CSE 290,F00,094053,Shalev; Aaron D,0,0,0,0
1653461052375,CSE 291,A00,090140,Munyaka; Imani N. S.,0,0,0,0
1653461052375,CSE 291,B00,094880,Yu; Qi,0,0,0,0
1653461052375,CSE 291,C00,090142,Pannuto; Patrick William,0,0,0,0
1653461052375,CSE 291,D00,094881,Zhang; Yiying,0,0,0,0
1653461052375,CSE 291,E00,095118,Su; Hao,0,0,0,0
1653461052931,CSE 293,001,094905,Bafna; Vineet,9999,0,9999,0
1653461052931,CSE 293,002,094906,Bellare; Mihir,9999,0,9999,0
1653461052931,CSE 293,003,094907,Berg-Kirkpatrick; Taylor D,9999,0,9999,0
1653461052931,CSE 293,004,094908,Christensen; Henrik I,9999,0,9999,0
1653461052931,CSE 293,005,094909,Cottrell; Garrison W,9999,0,9999,0
1653461052931,CSE 293,006,094910,Deutsch; Alin Bernard,9999,0,9999,0
1653461052931,CSE 293,007,094911,Esmaeilzadeh; Hadi,9999,0,9999,0
1653461052931,CSE 293,008,094912,Freund; Yoav,9999,0,9999,0
1653461052931,CSE 293,009,094913,Griswold; William G.,9999,0,9999,0
1653461052931,CSE 293,010,094914,Gymrek; Melissa Ann,9999,0,9999,0
1653461052931,CSE 293,011,094915,Heninger; Nadia A,9999,0,9999,0
1653461052931,CSE 293,012,094916,Impagliazzo; Russell,9999,0,9999,0
1653461052931,CSE 293,013,094917,Jhala; Ranjit,9999,0,9999,0
1653461052931,CSE 293,014,094918,Kahng; Andrew Byun,9999,0,9999,0
1653461052931,CSE 293,015,094919,Kane; Daniel Mertz,9999,0,9999,0
1653461052931,CSE 293,016,094920,Kriegman; David J,9999,0,9999,0
1653461052931,CSE 293,017,094921,Kumar; Arun Kumar,9999,0,9999,0
1653461052931,CSE 293,018,094922,Lerner; Sorin,9999,0,9999,0
1653461052931,CSE 293,019,094923,Lovett; Shachar,9999,0,9999,0
1653461052931,CSE 293,020,094924,McAuley; Julian John,9999,0,9999,0
1653461052931,CSE 293,021,094925,Micciancio; Daniele,9999,0,9999,0
1653461052931,CSE 293,022,094926,Orailoglu; Alex,9999,0,9999,0
1653461052931,CSE 293,023,094927,Paturi; Ramamohan,9999,0,9999,0
1653461052931,CSE 293,024,094928,Polikarpova; Nadezhda,9999,0,9999,0
1653461052931,CSE 293,025,094929,Politz; Joseph Gibbs,9999,0,9999,0
1653461052931,CSE 293,026,094930,Porter; George M,9999,0,9999,0
1653461052931,CSE 293,027,094931,Porter; Leonard Emerson,9999,0,9999,0
1653461052931,CSE 293,028,094932,Ramamoorthi; Ravi,9999,0,9999,0
1653461052931,CSE 293,029,094933,Sahoo; Debashis,9999,0,9999,0
1653461052931,CSE 293,030,094934,Saul; Lawrence,9999,0,9999,0
1653461052931,CSE 293,031,094935,Savage; Stefan,9999,0,9999,0
1653461052931,CSE 293,032,094936,Schulze; Jurgen P.,9999,0,9999,0
1653461052931,CSE 293,033,094937,Snoeren; Alex C.,9999,0,9999,0
1653461052931,CSE 293,034,094938,Shang; Jingbo,9999,0,9999,0
1653461052931,CSE 293,035,094939,Stefan; Deian,9999,0,9999,0
1653461052931,CSE 293,036,094940,Su; Hao,9999,0,9999,0
1653461052931,CSE 293,037,094941,Swanson; Steven James,9999,0,9999,0
1653461052931,CSE 293,038,094942,Tullsen; Dean Michael,9999,0,9999,0
1653461052931,CSE 293,039,094943,Voelker; Geoffrey M.,9999,0,9999,0
1653461052931,CSE 293,040,094944,Zhao; Jishen,9999,0,9999,0
1653461052931,CSE 293,041,094945,Zhou; Yuan-Yuan,9999,0,9999,0
1653461052931,CSE 293,042,094946,Gao; Sicun,9998,0,9999,1
1653461052931,CSE 293,043,094947,Weibel; Nadir,9999,0,9999,0
1653461052931,CSE 293,044,094948,Gupta; Rajesh K.,9999,0,9999,0
1653461053454,CSE 294,A00,090143,Porter; George M,9,0,10,1
1653461053987,DSE 200,A00,091799,Staff,50,0,50,0
1653461054513,DSE 203,A00,091800,Gupta; Amarnath,30,0,30,0
1653461055046,DSE 250,A00,091801,Deutsch; Alin Bernard,30,0,30,0
1653461055568,DSE 290,A00,091802,Altintas De Callaf; Ilkay,50,0,50,0
1653461056112,ECE 200,001,091003,Antipa; Nicholas A,9999,0,9999,0
1653461056112,ECE 200,002,091004,Atanasov; Nikolay A.,9999,0,9999,0
1653461056112,ECE 200,003,091005,Bharadia; Dinesh,9999,0,9999,0
1653461056112,ECE 200,004,091006,Cheng; Chung Kuan,9999,0,9999,0
1653461056112,ECE 200,005,091007,Cosman; Pamela C.,9999,0,9999,0
1653461056112,ECE 200,006,091008,Staff,9999,0,9999,0
1653461056112,ECE 200,007,091009,Dayeh; Shadi Ahmad,9999,0,9999,0
1653461056112,ECE 200,008,091010,Fainman; Yeshaiahu,9999,0,9999,0
1653461056112,ECE 200,009,091011,Ford; Joseph Earl,9999,0,9999,0
1653461056112,ECE 200,010,091012,Franceschetti; Massimo,9999,0,9999,0
1653461056112,ECE 200,011,091013,Fullerton; Eric E,9999,0,9999,0
1653461056112,ECE 200,012,091014,Galton; Ian A,9999,0,9999,0
1653461056112,ECE 200,013,091015,Gilja; Vikash,9999,0,9999,0
1653461056112,ECE 200,014,091016,Hall; Drew A.,9999,0,9999,0
1653461056112,ECE 200,015,091017,Hsueh; Tzu-Chien,9999,0,9999,0
1653461056112,ECE 200,016,091018,Javidi; Tara,9999,0,9999,0
1653461056112,ECE 200,017,091019,Kahng; Andrew Byun,9999,0,9999,0
1653461056112,ECE 200,018,091020,Kim; Young-Han,9999,0,9999,0
1653461056112,ECE 200,019,091021,Koushanfar; Farinaz,9999,0,9999,0
1653461056112,ECE 200,020,091022,Kuzum; Duygu,9999,0,9999,0
1653461056112,ECE 200,021,091023,Le; Hanh-Phuc,9999,0,9999,0
1653461056112,ECE 200,022,091024,Lin; Bill,9999,0,9999,0
1653461056112,ECE 200,023,091025,Liu; Zhaowei,9999,0,9999,0
1653461056112,ECE 200,024,091026,Lo; Yu-Hwa,9999,0,9999,0
1653461056112,ECE 200,025,091027,Lomakin; Vitaliy,9999,0,9999,0
1653461056112,ECE 200,026,091028,Mercier; Patrick Philip,9999,0,9999,0
1653461056112,ECE 200,027,091029,Meyer; Florian,9999,0,9999,0
1653461056112,ECE 200,028,091030,Milstein; Laurence B.,9999,0,9999,0
1653461056112,ECE 200,029,091031,Mir Arabbaygi; Siavash,9999,0,9999,0
1653461056112,ECE 200,030,091032,Mookherjea; Shayan,9999,0,9999,0
1653461056112,ECE 200,031,091033,Morris; Karcher William,9999,0,9999,0
1653461056112,ECE 200,032,091034,Ng; Tse Nga,9999,0,9999,0
1653461056112,ECE 200,033,091035,Nguyen; Truong Quang,9999,0,9999,0
1653461056112,ECE 200,034,091036,Nomura; Kenji,9999,0,9999,0
1653461056112,ECE 200,035,091037,Orlitsky; Alon,9999,0,9999,0
1653461056112,ECE 200,036,091038,Pal; Piya,9999,0,9999,0
1653461056112,ECE 200,037,091039,Papen; George C.,9999,0,9999,0
1653461056112,ECE 200,038,091040,Radic; Stojan,9999,0,9999,0
1653461056112,ECE 200,039,091041,Rao; Bhaskar D.,9999,0,9999,0
1653461056112,ECE 200,040,091042,Rao; Ramesh R,9999,0,9999,0
1653461056112,ECE 200,041,091043,Rebeiz; Gabriel,9999,0,9999,0
1653461056112,ECE 200,042,091044,Sanford; John R,9999,0,9999,0
1653461056112,ECE 200,043,091045,Siegel; Paul H.,9999,0,9999,0
1653461056112,ECE 200,044,091046,Sievenpiper; Daniel F.,9999,0,9999,0
1653461056112,ECE 200,045,091047,Sworder; David D.,9999,0,9999,0
1653461056112,ECE 200,046,091048,Taur; Yuan,9999,0,9999,0
1653461056112,ECE 200,047,091049,Touri; Behrouz,9999,0,9999,0
1653461056112,ECE 200,048,091050,Trivedi; Mohan M.,9999,0,9999,0
1653461056112,ECE 200,049,091051,Vardy; Alexander,9999,0,9999,0
1653461056112,ECE 200,050,091052,Vasconcelos; Nuno,9999,0,9999,0
1653461056112,ECE 200,051,091053,Wang; Xiaolong,9999,0,9999,0
1653461056112,ECE 200,052,091054,Xie; Pengtao,9999,0,9999,0
1653461056112,ECE 200,053,091055,Yip; Michael,9999,0,9999,0
1653461056112,ECE 200,054,091056,Zeger; Kenneth A.,9999,0,9999,0
1653461056112,ECE 200,055,091057,Zhang; Xinyu,9999,0,9999,0
1653461056112,ECE 200,056,091058,Turakhia; Yatish Girish,9999,0,9999,0
1653461056112,ECE 200,057,091059,Kang; Mingu,9999,0,9999,0
1653461056112,ECE 200,058,091060,Shi; Yuanyuan,9999,0,9999,0
1653461056112,ECE 200,059,091061,Wang; Edward Jay,9999,0,9999,0
1653461056112,ECE 200,060,091062,Zheng; Yang,9999,0,9999,0
1653461056654,ECE 203,A00,091065,Mercier; Patrick Philip,0,0,0,0
1653461057177,ECE 207A,A00,091605,Liu; Thomas Tao-Ming,0,0,0,0
1653461057698,ECE 212AN,A00,091068,Nomura; Kenji,0,0,0,0
1653461058221,ECE 222A,A00,091069,Rebeiz; Gabriel,0,0,0,0
1653461058743,ECE 225A,A00,091070,Orlitsky; Alon,0,0,0,0
1653461059268,ECE 230A,A00,091071,Nomura; Kenji,0,0,0,0
1653461059793,ECE 236A,A00,091072,Dayeh; Shadi Ahmad,0,0,0,0
1653461060319,ECE 238A,A00,091073,Luo; Jian,0,0,0,0
1653461060319,ECE 238A,B00,091074,Luo; Jian,0,0,0,0
1653461060845,ECE 240A,A00,091075,Radic; Stojan,0,0,0,0
1653461061374,ECE 247A,A00,091592,Shi; Lingyan,0,0,0,0
1653461061897,ECE 250,A00,091076,Touri; Behrouz,0,0,0,0
1653461062420,ECE 251C,A00,091078,Nguyen; Truong Quang,0,0,0,0
1653461062946,ECE 253,A00,091079,Cosman; Pamela C.,0,0,0,0
1653461063475,ECE 255A,A00,091080,Orlitsky; Alon,0,0,0,0
1653461063997,ECE 257A,A00,091081,Zhang; Xinyu,0,0,0,0
1653461064522,ECE 260A,A01,091084,Eldon; John,0,0,0,0
1653461065047,ECE 264C,A00,091085,Galton; Ian A,0,0,0,0
1653461065570,ECE 265C,A00,094889,Presti; Calogero Davide,0,0,0,9
1653461066114,ECE 266,A01,091087,Hall; Drew A.,0,0,0,0
1653461067166,ECE 271A,A00,091090,Vasconcelos; Nuno,0,0,0,0
1653461067692,ECE 272B,A00,091091,Sworder; David D.,0,0,0,0
1653461068215,ECE 275A,A00,091092,Meyer; Florian,0,0,0,0
1653461068738,ECE 277,A00,091093,An; Cheolhong,0,0,0,0
1653461069263,ECE 283,A00,091094,Le; Hanh-Phuc,0,0,0,0
1653461069787,ECE 284,A00,091095,Kang; Mingu,0,0,0,0
1653461069787,ECE 284,B00,091096,Wang; Edward Jay,0,0,0,0
1653461070310,ECE 285,A00,094334,Touri; Behrouz,0,0,0,0
1653461070847,ECE 289,A00,091097,Whelan; David Arthur,0,0,0,0
1653461071369,MATH 200A,A00,087414,Salehi Golsefidy; Alireza,7,0,8,1
1653461071979,MATH 202A,A00,087415,Gill; Philip E.,3,0,8,5
1653461072504,MATH 203A,A00,087416,Oprea; Dragos N.,6,0,8,2
1653461073036,MATH 204A,A00,087417,Kedlaya; Kiran S.,6,0,8,2
1653461073559,MATH 205,A00,087418,Sorensen; Claus M,6,0,8,2
1653461074084,MATH 206A,A00,087419,Izadi; Elham,7,0,8,1
1653461074608,MATH 207A,A00,087420,Mohammadi; Amir,6,0,8,2
1653461075136,MATH 208,A00,087421,Staff,9,0,10,1
1653461075675,MATH 209,A00,087422,Staff,10,0,10,0
1653461076197,MATH 218,A00,087423,Staff,10,0,10,0
1653461076726,MATH 220A,A00,087424,Novak; Jonathan I,7,0,8,1
1653461077249,MATH 231A,A00,087425,Bejenaru; Ioan,3,0,8,5
1653461077772,MATH 240A,A00,087426,Ebenfelt; Peter F,5,0,8,3
1653461078302,MATH 243,A00,087427,Staff,9,0,10,1
1653461078824,MATH 248,A00,087429,Staff,10,0,10,0
1653461079351,MATH 250A,A00,087430,Spolaor; Luca,4,0,8,4
1653461079878,MATH 257A,A00,087431,Spolaor; Luca,7,0,8,1
1653461080402,MATH 258,A00,087432,Staff,9,0,10,1
1653461080925,MATH 264A,A00,087433,Warnke; Lutz Peter,5,0,8,3
1653461081448,MATH 268,A00,087434,Staff,15,0,15,0
1653461081979,MATH 269,A00,087435,Staff,14,0,15,1
1653461082501,MATH 270A,A00,087436,Nie; Jiawang,0,0,8,8
1653461083037,MATH 272A,A00,087437,Tian; Xiaochuan,1,0,8,7
1653461083564,MATH 274,A01,087439,Cheng; Li-Tien,9,0,10,1
1653461083564,MATH 274,A02,087440,Cheng; Li-Tien,10,0,10,0
1653461084089,MATH 278A,A00,087441,Staff,8,0,10,2
1653461084612,MATH 278B,A00,087442,Staff,8,0,10,2
1653461085207,MATH 278C,A00,087443,Staff,8,0,10,2
1653461085730,MATH 280A,A00,087444,Zheng; Tianyi,0,0,8,8
1653461086257,MATH 281A,A00,087445,Bradic; Jelena,0,0,8,8
1653461086784,MATH 282A,A00,087446,Zhang; Danna,0,0,8,8
1653461087310,MATH 283,A00,087447,Tesler; Glenn,0,0,0,14
1653461087833,MATH 286,A00,087448,Kemp; Todd Aahron,5,0,8,3
1653461088363,MATH 287D,A00,087449,Bradic; Jelena,8,0,8,0
1653461088885,MATH 288,A00,087450,Staff,14,0,15,1
1653461088885,MATH 288,B00,087451,Staff,15,0,15,0
1653461088885,MATH 288,C00,087452,Staff,15,0,15,0
1653461089409,MATH 290A,A00,087453,Xu; Zhouli,7,0,8,1
1653461089939,MATH 291A,A00,087454,Xu; Zhouli,7,0,8,1
1653461090463,MATH 292,A00,087455,Staff,10,0,10,0
1653461090985,MATH 295,A00,087456,Staff,50,0,50,0
1653461091511,MATH 297,001,087457,Staff,998,0,999,1
1653461650728,COGS 200,A01,087991,Staff,47,0,50,3
1653461651251,COGS 201,A01,094504,Rangel; Lara M,17,0,25,8
1653461651774,COGS 203,A00,087992,Coulson; Seana M,18,0,20,2
1653461652311,COGS 210A,001,087993,Greene; Deanna Jacquelyn,9998,0,9999,1
1653461652311,COGS 210A,002,087994,Saygin; Ayse P,9999,0,9999,0
1653461652311,COGS 210A,003,087995,Xia; Haijun,9999,0,9999,0
1653461652311,COGS 210A,004,087996,Nitz; Douglas A.,9999,0,9999,0
1653461652311,COGS 210A,005,087997,Hollan; James D.,9999,0,9999,0
1653461652311,COGS 210A,006,087998,Deak; Gedeon O.,9998,0,9999,1
1653461652311,COGS 210A,007,087999,Rossano; Federico,9999,0,9999,0
1653461652838,COGS 211A,A00,088000,Coulson; Seana M,9997,0,9999,2
1653461653363,COGS 229,A00,088002,Staff,23,0,25,2
1653461653892,COGS 260,B00,094231,Staff,17,0,20,3
1653461653892,COGS 260,A00,088004,Nitz; Douglas A.,9998,0,9999,1
1653461654421,CSE 202,A00,090110,Paturi; Ramamohan,0,0,0,0
1653461654421,CSE 202,B00,090111,Paturi; Ramamohan,0,0,0,0
1653461654944,CSE 207B,A00,090112,Heninger; Nadia A,0,0,0,0
1653461655470,CSE 208,A00,094858,Micciancio; Daniele,0,0,0,0
1653461655994,CSE 210,A00,090113,Powell; Thomas Allan,0,0,0,0
1653461656515,CSE 219,A00,090898,Staff,0,0,0,0
1653461657038,CSE 221,A00,090114,Zhou; Yuan-Yuan,0,0,0,0
1653461657563,CSE 229A,A00,090115,Porter; George M,0,0,0,0
1653461658094,CSE 229C,A00,090116,Savage; Stefan,0,0,0,0
1653461658745,CSE 230,A00,090117,Jhala; Ranjit,0,0,0,0
1653461659267,CSE 232,A00,090118,Papakonstantinou; Yannis,0,0,0,0
1653461659792,CSE 239A,A00,090121,Kumar; Arun Kumar,0,0,0,0
1653461660315,CSE 239B,A00,090122,Jhala; Ranjit,0,0,0,0
1653461660838,CSE 240A,A00,090123,Zhao; Jishen,0,0,189,189
1653461661361,CSE 243A,A00,090124,Orailoglu; Alex,1,0,15,14
1653461661913,CSE 249B,A00,090125,Kahng; Andrew Byun,13,0,20,7
1653461662439,CSE 250A,A00,090126,Berg-Kirkpatrick; Taylor D,0,0,0,0
1653461662962,CSE 252A,A00,090127,Ochoa; Benjamin Lawrence,0,0,0,0
1653461663484,CSE 258,A01,090129,McAuley; Julian John,0,0,0,0
1653461664012,CSE 258R,A01,090131,McAuley; Julian John,0,0,0,0
1653461664536,CSE 274,A00,090132,Ramamoorthi; Ravi,0,0,0,0
1653461665059,CSE 276A,A00,090133,Christensen; Henrik I,0,0,0,0
1653461665592,CSE 276C,A00,090134,Christensen; Henrik I,0,0,0,0
1653461666127,CSE 290,A00,090135,Bafna; Vineet,0,0,0,0
1653461666127,CSE 290,B00,090136,Ramamoorthi; Ravi,0,0,0,0
1653461666127,CSE 290,C00,090137,Li; Tzumao,9,0,10,1
1653461666127,CSE 290,D00,090138,Zhou; Yuan-Yuan,10,0,10,0
1653461666127,CSE 290,E00,090139,Christensen; Henrik I,10,0,10,0
1653461666127,CSE 290,F00,094053,Shalev; Aaron D,0,0,0,0
1653461666651,CSE 291,A00,090140,Munyaka; Imani N. S.,0,0,0,0
1653461666651,CSE 291,B00,094880,Yu; Qi,0,0,0,0
1653461666651,CSE 291,C00,090142,Pannuto; Patrick William,0,0,0,0
1653461666651,CSE 291,D00,094881,Zhang; Yiying,0,0,0,0
1653461666651,CSE 291,E00,095118,Su; Hao,0,0,0,0
1653461667190,CSE 293,001,094905,Bafna; Vineet,9999,0,9999,0
1653461667190,CSE 293,002,094906,Bellare; Mihir,9999,0,9999,0
1653461667190,CSE 293,003,094907,Berg-Kirkpatrick; Taylor D,9999,0,9999,0
1653461667190,CSE 293,004,094908,Christensen; Henrik I,9999,0,9999,0
1653461667190,CSE 293,005,094909,Cottrell; Garrison W,9999,0,9999,0
1653461667190,CSE 293,006,094910,Deutsch; Alin Bernard,9999,0,9999,0
1653461667190,CSE 293,007,094911,Esmaeilzadeh; Hadi,9999,0,9999,0
1653461667190,CSE 293,008,094912,Freund; Yoav,9999,0,9999,0
1653461667190,CSE 293,009,094913,Griswold; William G.,9999,0,9999,0
1653461667190,CSE 293,010,094914,Gymrek; Melissa Ann,9999,0,9999,0
1653461667190,CSE 293,011,094915,Heninger; Nadia A,9999,0,9999,0
1653461667190,CSE 293,012,094916,Impagliazzo; Russell,9999,0,9999,0
1653461667190,CSE 293,013,094917,Jhala; Ranjit,9999,0,9999,0
1653461667190,CSE 293,014,094918,Kahng; Andrew Byun,9999,0,9999,0
1653461667190,CSE 293,015,094919,Kane; Daniel Mertz,9999,0,9999,0
1653461667190,CSE 293,016,094920,Kriegman; David J,9999,0,9999,0
1653461667190,CSE 293,017,094921,Kumar; Arun Kumar,9999,0,9999,0
1653461667190,CSE 293,018,094922,Lerner; Sorin,9999,0,9999,0
1653461667190,CSE 293,019,094923,Lovett; Shachar,9999,0,9999,0
1653461667190,CSE 293,020,094924,McAuley; Julian John,9999,0,9999,0
1653461667190,CSE 293,021,094925,Micciancio; Daniele,9999,0,9999,0
1653461667190,CSE 293,022,094926,Orailoglu; Alex,9999,0,9999,0
1653461667190,CSE 293,023,094927,Paturi; Ramamohan,9999,0,9999,0
1653461667190,CSE 293,024,094928,Polikarpova; Nadezhda,9999,0,9999,0
1653461667190,CSE 293,025,094929,Politz; Joseph Gibbs,9999,0,9999,0
1653461667190,CSE 293,026,094930,Porter; George M,9999,0,9999,0
1653461667190,CSE 293,027,094931,Porter; Leonard Emerson,9999,0,9999,0
1653461667190,CSE 293,028,094932,Ramamoorthi; Ravi,9999,0,9999,0
1653461667190,CSE 293,029,094933,Sahoo; Debashis,9999,0,9999,0
1653461667190,CSE 293,030,094934,Saul; Lawrence,9999,0,9999,0
1653461667190,CSE 293,031,094935,Savage; Stefan,9999,0,9999,0
1653461667190,CSE 293,032,094936,Schulze; Jurgen P.,9999,0,9999,0
1653461667190,CSE 293,033,094937,Snoeren; Alex C.,9999,0,9999,0
1653461667190,CSE 293,034,094938,Shang; Jingbo,9999,0,9999,0
1653461667190,CSE 293,035,094939,Stefan; Deian,9999,0,9999,0
1653461667190,CSE 293,036,094940,Su; Hao,9999,0,9999,0
1653461667190,CSE 293,037,094941,Swanson; Steven James,9999,0,9999,0
1653461667190,CSE 293,038,094942,Tullsen; Dean Michael,9999,0,9999,0
1653461667190,CSE 293,039,094943,Voelker; Geoffrey M.,9999,0,9999,0
1653461667190,CSE 293,040,094944,Zhao; Jishen,9999,0,9999,0
1653461667190,CSE 293,041,094945,Zhou; Yuan-Yuan,9999,0,9999,0
1653461667190,CSE 293,042,094946,Gao; Sicun,9998,0,9999,1
1653461667190,CSE 293,043,094947,Weibel; Nadir,9999,0,9999,0
1653461667190,CSE 293,044,094948,Gupta; Rajesh K.,9999,0,9999,0
1653461667713,CSE 294,A00,090143,Porter; George M,9,0,10,1
1653461668247,DSE 200,A00,091799,Staff,50,0,50,0
1653461668779,DSE 203,A00,091800,Gupta; Amarnath,30,0,30,0
1653461669303,DSE 250,A00,091801,Deutsch; Alin Bernard,30,0,30,0
1653461669826,DSE 290,A00,091802,Altintas De Callaf; Ilkay,50,0,50,0
1653461670364,ECE 200,001,091003,Antipa; Nicholas A,9999,0,9999,0
1653461670364,ECE 200,002,091004,Atanasov; Nikolay A.,9999,0,9999,0
1653461670364,ECE 200,003,091005,Bharadia; Dinesh,9999,0,9999,0
1653461670364,ECE 200,004,091006,Cheng; Chung Kuan,9999,0,9999,0
1653461670364,ECE 200,005,091007,Cosman; Pamela C.,9999,0,9999,0
1653461670364,ECE 200,006,091008,Staff,9999,0,9999,0
1653461670364,ECE 200,007,091009,Dayeh; Shadi Ahmad,9999,0,9999,0
1653461670364,ECE 200,008,091010,Fainman; Yeshaiahu,9999,0,9999,0
1653461670364,ECE 200,009,091011,Ford; Joseph Earl,9999,0,9999,0
1653461670364,ECE 200,010,091012,Franceschetti; Massimo,9999,0,9999,0
1653461670364,ECE 200,011,091013,Fullerton; Eric E,9999,0,9999,0
1653461670364,ECE 200,012,091014,Galton; Ian A,9999,0,9999,0
1653461670364,ECE 200,013,091015,Gilja; Vikash,9999,0,9999,0
1653461670364,ECE 200,014,091016,Hall; Drew A.,9999,0,9999,0
1653461670364,ECE 200,015,091017,Hsueh; Tzu-Chien,9999,0,9999,0
1653461670364,ECE 200,016,091018,Javidi; Tara,9999,0,9999,0
1653461670364,ECE 200,017,091019,Kahng; Andrew Byun,9999,0,9999,0
1653461670364,ECE 200,018,091020,Kim; Young-Han,9999,0,9999,0
1653461670364,ECE 200,019,091021,Koushanfar; Farinaz,9999,0,9999,0
1653461670364,ECE 200,020,091022,Kuzum; Duygu,9999,0,9999,0
1653461670364,ECE 200,021,091023,Le; Hanh-Phuc,9999,0,9999,0
1653461670364,ECE 200,022,091024,Lin; Bill,9999,0,9999,0
1653461670364,ECE 200,023,091025,Liu; Zhaowei,9999,0,9999,0
1653461670364,ECE 200,024,091026,Lo; Yu-Hwa,9999,0,9999,0
1653461670364,ECE 200,025,091027,Lomakin; Vitaliy,9999,0,9999,0
1653461670364,ECE 200,026,091028,Mercier; Patrick Philip,9999,0,9999,0
1653461670364,ECE 200,027,091029,Meyer; Florian,9999,0,9999,0
1653461670364,ECE 200,028,091030,Milstein; Laurence B.,9999,0,9999,0
1653461670364,ECE 200,029,091031,Mir Arabbaygi; Siavash,9999,0,9999,0
1653461670364,ECE 200,030,091032,Mookherjea; Shayan,9999,0,9999,0
1653461670364,ECE 200,031,091033,Morris; Karcher William,9999,0,9999,0
1653461670364,ECE 200,032,091034,Ng; Tse Nga,9999,0,9999,0
1653461670364,ECE 200,033,091035,Nguyen; Truong Quang,9999,0,9999,0
1653461670364,ECE 200,034,091036,Nomura; Kenji,9999,0,9999,0
1653461670364,ECE 200,035,091037,Orlitsky; Alon,9999,0,9999,0
1653461670364,ECE 200,036,091038,Pal; Piya,9999,0,9999,0
1653461670364,ECE 200,037,091039,Papen; George C.,9999,0,9999,0
1653461670364,ECE 200,038,091040,Radic; Stojan,9999,0,9999,0
1653461670364,ECE 200,039,091041,Rao; Bhaskar D.,9999,0,9999,0
1653461670364,ECE 200,040,091042,Rao; Ramesh R,9999,0,9999,0
1653461670364,ECE 200,041,091043,Rebeiz; Gabriel,9999,0,9999,0
1653461670364,ECE 200,042,091044,Sanford; John R,9999,0,9999,0
1653461670364,ECE 200,043,091045,Siegel; Paul H.,9999,0,9999,0
1653461670364,ECE 200,044,091046,Sievenpiper; Daniel F.,9999,0,9999,0
1653461670364,ECE 200,045,091047,Sworder; David D.,9999,0,9999,0
1653461670364,ECE 200,046,091048,Taur; Yuan,9999,0,9999,0
1653461670364,ECE 200,047,091049,Touri; Behrouz,9999,0,9999,0
1653461670364,ECE 200,048,091050,Trivedi; Mohan M.,9999,0,9999,0
1653461670364,ECE 200,049,091051,Vardy; Alexander,9999,0,9999,0
1653461670364,ECE 200,050,091052,Vasconcelos; Nuno,9999,0,9999,0
1653461670364,ECE 200,051,091053,Wang; Xiaolong,9999,0,9999,0
1653461670364,ECE 200,052,091054,Xie; Pengtao,9999,0,9999,0
1653461670364,ECE 200,053,091055,Yip; Michael,9999,0,9999,0
1653461670364,ECE 200,054,091056,Zeger; Kenneth A.,9999,0,9999,0
1653461670364,ECE 200,055,091057,Zhang; Xinyu,9999,0,9999,0
1653461670364,ECE 200,056,091058,Turakhia; Yatish Girish,9999,0,9999,0
1653461670364,ECE 200,057,091059,Kang; Mingu,9999,0,9999,0
1653461670364,ECE 200,058,091060,Shi; Yuanyuan,9999,0,9999,0
1653461670364,ECE 200,059,091061,Wang; Edward Jay,9999,0,9999,0
1653461670364,ECE 200,060,091062,Zheng; Yang,9999,0,9999,0
1653461670893,ECE 203,A00,091065,Mercier; Patrick Philip,0,0,0,0
1653461671421,ECE 207A,A00,091605,Liu; Thomas Tao-Ming,0,0,0,0
1653461671947,ECE 212AN,A00,091068,Nomura; Kenji,0,0,0,0
1653461672490,ECE 222A,A00,091069,Rebeiz; Gabriel,0,0,0,0
1653461673012,ECE 225A,A00,091070,Orlitsky; Alon,0,0,0,0
1653461673539,ECE 230A,A00,091071,Nomura; Kenji,0,0,0,0
1653461674064,ECE 236A,A00,091072,Dayeh; Shadi Ahmad,0,0,0,0
1653461674591,ECE 238A,A00,091073,Luo; Jian,0,0,0,0
1653461674591,ECE 238A,B00,091074,Luo; Jian,0,0,0,0
1653461675117,ECE 240A,A00,091075,Radic; Stojan,0,0,0,0
1653461675638,ECE 247A,A00,091592,Shi; Lingyan,0,0,0,0
1653461676170,ECE 250,A00,091076,Touri; Behrouz,0,0,0,0
1653461676701,ECE 251C,A00,091078,Nguyen; Truong Quang,0,0,0,0
1653461677224,ECE 253,A00,091079,Cosman; Pamela C.,0,0,0,0
1653461677751,ECE 255A,A00,091080,Orlitsky; Alon,0,0,0,0
1653461678279,ECE 257A,A00,091081,Zhang; Xinyu,0,0,0,0
1653461678810,ECE 260A,A01,091084,Eldon; John,0,0,0,0
1653461679332,ECE 264C,A00,091085,Galton; Ian A,0,0,0,0
1653461679856,ECE 265C,A00,094889,Presti; Calogero Davide,0,0,0,9
1653461680379,ECE 266,A01,091087,Hall; Drew A.,0,0,0,0
1653461681422,ECE 271A,A00,091090,Vasconcelos; Nuno,0,0,0,0
1653461681944,ECE 272B,A00,091091,Sworder; David D.,0,0,0,0
1653461682467,ECE 275A,A00,091092,Meyer; Florian,0,0,0,0
1653461682999,ECE 277,A00,091093,An; Cheolhong,0,0,0,0
1653461683529,ECE 283,A00,091094,Le; Hanh-Phuc,0,0,0,0
1653461684055,ECE 284,A00,091095,Kang; Mingu,0,0,0,0
1653461684055,ECE 284,B00,091096,Wang; Edward Jay,0,0,0,0
1653461684579,ECE 285,A00,094334,Touri; Behrouz,0,0,0,0
1653461685105,ECE 289,A00,091097,Whelan; David Arthur,0,0,0,0
1653461685628,MATH 200A,A00,087414,Salehi Golsefidy; Alireza,7,0,8,1
1653461686151,MATH 202A,A00,087415,Gill; Philip E.,3,0,8,5
1653461686672,MATH 203A,A00,087416,Oprea; Dragos N.,6,0,8,2
1653461687222,MATH 204A,A00,087417,Kedlaya; Kiran S.,6,0,8,2
1653461687744,MATH 205,A00,087418,Sorensen; Claus M,6,0,8,2
1653461688280,MATH 206A,A00,087419,Izadi; Elham,7,0,8,1
1653461688803,MATH 207A,A00,087420,Mohammadi; Amir,6,0,8,2
1653461689325,MATH 208,A00,087421,Staff,9,0,10,1
1653461689856,MATH 209,A00,087422,Staff,10,0,10,0
1653461690381,MATH 218,A00,087423,Staff,10,0,10,0
1653461690907,MATH 220A,A00,087424,Novak; Jonathan I,7,0,8,1
1653461691433,MATH 231A,A00,087425,Bejenaru; Ioan,3,0,8,5
1653461691958,MATH 240A,A00,087426,Ebenfelt; Peter F,5,0,8,3
1653461692482,MATH 243,A00,087427,Staff,9,0,10,1
1653461693012,MATH 248,A00,087429,Staff,10,0,10,0
1653461693535,MATH 250A,A00,087430,Spolaor; Luca,4,0,8,4
1653461694056,MATH 257A,A00,087431,Spolaor; Luca,7,0,8,1
1653461694579,MATH 258,A00,087432,Staff,9,0,10,1
1653461695129,MATH 264A,A00,087433,Warnke; Lutz Peter,5,0,8,3
1653461695655,MATH 268,A00,087434,Staff,15,0,15,0
1653461696180,MATH 269,A00,087435,Staff,14,0,15,1
1653461696704,MATH 270A,A00,087436,Nie; Jiawang,0,0,8,8
1653461697227,MATH 272A,A00,087437,Tian; Xiaochuan,1,0,8,7
1653461697769,MATH 274,A01,087439,Cheng; Li-Tien,9,0,10,1
1653461697769,MATH 274,A02,087440,Cheng; Li-Tien,10,0,10,0
1653461698307,MATH 278A,A00,087441,Staff,8,0,10,2
1653461698835,MATH 278B,A00,087442,Staff,8,0,10,2
1653461699357,MATH 278C,A00,087443,Staff,8,0,10,2
1653461699879,MATH 280A,A00,087444,Zheng; Tianyi,0,0,8,8
1653461700417,MATH 281A,A00,087445,Bradic; Jelena,0,0,8,8
1653461700961,MATH 282A,A00,087446,Zhang; Danna,0,0,8,8
1653461701488,MATH 283,A00,087447,Tesler; Glenn,0,0,0,14
1653461702012,MATH 286,A00,087448,Kemp; Todd Aahron,5,0,8,3
1653461702537,MATH 287D,A00,087449,Bradic; Jelena,8,0,8,0
1653461703063,MATH 288,A00,087450,Staff,14,0,15,1
1653461703063,MATH 288,B00,087451,Staff,15,0,15,0
1653461703063,MATH 288,C00,087452,Staff,15,0,15,0
1653461703592,MATH 290A,A00,087453,Xu; Zhouli,7,0,8,1
1653461704121,MATH 291A,A00,087454,Xu; Zhouli,7,0,8,1
1653461704643,MATH 292,A00,087455,Staff,10,0,10,0
1653461705167,MATH 295,A00,087456,Staff,50,0,50,0
1653461705690,MATH 297,001,087457,Staff,998,0,999,1
1653462266732,COGS 200,A01,087991,Staff,47,0,50,3
1653462267259,COGS 201,A01,094504,Rangel; Lara M,17,0,25,8
1653462267781,COGS 203,A00,087992,Coulson; Seana M,18,0,20,2
1653462268304,COGS 210A,001,087993,Greene; Deanna Jacquelyn,9998,0,9999,1
1653462268304,COGS 210A,002,087994,Saygin; Ayse P,9999,0,9999,0
1653462268304,COGS 210A,003,087995,Xia; Haijun,9999,0,9999,0
1653462268304,COGS 210A,004,087996,Nitz; Douglas A.,9999,0,9999,0
1653462268304,COGS 210A,005,087997,Hollan; James D.,9999,0,9999,0
1653462268304,COGS 210A,006,087998,Deak; Gedeon O.,9998,0,9999,1
1653462268304,COGS 210A,007,087999,Rossano; Federico,9999,0,9999,0
1653462268826,COGS 211A,A00,088000,Coulson; Seana M,9997,0,9999,2
1653462269357,COGS 229,A00,088002,Staff,23,0,25,2
1653462269883,COGS 260,B00,094231,Staff,17,0,20,3
1653462269883,COGS 260,A00,088004,Nitz; Douglas A.,9998,0,9999,1
1653462270406,CSE 202,A00,090110,Paturi; Ramamohan,0,0,0,0
1653462270406,CSE 202,B00,090111,Paturi; Ramamohan,0,0,0,0
1653462270931,CSE 207B,A00,090112,Heninger; Nadia A,0,0,0,0
1653462271454,CSE 208,A00,094858,Micciancio; Daniele,0,0,0,0
1653462271977,CSE 210,A00,090113,Powell; Thomas Allan,0,0,0,0
1653462272499,CSE 219,A00,090898,Staff,0,0,0,0
1653462273023,CSE 221,A00,090114,Zhou; Yuan-Yuan,0,0,0,0
1653462273550,CSE 229A,A00,090115,Porter; George M,0,0,0,0
1653462274080,CSE 229C,A00,090116,Savage; Stefan,0,0,0,0
1653462274603,CSE 230,A00,090117,Jhala; Ranjit,0,0,0,0
1653462275127,CSE 232,A00,090118,Papakonstantinou; Yannis,0,0,0,0
1653462275648,CSE 239A,A00,090121,Kumar; Arun Kumar,0,0,0,0
1653462276172,CSE 239B,A00,090122,Jhala; Ranjit,0,0,0,0
1653462276700,CSE 240A,A00,090123,Zhao; Jishen,0,0,189,189
1653462277228,CSE 243A,A00,090124,Orailoglu; Alex,1,0,15,14
1653462277755,CSE 249B,A00,090125,Kahng; Andrew Byun,13,0,20,7
1653462278287,CSE 250A,A00,090126,Berg-Kirkpatrick; Taylor D,0,0,0,0
1653462278816,CSE 252A,A00,090127,Ochoa; Benjamin Lawrence,0,0,0,0
1653462279344,CSE 258,A01,090129,McAuley; Julian John,0,0,0,0
1653462279871,CSE 258R,A01,090131,McAuley; Julian John,0,0,0,0
1653462280394,CSE 274,A00,090132,Ramamoorthi; Ravi,0,0,0,0
1653462280917,CSE 276A,A00,090133,Christensen; Henrik I,0,0,0,0
1653462281454,CSE 276C,A00,090134,Christensen; Henrik I,0,0,0,0
1653462281981,CSE 290,A00,090135,Bafna; Vineet,0,0,0,0
1653462281981,CSE 290,B00,090136,Ramamoorthi; Ravi,0,0,0,0
1653462281981,CSE 290,C00,090137,Li; Tzumao,9,0,10,1
1653462281981,CSE 290,D00,090138,Zhou; Yuan-Yuan,10,0,10,0
1653462281981,CSE 290,E00,090139,Christensen; Henrik I,10,0,10,0
1653462281981,CSE 290,F00,094053,Shalev; Aaron D,0,0,0,0
1653462282505,CSE 291,A00,090140,Munyaka; Imani N. S.,0,0,0,0
1653462282505,CSE 291,B00,094880,Yu; Qi,0,0,0,0
1653462282505,CSE 291,C00,090142,Pannuto; Patrick William,0,0,0,0
1653462282505,CSE 291,D00,094881,Zhang; Yiying,0,0,0,0
1653462282505,CSE 291,E00,095118,Su; Hao,0,0,0,0
1653462283031,CSE 293,001,094905,Bafna; Vineet,9999,0,9999,0
1653462283031,CSE 293,002,094906,Bellare; Mihir,9999,0,9999,0
1653462283031,CSE 293,003,094907,Berg-Kirkpatrick; Taylor D,9999,0,9999,0
1653462283031,CSE 293,004,094908,Christensen; Henrik I,9999,0,9999,0
1653462283031,CSE 293,005,094909,Cottrell; Garrison W,9999,0,9999,0
1653462283031,CSE 293,006,094910,Deutsch; Alin Bernard,9999,0,9999,0
1653462283031,CSE 293,007,094911,Esmaeilzadeh; Hadi,9999,0,9999,0
1653462283031,CSE 293,008,094912,Freund; Yoav,9999,0,9999,0
1653462283031,CSE 293,009,094913,Griswold; William G.,9999,0,9999,0
1653462283031,CSE 293,010,094914,Gymrek; Melissa Ann,9999,0,9999,0
1653462283031,CSE 293,011,094915,Heninger; Nadia A,9999,0,9999,0
1653462283031,CSE 293,012,094916,Impagliazzo; Russell,9999,0,9999,0
1653462283031,CSE 293,013,094917,Jhala; Ranjit,9999,0,9999,0
1653462283031,CSE 293,014,094918,Kahng; Andrew Byun,9999,0,9999,0
1653462283031,CSE 293,015,094919,Kane; Daniel Mertz,9999,0,9999,0
1653462283031,CSE 293,016,094920,Kriegman; David J,9999,0,9999,0
1653462283031,CSE 293,017,094921,Kumar; Arun Kumar,9999,0,9999,0
1653462283031,CSE 293,018,094922,Lerner; Sorin,9999,0,9999,0
1653462283031,CSE 293,019,094923,Lovett; Shachar,9999,0,9999,0
1653462283031,CSE 293,020,094924,McAuley; Julian John,9999,0,9999,0
1653462283031,CSE 293,021,094925,Micciancio; Daniele,9999,0,9999,0
1653462283031,CSE 293,022,094926,Orailoglu; Alex,9999,0,9999,0
1653462283031,CSE 293,023,094927,Paturi; Ramamohan,9999,0,9999,0
1653462283031,CSE 293,024,094928,Polikarpova; Nadezhda,9999,0,9999,0
1653462283031,CSE 293,025,094929,Politz; Joseph Gibbs,9999,0,9999,0
1653462283031,CSE 293,026,094930,Porter; George M,9999,0,9999,0
1653462283031,CSE 293,027,094931,Porter; Leonard Emerson,9999,0,9999,0
1653462283031,CSE 293,028,094932,Ramamoorthi; Ravi,9999,0,9999,0
1653462283031,CSE 293,029,094933,Sahoo; Debashis,9999,0,9999,0
1653462283031,CSE 293,030,094934,Saul; Lawrence,9999,0,9999,0
1653462283031,CSE 293,031,094935,Savage; Stefan,9999,0,9999,0
1653462283031,CSE 293,032,094936,Schulze; Jurgen P.,9999,0,9999,0
1653462283031,CSE 293,033,094937,Snoeren; Alex C.,9999,0,9999,0
1653462283031,CSE 293,034,094938,Shang; Jingbo,9999,0,9999,0
1653462283031,CSE 293,035,094939,Stefan; Deian,9999,0,9999,0
1653462283031,CSE 293,036,094940,Su; Hao,9999,0,9999,0
1653462283031,CSE 293,037,094941,Swanson; Steven James,9999,0,9999,0
1653462283031,CSE 293,038,094942,Tullsen; Dean Michael,9999,0,9999,0
1653462283031,CSE 293,039,094943,Voelker; Geoffrey M.,9999,0,9999,0
1653462283031,CSE 293,040,094944,Zhao; Jishen,9999,0,9999,0
1653462283031,CSE 293,041,094945,Zhou; Yuan-Yuan,9999,0,9999,0
1653462283031,CSE 293,042,094946,Gao; Sicun,9998,0,9999,1
1653462283031,CSE 293,043,094947,Weibel; Nadir,9999,0,9999,0
1653462283031,CSE 293,044,094948,Gupta; Rajesh K.,9999,0,9999,0
1653462283628,CSE 294,A00,090143,Porter; George M,9,0,10,1
1653462284157,DSE 200,A00,091799,Staff,50,0,50,0
1653462284680,DSE 203,A00,091800,Gupta; Amarnath,30,0,30,0
1653462285211,DSE 250,A00,091801,Deutsch; Alin Bernard,30,0,30,0
1653462285738,DSE 290,A00,091802,Altintas De Callaf; Ilkay,50,0,50,0
1653462286280,ECE 200,001,091003,Antipa; Nicholas A,9999,0,9999,0
1653462286280,ECE 200,002,091004,Atanasov; Nikolay A.,9999,0,9999,0
1653462286280,ECE 200,003,091005,Bharadia; Dinesh,9999,0,9999,0
1653462286280,ECE 200,004,091006,Cheng; Chung Kuan,9999,0,9999,0
1653462286280,ECE 200,005,091007,Cosman; Pamela C.,9999,0,9999,0
1653462286280,ECE 200,006,091008,Staff,9999,0,9999,0
1653462286280,ECE 200,007,091009,Dayeh; Shadi Ahmad,9999,0,9999,0
1653462286280,ECE 200,008,091010,Fainman; Yeshaiahu,9999,0,9999,0
1653462286280,ECE 200,009,091011,Ford; Joseph Earl,9999,0,9999,0
1653462286280,ECE 200,010,091012,Franceschetti; Massimo,9999,0,9999,0
1653462286280,ECE 200,011,091013,Fullerton; Eric E,9999,0,9999,0
1653462286280,ECE 200,012,091014,Galton; Ian A,9999,0,9999,0
1653462286280,ECE 200,013,091015,Gilja; Vikash,9999,0,9999,0
1653462286280,ECE 200,014,091016,Hall; Drew A.,9999,0,9999,0
1653462286280,ECE 200,015,091017,Hsueh; Tzu-Chien,9999,0,9999,0
1653462286280,ECE 200,016,091018,Javidi; Tara,9999,0,9999,0
1653462286280,ECE 200,017,091019,Kahng; Andrew Byun,9999,0,9999,0
1653462286280,ECE 200,018,091020,Kim; Young-Han,9999,0,9999,0
1653462286280,ECE 200,019,091021,Koushanfar; Farinaz,9999,0,9999,0
1653462286280,ECE 200,020,091022,Kuzum; Duygu,9999,0,9999,0
1653462286280,ECE 200,021,091023,Le; Hanh-Phuc,9999,0,9999,0
1653462286280,ECE 200,022,091024,Lin; Bill,9999,0,9999,0
1653462286280,ECE 200,023,091025,Liu; Zhaowei,9999,0,9999,0
1653462286280,ECE 200,024,091026,Lo; Yu-Hwa,9999,0,9999,0
1653462286280,ECE 200,025,091027,Lomakin; Vitaliy,9999,0,9999,0
1653462286280,ECE 200,026,091028,Mercier; Patrick Philip,9999,0,9999,0
1653462286280,ECE 200,027,091029,Meyer; Florian,9999,0,9999,0
1653462286280,ECE 200,028,091030,Milstein; Laurence B.,9999,0,9999,0
1653462286280,ECE 200,029,091031,Mir Arabbaygi; Siavash,9999,0,9999,0
1653462286280,ECE 200,030,091032,Mookherjea; Shayan,9999,0,9999,0
1653462286280,ECE 200,031,091033,Morris; Karcher William,9999,0,9999,0
1653462286280,ECE 200,032,091034,Ng; Tse Nga,9999,0,9999,0
1653462286280,ECE 200,033,091035,Nguyen; Truong Quang,9999,0,9999,0
1653462286280,ECE 200,034,091036,Nomura; Kenji,9999,0,9999,0
1653462286280,ECE 200,035,091037,Orlitsky; Alon,9999,0,9999,0
1653462286280,ECE 200,036,091038,Pal; Piya,9999,0,9999,0
1653462286280,ECE 200,037,091039,Papen; George C.,9999,0,9999,0
1653462286280,ECE 200,038,091040,Radic; Stojan,9999,0,9999,0
1653462286280,ECE 200,039,091041,Rao; Bhaskar D.,9999,0,9999,0
1653462286280,ECE 200,040,091042,Rao; Ramesh R,9999,0,9999,0
1653462286280,ECE 200,041,091043,Rebeiz; Gabriel,9999,0,9999,0
1653462286280,ECE 200,042,091044,Sanford; John R,9999,0,9999,0
1653462286280,ECE 200,043,091045,Siegel; Paul H.,9999,0,9999,0
1653462286280,ECE 200,044,091046,Sievenpiper; Daniel F.,9999,0,9999,0
1653462286280,ECE 200,045,091047,Sworder; David D.,9999,0,9999,0
1653462286280,ECE 200,046,091048,Taur; Yuan,9999,0,9999,0
1653462286280,ECE 200,047,091049,Touri; Behrouz,9999,0,9999,0
1653462286280,ECE 200,048,091050,Trivedi; Mohan M.,9999,0,9999,0
1653462286280,ECE 200,049,091051,Vardy; Alexander,9999,0,9999,0
1653462286280,ECE 200,050,091052,Vasconcelos; Nuno,9999,0,9999,0
1653462286280,ECE 200,051,091053,Wang; Xiaolong,9999,0,9999,0
1653462286280,ECE 200,052,091054,Xie; Pengtao,9999,0,9999,0
1653462286280,ECE 200,053,091055,Yip; Michael,9999,0,9999,0
1653462286280,ECE 200,054,091056,Zeger; Kenneth A.,9999,0,9999,0
1653462286280,ECE 200,055,091057,Zhang; Xinyu,9999,0,9999,0
1653462286280,ECE 200,056,091058,Turakhia; Yatish Girish,9999,0,9999,0
1653462286280,ECE 200,057,091059,Kang; Mingu,9999,0,9999,0
1653462286280,ECE 200,058,091060,Shi; Yuanyuan,9999,0,9999,0
1653462286280,ECE 200,059,091061,Wang; Edward Jay,9999,0,9999,0
1653462286280,ECE 200,060,091062,Zheng; Yang,9999,0,9999,0
1653462286825,ECE 203,A00,091065,Mercier; Patrick Philip,0,0,0,0
1653462287349,ECE 207A,A00,091605,Liu; Thomas Tao-Ming,0,0,0,0
1653462287876,ECE 212AN,A00,091068,Nomura; Kenji,0,0,0,0
1653462288404,ECE 222A,A00,091069,Rebeiz; Gabriel,0,0,0,0
1653462288927,ECE 225A,A00,091070,Orlitsky; Alon,0,0,0,0
1653462289455,ECE 230A,A00,091071,Nomura; Kenji,0,0,0,0
1653462289981,ECE 236A,A00,091072,Dayeh; Shadi Ahmad,0,0,0,0
1653462290508,ECE 238A,A00,091073,Luo; Jian,0,0,0,0
1653462290508,ECE 238A,B00,091074,Luo; Jian,0,0,0,0
1653462291031,ECE 240A,A00,091075,Radic; Stojan,0,0,0,0
1653462291560,ECE 247A,A00,091592,Shi; Lingyan,0,0,0,0
1653462292083,ECE 250,A00,091076,Touri; Behrouz,0,0,0,0
1653462292608,ECE 251C,A00,091078,Nguyen; Truong Quang,0,0,0,0
1653462293131,ECE 253,A00,091079,Cosman; Pamela C.,0,0,0,0
1653462293654,ECE 255A,A00,091080,Orlitsky; Alon,0,0,0,0
1653462294192,ECE 257A,A00,091081,Zhang; Xinyu,0,0,0,0
1653462294716,ECE 260A,A01,091084,Eldon; John,0,0,0,0
1653462295251,ECE 264C,A00,091085,Galton; Ian A,0,0,0,0
1653462295774,ECE 265C,A00,094889,Presti; Calogero Davide,0,0,0,9
1653462296300,ECE 266,A01,091087,Hall; Drew A.,0,0,0,0
1653462297350,ECE 271A,A00,091090,Vasconcelos; Nuno,0,0,0,0
1653462297876,ECE 272B,A00,091091,Sworder; David D.,0,0,0,0
1653462298399,ECE 275A,A00,091092,Meyer; Florian,0,0,0,0
1653462298923,ECE 277,A00,091093,An; Cheolhong,0,0,0,0
1653462299445,ECE 283,A00,091094,Le; Hanh-Phuc,0,0,0,0
1653462299969,ECE 284,A00,091095,Kang; Mingu,0,0,0,0
1653462299969,ECE 284,B00,091096,Wang; Edward Jay,0,0,0,0
1653462300583,ECE 285,A00,094334,Touri; Behrouz,0,0,0,0
1653462301106,ECE 289,A00,091097,Whelan; David Arthur,0,0,0,0
1653462301629,MATH 200A,A00,087414,Salehi Golsefidy; Alireza,7,0,8,1
1653462302152,MATH 202A,A00,087415,Gill; Philip E.,3,0,8,5
1653462302686,MATH 203A,A00,087416,Oprea; Dragos N.,6,0,8,2
1653462303215,MATH 204A,A00,087417,Kedlaya; Kiran S.,6,0,8,2
1653462303739,MATH 205,A00,087418,Sorensen; Claus M,6,0,8,2
1653462304262,MATH 206A,A00,087419,Izadi; Elham,7,0,8,1
1653462304793,MATH 207A,A00,087420,Mohammadi; Amir,6,0,8,2
1653462305316,MATH 208,A00,087421,Staff,9,0,10,1
1653462305842,MATH 209,A00,087422,Staff,10,0,10,0
1653462306365,MATH 218,A00,087423,Staff,10,0,10,0
1653462306889,MATH 220A,A00,087424,Novak; Jonathan I,7,0,8,1
1653462307416,MATH 231A,A00,087425,Bejenaru; Ioan,3,0,8,5
1653462307943,MATH 240A,A00,087426,Ebenfelt; Peter F,5,0,8,3
1653462308466,MATH 243,A00,087427,Staff,9,0,10,1
1653462308993,MATH 248,A00,087429,Staff,10,0,10,0
1653462309521,MATH 250A,A00,087430,Spolaor; Luca,4,0,8,4
1653462310046,MATH 257A,A00,087431,Spolaor; Luca,7,0,8,1
1653462310574,MATH 258,A00,087432,Staff,9,0,10,1
1653462311099,MATH 264A,A00,087433,Warnke; Lutz Peter,5,0,8,3
1653462311622,MATH 268,A00,087434,Staff,15,0,15,0
1653462312145,MATH 269,A00,087435,Staff,14,0,15,1
1653462312686,MATH 270A,A00,087436,Nie; Jiawang,0,0,8,8
1653462313215,MATH 272A,A00,087437,Tian; Xiaochuan,1,0,8,7
1653462313737,MATH 274,A01,087439,Cheng; Li-Tien,9,0,10,1
1653462313737,MATH 274,A02,087440,Cheng; Li-Tien,10,0,10,0
1653462314260,MATH 278A,A00,087441,Staff,8,0,10,2
1653462314783,MATH 278B,A00,087442,Staff,8,0,10,2
1653462315322,MATH 278C,A00,087443,Staff,8,0,10,2
1653462315845,MATH 280A,A00,087444,Zheng; Tianyi,0,0,8,8
1653462316371,MATH 281A,A00,087445,Bradic; Jelena,0,0,8,8
1653462316894,MATH 282A,A00,087446,Zhang; Danna,0,0,8,8
1653462317421,MATH 283,A00,087447,Tesler; Glenn,0,0,0,14
1653462317950,MATH 286,A00,087448,Kemp; Todd Aahron,5,0,8,3
1653462318482,MATH 287D,A00,087449,Bradic; Jelena,8,0,8,0
1653462319009,MATH 288,A00,087450,Staff,14,0,15,1
1653462319009,MATH 288,B00,087451,Staff,15,0,15,0
1653462319009,MATH 288,C00,087452,Staff,15,0,15,0
1653462319536,MATH 290A,A00,087453,Xu; Zhouli,7,0,8,1
1653462320066,MATH 291A,A00,087454,Xu; Zhouli,7,0,8,1
1653462320601,MATH 292,A00,087455,Staff,10,0,10,0
1653462321123,MATH 295,A00,087456,Staff,50,0,50,0
1653462321652,MATH 297,001,087457,Staff,998,0,999,1
1653462884502,COGS 200,A01,087991,Staff,47,0,50,3
1653462885035,COGS 201,A01,094504,Rangel; Lara M,17,0,25,8
1653462885567,COGS 203,A00,087992,Coulson; Seana M,18,0,20,2
1653462886091,COGS 210A,001,087993,Greene; Deanna Jacquelyn,9998,0,9999,1
1653462886091,COGS 210A,002,087994,Saygin; Ayse P,9999,0,9999,0
1653462886091,COGS 210A,003,087995,Xia; Haijun,9999,0,9999,0
1653462886091,COGS 210A,004,087996,Nitz; Douglas A.,9999,0,9999,0
1653462886091,COGS 210A,005,087997,Hollan; James D.,9999,0,9999,0
1653462886091,COGS 210A,006,087998,Deak; Gedeon O.,9998,0,9999,1
1653462886091,COGS 210A,007,087999,Rossano; Federico,9999,0,9999,0
1653462886622,COGS 211A,A00,088000,Coulson; Seana M,9997,0,9999,2
1653462887144,COGS 229,A00,088002,Staff,23,0,25,2
1653462887673,COGS 260,B00,094231,Staff,17,0,20,3
1653462887673,COGS 260,A00,088004,Nitz; Douglas A.,9998,0,9999,1
1653462888197,CSE 202,A00,090110,Paturi; Ramamohan,0,0,0,0
1653462888197,CSE 202,B00,090111,Paturi; Ramamohan,0,0,0,0
1653462888724,CSE 207B,A00,090112,Heninger; Nadia A,0,0,0,0
1653462889249,CSE 208,A00,094858,Micciancio; Daniele,0,0,0,0
1653462889785,CSE 210,A00,090113,Powell; Thomas Allan,0,0,0,0
1653462890308,CSE 219,A00,090898,Staff,0,0,0,0
1653462890925,CSE 221,A00,090114,Zhou; Yuan-Yuan,0,0,0,0
1653462891457,CSE 229A,A00,090115,Porter; George M,0,0,0,0
1653462891981,CSE 229C,A00,090116,Savage; Stefan,0,0,0,0
1653462892518,CSE 230,A00,090117,Jhala; Ranjit,0,0,0,0
1653462893067,CSE 232,A00,090118,Papakonstantinou; Yannis,0,0,0,0
1653462893593,CSE 239A,A00,090121,Kumar; Arun Kumar,0,0,0,0
1653462894116,CSE 239B,A00,090122,Jhala; Ranjit,0,0,0,0
1653462894640,CSE 240A,A00,090123,Zhao; Jishen,0,0,189,189
1653462895181,CSE 243A,A00,090124,Orailoglu; Alex,1,0,15,14
1653462895711,CSE 249B,A00,090125,Kahng; Andrew Byun,13,0,20,7
1653462896238,CSE 250A,A00,090126,Berg-Kirkpatrick; Taylor D,0,0,0,0
1653462896761,CSE 252A,A00,090127,Ochoa; Benjamin Lawrence,0,0,0,0
1653462897303,CSE 258,A01,090129,McAuley; Julian John,0,0,0,0
1653462897834,CSE 258R,A01,090131,McAuley; Julian John,0,0,0,0
1653462898371,CSE 274,A00,090132,Ramamoorthi; Ravi,0,0,0,0
1653462898897,CSE 276A,A00,090133,Christensen; Henrik I,0,0,0,0
1653462899429,CSE 276C,A00,090134,Christensen; Henrik I,0,0,0,0
1653462899962,CSE 290,A00,090135,Bafna; Vineet,0,0,0,0
1653462899962,CSE 290,B00,090136,Ramamoorthi; Ravi,0,0,0,0
1653462899962,CSE 290,C00,090137,Li; Tzumao,9,0,10,1
1653462899962,CSE 290,D00,090138,Zhou; Yuan-Yuan,10,0,10,0
1653462899962,CSE 290,E00,090139,Christensen; Henrik I,10,0,10,0
1653462899962,CSE 290,F00,094053,Shalev; Aaron D,0,0,0,0
1653462900509,CSE 291,A00,090140,Munyaka; Imani N. S.,0,0,0,0
1653462900509,CSE 291,B00,094880,Yu; Qi,0,0,0,0
1653462900509,CSE 291,C00,090142,Pannuto; Patrick William,0,0,0,0
1653462900509,CSE 291,D00,094881,Zhang; Yiying,0,0,0,0
1653462900509,CSE 291,E00,095118,Su; Hao,0,0,0,0
1653462901066,CSE 293,001,094905,Bafna; Vineet,9999,0,9999,0
1653462901066,CSE 293,002,094906,Bellare; Mihir,9999,0,9999,0
1653462901066,CSE 293,003,094907,Berg-Kirkpatrick; Taylor D,9999,0,9999,0
1653462901066,CSE 293,004,094908,Christensen; Henrik I,9999,0,9999,0
1653462901066,CSE 293,005,094909,Cottrell; Garrison W,9999,0,9999,0
1653462901066,CSE 293,006,094910,Deutsch; Alin Bernard,9999,0,9999,0
1653462901066,CSE 293,007,094911,Esmaeilzadeh; Hadi,9999,0,9999,0
1653462901066,CSE 293,008,094912,Freund; Yoav,9999,0,9999,0
1653462901066,CSE 293,009,094913,Griswold; William G.,9999,0,9999,0
1653462901066,CSE 293,010,094914,Gymrek; Melissa Ann,9999,0,9999,0
1653462901066,CSE 293,011,094915,Heninger; Nadia A,9999,0,9999,0
1653462901066,CSE 293,012,094916,Impagliazzo; Russell,9999,0,9999,0
1653462901066,CSE 293,013,094917,Jhala; Ranjit,9999,0,9999,0
1653462901066,CSE 293,014,094918,Kahng; Andrew Byun,9999,0,9999,0
1653462901066,CSE 293,015,094919,Kane; Daniel Mertz,9999,0,9999,0
1653462901066,CSE 293,016,094920,Kriegman; David J,9999,0,9999,0
1653462901066,CSE 293,017,094921,Kumar; Arun Kumar,9999,0,9999,0
1653462901066,CSE 293,018,094922,Lerner; Sorin,9999,0,9999,0
1653462901066,CSE 293,019,094923,Lovett; Shachar,9999,0,9999,0
1653462901066,CSE 293,020,094924,McAuley; Julian John,9999,0,9999,0
1653462901066,CSE 293,021,094925,Micciancio; Daniele,9999,0,9999,0
1653462901066,CSE 293,022,094926,Orailoglu; Alex,9999,0,9999,0
1653462901066,CSE 293,023,094927,Paturi; Ramamohan,9999,0,9999,0
1653462901066,CSE 293,024,094928,Polikarpova; Nadezhda,9999,0,9999,0
1653462901066,CSE 293,025,094929,Politz; Joseph Gibbs,9999,0,9999,0
1653462901066,CSE 293,026,094930,Porter; George M,9999,0,9999,0
1653462901066,CSE 293,027,094931,Porter; Leonard Emerson,9999,0,9999,0
1653462901066,CSE 293,028,094932,Ramamoorthi; Ravi,9999,0,9999,0
1653462901066,CSE 293,029,094933,Sahoo; Debashis,9999,0,9999,0
1653462901066,CSE 293,030,094934,Saul; Lawrence,9999,0,9999,0
1653462901066,CSE 293,031,094935,Savage; Stefan,9999,0,9999,0
1653462901066,CSE 293,032,094936,Schulze; Jurgen P.,9999,0,9999,0
1653462901066,CSE 293,033,094937,Snoeren; Alex C.,9999,0,9999,0
1653462901066,CSE 293,034,094938,Shang; Jingbo,9999,0,9999,0
1653462901066,CSE 293,035,094939,Stefan; Deian,9999,0,9999,0
1653462901066,CSE 293,036,094940,Su; Hao,9999,0,9999,0
1653462901066,CSE 293,037,094941,Swanson; Steven James,9999,0,9999,0
1653462901066,CSE 293,038,094942,Tullsen; Dean Michael,9999,0,9999,0
1653462901066,CSE 293,039,094943,Voelker; Geoffrey M.,9999,0,9999,0
1653462901066,CSE 293,040,094944,Zhao; Jishen,9999,0,9999,0
1653462901066,CSE 293,041,094945,Zhou; Yuan-Yuan,9999,0,9999,0
1653462901066,CSE 293,042,094946,Gao; Sicun,9998,0,9999,1
1653462901066,CSE 293,043,094947,Weibel; Nadir,9999,0,9999,0
1653462901066,CSE 293,044,094948,Gupta; Rajesh K.,9999,0,9999,0
1653462901607,CSE 294,A00,090143,Porter; George M,9,0,10,1
1653462902134,DSE 200,A00,091799,Staff,50,0,50,0
1653462902671,DSE 203,A00,091800,Gupta; Amarnath,30,0,30,0
1653462903195,DSE 250,A00,091801,Deutsch; Alin Bernard,30,0,30,0
1653462903733,DSE 290,A00,091802,Altintas De Callaf; Ilkay,50,0,50,0
1653462904267,ECE 200,001,091003,Antipa; Nicholas A,9999,0,9999,0
1653462904267,ECE 200,002,091004,Atanasov; Nikolay A.,9999,0,9999,0
1653462904267,ECE 200,003,091005,Bharadia; Dinesh,9999,0,9999,0
1653462904267,ECE 200,004,091006,Cheng; Chung Kuan,9999,0,9999,0
1653462904267,ECE 200,005,091007,Cosman; Pamela C.,9999,0,9999,0
1653462904267,ECE 200,006,091008,Staff,9999,0,9999,0
1653462904267,ECE 200,007,091009,Dayeh; Shadi Ahmad,9999,0,9999,0
1653462904267,ECE 200,008,091010,Fainman; Yeshaiahu,9999,0,9999,0
1653462904267,ECE 200,009,091011,Ford; Joseph Earl,9999,0,9999,0
1653462904267,ECE 200,010,091012,Franceschetti; Massimo,9999,0,9999,0
1653462904267,ECE 200,011,091013,Fullerton; Eric E,9999,0,9999,0
1653462904267,ECE 200,012,091014,Galton; Ian A,9999,0,9999,0
1653462904267,ECE 200,013,091015,Gilja; Vikash,9999,0,9999,0
1653462904267,ECE 200,014,091016,Hall; Drew A.,9999,0,9999,0
1653462904267,ECE 200,015,091017,Hsueh; Tzu-Chien,9999,0,9999,0
1653462904267,ECE 200,016,091018,Javidi; Tara,9999,0,9999,0
1653462904267,ECE 200,017,091019,Kahng; Andrew Byun,9999,0,9999,0
1653462904267,ECE 200,018,091020,Kim; Young-Han,9999,0,9999,0
1653462904267,ECE 200,019,091021,Koushanfar; Farinaz,9999,0,9999,0
1653462904267,ECE 200,020,091022,Kuzum; Duygu,9999,0,9999,0
1653462904267,ECE 200,021,091023,Le; Hanh-Phuc,9999,0,9999,0
1653462904267,ECE 200,022,091024,Lin; Bill,9999,0,9999,0
1653462904267,ECE 200,023,091025,Liu; Zhaowei,9999,0,9999,0
1653462904267,ECE 200,024,091026,Lo; Yu-Hwa,9999,0,9999,0
1653462904267,ECE 200,025,091027,Lomakin; Vitaliy,9999,0,9999,0
1653462904267,ECE 200,026,091028,Mercier; Patrick Philip,9999,0,9999,0
1653462904267,ECE 200,027,091029,Meyer; Florian,9999,0,9999,0
1653462904267,ECE 200,028,091030,Milstein; Laurence B.,9999,0,9999,0
1653462904267,ECE 200,029,091031,Mir Arabbaygi; Siavash,9999,0,9999,0
1653462904267,ECE 200,030,091032,Mookherjea; Shayan,9999,0,9999,0
1653462904267,ECE 200,031,091033,Morris; Karcher William,9999,0,9999,0
1653462904267,ECE 200,032,091034,Ng; Tse Nga,9999,0,9999,0
1653462904267,ECE 200,033,091035,Nguyen; Truong Quang,9999,0,9999,0
1653462904267,ECE 200,034,091036,Nomura; Kenji,9999,0,9999,0
1653462904267,ECE 200,035,091037,Orlitsky; Alon,9999,0,9999,0
1653462904267,ECE 200,036,091038,Pal; Piya,9999,0,9999,0
1653462904267,ECE 200,037,091039,Papen; George C.,9999,0,9999,0
1653462904267,ECE 200,038,091040,Radic; Stojan,9999,0,9999,0
1653462904267,ECE 200,039,091041,Rao; Bhaskar D.,9999,0,9999,0
1653462904267,ECE 200,040,091042,Rao; Ramesh R,9999,0,9999,0
1653462904267,ECE 200,041,091043,Rebeiz; Gabriel,9999,0,9999,0
1653462904267,ECE 200,042,091044,Sanford; John R,9999,0,9999,0
1653462904267,ECE 200,043,091045,Siegel; Paul H.,9999,0,9999,0
1653462904267,ECE 200,044,091046,Sievenpiper; Daniel F.,9999,0,9999,0
1653462904267,ECE 200,045,091047,Sworder; David D.,9999,0,9999,0
1653462904267,ECE 200,046,091048,Taur; Yuan,9999,0,9999,0
1653462904267,ECE 200,047,091049,Touri; Behrouz,9999,0,9999,0
1653462904267,ECE 200,048,091050,Trivedi; Mohan M.,9999,0,9999,0
1653462904267,ECE 200,049,091051,Vardy; Alexander,9999,0,9999,0
1653462904267,ECE 200,050,091052,Vasconcelos; Nuno,9999,0,9999,0
1653462904267,ECE 200,051,091053,Wang; Xiaolong,9999,0,9999,0
1653462904267,ECE 200,052,091054,Xie; Pengtao,9999,0,9999,0
1653462904267,ECE 200,053,091055,Yip; Michael,9999,0,9999,0
1653462904267,ECE 200,054,091056,Zeger; Kenneth A.,9999,0,9999,0
1653462904267,ECE 200,055,091057,Zhang; Xinyu,9999,0,9999,0
1653462904267,ECE 200,056,091058,Turakhia; Yatish Girish,9999,0,9999,0
1653462904267,ECE 200,057,091059,Kang; Mingu,9999,0,9999,0
1653462904267,ECE 200,058,091060,Shi; Yuanyuan,9999,0,9999,0
1653462904267,ECE 200,059,091061,Wang; Edward Jay,9999,0,9999,0
1653462904267,ECE 200,060,091062,Zheng; Yang,9999,0,9999,0
1653462904801,ECE 203,A00,091065,Mercier; Patrick Philip,0,0,0,0
1653462905333,ECE 207A,A00,091605,Liu; Thomas Tao-Ming,0,0,0,0
1653462905866,ECE 212AN,A00,091068,Nomura; Kenji,0,0,0,0
1653462906393,ECE 222A,A00,091069,Rebeiz; Gabriel,0,0,0,0
1653462906926,ECE 225A,A00,091070,Orlitsky; Alon,0,0,0,0
1653462907456,ECE 230A,A00,091071,Nomura; Kenji,0,0,0,0
1653462907986,ECE 236A,A00,091072,Dayeh; Shadi Ahmad,0,0,0,0
1653462908511,ECE 238A,A00,091073,Luo; Jian,0,0,0,0
1653462908511,ECE 238A,B00,091074,Luo; Jian,0,0,0,0
1653462909035,ECE 240A,A00,091075,Radic; Stojan,0,0,0,0
1653462909560,ECE 247A,A00,091592,Shi; Lingyan,0,0,0,0
1653462910085,ECE 250,A00,091076,Touri; Behrouz,0,0,0,0
1653462910620,ECE 251C,A00,091078,Nguyen; Truong Quang,0,0,0,0
1653462911146,ECE 253,A00,091079,Cosman; Pamela C.,0,0,0,0
1653462911674,ECE 255A,A00,091080,Orlitsky; Alon,0,0,0,0
1653462912199,ECE 257A,A00,091081,Zhang; Xinyu,0,0,0,0
1653462912723,ECE 260A,A01,091084,Eldon; John,0,0,0,0
1653462913251,ECE 264C,A00,091085,Galton; Ian A,0,0,0,0
1653462913777,ECE 265C,A00,094889,Presti; Calogero Davide,0,0,0,9
1653462914380,ECE 266,A01,091087,Hall; Drew A.,0,0,0,0
1653462915446,ECE 271A,A00,091090,Vasconcelos; Nuno,0,0,0,0
1653462916011,ECE 272B,A00,091091,Sworder; David D.,0,0,0,0
1653462916536,ECE 275A,A00,091092,Meyer; Florian,0,0,0,0
1653462917082,ECE 277,A00,091093,An; Cheolhong,0,0,0,0
1653462917622,ECE 283,A00,091094,Le; Hanh-Phuc,0,0,0,0
1653462918146,ECE 284,A00,091095,Kang; Mingu,0,0,0,0
1653462918146,ECE 284,B00,091096,Wang; Edward Jay,0,0,0,0
1653462918670,ECE 285,A00,094334,Touri; Behrouz,0,0,0,0
1653462919193,ECE 289,A00,091097,Whelan; David Arthur,0,0,0,0
1653462919732,MATH 200A,A00,087414,Salehi Golsefidy; Alireza,7,0,8,1
1653462920259,MATH 202A,A00,087415,Gill; Philip E.,3,0,8,5
1653462920783,MATH 203A,A00,087416,Oprea; Dragos N.,6,0,8,2
1653462921329,MATH 204A,A00,087417,Kedlaya; Kiran S.,6,0,8,2
1653462921856,MATH 205,A00,087418,Sorensen; Claus M,6,0,8,2
1653462922394,MATH 206A,A00,087419,Izadi; Elham,7,0,8,1
1653462922922,MATH 207A,A00,087420,Mohammadi; Amir,6,0,8,2
1653462923443,MATH 208,A00,087421,Staff,9,0,10,1
1653462924009,MATH 209,A00,087422,Staff,10,0,10,0
1653462924544,MATH 218,A00,087423,Staff,10,0,10,0
1653462925091,MATH 220A,A00,087424,Novak; Jonathan I,7,0,8,1
1653462925684,MATH 231A,A00,087425,Bejenaru; Ioan,3,0,8,5
1653462926207,MATH 240A,A00,087426,Ebenfelt; Peter F,5,0,8,3
1653462926760,MATH 243,A00,087427,Staff,9,0,10,1
1653462927287,MATH 248,A00,087429,Staff,10,0,10,0
1653462927865,MATH 250A,A00,087430,Spolaor; Luca,4,0,8,4
1653462928387,MATH 257A,A00,087431,Spolaor; Luca,7,0,8,1
1653462928977,MATH 258,A00,087432,Staff,9,0,10,1
1653462929515,MATH 264A,A00,087433,Warnke; Lutz Peter,5,0,8,3
1653462930038,MATH 268,A00,087434,Staff,15,0,15,0
1653462930564,MATH 269,A00,087435,Staff,14,0,15,1
1653462931087,MATH 270A,A00,087436,Nie; Jiawang,0,0,8,8
1653462931629,MATH 272A,A00,087437,Tian; Xiaochuan,1,0,8,7
1653462932156,MATH 274,A01,087439,Cheng; Li-Tien,9,0,10,1
1653462932156,MATH 274,A02,087440,Cheng; Li-Tien,10,0,10,0
1653462932720,MATH 278A,A00,087441,Staff,8,0,10,2
1653462933243,MATH 278B,A00,087442,Staff,8,0,10,2
1653462933789,MATH 278C,A00,087443,Staff,8,0,10,2
1653462934314,MATH 280A,A00,087444,Zheng; Tianyi,0,0,8,8
1653462934846,MATH 281A,A00,087445,Bradic; Jelena,0,0,8,8
1653462935373,MATH 282A,A00,087446,Zhang; Danna,0,0,8,8
1653462935898,MATH 283,A00,087447,Tesler; Glenn,0,0,0,14
1653462936444,MATH 286,A00,087448,Kemp; Todd Aahron,5,0,8,3
1653462936984,MATH 287D,A00,087449,Bradic; Jelena,8,0,8,0
1653462937512,MATH 288,A00,087450,Staff,14,0,15,1
1653462937512,MATH 288,B00,087451,Staff,15,0,15,0
1653462937512,MATH 288,C00,087452,Staff,15,0,15,0
1653462938040,MATH 290A,A00,087453,Xu; Zhouli,7,0,8,1
1653462938678,MATH 291A,A00,087454,Xu; Zhouli,7,0,8,1
1653462939201,MATH 292,A00,087455,Staff,10,0,10,0
1653462939730,MATH 295,A00,087456,Staff,50,0,50,0
1653462940255,MATH 297,001,087457,Staff,998,0,999,1
1653463502351,COGS 200,A01,087991,Staff,47,0,50,3
1653463502879,COGS 201,A01,094504,Rangel; Lara M,17,0,25,8
1653463503421,COGS 203,A00,087992,Coulson; Seana M,18,0,20,2
1653463503955,COGS 210A,001,087993,Greene; Deanna Jacquelyn,9998,0,9999,1
1653463503955,COGS 210A,002,087994,Saygin; Ayse P,9999,0,9999,0
1653463503955,COGS 210A,003,087995,Xia; Haijun,9999,0,9999,0
1653463503955,COGS 210A,004,087996,Nitz; Douglas A.,9999,0,9999,0
1653463503955,COGS 210A,005,087997,Hollan; James D.,9999,0,9999,0
1653463503955,COGS 210A,006,087998,Deak; Gedeon O.,9998,0,9999,1
1653463503955,COGS 210A,007,087999,Rossano; Federico,9999,0,9999,0
1653463504477,COGS 211A,A00,088000,Coulson; Seana M,9997,0,9999,2
1653463505014,COGS 229,A00,088002,Staff,23,0,25,2
1653463505541,COGS 260,B00,094231,Staff,17,0,20,3
1653463505541,COGS 260,A00,088004,Nitz; Douglas A.,9998,0,9999,1
1653463506071,CSE 202,A00,090110,Paturi; Ramamohan,0,0,0,0
1653463506071,CSE 202,B00,090111,Paturi; Ramamohan,0,0,0,0
1653463506594,CSE 207B,A00,090112,Heninger; Nadia A,0,0,0,0
1653463507118,CSE 208,A00,094858,Micciancio; Daniele,0,0,0,0
1653463507641,CSE 210,A00,090113,Powell; Thomas Allan,0,0,0,0
1653463508166,CSE 219,A00,090898,Staff,0,0,0,0
1653463508690,CSE 221,A00,090114,Zhou; Yuan-Yuan,0,0,0,0
1653463509215,CSE 229A,A00,090115,Porter; George M,0,0,0,0
1653463509738,CSE 229C,A00,090116,Savage; Stefan,0,0,0,0
1653463510264,CSE 230,A00,090117,Jhala; Ranjit,0,0,0,0
1653463510793,CSE 232,A00,090118,Papakonstantinou; Yannis,0,0,0,0
1653463511316,CSE 239A,A00,090121,Kumar; Arun Kumar,0,0,0,0
1653463511840,CSE 239B,A00,090122,Jhala; Ranjit,0,0,0,0
1653463512365,CSE 240A,A00,090123,Zhao; Jishen,0,0,189,189
1653463512887,CSE 243A,A00,090124,Orailoglu; Alex,1,0,15,14
1653463513410,CSE 249B,A00,090125,Kahng; Andrew Byun,13,0,20,7
1653463513934,CSE 250A,A00,090126,Berg-Kirkpatrick; Taylor D,0,0,0,0
1653463514463,CSE 252A,A00,090127,Ochoa; Benjamin Lawrence,0,0,0,0
1653463514985,CSE 258,A01,090129,McAuley; Julian John,0,0,0,0
1653463515510,CSE 258R,A01,090131,McAuley; Julian John,0,0,0,0
1653463516035,CSE 274,A00,090132,Ramamoorthi; Ravi,0,0,0,0
1653463516559,CSE 276A,A00,090133,Christensen; Henrik I,0,0,0,0
1653463517083,CSE 276C,A00,090134,Christensen; Henrik I,0,0,0,0
1653463517613,CSE 290,A00,090135,Bafna; Vineet,0,0,0,0
1653463517613,CSE 290,B00,090136,Ramamoorthi; Ravi,0,0,0,0
1653463517613,CSE 290,C00,090137,Li; Tzumao,9,0,10,1
1653463517613,CSE 290,D00,090138,Zhou; Yuan-Yuan,10,0,10,0
1653463517613,CSE 290,E00,090139,Christensen; Henrik I,10,0,10,0
1653463517613,CSE 290,F00,094053,Shalev; Aaron D,0,0,0,0
1653463518137,CSE 291,A00,090140,Munyaka; Imani N. S.,0,0,0,0
1653463518137,CSE 291,B00,094880,Yu; Qi,0,0,0,0
1653463518137,CSE 291,C00,090142,Pannuto; Patrick William,0,0,0,0
1653463518137,CSE 291,D00,094881,Zhang; Yiying,0,0,0,0
1653463518137,CSE 291,E00,095118,Su; Hao,0,0,0,0
1653463518670,CSE 293,001,094905,Bafna; Vineet,9999,0,9999,0
1653463518670,CSE 293,002,094906,Bellare; Mihir,9999,0,9999,0
1653463518670,CSE 293,003,094907,Berg-Kirkpatrick; Taylor D,9999,0,9999,0
1653463518670,CSE 293,004,094908,Christensen; Henrik I,9999,0,9999,0
1653463518670,CSE 293,005,094909,Cottrell; Garrison W,9999,0,9999,0
1653463518670,CSE 293,006,094910,Deutsch; Alin Bernard,9999,0,9999,0
1653463518670,CSE 293,007,094911,Esmaeilzadeh; Hadi,9999,0,9999,0
1653463518670,CSE 293,008,094912,Freund; Yoav,9999,0,9999,0
1653463518670,CSE 293,009,094913,Griswold; William G.,9999,0,9999,0
1653463518670,CSE 293,010,094914,Gymrek; Melissa Ann,9999,0,9999,0
1653463518670,CSE 293,011,094915,Heninger; Nadia A,9999,0,9999,0
1653463518670,CSE 293,012,094916,Impagliazzo; Russell,9999,0,9999,0
1653463518670,CSE 293,013,094917,Jhala; Ranjit,9999,0,9999,0
1653463518670,CSE 293,014,094918,Kahng; Andrew Byun,9999,0,9999,0
1653463518670,CSE 293,015,094919,Kane; Daniel Mertz,9999,0,9999,0
1653463518670,CSE 293,016,094920,Kriegman; David J,9999,0,9999,0
1653463518670,CSE 293,017,094921,Kumar; Arun Kumar,9999,0,9999,0
1653463518670,CSE 293,018,094922,Lerner; Sorin,9999,0,9999,0
1653463518670,CSE 293,019,094923,Lovett; Shachar,9999,0,9999,0
1653463518670,CSE 293,020,094924,McAuley; Julian John,9999,0,9999,0
1653463518670,CSE 293,021,094925,Micciancio; Daniele,9999,0,9999,0
1653463518670,CSE 293,022,094926,Orailoglu; Alex,9999,0,9999,0
1653463518670,CSE 293,023,094927,Paturi; Ramamohan,9999,0,9999,0
1653463518670,CSE 293,024,094928,Polikarpova; Nadezhda,9999,0,9999,0
1653463518670,CSE 293,025,094929,Politz; Joseph Gibbs,9999,0,9999,0
1653463518670,CSE 293,026,094930,Porter; George M,9999,0,9999,0
1653463518670,CSE 293,027,094931,Porter; Leonard Emerson,9999,0,9999,0
1653463518670,CSE 293,028,094932,Ramamoorthi; Ravi,9999,0,9999,0
1653463518670,CSE 293,029,094933,Sahoo; Debashis,9999,0,9999,0
1653463518670,CSE 293,030,094934,Saul; Lawrence,9999,0,9999,0
1653463518670,CSE 293,031,094935,Savage; Stefan,9999,0,9999,0
1653463518670,CSE 293,032,094936,Schulze; Jurgen P.,9999,0,9999,0
1653463518670,CSE 293,033,094937,Snoeren; Alex C.,9999,0,9999,0
1653463518670,CSE 293,034,094938,Shang; Jingbo,9999,0,9999,0
1653463518670,CSE 293,035,094939,Stefan; Deian,9999,0,9999,0
1653463518670,CSE 293,036,094940,Su; Hao,9999,0,9999,0
1653463518670,CSE 293,037,094941,Swanson; Steven James,9999,0,9999,0
1653463518670,CSE 293,038,094942,Tullsen; Dean Michael,9999,0,9999,0
1653463518670,CSE 293,039,094943,Voelker; Geoffrey M.,9999,0,9999,0
1653463518670,CSE 293,040,094944,Zhao; Jishen,9999,0,9999,0
1653463518670,CSE 293,041,094945,Zhou; Yuan-Yuan,9999,0,9999,0
1653463518670,CSE 293,042,094946,Gao; Sicun,9998,0,9999,1
1653463518670,CSE 293,043,094947,Weibel; Nadir,9999,0,9999,0
1653463518670,CSE 293,044,094948,Gupta; Rajesh K.,9999,0,9999,0
1653463519203,CSE 294,A00,090143,Porter; George M,9,0,10,1
1653463519729,DSE 200,A00,091799,Staff,50,0,50,0
1653463520252,DSE 203,A00,091800,Gupta; Amarnath,30,0,30,0
1653463520775,DSE 250,A00,091801,Deutsch; Alin Bernard,30,0,30,0
1653463521300,DSE 290,A00,091802,Altintas De Callaf; Ilkay,50,0,50,0
1653463521868,ECE 200,001,091003,Antipa; Nicholas A,9999,0,9999,0
1653463521868,ECE 200,002,091004,Atanasov; Nikolay A.,9999,0,9999,0
1653463521868,ECE 200,003,091005,Bharadia; Dinesh,9999,0,9999,0
1653463521868,ECE 200,004,091006,Cheng; Chung Kuan,9999,0,9999,0
1653463521868,ECE 200,005,091007,Cosman; Pamela C.,9999,0,9999,0
1653463521868,ECE 200,006,091008,Staff,9999,0,9999,0
1653463521868,ECE 200,007,091009,Dayeh; Shadi Ahmad,9999,0,9999,0
1653463521868,ECE 200,008,091010,Fainman; Yeshaiahu,9999,0,9999,0
1653463521868,ECE 200,009,091011,Ford; Joseph Earl,9999,0,9999,0
1653463521868,ECE 200,010,091012,Franceschetti; Massimo,9999,0,9999,0
1653463521868,ECE 200,011,091013,Fullerton; Eric E,9999,0,9999,0
1653463521868,ECE 200,012,091014,Galton; Ian A,9999,0,9999,0
1653463521868,ECE 200,013,091015,Gilja; Vikash,9999,0,9999,0
1653463521868,ECE 200,014,091016,Hall; Drew A.,9999,0,9999,0
1653463521868,ECE 200,015,091017,Hsueh; Tzu-Chien,9999,0,9999,0
1653463521868,ECE 200,016,091018,Javidi; Tara,9999,0,9999,0
1653463521868,ECE 200,017,091019,Kahng; Andrew Byun,9999,0,9999,0
1653463521868,ECE 200,018,091020,Kim; Young-Han,9999,0,9999,0
1653463521868,ECE 200,019,091021,Koushanfar; Farinaz,9999,0,9999,0
1653463521868,ECE 200,020,091022,Kuzum; Duygu,9999,0,9999,0
1653463521868,ECE 200,021,091023,Le; Hanh-Phuc,9999,0,9999,0
1653463521868,ECE 200,022,091024,Lin; Bill,9999,0,9999,0
1653463521868,ECE 200,023,091025,Liu; Zhaowei,9999,0,9999,0
1653463521868,ECE 200,024,091026,Lo; Yu-Hwa,9999,0,9999,0
1653463521868,ECE 200,025,091027,Lomakin; Vitaliy,9999,0,9999,0
1653463521868,ECE 200,026,091028,Mercier; Patrick Philip,9999,0,9999,0
1653463521868,ECE 200,027,091029,Meyer; Florian,9999,0,9999,0
1653463521868,ECE 200,028,091030,Milstein; Laurence B.,9999,0,9999,0
1653463521868,ECE 200,029,091031,Mir Arabbaygi; Siavash,9999,0,9999,0
1653463521868,ECE 200,030,091032,Mookherjea; Shayan,9999,0,9999,0
1653463521868,ECE 200,031,091033,Morris; Karcher William,9999,0,9999,0
1653463521868,ECE 200,032,091034,Ng; Tse Nga,9999,0,9999,0
1653463521868,ECE 200,033,091035,Nguyen; Truong Quang,9999,0,9999,0
1653463521868,ECE 200,034,091036,Nomura; Kenji,9999,0,9999,0
1653463521868,ECE 200,035,091037,Orlitsky; Alon,9999,0,9999,0
1653463521868,ECE 200,036,091038,Pal; Piya,9999,0,9999,0
1653463521868,ECE 200,037,091039,Papen; George C.,9999,0,9999,0
1653463521868,ECE 200,038,091040,Radic; Stojan,9999,0,9999,0
1653463521868,ECE 200,039,091041,Rao; Bhaskar D.,9999,0,9999,0
1653463521868,ECE 200,040,091042,Rao; Ramesh R,9999,0,9999,0
1653463521868,ECE 200,041,091043,Rebeiz; Gabriel,9999,0,9999,0
1653463521868,ECE 200,042,091044,Sanford; John R,9999,0,9999,0
1653463521868,ECE 200,043,091045,Siegel; Paul H.,9999,0,9999,0
1653463521868,ECE 200,044,091046,Sievenpiper; Daniel F.,9999,0,9999,0
1653463521868,ECE 200,045,091047,Sworder; David D.,9999,0,9999,0
1653463521868,ECE 200,046,091048,Taur; Yuan,9999,0,9999,0
1653463521868,ECE 200,047,091049,Touri; Behrouz,9999,0,9999,0
1653463521868,ECE 200,048,091050,Trivedi; Mohan M.,9999,0,9999,0
1653463521868,ECE 200,049,091051,Vardy; Alexander,9999,0,9999,0
1653463521868,ECE 200,050,091052,Vasconcelos; Nuno,9999,0,9999,0
1653463521868,ECE 200,051,091053,Wang; Xiaolong,9999,0,9999,0
1653463521868,ECE 200,052,091054,Xie; Pengtao,9999,0,9999,0
1653463521868,ECE 200,053,091055,Yip; Michael,9999,0,9999,0
1653463521868,ECE 200,054,091056,Zeger; Kenneth A.,9999,0,9999,0
1653463521868,ECE 200,055,091057,Zhang; Xinyu,9999,0,9999,0
1653463521868,ECE 200,056,091058,Turakhia; Yatish Girish,9999,0,9999,0
1653463521868,ECE 200,057,091059,Kang; Mingu,9999,0,9999,0
1653463521868,ECE 200,058,091060,Shi; Yuanyuan,9999,0,9999,0
1653463521868,ECE 200,059,091061,Wang; Edward Jay,9999,0,9999,0
1653463521868,ECE 200,060,091062,Zheng; Yang,9999,0,9999,0
1653463522394,ECE 203,A00,091065,Mercier; Patrick Philip,0,0,0,0
1653463522925,ECE 207A,A00,091605,Liu; Thomas Tao-Ming,0,0,0,0
1653463523459,ECE 212AN,A00,091068,Nomura; Kenji,0,0,0,0
1653463523982,ECE 222A,A00,091069,Rebeiz; Gabriel,0,0,0,0
1653463524505,ECE 225A,A00,091070,Orlitsky; Alon,0,0,0,0
1653463525028,ECE 230A,A00,091071,Nomura; Kenji,0,0,0,0
1653463525555,ECE 236A,A00,091072,Dayeh; Shadi Ahmad,0,0,0,0
1653463526080,ECE 238A,A00,091073,Luo; Jian,0,0,0,0
1653463526080,ECE 238A,B00,091074,Luo; Jian,0,0,0,0
1653463526603,ECE 240A,A00,091075,Radic; Stojan,0,0,0,0
1653463527130,ECE 247A,A00,091592,Shi; Lingyan,0,0,0,0
1653463527654,ECE 250,A00,091076,Touri; Behrouz,0,0,0,0
1653463528176,ECE 251C,A00,091078,Nguyen; Truong Quang,0,0,0,0
1653463528701,ECE 253,A00,091079,Cosman; Pamela C.,0,0,0,0
1653463529230,ECE 255A,A00,091080,Orlitsky; Alon,0,0,0,0
1653463529754,ECE 257A,A00,091081,Zhang; Xinyu,0,0,0,0
1653463530284,ECE 260A,A01,091084,Eldon; John,0,0,0,0
1653463530812,ECE 264C,A00,091085,Galton; Ian A,0,0,0,0
1653463531347,ECE 265C,A00,094889,Presti; Calogero Davide,0,0,0,9
1653463531873,ECE 266,A01,091087,Hall; Drew A.,0,0,0,0
1653463532921,ECE 271A,A00,091090,Vasconcelos; Nuno,0,0,0,0
1653463533444,ECE 272B,A00,091091,Sworder; David D.,0,0,0,0
1653463533977,ECE 275A,A00,091092,Meyer; Florian,0,0,0,0
1653463534574,ECE 277,A00,091093,An; Cheolhong,0,0,0,0
1653463535102,ECE 283,A00,091094,Le; Hanh-Phuc,0,0,0,0
1653463535632,ECE 284,A00,091095,Kang; Mingu,0,0,0,0
1653463535632,ECE 284,B00,091096,Wang; Edward Jay,0,0,0,0
1653463536157,ECE 285,A00,094334,Touri; Behrouz,0,0,0,0
1653463536683,ECE 289,A00,091097,Whelan; David Arthur,0,0,0,0
1653463537208,MATH 200A,A00,087414,Salehi Golsefidy; Alireza,7,0,8,1
1653463537741,MATH 202A,A00,087415,Gill; Philip E.,3,0,8,5
1653463538270,MATH 203A,A00,087416,Oprea; Dragos N.,6,0,8,2
1653463538794,MATH 204A,A00,087417,Kedlaya; Kiran S.,6,0,8,2
1653463539317,MATH 205,A00,087418,Sorensen; Claus M,6,0,8,2
1653463539840,MATH 206A,A00,087419,Izadi; Elham,7,0,8,1
1653463540363,MATH 207A,A00,087420,Mohammadi; Amir,6,0,8,2
1653463540887,MATH 208,A00,087421,Staff,9,0,10,1
1653463541409,MATH 209,A00,087422,Staff,10,0,10,0
1653463541932,MATH 218,A00,087423,Staff,10,0,10,0
1653463542453,MATH 220A,A00,087424,Novak; Jonathan I,7,0,8,1
1653463542976,MATH 231A,A00,087425,Bejenaru; Ioan,3,0,8,5
1653463543500,MATH 240A,A00,087426,Ebenfelt; Peter F,5,0,8,3
1653463544023,MATH 243,A00,087427,Staff,9,0,10,1
1653463544549,MATH 248,A00,087429,Staff,10,0,10,0
1653463545076,MATH 250A,A00,087430,Spolaor; Luca,4,0,8,4
1653463545599,MATH 257A,A00,087431,Spolaor; Luca,7,0,8,1
1653463546125,MATH 258,A00,087432,Staff,9,0,10,1
1653463546652,MATH 264A,A00,087433,Warnke; Lutz Peter,5,0,8,3
1653463547200,MATH 268,A00,087434,Staff,15,0,15,0
1653463547725,MATH 269,A00,087435,Staff,14,0,15,1
1653463548251,MATH 270A,A00,087436,Nie; Jiawang,0,0,8,8
1653463548776,MATH 272A,A00,087437,Tian; Xiaochuan,1,0,8,7
1653463549299,MATH 274,A01,087439,Cheng; Li-Tien,9,0,10,1
1653463549299,MATH 274,A02,087440,Cheng; Li-Tien,10,0,10,0
1653463549831,MATH 278A,A00,087441,Staff,8,0,10,2
1653463550359,MATH 278B,A00,087442,Staff,8,0,10,2
1653463550890,MATH 278C,A00,087443,Staff,8,0,10,2
1653463551413,MATH 280A,A00,087444,Zheng; Tianyi,0,0,8,8
1653463551935,MATH 281A,A00,087445,Bradic; Jelena,0,0,8,8
1653463552458,MATH 282A,A00,087446,Zhang; Danna,0,0,8,8
1653463552981,MATH 283,A00,087447,Tesler; Glenn,0,0,0,14
1653463553503,MATH 286,A00,087448,Kemp; Todd Aahron,5,0,8,3
1653463554034,MATH 287D,A00,087449,Bradic; Jelena,8,0,8,0
1653463554556,MATH 288,A00,087450,Staff,14,0,15,1
1653463554556,MATH 288,B00,087451,Staff,15,0,15,0
1653463554556,MATH 288,C00,087452,Staff,15,0,15,0
1653463555092,MATH 290A,A00,087453,Xu; Zhouli,7,0,8,1
1653463555618,MATH 291A,A00,087454,Xu; Zhouli,7,0,8,1
1653463556141,MATH 292,A00,087455,Staff,10,0,10,0
1653463556663,MATH 295,A00,087456,Staff,50,0,50,0
1653463557189,MATH 297,001,087457,Staff,998,0,999,1
1653464127830,COGS 200,A01,087991,Staff,47,0,50,3
1653464128354,COGS 201,A01,094504,Rangel; Lara M,17,0,25,8
1653464128878,COGS 203,A00,087992,Coulson; Seana M,18,0,20,2
1653464129404,COGS 210A,001,087993,Greene; Deanna Jacquelyn,9998,0,9999,1
1653464129404,COGS 210A,002,087994,Saygin; Ayse P,9999,0,9999,0
1653464129404,COGS 210A,003,087995,Xia; Haijun,9999,0,9999,0
1653464129404,COGS 210A,004,087996,Nitz; Douglas A.,9999,0,9999,0
1653464129404,COGS 210A,005,087997,Hollan; James D.,9999,0,9999,0
1653464129404,COGS 210A,006,087998,Deak; Gedeon O.,9998,0,9999,1
1653464129404,COGS 210A,007,087999,Rossano; Federico,9999,0,9999,0
1653464129929,COGS 211A,A00,088000,Coulson; Seana M,9997,0,9999,2
1653464130453,COGS 229,A00,088002,Staff,23,0,25,2
1653464130977,COGS 260,B00,094231,Staff,17,0,20,3
1653464130977,COGS 260,A00,088004,Nitz; Douglas A.,9998,0,9999,1
1653464131503,CSE 202,A00,090110,Paturi; Ramamohan,0,0,0,0
1653464131503,CSE 202,B00,090111,Paturi; Ramamohan,0,0,0,0
1653464132026,CSE 207B,A00,090112,Heninger; Nadia A,0,0,0,0
1653464132627,CSE 208,A00,094858,Micciancio; Daniele,0,0,0,0
1653464133157,CSE 210,A00,090113,Powell; Thomas Allan,0,0,0,0
1653464133681,CSE 219,A00,090898,Staff,0,0,0,0
1653464134205,CSE 221,A00,090114,Zhou; Yuan-Yuan,0,0,0,0
1653464134727,CSE 229A,A00,090115,Porter; George M,0,0,0,0
1653464135259,CSE 229C,A00,090116,Savage; Stefan,0,0,0,0
1653464135788,CSE 230,A00,090117,Jhala; Ranjit,0,0,0,0
1653464136315,CSE 232,A00,090118,Papakonstantinou; Yannis,0,0,0,0
1653464136844,CSE 239A,A00,090121,Kumar; Arun Kumar,0,0,0,0
1653464137371,CSE 239B,A00,090122,Jhala; Ranjit,0,0,0,0
1653464137894,CSE 240A,A00,090123,Zhao; Jishen,0,0,189,189
1653464138424,CSE 243A,A00,090124,Orailoglu; Alex,1,0,15,14
1653464138948,CSE 249B,A00,090125,Kahng; Andrew Byun,13,0,20,7
1653464139476,CSE 250A,A00,090126,Berg-Kirkpatrick; Taylor D,0,0,0,0
1653464140004,CSE 252A,A00,090127,Ochoa; Benjamin Lawrence,0,0,0,0
1653464140527,CSE 258,A01,090129,McAuley; Julian John,0,0,0,0
1653464141052,CSE 258R,A01,090131,McAuley; Julian John,0,0,0,0
1653464141576,CSE 274,A00,090132,Ramamoorthi; Ravi,0,0,0,0
1653464142118,CSE 276A,A00,090133,Christensen; Henrik I,0,0,0,0
1653464142657,CSE 276C,A00,090134,Christensen; Henrik I,0,0,0,0
1653464143200,CSE 290,A00,090135,Bafna; Vineet,0,0,0,0
1653464143200,CSE 290,B00,090136,Ramamoorthi; Ravi,0,0,0,0
1653464143200,CSE 290,C00,090137,Li; Tzumao,9,0,10,1
1653464143200,CSE 290,D00,090138,Zhou; Yuan-Yuan,10,0,10,0
1653464143200,CSE 290,E00,090139,Christensen; Henrik I,10,0,10,0
1653464143200,CSE 290,F00,094053,Shalev; Aaron D,0,0,0,0
1653464143734,CSE 291,A00,090140,Munyaka; Imani N. S.,0,0,0,0
1653464143734,CSE 291,B00,094880,Yu; Qi,0,0,0,0
1653464143734,CSE 291,C00,090142,Pannuto; Patrick William,0,0,0,0
1653464143734,CSE 291,D00,094881,Zhang; Yiying,0,0,0,0
1653464143734,CSE 291,E00,095118,Su; Hao,0,0,0,0
1653464144273,CSE 293,001,094905,Bafna; Vineet,9999,0,9999,0
1653464144273,CSE 293,002,094906,Bellare; Mihir,9999,0,9999,0
1653464144273,CSE 293,003,094907,Berg-Kirkpatrick; Taylor D,9999,0,9999,0
1653464144273,CSE 293,004,094908,Christensen; Henrik I,9999,0,9999,0
1653464144273,CSE 293,005,094909,Cottrell; Garrison W,9999,0,9999,0
1653464144273,CSE 293,006,094910,Deutsch; Alin Bernard,9999,0,9999,0
1653464144273,CSE 293,007,094911,Esmaeilzadeh; Hadi,9999,0,9999,0
1653464144273,CSE 293,008,094912,Freund; Yoav,9999,0,9999,0
1653464144273,CSE 293,009,094913,Griswold; William G.,9999,0,9999,0
1653464144273,CSE 293,010,094914,Gymrek; Melissa Ann,9999,0,9999,0
1653464144273,CSE 293,011,094915,Heninger; Nadia A,9999,0,9999,0
1653464144273,CSE 293,012,094916,Impagliazzo; Russell,9999,0,9999,0
1653464144273,CSE 293,013,094917,Jhala; Ranjit,9999,0,9999,0
1653464144273,CSE 293,014,094918,Kahng; Andrew Byun,9999,0,9999,0
1653464144273,CSE 293,015,094919,Kane; Daniel Mertz,9999,0,9999,0
1653464144273,CSE 293,016,094920,Kriegman; David J,9999,0,9999,0
1653464144273,CSE 293,017,094921,Kumar; Arun Kumar,9999,0,9999,0
1653464144273,CSE 293,018,094922,Lerner; Sorin,9999,0,9999,0
1653464144273,CSE 293,019,094923,Lovett; Shachar,9999,0,9999,0
1653464144273,CSE 293,020,094924,McAuley; Julian John,9999,0,9999,0
1653464144273,CSE 293,021,094925,Micciancio; Daniele,9999,0,9999,0
1653464144273,CSE 293,022,094926,Orailoglu; Alex,9999,0,9999,0
1653464144273,CSE 293,023,094927,Paturi; Ramamohan,9999,0,9999,0
1653464144273,CSE 293,024,094928,Polikarpova; Nadezhda,9999,0,9999,0
1653464144273,CSE 293,025,094929,Politz; Joseph Gibbs,9999,0,9999,0
1653464144273,CSE 293,026,094930,Porter; George M,9999,0,9999,0
1653464144273,CSE 293,027,094931,Porter; Leonard Emerson,9999,0,9999,0
1653464144273,CSE 293,028,094932,Ramamoorthi; Ravi,9999,0,9999,0
1653464144273,CSE 293,029,094933,Sahoo; Debashis,9999,0,9999,0
1653464144273,CSE 293,030,094934,Saul; Lawrence,9999,0,9999,0
1653464144273,CSE 293,031,094935,Savage; Stefan,9999,0,9999,0
1653464144273,CSE 293,032,094936,Schulze; Jurgen P.,9999,0,9999,0
1653464144273,CSE 293,033,094937,Snoeren; Alex C.,9999,0,9999,0
1653464144273,CSE 293,034,094938,Shang; Jingbo,9999,0,9999,0
1653464144273,CSE 293,035,094939,Stefan; Deian,9999,0,9999,0
1653464144273,CSE 293,036,094940,Su; Hao,9999,0,9999,0
1653464144273,CSE 293,037,094941,Swanson; Steven James,9999,0,9999,0
1653464144273,CSE 293,038,094942,Tullsen; Dean Michael,9999,0,9999,0
1653464144273,CSE 293,039,094943,Voelker; Geoffrey M.,9999,0,9999,0
1653464144273,CSE 293,040,094944,Zhao; Jishen,9999,0,9999,0
1653464144273,CSE 293,041,094945,Zhou; Yuan-Yuan,9999,0,9999,0
1653464144273,CSE 293,042,094946,Gao; Sicun,9998,0,9999,1
1653464144273,CSE 293,043,094947,Weibel; Nadir,9999,0,9999,0
1653464144273,CSE 293,044,094948,Gupta; Rajesh K.,9999,0,9999,0
1653464144796,CSE 294,A00,090143,Porter; George M,9,0,10,1
1653464145321,DSE 200,A00,091799,Staff,50,0,50,0
1653464145856,DSE 203,A00,091800,Gupta; Amarnath,30,0,30,0
1653464146379,DSE 250,A00,091801,Deutsch; Alin Bernard,30,0,30,0
1653464146918,DSE 290,A00,091802,Altintas De Callaf; Ilkay,50,0,50,0
1653464147502,ECE 200,001,091003,Antipa; Nicholas A,9999,0,9999,0
1653464147502,ECE 200,002,091004,Atanasov; Nikolay A.,9999,0,9999,0
1653464147502,ECE 200,003,091005,Bharadia; Dinesh,9999,0,9999,0
1653464147502,ECE 200,004,091006,Cheng; Chung Kuan,9999,0,9999,0
1653464147502,ECE 200,005,091007,Cosman; Pamela C.,9999,0,9999,0
1653464147502,ECE 200,006,091008,Staff,9999,0,9999,0
1653464147502,ECE 200,007,091009,Dayeh; Shadi Ahmad,9999,0,9999,0
1653464147502,ECE 200,008,091010,Fainman; Yeshaiahu,9999,0,9999,0
1653464147502,ECE 200,009,091011,Ford; Joseph Earl,9999,0,9999,0
1653464147502,ECE 200,010,091012,Franceschetti; Massimo,9999,0,9999,0
1653464147502,ECE 200,011,091013,Fullerton; Eric E,9999,0,9999,0
1653464147502,ECE 200,012,091014,Galton; Ian A,9999,0,9999,0
1653464147502,ECE 200,013,091015,Gilja; Vikash,9999,0,9999,0
1653464147502,ECE 200,014,091016,Hall; Drew A.,9999,0,9999,0
1653464147502,ECE 200,015,091017,Hsueh; Tzu-Chien,9999,0,9999,0
1653464147502,ECE 200,016,091018,Javidi; Tara,9999,0,9999,0
1653464147502,ECE 200,017,091019,Kahng; Andrew Byun,9999,0,9999,0
1653464147502,ECE 200,018,091020,Kim; Young-Han,9999,0,9999,0
1653464147502,ECE 200,019,091021,Koushanfar; Farinaz,9999,0,9999,0
1653464147502,ECE 200,020,091022,Kuzum; Duygu,9999,0,9999,0
1653464147502,ECE 200,021,091023,Le; Hanh-Phuc,9999,0,9999,0
1653464147502,ECE 200,022,091024,Lin; Bill,9999,0,9999,0
1653464147502,ECE 200,023,091025,Liu; Zhaowei,9999,0,9999,0
1653464147502,ECE 200,024,091026,Lo; Yu-Hwa,9999,0,9999,0
1653464147502,ECE 200,025,091027,Lomakin; Vitaliy,9999,0,9999,0
1653464147502,ECE 200,026,091028,Mercier; Patrick Philip,9999,0,9999,0
1653464147502,ECE 200,027,091029,Meyer; Florian,9999,0,9999,0
1653464147502,ECE 200,028,091030,Milstein; Laurence B.,9999,0,9999,0
1653464147502,ECE 200,029,091031,Mir Arabbaygi; Siavash,9999,0,9999,0
1653464147502,ECE 200,030,091032,Mookherjea; Shayan,9999,0,9999,0
1653464147502,ECE 200,031,091033,Morris; Karcher William,9999,0,9999,0
1653464147502,ECE 200,032,091034,Ng; Tse Nga,9999,0,9999,0
1653464147502,ECE 200,033,091035,Nguyen; Truong Quang,9999,0,9999,0
1653464147502,ECE 200,034,091036,Nomura; Kenji,9999,0,9999,0
1653464147502,ECE 200,035,091037,Orlitsky; Alon,9999,0,9999,0
1653464147502,ECE 200,036,091038,Pal; Piya,9999,0,9999,0
1653464147502,ECE 200,037,091039,Papen; George C.,9999,0,9999,0
1653464147502,ECE 200,038,091040,Radic; Stojan,9999,0,9999,0
1653464147502,ECE 200,039,091041,Rao; Bhaskar D.,9999,0,9999,0
1653464147502,ECE 200,040,091042,Rao; Ramesh R,9999,0,9999,0
1653464147502,ECE 200,041,091043,Rebeiz; Gabriel,9999,0,9999,0
1653464147502,ECE 200,042,091044,Sanford; John R,9999,0,9999,0
1653464147502,ECE 200,043,091045,Siegel; Paul H.,9999,0,9999,0
1653464147502,ECE 200,044,091046,Sievenpiper; Daniel F.,9999,0,9999,0
1653464147502,ECE 200,045,091047,Sworder; David D.,9999,0,9999,0
1653464147502,ECE 200,046,091048,Taur; Yuan,9999,0,9999,0
1653464147502,ECE 200,047,091049,Touri; Behrouz,9999,0,9999,0
1653464147502,ECE 200,048,091050,Trivedi; Mohan M.,9999,0,9999,0
1653464147502,ECE 200,049,091051,Vardy; Alexander,9999,0,9999,0
1653464147502,ECE 200,050,091052,Vasconcelos; Nuno,9999,0,9999,0
1653464147502,ECE 200,051,091053,Wang; Xiaolong,9999,0,9999,0
1653464147502,ECE 200,052,091054,Xie; Pengtao,9999,0,9999,0
1653464147502,ECE 200,053,091055,Yip; Michael,9999,0,9999,0
1653464147502,ECE 200,054,091056,Zeger; Kenneth A.,9999,0,9999,0
1653464147502,ECE 200,055,091057,Zhang; Xinyu,9999,0,9999,0
1653464147502,ECE 200,056,091058,Turakhia; Yatish Girish,9999,0,9999,0
1653464147502,ECE 200,057,091059,Kang; Mingu,9999,0,9999,0
1653464147502,ECE 200,058,091060,Shi; Yuanyuan,9999,0,9999,0
1653464147502,ECE 200,059,091061,Wang; Edward Jay,9999,0,9999,0
1653464147502,ECE 200,060,091062,Zheng; Yang,9999,0,9999,0
1653464148026,ECE 203,A00,091065,Mercier; Patrick Philip,0,0,0,0
1653464148550,ECE 207A,A00,091605,Liu; Thomas Tao-Ming,0,0,0,0
1653464149079,ECE 212AN,A00,091068,Nomura; Kenji,0,0,0,0
1653464149603,ECE 222A,A00,091069,Rebeiz; Gabriel,0,0,0,0
1653464150129,ECE 225A,A00,091070,Orlitsky; Alon,0,0,0,0
1653464150653,ECE 230A,A00,091071,Nomura; Kenji,0,0,0,0
1653464151182,ECE 236A,A00,091072,Dayeh; Shadi Ahmad,0,0,0,0
1653464151719,ECE 238A,A00,091073,Luo; Jian,0,0,0,0
1653464151719,ECE 238A,B00,091074,Luo; Jian,0,0,0,0
1653464152246,ECE 240A,A00,091075,Radic; Stojan,0,0,0,0
1653464152783,ECE 247A,A00,091592,Shi; Lingyan,0,0,0,0
1653464153311,ECE 250,A00,091076,Touri; Behrouz,0,0,0,0
1653464153842,ECE 251C,A00,091078,Nguyen; Truong Quang,0,0,0,0
1653464154374,ECE 253,A00,091079,Cosman; Pamela C.,0,0,0,0
1653464154901,ECE 255A,A00,091080,Orlitsky; Alon,0,0,0,0
1653464155424,ECE 257A,A00,091081,Zhang; Xinyu,0,0,0,0
1653464155956,ECE 260A,A01,091084,Eldon; John,0,0,0,0
1653464156484,ECE 264C,A00,091085,Galton; Ian A,0,0,0,0
1653464157010,ECE 265C,A00,094889,Presti; Calogero Davide,0,0,0,9
1653464157541,ECE 266,A01,091087,Hall; Drew A.,0,0,0,0
1653464158601,ECE 271A,A00,091090,Vasconcelos; Nuno,0,0,0,0
1653464159130,ECE 272B,A00,091091,Sworder; David D.,0,0,0,0
1653464159663,ECE 275A,A00,091092,Meyer; Florian,0,0,0,0
1653464160197,ECE 277,A00,091093,An; Cheolhong,0,0,0,0
1653464160725,ECE 283,A00,091094,Le; Hanh-Phuc,0,0,0,0
1653464161252,ECE 284,A00,091095,Kang; Mingu,0,0,0,0
1653464161252,ECE 284,B00,091096,Wang; Edward Jay,0,0,0,0
1653464161775,ECE 285,A00,094334,Touri; Behrouz,0,0,0,0
1653464162307,ECE 289,A00,091097,Whelan; David Arthur,0,0,0,0
1653464162838,MATH 200A,A00,087414,Salehi Golsefidy; Alireza,7,0,8,1
1653464163362,MATH 202A,A00,087415,Gill; Philip E.,3,0,8,5
1653464163912,MATH 203A,A00,087416,Oprea; Dragos N.,6,0,8,2
1653464164447,MATH 204A,A00,087417,Kedlaya; Kiran S.,6,0,8,2
1653464164979,MATH 205,A00,087418,Sorensen; Claus M,6,0,8,2
1653464165502,MATH 206A,A00,087419,Izadi; Elham,7,0,8,1
1653464166024,MATH 207A,A00,087420,Mohammadi; Amir,6,0,8,2
1653464166547,MATH 208,A00,087421,Staff,9,0,10,1
1653464167071,MATH 209,A00,087422,Staff,10,0,10,0
1653464167594,MATH 218,A00,087423,Staff,10,0,10,0
1653464168118,MATH 220A,A00,087424,Novak; Jonathan I,7,0,8,1
1653464168641,MATH 231A,A00,087425,Bejenaru; Ioan,3,0,8,5
1653464169174,MATH 240A,A00,087426,Ebenfelt; Peter F,5,0,8,3
1653464169712,MATH 243,A00,087427,Staff,9,0,10,1
1653464170236,MATH 248,A00,087429,Staff,10,0,10,0
1653464170759,MATH 250A,A00,087430,Spolaor; Luca,4,0,8,4
1653464171286,MATH 257A,A00,087431,Spolaor; Luca,7,0,8,1
1653464171818,MATH 258,A00,087432,Staff,9,0,10,1
1653464172358,MATH 264A,A00,087433,Warnke; Lutz Peter,5,0,8,3
1653464172883,MATH 268,A00,087434,Staff,15,0,15,0
1653464173408,MATH 269,A00,087435,Staff,14,0,15,1
1653464173935,MATH 270A,A00,087436,Nie; Jiawang,0,0,8,8
1653464174473,MATH 272A,A00,087437,Tian; Xiaochuan,1,0,8,7
1653464175002,MATH 274,A01,087439,Cheng; Li-Tien,9,0,10,1
1653464175002,MATH 274,A02,087440,Cheng; Li-Tien,10,0,10,0
1653464175526,MATH 278A,A00,087441,Staff,8,0,10,2
1653464176047,MATH 278B,A00,087442,Staff,8,0,10,2
1653464176570,MATH 278C,A00,087443,Staff,8,0,10,2
1653464177106,MATH 280A,A00,087444,Zheng; Tianyi,0,0,8,8
1653464177634,MATH 281A,A00,087445,Bradic; Jelena,0,0,8,8
1653464178161,MATH 282A,A00,087446,Zhang; Danna,0,0,8,8
1653464178685,MATH 283,A00,087447,Tesler; Glenn,0,0,0,14
1653464179212,MATH 286,A00,087448,Kemp; Todd Aahron,5,0,8,3
1653464179737,MATH 287D,A00,087449,Bradic; Jelena,8,0,8,0
1653464180263,MATH 288,A00,087450,Staff,14,0,15,1
1653464180263,MATH 288,B00,087451,Staff,15,0,15,0
1653464180263,MATH 288,C00,087452,Staff,15,0,15,0
1653464180785,MATH 290A,A00,087453,Xu; Zhouli,7,0,8,1
1653464181314,MATH 291A,A00,087454,Xu; Zhouli,7,0,8,1
1653464181837,MATH 292,A00,087455,Staff,10,0,10,0
1653464182364,MATH 295,A00,087456,Staff,50,0,50,0
1653464182889,MATH 297,001,087457,Staff,998,0,999,1
1653464744996,COGS 200,A01,087991,Staff,47,0,50,3
1653464745519,COGS 201,A01,094504,Rangel; Lara M,17,0,25,8
1653464746043,COGS 203,A00,087992,Coulson; Seana M,18,0,20,2
1653464746570,COGS 210A,001,087993,Greene; Deanna Jacquelyn,9998,0,9999,1
1653464746570,COGS 210A,002,087994,Saygin; Ayse P,9999,0,9999,0
1653464746570,COGS 210A,003,087995,Xia; Haijun,9999,0,9999,0
1653464746570,COGS 210A,004,087996,Nitz; Douglas A.,9999,0,9999,0
1653464746570,COGS 210A,005,087997,Hollan; James D.,9999,0,9999,0
1653464746570,COGS 210A,006,087998,Deak; Gedeon O.,9998,0,9999,1
1653464746570,COGS 210A,007,087999,Rossano; Federico,9999,0,9999,0
1653464747093,COGS 211A,A00,088000,Coulson; Seana M,9997,0,9999,2
1653464747616,COGS 229,A00,088002,Staff,23,0,25,2
1653464748147,COGS 260,B00,094231,Staff,17,0,20,3
1653464748147,COGS 260,A00,088004,Nitz; Douglas A.,9998,0,9999,1
1653464748672,CSE 202,A00,090110,Paturi; Ramamohan,0,0,0,0
1653464748672,CSE 202,B00,090111,Paturi; Ramamohan,0,0,0,0
1653464749197,CSE 207B,A00,090112,Heninger; Nadia A,0,0,0,0
1653464749725,CSE 208,A00,094858,Micciancio; Daniele,0,0,0,0
1653464750251,CSE 210,A00,090113,Powell; Thomas Allan,0,0,0,0
1653464750778,CSE 219,A00,090898,Staff,0,0,0,0
1653464751303,CSE 221,A00,090114,Zhou; Yuan-Yuan,0,0,0,0
1653464751832,CSE 229A,A00,090115,Porter; George M,0,0,0,0
1653464752356,CSE 229C,A00,090116,Savage; Stefan,0,0,0,0
1653464752883,CSE 230,A00,090117,Jhala; Ranjit,0,0,0,0
1653464753404,CSE 232,A00,090118,Papakonstantinou; Yannis,0,0,0,0
1653464753930,CSE 239A,A00,090121,Kumar; Arun Kumar,0,0,0,0
1653464754452,CSE 239B,A00,090122,Jhala; Ranjit,0,0,0,0
1653464754979,CSE 240A,A00,090123,Zhao; Jishen,0,0,189,189
1653464755503,CSE 243A,A00,090124,Orailoglu; Alex,1,0,15,14
1653464756031,CSE 249B,A00,090125,Kahng; Andrew Byun,13,0,20,7
1653464756555,CSE 250A,A00,090126,Berg-Kirkpatrick; Taylor D,0,0,0,0
1653464757083,CSE 252A,A00,090127,Ochoa; Benjamin Lawrence,0,0,0,0
1653464757610,CSE 258,A01,090129,McAuley; Julian John,0,0,0,0
1653464758135,CSE 258R,A01,090131,McAuley; Julian John,0,0,0,0
1653464758659,CSE 274,A00,090132,Ramamoorthi; Ravi,0,0,0,0
1653464759186,CSE 276A,A00,090133,Christensen; Henrik I,0,0,0,0
1653464759711,CSE 276C,A00,090134,Christensen; Henrik I,0,0,0,0
1653464760236,CSE 290,A00,090135,Bafna; Vineet,0,0,0,0
1653464760236,CSE 290,B00,090136,Ramamoorthi; Ravi,0,0,0,0
1653464760236,CSE 290,C00,090137,Li; Tzumao,9,0,10,1
1653464760236,CSE 290,D00,090138,Zhou; Yuan-Yuan,10,0,10,0
1653464760236,CSE 290,E00,090139,Christensen; Henrik I,10,0,10,0
1653464760236,CSE 290,F00,094053,Shalev; Aaron D,0,0,0,0
1653464760783,CSE 291,A00,090140,Munyaka; Imani N. S.,0,0,0,0
1653464760783,CSE 291,B00,094880,Yu; Qi,0,0,0,0
1653464760783,CSE 291,C00,090142,Pannuto; Patrick William,0,0,0,0
1653464760783,CSE 291,D00,094881,Zhang; Yiying,0,0,0,0
1653464760783,CSE 291,E00,095118,Su; Hao,0,0,0,0
1653464761320,CSE 293,001,094905,Bafna; Vineet,9999,0,9999,0
1653464761320,CSE 293,002,094906,Bellare; Mihir,9999,0,9999,0
1653464761320,CSE 293,003,094907,Berg-Kirkpatrick; Taylor D,9999,0,9999,0
1653464761320,CSE 293,004,094908,Christensen; Henrik I,9999,0,9999,0
1653464761320,CSE 293,005,094909,Cottrell; Garrison W,9999,0,9999,0
1653464761320,CSE 293,006,094910,Deutsch; Alin Bernard,9999,0,9999,0
1653464761320,CSE 293,007,094911,Esmaeilzadeh; Hadi,9999,0,9999,0
1653464761320,CSE 293,008,094912,Freund; Yoav,9999,0,9999,0
1653464761320,CSE 293,009,094913,Griswold; William G.,9999,0,9999,0
1653464761320,CSE 293,010,094914,Gymrek; Melissa Ann,9999,0,9999,0
1653464761320,CSE 293,011,094915,Heninger; Nadia A,9999,0,9999,0
1653464761320,CSE 293,012,094916,Impagliazzo; Russell,9999,0,9999,0
1653464761320,CSE 293,013,094917,Jhala; Ranjit,9999,0,9999,0
1653464761320,CSE 293,014,094918,Kahng; Andrew Byun,9999,0,9999,0
1653464761320,CSE 293,015,094919,Kane; Daniel Mertz,9999,0,9999,0
1653464761320,CSE 293,016,094920,Kriegman; David J,9999,0,9999,0
1653464761320,CSE 293,017,094921,Kumar; Arun Kumar,9999,0,9999,0
1653464761320,CSE 293,018,094922,Lerner; Sorin,9999,0,9999,0
1653464761320,CSE 293,019,094923,Lovett; Shachar,9999,0,9999,0
1653464761320,CSE 293,020,094924,McAuley; Julian John,9999,0,9999,0
1653464761320,CSE 293,021,094925,Micciancio; Daniele,9999,0,9999,0
1653464761320,CSE 293,022,094926,Orailoglu; Alex,9999,0,9999,0
1653464761320,CSE 293,023,094927,Paturi; Ramamohan,9999,0,9999,0
1653464761320,CSE 293,024,094928,Polikarpova; Nadezhda,9999,0,9999,0
1653464761320,CSE 293,025,094929,Politz; Joseph Gibbs,9999,0,9999,0
1653464761320,CSE 293,026,094930,Porter; George M,9999,0,9999,0
1653464761320,CSE 293,027,094931,Porter; Leonard Emerson,9999,0,9999,0
1653464761320,CSE 293,028,094932,Ramamoorthi; Ravi,9999,0,9999,0
1653464761320,CSE 293,029,094933,Sahoo; Debashis,9999,0,9999,0
1653464761320,CSE 293,030,094934,Saul; Lawrence,9999,0,9999,0
1653464761320,CSE 293,031,094935,Savage; Stefan,9999,0,9999,0
1653464761320,CSE 293,032,094936,Schulze; Jurgen P.,9999,0,9999,0
1653464761320,CSE 293,033,094937,Snoeren; Alex C.,9999,0,9999,0
1653464761320,CSE 293,034,094938,Shang; Jingbo,9999,0,9999,0
1653464761320,CSE 293,035,094939,Stefan; Deian,9999,0,9999,0
1653464761320,CSE 293,036,094940,Su; Hao,9999,0,9999,0
1653464761320,CSE 293,037,094941,Swanson; Steven James,9999,0,9999,0
1653464761320,CSE 293,038,094942,Tullsen; Dean Michael,9999,0,9999,0
1653464761320,CSE 293,039,094943,Voelker; Geoffrey M.,9999,0,9999,0
1653464761320,CSE 293,040,094944,Zhao; Jishen,9999,0,9999,0
1653464761320,CSE 293,041,094945,Zhou; Yuan-Yuan,9999,0,9999,0
1653464761320,CSE 293,042,094946,Gao; Sicun,9998,0,9999,1
1653464761320,CSE 293,043,094947,Weibel; Nadir,9999,0,9999,0
1653464761320,CSE 293,044,094948,Gupta; Rajesh K.,9999,0,9999,0
1653464761845,CSE 294,A00,090143,Porter; George M,9,0,10,1
1653464762372,DSE 200,A00,091799,Staff,50,0,50,0
1653464762896,DSE 203,A00,091800,Gupta; Amarnath,30,0,30,0
1653464763418,DSE 250,A00,091801,Deutsch; Alin Bernard,30,0,30,0
1653464763944,DSE 290,A00,091802,Altintas De Callaf; Ilkay,50,0,50,0
1653464764526,ECE 200,001,091003,Antipa; Nicholas A,9999,0,9999,0
1653464764526,ECE 200,002,091004,Atanasov; Nikolay A.,9999,0,9999,0
1653464764526,ECE 200,003,091005,Bharadia; Dinesh,9999,0,9999,0
1653464764526,ECE 200,004,091006,Cheng; Chung Kuan,9999,0,9999,0
1653464764526,ECE 200,005,091007,Cosman; Pamela C.,9999,0,9999,0
1653464764526,ECE 200,006,091008,Staff,9999,0,9999,0
1653464764526,ECE 200,007,091009,Dayeh; Shadi Ahmad,9999,0,9999,0
1653464764526,ECE 200,008,091010,Fainman; Yeshaiahu,9999,0,9999,0
1653464764526,ECE 200,009,091011,Ford; Joseph Earl,9999,0,9999,0
1653464764526,ECE 200,010,091012,Franceschetti; Massimo,9999,0,9999,0
1653464764526,ECE 200,011,091013,Fullerton; Eric E,9999,0,9999,0
1653464764526,ECE 200,012,091014,Galton; Ian A,9999,0,9999,0
1653464764526,ECE 200,013,091015,Gilja; Vikash,9999,0,9999,0
1653464764526,ECE 200,014,091016,Hall; Drew A.,9999,0,9999,0
1653464764526,ECE 200,015,091017,Hsueh; Tzu-Chien,9999,0,9999,0
1653464764526,ECE 200,016,091018,Javidi; Tara,9999,0,9999,0
1653464764526,ECE 200,017,091019,Kahng; Andrew Byun,9999,0,9999,0
1653464764526,ECE 200,018,091020,Kim; Young-Han,9999,0,9999,0
1653464764526,ECE 200,019,091021,Koushanfar; Farinaz,9999,0,9999,0
1653464764526,ECE 200,020,091022,Kuzum; Duygu,9999,0,9999,0
1653464764526,ECE 200,021,091023,Le; Hanh-Phuc,9999,0,9999,0
1653464764526,ECE 200,022,091024,Lin; Bill,9999,0,9999,0
1653464764526,ECE 200,023,091025,Liu; Zhaowei,9999,0,9999,0
1653464764526,ECE 200,024,091026,Lo; Yu-Hwa,9999,0,9999,0
1653464764526,ECE 200,025,091027,Lomakin; Vitaliy,9999,0,9999,0
1653464764526,ECE 200,026,091028,Mercier; Patrick Philip,9999,0,9999,0
1653464764526,ECE 200,027,091029,Meyer; Florian,9999,0,9999,0
1653464764526,ECE 200,028,091030,Milstein; Laurence B.,9999,0,9999,0
1653464764526,ECE 200,029,091031,Mir Arabbaygi; Siavash,9999,0,9999,0
1653464764526,ECE 200,030,091032,Mookherjea; Shayan,9999,0,9999,0
1653464764526,ECE 200,031,091033,Morris; Karcher William,9999,0,9999,0
1653464764526,ECE 200,032,091034,Ng; Tse Nga,9999,0,9999,0
1653464764526,ECE 200,033,091035,Nguyen; Truong Quang,9999,0,9999,0
1653464764526,ECE 200,034,091036,Nomura; Kenji,9999,0,9999,0
1653464764526,ECE 200,035,091037,Orlitsky; Alon,9999,0,9999,0
1653464764526,ECE 200,036,091038,Pal; Piya,9999,0,9999,0
1653464764526,ECE 200,037,091039,Papen; George C.,9999,0,9999,0
1653464764526,ECE 200,038,091040,Radic; Stojan,9999,0,9999,0
1653464764526,ECE 200,039,091041,Rao; Bhaskar D.,9999,0,9999,0
1653464764526,ECE 200,040,091042,Rao; Ramesh R,9999,0,9999,0
1653464764526,ECE 200,041,091043,Rebeiz; Gabriel,9999,0,9999,0
1653464764526,ECE 200,042,091044,Sanford; John R,9999,0,9999,0
1653464764526,ECE 200,043,091045,Siegel; Paul H.,9999,0,9999,0
1653464764526,ECE 200,044,091046,Sievenpiper; Daniel F.,9999,0,9999,0
1653464764526,ECE 200,045,091047,Sworder; David D.,9999,0,9999,0
1653464764526,ECE 200,046,091048,Taur; Yuan,9999,0,9999,0
1653464764526,ECE 200,047,091049,Touri; Behrouz,9999,0,9999,0
1653464764526,ECE 200,048,091050,Trivedi; Mohan M.,9999,0,9999,0
1653464764526,ECE 200,049,091051,Vardy; Alexander,9999,0,9999,0
1653464764526,ECE 200,050,091052,Vasconcelos; Nuno,9999,0,9999,0
1653464764526,ECE 200,051,091053,Wang; Xiaolong,9999,0,9999,0
1653464764526,ECE 200,052,091054,Xie; Pengtao,9999,0,9999,0
1653464764526,ECE 200,053,091055,Yip; Michael,9999,0,9999,0
1653464764526,ECE 200,054,091056,Zeger; Kenneth A.,9999,0,9999,0
1653464764526,ECE 200,055,091057,Zhang; Xinyu,9999,0,9999,0
1653464764526,ECE 200,056,091058,Turakhia; Yatish Girish,9999,0,9999,0
1653464764526,ECE 200,057,091059,Kang; Mingu,9999,0,9999,0
1653464764526,ECE 200,058,091060,Shi; Yuanyuan,9999,0,9999,0
1653464764526,ECE 200,059,091061,Wang; Edward Jay,9999,0,9999,0
1653464764526,ECE 200,060,091062,Zheng; Yang,9999,0,9999,0
1653464765051,ECE 203,A00,091065,Mercier; Patrick Philip,0,0,0,0
1653464765589,ECE 207A,A00,091605,Liu; Thomas Tao-Ming,0,0,0,0
1653464766119,ECE 212AN,A00,091068,Nomura; Kenji,0,0,0,0
1653464766645,ECE 222A,A00,091069,Rebeiz; Gabriel,0,0,0,0
1653464767168,ECE 225A,A00,091070,Orlitsky; Alon,0,0,0,0
1653464767697,ECE 230A,A00,091071,Nomura; Kenji,0,0,0,0
1653464768225,ECE 236A,A00,091072,Dayeh; Shadi Ahmad,0,0,0,0
1653464768757,ECE 238A,A00,091073,Luo; Jian,0,0,0,0
1653464768757,ECE 238A,B00,091074,Luo; Jian,0,0,0,0
1653464769282,ECE 240A,A00,091075,Radic; Stojan,0,0,0,0
1653464769804,ECE 247A,A00,091592,Shi; Lingyan,0,0,0,0
1653464770330,ECE 250,A00,091076,Touri; Behrouz,0,0,0,0
1653464770854,ECE 251C,A00,091078,Nguyen; Truong Quang,0,0,0,0
1653464771378,ECE 253,A00,091079,Cosman; Pamela C.,0,0,0,0
1653464771901,ECE 255A,A00,091080,Orlitsky; Alon,0,0,0,0
1653464772432,ECE 257A,A00,091081,Zhang; Xinyu,0,0,0,0
1653464772960,ECE 260A,A01,091084,Eldon; John,0,0,0,0
1653464773489,ECE 264C,A00,091085,Galton; Ian A,0,0,0,0
1653464774021,ECE 265C,A00,094889,Presti; Calogero Davide,0,0,0,9
1653464774545,ECE 266,A01,091087,Hall; Drew A.,0,0,0,0
1653464775696,ECE 271A,A00,091090,Vasconcelos; Nuno,0,0,0,0
1653464776218,ECE 272B,A00,091091,Sworder; David D.,0,0,0,0
1653464776757,ECE 275A,A00,091092,Meyer; Florian,0,0,0,0
1653464777286,ECE 277,A00,091093,An; Cheolhong,0,0,0,0
1653464777810,ECE 283,A00,091094,Le; Hanh-Phuc,0,0,0,0
1653464778335,ECE 284,A00,091095,Kang; Mingu,0,0,0,0
1653464778335,ECE 284,B00,091096,Wang; Edward Jay,0,0,0,0
1653464778862,ECE 285,A00,094334,Touri; Behrouz,0,0,0,0
1653464779387,ECE 289,A00,091097,Whelan; David Arthur,0,0,0,0
1653464779912,MATH 200A,A00,087414,Salehi Golsefidy; Alireza,7,0,8,1
1653464780437,MATH 202A,A00,087415,Gill; Philip E.,3,0,8,5
1653464780965,MATH 203A,A00,087416,Oprea; Dragos N.,6,0,8,2
1653464781491,MATH 204A,A00,087417,Kedlaya; Kiran S.,6,0,8,2
1653464782015,MATH 205,A00,087418,Sorensen; Claus M,6,0,8,2
1653464782542,MATH 206A,A00,087419,Izadi; Elham,7,0,8,1
1653464783127,MATH 207A,A00,087420,Mohammadi; Amir,6,0,8,2
1653464783659,MATH 208,A00,087421,Staff,9,0,10,1
1653464784182,MATH 209,A00,087422,Staff,10,0,10,0
1653464784711,MATH 218,A00,087423,Staff,10,0,10,0
1653464785239,MATH 220A,A00,087424,Novak; Jonathan I,7,0,8,1
1653464785767,MATH 231A,A00,087425,Bejenaru; Ioan,3,0,8,5
1653464786290,MATH 240A,A00,087426,Ebenfelt; Peter F,5,0,8,3
1653464786817,MATH 243,A00,087427,Staff,9,0,10,1
1653464787340,MATH 248,A00,087429,Staff,10,0,10,0
1653464787864,MATH 250A,A00,087430,Spolaor; Luca,4,0,8,4
1653464788388,MATH 257A,A00,087431,Spolaor; Luca,7,0,8,1
1653464788916,MATH 258,A00,087432,Staff,9,0,10,1
1653464789439,MATH 264A,A00,087433,Warnke; Lutz Peter,5,0,8,3
1653464789965,MATH 268,A00,087434,Staff,15,0,15,0
1653464790488,MATH 269,A00,087435,Staff,14,0,15,1
1653464791013,MATH 270A,A00,087436,Nie; Jiawang,0,0,8,8
1653464791540,MATH 272A,A00,087437,Tian; Xiaochuan,1,0,8,7
1653464792066,MATH 274,A01,087439,Cheng; Li-Tien,9,0,10,1
1653464792066,MATH 274,A02,087440,Cheng; Li-Tien,10,0,10,0
1653464792589,MATH 278A,A00,087441,Staff,8,0,10,2
1653464793113,MATH 278B,A00,087442,Staff,8,0,10,2
1653464793638,MATH 278C,A00,087443,Staff,8,0,10,2
1653464794163,MATH 280A,A00,087444,Zheng; Tianyi,0,0,8,8
1653464794686,MATH 281A,A00,087445,Bradic; Jelena,0,0,8,8
1653464795210,MATH 282A,A00,087446,Zhang; Danna,0,0,8,8
1653464795735,MATH 283,A00,087447,Tesler; Glenn,0,0,0,14
1653464796257,MATH 286,A00,087448,Kemp; Todd Aahron,5,0,8,3
1653464796779,MATH 287D,A00,087449,Bradic; Jelena,8,0,8,0
1653464797303,MATH 288,A00,087450,Staff,14,0,15,1
1653464797303,MATH 288,B00,087451,Staff,15,0,15,0
1653464797303,MATH 288,C00,087452,Staff,15,0,15,0
1653464797826,MATH 290A,A00,087453,Xu; Zhouli,7,0,8,1
1653464798349,MATH 291A,A00,087454,Xu; Zhouli,7,0,8,1
1653464798873,MATH 292,A00,087455,Staff,10,0,10,0
1653464799407,MATH 295,A00,087456,Staff,50,0,50,0
1653464799931,MATH 297,001,087457,Staff,998,0,999,1
1653465360045,COGS 200,A01,087991,Staff,47,0,50,3
1653465360585,COGS 201,A01,094504,Rangel; Lara M,17,0,25,8
1653465361112,COGS 203,A00,087992,Coulson; Seana M,18,0,20,2
1653465361645,COGS 210A,001,087993,Greene; Deanna Jacquelyn,9998,0,9999,1
1653465361645,COGS 210A,002,087994,Saygin; Ayse P,9999,0,9999,0
1653465361645,COGS 210A,003,087995,Xia; Haijun,9999,0,9999,0
1653465361645,COGS 210A,004,087996,Nitz; Douglas A.,9999,0,9999,0
1653465361645,COGS 210A,005,087997,Hollan; James D.,9999,0,9999,0
1653465361645,COGS 210A,006,087998,Deak; Gedeon O.,9998,0,9999,1
1653465361645,COGS 210A,007,087999,Rossano; Federico,9999,0,9999,0
1653465362177,COGS 211A,A00,088000,Coulson; Seana M,9997,0,9999,2
1653465362699,COGS 229,A00,088002,Staff,23,0,25,2
1653465363334,COGS 260,B00,094231,Staff,17,0,20,3
1653465363334,COGS 260,A00,088004,Nitz; Douglas A.,9998,0,9999,1
1653465363883,CSE 202,A00,090110,Paturi; Ramamohan,0,0,0,0
1653465363883,CSE 202,B00,090111,Paturi; Ramamohan,0,0,0,0
1653465364406,CSE 207B,A00,090112,Heninger; Nadia A,0,0,0,0
1653465364937,CSE 208,A00,094858,Micciancio; Daniele,0,0,0,0
1653465365464,CSE 210,A00,090113,Powell; Thomas Allan,0,0,0,0
1653465365993,CSE 219,A00,090898,Staff,0,0,0,0
1653465366521,CSE 221,A00,090114,Zhou; Yuan-Yuan,0,0,0,0
1653465367049,CSE 229A,A00,090115,Porter; George M,0,0,0,0
1653465367575,CSE 229C,A00,090116,Savage; Stefan,0,0,0,0
1653465368098,CSE 230,A00,090117,Jhala; Ranjit,0,0,0,0
1653465368632,CSE 232,A00,090118,Papakonstantinou; Yannis,0,0,0,0
1653465369154,CSE 239A,A00,090121,Kumar; Arun Kumar,0,0,0,0
1653465369675,CSE 239B,A00,090122,Jhala; Ranjit,0,0,0,0
1653465370198,CSE 240A,A00,090123,Zhao; Jishen,0,0,189,189
1653465370726,CSE 243A,A00,090124,Orailoglu; Alex,1,0,15,14
1653465371248,CSE 249B,A00,090125,Kahng; Andrew Byun,13,0,20,7
1653465371774,CSE 250A,A00,090126,Berg-Kirkpatrick; Taylor D,0,0,0,0
1653465372304,CSE 252A,A00,090127,Ochoa; Benjamin Lawrence,0,0,0,0
1653465372826,CSE 258,A01,090129,McAuley; Julian John,0,0,0,0
1653465373350,CSE 258R,A01,090131,McAuley; Julian John,0,0,0,0
1653465373873,CSE 274,A00,090132,Ramamoorthi; Ravi,0,0,0,0
1653465374400,CSE 276A,A00,090133,Christensen; Henrik I,0,0,0,0
1653465374928,CSE 276C,A00,090134,Christensen; Henrik I,0,0,0,0
1653465375453,CSE 290,A00,090135,Bafna; Vineet,0,0,0,0
1653465375453,CSE 290,B00,090136,Ramamoorthi; Ravi,0,0,0,0
1653465375453,CSE 290,C00,090137,Li; Tzumao,9,0,10,1
1653465375453,CSE 290,D00,090138,Zhou; Yuan-Yuan,10,0,10,0
1653465375453,CSE 290,E00,090139,Christensen; Henrik I,10,0,10,0
1653465375453,CSE 290,F00,094053,Shalev; Aaron D,0,0,0,0
1653465375978,CSE 291,A00,090140,Munyaka; Imani N. S.,0,0,0,0
1653465375978,CSE 291,B00,094880,Yu; Qi,0,0,0,0
1653465375978,CSE 291,C00,090142,Pannuto; Patrick William,0,0,0,0
1653465375978,CSE 291,D00,094881,Zhang; Yiying,0,0,0,0
1653465375978,CSE 291,E00,095118,Su; Hao,0,0,0,0
1653465376523,CSE 293,001,094905,Bafna; Vineet,9999,0,9999,0
1653465376523,CSE 293,002,094906,Bellare; Mihir,9999,0,9999,0
1653465376523,CSE 293,003,094907,Berg-Kirkpatrick; Taylor D,9999,0,9999,0
1653465376523,CSE 293,004,094908,Christensen; Henrik I,9999,0,9999,0
1653465376523,CSE 293,005,094909,Cottrell; Garrison W,9999,0,9999,0
1653465376523,CSE 293,006,094910,Deutsch; Alin Bernard,9999,0,9999,0
1653465376523,CSE 293,007,094911,Esmaeilzadeh; Hadi,9999,0,9999,0
1653465376523,CSE 293,008,094912,Freund; Yoav,9999,0,9999,0
1653465376523,CSE 293,009,094913,Griswold; William G.,9999,0,9999,0
1653465376523,CSE 293,010,094914,Gymrek; Melissa Ann,9999,0,9999,0
1653465376523,CSE 293,011,094915,Heninger; Nadia A,9999,0,9999,0
1653465376523,CSE 293,012,094916,Impagliazzo; Russell,9999,0,9999,0
1653465376523,CSE 293,013,094917,Jhala; Ranjit,9999,0,9999,0
1653465376523,CSE 293,014,094918,Kahng; Andrew Byun,9999,0,9999,0
1653465376523,CSE 293,015,094919,Kane; Daniel Mertz,9999,0,9999,0
1653465376523,CSE 293,016,094920,Kriegman; David J,9999,0,9999,0
1653465376523,CSE 293,017,094921,Kumar; Arun Kumar,9999,0,9999,0
1653465376523,CSE 293,018,094922,Lerner; Sorin,9999,0,9999,0
1653465376523,CSE 293,019,094923,Lovett; Shachar,9999,0,9999,0
1653465376523,CSE 293,020,094924,McAuley; Julian John,9999,0,9999,0
1653465376523,CSE 293,021,094925,Micciancio; Daniele,9999,0,9999,0
1653465376523,CSE 293,022,094926,Orailoglu; Alex,9999,0,9999,0
1653465376523,CSE 293,023,094927,Paturi; Ramamohan,9999,0,9999,0
1653465376523,CSE 293,024,094928,Polikarpova; Nadezhda,9999,0,9999,0
1653465376523,CSE 293,025,094929,Politz; Joseph Gibbs,9999,0,9999,0
1653465376523,CSE 293,026,094930,Porter; George M,9999,0,9999,0
1653465376523,CSE 293,027,094931,Porter; Leonard Emerson,9999,0,9999,0
1653465376523,CSE 293,028,094932,Ramamoorthi; Ravi,9999,0,9999,0
1653465376523,CSE 293,029,094933,Sahoo; Debashis,9999,0,9999,0
1653465376523,CSE 293,030,094934,Saul; Lawrence,9999,0,9999,0
1653465376523,CSE 293,031,094935,Savage; Stefan,9999,0,9999,0
1653465376523,CSE 293,032,094936,Schulze; Jurgen P.,9999,0,9999,0
1653465376523,CSE 293,033,094937,Snoeren; Alex C.,9999,0,9999,0
1653465376523,CSE 293,034,094938,Shang; Jingbo,9999,0,9999,0
1653465376523,CSE 293,035,094939,Stefan; Deian,9999,0,9999,0
1653465376523,CSE 293,036,094940,Su; Hao,9999,0,9999,0
1653465376523,CSE 293,037,094941,Swanson; Steven James,9999,0,9999,0
1653465376523,CSE 293,038,094942,Tullsen; Dean Michael,9999,0,9999,0
1653465376523,CSE 293,039,094943,Voelker; Geoffrey M.,9999,0,9999,0
1653465376523,CSE 293,040,094944,Zhao; Jishen,9999,0,9999,0
1653465376523,CSE 293,041,094945,Zhou; Yuan-Yuan,9999,0,9999,0
1653465376523,CSE 293,042,094946,Gao; Sicun,9998,0,9999,1
1653465376523,CSE 293,043,094947,Weibel; Nadir,9999,0,9999,0
1653465376523,CSE 293,044,094948,Gupta; Rajesh K.,9999,0,9999,0
1653465377049,CSE 294,A00,090143,Porter; George M,9,0,10,1
1653465377573,DSE 200,A00,091799,Staff,50,0,50,0
1653465378097,DSE 203,A00,091800,Gupta; Amarnath,30,0,30,0
1653465378623,DSE 250,A00,091801,Deutsch; Alin Bernard,30,0,30,0
1653465379147,DSE 290,A00,091802,Altintas De Callaf; Ilkay,50,0,50,0
1653465379733,ECE 200,001,091003,Antipa; Nicholas A,9999,0,9999,0
1653465379733,ECE 200,002,091004,Atanasov; Nikolay A.,9999,0,9999,0
1653465379733,ECE 200,003,091005,Bharadia; Dinesh,9999,0,9999,0
1653465379733,ECE 200,004,091006,Cheng; Chung Kuan,9999,0,9999,0
1653465379733,ECE 200,005,091007,Cosman; Pamela C.,9999,0,9999,0
1653465379733,ECE 200,006,091008,Staff,9999,0,9999,0
1653465379733,ECE 200,007,091009,Dayeh; Shadi Ahmad,9999,0,9999,0
1653465379733,ECE 200,008,091010,Fainman; Yeshaiahu,9999,0,9999,0
1653465379733,ECE 200,009,091011,Ford; Joseph Earl,9999,0,9999,0
1653465379733,ECE 200,010,091012,Franceschetti; Massimo,9999,0,9999,0
1653465379733,ECE 200,011,091013,Fullerton; Eric E,9999,0,9999,0
1653465379733,ECE 200,012,091014,Galton; Ian A,9999,0,9999,0
1653465379733,ECE 200,013,091015,Gilja; Vikash,9999,0,9999,0
1653465379733,ECE 200,014,091016,Hall; Drew A.,9999,0,9999,0
1653465379733,ECE 200,015,091017,Hsueh; Tzu-Chien,9999,0,9999,0
1653465379733,ECE 200,016,091018,Javidi; Tara,9999,0,9999,0
1653465379733,ECE 200,017,091019,Kahng; Andrew Byun,9999,0,9999,0
1653465379733,ECE 200,018,091020,Kim; Young-Han,9999,0,9999,0
1653465379733,ECE 200,019,091021,Koushanfar; Farinaz,9999,0,9999,0
1653465379733,ECE 200,020,091022,Kuzum; Duygu,9999,0,9999,0
1653465379733,ECE 200,021,091023,Le; Hanh-Phuc,9999,0,9999,0
1653465379733,ECE 200,022,091024,Lin; Bill,9999,0,9999,0
1653465379733,ECE 200,023,091025,Liu; Zhaowei,9999,0,9999,0
1653465379733,ECE 200,024,091026,Lo; Yu-Hwa,9999,0,9999,0
1653465379733,ECE 200,025,091027,Lomakin; Vitaliy,9999,0,9999,0
1653465379733,ECE 200,026,091028,Mercier; Patrick Philip,9999,0,9999,0
1653465379733,ECE 200,027,091029,Meyer; Florian,9999,0,9999,0
1653465379733,ECE 200,028,091030,Milstein; Laurence B.,9999,0,9999,0
1653465379733,ECE 200,029,091031,Mir Arabbaygi; Siavash,9999,0,9999,0
1653465379733,ECE 200,030,091032,Mookherjea; Shayan,9999,0,9999,0
1653465379733,ECE 200,031,091033,Morris; Karcher William,9999,0,9999,0
1653465379733,ECE 200,032,091034,Ng; Tse Nga,9999,0,9999,0
1653465379733,ECE 200,033,091035,Nguyen; Truong Quang,9999,0,9999,0
1653465379733,ECE 200,034,091036,Nomura; Kenji,9999,0,9999,0
1653465379733,ECE 200,035,091037,Orlitsky; Alon,9999,0,9999,0
1653465379733,ECE 200,036,091038,Pal; Piya,9999,0,9999,0
1653465379733,ECE 200,037,091039,Papen; George C.,9999,0,9999,0
1653465379733,ECE 200,038,091040,Radic; Stojan,9999,0,9999,0
1653465379733,ECE 200,039,091041,Rao; Bhaskar D.,9999,0,9999,0
1653465379733,ECE 200,040,091042,Rao; Ramesh R,9999,0,9999,0
1653465379733,ECE 200,041,091043,Rebeiz; Gabriel,9999,0,9999,0
1653465379733,ECE 200,042,091044,Sanford; John R,9999,0,9999,0
1653465379733,ECE 200,043,091045,Siegel; Paul H.,9999,0,9999,0
1653465379733,ECE 200,044,091046,Sievenpiper; Daniel F.,9999,0,9999,0
1653465379733,ECE 200,045,091047,Sworder; David D.,9999,0,9999,0
1653465379733,ECE 200,046,091048,Taur; Yuan,9999,0,9999,0
1653465379733,ECE 200,047,091049,Touri; Behrouz,9999,0,9999,0
1653465379733,ECE 200,048,091050,Trivedi; Mohan M.,9999,0,9999,0
1653465379733,ECE 200,049,091051,Vardy; Alexander,9999,0,9999,0
1653465379733,ECE 200,050,091052,Vasconcelos; Nuno,9999,0,9999,0
1653465379733,ECE 200,051,091053,Wang; Xiaolong,9999,0,9999,0
1653465379733,ECE 200,052,091054,Xie; Pengtao,9999,0,9999,0
1653465379733,ECE 200,053,091055,Yip; Michael,9999,0,9999,0
1653465379733,ECE 200,054,091056,Zeger; Kenneth A.,9999,0,9999,0
1653465379733,ECE 200,055,091057,Zhang; Xinyu,9999,0,9999,0
1653465379733,ECE 200,056,091058,Turakhia; Yatish Girish,9999,0,9999,0
1653465379733,ECE 200,057,091059,Kang; Mingu,9999,0,9999,0
1653465379733,ECE 200,058,091060,Shi; Yuanyuan,9999,0,9999,0
1653465379733,ECE 200,059,091061,Wang; Edward Jay,9999,0,9999,0
1653465379733,ECE 200,060,091062,Zheng; Yang,9999,0,9999,0
1653465380258,ECE 203,A00,091065,Mercier; Patrick Philip,0,0,0,0
1653465380787,ECE 207A,A00,091605,Liu; Thomas Tao-Ming,0,0,0,0
1653465381312,ECE 212AN,A00,091068,Nomura; Kenji,0,0,0,0
1653465381839,ECE 222A,A00,091069,Rebeiz; Gabriel,0,0,0,0
1653465382366,ECE 225A,A00,091070,Orlitsky; Alon,0,0,0,0
1653465382894,ECE 230A,A00,091071,Nomura; Kenji,0,0,0,0
1653465383426,ECE 236A,A00,091072,Dayeh; Shadi Ahmad,0,0,0,0
1653465383957,ECE 238A,A00,091073,Luo; Jian,0,0,0,0
1653465383957,ECE 238A,B00,091074,Luo; Jian,0,0,0,0
1653465384481,ECE 240A,A00,091075,Radic; Stojan,0,0,0,0
1653465385005,ECE 247A,A00,091592,Shi; Lingyan,0,0,0,0
1653465385532,ECE 250,A00,091076,Touri; Behrouz,0,0,0,0
1653465386059,ECE 251C,A00,091078,Nguyen; Truong Quang,0,0,0,0
1653465386595,ECE 253,A00,091079,Cosman; Pamela C.,0,0,0,0
1653465387122,ECE 255A,A00,091080,Orlitsky; Alon,0,0,0,0
1653465387645,ECE 257A,A00,091081,Zhang; Xinyu,0,0,0,0
1653465388169,ECE 260A,A01,091084,Eldon; John,0,0,0,0
1653465388695,ECE 264C,A00,091085,Galton; Ian A,0,0,0,0
1653465389226,ECE 265C,A00,094889,Presti; Calogero Davide,0,0,0,9
1653465389751,ECE 266,A01,091087,Hall; Drew A.,0,0,0,0
1653465390798,ECE 271A,A00,091090,Vasconcelos; Nuno,0,0,0,0
1653465391324,ECE 272B,A00,091091,Sworder; David D.,0,0,0,0
1653465391848,ECE 275A,A00,091092,Meyer; Florian,0,0,0,0
1653465392378,ECE 277,A00,091093,An; Cheolhong,0,0,0,0
1653465392906,ECE 283,A00,091094,Le; Hanh-Phuc,0,0,0,0
1653465393436,ECE 284,A00,091095,Kang; Mingu,0,0,0,0
1653465393436,ECE 284,B00,091096,Wang; Edward Jay,0,0,0,0
1653465393960,ECE 285,A00,094334,Touri; Behrouz,0,0,0,0
1653465394484,ECE 289,A00,091097,Whelan; David Arthur,0,0,0,0
1653465395008,MATH 200A,A00,087414,Salehi Golsefidy; Alireza,7,0,8,1
1653465395536,MATH 202A,A00,087415,Gill; Philip E.,3,0,8,5
1653465396060,MATH 203A,A00,087416,Oprea; Dragos N.,6,0,8,2
1653465396587,MATH 204A,A00,087417,Kedlaya; Kiran S.,6,0,8,2
1653465397110,MATH 205,A00,087418,Sorensen; Claus M,6,0,8,2
1653465397635,MATH 206A,A00,087419,Izadi; Elham,7,0,8,1
1653465398158,MATH 207A,A00,087420,Mohammadi; Amir,6,0,8,2
1653465398680,MATH 208,A00,087421,Staff,9,0,10,1
1653465399202,MATH 209,A00,087422,Staff,10,0,10,0
1653465399727,MATH 218,A00,087423,Staff,10,0,10,0
1653465400250,MATH 220A,A00,087424,Novak; Jonathan I,7,0,8,1
1653465400774,MATH 231A,A00,087425,Bejenaru; Ioan,3,0,8,5
1653465401298,MATH 240A,A00,087426,Ebenfelt; Peter F,5,0,8,3
1653465401820,MATH 243,A00,087427,Staff,9,0,10,1
1653465402347,MATH 248,A00,087429,Staff,10,0,10,0
1653465402871,MATH 250A,A00,087430,Spolaor; Luca,4,0,8,4
1653465403402,MATH 257A,A00,087431,Spolaor; Luca,7,0,8,1
1653465403925,MATH 258,A00,087432,Staff,9,0,10,1
1653465404449,MATH 264A,A00,087433,Warnke; Lutz Peter,5,0,8,3
1653465404974,MATH 268,A00,087434,Staff,15,0,15,0
1653465405496,MATH 269,A00,087435,Staff,14,0,15,1
1653465406020,MATH 270A,A00,087436,Nie; Jiawang,0,0,8,8
1653465406547,MATH 272A,A00,087437,Tian; Xiaochuan,1,0,8,7
1653465407076,MATH 274,A01,087439,Cheng; Li-Tien,9,0,10,1
1653465407076,MATH 274,A02,087440,Cheng; Li-Tien,10,0,10,0
1653465407601,MATH 278A,A00,087441,Staff,8,0,10,2
1653465408124,MATH 278B,A00,087442,Staff,8,0,10,2
1653465408648,MATH 278C,A00,087443,Staff,8,0,10,2
1653465409173,MATH 280A,A00,087444,Zheng; Tianyi,0,0,8,8
1653465409707,MATH 281A,A00,087445,Bradic; Jelena,0,0,8,8
1653465410229,MATH 282A,A00,087446,Zhang; Danna,0,0,8,8
1653465410751,MATH 283,A00,087447,Tesler; Glenn,0,0,0,14
1653465411279,MATH 286,A00,087448,Kemp; Todd Aahron,5,0,8,3
1653465411802,MATH 287D,A00,087449,Bradic; Jelena,8,0,8,0
1653465412328,MATH 288,A00,087450,Staff,14,0,15,1
1653465412328,MATH 288,B00,087451,Staff,15,0,15,0
1653465412328,MATH 288,C00,087452,Staff,15,0,15,0
1653465412856,MATH 290A,A00,087453,Xu; Zhouli,7,0,8,1
1653465413379,MATH 291A,A00,087454,Xu; Zhouli,7,0,8,1
1653465413905,MATH 292,A00,087455,Staff,10,0,10,0
1653465414429,MATH 295,A00,087456,Staff,50,0,50,0
1653465414951,MATH 297,001,087457,Staff,998,0,999,1
1653465975654,COGS 200,A01,087991,Staff,47,0,50,3
1653465976180,COGS 201,A01,094504,Rangel; Lara M,17,0,25,8
1653465976711,COGS 203,A00,087992,Coulson; Seana M,18,0,20,2
1653465977237,COGS 210A,001,087993,Greene; Deanna Jacquelyn,9998,0,9999,1
1653465977237,COGS 210A,002,087994,Saygin; Ayse P,9999,0,9999,0
1653465977237,COGS 210A,003,087995,Xia; Haijun,9999,0,9999,0
1653465977237,COGS 210A,004,087996,Nitz; Douglas A.,9999,0,9999,0
1653465977237,COGS 210A,005,087997,Hollan; James D.,9999,0,9999,0
1653465977237,COGS 210A,006,087998,Deak; Gedeon O.,9998,0,9999,1
1653465977237,COGS 210A,007,087999,Rossano; Federico,9999,0,9999,0
1653465977762,COGS 211A,A00,088000,Coulson; Seana M,9997,0,9999,2
1653465978294,COGS 229,A00,088002,Staff,23,0,25,2
1653465978821,COGS 260,B00,094231,Staff,17,0,20,3
1653465978821,COGS 260,A00,088004,Nitz; Douglas A.,9998,0,9999,1
1653465979345,CSE 202,A00,090110,Paturi; Ramamohan,0,0,0,0
1653465979345,CSE 202,B00,090111,Paturi; Ramamohan,0,0,0,0
1653465979882,CSE 207B,A00,090112,Heninger; Nadia A,0,0,0,0
1653465980419,CSE 208,A00,094858,Micciancio; Daniele,0,0,0,0
1653465980946,CSE 210,A00,090113,Powell; Thomas Allan,0,0,0,0
1653465981472,CSE 219,A00,090898,Staff,0,0,0,0
1653465981996,CSE 221,A00,090114,Zhou; Yuan-Yuan,0,0,0,0
1653465982522,CSE 229A,A00,090115,Porter; George M,0,0,0,0
1653465983048,CSE 229C,A00,090116,Savage; Stefan,0,0,0,0
1653465983576,CSE 230,A00,090117,Jhala; Ranjit,0,0,0,0
1653465984098,CSE 232,A00,090118,Papakonstantinou; Yannis,0,0,0,0
1653465984621,CSE 239A,A00,090121,Kumar; Arun Kumar,0,0,0,0
1653465985145,CSE 239B,A00,090122,Jhala; Ranjit,0,0,0,0
1653465985673,CSE 240A,A00,090123,Zhao; Jishen,0,0,189,189
1653465986201,CSE 243A,A00,090124,Orailoglu; Alex,0,0,15,15
1653465986729,CSE 249B,A00,090125,Kahng; Andrew Byun,13,0,20,7
1653465987253,CSE 250A,A00,090126,Berg-Kirkpatrick; Taylor D,0,0,0,0
1653465987778,CSE 252A,A00,090127,Ochoa; Benjamin Lawrence,0,0,0,0
1653465988302,CSE 258,A01,090129,McAuley; Julian John,0,0,0,0
1653465988829,CSE 258R,A01,090131,McAuley; Julian John,0,0,0,0
1653465989352,CSE 274,A00,090132,Ramamoorthi; Ravi,0,0,0,0
1653465989875,CSE 276A,A00,090133,Christensen; Henrik I,0,0,0,0
1653465990398,CSE 276C,A00,090134,Christensen; Henrik I,0,0,0,0
1653465990936,CSE 290,A00,090135,Bafna; Vineet,0,0,0,0
1653465990936,CSE 290,B00,090136,Ramamoorthi; Ravi,0,0,0,0
1653465990936,CSE 290,C00,090137,Li; Tzumao,9,0,10,1
1653465990936,CSE 290,D00,090138,Zhou; Yuan-Yuan,10,0,10,0
1653465990936,CSE 290,E00,090139,Christensen; Henrik I,10,0,10,0
1653465990936,CSE 290,F00,094053,Shalev; Aaron D,0,0,0,0
1653465991474,CSE 291,A00,090140,Munyaka; Imani N. S.,0,0,0,0
1653465991474,CSE 291,B00,094880,Yu; Qi,0,0,0,0
1653465991474,CSE 291,C00,090142,Pannuto; Patrick William,0,0,0,0
1653465991474,CSE 291,D00,094881,Zhang; Yiying,0,0,0,0
1653465991474,CSE 291,E00,095118,Su; Hao,0,0,0,0
1653465992006,CSE 293,001,094905,Bafna; Vineet,9999,0,9999,0
1653465992006,CSE 293,002,094906,Bellare; Mihir,9999,0,9999,0
1653465992006,CSE 293,003,094907,Berg-Kirkpatrick; Taylor D,9999,0,9999,0
1653465992006,CSE 293,004,094908,Christensen; Henrik I,9999,0,9999,0
1653465992006,CSE 293,005,094909,Cottrell; Garrison W,9999,0,9999,0
1653465992006,CSE 293,006,094910,Deutsch; Alin Bernard,9999,0,9999,0
1653465992006,CSE 293,007,094911,Esmaeilzadeh; Hadi,9999,0,9999,0
1653465992006,CSE 293,008,094912,Freund; Yoav,9999,0,9999,0
1653465992006,CSE 293,009,094913,Griswold; William G.,9999,0,9999,0
1653465992006,CSE 293,010,094914,Gymrek; Melissa Ann,9999,0,9999,0
1653465992006,CSE 293,011,094915,Heninger; Nadia A,9999,0,9999,0
1653465992006,CSE 293,012,094916,Impagliazzo; Russell,9999,0,9999,0
1653465992006,CSE 293,013,094917,Jhala; Ranjit,9999,0,9999,0
1653465992006,CSE 293,014,094918,Kahng; Andrew Byun,9999,0,9999,0
1653465992006,CSE 293,015,094919,Kane; Daniel Mertz,9999,0,9999,0
1653465992006,CSE 293,016,094920,Kriegman; David J,9999,0,9999,0
1653465992006,CSE 293,017,094921,Kumar; Arun Kumar,9999,0,9999,0
1653465992006,CSE 293,018,094922,Lerner; Sorin,9999,0,9999,0
1653465992006,CSE 293,019,094923,Lovett; Shachar,9999,0,9999,0
1653465992006,CSE 293,020,094924,McAuley; Julian John,9999,0,9999,0
1653465992006,CSE 293,021,094925,Micciancio; Daniele,9999,0,9999,0
1653465992006,CSE 293,022,094926,Orailoglu; Alex,9999,0,9999,0
1653465992006,CSE 293,023,094927,Paturi; Ramamohan,9999,0,9999,0
1653465992006,CSE 293,024,094928,Polikarpova; Nadezhda,9999,0,9999,0
1653465992006,CSE 293,025,094929,Politz; Joseph Gibbs,9999,0,9999,0
1653465992006,CSE 293,026,094930,Porter; George M,9999,0,9999,0
1653465992006,CSE 293,027,094931,Porter; Leonard Emerson,9999,0,9999,0
1653465992006,CSE 293,028,094932,Ramamoorthi; Ravi,9999,0,9999,0
1653465992006,CSE 293,029,094933,Sahoo; Debashis,9999,0,9999,0
1653465992006,CSE 293,030,094934,Saul; Lawrence,9999,0,9999,0
1653465992006,CSE 293,031,094935,Savage; Stefan,9999,0,9999,0
1653465992006,CSE 293,032,094936,Schulze; Jurgen P.,9999,0,9999,0
1653465992006,CSE 293,033,094937,Snoeren; Alex C.,9999,0,9999,0
1653465992006,CSE 293,034,094938,Shang; Jingbo,9999,0,9999,0
1653465992006,CSE 293,035,094939,Stefan; Deian,9999,0,9999,0
1653465992006,CSE 293,036,094940,Su; Hao,9999,0,9999,0
1653465992006,CSE 293,037,094941,Swanson; Steven James,9999,0,9999,0
1653465992006,CSE 293,038,094942,Tullsen; Dean Michael,9999,0,9999,0
1653465992006,CSE 293,039,094943,Voelker; Geoffrey M.,9999,0,9999,0
1653465992006,CSE 293,040,094944,Zhao; Jishen,9999,0,9999,0
1653465992006,CSE 293,041,094945,Zhou; Yuan-Yuan,9999,0,9999,0
1653465992006,CSE 293,042,094946,Gao; Sicun,9998,0,9999,1
1653465992006,CSE 293,043,094947,Weibel; Nadir,9999,0,9999,0
1653465992006,CSE 293,044,094948,Gupta; Rajesh K.,9999,0,9999,0
1653465992532,CSE 294,A00,090143,Porter; George M,9,0,10,1
1653465993060,DSE 200,A00,091799,Staff,50,0,50,0
1653465993586,DSE 203,A00,091800,Gupta; Amarnath,30,0,30,0
1653465994109,DSE 250,A00,091801,Deutsch; Alin Bernard,30,0,30,0
1653465994646,DSE 290,A00,091802,Altintas De Callaf; Ilkay,50,0,50,0
1653465995226,ECE 200,001,091003,Antipa; Nicholas A,9999,0,9999,0
1653465995226,ECE 200,002,091004,Atanasov; Nikolay A.,9999,0,9999,0
1653465995226,ECE 200,003,091005,Bharadia; Dinesh,9999,0,9999,0
1653465995226,ECE 200,004,091006,Cheng; Chung Kuan,9999,0,9999,0
1653465995226,ECE 200,005,091007,Cosman; Pamela C.,9999,0,9999,0
1653465995226,ECE 200,006,091008,Staff,9999,0,9999,0
1653465995226,ECE 200,007,091009,Dayeh; Shadi Ahmad,9999,0,9999,0
1653465995226,ECE 200,008,091010,Fainman; Yeshaiahu,9999,0,9999,0
1653465995226,ECE 200,009,091011,Ford; Joseph Earl,9999,0,9999,0
1653465995226,ECE 200,010,091012,Franceschetti; Massimo,9999,0,9999,0
1653465995226,ECE 200,011,091013,Fullerton; Eric E,9999,0,9999,0
1653465995226,ECE 200,012,091014,Galton; Ian A,9999,0,9999,0
1653465995226,ECE 200,013,091015,Gilja; Vikash,9999,0,9999,0
1653465995226,ECE 200,014,091016,Hall; Drew A.,9999,0,9999,0
1653465995226,ECE 200,015,091017,Hsueh; Tzu-Chien,9999,0,9999,0
1653465995226,ECE 200,016,091018,Javidi; Tara,9999,0,9999,0
1653465995226,ECE 200,017,091019,Kahng; Andrew Byun,9999,0,9999,0
1653465995226,ECE 200,018,091020,Kim; Young-Han,9999,0,9999,0
1653465995226,ECE 200,019,091021,Koushanfar; Farinaz,9999,0,9999,0
1653465995226,ECE 200,020,091022,Kuzum; Duygu,9999,0,9999,0
1653465995226,ECE 200,021,091023,Le; Hanh-Phuc,9999,0,9999,0
1653465995226,ECE 200,022,091024,Lin; Bill,9999,0,9999,0
1653465995226,ECE 200,023,091025,Liu; Zhaowei,9999,0,9999,0
1653465995226,ECE 200,024,091026,Lo; Yu-Hwa,9999,0,9999,0
1653465995226,ECE 200,025,091027,Lomakin; Vitaliy,9999,0,9999,0
1653465995226,ECE 200,026,091028,Mercier; Patrick Philip,9999,0,9999,0
1653465995226,ECE 200,027,091029,Meyer; Florian,9999,0,9999,0
1653465995226,ECE 200,028,091030,Milstein; Laurence B.,9999,0,9999,0
1653465995226,ECE 200,029,091031,Mir Arabbaygi; Siavash,9999,0,9999,0
1653465995226,ECE 200,030,091032,Mookherjea; Shayan,9999,0,9999,0
1653465995226,ECE 200,031,091033,Morris; Karcher William,9999,0,9999,0
1653465995226,ECE 200,032,091034,Ng; Tse Nga,9999,0,9999,0
1653465995226,ECE 200,033,091035,Nguyen; Truong Quang,9999,0,9999,0
1653465995226,ECE 200,034,091036,Nomura; Kenji,9999,0,9999,0
1653465995226,ECE 200,035,091037,Orlitsky; Alon,9999,0,9999,0
1653465995226,ECE 200,036,091038,Pal; Piya,9999,0,9999,0
1653465995226,ECE 200,037,091039,Papen; George C.,9999,0,9999,0
1653465995226,ECE 200,038,091040,Radic; Stojan,9999,0,9999,0
1653465995226,ECE 200,039,091041,Rao; Bhaskar D.,9999,0,9999,0
1653465995226,ECE 200,040,091042,Rao; Ramesh R,9999,0,9999,0
1653465995226,ECE 200,041,091043,Rebeiz; Gabriel,9999,0,9999,0
1653465995226,ECE 200,042,091044,Sanford; John R,9999,0,9999,0
1653465995226,ECE 200,043,091045,Siegel; Paul H.,9999,0,9999,0
1653465995226,ECE 200,044,091046,Sievenpiper; Daniel F.,9999,0,9999,0
1653465995226,ECE 200,045,091047,Sworder; David D.,9999,0,9999,0
1653465995226,ECE 200,046,091048,Taur; Yuan,9999,0,9999,0
1653465995226,ECE 200,047,091049,Touri; Behrouz,9999,0,9999,0
1653465995226,ECE 200,048,091050,Trivedi; Mohan M.,9999,0,9999,0
1653465995226,ECE 200,049,091051,Vardy; Alexander,9999,0,9999,0
1653465995226,ECE 200,050,091052,Vasconcelos; Nuno,9999,0,9999,0
1653465995226,ECE 200,051,091053,Wang; Xiaolong,9999,0,9999,0
1653465995226,ECE 200,052,091054,Xie; Pengtao,9999,0,9999,0
1653465995226,ECE 200,053,091055,Yip; Michael,9999,0,9999,0
1653465995226,ECE 200,054,091056,Zeger; Kenneth A.,9999,0,9999,0
1653465995226,ECE 200,055,091057,Zhang; Xinyu,9999,0,9999,0
1653465995226,ECE 200,056,091058,Turakhia; Yatish Girish,9999,0,9999,0
1653465995226,ECE 200,057,091059,Kang; Mingu,9999,0,9999,0
1653465995226,ECE 200,058,091060,Shi; Yuanyuan,9999,0,9999,0
1653465995226,ECE 200,059,091061,Wang; Edward Jay,9999,0,9999,0
1653465995226,ECE 200,060,091062,Zheng; Yang,9999,0,9999,0
1653465995750,ECE 203,A00,091065,Mercier; Patrick Philip,0,0,0,0
1653465996279,ECE 207A,A00,091605,Liu; Thomas Tao-Ming,0,0,0,0
1653465996810,ECE 212AN,A00,091068,Nomura; Kenji,0,0,0,0
1653465997333,ECE 222A,A00,091069,Rebeiz; Gabriel,0,0,0,0
1653465997857,ECE 225A,A00,091070,Orlitsky; Alon,0,0,0,0
1653465998389,ECE 230A,A00,091071,Nomura; Kenji,0,0,0,0
1653465998924,ECE 236A,A00,091072,Dayeh; Shadi Ahmad,0,0,0,0
1653465999448,ECE 238A,A00,091073,Luo; Jian,0,0,0,0
1653465999448,ECE 238A,B00,091074,Luo; Jian,0,0,0,0
1653465999970,ECE 240A,A00,091075,Radic; Stojan,0,0,0,0
1653466000498,ECE 247A,A00,091592,Shi; Lingyan,0,0,0,0
1653466001023,ECE 250,A00,091076,Touri; Behrouz,0,0,0,0
1653466001545,ECE 251C,A00,091078,Nguyen; Truong Quang,0,0,0,0
1653466002070,ECE 253,A00,091079,Cosman; Pamela C.,0,0,0,0
1653466002591,ECE 255A,A00,091080,Orlitsky; Alon,0,0,0,0
1653466003118,ECE 257A,A00,091081,Zhang; Xinyu,0,0,0,0
1653466003646,ECE 260A,A01,091084,Eldon; John,0,0,0,0
1653466004172,ECE 264C,A00,091085,Galton; Ian A,0,0,0,0
1653466004776,ECE 265C,A00,094889,Presti; Calogero Davide,0,0,0,9
1653466005311,ECE 266,A01,091087,Hall; Drew A.,0,0,0,0
1653466006383,ECE 271A,A00,091090,Vasconcelos; Nuno,0,0,0,0
1653466006910,ECE 272B,A00,091091,Sworder; David D.,0,0,0,0
1653466007436,ECE 275A,A00,091092,Meyer; Florian,0,0,0,0
1653466007974,ECE 277,A00,091093,An; Cheolhong,0,0,0,0
1653466008502,ECE 283,A00,091094,Le; Hanh-Phuc,0,0,0,0
1653466009029,ECE 284,A00,091095,Kang; Mingu,0,0,0,0
1653466009029,ECE 284,B00,091096,Wang; Edward Jay,0,0,0,0
1653466009552,ECE 285,A00,094334,Touri; Behrouz,0,0,0,0
1653466010084,ECE 289,A00,091097,Whelan; David Arthur,0,0,0,0
1653466010611,MATH 200A,A00,087414,Salehi Golsefidy; Alireza,7,0,8,1
1653466011134,MATH 202A,A00,087415,Gill; Philip E.,3,0,8,5
1653466011659,MATH 203A,A00,087416,Oprea; Dragos N.,6,0,8,2
1653466012183,MATH 204A,A00,087417,Kedlaya; Kiran S.,6,0,8,2
1653466012704,MATH 205,A00,087418,Sorensen; Claus M,6,0,8,2
1653466013226,MATH 206A,A00,087419,Izadi; Elham,7,0,8,1
1653466013754,MATH 207A,A00,087420,Mohammadi; Amir,6,0,8,2
1653466014291,MATH 208,A00,087421,Staff,9,0,10,1
1653466014834,MATH 209,A00,087422,Staff,10,0,10,0
1653466015362,MATH 218,A00,087423,Staff,10,0,10,0
1653466015896,MATH 220A,A00,087424,Novak; Jonathan I,7,0,8,1
1653466016422,MATH 231A,A00,087425,Bejenaru; Ioan,3,0,8,5
1653466016955,MATH 240A,A00,087426,Ebenfelt; Peter F,5,0,8,3
1653466017479,MATH 243,A00,087427,Staff,9,0,10,1
1653466018008,MATH 248,A00,087429,Staff,10,0,10,0
1653466018556,MATH 250A,A00,087430,Spolaor; Luca,4,0,8,4
1653466019083,MATH 257A,A00,087431,Spolaor; Luca,7,0,8,1
1653466019617,MATH 258,A00,087432,Staff,9,0,10,1
1653466020142,MATH 264A,A00,087433,Warnke; Lutz Peter,5,0,8,3
1653466020671,MATH 268,A00,087434,Staff,15,0,15,0
1653466021197,MATH 269,A00,087435,Staff,14,0,15,1
1653466021721,MATH 270A,A00,087436,Nie; Jiawang,0,0,8,8
1653466022250,MATH 272A,A00,087437,Tian; Xiaochuan,1,0,8,7
1653466022775,MATH 274,A01,087439,Cheng; Li-Tien,9,0,10,1
1653466022775,MATH 274,A02,087440,Cheng; Li-Tien,10,0,10,0
1653466023307,MATH 278A,A00,087441,Staff,8,0,10,2
1653466023830,MATH 278B,A00,087442,Staff,8,0,10,2
1653466024353,MATH 278C,A00,087443,Staff,8,0,10,2
1653466024878,MATH 280A,A00,087444,Zheng; Tianyi,0,0,8,8
1653466025409,MATH 281A,A00,087445,Bradic; Jelena,0,0,8,8
1653466025933,MATH 282A,A00,087446,Zhang; Danna,0,0,8,8
1653466026471,MATH 283,A00,087447,Tesler; Glenn,0,0,0,14
1653466027004,MATH 286,A00,087448,Kemp; Todd Aahron,5,0,8,3
1653466027531,MATH 287D,A00,087449,Bradic; Jelena,8,0,8,0
1653466028059,MATH 288,A00,087450,Staff,14,0,15,1
1653466028059,MATH 288,B00,087451,Staff,15,0,15,0
1653466028059,MATH 288,C00,087452,Staff,15,0,15,0
1653466028587,MATH 290A,A00,087453,Xu; Zhouli,7,0,8,1
1653466029115,MATH 291A,A00,087454,Xu; Zhouli,7,0,8,1
1653466029638,MATH 292,A00,087455,Staff,10,0,10,0
1653466030163,MATH 295,A00,087456,Staff,50,0,50,0
1653466030690,MATH 297,001,087457,Staff,998,0,999,1
1653466591637,COGS 200,A01,087991,Staff,47,0,50,3
1653466592162,COGS 201,A01,094504,Rangel; Lara M,17,0,25,8
1653466592692,COGS 203,A00,087992,Coulson; Seana M,18,0,20,2
1653466593314,COGS 210A,001,087993,Greene; Deanna Jacquelyn,9998,0,9999,1
1653466593314,COGS 210A,002,087994,Saygin; Ayse P,9999,0,9999,0
1653466593314,COGS 210A,003,087995,Xia; Haijun,9999,0,9999,0
1653466593314,COGS 210A,004,087996,Nitz; Douglas A.,9999,0,9999,0
1653466593314,COGS 210A,005,087997,Hollan; James D.,9999,0,9999,0
1653466593314,COGS 210A,006,087998,Deak; Gedeon O.,9998,0,9999,1
1653466593314,COGS 210A,007,087999,Rossano; Federico,9999,0,9999,0
1653466593836,COGS 211A,A00,088000,Coulson; Seana M,9997,0,9999,2
1653466594372,COGS 229,A00,088002,Staff,23,0,25,2
1653466594895,COGS 260,B00,094231,Staff,17,0,20,3
1653466594895,COGS 260,A00,088004,Nitz; Douglas A.,9998,0,9999,1
1653466595422,CSE 202,A00,090110,Paturi; Ramamohan,0,0,0,0
1653466595422,CSE 202,B00,090111,Paturi; Ramamohan,0,0,0,0
1653466595951,CSE 207B,A00,090112,Heninger; Nadia A,0,0,0,0
1653466596479,CSE 208,A00,094858,Micciancio; Daniele,0,0,0,0
1653466597002,CSE 210,A00,090113,Powell; Thomas Allan,0,0,0,0
1653466597529,CSE 219,A00,090898,Staff,0,0,0,0
1653466598064,CSE 221,A00,090114,Zhou; Yuan-Yuan,0,0,0,0
1653466598587,CSE 229A,A00,090115,Porter; George M,0,0,0,0
1653466599111,CSE 229C,A00,090116,Savage; Stefan,0,0,0,0
1653466599641,CSE 230,A00,090117,Jhala; Ranjit,0,0,0,0
1653466600219,CSE 232,A00,090118,Papakonstantinou; Yannis,0,0,0,0
1653466600749,CSE 239A,A00,090121,Kumar; Arun Kumar,0,0,0,0
1653466601274,CSE 239B,A00,090122,Jhala; Ranjit,0,0,0,0
1653466601799,CSE 240A,A00,090123,Zhao; Jishen,0,0,189,189
1653466602324,CSE 243A,A00,090124,Orailoglu; Alex,0,0,15,15
1653466602848,CSE 249B,A00,090125,Kahng; Andrew Byun,13,0,20,7
1653466603373,CSE 250A,A00,090126,Berg-Kirkpatrick; Taylor D,0,0,0,0
1653466603901,CSE 252A,A00,090127,Ochoa; Benjamin Lawrence,0,0,0,0
1653466604425,CSE 258,A01,090129,McAuley; Julian John,0,0,0,0
1653466604948,CSE 258R,A01,090131,McAuley; Julian John,0,0,0,0
1653466605475,CSE 274,A00,090132,Ramamoorthi; Ravi,0,0,0,0
1653466605999,CSE 276A,A00,090133,Christensen; Henrik I,0,0,0,0
1653466606523,CSE 276C,A00,090134,Christensen; Henrik I,0,0,0,0
1653466607063,CSE 290,A00,090135,Bafna; Vineet,0,0,0,0
1653466607063,CSE 290,B00,090136,Ramamoorthi; Ravi,0,0,0,0
1653466607063,CSE 290,C00,090137,Li; Tzumao,9,0,10,1
1653466607063,CSE 290,D00,090138,Zhou; Yuan-Yuan,10,0,10,0
1653466607063,CSE 290,E00,090139,Christensen; Henrik I,10,0,10,0
1653466607063,CSE 290,F00,094053,Shalev; Aaron D,0,0,0,0
1653466607594,CSE 291,A00,090140,Munyaka; Imani N. S.,0,0,0,0
1653466607594,CSE 291,B00,094880,Yu; Qi,0,0,0,0
1653466607594,CSE 291,C00,090142,Pannuto; Patrick William,0,0,0,0
1653466607594,CSE 291,D00,094881,Zhang; Yiying,0,0,0,0
1653466607594,CSE 291,E00,095118,Su; Hao,0,0,0,0
1653466608174,CSE 293,001,094905,Bafna; Vineet,9999,0,9999,0
1653466608174,CSE 293,002,094906,Bellare; Mihir,9999,0,9999,0
1653466608174,CSE 293,003,094907,Berg-Kirkpatrick; Taylor D,9999,0,9999,0
1653466608174,CSE 293,004,094908,Christensen; Henrik I,9999,0,9999,0
1653466608174,CSE 293,005,094909,Cottrell; Garrison W,9999,0,9999,0
1653466608174,CSE 293,006,094910,Deutsch; Alin Bernard,9999,0,9999,0
1653466608174,CSE 293,007,094911,Esmaeilzadeh; Hadi,9999,0,9999,0
1653466608174,CSE 293,008,094912,Freund; Yoav,9999,0,9999,0
1653466608174,CSE 293,009,094913,Griswold; William G.,9999,0,9999,0
1653466608174,CSE 293,010,094914,Gymrek; Melissa Ann,9999,0,9999,0
1653466608174,CSE 293,011,094915,Heninger; Nadia A,9999,0,9999,0
1653466608174,CSE 293,012,094916,Impagliazzo; Russell,9999,0,9999,0
1653466608174,CSE 293,013,094917,Jhala; Ranjit,9999,0,9999,0
1653466608174,CSE 293,014,094918,Kahng; Andrew Byun,9999,0,9999,0
1653466608174,CSE 293,015,094919,Kane; Daniel Mertz,9999,0,9999,0
1653466608174,CSE 293,016,094920,Kriegman; David J,9999,0,9999,0
1653466608174,CSE 293,017,094921,Kumar; Arun Kumar,9999,0,9999,0
1653466608174,CSE 293,018,094922,Lerner; Sorin,9999,0,9999,0
1653466608174,CSE 293,019,094923,Lovett; Shachar,9999,0,9999,0
1653466608174,CSE 293,020,094924,McAuley; Julian John,9999,0,9999,0
1653466608174,CSE 293,021,094925,Micciancio; Daniele,9999,0,9999,0
1653466608174,CSE 293,022,094926,Orailoglu; Alex,9999,0,9999,0
1653466608174,CSE 293,023,094927,Paturi; Ramamohan,9999,0,9999,0
1653466608174,CSE 293,024,094928,Polikarpova; Nadezhda,9999,0,9999,0
1653466608174,CSE 293,025,094929,Politz; Joseph Gibbs,9999,0,9999,0
1653466608174,CSE 293,026,094930,Porter; George M,9999,0,9999,0
1653466608174,CSE 293,027,094931,Porter; Leonard Emerson,9999,0,9999,0
1653466608174,CSE 293,028,094932,Ramamoorthi; Ravi,9999,0,9999,0
1653466608174,CSE 293,029,094933,Sahoo; Debashis,9999,0,9999,0
1653466608174,CSE 293,030,094934,Saul; Lawrence,9999,0,9999,0
1653466608174,CSE 293,031,094935,Savage; Stefan,9999,0,9999,0
1653466608174,CSE 293,032,094936,Schulze; Jurgen P.,9999,0,9999,0
1653466608174,CSE 293,033,094937,Snoeren; Alex C.,9999,0,9999,0
1653466608174,CSE 293,034,094938,Shang; Jingbo,9999,0,9999,0
1653466608174,CSE 293,035,094939,Stefan; Deian,9999,0,9999,0
1653466608174,CSE 293,036,094940,Su; Hao,9999,0,9999,0
1653466608174,CSE 293,037,094941,Swanson; Steven James,9999,0,9999,0
1653466608174,CSE 293,038,094942,Tullsen; Dean Michael,9999,0,9999,0
1653466608174,CSE 293,039,094943,Voelker; Geoffrey M.,9999,0,9999,0
1653466608174,CSE 293,040,094944,Zhao; Jishen,9999,0,9999,0
1653466608174,CSE 293,041,094945,Zhou; Yuan-Yuan,9999,0,9999,0
1653466608174,CSE 293,042,094946,Gao; Sicun,9998,0,9999,1
1653466608174,CSE 293,043,094947,Weibel; Nadir,9999,0,9999,0
1653466608174,CSE 293,044,094948,Gupta; Rajesh K.,9999,0,9999,0
1653466608699,CSE 294,A00,090143,Porter; George M,9,0,10,1
1653466609230,DSE 200,A00,091799,Staff,50,0,50,0
1653466609753,DSE 203,A00,091800,Gupta; Amarnath,30,0,30,0
1653466610275,DSE 250,A00,091801,Deutsch; Alin Bernard,30,0,30,0
1653466610800,DSE 290,A00,091802,Altintas De Callaf; Ilkay,50,0,50,0
1653466611415,ECE 200,001,091003,Antipa; Nicholas A,9999,0,9999,0
1653466611415,ECE 200,002,091004,Atanasov; Nikolay A.,9999,0,9999,0
1653466611415,ECE 200,003,091005,Bharadia; Dinesh,9999,0,9999,0
1653466611415,ECE 200,004,091006,Cheng; Chung Kuan,9999,0,9999,0
1653466611415,ECE 200,005,091007,Cosman; Pamela C.,9999,0,9999,0
1653466611415,ECE 200,006,091008,Staff,9999,0,9999,0
1653466611415,ECE 200,007,091009,Dayeh; Shadi Ahmad,9999,0,9999,0
1653466611415,ECE 200,008,091010,Fainman; Yeshaiahu,9999,0,9999,0
1653466611415,ECE 200,009,091011,Ford; Joseph Earl,9999,0,9999,0
1653466611415,ECE 200,010,091012,Franceschetti; Massimo,9999,0,9999,0
1653466611415,ECE 200,011,091013,Fullerton; Eric E,9999,0,9999,0
1653466611415,ECE 200,012,091014,Galton; Ian A,9999,0,9999,0
1653466611415,ECE 200,013,091015,Gilja; Vikash,9999,0,9999,0
1653466611415,ECE 200,014,091016,Hall; Drew A.,9999,0,9999,0
1653466611415,ECE 200,015,091017,Hsueh; Tzu-Chien,9999,0,9999,0
1653466611415,ECE 200,016,091018,Javidi; Tara,9999,0,9999,0
1653466611415,ECE 200,017,091019,Kahng; Andrew Byun,9999,0,9999,0
1653466611415,ECE 200,018,091020,Kim; Young-Han,9999,0,9999,0
1653466611415,ECE 200,019,091021,Koushanfar; Farinaz,9999,0,9999,0
1653466611415,ECE 200,020,091022,Kuzum; Duygu,9999,0,9999,0
1653466611415,ECE 200,021,091023,Le; Hanh-Phuc,9999,0,9999,0
1653466611415,ECE 200,022,091024,Lin; Bill,9999,0,9999,0
1653466611415,ECE 200,023,091025,Liu; Zhaowei,9999,0,9999,0
1653466611415,ECE 200,024,091026,Lo; Yu-Hwa,9999,0,9999,0
1653466611415,ECE 200,025,091027,Lomakin; Vitaliy,9999,0,9999,0
1653466611415,ECE 200,026,091028,Mercier; Patrick Philip,9999,0,9999,0
1653466611415,ECE 200,027,091029,Meyer; Florian,9999,0,9999,0
1653466611415,ECE 200,028,091030,Milstein; Laurence B.,9999,0,9999,0
1653466611415,ECE 200,029,091031,Mir Arabbaygi; Siavash,9999,0,9999,0
1653466611415,ECE 200,030,091032,Mookherjea; Shayan,9999,0,9999,0
1653466611415,ECE 200,031,091033,Morris; Karcher William,9999,0,9999,0
1653466611415,ECE 200,032,091034,Ng; Tse Nga,9999,0,9999,0
1653466611415,ECE 200,033,091035,Nguyen; Truong Quang,9999,0,9999,0
1653466611415,ECE 200,034,091036,Nomura; Kenji,9999,0,9999,0
1653466611415,ECE 200,035,091037,Orlitsky; Alon,9999,0,9999,0
1653466611415,ECE 200,036,091038,Pal; Piya,9999,0,9999,0
1653466611415,ECE 200,037,091039,Papen; George C.,9999,0,9999,0
1653466611415,ECE 200,038,091040,Radic; Stojan,9999,0,9999,0
1653466611415,ECE 200,039,091041,Rao; Bhaskar D.,9999,0,9999,0
1653466611415,ECE 200,040,091042,Rao; Ramesh R,9999,0,9999,0
1653466611415,ECE 200,041,091043,Rebeiz; Gabriel,9999,0,9999,0
1653466611415,ECE 200,042,091044,Sanford; John R,9999,0,9999,0
1653466611415,ECE 200,043,091045,Siegel; Paul H.,9999,0,9999,0
1653466611415,ECE 200,044,091046,Sievenpiper; Daniel F.,9999,0,9999,0
1653466611415,ECE 200,045,091047,Sworder; David D.,9999,0,9999,0
1653466611415,ECE 200,046,091048,Taur; Yuan,9999,0,9999,0
1653466611415,ECE 200,047,091049,Touri; Behrouz,9999,0,9999,0
1653466611415,ECE 200,048,091050,Trivedi; Mohan M.,9999,0,9999,0
1653466611415,ECE 200,049,091051,Vardy; Alexander,9999,0,9999,0
1653466611415,ECE 200,050,091052,Vasconcelos; Nuno,9999,0,9999,0
1653466611415,ECE 200,051,091053,Wang; Xiaolong,9999,0,9999,0
1653466611415,ECE 200,052,091054,Xie; Pengtao,9999,0,9999,0
1653466611415,ECE 200,053,091055,Yip; Michael,9999,0,9999,0
1653466611415,ECE 200,054,091056,Zeger; Kenneth A.,9999,0,9999,0
1653466611415,ECE 200,055,091057,Zhang; Xinyu,9999,0,9999,0
1653466611415,ECE 200,056,091058,Turakhia; Yatish Girish,9999,0,9999,0
1653466611415,ECE 200,057,091059,Kang; Mingu,9999,0,9999,0
1653466611415,ECE 200,058,091060,Shi; Yuanyuan,9999,0,9999,0
1653466611415,ECE 200,059,091061,Wang; Edward Jay,9999,0,9999,0
1653466611415,ECE 200,060,091062,Zheng; Yang,9999,0,9999,0
1653466611940,ECE 203,A00,091065,Mercier; Patrick Philip,0,0,0,0
1653466612465,ECE 207A,A00,091605,Liu; Thomas Tao-Ming,0,0,0,0
1653466612989,ECE 212AN,A00,091068,Nomura; Kenji,0,0,0,0
1653466613510,ECE 222A,A00,091069,Rebeiz; Gabriel,0,0,0,0
1653466614034,ECE 225A,A00,091070,Orlitsky; Alon,0,0,0,0
1653466614559,ECE 230A,A00,091071,Nomura; Kenji,0,0,0,0
1653466615090,ECE 236A,A00,091072,Dayeh; Shadi Ahmad,0,0,0,0
1653466615620,ECE 238A,A00,091073,Luo; Jian,0,0,0,0
1653466615620,ECE 238A,B00,091074,Luo; Jian,0,0,0,0
1653466616145,ECE 240A,A00,091075,Radic; Stojan,0,0,0,0
1653466616670,ECE 247A,A00,091592,Shi; Lingyan,0,0,0,0
1653466617195,ECE 250,A00,091076,Touri; Behrouz,0,0,0,0
1653466617727,ECE 251C,A00,091078,Nguyen; Truong Quang,0,0,0,0
1653466618256,ECE 253,A00,091079,Cosman; Pamela C.,0,0,0,0
1653466618794,ECE 255A,A00,091080,Orlitsky; Alon,0,0,0,0
1653466619323,ECE 257A,A00,091081,Zhang; Xinyu,0,0,0,0
1653466619855,ECE 260A,A01,091084,Eldon; John,0,0,0,0
1653466620379,ECE 264C,A00,091085,Galton; Ian A,0,0,0,0
1653466620909,ECE 265C,A00,094889,Presti; Calogero Davide,0,0,0,9
1653466621441,ECE 266,A01,091087,Hall; Drew A.,0,0,0,0
1653466622509,ECE 271A,A00,091090,Vasconcelos; Nuno,0,0,0,0
1653466623052,ECE 272B,A00,091091,Sworder; David D.,0,0,0,0
1653466623586,ECE 275A,A00,091092,Meyer; Florian,0,0,0,0
1653466624111,ECE 277,A00,091093,An; Cheolhong,0,0,0,0
1653466624634,ECE 283,A00,091094,Le; Hanh-Phuc,0,0,0,0
1653466625160,ECE 284,A00,091095,Kang; Mingu,0,0,0,0
1653466625160,ECE 284,B00,091096,Wang; Edward Jay,0,0,0,0
1653466625686,ECE 285,A00,094334,Touri; Behrouz,0,0,0,0
1653466626214,ECE 289,A00,091097,Whelan; David Arthur,0,0,0,0
1653466626739,MATH 200A,A00,087414,Salehi Golsefidy; Alireza,7,0,8,1
1653466627263,MATH 202A,A00,087415,Gill; Philip E.,3,0,8,5
1653466627787,MATH 203A,A00,087416,Oprea; Dragos N.,6,0,8,2
1653466628312,MATH 204A,A00,087417,Kedlaya; Kiran S.,6,0,8,2
1653466628841,MATH 205,A00,087418,Sorensen; Claus M,6,0,8,2
1653466629363,MATH 206A,A00,087419,Izadi; Elham,7,0,8,1
1653466629886,MATH 207A,A00,087420,Mohammadi; Amir,6,0,8,2
1653466630413,MATH 208,A00,087421,Staff,9,0,10,1
1653466630938,MATH 209,A00,087422,Staff,10,0,10,0
1653466631465,MATH 218,A00,087423,Staff,10,0,10,0
1653466631988,MATH 220A,A00,087424,Novak; Jonathan I,7,0,8,1
1653466632519,MATH 231A,A00,087425,Bejenaru; Ioan,3,0,8,5
1653466633044,MATH 240A,A00,087426,Ebenfelt; Peter F,5,0,8,3
1653466633566,MATH 243,A00,087427,Staff,9,0,10,1
1653466634089,MATH 248,A00,087429,Staff,10,0,10,0
1653466634622,MATH 250A,A00,087430,Spolaor; Luca,4,0,8,4
1653466635146,MATH 257A,A00,087431,Spolaor; Luca,7,0,8,1
1653466635673,MATH 258,A00,087432,Staff,9,0,10,1
1653466636197,MATH 264A,A00,087433,Warnke; Lutz Peter,5,0,8,3
1653466636723,MATH 268,A00,087434,Staff,15,0,15,0
1653466637251,MATH 269,A00,087435,Staff,14,0,15,1
1653466637777,MATH 270A,A00,087436,Nie; Jiawang,0,0,8,8
1653466638303,MATH 272A,A00,087437,Tian; Xiaochuan,1,0,8,7
1653466638827,MATH 274,A01,087439,Cheng; Li-Tien,9,0,10,1
1653466638827,MATH 274,A02,087440,Cheng; Li-Tien,10,0,10,0
1653466639349,MATH 278A,A00,087441,Staff,8,0,10,2
1653466639876,MATH 278B,A00,087442,Staff,8,0,10,2
1653466640399,MATH 278C,A00,087443,Staff,8,0,10,2
1653466640922,MATH 280A,A00,087444,Zheng; Tianyi,0,0,8,8
1653466641449,MATH 281A,A00,087445,Bradic; Jelena,0,0,8,8
1653466641991,MATH 282A,A00,087446,Zhang; Danna,0,0,8,8
1653466642518,MATH 283,A00,087447,Tesler; Glenn,0,0,0,14
1653466643045,MATH 286,A00,087448,Kemp; Todd Aahron,5,0,8,3
1653466643567,MATH 287D,A00,087449,Bradic; Jelena,8,0,8,0
1653466644090,MATH 288,A00,087450,Staff,14,0,15,1
1653466644090,MATH 288,B00,087451,Staff,15,0,15,0
1653466644090,MATH 288,C00,087452,Staff,15,0,15,0
1653466644685,MATH 290A,A00,087453,Xu; Zhouli,7,0,8,1
1653466645211,MATH 291A,A00,087454,Xu; Zhouli,7,0,8,1
1653466645739,MATH 292,A00,087455,Staff,10,0,10,0
1653466646270,MATH 295,A00,087456,Staff,50,0,50,0
1653466646871,MATH 297,001,087457,Staff,998,0,999,1
1653467207571,COGS 200,A01,087991,Staff,47,0,50,3
1653467208101,COGS 201,A01,094504,Rangel; Lara M,17,0,25,8
1653467208628,COGS 203,A00,087992,Coulson; Seana M,18,0,20,2
1653467209154,COGS 210A,001,087993,Greene; Deanna Jacquelyn,9998,0,9999,1
1653467209154,COGS 210A,002,087994,Saygin; Ayse P,9999,0,9999,0
1653467209154,COGS 210A,003,087995,Xia; Haijun,9999,0,9999,0
1653467209154,COGS 210A,004,087996,Nitz; Douglas A.,9999,0,9999,0
1653467209154,COGS 210A,005,087997,Hollan; James D.,9999,0,9999,0
1653467209154,COGS 210A,006,087998,Deak; Gedeon O.,9998,0,9999,1
1653467209154,COGS 210A,007,087999,Rossano; Federico,9999,0,9999,0
1653467209682,COGS 211A,A00,088000,Coulson; Seana M,9997,0,9999,2
1653467210208,COGS 229,A00,088002,Staff,23,0,25,2
1653467210732,COGS 260,B00,094231,Staff,17,0,20,3
1653467210732,COGS 260,A00,088004,Nitz; Douglas A.,9998,0,9999,1
1653467211263,CSE 202,A00,090110,Paturi; Ramamohan,0,0,0,0
1653467211263,CSE 202,B00,090111,Paturi; Ramamohan,0,0,0,0
1653467211790,CSE 207B,A00,090112,Heninger; Nadia A,0,0,0,0
1653467212313,CSE 208,A00,094858,Micciancio; Daniele,0,0,0,0
1653467212838,CSE 210,A00,090113,Powell; Thomas Allan,0,0,0,0
1653467213362,CSE 219,A00,090898,Staff,0,0,0,0
1653467213886,CSE 221,A00,090114,Zhou; Yuan-Yuan,0,0,0,0
1653467214423,CSE 229A,A00,090115,Porter; George M,0,0,0,0
1653467214953,CSE 229C,A00,090116,Savage; Stefan,0,0,0,0
1653467215477,CSE 230,A00,090117,Jhala; Ranjit,0,0,0,0
1653467216002,CSE 232,A00,090118,Papakonstantinou; Yannis,0,0,0,0
1653467216530,CSE 239A,A00,090121,Kumar; Arun Kumar,0,0,0,0
1653467217064,CSE 239B,A00,090122,Jhala; Ranjit,0,0,0,0
1653467217587,CSE 240A,A00,090123,Zhao; Jishen,0,0,189,189
1653467218112,CSE 243A,A00,090124,Orailoglu; Alex,0,0,15,15
1653467218641,CSE 249B,A00,090125,Kahng; Andrew Byun,13,0,20,7
1653467219165,CSE 250A,A00,090126,Berg-Kirkpatrick; Taylor D,0,0,0,0
1653467219688,CSE 252A,A00,090127,Ochoa; Benjamin Lawrence,0,0,0,0
1653467220214,CSE 258,A01,090129,McAuley; Julian John,0,0,0,0
1653467220747,CSE 258R,A01,090131,McAuley; Julian John,0,0,0,0
1653467221272,CSE 274,A00,090132,Ramamoorthi; Ravi,0,0,0,0
1653467221800,CSE 276A,A00,090133,Christensen; Henrik I,0,0,0,0
1653467222331,CSE 276C,A00,090134,Christensen; Henrik I,0,0,0,0
1653467222864,CSE 290,A00,090135,Bafna; Vineet,0,0,0,0
1653467222864,CSE 290,B00,090136,Ramamoorthi; Ravi,0,0,0,0
1653467222864,CSE 290,C00,090137,Li; Tzumao,9,0,10,1
1653467222864,CSE 290,D00,090138,Zhou; Yuan-Yuan,10,0,10,0
1653467222864,CSE 290,E00,090139,Christensen; Henrik I,10,0,10,0
1653467222864,CSE 290,F00,094053,Shalev; Aaron D,0,0,0,0
1653467223397,CSE 291,A00,090140,Munyaka; Imani N. S.,0,0,0,0
1653467223397,CSE 291,B00,094880,Yu; Qi,0,0,0,0
1653467223397,CSE 291,C00,090142,Pannuto; Patrick William,0,0,0,0
1653467223397,CSE 291,D00,094881,Zhang; Yiying,0,0,0,0
1653467223397,CSE 291,E00,095118,Su; Hao,0,0,0,0
1653467223926,CSE 293,001,094905,Bafna; Vineet,9999,0,9999,0
1653467223926,CSE 293,002,094906,Bellare; Mihir,9999,0,9999,0
1653467223926,CSE 293,003,094907,Berg-Kirkpatrick; Taylor D,9999,0,9999,0
1653467223926,CSE 293,004,094908,Christensen; Henrik I,9999,0,9999,0
1653467223926,CSE 293,005,094909,Cottrell; Garrison W,9999,0,9999,0
1653467223926,CSE 293,006,094910,Deutsch; Alin Bernard,9999,0,9999,0
1653467223926,CSE 293,007,094911,Esmaeilzadeh; Hadi,9999,0,9999,0
1653467223926,CSE 293,008,094912,Freund; Yoav,9999,0,9999,0
1653467223926,CSE 293,009,094913,Griswold; William G.,9999,0,9999,0
1653467223926,CSE 293,010,094914,Gymrek; Melissa Ann,9999,0,9999,0
1653467223926,CSE 293,011,094915,Heninger; Nadia A,9999,0,9999,0
1653467223926,CSE 293,012,094916,Impagliazzo; Russell,9999,0,9999,0
1653467223926,CSE 293,013,094917,Jhala; Ranjit,9999,0,9999,0
1653467223926,CSE 293,014,094918,Kahng; Andrew Byun,9999,0,9999,0
1653467223926,CSE 293,015,094919,Kane; Daniel Mertz,9999,0,9999,0
1653467223926,CSE 293,016,094920,Kriegman; David J,9999,0,9999,0
1653467223926,CSE 293,017,094921,Kumar; Arun Kumar,9999,0,9999,0
1653467223926,CSE 293,018,094922,Lerner; Sorin,9999,0,9999,0
1653467223926,CSE 293,019,094923,Lovett; Shachar,9999,0,9999,0
1653467223926,CSE 293,020,094924,McAuley; Julian John,9999,0,9999,0
1653467223926,CSE 293,021,094925,Micciancio; Daniele,9999,0,9999,0
1653467223926,CSE 293,022,094926,Orailoglu; Alex,9999,0,9999,0
1653467223926,CSE 293,023,094927,Paturi; Ramamohan,9999,0,9999,0
1653467223926,CSE 293,024,094928,Polikarpova; Nadezhda,9999,0,9999,0
1653467223926,CSE 293,025,094929,Politz; Joseph Gibbs,9999,0,9999,0
1653467223926,CSE 293,026,094930,Porter; George M,9999,0,9999,0
1653467223926,CSE 293,027,094931,Porter; Leonard Emerson,9999,0,9999,0
1653467223926,CSE 293,028,094932,Ramamoorthi; Ravi,9999,0,9999,0
1653467223926,CSE 293,029,094933,Sahoo; Debashis,9999,0,9999,0
1653467223926,CSE 293,030,094934,Saul; Lawrence,9999,0,9999,0
1653467223926,CSE 293,031,094935,Savage; Stefan,9999,0,9999,0
1653467223926,CSE 293,032,094936,Schulze; Jurgen P.,9999,0,9999,0
1653467223926,CSE 293,033,094937,Snoeren; Alex C.,9999,0,9999,0
1653467223926,CSE 293,034,094938,Shang; Jingbo,9999,0,9999,0
1653467223926,CSE 293,035,094939,Stefan; Deian,9999,0,9999,0
1653467223926,CSE 293,036,094940,Su; Hao,9999,0,9999,0
1653467223926,CSE 293,037,094941,Swanson; Steven James,9999,0,9999,0
1653467223926,CSE 293,038,094942,Tullsen; Dean Michael,9999,0,9999,0
1653467223926,CSE 293,039,094943,Voelker; Geoffrey M.,9999,0,9999,0
1653467223926,CSE 293,040,094944,Zhao; Jishen,9999,0,9999,0
1653467223926,CSE 293,041,094945,Zhou; Yuan-Yuan,9999,0,9999,0
1653467223926,CSE 293,042,094946,Gao; Sicun,9998,0,9999,1
1653467223926,CSE 293,043,094947,Weibel; Nadir,9999,0,9999,0
1653467223926,CSE 293,044,094948,Gupta; Rajesh K.,9999,0,9999,0
1653467224450,CSE 294,A00,090143,Porter; George M,9,0,10,1
1653467224980,DSE 200,A00,091799,Staff,50,0,50,0
1653467225502,DSE 203,A00,091800,Gupta; Amarnath,30,0,30,0
1653467226025,DSE 250,A00,091801,Deutsch; Alin Bernard,30,0,30,0
1653467226559,DSE 290,A00,091802,Altintas De Callaf; Ilkay,50,0,50,0
1653467227108,ECE 200,001,091003,Antipa; Nicholas A,9999,0,9999,0
1653467227108,ECE 200,002,091004,Atanasov; Nikolay A.,9999,0,9999,0
1653467227108,ECE 200,003,091005,Bharadia; Dinesh,9999,0,9999,0
1653467227108,ECE 200,004,091006,Cheng; Chung Kuan,9999,0,9999,0
1653467227108,ECE 200,005,091007,Cosman; Pamela C.,9999,0,9999,0
1653467227108,ECE 200,006,091008,Staff,9999,0,9999,0
1653467227108,ECE 200,007,091009,Dayeh; Shadi Ahmad,9999,0,9999,0
1653467227108,ECE 200,008,091010,Fainman; Yeshaiahu,9999,0,9999,0
1653467227108,ECE 200,009,091011,Ford; Joseph Earl,9999,0,9999,0
1653467227108,ECE 200,010,091012,Franceschetti; Massimo,9999,0,9999,0
1653467227108,ECE 200,011,091013,Fullerton; Eric E,9999,0,9999,0
1653467227108,ECE 200,012,091014,Galton; Ian A,9999,0,9999,0
1653467227108,ECE 200,013,091015,Gilja; Vikash,9999,0,9999,0
1653467227108,ECE 200,014,091016,Hall; Drew A.,9999,0,9999,0
1653467227108,ECE 200,015,091017,Hsueh; Tzu-Chien,9999,0,9999,0
1653467227108,ECE 200,016,091018,Javidi; Tara,9999,0,9999,0
1653467227108,ECE 200,017,091019,Kahng; Andrew Byun,9999,0,9999,0
1653467227108,ECE 200,018,091020,Kim; Young-Han,9999,0,9999,0
1653467227108,ECE 200,019,091021,Koushanfar; Farinaz,9999,0,9999,0
1653467227108,ECE 200,020,091022,Kuzum; Duygu,9999,0,9999,0
1653467227108,ECE 200,021,091023,Le; Hanh-Phuc,9999,0,9999,0
1653467227108,ECE 200,022,091024,Lin; Bill,9999,0,9999,0
1653467227108,ECE 200,023,091025,Liu; Zhaowei,9999,0,9999,0
1653467227108,ECE 200,024,091026,Lo; Yu-Hwa,9999,0,9999,0
1653467227108,ECE 200,025,091027,Lomakin; Vitaliy,9999,0,9999,0
1653467227108,ECE 200,026,091028,Mercier; Patrick Philip,9999,0,9999,0
1653467227108,ECE 200,027,091029,Meyer; Florian,9999,0,9999,0
1653467227108,ECE 200,028,091030,Milstein; Laurence B.,9999,0,9999,0
1653467227108,ECE 200,029,091031,Mir Arabbaygi; Siavash,9999,0,9999,0
1653467227108,ECE 200,030,091032,Mookherjea; Shayan,9999,0,9999,0
1653467227108,ECE 200,031,091033,Morris; Karcher William,9999,0,9999,0
1653467227108,ECE 200,032,091034,Ng; Tse Nga,9999,0,9999,0
1653467227108,ECE 200,033,091035,Nguyen; Truong Quang,9999,0,9999,0
1653467227108,ECE 200,034,091036,Nomura; Kenji,9999,0,9999,0
1653467227108,ECE 200,035,091037,Orlitsky; Alon,9999,0,9999,0
1653467227108,ECE 200,036,091038,Pal; Piya,9999,0,9999,0
1653467227108,ECE 200,037,091039,Papen; George C.,9999,0,9999,0
1653467227108,ECE 200,038,091040,Radic; Stojan,9999,0,9999,0
1653467227108,ECE 200,039,091041,Rao; Bhaskar D.,9999,0,9999,0
1653467227108,ECE 200,040,091042,Rao; Ramesh R,9999,0,9999,0
1653467227108,ECE 200,041,091043,Rebeiz; Gabriel,9999,0,9999,0
1653467227108,ECE 200,042,091044,Sanford; John R,9999,0,9999,0
1653467227108,ECE 200,043,091045,Siegel; Paul H.,9999,0,9999,0
1653467227108,ECE 200,044,091046,Sievenpiper; Daniel F.,9999,0,9999,0
1653467227108,ECE 200,045,091047,Sworder; David D.,9999,0,9999,0
1653467227108,ECE 200,046,091048,Taur; Yuan,9999,0,9999,0
1653467227108,ECE 200,047,091049,Touri; Behrouz,9999,0,9999,0
1653467227108,ECE 200,048,091050,Trivedi; Mohan M.,9999,0,9999,0
1653467227108,ECE 200,049,091051,Vardy; Alexander,9999,0,9999,0
1653467227108,ECE 200,050,091052,Vasconcelos; Nuno,9999,0,9999,0
1653467227108,ECE 200,051,091053,Wang; Xiaolong,9999,0,9999,0
1653467227108,ECE 200,052,091054,Xie; Pengtao,9999,0,9999,0
1653467227108,ECE 200,053,091055,Yip; Michael,9999,0,9999,0
1653467227108,ECE 200,054,091056,Zeger; Kenneth A.,9999,0,9999,0
1653467227108,ECE 200,055,091057,Zhang; Xinyu,9999,0,9999,0
1653467227108,ECE 200,056,091058,Turakhia; Yatish Girish,9999,0,9999,0
1653467227108,ECE 200,057,091059,Kang; Mingu,9999,0,9999,0
1653467227108,ECE 200,058,091060,Shi; Yuanyuan,9999,0,9999,0
1653467227108,ECE 200,059,091061,Wang; Edward Jay,9999,0,9999,0
1653467227108,ECE 200,060,091062,Zheng; Yang,9999,0,9999,0
1653467227636,ECE 203,A00,091065,Mercier; Patrick Philip,0,0,0,0
1653467228167,ECE 207A,A00,091605,Liu; Thomas Tao-Ming,0,0,0,0
1653467228692,ECE 212AN,A00,091068,Nomura; Kenji,0,0,0,0
1653467229214,ECE 222A,A00,091069,Rebeiz; Gabriel,0,0,0,0
1653467229738,ECE 225A,A00,091070,Orlitsky; Alon,0,0,0,0
1653467230270,ECE 230A,A00,091071,Nomura; Kenji,0,0,0,0
1653467230810,ECE 236A,A00,091072,Dayeh; Shadi Ahmad,0,0,0,0
1653467231343,ECE 238A,A00,091073,Luo; Jian,0,0,0,0
1653467231343,ECE 238A,B00,091074,Luo; Jian,0,0,0,0
1653467231868,ECE 240A,A00,091075,Radic; Stojan,0,0,0,0
1653467232392,ECE 247A,A00,091592,Shi; Lingyan,0,0,0,0
1653467232925,ECE 250,A00,091076,Touri; Behrouz,0,0,0,0
1653467233448,ECE 251C,A00,091078,Nguyen; Truong Quang,0,0,0,0
1653467233971,ECE 253,A00,091079,Cosman; Pamela C.,0,0,0,0
1653467234493,ECE 255A,A00,091080,Orlitsky; Alon,0,0,0,0
1653467235089,ECE 257A,A00,091081,Zhang; Xinyu,0,0,0,0
1653467235612,ECE 260A,A01,091084,Eldon; John,0,0,0,0
1653467236141,ECE 264C,A00,091085,Galton; Ian A,0,0,0,0
1653467236664,ECE 265C,A00,094889,Presti; Calogero Davide,0,0,0,9
1653467237192,ECE 266,A01,091087,Hall; Drew A.,0,0,0,0
1653467238237,ECE 271A,A00,091090,Vasconcelos; Nuno,0,0,0,0
1653467238760,ECE 272B,A00,091091,Sworder; David D.,0,0,0,0
1653467239287,ECE 275A,A00,091092,Meyer; Florian,0,0,0,0
1653467239810,ECE 277,A00,091093,An; Cheolhong,0,0,0,0
1653467240335,ECE 283,A00,091094,Le; Hanh-Phuc,0,0,0,0
1653467240858,ECE 284,A00,091095,Kang; Mingu,0,0,0,0
1653467240858,ECE 284,B00,091096,Wang; Edward Jay,0,0,0,0
1653467241382,ECE 285,A00,094334,Touri; Behrouz,0,0,0,0
1653467241906,ECE 289,A00,091097,Whelan; David Arthur,0,0,0,0
1653467242432,MATH 200A,A00,087414,Salehi Golsefidy; Alireza,7,0,8,1
1653467242955,MATH 202A,A00,087415,Gill; Philip E.,3,0,8,5
1653467243477,MATH 203A,A00,087416,Oprea; Dragos N.,6,0,8,2
1653467244003,MATH 204A,A00,087417,Kedlaya; Kiran S.,6,0,8,2
1653467244525,MATH 205,A00,087418,Sorensen; Claus M,6,0,8,2
1653467245063,MATH 206A,A00,087419,Izadi; Elham,7,0,8,1
1653467245585,MATH 207A,A00,087420,Mohammadi; Amir,6,0,8,2
1653467246112,MATH 208,A00,087421,Staff,9,0,10,1
1653467246638,MATH 209,A00,087422,Staff,10,0,10,0
1653467247165,MATH 218,A00,087423,Staff,10,0,10,0
1653467247688,MATH 220A,A00,087424,Novak; Jonathan I,7,0,8,1
1653467248214,MATH 231A,A00,087425,Bejenaru; Ioan,3,0,8,5
1653467248743,MATH 240A,A00,087426,Ebenfelt; Peter F,5,0,8,3
1653467249277,MATH 243,A00,087427,Staff,9,0,10,1
1653467249802,MATH 248,A00,087429,Staff,10,0,10,0
1653467250329,MATH 250A,A00,087430,Spolaor; Luca,4,0,8,4
1653467250856,MATH 257A,A00,087431,Spolaor; Luca,7,0,8,1
1653467251379,MATH 258,A00,087432,Staff,9,0,10,1
1653467251906,MATH 264A,A00,087433,Warnke; Lutz Peter,5,0,8,3
1653467252428,MATH 268,A00,087434,Staff,15,0,15,0
1653467252951,MATH 269,A00,087435,Staff,14,0,15,1
1653467253476,MATH 270A,A00,087436,Nie; Jiawang,0,0,8,8
1653467254002,MATH 272A,A00,087437,Tian; Xiaochuan,1,0,8,7
1653467254529,MATH 274,A01,087439,Cheng; Li-Tien,9,0,10,1
1653467254529,MATH 274,A02,087440,Cheng; Li-Tien,10,0,10,0
1653467255053,MATH 278A,A00,087441,Staff,8,0,10,2
1653467255575,MATH 278B,A00,087442,Staff,8,0,10,2
1653467256096,MATH 278C,A00,087443,Staff,8,0,10,2
1653467256623,MATH 280A,A00,087444,Zheng; Tianyi,0,0,8,8
1653467257151,MATH 281A,A00,087445,Bradic; Jelena,0,0,8,8
1653467257680,MATH 282A,A00,087446,Zhang; Danna,0,0,8,8
1653467258203,MATH 283,A00,087447,Tesler; Glenn,0,0,0,14
1653467258726,MATH 286,A00,087448,Kemp; Todd Aahron,5,0,8,3
1653467259248,MATH 287D,A00,087449,Bradic; Jelena,8,0,8,0
1653467259771,MATH 288,A00,087450,Staff,14,0,15,1
1653467259771,MATH 288,B00,087451,Staff,15,0,15,0
1653467259771,MATH 288,C00,087452,Staff,15,0,15,0
1653467260298,MATH 290A,A00,087453,Xu; Zhouli,7,0,8,1
1653467260823,MATH 291A,A00,087454,Xu; Zhouli,7,0,8,1
1653467261344,MATH 292,A00,087455,Staff,10,0,10,0
1653467261868,MATH 295,A00,087456,Staff,50,0,50,0
1653467262391,MATH 297,001,087457,Staff,998,0,999,1
1653467822044,COGS 200,A01,087991,Staff,47,0,50,3
1653467822571,COGS 201,A01,094504,Rangel; Lara M,17,0,25,8
1653467823094,COGS 203,A00,087992,Coulson; Seana M,18,0,20,2
1653467823628,COGS 210A,001,087993,Greene; Deanna Jacquelyn,9998,0,9999,1
1653467823628,COGS 210A,002,087994,Saygin; Ayse P,9999,0,9999,0
1653467823628,COGS 210A,003,087995,Xia; Haijun,9999,0,9999,0
1653467823628,COGS 210A,004,087996,Nitz; Douglas A.,9999,0,9999,0
1653467823628,COGS 210A,005,087997,Hollan; James D.,9999,0,9999,0
1653467823628,COGS 210A,006,087998,Deak; Gedeon O.,9998,0,9999,1
1653467823628,COGS 210A,007,087999,Rossano; Federico,9999,0,9999,0
1653467824153,COGS 211A,A00,088000,Coulson; Seana M,9997,0,9999,2
1653467824676,COGS 229,A00,088002,Staff,23,0,25,2
1653467825201,COGS 260,B00,094231,Staff,17,0,20,3
1653467825201,COGS 260,A00,088004,Nitz; Douglas A.,9998,0,9999,1
1653467825725,CSE 202,A00,090110,Paturi; Ramamohan,0,0,0,0
1653467825725,CSE 202,B00,090111,Paturi; Ramamohan,0,0,0,0
1653467826251,CSE 207B,A00,090112,Heninger; Nadia A,0,0,0,0
1653467826772,CSE 208,A00,094858,Micciancio; Daniele,0,0,0,0
1653467827300,CSE 210,A00,090113,Powell; Thomas Allan,0,0,0,0
1653467827823,CSE 219,A00,090898,Staff,0,0,0,0
1653467828347,CSE 221,A00,090114,Zhou; Yuan-Yuan,0,0,0,0
1653467828870,CSE 229A,A00,090115,Porter; George M,0,0,0,0
1653467829393,CSE 229C,A00,090116,Savage; Stefan,0,0,0,0
1653467829917,CSE 230,A00,090117,Jhala; Ranjit,0,0,0,0
1653467830439,CSE 232,A00,090118,Papakonstantinou; Yannis,0,0,0,0
1653467830965,CSE 239A,A00,090121,Kumar; Arun Kumar,0,0,0,0
1653467831489,CSE 239B,A00,090122,Jhala; Ranjit,0,0,0,0
1653467832012,CSE 240A,A00,090123,Zhao; Jishen,0,0,189,189
1653467832536,CSE 243A,A00,090124,Orailoglu; Alex,0,0,15,15
1653467833062,CSE 249B,A00,090125,Kahng; Andrew Byun,13,0,20,7
1653467833588,CSE 250A,A00,090126,Berg-Kirkpatrick; Taylor D,0,0,0,0
1653467834112,CSE 252A,A00,090127,Ochoa; Benjamin Lawrence,0,0,0,0
1653467834635,CSE 258,A01,090129,McAuley; Julian John,0,0,0,0
1653467835160,CSE 258R,A01,090131,McAuley; Julian John,0,0,0,0
1653467835681,CSE 274,A00,090132,Ramamoorthi; Ravi,0,0,0,0
1653467836204,CSE 276A,A00,090133,Christensen; Henrik I,0,0,0,0
1653467836730,CSE 276C,A00,090134,Christensen; Henrik I,0,0,0,0
1653467837255,CSE 290,A00,090135,Bafna; Vineet,0,0,0,0
1653467837255,CSE 290,B00,090136,Ramamoorthi; Ravi,0,0,0,0
1653467837255,CSE 290,C00,090137,Li; Tzumao,9,0,10,1
1653467837255,CSE 290,D00,090138,Zhou; Yuan-Yuan,10,0,10,0
1653467837255,CSE 290,E00,090139,Christensen; Henrik I,10,0,10,0
1653467837255,CSE 290,F00,094053,Shalev; Aaron D,0,0,0,0
1653467837786,CSE 291,A00,090140,Munyaka; Imani N. S.,0,0,0,0
1653467837786,CSE 291,B00,094880,Yu; Qi,0,0,0,0
1653467837786,CSE 291,C00,090142,Pannuto; Patrick William,0,0,0,0
1653467837786,CSE 291,D00,094881,Zhang; Yiying,0,0,0,0
1653467837786,CSE 291,E00,095118,Su; Hao,0,0,0,0
1653467838319,CSE 293,001,094905,Bafna; Vineet,9999,0,9999,0
1653467838319,CSE 293,002,094906,Bellare; Mihir,9999,0,9999,0
1653467838319,CSE 293,003,094907,Berg-Kirkpatrick; Taylor D,9999,0,9999,0
1653467838319,CSE 293,004,094908,Christensen; Henrik I,9999,0,9999,0
1653467838319,CSE 293,005,094909,Cottrell; Garrison W,9999,0,9999,0
1653467838319,CSE 293,006,094910,Deutsch; Alin Bernard,9999,0,9999,0
1653467838319,CSE 293,007,094911,Esmaeilzadeh; Hadi,9999,0,9999,0
1653467838319,CSE 293,008,094912,Freund; Yoav,9999,0,9999,0
1653467838319,CSE 293,009,094913,Griswold; William G.,9999,0,9999,0
1653467838319,CSE 293,010,094914,Gymrek; Melissa Ann,9999,0,9999,0
1653467838319,CSE 293,011,094915,Heninger; Nadia A,9999,0,9999,0
1653467838319,CSE 293,012,094916,Impagliazzo; Russell,9999,0,9999,0
1653467838319,CSE 293,013,094917,Jhala; Ranjit,9999,0,9999,0
1653467838319,CSE 293,014,094918,Kahng; Andrew Byun,9999,0,9999,0
1653467838319,CSE 293,015,094919,Kane; Daniel Mertz,9999,0,9999,0
1653467838319,CSE 293,016,094920,Kriegman; David J,9999,0,9999,0
1653467838319,CSE 293,017,094921,Kumar; Arun Kumar,9999,0,9999,0
1653467838319,CSE 293,018,094922,Lerner; Sorin,9999,0,9999,0
1653467838319,CSE 293,019,094923,Lovett; Shachar,9999,0,9999,0
1653467838319,CSE 293,020,094924,McAuley; Julian John,9999,0,9999,0
1653467838319,CSE 293,021,094925,Micciancio; Daniele,9999,0,9999,0
1653467838319,CSE 293,022,094926,Orailoglu; Alex,9999,0,9999,0
1653467838319,CSE 293,023,094927,Paturi; Ramamohan,9999,0,9999,0
1653467838319,CSE 293,024,094928,Polikarpova; Nadezhda,9999,0,9999,0
1653467838319,CSE 293,025,094929,Politz; Joseph Gibbs,9999,0,9999,0
1653467838319,CSE 293,026,094930,Porter; George M,9999,0,9999,0
1653467838319,CSE 293,027,094931,Porter; Leonard Emerson,9999,0,9999,0
1653467838319,CSE 293,028,094932,Ramamoorthi; Ravi,9999,0,9999,0
1653467838319,CSE 293,029,094933,Sahoo; Debashis,9999,0,9999,0
1653467838319,CSE 293,030,094934,Saul; Lawrence,9999,0,9999,0
1653467838319,CSE 293,031,094935,Savage; Stefan,9999,0,9999,0
1653467838319,CSE 293,032,094936,Schulze; Jurgen P.,9999,0,9999,0
1653467838319,CSE 293,033,094937,Snoeren; Alex C.,9999,0,9999,0
1653467838319,CSE 293,034,094938,Shang; Jingbo,9999,0,9999,0
1653467838319,CSE 293,035,094939,Stefan; Deian,9999,0,9999,0
1653467838319,CSE 293,036,094940,Su; Hao,9999,0,9999,0
1653467838319,CSE 293,037,094941,Swanson; Steven James,9999,0,9999,0
1653467838319,CSE 293,038,094942,Tullsen; Dean Michael,9999,0,9999,0
1653467838319,CSE 293,039,094943,Voelker; Geoffrey M.,9999,0,9999,0
1653467838319,CSE 293,040,094944,Zhao; Jishen,9999,0,9999,0
1653467838319,CSE 293,041,094945,Zhou; Yuan-Yuan,9999,0,9999,0
1653467838319,CSE 293,042,094946,Gao; Sicun,9998,0,9999,1
1653467838319,CSE 293,043,094947,Weibel; Nadir,9999,0,9999,0
1653467838319,CSE 293,044,094948,Gupta; Rajesh K.,9999,0,9999,0
1653467838845,CSE 294,A00,090143,Porter; George M,9,0,10,1
1653467839367,DSE 200,A00,091799,Staff,50,0,50,0
1653467839892,DSE 203,A00,091800,Gupta; Amarnath,30,0,30,0
1653467840414,DSE 250,A00,091801,Deutsch; Alin Bernard,30,0,30,0
1653467840937,DSE 290,A00,091802,Altintas De Callaf; Ilkay,50,0,50,0
1653467841512,ECE 200,001,091003,Antipa; Nicholas A,9999,0,9999,0
1653467841512,ECE 200,002,091004,Atanasov; Nikolay A.,9999,0,9999,0
1653467841512,ECE 200,003,091005,Bharadia; Dinesh,9999,0,9999,0
1653467841512,ECE 200,004,091006,Cheng; Chung Kuan,9999,0,9999,0
1653467841512,ECE 200,005,091007,Cosman; Pamela C.,9999,0,9999,0
1653467841512,ECE 200,006,091008,Staff,9999,0,9999,0
1653467841512,ECE 200,007,091009,Dayeh; Shadi Ahmad,9999,0,9999,0
1653467841512,ECE 200,008,091010,Fainman; Yeshaiahu,9999,0,9999,0
1653467841512,ECE 200,009,091011,Ford; Joseph Earl,9999,0,9999,0
1653467841512,ECE 200,010,091012,Franceschetti; Massimo,9999,0,9999,0
1653467841512,ECE 200,011,091013,Fullerton; Eric E,9999,0,9999,0
1653467841512,ECE 200,012,091014,Galton; Ian A,9999,0,9999,0
1653467841512,ECE 200,013,091015,Gilja; Vikash,9999,0,9999,0
1653467841512,ECE 200,014,091016,Hall; Drew A.,9999,0,9999,0
1653467841512,ECE 200,015,091017,Hsueh; Tzu-Chien,9999,0,9999,0
1653467841512,ECE 200,016,091018,Javidi; Tara,9999,0,9999,0
1653467841512,ECE 200,017,091019,Kahng; Andrew Byun,9999,0,9999,0
1653467841512,ECE 200,018,091020,Kim; Young-Han,9999,0,9999,0
1653467841512,ECE 200,019,091021,Koushanfar; Farinaz,9999,0,9999,0
1653467841512,ECE 200,020,091022,Kuzum; Duygu,9999,0,9999,0
1653467841512,ECE 200,021,091023,Le; Hanh-Phuc,9999,0,9999,0
1653467841512,ECE 200,022,091024,Lin; Bill,9999,0,9999,0
1653467841512,ECE 200,023,091025,Liu; Zhaowei,9999,0,9999,0
1653467841512,ECE 200,024,091026,Lo; Yu-Hwa,9999,0,9999,0
1653467841512,ECE 200,025,091027,Lomakin; Vitaliy,9999,0,9999,0
1653467841512,ECE 200,026,091028,Mercier; Patrick Philip,9999,0,9999,0
1653467841512,ECE 200,027,091029,Meyer; Florian,9999,0,9999,0
1653467841512,ECE 200,028,091030,Milstein; Laurence B.,9999,0,9999,0
1653467841512,ECE 200,029,091031,Mir Arabbaygi; Siavash,9999,0,9999,0
1653467841512,ECE 200,030,091032,Mookherjea; Shayan,9999,0,9999,0
1653467841512,ECE 200,031,091033,Morris; Karcher William,9999,0,9999,0
1653467841512,ECE 200,032,091034,Ng; Tse Nga,9999,0,9999,0
1653467841512,ECE 200,033,091035,Nguyen; Truong Quang,9999,0,9999,0
1653467841512,ECE 200,034,091036,Nomura; Kenji,9999,0,9999,0
1653467841512,ECE 200,035,091037,Orlitsky; Alon,9999,0,9999,0
1653467841512,ECE 200,036,091038,Pal; Piya,9999,0,9999,0
1653467841512,ECE 200,037,091039,Papen; George C.,9999,0,9999,0
1653467841512,ECE 200,038,091040,Radic; Stojan,9999,0,9999,0
1653467841512,ECE 200,039,091041,Rao; Bhaskar D.,9999,0,9999,0
1653467841512,ECE 200,040,091042,Rao; Ramesh R,9999,0,9999,0
1653467841512,ECE 200,041,091043,Rebeiz; Gabriel,9999,0,9999,0
1653467841512,ECE 200,042,091044,Sanford; John R,9999,0,9999,0
1653467841512,ECE 200,043,091045,Siegel; Paul H.,9999,0,9999,0
1653467841512,ECE 200,044,091046,Sievenpiper; Daniel F.,9999,0,9999,0
1653467841512,ECE 200,045,091047,Sworder; David D.,9999,0,9999,0
1653467841512,ECE 200,046,091048,Taur; Yuan,9999,0,9999,0
1653467841512,ECE 200,047,091049,Touri; Behrouz,9999,0,9999,0
1653467841512,ECE 200,048,091050,Trivedi; Mohan M.,9999,0,9999,0
1653467841512,ECE 200,049,091051,Vardy; Alexander,9999,0,9999,0
1653467841512,ECE 200,050,091052,Vasconcelos; Nuno,9999,0,9999,0
1653467841512,ECE 200,051,091053,Wang; Xiaolong,9999,0,9999,0
1653467841512,ECE 200,052,091054,Xie; Pengtao,9999,0,9999,0
1653467841512,ECE 200,053,091055,Yip; Michael,9999,0,9999,0
1653467841512,ECE 200,054,091056,Zeger; Kenneth A.,9999,0,9999,0
1653467841512,ECE 200,055,091057,Zhang; Xinyu,9999,0,9999,0
1653467841512,ECE 200,056,091058,Turakhia; Yatish Girish,9999,0,9999,0
1653467841512,ECE 200,057,091059,Kang; Mingu,9999,0,9999,0
1653467841512,ECE 200,058,091060,Shi; Yuanyuan,9999,0,9999,0
1653467841512,ECE 200,059,091061,Wang; Edward Jay,9999,0,9999,0
1653467841512,ECE 200,060,091062,Zheng; Yang,9999,0,9999,0
1653467842036,ECE 203,A00,091065,Mercier; Patrick Philip,0,0,0,0
1653467842564,ECE 207A,A00,091605,Liu; Thomas Tao-Ming,0,0,0,0
1653467843089,ECE 212AN,A00,091068,Nomura; Kenji,0,0,0,0
1653467843613,ECE 222A,A00,091069,Rebeiz; Gabriel,0,0,0,0
1653467844141,ECE 225A,A00,091070,Orlitsky; Alon,0,0,0,0
1653467844667,ECE 230A,A00,091071,Nomura; Kenji,0,0,0,0
1653467845202,ECE 236A,A00,091072,Dayeh; Shadi Ahmad,0,0,0,0
1653467845726,ECE 238A,A00,091073,Luo; Jian,0,0,0,0
1653467845726,ECE 238A,B00,091074,Luo; Jian,0,0,0,0
1653467846249,ECE 240A,A00,091075,Radic; Stojan,0,0,0,0
1653467846772,ECE 247A,A00,091592,Shi; Lingyan,0,0,0,0
1653467847294,ECE 250,A00,091076,Touri; Behrouz,0,0,0,0
1653467847818,ECE 251C,A00,091078,Nguyen; Truong Quang,0,0,0,0
1653467848355,ECE 253,A00,091079,Cosman; Pamela C.,0,0,0,0
1653467848877,ECE 255A,A00,091080,Orlitsky; Alon,0,0,0,0
1653467849411,ECE 257A,A00,091081,Zhang; Xinyu,0,0,0,0
1653467849937,ECE 260A,A01,091084,Eldon; John,0,0,0,0
1653467850464,ECE 264C,A00,091085,Galton; Ian A,0,0,0,0
1653467850988,ECE 265C,A00,094889,Presti; Calogero Davide,0,0,0,9
1653467851511,ECE 266,A01,091087,Hall; Drew A.,0,0,0,0
1653467852558,ECE 271A,A00,091090,Vasconcelos; Nuno,0,0,0,0
1653467853084,ECE 272B,A00,091091,Sworder; David D.,0,0,0,0
1653467853607,ECE 275A,A00,091092,Meyer; Florian,0,0,0,0
1653467854131,ECE 277,A00,091093,An; Cheolhong,0,0,0,0
1653467854665,ECE 283,A00,091094,Le; Hanh-Phuc,0,0,0,0
1653467855197,ECE 284,A00,091095,Kang; Mingu,0,0,0,0
1653467855197,ECE 284,B00,091096,Wang; Edward Jay,0,0,0,0
1653467855719,ECE 285,A00,094334,Touri; Behrouz,0,0,0,0
1653467856248,ECE 289,A00,091097,Whelan; David Arthur,0,0,0,0
1653467856776,MATH 200A,A00,087414,Salehi Golsefidy; Alireza,7,0,8,1
1653467857302,MATH 202A,A00,087415,Gill; Philip E.,3,0,8,5
1653467857828,MATH 203A,A00,087416,Oprea; Dragos N.,6,0,8,2
1653467858353,MATH 204A,A00,087417,Kedlaya; Kiran S.,6,0,8,2
1653467858880,MATH 205,A00,087418,Sorensen; Claus M,6,0,8,2
1653467859402,MATH 206A,A00,087419,Izadi; Elham,7,0,8,1
1653467859928,MATH 207A,A00,087420,Mohammadi; Amir,6,0,8,2
1653467860453,MATH 208,A00,087421,Staff,9,0,10,1
1653467860978,MATH 209,A00,087422,Staff,10,0,10,0
1653467861500,MATH 218,A00,087423,Staff,10,0,10,0
1653467862024,MATH 220A,A00,087424,Novak; Jonathan I,7,0,8,1
1653467862550,MATH 231A,A00,087425,Bejenaru; Ioan,3,0,8,5
1653467863080,MATH 240A,A00,087426,Ebenfelt; Peter F,5,0,8,3
1653467863603,MATH 243,A00,087427,Staff,9,0,10,1
1653467864130,MATH 248,A00,087429,Staff,10,0,10,0
1653467864653,MATH 250A,A00,087430,Spolaor; Luca,4,0,8,4
1653467865179,MATH 257A,A00,087431,Spolaor; Luca,7,0,8,1
1653467865702,MATH 258,A00,087432,Staff,9,0,10,1
1653467866229,MATH 264A,A00,087433,Warnke; Lutz Peter,5,0,8,3
1653467866751,MATH 268,A00,087434,Staff,15,0,15,0
1653467867277,MATH 269,A00,087435,Staff,14,0,15,1
1653467867809,MATH 270A,A00,087436,Nie; Jiawang,0,0,8,8
1653467868339,MATH 272A,A00,087437,Tian; Xiaochuan,1,0,8,7
1653467868861,MATH 274,A01,087439,Cheng; Li-Tien,9,0,10,1
1653467868861,MATH 274,A02,087440,Cheng; Li-Tien,10,0,10,0
1653467869389,MATH 278A,A00,087441,Staff,8,0,10,2
1653467869913,MATH 278B,A00,087442,Staff,8,0,10,2
1653467870435,MATH 278C,A00,087443,Staff,8,0,10,2
1653467870958,MATH 280A,A00,087444,Zheng; Tianyi,0,0,8,8
1653467871485,MATH 281A,A00,087445,Bradic; Jelena,0,0,8,8
1653467872017,MATH 282A,A00,087446,Zhang; Danna,0,0,8,8
1653467872539,MATH 283,A00,087447,Tesler; Glenn,0,0,0,14
1653467873063,MATH 286,A00,087448,Kemp; Todd Aahron,5,0,8,3
1653467873589,MATH 287D,A00,087449,Bradic; Jelena,8,0,8,0
1653467874112,MATH 288,A00,087450,Staff,14,0,15,1
1653467874112,MATH 288,B00,087451,Staff,15,0,15,0
1653467874112,MATH 288,C00,087452,Staff,15,0,15,0
1653467874656,MATH 290A,A00,087453,Xu; Zhouli,7,0,8,1
1653467875252,MATH 291A,A00,087454,Xu; Zhouli,7,0,8,1
1653467875776,MATH 292,A00,087455,Staff,10,0,10,0
1653467876299,MATH 295,A00,087456,Staff,50,0,50,0
1653467876822,MATH 297,001,087457,Staff,998,0,999,1
1653468436348,COGS 200,A01,087991,Staff,47,0,50,3
1653468436878,COGS 201,A01,094504,Rangel; Lara M,17,0,25,8
1653468437403,COGS 203,A00,087992,Coulson; Seana M,18,0,20,2
1653468437931,COGS 210A,001,087993,Greene; Deanna Jacquelyn,9998,0,9999,1
1653468437931,COGS 210A,002,087994,Saygin; Ayse P,9999,0,9999,0
1653468437931,COGS 210A,003,087995,Xia; Haijun,9999,0,9999,0
1653468437931,COGS 210A,004,087996,Nitz; Douglas A.,9999,0,9999,0
1653468437931,COGS 210A,005,087997,Hollan; James D.,9999,0,9999,0
1653468437931,COGS 210A,006,087998,Deak; Gedeon O.,9998,0,9999,1
1653468437931,COGS 210A,007,087999,Rossano; Federico,9999,0,9999,0
1653468438454,COGS 211A,A00,088000,Coulson; Seana M,9997,0,9999,2
1653468438977,COGS 229,A00,088002,Staff,23,0,25,2
1653468439502,COGS 260,B00,094231,Staff,17,0,20,3
1653468439502,COGS 260,A00,088004,Nitz; Douglas A.,9998,0,9999,1
1653468440035,CSE 202,A00,090110,Paturi; Ramamohan,0,0,0,0
1653468440035,CSE 202,B00,090111,Paturi; Ramamohan,0,0,0,0
1653468440558,CSE 207B,A00,090112,Heninger; Nadia A,0,0,0,0
1653468441089,CSE 208,A00,094858,Micciancio; Daniele,0,0,0,0
1653468441614,CSE 210,A00,090113,Powell; Thomas Allan,0,0,0,0
1653468442141,CSE 219,A00,090898,Staff,0,0,0,0
1653468442669,CSE 221,A00,090114,Zhou; Yuan-Yuan,0,0,0,0
1653468443191,CSE 229A,A00,090115,Porter; George M,0,0,0,0
1653468443727,CSE 229C,A00,090116,Savage; Stefan,0,0,0,0
1653468444259,CSE 230,A00,090117,Jhala; Ranjit,0,0,0,0
1653468444784,CSE 232,A00,090118,Papakonstantinou; Yannis,0,0,0,0
1653468445308,CSE 239A,A00,090121,Kumar; Arun Kumar,0,0,0,0
1653468445831,CSE 239B,A00,090122,Jhala; Ranjit,0,0,0,0
1653468446359,CSE 240A,A00,090123,Zhao; Jishen,0,0,189,189
1653468446891,CSE 243A,A00,090124,Orailoglu; Alex,0,0,15,15
1653468447414,CSE 249B,A00,090125,Kahng; Andrew Byun,13,0,20,7
1653468447937,CSE 250A,A00,090126,Berg-Kirkpatrick; Taylor D,0,0,0,0
1653468448461,CSE 252A,A00,090127,Ochoa; Benjamin Lawrence,0,0,0,0
1653468448985,CSE 258,A01,090129,McAuley; Julian John,0,0,0,0
1653468449513,CSE 258R,A01,090131,McAuley; Julian John,0,0,0,0
1653468450038,CSE 274,A00,090132,Ramamoorthi; Ravi,0,0,0,0
1653468450562,CSE 276A,A00,090133,Christensen; Henrik I,0,0,0,0
1653468451090,CSE 276C,A00,090134,Christensen; Henrik I,0,0,0,0
1653468451619,CSE 290,A00,090135,Bafna; Vineet,0,0,0,0
1653468451619,CSE 290,B00,090136,Ramamoorthi; Ravi,0,0,0,0
1653468451619,CSE 290,C00,090137,Li; Tzumao,9,0,10,1
1653468451619,CSE 290,D00,090138,Zhou; Yuan-Yuan,10,0,10,0
1653468451619,CSE 290,E00,090139,Christensen; Henrik I,10,0,10,0
1653468451619,CSE 290,F00,094053,Shalev; Aaron D,0,0,0,0
1653468452152,CSE 291,A00,090140,Munyaka; Imani N. S.,0,0,0,0
1653468452152,CSE 291,B00,094880,Yu; Qi,0,0,0,0
1653468452152,CSE 291,C00,090142,Pannuto; Patrick William,0,0,0,0
1653468452152,CSE 291,D00,094881,Zhang; Yiying,0,0,0,0
1653468452152,CSE 291,E00,095118,Su; Hao,0,0,0,0
1653468452703,CSE 293,001,094905,Bafna; Vineet,9999,0,9999,0
1653468452703,CSE 293,002,094906,Bellare; Mihir,9999,0,9999,0
1653468452703,CSE 293,003,094907,Berg-Kirkpatrick; Taylor D,9999,0,9999,0
1653468452703,CSE 293,004,094908,Christensen; Henrik I,9999,0,9999,0
1653468452703,CSE 293,005,094909,Cottrell; Garrison W,9999,0,9999,0
1653468452703,CSE 293,006,094910,Deutsch; Alin Bernard,9999,0,9999,0
1653468452703,CSE 293,007,094911,Esmaeilzadeh; Hadi,9999,0,9999,0
1653468452703,CSE 293,008,094912,Freund; Yoav,9999,0,9999,0
1653468452703,CSE 293,009,094913,Griswold; William G.,9999,0,9999,0
1653468452703,CSE 293,010,094914,Gymrek; Melissa Ann,9999,0,9999,0
1653468452703,CSE 293,011,094915,Heninger; Nadia A,9999,0,9999,0
1653468452703,CSE 293,012,094916,Impagliazzo; Russell,9999,0,9999,0
1653468452703,CSE 293,013,094917,Jhala; Ranjit,9999,0,9999,0
1653468452703,CSE 293,014,094918,Kahng; Andrew Byun,9999,0,9999,0
1653468452703,CSE 293,015,094919,Kane; Daniel Mertz,9999,0,9999,0
1653468452703,CSE 293,016,094920,Kriegman; David J,9999,0,9999,0
1653468452703,CSE 293,017,094921,Kumar; Arun Kumar,9999,0,9999,0
1653468452703,CSE 293,018,094922,Lerner; Sorin,9999,0,9999,0
1653468452703,CSE 293,019,094923,Lovett; Shachar,9999,0,9999,0
1653468452703,CSE 293,020,094924,McAuley; Julian John,9999,0,9999,0
1653468452703,CSE 293,021,094925,Micciancio; Daniele,9999,0,9999,0
1653468452703,CSE 293,022,094926,Orailoglu; Alex,9999,0,9999,0
1653468452703,CSE 293,023,094927,Paturi; Ramamohan,9999,0,9999,0
1653468452703,CSE 293,024,094928,Polikarpova; Nadezhda,9999,0,9999,0
1653468452703,CSE 293,025,094929,Politz; Joseph Gibbs,9999,0,9999,0
1653468452703,CSE 293,026,094930,Porter; George M,9999,0,9999,0
1653468452703,CSE 293,027,094931,Porter; Leonard Emerson,9999,0,9999,0
1653468452703,CSE 293,028,094932,Ramamoorthi; Ravi,9999,0,9999,0
1653468452703,CSE 293,029,094933,Sahoo; Debashis,9999,0,9999,0
1653468452703,CSE 293,030,094934,Saul; Lawrence,9999,0,9999,0
1653468452703,CSE 293,031,094935,Savage; Stefan,9999,0,9999,0
1653468452703,CSE 293,032,094936,Schulze; Jurgen P.,9999,0,9999,0
1653468452703,CSE 293,033,094937,Snoeren; Alex C.,9999,0,9999,0
1653468452703,CSE 293,034,094938,Shang; Jingbo,9999,0,9999,0
1653468452703,CSE 293,035,094939,Stefan; Deian,9999,0,9999,0
1653468452703,CSE 293,036,094940,Su; Hao,9999,0,9999,0
1653468452703,CSE 293,037,094941,Swanson; Steven James,9999,0,9999,0
1653468452703,CSE 293,038,094942,Tullsen; Dean Michael,9999,0,9999,0
1653468452703,CSE 293,039,094943,Voelker; Geoffrey M.,9999,0,9999,0
1653468452703,CSE 293,040,094944,Zhao; Jishen,9999,0,9999,0
1653468452703,CSE 293,041,094945,Zhou; Yuan-Yuan,9999,0,9999,0
1653468452703,CSE 293,042,094946,Gao; Sicun,9998,0,9999,1
1653468452703,CSE 293,043,094947,Weibel; Nadir,9999,0,9999,0
1653468452703,CSE 293,044,094948,Gupta; Rajesh K.,9999,0,9999,0
1653468453227,CSE 294,A00,090143,Porter; George M,9,0,10,1
1653468453775,DSE 200,A00,091799,Staff,50,0,50,0
1653468454302,DSE 203,A00,091800,Gupta; Amarnath,30,0,30,0
1653468454828,DSE 250,A00,091801,Deutsch; Alin Bernard,30,0,30,0
1653468455354,DSE 290,A00,091802,Altintas De Callaf; Ilkay,50,0,50,0
1653468455907,ECE 200,001,091003,Antipa; Nicholas A,9999,0,9999,0
1653468455907,ECE 200,002,091004,Atanasov; Nikolay A.,9999,0,9999,0
1653468455907,ECE 200,003,091005,Bharadia; Dinesh,9999,0,9999,0
1653468455907,ECE 200,004,091006,Cheng; Chung Kuan,9999,0,9999,0
1653468455907,ECE 200,005,091007,Cosman; Pamela C.,9999,0,9999,0
1653468455907,ECE 200,006,091008,Staff,9999,0,9999,0
1653468455907,ECE 200,007,091009,Dayeh; Shadi Ahmad,9999,0,9999,0
1653468455907,ECE 200,008,091010,Fainman; Yeshaiahu,9999,0,9999,0
1653468455907,ECE 200,009,091011,Ford; Joseph Earl,9999,0,9999,0
1653468455907,ECE 200,010,091012,Franceschetti; Massimo,9999,0,9999,0
1653468455907,ECE 200,011,091013,Fullerton; Eric E,9999,0,9999,0
1653468455907,ECE 200,012,091014,Galton; Ian A,9999,0,9999,0
1653468455907,ECE 200,013,091015,Gilja; Vikash,9999,0,9999,0
1653468455907,ECE 200,014,091016,Hall; Drew A.,9999,0,9999,0
1653468455907,ECE 200,015,091017,Hsueh; Tzu-Chien,9999,0,9999,0
1653468455907,ECE 200,016,091018,Javidi; Tara,9999,0,9999,0
1653468455907,ECE 200,017,091019,Kahng; Andrew Byun,9999,0,9999,0
1653468455907,ECE 200,018,091020,Kim; Young-Han,9999,0,9999,0
1653468455907,ECE 200,019,091021,Koushanfar; Farinaz,9999,0,9999,0
1653468455907,ECE 200,020,091022,Kuzum; Duygu,9999,0,9999,0
1653468455907,ECE 200,021,091023,Le; Hanh-Phuc,9999,0,9999,0
1653468455907,ECE 200,022,091024,Lin; Bill,9999,0,9999,0
1653468455907,ECE 200,023,091025,Liu; Zhaowei,9999,0,9999,0
1653468455907,ECE 200,024,091026,Lo; Yu-Hwa,9999,0,9999,0
1653468455907,ECE 200,025,091027,Lomakin; Vitaliy,9999,0,9999,0
1653468455907,ECE 200,026,091028,Mercier; Patrick Philip,9999,0,9999,0
1653468455907,ECE 200,027,091029,Meyer; Florian,9999,0,9999,0
1653468455907,ECE 200,028,091030,Milstein; Laurence B.,9999,0,9999,0
1653468455907,ECE 200,029,091031,Mir Arabbaygi; Siavash,9999,0,9999,0
1653468455907,ECE 200,030,091032,Mookherjea; Shayan,9999,0,9999,0
1653468455907,ECE 200,031,091033,Morris; Karcher William,9999,0,9999,0
1653468455907,ECE 200,032,091034,Ng; Tse Nga,9999,0,9999,0
1653468455907,ECE 200,033,091035,Nguyen; Truong Quang,9999,0,9999,0
1653468455907,ECE 200,034,091036,Nomura; Kenji,9999,0,9999,0
1653468455907,ECE 200,035,091037,Orlitsky; Alon,9999,0,9999,0
1653468455907,ECE 200,036,091038,Pal; Piya,9999,0,9999,0
1653468455907,ECE 200,037,091039,Papen; George C.,9999,0,9999,0
1653468455907,ECE 200,038,091040,Radic; Stojan,9999,0,9999,0
1653468455907,ECE 200,039,091041,Rao; Bhaskar D.,9999,0,9999,0
1653468455907,ECE 200,040,091042,Rao; Ramesh R,9999,0,9999,0
1653468455907,ECE 200,041,091043,Rebeiz; Gabriel,9999,0,9999,0
1653468455907,ECE 200,042,091044,Sanford; John R,9999,0,9999,0
1653468455907,ECE 200,043,091045,Siegel; Paul H.,9999,0,9999,0
1653468455907,ECE 200,044,091046,Sievenpiper; Daniel F.,9999,0,9999,0
1653468455907,ECE 200,045,091047,Sworder; David D.,9999,0,9999,0
1653468455907,ECE 200,046,091048,Taur; Yuan,9999,0,9999,0
1653468455907,ECE 200,047,091049,Touri; Behrouz,9999,0,9999,0
1653468455907,ECE 200,048,091050,Trivedi; Mohan M.,9999,0,9999,0
1653468455907,ECE 200,049,091051,Vardy; Alexander,9999,0,9999,0
1653468455907,ECE 200,050,091052,Vasconcelos; Nuno,9999,0,9999,0
1653468455907,ECE 200,051,091053,Wang; Xiaolong,9999,0,9999,0
1653468455907,ECE 200,052,091054,Xie; Pengtao,9999,0,9999,0
1653468455907,ECE 200,053,091055,Yip; Michael,9999,0,9999,0
1653468455907,ECE 200,054,091056,Zeger; Kenneth A.,9999,0,9999,0
1653468455907,ECE 200,055,091057,Zhang; Xinyu,9999,0,9999,0
1653468455907,ECE 200,056,091058,Turakhia; Yatish Girish,9999,0,9999,0
1653468455907,ECE 200,057,091059,Kang; Mingu,9999,0,9999,0
1653468455907,ECE 200,058,091060,Shi; Yuanyuan,9999,0,9999,0
1653468455907,ECE 200,059,091061,Wang; Edward Jay,9999,0,9999,0
1653468455907,ECE 200,060,091062,Zheng; Yang,9999,0,9999,0
1653468456432,ECE 203,A00,091065,Mercier; Patrick Philip,0,0,0,0
1653468456956,ECE 207A,A00,091605,Liu; Thomas Tao-Ming,0,0,0,0
1653468457480,ECE 212AN,A00,091068,Nomura; Kenji,0,0,0,0
1653468458004,ECE 222A,A00,091069,Rebeiz; Gabriel,0,0,0,0
1653468458535,ECE 225A,A00,091070,Orlitsky; Alon,0,0,0,0
1653468459067,ECE 230A,A00,091071,Nomura; Kenji,0,0,0,0
1653468459589,ECE 236A,A00,091072,Dayeh; Shadi Ahmad,0,0,0,0
1653468460113,ECE 238A,A00,091073,Luo; Jian,0,0,0,0
1653468460113,ECE 238A,B00,091074,Luo; Jian,0,0,0,0
1653468460639,ECE 240A,A00,091075,Radic; Stojan,0,0,0,0
1653468461165,ECE 247A,A00,091592,Shi; Lingyan,0,0,0,0
1653468461696,ECE 250,A00,091076,Touri; Behrouz,0,0,0,0
1653468462311,ECE 251C,A00,091078,Nguyen; Truong Quang,0,0,0,0
1653468462836,ECE 253,A00,091079,Cosman; Pamela C.,0,0,0,0
1653468463359,ECE 255A,A00,091080,Orlitsky; Alon,0,0,0,0
1653468463884,ECE 257A,A00,091081,Zhang; Xinyu,0,0,0,0
1653468464417,ECE 260A,A01,091084,Eldon; John,0,0,0,0
1653468464944,ECE 264C,A00,091085,Galton; Ian A,0,0,0,0
1653468465473,ECE 265C,A00,094889,Presti; Calogero Davide,0,0,0,9
1653468465996,ECE 266,A01,091087,Hall; Drew A.,0,0,0,0
1653468467052,ECE 271A,A00,091090,Vasconcelos; Nuno,0,0,0,0
1653468467577,ECE 272B,A00,091091,Sworder; David D.,0,0,0,0
1653468468100,ECE 275A,A00,091092,Meyer; Florian,0,0,0,0
1653468468624,ECE 277,A00,091093,An; Cheolhong,0,0,0,0
1653468469157,ECE 283,A00,091094,Le; Hanh-Phuc,0,0,0,0
1653468469681,ECE 284,A00,091095,Kang; Mingu,0,0,0,0
1653468469681,ECE 284,B00,091096,Wang; Edward Jay,0,0,0,0
1653468470207,ECE 285,A00,094334,Touri; Behrouz,0,0,0,0
1653468470736,ECE 289,A00,091097,Whelan; David Arthur,0,0,0,0
1653468471267,MATH 200A,A00,087414,Salehi Golsefidy; Alireza,7,0,8,1
1653468471795,MATH 202A,A00,087415,Gill; Philip E.,3,0,8,5
1653468472323,MATH 203A,A00,087416,Oprea; Dragos N.,6,0,8,2
1653468472847,MATH 204A,A00,087417,Kedlaya; Kiran S.,6,0,8,2
1653468473373,MATH 205,A00,087418,Sorensen; Claus M,6,0,8,2
1653468473911,MATH 206A,A00,087419,Izadi; Elham,7,0,8,1
1653468474434,MATH 207A,A00,087420,Mohammadi; Amir,6,0,8,2
1653468474957,MATH 208,A00,087421,Staff,9,0,10,1
1653468475481,MATH 209,A00,087422,Staff,10,0,10,0
1653468476005,MATH 218,A00,087423,Staff,10,0,10,0
1653468476528,MATH 220A,A00,087424,Novak; Jonathan I,7,0,8,1
1653468477056,MATH 231A,A00,087425,Bejenaru; Ioan,3,0,8,5
1653468477582,MATH 240A,A00,087426,Ebenfelt; Peter F,5,0,8,3
1653468478107,MATH 243,A00,087427,Staff,9,0,10,1
1653468478630,MATH 248,A00,087429,Staff,10,0,10,0
1653468479153,MATH 250A,A00,087430,Spolaor; Luca,4,0,8,4
1653468479676,MATH 257A,A00,087431,Spolaor; Luca,7,0,8,1
1653468480201,MATH 258,A00,087432,Staff,9,0,10,1
1653468480723,MATH 264A,A00,087433,Warnke; Lutz Peter,5,0,8,3
1653468481246,MATH 268,A00,087434,Staff,15,0,15,0
1653468481776,MATH 269,A00,087435,Staff,14,0,15,1
1653468482301,MATH 270A,A00,087436,Nie; Jiawang,0,0,8,8
1653468482833,MATH 272A,A00,087437,Tian; Xiaochuan,1,0,8,7
1653468483360,MATH 274,A01,087439,Cheng; Li-Tien,9,0,10,1
1653468483360,MATH 274,A02,087440,Cheng; Li-Tien,10,0,10,0
1653468483882,MATH 278A,A00,087441,Staff,8,0,10,2
1653468484406,MATH 278B,A00,087442,Staff,8,0,10,2
1653468484929,MATH 278C,A00,087443,Staff,8,0,10,2
1653468485455,MATH 280A,A00,087444,Zheng; Tianyi,0,0,8,8
1653468485982,MATH 281A,A00,087445,Bradic; Jelena,0,0,8,8
1653468486511,MATH 282A,A00,087446,Zhang; Danna,0,0,8,8
1653468487035,MATH 283,A00,087447,Tesler; Glenn,0,0,0,14
1653468487563,MATH 286,A00,087448,Kemp; Todd Aahron,5,0,8,3
1653468488089,MATH 287D,A00,087449,Bradic; Jelena,8,0,8,0
1653468488612,MATH 288,A00,087450,Staff,14,0,15,1
1653468488612,MATH 288,B00,087451,Staff,15,0,15,0
1653468488612,MATH 288,C00,087452,Staff,15,0,15,0
1653468489137,MATH 290A,A00,087453,Xu; Zhouli,7,0,8,1
1653468489662,MATH 291A,A00,087454,Xu; Zhouli,7,0,8,1
1653468490192,MATH 292,A00,087455,Staff,10,0,10,0
1653468490719,MATH 295,A00,087456,Staff,50,0,50,0
1653468491242,MATH 297,001,087457,Staff,998,0,999,1
1653469052141,COGS 200,A01,087991,Staff,47,0,50,3
1653469052665,COGS 201,A01,094504,Rangel; Lara M,17,0,25,8
1653469053191,COGS 203,A00,087992,Coulson; Seana M,18,0,20,2
1653469053728,COGS 210A,001,087993,Greene; Deanna Jacquelyn,9998,0,9999,1
1653469053728,COGS 210A,002,087994,Saygin; Ayse P,9999,0,9999,0
1653469053728,COGS 210A,003,087995,Xia; Haijun,9999,0,9999,0
1653469053728,COGS 210A,004,087996,Nitz; Douglas A.,9999,0,9999,0
1653469053728,COGS 210A,005,087997,Hollan; James D.,9999,0,9999,0
1653469053728,COGS 210A,006,087998,Deak; Gedeon O.,9998,0,9999,1
1653469053728,COGS 210A,007,087999,Rossano; Federico,9999,0,9999,0
1653469054254,COGS 211A,A00,088000,Coulson; Seana M,9997,0,9999,2
1653469054782,COGS 229,A00,088002,Staff,23,0,25,2
1653469055305,COGS 260,B00,094231,Staff,17,0,20,3
1653469055305,COGS 260,A00,088004,Nitz; Douglas A.,9998,0,9999,1
1653469055875,CSE 202,A00,090110,Paturi; Ramamohan,0,0,0,0
1653469055875,CSE 202,B00,090111,Paturi; Ramamohan,0,0,0,0
1653469056399,CSE 207B,A00,090112,Heninger; Nadia A,0,0,0,0
1653469056922,CSE 208,A00,094858,Micciancio; Daniele,0,0,0,0
1653469057445,CSE 210,A00,090113,Powell; Thomas Allan,0,0,0,0
1653469057972,CSE 219,A00,090898,Staff,0,0,0,0
1653469058501,CSE 221,A00,090114,Zhou; Yuan-Yuan,0,0,0,0
1653469059026,CSE 229A,A00,090115,Porter; George M,0,0,0,0
1653469059551,CSE 229C,A00,090116,Savage; Stefan,0,0,0,0
1653469060074,CSE 230,A00,090117,Jhala; Ranjit,0,0,0,0
1653469060604,CSE 232,A00,090118,Papakonstantinou; Yannis,0,0,0,0
1653469061127,CSE 239A,A00,090121,Kumar; Arun Kumar,0,0,0,0
1653469061651,CSE 239B,A00,090122,Jhala; Ranjit,0,0,0,0
1653469062179,CSE 240A,A00,090123,Zhao; Jishen,0,0,189,189
1653469062703,CSE 243A,A00,090124,Orailoglu; Alex,0,0,15,15
1653469063228,CSE 249B,A00,090125,Kahng; Andrew Byun,13,0,20,7
1653469063757,CSE 250A,A00,090126,Berg-Kirkpatrick; Taylor D,0,0,0,0
1653469064295,CSE 252A,A00,090127,Ochoa; Benjamin Lawrence,0,0,0,0
1653469064821,CSE 258,A01,090129,McAuley; Julian John,0,0,0,0
1653469065348,CSE 258R,A01,090131,McAuley; Julian John,0,0,0,0
1653469065871,CSE 274,A00,090132,Ramamoorthi; Ravi,0,0,0,0
1653469066397,CSE 276A,A00,090133,Christensen; Henrik I,0,0,0,0
1653469066920,CSE 276C,A00,090134,Christensen; Henrik I,0,0,0,0
1653469067446,CSE 290,A00,090135,Bafna; Vineet,0,0,0,0
1653469067446,CSE 290,B00,090136,Ramamoorthi; Ravi,0,0,0,0
1653469067446,CSE 290,C00,090137,Li; Tzumao,9,0,10,1
1653469067446,CSE 290,D00,090138,Zhou; Yuan-Yuan,10,0,10,0
1653469067446,CSE 290,E00,090139,Christensen; Henrik I,10,0,10,0
1653469067446,CSE 290,F00,094053,Shalev; Aaron D,0,0,0,0
1653469067975,CSE 291,A00,090140,Munyaka; Imani N. S.,0,0,0,0
1653469067975,CSE 291,B00,094880,Yu; Qi,0,0,0,0
1653469067975,CSE 291,C00,090142,Pannuto; Patrick William,0,0,0,0
1653469067975,CSE 291,D00,094881,Zhang; Yiying,0,0,0,0
1653469067975,CSE 291,E00,095118,Su; Hao,0,0,0,0
1653469068544,CSE 293,001,094905,Bafna; Vineet,9999,0,9999,0
1653469068544,CSE 293,002,094906,Bellare; Mihir,9999,0,9999,0
1653469068544,CSE 293,003,094907,Berg-Kirkpatrick; Taylor D,9999,0,9999,0
1653469068544,CSE 293,004,094908,Christensen; Henrik I,9999,0,9999,0
1653469068544,CSE 293,005,094909,Cottrell; Garrison W,9999,0,9999,0
1653469068544,CSE 293,006,094910,Deutsch; Alin Bernard,9999,0,9999,0
1653469068544,CSE 293,007,094911,Esmaeilzadeh; Hadi,9999,0,9999,0
1653469068544,CSE 293,008,094912,Freund; Yoav,9999,0,9999,0
1653469068544,CSE 293,009,094913,Griswold; William G.,9999,0,9999,0
1653469068544,CSE 293,010,094914,Gymrek; Melissa Ann,9999,0,9999,0
1653469068544,CSE 293,011,094915,Heninger; Nadia A,9999,0,9999,0
1653469068544,CSE 293,012,094916,Impagliazzo; Russell,9999,0,9999,0
1653469068544,CSE 293,013,094917,Jhala; Ranjit,9999,0,9999,0
1653469068544,CSE 293,014,094918,Kahng; Andrew Byun,9999,0,9999,0
1653469068544,CSE 293,015,094919,Kane; Daniel Mertz,9999,0,9999,0
1653469068544,CSE 293,016,094920,Kriegman; David J,9999,0,9999,0
1653469068544,CSE 293,017,094921,Kumar; Arun Kumar,9999,0,9999,0
1653469068544,CSE 293,018,094922,Lerner; Sorin,9999,0,9999,0
1653469068544,CSE 293,019,094923,Lovett; Shachar,9999,0,9999,0
1653469068544,CSE 293,020,094924,McAuley; Julian John,9999,0,9999,0
1653469068544,CSE 293,021,094925,Micciancio; Daniele,9999,0,9999,0
1653469068544,CSE 293,022,094926,Orailoglu; Alex,9999,0,9999,0
1653469068544,CSE 293,023,094927,Paturi; Ramamohan,9999,0,9999,0
1653469068544,CSE 293,024,094928,Polikarpova; Nadezhda,9999,0,9999,0
1653469068544,CSE 293,025,094929,Politz; Joseph Gibbs,9999,0,9999,0
1653469068544,CSE 293,026,094930,Porter; George M,9999,0,9999,0
1653469068544,CSE 293,027,094931,Porter; Leonard Emerson,9999,0,9999,0
1653469068544,CSE 293,028,094932,Ramamoorthi; Ravi,9999,0,9999,0
1653469068544,CSE 293,029,094933,Sahoo; Debashis,9999,0,9999,0
1653469068544,CSE 293,030,094934,Saul; Lawrence,9999,0,9999,0
1653469068544,CSE 293,031,094935,Savage; Stefan,9999,0,9999,0
1653469068544,CSE 293,032,094936,Schulze; Jurgen P.,9999,0,9999,0
1653469068544,CSE 293,033,094937,Snoeren; Alex C.,9999,0,9999,0
1653469068544,CSE 293,034,094938,Shang; Jingbo,9999,0,9999,0
1653469068544,CSE 293,035,094939,Stefan; Deian,9999,0,9999,0
1653469068544,CSE 293,036,094940,Su; Hao,9999,0,9999,0
1653469068544,CSE 293,037,094941,Swanson; Steven James,9999,0,9999,0
1653469068544,CSE 293,038,094942,Tullsen; Dean Michael,9999,0,9999,0
1653469068544,CSE 293,039,094943,Voelker; Geoffrey M.,9999,0,9999,0
1653469068544,CSE 293,040,094944,Zhao; Jishen,9999,0,9999,0
1653469068544,CSE 293,041,094945,Zhou; Yuan-Yuan,9999,0,9999,0
1653469068544,CSE 293,042,094946,Gao; Sicun,9998,0,9999,1
1653469068544,CSE 293,043,094947,Weibel; Nadir,9999,0,9999,0
1653469068544,CSE 293,044,094948,Gupta; Rajesh K.,9999,0,9999,0
1653469069067,CSE 294,A00,090143,Porter; George M,9,0,10,1
1653469069591,DSE 200,A00,091799,Staff,50,0,50,0
1653469070113,DSE 203,A00,091800,Gupta; Amarnath,30,0,30,0
1653469070638,DSE 250,A00,091801,Deutsch; Alin Bernard,30,0,30,0
1653469071161,DSE 290,A00,091802,Altintas De Callaf; Ilkay,50,0,50,0
1653469071716,ECE 200,001,091003,Antipa; Nicholas A,9999,0,9999,0
1653469071716,ECE 200,002,091004,Atanasov; Nikolay A.,9999,0,9999,0
1653469071716,ECE 200,003,091005,Bharadia; Dinesh,9999,0,9999,0
1653469071716,ECE 200,004,091006,Cheng; Chung Kuan,9999,0,9999,0
1653469071716,ECE 200,005,091007,Cosman; Pamela C.,9999,0,9999,0
1653469071716,ECE 200,006,091008,Staff,9999,0,9999,0
1653469071716,ECE 200,007,091009,Dayeh; Shadi Ahmad,9999,0,9999,0
1653469071716,ECE 200,008,091010,Fainman; Yeshaiahu,9999,0,9999,0
1653469071716,ECE 200,009,091011,Ford; Joseph Earl,9999,0,9999,0
1653469071716,ECE 200,010,091012,Franceschetti; Massimo,9999,0,9999,0
1653469071716,ECE 200,011,091013,Fullerton; Eric E,9999,0,9999,0
1653469071716,ECE 200,012,091014,Galton; Ian A,9999,0,9999,0
1653469071716,ECE 200,013,091015,Gilja; Vikash,9999,0,9999,0
1653469071716,ECE 200,014,091016,Hall; Drew A.,9999,0,9999,0
1653469071716,ECE 200,015,091017,Hsueh; Tzu-Chien,9999,0,9999,0
1653469071716,ECE 200,016,091018,Javidi; Tara,9999,0,9999,0
1653469071716,ECE 200,017,091019,Kahng; Andrew Byun,9999,0,9999,0
1653469071716,ECE 200,018,091020,Kim; Young-Han,9999,0,9999,0
1653469071716,ECE 200,019,091021,Koushanfar; Farinaz,9999,0,9999,0
1653469071716,ECE 200,020,091022,Kuzum; Duygu,9999,0,9999,0
1653469071716,ECE 200,021,091023,Le; Hanh-Phuc,9999,0,9999,0
1653469071716,ECE 200,022,091024,Lin; Bill,9999,0,9999,0
1653469071716,ECE 200,023,091025,Liu; Zhaowei,9999,0,9999,0
1653469071716,ECE 200,024,091026,Lo; Yu-Hwa,9999,0,9999,0
1653469071716,ECE 200,025,091027,Lomakin; Vitaliy,9999,0,9999,0
1653469071716,ECE 200,026,091028,Mercier; Patrick Philip,9999,0,9999,0
1653469071716,ECE 200,027,091029,Meyer; Florian,9999,0,9999,0
1653469071716,ECE 200,028,091030,Milstein; Laurence B.,9999,0,9999,0
1653469071716,ECE 200,029,091031,Mir Arabbaygi; Siavash,9999,0,9999,0
1653469071716,ECE 200,030,091032,Mookherjea; Shayan,9999,0,9999,0
1653469071716,ECE 200,031,091033,Morris; Karcher William,9999,0,9999,0
1653469071716,ECE 200,032,091034,Ng; Tse Nga,9999,0,9999,0
1653469071716,ECE 200,033,091035,Nguyen; Truong Quang,9999,0,9999,0
1653469071716,ECE 200,034,091036,Nomura; Kenji,9999,0,9999,0
1653469071716,ECE 200,035,091037,Orlitsky; Alon,9999,0,9999,0
1653469071716,ECE 200,036,091038,Pal; Piya,9999,0,9999,0
1653469071716,ECE 200,037,091039,Papen; George C.,9999,0,9999,0
1653469071716,ECE 200,038,091040,Radic; Stojan,9999,0,9999,0
1653469071716,ECE 200,039,091041,Rao; Bhaskar D.,9999,0,9999,0
1653469071716,ECE 200,040,091042,Rao; Ramesh R,9999,0,9999,0
1653469071716,ECE 200,041,091043,Rebeiz; Gabriel,9999,0,9999,0
1653469071716,ECE 200,042,091044,Sanford; John R,9999,0,9999,0
1653469071716,ECE 200,043,091045,Siegel; Paul H.,9999,0,9999,0
1653469071716,ECE 200,044,091046,Sievenpiper; Daniel F.,9999,0,9999,0
1653469071716,ECE 200,045,091047,Sworder; David D.,9999,0,9999,0
1653469071716,ECE 200,046,091048,Taur; Yuan,9999,0,9999,0
1653469071716,ECE 200,047,091049,Touri; Behrouz,9999,0,9999,0
1653469071716,ECE 200,048,091050,Trivedi; Mohan M.,9999,0,9999,0
1653469071716,ECE 200,049,091051,Vardy; Alexander,9999,0,9999,0
1653469071716,ECE 200,050,091052,Vasconcelos; Nuno,9999,0,9999,0
1653469071716,ECE 200,051,091053,Wang; Xiaolong,9999,0,9999,0
1653469071716,ECE 200,052,091054,Xie; Pengtao,9999,0,9999,0
1653469071716,ECE 200,053,091055,Yip; Michael,9999,0,9999,0
1653469071716,ECE 200,054,091056,Zeger; Kenneth A.,9999,0,9999,0
1653469071716,ECE 200,055,091057,Zhang; Xinyu,9999,0,9999,0
1653469071716,ECE 200,056,091058,Turakhia; Yatish Girish,9999,0,9999,0
1653469071716,ECE 200,057,091059,Kang; Mingu,9999,0,9999,0
1653469071716,ECE 200,058,091060,Shi; Yuanyuan,9999,0,9999,0
1653469071716,ECE 200,059,091061,Wang; Edward Jay,9999,0,9999,0
1653469071716,ECE 200,060,091062,Zheng; Yang,9999,0,9999,0
1653469072244,ECE 203,A00,091065,Mercier; Patrick Philip,0,0,0,0
1653469072767,ECE 207A,A00,091605,Liu; Thomas Tao-Ming,0,0,0,0
1653469073350,ECE 212AN,A00,091068,Nomura; Kenji,0,0,0,0
1653469073873,ECE 222A,A00,091069,Rebeiz; Gabriel,0,0,0,0
1653469074396,ECE 225A,A00,091070,Orlitsky; Alon,0,0,0,0
1653469074920,ECE 230A,A00,091071,Nomura; Kenji,0,0,0,0
1653469075455,ECE 236A,A00,091072,Dayeh; Shadi Ahmad,0,0,0,0
1653469075984,ECE 238A,A00,091073,Luo; Jian,0,0,0,0
1653469075984,ECE 238A,B00,091074,Luo; Jian,0,0,0,0
1653469076507,ECE 240A,A00,091075,Radic; Stojan,0,0,0,0
1653469077046,ECE 247A,A00,091592,Shi; Lingyan,0,0,0,0
1653469077574,ECE 250,A00,091076,Touri; Behrouz,0,0,0,0
1653469078100,ECE 251C,A00,091078,Nguyen; Truong Quang,0,0,0,0
1653469078629,ECE 253,A00,091079,Cosman; Pamela C.,0,0,0,0
1653469079156,ECE 255A,A00,091080,Orlitsky; Alon,0,0,0,0
1653469079676,ECE 257A,A00,091081,Zhang; Xinyu,0,0,0,0
1653469080211,ECE 260A,A01,091084,Eldon; John,0,0,0,0
1653469080735,ECE 264C,A00,091085,Galton; Ian A,0,0,0,0
1653469081263,ECE 265C,A00,094889,Presti; Calogero Davide,0,0,0,9
1653469081791,ECE 266,A01,091087,Hall; Drew A.,0,0,0,0
1653469082840,ECE 271A,A00,091090,Vasconcelos; Nuno,0,0,0,0
1653469083363,ECE 272B,A00,091091,Sworder; David D.,0,0,0,0
1653469083886,ECE 275A,A00,091092,Meyer; Florian,0,0,0,0
1653469084409,ECE 277,A00,091093,An; Cheolhong,0,0,0,0
1653469084933,ECE 283,A00,091094,Le; Hanh-Phuc,0,0,0,0
1653469085455,ECE 284,A00,091095,Kang; Mingu,0,0,0,0
1653469085455,ECE 284,B00,091096,Wang; Edward Jay,0,0,0,0
1653469085990,ECE 285,A00,094334,Touri; Behrouz,0,0,0,0
1653469086519,ECE 289,A00,091097,Whelan; David Arthur,0,0,0,0
1653469087043,MATH 200A,A00,087414,Salehi Golsefidy; Alireza,7,0,8,1
1653469087566,MATH 202A,A00,087415,Gill; Philip E.,3,0,8,5
1653469088094,MATH 203A,A00,087416,Oprea; Dragos N.,6,0,8,2
1653469088616,MATH 204A,A00,087417,Kedlaya; Kiran S.,6,0,8,2
1653469089147,MATH 205,A00,087418,Sorensen; Claus M,6,0,8,2
1653469089669,MATH 206A,A00,087419,Izadi; Elham,7,0,8,1
1653469090195,MATH 207A,A00,087420,Mohammadi; Amir,6,0,8,2
1653469090717,MATH 208,A00,087421,Staff,9,0,10,1
1653469091242,MATH 209,A00,087422,Staff,10,0,10,0
1653469091764,MATH 218,A00,087423,Staff,10,0,10,0
1653469092291,MATH 220A,A00,087424,Novak; Jonathan I,7,0,8,1
1653469092814,MATH 231A,A00,087425,Bejenaru; Ioan,3,0,8,5
1653469093342,MATH 240A,A00,087426,Ebenfelt; Peter F,5,0,8,3
1653469093867,MATH 243,A00,087427,Staff,9,0,10,1
1653469094389,MATH 248,A00,087429,Staff,10,0,10,0
1653469094926,MATH 250A,A00,087430,Spolaor; Luca,4,0,8,4
1653469095448,MATH 257A,A00,087431,Spolaor; Luca,7,0,8,1
1653469095971,MATH 258,A00,087432,Staff,9,0,10,1
1653469096493,MATH 264A,A00,087433,Warnke; Lutz Peter,5,0,8,3
1653469097016,MATH 268,A00,087434,Staff,15,0,15,0
1653469097537,MATH 269,A00,087435,Staff,14,0,15,1
1653469098060,MATH 270A,A00,087436,Nie; Jiawang,0,0,8,8
1653469098595,MATH 272A,A00,087437,Tian; Xiaochuan,1,0,8,7
1653469099118,MATH 274,A01,087439,Cheng; Li-Tien,9,0,10,1
1653469099118,MATH 274,A02,087440,Cheng; Li-Tien,10,0,10,0
1653469099641,MATH 278A,A00,087441,Staff,8,0,10,2
1653469100163,MATH 278B,A00,087442,Staff,8,0,10,2
1653469100688,MATH 278C,A00,087443,Staff,8,0,10,2
1653469101211,MATH 280A,A00,087444,Zheng; Tianyi,0,0,8,8
1653469101735,MATH 281A,A00,087445,Bradic; Jelena,0,0,8,8
1653469102260,MATH 282A,A00,087446,Zhang; Danna,0,0,8,8
1653469102783,MATH 283,A00,087447,Tesler; Glenn,0,0,0,14
1653469103309,MATH 286,A00,087448,Kemp; Todd Aahron,5,0,8,3
1653469103923,MATH 287D,A00,087449,Bradic; Jelena,8,0,8,0
1653469104456,MATH 288,A00,087450,Staff,14,0,15,1
1653469104456,MATH 288,B00,087451,Staff,15,0,15,0
1653469104456,MATH 288,C00,087452,Staff,15,0,15,0
1653469104982,MATH 290A,A00,087453,Xu; Zhouli,7,0,8,1
1653469105508,MATH 291A,A00,087454,Xu; Zhouli,7,0,8,1
1653469106031,MATH 292,A00,087455,Staff,10,0,10,0
1653469106564,MATH 295,A00,087456,Staff,50,0,50,0
1653469107086,MATH 297,001,087457,Staff,998,0,999,1
1653469666892,COGS 200,A01,087991,Staff,47,0,50,3
1653469667418,COGS 201,A01,094504,Rangel; Lara M,17,0,25,8
1653469667945,COGS 203,A00,087992,Coulson; Seana M,18,0,20,2
1653469668470,COGS 210A,001,087993,Greene; Deanna Jacquelyn,9998,0,9999,1
1653469668470,COGS 210A,002,087994,Saygin; Ayse P,9999,0,9999,0
1653469668470,COGS 210A,003,087995,Xia; Haijun,9999,0,9999,0
1653469668470,COGS 210A,004,087996,Nitz; Douglas A.,9999,0,9999,0
1653469668470,COGS 210A,005,087997,Hollan; James D.,9999,0,9999,0
1653469668470,COGS 210A,006,087998,Deak; Gedeon O.,9998,0,9999,1
1653469668470,COGS 210A,007,087999,Rossano; Federico,9999,0,9999,0
1653469668996,COGS 211A,A00,088000,Coulson; Seana M,9997,0,9999,2
1653469669520,COGS 229,A00,088002,Staff,23,0,25,2
1653469670046,COGS 260,B00,094231,Staff,17,0,20,3
1653469670046,COGS 260,A00,088004,Nitz; Douglas A.,9998,0,9999,1
1653469670585,CSE 202,A00,090110,Paturi; Ramamohan,0,0,0,0
1653469670585,CSE 202,B00,090111,Paturi; Ramamohan,0,0,0,0
1653469671111,CSE 207B,A00,090112,Heninger; Nadia A,0,0,0,0
1653469671636,CSE 208,A00,094858,Micciancio; Daniele,0,0,0,0
1653469672158,CSE 210,A00,090113,Powell; Thomas Allan,0,0,0,0
1653469672681,CSE 219,A00,090898,Staff,0,0,0,0
1653469673204,CSE 221,A00,090114,Zhou; Yuan-Yuan,0,0,0,0
1653469673730,CSE 229A,A00,090115,Porter; George M,0,0,0,0
1653469674255,CSE 229C,A00,090116,Savage; Stefan,0,0,0,0
1653469674781,CSE 230,A00,090117,Jhala; Ranjit,0,0,0,0
1653469675304,CSE 232,A00,090118,Papakonstantinou; Yannis,0,0,0,0
1653469675827,CSE 239A,A00,090121,Kumar; Arun Kumar,0,0,0,0
1653469676352,CSE 239B,A00,090122,Jhala; Ranjit,0,0,0,0
1653469676875,CSE 240A,A00,090123,Zhao; Jishen,0,0,189,189
1653469677397,CSE 243A,A00,090124,Orailoglu; Alex,0,0,15,15
1653469677920,CSE 249B,A00,090125,Kahng; Andrew Byun,13,0,20,7
1653469678445,CSE 250A,A00,090126,Berg-Kirkpatrick; Taylor D,0,0,0,0
1653469678968,CSE 252A,A00,090127,Ochoa; Benjamin Lawrence,0,0,0,0
1653469679497,CSE 258,A01,090129,McAuley; Julian John,0,0,0,0
1653469680018,CSE 258R,A01,090131,McAuley; Julian John,0,0,0,0
1653469680551,CSE 274,A00,090132,Ramamoorthi; Ravi,0,0,0,0
1653469681079,CSE 276A,A00,090133,Christensen; Henrik I,0,0,0,0
1653469681610,CSE 276C,A00,090134,Christensen; Henrik I,0,0,0,0
1653469682140,CSE 290,A00,090135,Bafna; Vineet,0,0,0,0
1653469682140,CSE 290,B00,090136,Ramamoorthi; Ravi,0,0,0,0
1653469682140,CSE 290,C00,090137,Li; Tzumao,9,0,10,1
1653469682140,CSE 290,D00,090138,Zhou; Yuan-Yuan,10,0,10,0
1653469682140,CSE 290,E00,090139,Christensen; Henrik I,10,0,10,0
1653469682140,CSE 290,F00,094053,Shalev; Aaron D,0,0,0,0
1653469682671,CSE 291,A00,090140,Munyaka; Imani N. S.,0,0,0,0
1653469682671,CSE 291,B00,094880,Yu; Qi,0,0,0,0
1653469682671,CSE 291,C00,090142,Pannuto; Patrick William,0,0,0,0
1653469682671,CSE 291,D00,094881,Zhang; Yiying,0,0,0,0
1653469682671,CSE 291,E00,095118,Su; Hao,0,0,0,0
1653469683204,CSE 293,001,094905,Bafna; Vineet,9999,0,9999,0
1653469683204,CSE 293,002,094906,Bellare; Mihir,9999,0,9999,0
1653469683204,CSE 293,003,094907,Berg-Kirkpatrick; Taylor D,9999,0,9999,0
1653469683204,CSE 293,004,094908,Christensen; Henrik I,9999,0,9999,0
1653469683204,CSE 293,005,094909,Cottrell; Garrison W,9999,0,9999,0
1653469683204,CSE 293,006,094910,Deutsch; Alin Bernard,9999,0,9999,0
1653469683204,CSE 293,007,094911,Esmaeilzadeh; Hadi,9999,0,9999,0
1653469683204,CSE 293,008,094912,Freund; Yoav,9999,0,9999,0
1653469683204,CSE 293,009,094913,Griswold; William G.,9999,0,9999,0
1653469683204,CSE 293,010,094914,Gymrek; Melissa Ann,9999,0,9999,0
1653469683204,CSE 293,011,094915,Heninger; Nadia A,9999,0,9999,0
1653469683204,CSE 293,012,094916,Impagliazzo; Russell,9999,0,9999,0
1653469683204,CSE 293,013,094917,Jhala; Ranjit,9999,0,9999,0
1653469683204,CSE 293,014,094918,Kahng; Andrew Byun,9999,0,9999,0
1653469683204,CSE 293,015,094919,Kane; Daniel Mertz,9999,0,9999,0
1653469683204,CSE 293,016,094920,Kriegman; David J,9999,0,9999,0
1653469683204,CSE 293,017,094921,Kumar; Arun Kumar,9999,0,9999,0
1653469683204,CSE 293,018,094922,Lerner; Sorin,9999,0,9999,0
1653469683204,CSE 293,019,094923,Lovett; Shachar,9999,0,9999,0
1653469683204,CSE 293,020,094924,McAuley; Julian John,9999,0,9999,0
1653469683204,CSE 293,021,094925,Micciancio; Daniele,9999,0,9999,0
1653469683204,CSE 293,022,094926,Orailoglu; Alex,9999,0,9999,0
1653469683204,CSE 293,023,094927,Paturi; Ramamohan,9999,0,9999,0
1653469683204,CSE 293,024,094928,Polikarpova; Nadezhda,9999,0,9999,0
1653469683204,CSE 293,025,094929,Politz; Joseph Gibbs,9999,0,9999,0
1653469683204,CSE 293,026,094930,Porter; George M,9999,0,9999,0
1653469683204,CSE 293,027,094931,Porter; Leonard Emerson,9999,0,9999,0
1653469683204,CSE 293,028,094932,Ramamoorthi; Ravi,9999,0,9999,0
1653469683204,CSE 293,029,094933,Sahoo; Debashis,9999,0,9999,0
1653469683204,CSE 293,030,094934,Saul; Lawrence,9999,0,9999,0
1653469683204,CSE 293,031,094935,Savage; Stefan,9999,0,9999,0
1653469683204,CSE 293,032,094936,Schulze; Jurgen P.,9999,0,9999,0
1653469683204,CSE 293,033,094937,Snoeren; Alex C.,9999,0,9999,0
1653469683204,CSE 293,034,094938,Shang; Jingbo,9999,0,9999,0
1653469683204,CSE 293,035,094939,Stefan; Deian,9999,0,9999,0
1653469683204,CSE 293,036,094940,Su; Hao,9999,0,9999,0
1653469683204,CSE 293,037,094941,Swanson; Steven James,9999,0,9999,0
1653469683204,CSE 293,038,094942,Tullsen; Dean Michael,9999,0,9999,0
1653469683204,CSE 293,039,094943,Voelker; Geoffrey M.,9999,0,9999,0
1653469683204,CSE 293,040,094944,Zhao; Jishen,9999,0,9999,0
1653469683204,CSE 293,041,094945,Zhou; Yuan-Yuan,9999,0,9999,0
1653469683204,CSE 293,042,094946,Gao; Sicun,9998,0,9999,1
1653469683204,CSE 293,043,094947,Weibel; Nadir,9999,0,9999,0
1653469683204,CSE 293,044,094948,Gupta; Rajesh K.,9999,0,9999,0
1653469683726,CSE 294,A00,090143,Porter; George M,9,0,10,1
1653469684250,DSE 200,A00,091799,Staff,50,0,50,0
1653469684778,DSE 203,A00,091800,Gupta; Amarnath,30,0,30,0
1653469685302,DSE 250,A00,091801,Deutsch; Alin Bernard,30,0,30,0
1653469685825,DSE 290,A00,091802,Altintas De Callaf; Ilkay,50,0,50,0
1653469686361,ECE 200,001,091003,Antipa; Nicholas A,9999,0,9999,0
1653469686361,ECE 200,002,091004,Atanasov; Nikolay A.,9999,0,9999,0
1653469686361,ECE 200,003,091005,Bharadia; Dinesh,9999,0,9999,0
1653469686361,ECE 200,004,091006,Cheng; Chung Kuan,9999,0,9999,0
1653469686361,ECE 200,005,091007,Cosman; Pamela C.,9999,0,9999,0
1653469686361,ECE 200,006,091008,Staff,9999,0,9999,0
1653469686361,ECE 200,007,091009,Dayeh; Shadi Ahmad,9999,0,9999,0
1653469686361,ECE 200,008,091010,Fainman; Yeshaiahu,9999,0,9999,0
1653469686361,ECE 200,009,091011,Ford; Joseph Earl,9999,0,9999,0
1653469686361,ECE 200,010,091012,Franceschetti; Massimo,9999,0,9999,0
1653469686361,ECE 200,011,091013,Fullerton; Eric E,9999,0,9999,0
1653469686361,ECE 200,012,091014,Galton; Ian A,9999,0,9999,0
1653469686361,ECE 200,013,091015,Gilja; Vikash,9999,0,9999,0
1653469686361,ECE 200,014,091016,Hall; Drew A.,9999,0,9999,0
1653469686361,ECE 200,015,091017,Hsueh; Tzu-Chien,9999,0,9999,0
1653469686361,ECE 200,016,091018,Javidi; Tara,9999,0,9999,0
1653469686361,ECE 200,017,091019,Kahng; Andrew Byun,9999,0,9999,0
1653469686361,ECE 200,018,091020,Kim; Young-Han,9999,0,9999,0
1653469686361,ECE 200,019,091021,Koushanfar; Farinaz,9999,0,9999,0
1653469686361,ECE 200,020,091022,Kuzum; Duygu,9999,0,9999,0
1653469686361,ECE 200,021,091023,Le; Hanh-Phuc,9999,0,9999,0
1653469686361,ECE 200,022,091024,Lin; Bill,9999,0,9999,0
1653469686361,ECE 200,023,091025,Liu; Zhaowei,9999,0,9999,0
1653469686361,ECE 200,024,091026,Lo; Yu-Hwa,9999,0,9999,0
1653469686361,ECE 200,025,091027,Lomakin; Vitaliy,9999,0,9999,0
1653469686361,ECE 200,026,091028,Mercier; Patrick Philip,9999,0,9999,0
1653469686361,ECE 200,027,091029,Meyer; Florian,9999,0,9999,0
1653469686361,ECE 200,028,091030,Milstein; Laurence B.,9999,0,9999,0
1653469686361,ECE 200,029,091031,Mir Arabbaygi; Siavash,9999,0,9999,0
1653469686361,ECE 200,030,091032,Mookherjea; Shayan,9999,0,9999,0
1653469686361,ECE 200,031,091033,Morris; Karcher William,9999,0,9999,0
1653469686361,ECE 200,032,091034,Ng; Tse Nga,9999,0,9999,0
1653469686361,ECE 200,033,091035,Nguyen; Truong Quang,9999,0,9999,0
1653469686361,ECE 200,034,091036,Nomura; Kenji,9999,0,9999,0
1653469686361,ECE 200,035,091037,Orlitsky; Alon,9999,0,9999,0
1653469686361,ECE 200,036,091038,Pal; Piya,9999,0,9999,0
1653469686361,ECE 200,037,091039,Papen; George C.,9999,0,9999,0
1653469686361,ECE 200,038,091040,Radic; Stojan,9999,0,9999,0
1653469686361,ECE 200,039,091041,Rao; Bhaskar D.,9999,0,9999,0
1653469686361,ECE 200,040,091042,Rao; Ramesh R,9999,0,9999,0
1653469686361,ECE 200,041,091043,Rebeiz; Gabriel,9999,0,9999,0
1653469686361,ECE 200,042,091044,Sanford; John R,9999,0,9999,0
1653469686361,ECE 200,043,091045,Siegel; Paul H.,9999,0,9999,0
1653469686361,ECE 200,044,091046,Sievenpiper; Daniel F.,9999,0,9999,0
1653469686361,ECE 200,045,091047,Sworder; David D.,9999,0,9999,0
1653469686361,ECE 200,046,091048,Taur; Yuan,9999,0,9999,0
1653469686361,ECE 200,047,091049,Touri; Behrouz,9999,0,9999,0
1653469686361,ECE 200,048,091050,Trivedi; Mohan M.,9999,0,9999,0
1653469686361,ECE 200,049,091051,Vardy; Alexander,9999,0,9999,0
1653469686361,ECE 200,050,091052,Vasconcelos; Nuno,9999,0,9999,0
1653469686361,ECE 200,051,091053,Wang; Xiaolong,9999,0,9999,0
1653469686361,ECE 200,052,091054,Xie; Pengtao,9999,0,9999,0
1653469686361,ECE 200,053,091055,Yip; Michael,9999,0,9999,0
1653469686361,ECE 200,054,091056,Zeger; Kenneth A.,9999,0,9999,0
1653469686361,ECE 200,055,091057,Zhang; Xinyu,9999,0,9999,0
1653469686361,ECE 200,056,091058,Turakhia; Yatish Girish,9999,0,9999,0
1653469686361,ECE 200,057,091059,Kang; Mingu,9999,0,9999,0
1653469686361,ECE 200,058,091060,Shi; Yuanyuan,9999,0,9999,0
1653469686361,ECE 200,059,091061,Wang; Edward Jay,9999,0,9999,0
1653469686361,ECE 200,060,091062,Zheng; Yang,9999,0,9999,0
1653469686894,ECE 203,A00,091065,Mercier; Patrick Philip,0,0,0,0
1653469687417,ECE 207A,A00,091605,Liu; Thomas Tao-Ming,0,0,0,0
1653469687951,ECE 212AN,A00,091068,Nomura; Kenji,0,0,0,0
1653469688474,ECE 222A,A00,091069,Rebeiz; Gabriel,0,0,0,0
1653469688998,ECE 225A,A00,091070,Orlitsky; Alon,0,0,0,0
1653469689528,ECE 230A,A00,091071,Nomura; Kenji,0,0,0,0
1653469690057,ECE 236A,A00,091072,Dayeh; Shadi Ahmad,0,0,0,0
1653469690586,ECE 238A,A00,091073,Luo; Jian,0,0,0,0
1653469690586,ECE 238A,B00,091074,Luo; Jian,0,0,0,0
1653469691183,ECE 240A,A00,091075,Radic; Stojan,0,0,0,0
1653469691706,ECE 247A,A00,091592,Shi; Lingyan,0,0,0,0
1653469692227,ECE 250,A00,091076,Touri; Behrouz,0,0,0,0
1653469692749,ECE 251C,A00,091078,Nguyen; Truong Quang,0,0,0,0
1653469693274,ECE 253,A00,091079,Cosman; Pamela C.,0,0,0,0
1653469693799,ECE 255A,A00,091080,Orlitsky; Alon,0,0,0,0
1653469694324,ECE 257A,A00,091081,Zhang; Xinyu,0,0,0,0
1653469694852,ECE 260A,A01,091084,Eldon; John,0,0,0,0
1653469695376,ECE 264C,A00,091085,Galton; Ian A,0,0,0,0
1653469695900,ECE 265C,A00,094889,Presti; Calogero Davide,0,0,0,9
1653469696423,ECE 266,A01,091087,Hall; Drew A.,0,0,0,0
1653469697472,ECE 271A,A00,091090,Vasconcelos; Nuno,0,0,0,0
1653469697994,ECE 272B,A00,091091,Sworder; David D.,0,0,0,0
1653469698516,ECE 275A,A00,091092,Meyer; Florian,0,0,0,0
1653469699041,ECE 277,A00,091093,An; Cheolhong,0,0,0,0
1653469699567,ECE 283,A00,091094,Le; Hanh-Phuc,0,0,0,0
1653469700092,ECE 284,A00,091095,Kang; Mingu,0,0,0,0
1653469700092,ECE 284,B00,091096,Wang; Edward Jay,0,0,0,0
1653469700616,ECE 285,A00,094334,Touri; Behrouz,0,0,0,0
1653469701138,ECE 289,A00,091097,Whelan; David Arthur,0,0,0,0
1653469701661,MATH 200A,A00,087414,Salehi Golsefidy; Alireza,7,0,8,1
1653469702185,MATH 202A,A00,087415,Gill; Philip E.,3,0,8,5
1653469702707,MATH 203A,A00,087416,Oprea; Dragos N.,6,0,8,2
1653469703234,MATH 204A,A00,087417,Kedlaya; Kiran S.,6,0,8,2
1653469703759,MATH 205,A00,087418,Sorensen; Claus M,6,0,8,2
1653469704286,MATH 206A,A00,087419,Izadi; Elham,7,0,8,1
1653469704812,MATH 207A,A00,087420,Mohammadi; Amir,6,0,8,2
1653469705338,MATH 208,A00,087421,Staff,9,0,10,1
1653469705866,MATH 209,A00,087422,Staff,10,0,10,0
1653469706390,MATH 218,A00,087423,Staff,10,0,10,0
1653469706913,MATH 220A,A00,087424,Novak; Jonathan I,7,0,8,1
1653469707436,MATH 231A,A00,087425,Bejenaru; Ioan,3,0,8,5
1653469707963,MATH 240A,A00,087426,Ebenfelt; Peter F,5,0,8,3
1653469708487,MATH 243,A00,087427,Staff,9,0,10,1
1653469709010,MATH 248,A00,087429,Staff,10,0,10,0
1653469709537,MATH 250A,A00,087430,Spolaor; Luca,4,0,8,4
1653469710068,MATH 257A,A00,087431,Spolaor; Luca,7,0,8,1
1653469710591,MATH 258,A00,087432,Staff,9,0,10,1
1653469711115,MATH 264A,A00,087433,Warnke; Lutz Peter,5,0,8,3
1653469711637,MATH 268,A00,087434,Staff,15,0,15,0
1653469712160,MATH 269,A00,087435,Staff,14,0,15,1
1653469712683,MATH 270A,A00,087436,Nie; Jiawang,0,0,8,8
1653469713216,MATH 272A,A00,087437,Tian; Xiaochuan,1,0,8,7
1653469713739,MATH 274,A01,087439,Cheng; Li-Tien,9,0,10,1
1653469713739,MATH 274,A02,087440,Cheng; Li-Tien,10,0,10,0
1653469714261,MATH 278A,A00,087441,Staff,8,0,10,2
1653469714786,MATH 278B,A00,087442,Staff,8,0,10,2
1653469715311,MATH 278C,A00,087443,Staff,8,0,10,2
1653469715835,MATH 280A,A00,087444,Zheng; Tianyi,0,0,8,8
1653469716357,MATH 281A,A00,087445,Bradic; Jelena,0,0,8,8
1653469716886,MATH 282A,A00,087446,Zhang; Danna,0,0,8,8
1653469717410,MATH 283,A00,087447,Tesler; Glenn,0,0,0,14
1653469717933,MATH 286,A00,087448,Kemp; Todd Aahron,5,0,8,3
1653469718459,MATH 287D,A00,087449,Bradic; Jelena,8,0,8,0
1653469718988,MATH 288,A00,087450,Staff,14,0,15,1
1653469718988,MATH 288,B00,087451,Staff,15,0,15,0
1653469718988,MATH 288,C00,087452,Staff,15,0,15,0
1653469719514,MATH 290A,A00,087453,Xu; Zhouli,7,0,8,1
1653469720037,MATH 291A,A00,087454,Xu; Zhouli,7,0,8,1
1653469720562,MATH 292,A00,087455,Staff,10,0,10,0
1653469721084,MATH 295,A00,087456,Staff,50,0,50,0
1653469721606,MATH 297,001,087457,Staff,998,0,999,1
1653470281291,COGS 200,A01,087991,Staff,47,0,50,3
1653470281816,COGS 201,A01,094504,Rangel; Lara M,17,0,25,8
1653470282342,COGS 203,A00,087992,Coulson; Seana M,18,0,20,2
1653470282872,COGS 210A,001,087993,Greene; Deanna Jacquelyn,9998,0,9999,1
1653470282872,COGS 210A,002,087994,Saygin; Ayse P,9999,0,9999,0
1653470282872,COGS 210A,003,087995,Xia; Haijun,9999,0,9999,0
1653470282872,COGS 210A,004,087996,Nitz; Douglas A.,9999,0,9999,0
1653470282872,COGS 210A,005,087997,Hollan; James D.,9999,0,9999,0
1653470282872,COGS 210A,006,087998,Deak; Gedeon O.,9998,0,9999,1
1653470282872,COGS 210A,007,087999,Rossano; Federico,9999,0,9999,0
1653470283396,COGS 211A,A00,088000,Coulson; Seana M,9997,0,9999,2
1653470283917,COGS 229,A00,088002,Staff,23,0,25,2
1653470284442,COGS 260,B00,094231,Staff,17,0,20,3
1653470284442,COGS 260,A00,088004,Nitz; Douglas A.,9998,0,9999,1
1653470284967,CSE 202,A00,090110,Paturi; Ramamohan,0,0,0,0
1653470284967,CSE 202,B00,090111,Paturi; Ramamohan,0,0,0,0
1653470285494,CSE 207B,A00,090112,Heninger; Nadia A,0,0,0,0
1653470286018,CSE 208,A00,094858,Micciancio; Daniele,0,0,0,0
1653470286545,CSE 210,A00,090113,Powell; Thomas Allan,0,0,0,0
1653470287070,CSE 219,A00,090898,Staff,0,0,0,0
1653470287596,CSE 221,A00,090114,Zhou; Yuan-Yuan,0,0,0,0
1653470288119,CSE 229A,A00,090115,Porter; George M,0,0,0,0
1653470288642,CSE 229C,A00,090116,Savage; Stefan,0,0,0,0
1653470289183,CSE 230,A00,090117,Jhala; Ranjit,0,0,0,0
1653470289705,CSE 232,A00,090118,Papakonstantinou; Yannis,0,0,0,0
1653470290237,CSE 239A,A00,090121,Kumar; Arun Kumar,0,0,0,0
1653470290759,CSE 239B,A00,090122,Jhala; Ranjit,0,0,0,0
1653470291282,CSE 240A,A00,090123,Zhao; Jishen,0,0,189,189
1653470291810,CSE 243A,A00,090124,Orailoglu; Alex,0,0,15,15
1653470292336,CSE 249B,A00,090125,Kahng; Andrew Byun,13,0,20,7
1653470292859,CSE 250A,A00,090126,Berg-Kirkpatrick; Taylor D,0,0,0,0
1653470293383,CSE 252A,A00,090127,Ochoa; Benjamin Lawrence,0,0,0,0
1653470293906,CSE 258,A01,090129,McAuley; Julian John,0,0,0,0
1653470294428,CSE 258R,A01,090131,McAuley; Julian John,0,0,0,0
1653470294952,CSE 274,A00,090132,Ramamoorthi; Ravi,0,0,0,0
1653470295479,CSE 276A,A00,090133,Christensen; Henrik I,0,0,0,0
1653470296001,CSE 276C,A00,090134,Christensen; Henrik I,0,0,0,0
1653470296528,CSE 290,A00,090135,Bafna; Vineet,0,0,0,0
1653470296528,CSE 290,B00,090136,Ramamoorthi; Ravi,0,0,0,0
1653470296528,CSE 290,C00,090137,Li; Tzumao,9,0,10,1
1653470296528,CSE 290,D00,090138,Zhou; Yuan-Yuan,10,0,10,0
1653470296528,CSE 290,E00,090139,Christensen; Henrik I,10,0,10,0
1653470296528,CSE 290,F00,094053,Shalev; Aaron D,0,0,0,0
1653470297052,CSE 291,A00,090140,Munyaka; Imani N. S.,0,0,0,0
1653470297052,CSE 291,B00,094880,Yu; Qi,0,0,0,0
1653470297052,CSE 291,C00,090142,Pannuto; Patrick William,0,0,0,0
1653470297052,CSE 291,D00,094881,Zhang; Yiying,0,0,0,0
1653470297052,CSE 291,E00,095118,Su; Hao,0,0,0,0
1653470297588,CSE 293,001,094905,Bafna; Vineet,9999,0,9999,0
1653470297588,CSE 293,002,094906,Bellare; Mihir,9999,0,9999,0
1653470297588,CSE 293,003,094907,Berg-Kirkpatrick; Taylor D,9999,0,9999,0
1653470297588,CSE 293,004,094908,Christensen; Henrik I,9999,0,9999,0
1653470297588,CSE 293,005,094909,Cottrell; Garrison W,9999,0,9999,0
1653470297588,CSE 293,006,094910,Deutsch; Alin Bernard,9999,0,9999,0
1653470297588,CSE 293,007,094911,Esmaeilzadeh; Hadi,9999,0,9999,0
1653470297588,CSE 293,008,094912,Freund; Yoav,9999,0,9999,0
1653470297588,CSE 293,009,094913,Griswold; William G.,9999,0,9999,0
1653470297588,CSE 293,010,094914,Gymrek; Melissa Ann,9999,0,9999,0
1653470297588,CSE 293,011,094915,Heninger; Nadia A,9999,0,9999,0
1653470297588,CSE 293,012,094916,Impagliazzo; Russell,9999,0,9999,0
1653470297588,CSE 293,013,094917,Jhala; Ranjit,9999,0,9999,0
1653470297588,CSE 293,014,094918,Kahng; Andrew Byun,9999,0,9999,0
1653470297588,CSE 293,015,094919,Kane; Daniel Mertz,9999,0,9999,0
1653470297588,CSE 293,016,094920,Kriegman; David J,9999,0,9999,0
1653470297588,CSE 293,017,094921,Kumar; Arun Kumar,9999,0,9999,0
1653470297588,CSE 293,018,094922,Lerner; Sorin,9999,0,9999,0
1653470297588,CSE 293,019,094923,Lovett; Shachar,9999,0,9999,0
1653470297588,CSE 293,020,094924,McAuley; Julian John,9999,0,9999,0
1653470297588,CSE 293,021,094925,Micciancio; Daniele,9999,0,9999,0
1653470297588,CSE 293,022,094926,Orailoglu; Alex,9999,0,9999,0
1653470297588,CSE 293,023,094927,Paturi; Ramamohan,9999,0,9999,0
1653470297588,CSE 293,024,094928,Polikarpova; Nadezhda,9999,0,9999,0
1653470297588,CSE 293,025,094929,Politz; Joseph Gibbs,9999,0,9999,0
1653470297588,CSE 293,026,094930,Porter; George M,9999,0,9999,0
1653470297588,CSE 293,027,094931,Porter; Leonard Emerson,9999,0,9999,0
1653470297588,CSE 293,028,094932,Ramamoorthi; Ravi,9999,0,9999,0
1653470297588,CSE 293,029,094933,Sahoo; Debashis,9999,0,9999,0
1653470297588,CSE 293,030,094934,Saul; Lawrence,9999,0,9999,0
1653470297588,CSE 293,031,094935,Savage; Stefan,9999,0,9999,0
1653470297588,CSE 293,032,094936,Schulze; Jurgen P.,9999,0,9999,0
1653470297588,CSE 293,033,094937,Snoeren; Alex C.,9999,0,9999,0
1653470297588,CSE 293,034,094938,Shang; Jingbo,9999,0,9999,0
1653470297588,CSE 293,035,094939,Stefan; Deian,9999,0,9999,0
1653470297588,CSE 293,036,094940,Su; Hao,9999,0,9999,0
1653470297588,CSE 293,037,094941,Swanson; Steven James,9999,0,9999,0
1653470297588,CSE 293,038,094942,Tullsen; Dean Michael,9999,0,9999,0
1653470297588,CSE 293,039,094943,Voelker; Geoffrey M.,9999,0,9999,0
1653470297588,CSE 293,040,094944,Zhao; Jishen,9999,0,9999,0
1653470297588,CSE 293,041,094945,Zhou; Yuan-Yuan,9999,0,9999,0
1653470297588,CSE 293,042,094946,Gao; Sicun,9998,0,9999,1
1653470297588,CSE 293,043,094947,Weibel; Nadir,9999,0,9999,0
1653470297588,CSE 293,044,094948,Gupta; Rajesh K.,9999,0,9999,0
1653470298112,CSE 294,A00,090143,Porter; George M,9,0,10,1
1653470298640,DSE 200,A00,091799,Staff,50,0,50,0
1653470299164,DSE 203,A00,091800,Gupta; Amarnath,30,0,30,0
1653470299692,DSE 250,A00,091801,Deutsch; Alin Bernard,30,0,30,0
1653470300215,DSE 290,A00,091802,Altintas De Callaf; Ilkay,50,0,50,0
1653470300774,ECE 200,001,091003,Antipa; Nicholas A,9999,0,9999,0
1653470300774,ECE 200,002,091004,Atanasov; Nikolay A.,9999,0,9999,0
1653470300774,ECE 200,003,091005,Bharadia; Dinesh,9999,0,9999,0
1653470300774,ECE 200,004,091006,Cheng; Chung Kuan,9999,0,9999,0
1653470300774,ECE 200,005,091007,Cosman; Pamela C.,9999,0,9999,0
1653470300774,ECE 200,006,091008,Staff,9999,0,9999,0
1653470300774,ECE 200,007,091009,Dayeh; Shadi Ahmad,9999,0,9999,0
1653470300774,ECE 200,008,091010,Fainman; Yeshaiahu,9999,0,9999,0
1653470300774,ECE 200,009,091011,Ford; Joseph Earl,9999,0,9999,0
1653470300774,ECE 200,010,091012,Franceschetti; Massimo,9999,0,9999,0
1653470300774,ECE 200,011,091013,Fullerton; Eric E,9999,0,9999,0
1653470300774,ECE 200,012,091014,Galton; Ian A,9999,0,9999,0
1653470300774,ECE 200,013,091015,Gilja; Vikash,9999,0,9999,0
1653470300774,ECE 200,014,091016,Hall; Drew A.,9999,0,9999,0
1653470300774,ECE 200,015,091017,Hsueh; Tzu-Chien,9999,0,9999,0
1653470300774,ECE 200,016,091018,Javidi; Tara,9999,0,9999,0
1653470300774,ECE 200,017,091019,Kahng; Andrew Byun,9999,0,9999,0
1653470300774,ECE 200,018,091020,Kim; Young-Han,9999,0,9999,0
1653470300774,ECE 200,019,091021,Koushanfar; Farinaz,9999,0,9999,0
1653470300774,ECE 200,020,091022,Kuzum; Duygu,9999,0,9999,0
1653470300774,ECE 200,021,091023,Le; Hanh-Phuc,9999,0,9999,0
1653470300774,ECE 200,022,091024,Lin; Bill,9999,0,9999,0
1653470300774,ECE 200,023,091025,Liu; Zhaowei,9999,0,9999,0
1653470300774,ECE 200,024,091026,Lo; Yu-Hwa,9999,0,9999,0
1653470300774,ECE 200,025,091027,Lomakin; Vitaliy,9999,0,9999,0
1653470300774,ECE 200,026,091028,Mercier; Patrick Philip,9999,0,9999,0
1653470300774,ECE 200,027,091029,Meyer; Florian,9999,0,9999,0
1653470300774,ECE 200,028,091030,Milstein; Laurence B.,9999,0,9999,0
1653470300774,ECE 200,029,091031,Mir Arabbaygi; Siavash,9999,0,9999,0
1653470300774,ECE 200,030,091032,Mookherjea; Shayan,9999,0,9999,0
1653470300774,ECE 200,031,091033,Morris; Karcher William,9999,0,9999,0
1653470300774,ECE 200,032,091034,Ng; Tse Nga,9999,0,9999,0
1653470300774,ECE 200,033,091035,Nguyen; Truong Quang,9999,0,9999,0
1653470300774,ECE 200,034,091036,Nomura; Kenji,9999,0,9999,0
1653470300774,ECE 200,035,091037,Orlitsky; Alon,9999,0,9999,0
1653470300774,ECE 200,036,091038,Pal; Piya,9999,0,9999,0
1653470300774,ECE 200,037,091039,Papen; George C.,9999,0,9999,0
1653470300774,ECE 200,038,091040,Radic; Stojan,9999,0,9999,0
1653470300774,ECE 200,039,091041,Rao; Bhaskar D.,9999,0,9999,0
1653470300774,ECE 200,040,091042,Rao; Ramesh R,9999,0,9999,0
1653470300774,ECE 200,041,091043,Rebeiz; Gabriel,9999,0,9999,0
1653470300774,ECE 200,042,091044,Sanford; John R,9999,0,9999,0
1653470300774,ECE 200,043,091045,Siegel; Paul H.,9999,0,9999,0
1653470300774,ECE 200,044,091046,Sievenpiper; Daniel F.,9999,0,9999,0
1653470300774,ECE 200,045,091047,Sworder; David D.,9999,0,9999,0
1653470300774,ECE 200,046,091048,Taur; Yuan,9999,0,9999,0
1653470300774,ECE 200,047,091049,Touri; Behrouz,9999,0,9999,0
1653470300774,ECE 200,048,091050,Trivedi; Mohan M.,9999,0,9999,0
1653470300774,ECE 200,049,091051,Vardy; Alexander,9999,0,9999,0
1653470300774,ECE 200,050,091052,Vasconcelos; Nuno,9999,0,9999,0
1653470300774,ECE 200,051,091053,Wang; Xiaolong,9999,0,9999,0
1653470300774,ECE 200,052,091054,Xie; Pengtao,9999,0,9999,0
1653470300774,ECE 200,053,091055,Yip; Michael,9999,0,9999,0
1653470300774,ECE 200,054,091056,Zeger; Kenneth A.,9999,0,9999,0
1653470300774,ECE 200,055,091057,Zhang; Xinyu,9999,0,9999,0
1653470300774,ECE 200,056,091058,Turakhia; Yatish Girish,9999,0,9999,0
1653470300774,ECE 200,057,091059,Kang; Mingu,9999,0,9999,0
1653470300774,ECE 200,058,091060,Shi; Yuanyuan,9999,0,9999,0
1653470300774,ECE 200,059,091061,Wang; Edward Jay,9999,0,9999,0
1653470300774,ECE 200,060,091062,Zheng; Yang,9999,0,9999,0
1653470301301,ECE 203,A00,091065,Mercier; Patrick Philip,0,0,0,0
1653470301824,ECE 207A,A00,091605,Liu; Thomas Tao-Ming,0,0,0,0
1653470302347,ECE 212AN,A00,091068,Nomura; Kenji,0,0,0,0
1653470302870,ECE 222A,A00,091069,Rebeiz; Gabriel,0,0,0,0
1653470303400,ECE 225A,A00,091070,Orlitsky; Alon,0,0,0,0
1653470303926,ECE 230A,A00,091071,Nomura; Kenji,0,0,0,0
1653470304451,ECE 236A,A00,091072,Dayeh; Shadi Ahmad,0,0,0,0
1653470304975,ECE 238A,A00,091073,Luo; Jian,0,0,0,0
1653470304975,ECE 238A,B00,091074,Luo; Jian,0,0,0,0
1653470305500,ECE 240A,A00,091075,Radic; Stojan,0,0,0,0
1653470306023,ECE 247A,A00,091592,Shi; Lingyan,0,0,0,0
1653470306549,ECE 250,A00,091076,Touri; Behrouz,0,0,0,0
1653470307077,ECE 251C,A00,091078,Nguyen; Truong Quang,0,0,0,0
1653470307601,ECE 253,A00,091079,Cosman; Pamela C.,0,0,0,0
1653470308124,ECE 255A,A00,091080,Orlitsky; Alon,0,0,0,0
1653470308647,ECE 257A,A00,091081,Zhang; Xinyu,0,0,0,0
1653470309168,ECE 260A,A01,091084,Eldon; John,0,0,0,0
1653470309690,ECE 264C,A00,091085,Galton; Ian A,0,0,0,0
1653470310214,ECE 265C,A00,094889,Presti; Calogero Davide,0,0,0,9
1653470310741,ECE 266,A01,091087,Hall; Drew A.,0,0,0,0
1653470311793,ECE 271A,A00,091090,Vasconcelos; Nuno,0,0,0,0
1653470312318,ECE 272B,A00,091091,Sworder; David D.,0,0,0,0
1653470312844,ECE 275A,A00,091092,Meyer; Florian,0,0,0,0
1653470313368,ECE 277,A00,091093,An; Cheolhong,0,0,0,0
1653470313890,ECE 283,A00,091094,Le; Hanh-Phuc,0,0,0,0
1653470314418,ECE 284,A00,091095,Kang; Mingu,0,0,0,0
1653470314418,ECE 284,B00,091096,Wang; Edward Jay,0,0,0,0
1653470314940,ECE 285,A00,094334,Touri; Behrouz,0,0,0,0
1653470315463,ECE 289,A00,091097,Whelan; David Arthur,0,0,0,0
1653470315992,MATH 200A,A00,087414,Salehi Golsefidy; Alireza,7,0,8,1
1653470316515,MATH 202A,A00,087415,Gill; Philip E.,3,0,8,5
1653470317043,MATH 203A,A00,087416,Oprea; Dragos N.,6,0,8,2
1653470317568,MATH 204A,A00,087417,Kedlaya; Kiran S.,6,0,8,2
1653470318090,MATH 205,A00,087418,Sorensen; Claus M,6,0,8,2
1653470318612,MATH 206A,A00,087419,Izadi; Elham,7,0,8,1
1653470319135,MATH 207A,A00,087420,Mohammadi; Amir,6,0,8,2
1653470319657,MATH 208,A00,087421,Staff,9,0,10,1
1653470320182,MATH 209,A00,087422,Staff,10,0,10,0
1653470320705,MATH 218,A00,087423,Staff,10,0,10,0
1653470321228,MATH 220A,A00,087424,Novak; Jonathan I,7,0,8,1
1653470321754,MATH 231A,A00,087425,Bejenaru; Ioan,3,0,8,5
1653470322281,MATH 240A,A00,087426,Ebenfelt; Peter F,5,0,8,3
1653470322803,MATH 243,A00,087427,Staff,9,0,10,1
1653470323325,MATH 248,A00,087429,Staff,10,0,10,0
1653470323851,MATH 250A,A00,087430,Spolaor; Luca,4,0,8,4
1653470324375,MATH 257A,A00,087431,Spolaor; Luca,7,0,8,1
1653470324898,MATH 258,A00,087432,Staff,9,0,10,1
1653470325420,MATH 264A,A00,087433,Warnke; Lutz Peter,5,0,8,3
1653470325945,MATH 268,A00,087434,Staff,15,0,15,0
1653470326468,MATH 269,A00,087435,Staff,14,0,15,1
1653470326999,MATH 270A,A00,087436,Nie; Jiawang,0,0,8,8
1653470327521,MATH 272A,A00,087437,Tian; Xiaochuan,1,0,8,7
1653470328046,MATH 274,A01,087439,Cheng; Li-Tien,9,0,10,1
1653470328046,MATH 274,A02,087440,Cheng; Li-Tien,10,0,10,0
1653470328568,MATH 278A,A00,087441,Staff,8,0,10,2
1653470329093,MATH 278B,A00,087442,Staff,8,0,10,2
1653470329616,MATH 278C,A00,087443,Staff,8,0,10,2
1653470330143,MATH 280A,A00,087444,Zheng; Tianyi,0,0,8,8
1653470330667,MATH 281A,A00,087445,Bradic; Jelena,0,0,8,8
1653470331296,MATH 282A,A00,087446,Zhang; Danna,0,0,8,8
1653470331819,MATH 283,A00,087447,Tesler; Glenn,0,0,0,14
1653470332343,MATH 286,A00,087448,Kemp; Todd Aahron,5,0,8,3
1653470332867,MATH 287D,A00,087449,Bradic; Jelena,8,0,8,0
1653470333392,MATH 288,A00,087450,Staff,14,0,15,1
1653470333392,MATH 288,B00,087451,Staff,15,0,15,0
1653470333392,MATH 288,C00,087452,Staff,15,0,15,0
1653470333917,MATH 290A,A00,087453,Xu; Zhouli,7,0,8,1
1653470334443,MATH 291A,A00,087454,Xu; Zhouli,7,0,8,1
1653470334969,MATH 292,A00,087455,Staff,10,0,10,0
1653470335492,MATH 295,A00,087456,Staff,50,0,50,0
1653470336017,MATH 297,001,087457,Staff,998,0,999,1
1653470895348,COGS 200,A01,087991,Staff,47,0,50,3
1653470895869,COGS 201,A01,094504,Rangel; Lara M,17,0,25,8
1653470896391,COGS 203,A00,087992,Coulson; Seana M,18,0,20,2
1653470896917,COGS 210A,001,087993,Greene; Deanna Jacquelyn,9998,0,9999,1
1653470896917,COGS 210A,002,087994,Saygin; Ayse P,9999,0,9999,0
1653470896917,COGS 210A,003,087995,Xia; Haijun,9999,0,9999,0
1653470896917,COGS 210A,004,087996,Nitz; Douglas A.,9999,0,9999,0
1653470896917,COGS 210A,005,087997,Hollan; James D.,9999,0,9999,0
1653470896917,COGS 210A,006,087998,Deak; Gedeon O.,9998,0,9999,1
1653470896917,COGS 210A,007,087999,Rossano; Federico,9999,0,9999,0
1653470897439,COGS 211A,A00,088000,Coulson; Seana M,9997,0,9999,2
1653470897965,COGS 229,A00,088002,Staff,23,0,25,2
1653470898495,COGS 260,B00,094231,Staff,17,0,20,3
1653470898495,COGS 260,A00,088004,Nitz; Douglas A.,9998,0,9999,1
1653470899017,CSE 202,A00,090110,Paturi; Ramamohan,0,0,0,0
1653470899017,CSE 202,B00,090111,Paturi; Ramamohan,0,0,0,0
1653470899543,CSE 207B,A00,090112,Heninger; Nadia A,0,0,0,0
1653470900069,CSE 208,A00,094858,Micciancio; Daniele,0,0,0,0
1653470900592,CSE 210,A00,090113,Powell; Thomas Allan,0,0,0,0
1653470901116,CSE 219,A00,090898,Staff,0,0,0,0
1653470901642,CSE 221,A00,090114,Zhou; Yuan-Yuan,0,0,0,0
1653470902166,CSE 229A,A00,090115,Porter; George M,0,0,0,0
1653470902699,CSE 229C,A00,090116,Savage; Stefan,0,0,0,0
1653470903221,CSE 230,A00,090117,Jhala; Ranjit,0,0,0,0
1653470903744,CSE 232,A00,090118,Papakonstantinou; Yannis,0,0,0,0
1653470904267,CSE 239A,A00,090121,Kumar; Arun Kumar,0,0,0,0
1653470904789,CSE 239B,A00,090122,Jhala; Ranjit,0,0,0,0
1653470905312,CSE 240A,A00,090123,Zhao; Jishen,0,0,189,189
1653470905835,CSE 243A,A00,090124,Orailoglu; Alex,0,0,15,15
1653470906357,CSE 249B,A00,090125,Kahng; Andrew Byun,13,0,20,7
1653470906888,CSE 250A,A00,090126,Berg-Kirkpatrick; Taylor D,0,0,0,0
1653470907412,CSE 252A,A00,090127,Ochoa; Benjamin Lawrence,0,0,0,0
1653470907939,CSE 258,A01,090129,McAuley; Julian John,0,0,0,0
1653470908464,CSE 258R,A01,090131,McAuley; Julian John,0,0,0,0
1653470908988,CSE 274,A00,090132,Ramamoorthi; Ravi,0,0,0,0
1653470909513,CSE 276A,A00,090133,Christensen; Henrik I,0,0,0,0
1653470910038,CSE 276C,A00,090134,Christensen; Henrik I,0,0,0,0
1653470910560,CSE 290,A00,090135,Bafna; Vineet,0,0,0,0
1653470910560,CSE 290,B00,090136,Ramamoorthi; Ravi,0,0,0,0
1653470910560,CSE 290,C00,090137,Li; Tzumao,9,0,10,1
1653470910560,CSE 290,D00,090138,Zhou; Yuan-Yuan,10,0,10,0
1653470910560,CSE 290,E00,090139,Christensen; Henrik I,10,0,10,0
1653470910560,CSE 290,F00,094053,Shalev; Aaron D,0,0,0,0
1653470911090,CSE 291,A00,090140,Munyaka; Imani N. S.,0,0,0,0
1653470911090,CSE 291,B00,094880,Yu; Qi,0,0,0,0
1653470911090,CSE 291,C00,090142,Pannuto; Patrick William,0,0,0,0
1653470911090,CSE 291,D00,094881,Zhang; Yiying,0,0,0,0
1653470911090,CSE 291,E00,095118,Su; Hao,0,0,0,0
1653470911635,CSE 293,001,094905,Bafna; Vineet,9999,0,9999,0
1653470911635,CSE 293,002,094906,Bellare; Mihir,9999,0,9999,0
1653470911635,CSE 293,003,094907,Berg-Kirkpatrick; Taylor D,9999,0,9999,0
1653470911635,CSE 293,004,094908,Christensen; Henrik I,9999,0,9999,0
1653470911635,CSE 293,005,094909,Cottrell; Garrison W,9999,0,9999,0
1653470911635,CSE 293,006,094910,Deutsch; Alin Bernard,9999,0,9999,0
1653470911635,CSE 293,007,094911,Esmaeilzadeh; Hadi,9999,0,9999,0
1653470911635,CSE 293,008,094912,Freund; Yoav,9999,0,9999,0
1653470911635,CSE 293,009,094913,Griswold; William G.,9999,0,9999,0
1653470911635,CSE 293,010,094914,Gymrek; Melissa Ann,9999,0,9999,0
1653470911635,CSE 293,011,094915,Heninger; Nadia A,9999,0,9999,0
1653470911635,CSE 293,012,094916,Impagliazzo; Russell,9999,0,9999,0
1653470911635,CSE 293,013,094917,Jhala; Ranjit,9999,0,9999,0
1653470911635,CSE 293,014,094918,Kahng; Andrew Byun,9999,0,9999,0
1653470911635,CSE 293,015,094919,Kane; Daniel Mertz,9999,0,9999,0
1653470911635,CSE 293,016,094920,Kriegman; David J,9999,0,9999,0
1653470911635,CSE 293,017,094921,Kumar; Arun Kumar,9999,0,9999,0
1653470911635,CSE 293,018,094922,Lerner; Sorin,9999,0,9999,0
1653470911635,CSE 293,019,094923,Lovett; Shachar,9999,0,9999,0
1653470911635,CSE 293,020,094924,McAuley; Julian John,9999,0,9999,0
1653470911635,CSE 293,021,094925,Micciancio; Daniele,9999,0,9999,0
1653470911635,CSE 293,022,094926,Orailoglu; Alex,9999,0,9999,0
1653470911635,CSE 293,023,094927,Paturi; Ramamohan,9999,0,9999,0
1653470911635,CSE 293,024,094928,Polikarpova; Nadezhda,9999,0,9999,0
1653470911635,CSE 293,025,094929,Politz; Joseph Gibbs,9999,0,9999,0
1653470911635,CSE 293,026,094930,Porter; George M,9999,0,9999,0
1653470911635,CSE 293,027,094931,Porter; Leonard Emerson,9999,0,9999,0
1653470911635,CSE 293,028,094932,Ramamoorthi; Ravi,9999,0,9999,0
1653470911635,CSE 293,029,094933,Sahoo; Debashis,9999,0,9999,0
1653470911635,CSE 293,030,094934,Saul; Lawrence,9999,0,9999,0
1653470911635,CSE 293,031,094935,Savage; Stefan,9999,0,9999,0
1653470911635,CSE 293,032,094936,Schulze; Jurgen P.,9999,0,9999,0
1653470911635,CSE 293,033,094937,Snoeren; Alex C.,9999,0,9999,0
1653470911635,CSE 293,034,094938,Shang; Jingbo,9999,0,9999,0
1653470911635,CSE 293,035,094939,Stefan; Deian,9999,0,9999,0
1653470911635,CSE 293,036,094940,Su; Hao,9999,0,9999,0
1653470911635,CSE 293,037,094941,Swanson; Steven James,9999,0,9999,0
1653470911635,CSE 293,038,094942,Tullsen; Dean Michael,9999,0,9999,0
1653470911635,CSE 293,039,094943,Voelker; Geoffrey M.,9999,0,9999,0
1653470911635,CSE 293,040,094944,Zhao; Jishen,9999,0,9999,0
1653470911635,CSE 293,041,094945,Zhou; Yuan-Yuan,9999,0,9999,0
1653470911635,CSE 293,042,094946,Gao; Sicun,9998,0,9999,1
1653470911635,CSE 293,043,094947,Weibel; Nadir,9999,0,9999,0
1653470911635,CSE 293,044,094948,Gupta; Rajesh K.,9999,0,9999,0
1653470912157,CSE 294,A00,090143,Porter; George M,9,0,10,1
1653470912683,DSE 200,A00,091799,Staff,50,0,50,0
1653470913225,DSE 203,A00,091800,Gupta; Amarnath,30,0,30,0
1653470913752,DSE 250,A00,091801,Deutsch; Alin Bernard,30,0,30,0
1653470914284,DSE 290,A00,091802,Altintas De Callaf; Ilkay,50,0,50,0
1653470914820,ECE 200,001,091003,Antipa; Nicholas A,9999,0,9999,0
1653470914820,ECE 200,002,091004,Atanasov; Nikolay A.,9999,0,9999,0
1653470914820,ECE 200,003,091005,Bharadia; Dinesh,9999,0,9999,0
1653470914820,ECE 200,004,091006,Cheng; Chung Kuan,9999,0,9999,0
1653470914820,ECE 200,005,091007,Cosman; Pamela C.,9999,0,9999,0
1653470914820,ECE 200,006,091008,Staff,9999,0,9999,0
1653470914820,ECE 200,007,091009,Dayeh; Shadi Ahmad,9999,0,9999,0
1653470914820,ECE 200,008,091010,Fainman; Yeshaiahu,9999,0,9999,0
1653470914820,ECE 200,009,091011,Ford; Joseph Earl,9999,0,9999,0
1653470914820,ECE 200,010,091012,Franceschetti; Massimo,9999,0,9999,0
1653470914820,ECE 200,011,091013,Fullerton; Eric E,9999,0,9999,0
1653470914820,ECE 200,012,091014,Galton; Ian A,9999,0,9999,0
1653470914820,ECE 200,013,091015,Gilja; Vikash,9999,0,9999,0
1653470914820,ECE 200,014,091016,Hall; Drew A.,9999,0,9999,0
1653470914820,ECE 200,015,091017,Hsueh; Tzu-Chien,9999,0,9999,0
1653470914820,ECE 200,016,091018,Javidi; Tara,9999,0,9999,0
1653470914820,ECE 200,017,091019,Kahng; Andrew Byun,9999,0,9999,0
1653470914820,ECE 200,018,091020,Kim; Young-Han,9999,0,9999,0
1653470914820,ECE 200,019,091021,Koushanfar; Farinaz,9999,0,9999,0
1653470914820,ECE 200,020,091022,Kuzum; Duygu,9999,0,9999,0
1653470914820,ECE 200,021,091023,Le; Hanh-Phuc,9999,0,9999,0
1653470914820,ECE 200,022,091024,Lin; Bill,9999,0,9999,0
1653470914820,ECE 200,023,091025,Liu; Zhaowei,9999,0,9999,0
1653470914820,ECE 200,024,091026,Lo; Yu-Hwa,9999,0,9999,0
1653470914820,ECE 200,025,091027,Lomakin; Vitaliy,9999,0,9999,0
1653470914820,ECE 200,026,091028,Mercier; Patrick Philip,9999,0,9999,0
1653470914820,ECE 200,027,091029,Meyer; Florian,9999,0,9999,0
1653470914820,ECE 200,028,091030,Milstein; Laurence B.,9999,0,9999,0
1653470914820,ECE 200,029,091031,Mir Arabbaygi; Siavash,9999,0,9999,0
1653470914820,ECE 200,030,091032,Mookherjea; Shayan,9999,0,9999,0
1653470914820,ECE 200,031,091033,Morris; Karcher William,9999,0,9999,0
1653470914820,ECE 200,032,091034,Ng; Tse Nga,9999,0,9999,0
1653470914820,ECE 200,033,091035,Nguyen; Truong Quang,9999,0,9999,0
1653470914820,ECE 200,034,091036,Nomura; Kenji,9999,0,9999,0
1653470914820,ECE 200,035,091037,Orlitsky; Alon,9999,0,9999,0
1653470914820,ECE 200,036,091038,Pal; Piya,9999,0,9999,0
1653470914820,ECE 200,037,091039,Papen; George C.,9999,0,9999,0
1653470914820,ECE 200,038,091040,Radic; Stojan,9999,0,9999,0
1653470914820,ECE 200,039,091041,Rao; Bhaskar D.,9999,0,9999,0
1653470914820,ECE 200,040,091042,Rao; Ramesh R,9999,0,9999,0
1653470914820,ECE 200,041,091043,Rebeiz; Gabriel,9999,0,9999,0
1653470914820,ECE 200,042,091044,Sanford; John R,9999,0,9999,0
1653470914820,ECE 200,043,091045,Siegel; Paul H.,9999,0,9999,0
1653470914820,ECE 200,044,091046,Sievenpiper; Daniel F.,9999,0,9999,0
1653470914820,ECE 200,045,091047,Sworder; David D.,9999,0,9999,0
1653470914820,ECE 200,046,091048,Taur; Yuan,9999,0,9999,0
1653470914820,ECE 200,047,091049,Touri; Behrouz,9999,0,9999,0
1653470914820,ECE 200,048,091050,Trivedi; Mohan M.,9999,0,9999,0
1653470914820,ECE 200,049,091051,Vardy; Alexander,9999,0,9999,0
1653470914820,ECE 200,050,091052,Vasconcelos; Nuno,9999,0,9999,0
1653470914820,ECE 200,051,091053,Wang; Xiaolong,9999,0,9999,0
1653470914820,ECE 200,052,091054,Xie; Pengtao,9999,0,9999,0
1653470914820,ECE 200,053,091055,Yip; Michael,9999,0,9999,0
1653470914820,ECE 200,054,091056,Zeger; Kenneth A.,9999,0,9999,0
1653470914820,ECE 200,055,091057,Zhang; Xinyu,9999,0,9999,0
1653470914820,ECE 200,056,091058,Turakhia; Yatish Girish,9999,0,9999,0
1653470914820,ECE 200,057,091059,Kang; Mingu,9999,0,9999,0
1653470914820,ECE 200,058,091060,Shi; Yuanyuan,9999,0,9999,0
1653470914820,ECE 200,059,091061,Wang; Edward Jay,9999,0,9999,0
1653470914820,ECE 200,060,091062,Zheng; Yang,9999,0,9999,0
1653470915347,ECE 203,A00,091065,Mercier; Patrick Philip,0,0,0,0
1653470915874,ECE 207A,A00,091605,Liu; Thomas Tao-Ming,0,0,0,0
1653470916401,ECE 212AN,A00,091068,Nomura; Kenji,0,0,0,0
1653470916926,ECE 222A,A00,091069,Rebeiz; Gabriel,0,0,0,0
1653470917450,ECE 225A,A00,091070,Orlitsky; Alon,0,0,0,0
1653470918045,ECE 230A,A00,091071,Nomura; Kenji,0,0,0,0
1653470918573,ECE 236A,A00,091072,Dayeh; Shadi Ahmad,0,0,0,0
1653470919096,ECE 238A,A00,091073,Luo; Jian,0,0,0,0
1653470919096,ECE 238A,B00,091074,Luo; Jian,0,0,0,0
1653470919623,ECE 240A,A00,091075,Radic; Stojan,0,0,0,0
1653470920148,ECE 247A,A00,091592,Shi; Lingyan,0,0,0,0
1653470920671,ECE 250,A00,091076,Touri; Behrouz,0,0,0,0
1653470921199,ECE 251C,A00,091078,Nguyen; Truong Quang,0,0,0,0
1653470921722,ECE 253,A00,091079,Cosman; Pamela C.,0,0,0,0
1653470922249,ECE 255A,A00,091080,Orlitsky; Alon,0,0,0,0
1653470922775,ECE 257A,A00,091081,Zhang; Xinyu,0,0,0,0
1653470923298,ECE 260A,A01,091084,Eldon; John,0,0,0,0
1653470923820,ECE 264C,A00,091085,Galton; Ian A,0,0,0,0
1653470924345,ECE 265C,A00,094889,Presti; Calogero Davide,0,0,0,9
1653470924872,ECE 266,A01,091087,Hall; Drew A.,0,0,0,0
1653470925922,ECE 271A,A00,091090,Vasconcelos; Nuno,0,0,0,0
1653470926446,ECE 272B,A00,091091,Sworder; David D.,0,0,0,0
1653470926969,ECE 275A,A00,091092,Meyer; Florian,0,0,0,0
1653470927494,ECE 277,A00,091093,An; Cheolhong,0,0,0,0
1653470928017,ECE 283,A00,091094,Le; Hanh-Phuc,0,0,0,0
1653470928544,ECE 284,A00,091095,Kang; Mingu,0,0,0,0
1653470928544,ECE 284,B00,091096,Wang; Edward Jay,0,0,0,0
1653470929067,ECE 285,A00,094334,Touri; Behrouz,0,0,0,0
1653470929606,ECE 289,A00,091097,Whelan; David Arthur,0,0,0,0
1653470930129,MATH 200A,A00,087414,Salehi Golsefidy; Alireza,7,0,8,1
1653470930657,MATH 202A,A00,087415,Gill; Philip E.,3,0,8,5
1653470931184,MATH 203A,A00,087416,Oprea; Dragos N.,6,0,8,2
1653470931710,MATH 204A,A00,087417,Kedlaya; Kiran S.,6,0,8,2
1653470932236,MATH 205,A00,087418,Sorensen; Claus M,6,0,8,2
1653470932761,MATH 206A,A00,087419,Izadi; Elham,7,0,8,1
1653470933285,MATH 207A,A00,087420,Mohammadi; Amir,6,0,8,2
1653470933811,MATH 208,A00,087421,Staff,9,0,10,1
1653470934338,MATH 209,A00,087422,Staff,10,0,10,0
1653470934865,MATH 218,A00,087423,Staff,10,0,10,0
1653470935392,MATH 220A,A00,087424,Novak; Jonathan I,7,0,8,1
1653470935918,MATH 231A,A00,087425,Bejenaru; Ioan,3,0,8,5
1653470936444,MATH 240A,A00,087426,Ebenfelt; Peter F,5,0,8,3
1653470936967,MATH 243,A00,087427,Staff,9,0,10,1
1653470937490,MATH 248,A00,087429,Staff,10,0,10,0
1653470938015,MATH 250A,A00,087430,Spolaor; Luca,4,0,8,4
1653470938539,MATH 257A,A00,087431,Spolaor; Luca,7,0,8,1
1653470939064,MATH 258,A00,087432,Staff,9,0,10,1
1653470939585,MATH 264A,A00,087433,Warnke; Lutz Peter,5,0,8,3
1653470940113,MATH 268,A00,087434,Staff,15,0,15,0
1653470940636,MATH 269,A00,087435,Staff,14,0,15,1
1653470941160,MATH 270A,A00,087436,Nie; Jiawang,0,0,8,8
1653470941688,MATH 272A,A00,087437,Tian; Xiaochuan,1,0,8,7
1653470942216,MATH 274,A01,087439,Cheng; Li-Tien,9,0,10,1
1653470942216,MATH 274,A02,087440,Cheng; Li-Tien,10,0,10,0
1653470942739,MATH 278A,A00,087441,Staff,8,0,10,2
1653470943261,MATH 278B,A00,087442,Staff,8,0,10,2
1653470943786,MATH 278C,A00,087443,Staff,8,0,10,2
1653470944312,MATH 280A,A00,087444,Zheng; Tianyi,0,0,8,8
1653470944840,MATH 281A,A00,087445,Bradic; Jelena,0,0,8,8
1653470945364,MATH 282A,A00,087446,Zhang; Danna,0,0,8,8
1653470945890,MATH 283,A00,087447,Tesler; Glenn,0,0,0,14
1653470946416,MATH 286,A00,087448,Kemp; Todd Aahron,5,0,8,3
1653470946942,MATH 287D,A00,087449,Bradic; Jelena,8,0,8,0
1653470947464,MATH 288,A00,087450,Staff,14,0,15,1
1653470947464,MATH 288,B00,087451,Staff,15,0,15,0
1653470947464,MATH 288,C00,087452,Staff,15,0,15,0
1653470947990,MATH 290A,A00,087453,Xu; Zhouli,7,0,8,1
1653470948512,MATH 291A,A00,087454,Xu; Zhouli,7,0,8,1
1653470949034,MATH 292,A00,087455,Staff,10,0,10,0
1653470949560,MATH 295,A00,087456,Staff,50,0,50,0
1653470950083,MATH 297,001,087457,Staff,998,0,999,1
1653471510831,COGS 200,A01,087991,Staff,47,0,50,3
1653471511356,COGS 201,A01,094504,Rangel; Lara M,17,0,25,8
1653471511884,COGS 203,A00,087992,Coulson; Seana M,18,0,20,2
1653471512418,COGS 210A,001,087993,Greene; Deanna Jacquelyn,9998,0,9999,1
1653471512418,COGS 210A,002,087994,Saygin; Ayse P,9999,0,9999,0
1653471512418,COGS 210A,003,087995,Xia; Haijun,9999,0,9999,0
1653471512418,COGS 210A,004,087996,Nitz; Douglas A.,9999,0,9999,0
1653471512418,COGS 210A,005,087997,Hollan; James D.,9999,0,9999,0
1653471512418,COGS 210A,006,087998,Deak; Gedeon O.,9998,0,9999,1
1653471512418,COGS 210A,007,087999,Rossano; Federico,9999,0,9999,0
1653471512943,COGS 211A,A00,088000,Coulson; Seana M,9997,0,9999,2
1653471513467,COGS 229,A00,088002,Staff,23,0,25,2
1653471513993,COGS 260,B00,094231,Staff,17,0,20,3
1653471513993,COGS 260,A00,088004,Nitz; Douglas A.,9998,0,9999,1
1653471514524,CSE 202,A00,090110,Paturi; Ramamohan,0,0,0,0
1653471514524,CSE 202,B00,090111,Paturi; Ramamohan,0,0,0,0
1653471515048,CSE 207B,A00,090112,Heninger; Nadia A,0,0,0,0
1653471515576,CSE 208,A00,094858,Micciancio; Daniele,0,0,0,0
1653471516105,CSE 210,A00,090113,Powell; Thomas Allan,0,0,0,0
1653471516629,CSE 219,A00,090898,Staff,0,0,0,0
1653471517158,CSE 221,A00,090114,Zhou; Yuan-Yuan,0,0,0,0
1653471517695,CSE 229A,A00,090115,Porter; George M,0,0,0,0
1653471518223,CSE 229C,A00,090116,Savage; Stefan,0,0,0,0
1653471518751,CSE 230,A00,090117,Jhala; Ranjit,0,0,0,0
1653471519276,CSE 232,A00,090118,Papakonstantinou; Yannis,0,0,0,0
1653471519801,CSE 239A,A00,090121,Kumar; Arun Kumar,0,0,0,0
1653471520328,CSE 239B,A00,090122,Jhala; Ranjit,0,0,0,0
1653471520855,CSE 240A,A00,090123,Zhao; Jishen,0,0,189,189
1653471521381,CSE 243A,A00,090124,Orailoglu; Alex,0,0,15,15
1653471521906,CSE 249B,A00,090125,Kahng; Andrew Byun,13,0,20,7
1653471522433,CSE 250A,A00,090126,Berg-Kirkpatrick; Taylor D,0,0,0,0
1653471522960,CSE 252A,A00,090127,Ochoa; Benjamin Lawrence,0,0,0,0
1653471523486,CSE 258,A01,090129,McAuley; Julian John,0,0,0,0
1653471524013,CSE 258R,A01,090131,McAuley; Julian John,0,0,0,0
1653471524535,CSE 274,A00,090132,Ramamoorthi; Ravi,0,0,0,0
1653471525056,CSE 276A,A00,090133,Christensen; Henrik I,0,0,0,0
1653471525581,CSE 276C,A00,090134,Christensen; Henrik I,0,0,0,0
1653471526110,CSE 290,A00,090135,Bafna; Vineet,0,0,0,0
1653471526110,CSE 290,B00,090136,Ramamoorthi; Ravi,0,0,0,0
1653471526110,CSE 290,C00,090137,Li; Tzumao,9,0,10,1
1653471526110,CSE 290,D00,090138,Zhou; Yuan-Yuan,10,0,10,0
1653471526110,CSE 290,E00,090139,Christensen; Henrik I,10,0,10,0
1653471526110,CSE 290,F00,094053,Shalev; Aaron D,0,0,0,0
1653471526651,CSE 291,A00,090140,Munyaka; Imani N. S.,0,0,0,0
1653471526651,CSE 291,B00,094880,Yu; Qi,0,0,0,0
1653471526651,CSE 291,C00,090142,Pannuto; Patrick William,0,0,0,0
1653471526651,CSE 291,D00,094881,Zhang; Yiying,0,0,0,0
1653471526651,CSE 291,E00,095118,Su; Hao,0,0,0,0
1653471527200,CSE 293,001,094905,Bafna; Vineet,9999,0,9999,0
1653471527200,CSE 293,002,094906,Bellare; Mihir,9999,0,9999,0
1653471527200,CSE 293,003,094907,Berg-Kirkpatrick; Taylor D,9999,0,9999,0
1653471527200,CSE 293,004,094908,Christensen; Henrik I,9999,0,9999,0
1653471527200,CSE 293,005,094909,Cottrell; Garrison W,9999,0,9999,0
1653471527200,CSE 293,006,094910,Deutsch; Alin Bernard,9999,0,9999,0
1653471527200,CSE 293,007,094911,Esmaeilzadeh; Hadi,9999,0,9999,0
1653471527200,CSE 293,008,094912,Freund; Yoav,9999,0,9999,0
1653471527200,CSE 293,009,094913,Griswold; William G.,9999,0,9999,0
1653471527200,CSE 293,010,094914,Gymrek; Melissa Ann,9999,0,9999,0
1653471527200,CSE 293,011,094915,Heninger; Nadia A,9999,0,9999,0
1653471527200,CSE 293,012,094916,Impagliazzo; Russell,9999,0,9999,0
1653471527200,CSE 293,013,094917,Jhala; Ranjit,9999,0,9999,0
1653471527200,CSE 293,014,094918,Kahng; Andrew Byun,9999,0,9999,0
1653471527200,CSE 293,015,094919,Kane; Daniel Mertz,9999,0,9999,0
1653471527200,CSE 293,016,094920,Kriegman; David J,9999,0,9999,0
1653471527200,CSE 293,017,094921,Kumar; Arun Kumar,9999,0,9999,0
1653471527200,CSE 293,018,094922,Lerner; Sorin,9999,0,9999,0
1653471527200,CSE 293,019,094923,Lovett; Shachar,9999,0,9999,0
1653471527200,CSE 293,020,094924,McAuley; Julian John,9999,0,9999,0
1653471527200,CSE 293,021,094925,Micciancio; Daniele,9999,0,9999,0
1653471527200,CSE 293,022,094926,Orailoglu; Alex,9999,0,9999,0
1653471527200,CSE 293,023,094927,Paturi; Ramamohan,9999,0,9999,0
1653471527200,CSE 293,024,094928,Polikarpova; Nadezhda,9999,0,9999,0
1653471527200,CSE 293,025,094929,Politz; Joseph Gibbs,9999,0,9999,0
1653471527200,CSE 293,026,094930,Porter; George M,9999,0,9999,0
1653471527200,CSE 293,027,094931,Porter; Leonard Emerson,9999,0,9999,0
1653471527200,CSE 293,028,094932,Ramamoorthi; Ravi,9999,0,9999,0
1653471527200,CSE 293,029,094933,Sahoo; Debashis,9999,0,9999,0
1653471527200,CSE 293,030,094934,Saul; Lawrence,9999,0,9999,0
1653471527200,CSE 293,031,094935,Savage; Stefan,9999,0,9999,0
1653471527200,CSE 293,032,094936,Schulze; Jurgen P.,9999,0,9999,0
1653471527200,CSE 293,033,094937,Snoeren; Alex C.,9999,0,9999,0
1653471527200,CSE 293,034,094938,Shang; Jingbo,9999,0,9999,0
1653471527200,CSE 293,035,094939,Stefan; Deian,9999,0,9999,0
1653471527200,CSE 293,036,094940,Su; Hao,9999,0,9999,0
1653471527200,CSE 293,037,094941,Swanson; Steven James,9999,0,9999,0
1653471527200,CSE 293,038,094942,Tullsen; Dean Michael,9999,0,9999,0
1653471527200,CSE 293,039,094943,Voelker; Geoffrey M.,9999,0,9999,0
1653471527200,CSE 293,040,094944,Zhao; Jishen,9999,0,9999,0
1653471527200,CSE 293,041,094945,Zhou; Yuan-Yuan,9999,0,9999,0
1653471527200,CSE 293,042,094946,Gao; Sicun,9998,0,9999,1
1653471527200,CSE 293,043,094947,Weibel; Nadir,9999,0,9999,0
1653471527200,CSE 293,044,094948,Gupta; Rajesh K.,9999,0,9999,0
1653471527723,CSE 294,A00,090143,Porter; George M,9,0,10,1
1653471528247,DSE 200,A00,091799,Staff,50,0,50,0
1653471528770,DSE 203,A00,091800,Gupta; Amarnath,30,0,30,0
1653471529293,DSE 250,A00,091801,Deutsch; Alin Bernard,30,0,30,0
1653471529818,DSE 290,A00,091802,Altintas De Callaf; Ilkay,50,0,50,0
1653471530386,ECE 200,001,091003,Antipa; Nicholas A,9999,0,9999,0
1653471530386,ECE 200,002,091004,Atanasov; Nikolay A.,9999,0,9999,0
1653471530386,ECE 200,003,091005,Bharadia; Dinesh,9999,0,9999,0
1653471530386,ECE 200,004,091006,Cheng; Chung Kuan,9999,0,9999,0
1653471530386,ECE 200,005,091007,Cosman; Pamela C.,9999,0,9999,0
1653471530386,ECE 200,006,091008,Staff,9999,0,9999,0
1653471530386,ECE 200,007,091009,Dayeh; Shadi Ahmad,9999,0,9999,0
1653471530386,ECE 200,008,091010,Fainman; Yeshaiahu,9999,0,9999,0
1653471530386,ECE 200,009,091011,Ford; Joseph Earl,9999,0,9999,0
1653471530386,ECE 200,010,091012,Franceschetti; Massimo,9999,0,9999,0
1653471530386,ECE 200,011,091013,Fullerton; Eric E,9999,0,9999,0
1653471530386,ECE 200,012,091014,Galton; Ian A,9999,0,9999,0
1653471530386,ECE 200,013,091015,Gilja; Vikash,9999,0,9999,0
1653471530386,ECE 200,014,091016,Hall; Drew A.,9999,0,9999,0
1653471530386,ECE 200,015,091017,Hsueh; Tzu-Chien,9999,0,9999,0
1653471530386,ECE 200,016,091018,Javidi; Tara,9999,0,9999,0
1653471530386,ECE 200,017,091019,Kahng; Andrew Byun,9999,0,9999,0
1653471530386,ECE 200,018,091020,Kim; Young-Han,9999,0,9999,0
1653471530386,ECE 200,019,091021,Koushanfar; Farinaz,9999,0,9999,0
1653471530386,ECE 200,020,091022,Kuzum; Duygu,9999,0,9999,0
1653471530386,ECE 200,021,091023,Le; Hanh-Phuc,9999,0,9999,0
1653471530386,ECE 200,022,091024,Lin; Bill,9999,0,9999,0
1653471530386,ECE 200,023,091025,Liu; Zhaowei,9999,0,9999,0
1653471530386,ECE 200,024,091026,Lo; Yu-Hwa,9999,0,9999,0
1653471530386,ECE 200,025,091027,Lomakin; Vitaliy,9999,0,9999,0
1653471530386,ECE 200,026,091028,Mercier; Patrick Philip,9999,0,9999,0
1653471530386,ECE 200,027,091029,Meyer; Florian,9999,0,9999,0
1653471530386,ECE 200,028,091030,Milstein; Laurence B.,9999,0,9999,0
1653471530386,ECE 200,029,091031,Mir Arabbaygi; Siavash,9999,0,9999,0
1653471530386,ECE 200,030,091032,Mookherjea; Shayan,9999,0,9999,0
1653471530386,ECE 200,031,091033,Morris; Karcher William,9999,0,9999,0
1653471530386,ECE 200,032,091034,Ng; Tse Nga,9999,0,9999,0
1653471530386,ECE 200,033,091035,Nguyen; Truong Quang,9999,0,9999,0
1653471530386,ECE 200,034,091036,Nomura; Kenji,9999,0,9999,0
1653471530386,ECE 200,035,091037,Orlitsky; Alon,9999,0,9999,0
1653471530386,ECE 200,036,091038,Pal; Piya,9999,0,9999,0
1653471530386,ECE 200,037,091039,Papen; George C.,9999,0,9999,0
1653471530386,ECE 200,038,091040,Radic; Stojan,9999,0,9999,0
1653471530386,ECE 200,039,091041,Rao; Bhaskar D.,9999,0,9999,0
1653471530386,ECE 200,040,091042,Rao; Ramesh R,9999,0,9999,0
1653471530386,ECE 200,041,091043,Rebeiz; Gabriel,9999,0,9999,0
1653471530386,ECE 200,042,091044,Sanford; John R,9999,0,9999,0
1653471530386,ECE 200,043,091045,Siegel; Paul H.,9999,0,9999,0
1653471530386,ECE 200,044,091046,Sievenpiper; Daniel F.,9999,0,9999,0
1653471530386,ECE 200,045,091047,Sworder; David D.,9999,0,9999,0
1653471530386,ECE 200,046,091048,Taur; Yuan,9999,0,9999,0
1653471530386,ECE 200,047,091049,Touri; Behrouz,9999,0,9999,0
1653471530386,ECE 200,048,091050,Trivedi; Mohan M.,9999,0,9999,0
1653471530386,ECE 200,049,091051,Vardy; Alexander,9999,0,9999,0
1653471530386,ECE 200,050,091052,Vasconcelos; Nuno,9999,0,9999,0
1653471530386,ECE 200,051,091053,Wang; Xiaolong,9999,0,9999,0
1653471530386,ECE 200,052,091054,Xie; Pengtao,9999,0,9999,0
1653471530386,ECE 200,053,091055,Yip; Michael,9999,0,9999,0
1653471530386,ECE 200,054,091056,Zeger; Kenneth A.,9999,0,9999,0
1653471530386,ECE 200,055,091057,Zhang; Xinyu,9999,0,9999,0
1653471530386,ECE 200,056,091058,Turakhia; Yatish Girish,9999,0,9999,0
1653471530386,ECE 200,057,091059,Kang; Mingu,9999,0,9999,0
1653471530386,ECE 200,058,091060,Shi; Yuanyuan,9999,0,9999,0
1653471530386,ECE 200,059,091061,Wang; Edward Jay,9999,0,9999,0
1653471530386,ECE 200,060,091062,Zheng; Yang,9999,0,9999,0
1653471530911,ECE 203,A00,091065,Mercier; Patrick Philip,0,0,0,0
1653471531434,ECE 207A,A00,091605,Liu; Thomas Tao-Ming,0,0,0,0
1653471531958,ECE 212AN,A00,091068,Nomura; Kenji,0,0,0,0
1653471532483,ECE 222A,A00,091069,Rebeiz; Gabriel,0,0,0,0
1653471533010,ECE 225A,A00,091070,Orlitsky; Alon,0,0,0,0
1653471533533,ECE 230A,A00,091071,Nomura; Kenji,0,0,0,0
1653471534061,ECE 236A,A00,091072,Dayeh; Shadi Ahmad,0,0,0,0
1653471534590,ECE 238A,A00,091073,Luo; Jian,0,0,0,0
1653471534590,ECE 238A,B00,091074,Luo; Jian,0,0,0,0
1653471535115,ECE 240A,A00,091075,Radic; Stojan,0,0,0,0
1653471535639,ECE 247A,A00,091592,Shi; Lingyan,0,0,0,0
1653471536167,ECE 250,A00,091076,Touri; Behrouz,0,0,0,0
1653471536699,ECE 251C,A00,091078,Nguyen; Truong Quang,0,0,0,0
1653471537223,ECE 253,A00,091079,Cosman; Pamela C.,0,0,0,0
1653471537753,ECE 255A,A00,091080,Orlitsky; Alon,0,0,0,0
1653471538281,ECE 257A,A00,091081,Zhang; Xinyu,0,0,0,0
1653471538809,ECE 260A,A01,091084,Eldon; John,0,0,0,0
1653471539332,ECE 264C,A00,091085,Galton; Ian A,0,0,0,0
1653471539863,ECE 265C,A00,094889,Presti; Calogero Davide,0,0,0,9
1653471540393,ECE 266,A01,091087,Hall; Drew A.,0,0,0,0
1653471541449,ECE 271A,A00,091090,Vasconcelos; Nuno,0,0,0,0
1653471541978,ECE 272B,A00,091091,Sworder; David D.,0,0,0,0
1653471542501,ECE 275A,A00,091092,Meyer; Florian,0,0,0,0
1653471543039,ECE 277,A00,091093,An; Cheolhong,0,0,0,0
1653471543565,ECE 283,A00,091094,Le; Hanh-Phuc,0,0,0,0
1653471544103,ECE 284,A00,091095,Kang; Mingu,0,0,0,0
1653471544103,ECE 284,B00,091096,Wang; Edward Jay,0,0,0,0
1653471544633,ECE 285,A00,094334,Touri; Behrouz,0,0,0,0
1653471545164,ECE 289,A00,091097,Whelan; David Arthur,0,0,0,0
1653471545690,MATH 200A,A00,087414,Salehi Golsefidy; Alireza,7,0,8,1
1653471546215,MATH 202A,A00,087415,Gill; Philip E.,3,0,8,5
1653471546753,MATH 203A,A00,087416,Oprea; Dragos N.,6,0,8,2
1653471547283,MATH 204A,A00,087417,Kedlaya; Kiran S.,6,0,8,2
1653471547809,MATH 205,A00,087418,Sorensen; Claus M,6,0,8,2
1653471548336,MATH 206A,A00,087419,Izadi; Elham,7,0,8,1
1653471548864,MATH 207A,A00,087420,Mohammadi; Amir,6,0,8,2
1653471549391,MATH 208,A00,087421,Staff,9,0,10,1
1653471549925,MATH 209,A00,087422,Staff,10,0,10,0
1653471550450,MATH 218,A00,087423,Staff,10,0,10,0
1653471550975,MATH 220A,A00,087424,Novak; Jonathan I,7,0,8,1
1653471551498,MATH 231A,A00,087425,Bejenaru; Ioan,3,0,8,5
1653471552023,MATH 240A,A00,087426,Ebenfelt; Peter F,5,0,8,3
1653471552547,MATH 243,A00,087427,Staff,9,0,10,1
1653471553076,MATH 248,A00,087429,Staff,10,0,10,0
1653471553600,MATH 250A,A00,087430,Spolaor; Luca,4,0,8,4
1653471554136,MATH 257A,A00,087431,Spolaor; Luca,7,0,8,1
1653471554661,MATH 258,A00,087432,Staff,9,0,10,1
1653471555186,MATH 264A,A00,087433,Warnke; Lutz Peter,5,0,8,3
1653471555710,MATH 268,A00,087434,Staff,15,0,15,0
1653471556233,MATH 269,A00,087435,Staff,14,0,15,1
1653471556758,MATH 270A,A00,087436,Nie; Jiawang,0,0,8,8
1653471557283,MATH 272A,A00,087437,Tian; Xiaochuan,1,0,8,7
1653471557809,MATH 274,A01,087439,Cheng; Li-Tien,9,0,10,1
1653471557809,MATH 274,A02,087440,Cheng; Li-Tien,10,0,10,0
1653471558333,MATH 278A,A00,087441,Staff,8,0,10,2
1653471558857,MATH 278B,A00,087442,Staff,8,0,10,2
1653471559452,MATH 278C,A00,087443,Staff,8,0,10,2
1653471559976,MATH 280A,A00,087444,Zheng; Tianyi,0,0,8,8
1653471560500,MATH 281A,A00,087445,Bradic; Jelena,0,0,8,8
1653471561023,MATH 282A,A00,087446,Zhang; Danna,0,0,8,8
1653471561548,MATH 283,A00,087447,Tesler; Glenn,0,0,0,14
1653471562076,MATH 286,A00,087448,Kemp; Todd Aahron,5,0,8,3
1653471562600,MATH 287D,A00,087449,Bradic; Jelena,8,0,8,0
1653471563124,MATH 288,A00,087450,Staff,14,0,15,1
1653471563124,MATH 288,B00,087451,Staff,15,0,15,0
1653471563124,MATH 288,C00,087452,Staff,15,0,15,0
1653471563661,MATH 290A,A00,087453,Xu; Zhouli,7,0,8,1
1653471564190,MATH 291A,A00,087454,Xu; Zhouli,7,0,8,1
1653471564714,MATH 292,A00,087455,Staff,10,0,10,0
1653471565242,MATH 295,A00,087456,Staff,50,0,50,0
1653471565770,MATH 297,001,087457,Staff,998,0,999,1
1653472126351,COGS 200,A01,087991,Staff,47,0,50,3
1653472126880,COGS 201,A01,094504,Rangel; Lara M,17,0,25,8
1653472127407,COGS 203,A00,087992,Coulson; Seana M,18,0,20,2
1653472127940,COGS 210A,001,087993,Greene; Deanna Jacquelyn,9998,0,9999,1
1653472127940,COGS 210A,002,087994,Saygin; Ayse P,9999,0,9999,0
1653472127940,COGS 210A,003,087995,Xia; Haijun,9999,0,9999,0
1653472127940,COGS 210A,004,087996,Nitz; Douglas A.,9999,0,9999,0
1653472127940,COGS 210A,005,087997,Hollan; James D.,9999,0,9999,0
1653472127940,COGS 210A,006,087998,Deak; Gedeon O.,9998,0,9999,1
1653472127940,COGS 210A,007,087999,Rossano; Federico,9999,0,9999,0
1653472128464,COGS 211A,A00,088000,Coulson; Seana M,9997,0,9999,2
1653472128990,COGS 229,A00,088002,Staff,23,0,25,2
1653472129516,COGS 260,B00,094231,Staff,17,0,20,3
1653472129516,COGS 260,A00,088004,Nitz; Douglas A.,9998,0,9999,1
1653472130045,CSE 202,A00,090110,Paturi; Ramamohan,0,0,0,0
1653472130045,CSE 202,B00,090111,Paturi; Ramamohan,0,0,0,0
1653472130571,CSE 207B,A00,090112,Heninger; Nadia A,0,0,0,0
1653472131099,CSE 208,A00,094858,Micciancio; Daniele,0,0,0,0
1653472131632,CSE 210,A00,090113,Powell; Thomas Allan,0,0,0,0
1653472132159,CSE 219,A00,090898,Staff,0,0,0,0
1653472132692,CSE 221,A00,090114,Zhou; Yuan-Yuan,0,0,0,0
1653472133216,CSE 229A,A00,090115,Porter; George M,0,0,0,0
1653472133740,CSE 229C,A00,090116,Savage; Stefan,0,0,0,0
1653472134263,CSE 230,A00,090117,Jhala; Ranjit,0,0,0,0
1653472134791,CSE 232,A00,090118,Papakonstantinou; Yannis,0,0,0,0
1653472135312,CSE 239A,A00,090121,Kumar; Arun Kumar,0,0,0,0
1653472135834,CSE 239B,A00,090122,Jhala; Ranjit,0,0,0,0
1653472136363,CSE 240A,A00,090123,Zhao; Jishen,0,0,189,189
1653472136888,CSE 243A,A00,090124,Orailoglu; Alex,0,0,15,15
1653472137413,CSE 249B,A00,090125,Kahng; Andrew Byun,13,0,20,7
1653472137942,CSE 250A,A00,090126,Berg-Kirkpatrick; Taylor D,0,0,0,0
1653472138468,CSE 252A,A00,090127,Ochoa; Benjamin Lawrence,0,0,0,0
1653472138992,CSE 258,A01,090129,McAuley; Julian John,0,0,0,0
1653472139516,CSE 258R,A01,090131,McAuley; Julian John,0,0,0,0
1653472140039,CSE 274,A00,090132,Ramamoorthi; Ravi,0,0,0,0
1653472140563,CSE 276A,A00,090133,Christensen; Henrik I,0,0,0,0
1653472141091,CSE 276C,A00,090134,Christensen; Henrik I,0,0,0,0
1653472141626,CSE 290,A00,090135,Bafna; Vineet,0,0,0,0
1653472141626,CSE 290,B00,090136,Ramamoorthi; Ravi,0,0,0,0
1653472141626,CSE 290,C00,090137,Li; Tzumao,9,0,10,1
1653472141626,CSE 290,D00,090138,Zhou; Yuan-Yuan,10,0,10,0
1653472141626,CSE 290,E00,090139,Christensen; Henrik I,10,0,10,0
1653472141626,CSE 290,F00,094053,Shalev; Aaron D,0,0,0,0
1653472142153,CSE 291,A00,090140,Munyaka; Imani N. S.,0,0,0,0
1653472142153,CSE 291,B00,094880,Yu; Qi,0,0,0,0
1653472142153,CSE 291,C00,090142,Pannuto; Patrick William,0,0,0,0
1653472142153,CSE 291,D00,094881,Zhang; Yiying,0,0,0,0
1653472142153,CSE 291,E00,095118,Su; Hao,0,0,0,0
1653472142690,CSE 293,001,094905,Bafna; Vineet,9999,0,9999,0
1653472142690,CSE 293,002,094906,Bellare; Mihir,9999,0,9999,0
1653472142690,CSE 293,003,094907,Berg-Kirkpatrick; Taylor D,9999,0,9999,0
1653472142690,CSE 293,004,094908,Christensen; Henrik I,9999,0,9999,0
1653472142690,CSE 293,005,094909,Cottrell; Garrison W,9999,0,9999,0
1653472142690,CSE 293,006,094910,Deutsch; Alin Bernard,9999,0,9999,0
1653472142690,CSE 293,007,094911,Esmaeilzadeh; Hadi,9999,0,9999,0
1653472142690,CSE 293,008,094912,Freund; Yoav,9999,0,9999,0
1653472142690,CSE 293,009,094913,Griswold; William G.,9999,0,9999,0
1653472142690,CSE 293,010,094914,Gymrek; Melissa Ann,9999,0,9999,0
1653472142690,CSE 293,011,094915,Heninger; Nadia A,9999,0,9999,0
1653472142690,CSE 293,012,094916,Impagliazzo; Russell,9999,0,9999,0
1653472142690,CSE 293,013,094917,Jhala; Ranjit,9999,0,9999,0
1653472142690,CSE 293,014,094918,Kahng; Andrew Byun,9999,0,9999,0
1653472142690,CSE 293,015,094919,Kane; Daniel Mertz,9999,0,9999,0
1653472142690,CSE 293,016,094920,Kriegman; David J,9999,0,9999,0
1653472142690,CSE 293,017,094921,Kumar; Arun Kumar,9999,0,9999,0
1653472142690,CSE 293,018,094922,Lerner; Sorin,9999,0,9999,0
1653472142690,CSE 293,019,094923,Lovett; Shachar,9999,0,9999,0
1653472142690,CSE 293,020,094924,McAuley; Julian John,9999,0,9999,0
1653472142690,CSE 293,021,094925,Micciancio; Daniele,9999,0,9999,0
1653472142690,CSE 293,022,094926,Orailoglu; Alex,9999,0,9999,0
1653472142690,CSE 293,023,094927,Paturi; Ramamohan,9999,0,9999,0
1653472142690,CSE 293,024,094928,Polikarpova; Nadezhda,9999,0,9999,0
1653472142690,CSE 293,025,094929,Politz; Joseph Gibbs,9999,0,9999,0
1653472142690,CSE 293,026,094930,Porter; George M,9999,0,9999,0
1653472142690,CSE 293,027,094931,Porter; Leonard Emerson,9999,0,9999,0
1653472142690,CSE 293,028,094932,Ramamoorthi; Ravi,9999,0,9999,0
1653472142690,CSE 293,029,094933,Sahoo; Debashis,9999,0,9999,0
1653472142690,CSE 293,030,094934,Saul; Lawrence,9999,0,9999,0
1653472142690,CSE 293,031,094935,Savage; Stefan,9999,0,9999,0
1653472142690,CSE 293,032,094936,Schulze; Jurgen P.,9999,0,9999,0
1653472142690,CSE 293,033,094937,Snoeren; Alex C.,9999,0,9999,0
1653472142690,CSE 293,034,094938,Shang; Jingbo,9999,0,9999,0
1653472142690,CSE 293,035,094939,Stefan; Deian,9999,0,9999,0
1653472142690,CSE 293,036,094940,Su; Hao,9999,0,9999,0
1653472142690,CSE 293,037,094941,Swanson; Steven James,9999,0,9999,0
1653472142690,CSE 293,038,094942,Tullsen; Dean Michael,9999,0,9999,0
1653472142690,CSE 293,039,094943,Voelker; Geoffrey M.,9999,0,9999,0
1653472142690,CSE 293,040,094944,Zhao; Jishen,9999,0,9999,0
1653472142690,CSE 293,041,094945,Zhou; Yuan-Yuan,9999,0,9999,0
1653472142690,CSE 293,042,094946,Gao; Sicun,9998,0,9999,1
1653472142690,CSE 293,043,094947,Weibel; Nadir,9999,0,9999,0
1653472142690,CSE 293,044,094948,Gupta; Rajesh K.,9999,0,9999,0
1653472143216,CSE 294,A00,090143,Porter; George M,9,0,10,1
1653472143743,DSE 200,A00,091799,Staff,50,0,50,0
1653472144268,DSE 203,A00,091800,Gupta; Amarnath,30,0,30,0
1653472144795,DSE 250,A00,091801,Deutsch; Alin Bernard,30,0,30,0
1653472145318,DSE 290,A00,091802,Altintas De Callaf; Ilkay,50,0,50,0
1653472145870,ECE 200,001,091003,Antipa; Nicholas A,9999,0,9999,0
1653472145870,ECE 200,002,091004,Atanasov; Nikolay A.,9999,0,9999,0
1653472145870,ECE 200,003,091005,Bharadia; Dinesh,9999,0,9999,0
1653472145870,ECE 200,004,091006,Cheng; Chung Kuan,9999,0,9999,0
1653472145870,ECE 200,005,091007,Cosman; Pamela C.,9999,0,9999,0
1653472145870,ECE 200,006,091008,Staff,9999,0,9999,0
1653472145870,ECE 200,007,091009,Dayeh; Shadi Ahmad,9999,0,9999,0
1653472145870,ECE 200,008,091010,Fainman; Yeshaiahu,9999,0,9999,0
1653472145870,ECE 200,009,091011,Ford; Joseph Earl,9999,0,9999,0
1653472145870,ECE 200,010,091012,Franceschetti; Massimo,9999,0,9999,0
1653472145870,ECE 200,011,091013,Fullerton; Eric E,9999,0,9999,0
1653472145870,ECE 200,012,091014,Galton; Ian A,9999,0,9999,0
1653472145870,ECE 200,013,091015,Gilja; Vikash,9999,0,9999,0
1653472145870,ECE 200,014,091016,Hall; Drew A.,9999,0,9999,0
1653472145870,ECE 200,015,091017,Hsueh; Tzu-Chien,9999,0,9999,0
1653472145870,ECE 200,016,091018,Javidi; Tara,9999,0,9999,0
1653472145870,ECE 200,017,091019,Kahng; Andrew Byun,9999,0,9999,0
1653472145870,ECE 200,018,091020,Kim; Young-Han,9999,0,9999,0
1653472145870,ECE 200,019,091021,Koushanfar; Farinaz,9999,0,9999,0
1653472145870,ECE 200,020,091022,Kuzum; Duygu,9999,0,9999,0
1653472145870,ECE 200,021,091023,Le; Hanh-Phuc,9999,0,9999,0
1653472145870,ECE 200,022,091024,Lin; Bill,9999,0,9999,0
1653472145870,ECE 200,023,091025,Liu; Zhaowei,9999,0,9999,0
1653472145870,ECE 200,024,091026,Lo; Yu-Hwa,9999,0,9999,0
1653472145870,ECE 200,025,091027,Lomakin; Vitaliy,9999,0,9999,0
1653472145870,ECE 200,026,091028,Mercier; Patrick Philip,9999,0,9999,0
1653472145870,ECE 200,027,091029,Meyer; Florian,9999,0,9999,0
1653472145870,ECE 200,028,091030,Milstein; Laurence B.,9999,0,9999,0
1653472145870,ECE 200,029,091031,Mir Arabbaygi; Siavash,9999,0,9999,0
1653472145870,ECE 200,030,091032,Mookherjea; Shayan,9999,0,9999,0
1653472145870,ECE 200,031,091033,Morris; Karcher William,9999,0,9999,0
1653472145870,ECE 200,032,091034,Ng; Tse Nga,9999,0,9999,0
1653472145870,ECE 200,033,091035,Nguyen; Truong Quang,9999,0,9999,0
1653472145870,ECE 200,034,091036,Nomura; Kenji,9999,0,9999,0
1653472145870,ECE 200,035,091037,Orlitsky; Alon,9999,0,9999,0
1653472145870,ECE 200,036,091038,Pal; Piya,9999,0,9999,0
1653472145870,ECE 200,037,091039,Papen; George C.,9999,0,9999,0
1653472145870,ECE 200,038,091040,Radic; Stojan,9999,0,9999,0
1653472145870,ECE 200,039,091041,Rao; Bhaskar D.,9999,0,9999,0
1653472145870,ECE 200,040,091042,Rao; Ramesh R,9999,0,9999,0
1653472145870,ECE 200,041,091043,Rebeiz; Gabriel,9999,0,9999,0
1653472145870,ECE 200,042,091044,Sanford; John R,9999,0,9999,0
1653472145870,ECE 200,043,091045,Siegel; Paul H.,9999,0,9999,0
1653472145870,ECE 200,044,091046,Sievenpiper; Daniel F.,9999,0,9999,0
1653472145870,ECE 200,045,091047,Sworder; David D.,9999,0,9999,0
1653472145870,ECE 200,046,091048,Taur; Yuan,9999,0,9999,0
1653472145870,ECE 200,047,091049,Touri; Behrouz,9999,0,9999,0
1653472145870,ECE 200,048,091050,Trivedi; Mohan M.,9999,0,9999,0
1653472145870,ECE 200,049,091051,Vardy; Alexander,9999,0,9999,0
1653472145870,ECE 200,050,091052,Vasconcelos; Nuno,9999,0,9999,0
1653472145870,ECE 200,051,091053,Wang; Xiaolong,9999,0,9999,0
1653472145870,ECE 200,052,091054,Xie; Pengtao,9999,0,9999,0
1653472145870,ECE 200,053,091055,Yip; Michael,9999,0,9999,0
1653472145870,ECE 200,054,091056,Zeger; Kenneth A.,9999,0,9999,0
1653472145870,ECE 200,055,091057,Zhang; Xinyu,9999,0,9999,0
1653472145870,ECE 200,056,091058,Turakhia; Yatish Girish,9999,0,9999,0
1653472145870,ECE 200,057,091059,Kang; Mingu,9999,0,9999,0
1653472145870,ECE 200,058,091060,Shi; Yuanyuan,9999,0,9999,0
1653472145870,ECE 200,059,091061,Wang; Edward Jay,9999,0,9999,0
1653472145870,ECE 200,060,091062,Zheng; Yang,9999,0,9999,0
1653472146395,ECE 203,A00,091065,Mercier; Patrick Philip,0,0,0,0
1653472146928,ECE 207A,A00,091605,Liu; Thomas Tao-Ming,0,0,0,0
1653472147551,ECE 212AN,A00,091068,Nomura; Kenji,0,0,0,0
1653472148076,ECE 222A,A00,091069,Rebeiz; Gabriel,0,0,0,0
1653472148599,ECE 225A,A00,091070,Orlitsky; Alon,0,0,0,0
1653472149127,ECE 230A,A00,091071,Nomura; Kenji,0,0,0,0
1653472149652,ECE 236A,A00,091072,Dayeh; Shadi Ahmad,0,0,0,0
1653472150183,ECE 238A,A00,091073,Luo; Jian,0,0,0,0
1653472150183,ECE 238A,B00,091074,Luo; Jian,0,0,0,0
1653472150710,ECE 240A,A00,091075,Radic; Stojan,0,0,0,0
1653472151241,ECE 247A,A00,091592,Shi; Lingyan,0,0,0,0
1653472151763,ECE 250,A00,091076,Touri; Behrouz,0,0,0,0
1653472152288,ECE 251C,A00,091078,Nguyen; Truong Quang,0,0,0,0
1653472152818,ECE 253,A00,091079,Cosman; Pamela C.,0,0,0,0
1653472153342,ECE 255A,A00,091080,Orlitsky; Alon,0,0,0,0
1653472153867,ECE 257A,A00,091081,Zhang; Xinyu,0,0,0,0
1653472154396,ECE 260A,A01,091084,Eldon; John,0,0,0,0
1653472154920,ECE 264C,A00,091085,Galton; Ian A,0,0,0,0
1653472155449,ECE 265C,A00,094889,Presti; Calogero Davide,0,0,0,9
1653472155973,ECE 266,A01,091087,Hall; Drew A.,0,0,0,0
1653472157021,ECE 271A,A00,091090,Vasconcelos; Nuno,0,0,0,0
1653472157552,ECE 272B,A00,091091,Sworder; David D.,0,0,0,0
1653472158079,ECE 275A,A00,091092,Meyer; Florian,0,0,0,0
1653472158606,ECE 277,A00,091093,An; Cheolhong,0,0,0,0
1653472159133,ECE 283,A00,091094,Le; Hanh-Phuc,0,0,0,0
1653472159665,ECE 284,A00,091095,Kang; Mingu,0,0,0,0
1653472159665,ECE 284,B00,091096,Wang; Edward Jay,0,0,0,0
1653472160188,ECE 285,A00,094334,Touri; Behrouz,0,0,0,0
1653472160710,ECE 289,A00,091097,Whelan; David Arthur,0,0,0,0
1653472161239,MATH 200A,A00,087414,Salehi Golsefidy; Alireza,7,0,8,1
1653472161766,MATH 202A,A00,087415,Gill; Philip E.,3,0,8,5
1653472162289,MATH 203A,A00,087416,Oprea; Dragos N.,6,0,8,2
1653472162810,MATH 204A,A00,087417,Kedlaya; Kiran S.,6,0,8,2
1653472173268,MATH 205,A00,087418,Sorensen; Claus M,6,0,8,2
1653472173789,MATH 206A,A00,087419,Izadi; Elham,7,0,8,1
1653472174312,MATH 207A,A00,087420,Mohammadi; Amir,6,0,8,2
1653472174839,MATH 208,A00,087421,Staff,9,0,10,1
1653472175363,MATH 209,A00,087422,Staff,10,0,10,0
1653472175886,MATH 218,A00,087423,Staff,10,0,10,0
1653472176410,MATH 220A,A00,087424,Novak; Jonathan I,7,0,8,1
1653472176938,MATH 231A,A00,087425,Bejenaru; Ioan,3,0,8,5
1653472177461,MATH 240A,A00,087426,Ebenfelt; Peter F,5,0,8,3
1653472177983,MATH 243,A00,087427,Staff,9,0,10,1
1653472178505,MATH 248,A00,087429,Staff,10,0,10,0
1653472179031,MATH 250A,A00,087430,Spolaor; Luca,4,0,8,4
1653472179559,MATH 257A,A00,087431,Spolaor; Luca,7,0,8,1
1653472180084,MATH 258,A00,087432,Staff,9,0,10,1
1653472180608,MATH 264A,A00,087433,Warnke; Lutz Peter,5,0,8,3
1653472181130,MATH 268,A00,087434,Staff,15,0,15,0
1653472181651,MATH 269,A00,087435,Staff,14,0,15,1
1653472182178,MATH 270A,A00,087436,Nie; Jiawang,0,0,8,8
1653472182714,MATH 272A,A00,087437,Tian; Xiaochuan,1,0,8,7
1653472183239,MATH 274,A01,087439,Cheng; Li-Tien,9,0,10,1
1653472183239,MATH 274,A02,087440,Cheng; Li-Tien,10,0,10,0
1653472183766,MATH 278A,A00,087441,Staff,8,0,10,2
1653472184292,MATH 278B,A00,087442,Staff,8,0,10,2
1653472184819,MATH 278C,A00,087443,Staff,8,0,10,2
1653472185355,MATH 280A,A00,087444,Zheng; Tianyi,0,0,8,8
1653472185879,MATH 281A,A00,087445,Bradic; Jelena,0,0,8,8
1653472186404,MATH 282A,A00,087446,Zhang; Danna,0,0,8,8
1653472186930,MATH 283,A00,087447,Tesler; Glenn,0,0,0,14
1653472187456,MATH 286,A00,087448,Kemp; Todd Aahron,5,0,8,3
1653472187984,MATH 287D,A00,087449,Bradic; Jelena,8,0,8,0
1653472188508,MATH 288,A00,087450,Staff,14,0,15,1
1653472188508,MATH 288,B00,087451,Staff,15,0,15,0
1653472188508,MATH 288,C00,087452,Staff,15,0,15,0
1653472189038,MATH 290A,A00,087453,Xu; Zhouli,7,0,8,1
1653472189571,MATH 291A,A00,087454,Xu; Zhouli,7,0,8,1
1653472190095,MATH 292,A00,087455,Staff,10,0,10,0
1653472190618,MATH 295,A00,087456,Staff,50,0,50,0
1653472191146,MATH 297,001,087457,Staff,998,0,999,1
1653472751900,COGS 200,A01,087991,Staff,47,0,50,3
1653472752424,COGS 201,A01,094504,Rangel; Lara M,17,0,25,8
1653472752958,COGS 203,A00,087992,Coulson; Seana M,18,0,20,2
1653472753491,COGS 210A,001,087993,Greene; Deanna Jacquelyn,9998,0,9999,1
1653472753491,COGS 210A,002,087994,Saygin; Ayse P,9999,0,9999,0
1653472753491,COGS 210A,003,087995,Xia; Haijun,9999,0,9999,0
1653472753491,COGS 210A,004,087996,Nitz; Douglas A.,9999,0,9999,0
1653472753491,COGS 210A,005,087997,Hollan; James D.,9999,0,9999,0
1653472753491,COGS 210A,006,087998,Deak; Gedeon O.,9998,0,9999,1
1653472753491,COGS 210A,007,087999,Rossano; Federico,9999,0,9999,0
1653472754014,COGS 211A,A00,088000,Coulson; Seana M,9997,0,9999,2
1653472754537,COGS 229,A00,088002,Staff,23,0,25,2
1653472755067,COGS 260,B00,094231,Staff,17,0,20,3
1653472755067,COGS 260,A00,088004,Nitz; Douglas A.,9998,0,9999,1
1653472755601,CSE 202,A00,090110,Paturi; Ramamohan,0,0,0,0
1653472755601,CSE 202,B00,090111,Paturi; Ramamohan,0,0,0,0
1653472756125,CSE 207B,A00,090112,Heninger; Nadia A,0,0,0,0
1653472756653,CSE 208,A00,094858,Micciancio; Daniele,0,0,0,0
1653472757179,CSE 210,A00,090113,Powell; Thomas Allan,0,0,0,0
1653472757703,CSE 219,A00,090898,Staff,0,0,0,0
1653472758231,CSE 221,A00,090114,Zhou; Yuan-Yuan,0,0,0,0
1653472758758,CSE 229A,A00,090115,Porter; George M,0,0,0,0
1653472759281,CSE 229C,A00,090116,Savage; Stefan,0,0,0,0
1653472759810,CSE 230,A00,090117,Jhala; Ranjit,0,0,0,0
1653472760334,CSE 232,A00,090118,Papakonstantinou; Yannis,0,0,0,0
1653472760857,CSE 239A,A00,090121,Kumar; Arun Kumar,0,0,0,0
1653472761380,CSE 239B,A00,090122,Jhala; Ranjit,0,0,0,0
1653472761907,CSE 240A,A00,090123,Zhao; Jishen,0,0,189,189
1653472762433,CSE 243A,A00,090124,Orailoglu; Alex,0,0,15,15
1653472762960,CSE 249B,A00,090125,Kahng; Andrew Byun,13,0,20,7
1653472763487,CSE 250A,A00,090126,Berg-Kirkpatrick; Taylor D,0,0,0,0
1653472764011,CSE 252A,A00,090127,Ochoa; Benjamin Lawrence,0,0,0,0
1653472764537,CSE 258,A01,090129,McAuley; Julian John,0,0,0,0
1653472765064,CSE 258R,A01,090131,McAuley; Julian John,0,0,0,0
1653472765588,CSE 274,A00,090132,Ramamoorthi; Ravi,0,0,0,0
1653472766113,CSE 276A,A00,090133,Christensen; Henrik I,0,0,0,0
1653472766639,CSE 276C,A00,090134,Christensen; Henrik I,0,0,0,0
1653472767164,CSE 290,A00,090135,Bafna; Vineet,0,0,0,0
1653472767164,CSE 290,B00,090136,Ramamoorthi; Ravi,0,0,0,0
1653472767164,CSE 290,C00,090137,Li; Tzumao,9,0,10,1
1653472767164,CSE 290,D00,090138,Zhou; Yuan-Yuan,10,0,10,0
1653472767164,CSE 290,E00,090139,Christensen; Henrik I,10,0,10,0
1653472767164,CSE 290,F00,094053,Shalev; Aaron D,0,0,0,0
1653472767692,CSE 291,A00,090140,Munyaka; Imani N. S.,0,0,0,0
1653472767692,CSE 291,B00,094880,Yu; Qi,0,0,0,0
1653472767692,CSE 291,C00,090142,Pannuto; Patrick William,0,0,0,0
1653472767692,CSE 291,D00,094881,Zhang; Yiying,0,0,0,0
1653472767692,CSE 291,E00,095118,Su; Hao,0,0,0,0
1653472768250,CSE 293,001,094905,Bafna; Vineet,9999,0,9999,0
1653472768250,CSE 293,002,094906,Bellare; Mihir,9999,0,9999,0
1653472768250,CSE 293,003,094907,Berg-Kirkpatrick; Taylor D,9999,0,9999,0
1653472768250,CSE 293,004,094908,Christensen; Henrik I,9999,0,9999,0
1653472768250,CSE 293,005,094909,Cottrell; Garrison W,9999,0,9999,0
1653472768250,CSE 293,006,094910,Deutsch; Alin Bernard,9999,0,9999,0
1653472768250,CSE 293,007,094911,Esmaeilzadeh; Hadi,9999,0,9999,0
1653472768250,CSE 293,008,094912,Freund; Yoav,9999,0,9999,0
1653472768250,CSE 293,009,094913,Griswold; William G.,9999,0,9999,0
1653472768250,CSE 293,010,094914,Gymrek; Melissa Ann,9999,0,9999,0
1653472768250,CSE 293,011,094915,Heninger; Nadia A,9999,0,9999,0
1653472768250,CSE 293,012,094916,Impagliazzo; Russell,9999,0,9999,0
1653472768250,CSE 293,013,094917,Jhala; Ranjit,9999,0,9999,0
1653472768250,CSE 293,014,094918,Kahng; Andrew Byun,9999,0,9999,0
1653472768250,CSE 293,015,094919,Kane; Daniel Mertz,9999,0,9999,0
1653472768250,CSE 293,016,094920,Kriegman; David J,9999,0,9999,0
1653472768250,CSE 293,017,094921,Kumar; Arun Kumar,9999,0,9999,0
1653472768250,CSE 293,018,094922,Lerner; Sorin,9999,0,9999,0
1653472768250,CSE 293,019,094923,Lovett; Shachar,9999,0,9999,0
1653472768250,CSE 293,020,094924,McAuley; Julian John,9999,0,9999,0
1653472768250,CSE 293,021,094925,Micciancio; Daniele,9999,0,9999,0
1653472768250,CSE 293,022,094926,Orailoglu; Alex,9999,0,9999,0
1653472768250,CSE 293,023,094927,Paturi; Ramamohan,9999,0,9999,0
1653472768250,CSE 293,024,094928,Polikarpova; Nadezhda,9999,0,9999,0
1653472768250,CSE 293,025,094929,Politz; Joseph Gibbs,9999,0,9999,0
1653472768250,CSE 293,026,094930,Porter; George M,9999,0,9999,0
1653472768250,CSE 293,027,094931,Porter; Leonard Emerson,9999,0,9999,0
1653472768250,CSE 293,028,094932,Ramamoorthi; Ravi,9999,0,9999,0
1653472768250,CSE 293,029,094933,Sahoo; Debashis,9999,0,9999,0
1653472768250,CSE 293,030,094934,Saul; Lawrence,9999,0,9999,0
1653472768250,CSE 293,031,094935,Savage; Stefan,9999,0,9999,0
1653472768250,CSE 293,032,094936,Schulze; Jurgen P.,9999,0,9999,0
1653472768250,CSE 293,033,094937,Snoeren; Alex C.,9999,0,9999,0
1653472768250,CSE 293,034,094938,Shang; Jingbo,9999,0,9999,0
1653472768250,CSE 293,035,094939,Stefan; Deian,9999,0,9999,0
1653472768250,CSE 293,036,094940,Su; Hao,9999,0,9999,0
1653472768250,CSE 293,037,094941,Swanson; Steven James,9999,0,9999,0
1653472768250,CSE 293,038,094942,Tullsen; Dean Michael,9999,0,9999,0
1653472768250,CSE 293,039,094943,Voelker; Geoffrey M.,9999,0,9999,0
1653472768250,CSE 293,040,094944,Zhao; Jishen,9999,0,9999,0
1653472768250,CSE 293,041,094945,Zhou; Yuan-Yuan,9999,0,9999,0
1653472768250,CSE 293,042,094946,Gao; Sicun,9998,0,9999,1
1653472768250,CSE 293,043,094947,Weibel; Nadir,9999,0,9999,0
1653472768250,CSE 293,044,094948,Gupta; Rajesh K.,9999,0,9999,0
1653472768776,CSE 294,A00,090143,Porter; George M,9,0,10,1
1653472769314,DSE 200,A00,091799,Staff,50,0,50,0
1653472769838,DSE 203,A00,091800,Gupta; Amarnath,30,0,30,0
1653472770359,DSE 250,A00,091801,Deutsch; Alin Bernard,30,0,30,0
1653472770883,DSE 290,A00,091802,Altintas De Callaf; Ilkay,50,0,50,0
1653472771436,ECE 200,001,091003,Antipa; Nicholas A,9999,0,9999,0
1653472771436,ECE 200,002,091004,Atanasov; Nikolay A.,9999,0,9999,0
1653472771436,ECE 200,003,091005,Bharadia; Dinesh,9999,0,9999,0
1653472771436,ECE 200,004,091006,Cheng; Chung Kuan,9999,0,9999,0
1653472771436,ECE 200,005,091007,Cosman; Pamela C.,9999,0,9999,0
1653472771436,ECE 200,006,091008,Staff,9999,0,9999,0
1653472771436,ECE 200,007,091009,Dayeh; Shadi Ahmad,9999,0,9999,0
1653472771436,ECE 200,008,091010,Fainman; Yeshaiahu,9999,0,9999,0
1653472771436,ECE 200,009,091011,Ford; Joseph Earl,9999,0,9999,0
1653472771436,ECE 200,010,091012,Franceschetti; Massimo,9999,0,9999,0
1653472771436,ECE 200,011,091013,Fullerton; Eric E,9999,0,9999,0
1653472771436,ECE 200,012,091014,Galton; Ian A,9999,0,9999,0
1653472771436,ECE 200,013,091015,Gilja; Vikash,9999,0,9999,0
1653472771436,ECE 200,014,091016,Hall; Drew A.,9999,0,9999,0
1653472771436,ECE 200,015,091017,Hsueh; Tzu-Chien,9999,0,9999,0
1653472771436,ECE 200,016,091018,Javidi; Tara,9999,0,9999,0
1653472771436,ECE 200,017,091019,Kahng; Andrew Byun,9999,0,9999,0
1653472771436,ECE 200,018,091020,Kim; Young-Han,9999,0,9999,0
1653472771436,ECE 200,019,091021,Koushanfar; Farinaz,9999,0,9999,0
1653472771436,ECE 200,020,091022,Kuzum; Duygu,9999,0,9999,0
1653472771436,ECE 200,021,091023,Le; Hanh-Phuc,9999,0,9999,0
1653472771436,ECE 200,022,091024,Lin; Bill,9999,0,9999,0
1653472771436,ECE 200,023,091025,Liu; Zhaowei,9999,0,9999,0
1653472771436,ECE 200,024,091026,Lo; Yu-Hwa,9999,0,9999,0
1653472771436,ECE 200,025,091027,Lomakin; Vitaliy,9999,0,9999,0
1653472771436,ECE 200,026,091028,Mercier; Patrick Philip,9999,0,9999,0
1653472771436,ECE 200,027,091029,Meyer; Florian,9999,0,9999,0
1653472771436,ECE 200,028,091030,Milstein; Laurence B.,9999,0,9999,0
1653472771436,ECE 200,029,091031,Mir Arabbaygi; Siavash,9999,0,9999,0
1653472771436,ECE 200,030,091032,Mookherjea; Shayan,9999,0,9999,0
1653472771436,ECE 200,031,091033,Morris; Karcher William,9999,0,9999,0
1653472771436,ECE 200,032,091034,Ng; Tse Nga,9999,0,9999,0
1653472771436,ECE 200,033,091035,Nguyen; Truong Quang,9999,0,9999,0
1653472771436,ECE 200,034,091036,Nomura; Kenji,9999,0,9999,0
1653472771436,ECE 200,035,091037,Orlitsky; Alon,9999,0,9999,0
1653472771436,ECE 200,036,091038,Pal; Piya,9999,0,9999,0
1653472771436,ECE 200,037,091039,Papen; George C.,9999,0,9999,0
1653472771436,ECE 200,038,091040,Radic; Stojan,9999,0,9999,0
1653472771436,ECE 200,039,091041,Rao; Bhaskar D.,9999,0,9999,0
1653472771436,ECE 200,040,091042,Rao; Ramesh R,9999,0,9999,0
1653472771436,ECE 200,041,091043,Rebeiz; Gabriel,9999,0,9999,0
1653472771436,ECE 200,042,091044,Sanford; John R,9999,0,9999,0
1653472771436,ECE 200,043,091045,Siegel; Paul H.,9999,0,9999,0
1653472771436,ECE 200,044,091046,Sievenpiper; Daniel F.,9999,0,9999,0
1653472771436,ECE 200,045,091047,Sworder; David D.,9999,0,9999,0
1653472771436,ECE 200,046,091048,Taur; Yuan,9999,0,9999,0
1653472771436,ECE 200,047,091049,Touri; Behrouz,9999,0,9999,0
1653472771436,ECE 200,048,091050,Trivedi; Mohan M.,9999,0,9999,0
1653472771436,ECE 200,049,091051,Vardy; Alexander,9999,0,9999,0
1653472771436,ECE 200,050,091052,Vasconcelos; Nuno,9999,0,9999,0
1653472771436,ECE 200,051,091053,Wang; Xiaolong,9999,0,9999,0
1653472771436,ECE 200,052,091054,Xie; Pengtao,9999,0,9999,0
1653472771436,ECE 200,053,091055,Yip; Michael,9999,0,9999,0
1653472771436,ECE 200,054,091056,Zeger; Kenneth A.,9999,0,9999,0
1653472771436,ECE 200,055,091057,Zhang; Xinyu,9999,0,9999,0
1653472771436,ECE 200,056,091058,Turakhia; Yatish Girish,9999,0,9999,0
1653472771436,ECE 200,057,091059,Kang; Mingu,9999,0,9999,0
1653472771436,ECE 200,058,091060,Shi; Yuanyuan,9999,0,9999,0
1653472771436,ECE 200,059,091061,Wang; Edward Jay,9999,0,9999,0
1653472771436,ECE 200,060,091062,Zheng; Yang,9999,0,9999,0
1653472771963,ECE 203,A00,091065,Mercier; Patrick Philip,0,0,0,0
1653472772486,ECE 207A,A00,091605,Liu; Thomas Tao-Ming,0,0,0,0
1653472773013,ECE 212AN,A00,091068,Nomura; Kenji,0,0,0,0
1653472773539,ECE 222A,A00,091069,Rebeiz; Gabriel,0,0,0,0
1653472774062,ECE 225A,A00,091070,Orlitsky; Alon,0,0,0,0
1653472774584,ECE 230A,A00,091071,Nomura; Kenji,0,0,0,0
1653472775108,ECE 236A,A00,091072,Dayeh; Shadi Ahmad,0,0,0,0
1653472775632,ECE 238A,A00,091073,Luo; Jian,0,0,0,0
1653472775632,ECE 238A,B00,091074,Luo; Jian,0,0,0,0
1653472776161,ECE 240A,A00,091075,Radic; Stojan,0,0,0,0
1653472776685,ECE 247A,A00,091592,Shi; Lingyan,0,0,0,0
1653472777209,ECE 250,A00,091076,Touri; Behrouz,0,0,0,0
1653472777732,ECE 251C,A00,091078,Nguyen; Truong Quang,0,0,0,0
1653472778260,ECE 253,A00,091079,Cosman; Pamela C.,0,0,0,0
1653472778784,ECE 255A,A00,091080,Orlitsky; Alon,0,0,0,0
1653472779309,ECE 257A,A00,091081,Zhang; Xinyu,0,0,0,0
1653472779833,ECE 260A,A01,091084,Eldon; John,0,0,0,0
1653472780356,ECE 264C,A00,091085,Galton; Ian A,0,0,0,0
1653472780880,ECE 265C,A00,094889,Presti; Calogero Davide,0,0,0,9
1653472781408,ECE 266,A01,091087,Hall; Drew A.,0,0,0,0
1653472782454,ECE 271A,A00,091090,Vasconcelos; Nuno,0,0,0,0
1653472782981,ECE 272B,A00,091091,Sworder; David D.,0,0,0,0
1653472783503,ECE 275A,A00,091092,Meyer; Florian,0,0,0,0
1653472784035,ECE 277,A00,091093,An; Cheolhong,0,0,0,0
1653472784558,ECE 283,A00,091094,Le; Hanh-Phuc,0,0,0,0
1653472785081,ECE 284,A00,091095,Kang; Mingu,0,0,0,0
1653472785081,ECE 284,B00,091096,Wang; Edward Jay,0,0,0,0
1653472785609,ECE 285,A00,094334,Touri; Behrouz,0,0,0,0
1653472786137,ECE 289,A00,091097,Whelan; David Arthur,0,0,0,0
1653472786662,MATH 200A,A00,087414,Salehi Golsefidy; Alireza,7,0,8,1
1653472787185,MATH 202A,A00,087415,Gill; Philip E.,3,0,8,5
1653472787726,MATH 203A,A00,087416,Oprea; Dragos N.,6,0,8,2
1653472788252,MATH 204A,A00,087417,Kedlaya; Kiran S.,6,0,8,2
1653472788780,MATH 205,A00,087418,Sorensen; Claus M,6,0,8,2
1653472789304,MATH 206A,A00,087419,Izadi; Elham,7,0,8,1
1653472789827,MATH 207A,A00,087420,Mohammadi; Amir,6,0,8,2
1653472790354,MATH 208,A00,087421,Staff,9,0,10,1
1653472790877,MATH 209,A00,087422,Staff,10,0,10,0
1653472791402,MATH 218,A00,087423,Staff,10,0,10,0
1653472791926,MATH 220A,A00,087424,Novak; Jonathan I,7,0,8,1
1653472792451,MATH 231A,A00,087425,Bejenaru; Ioan,3,0,8,5
1653472792975,MATH 240A,A00,087426,Ebenfelt; Peter F,5,0,8,3
1653472793500,MATH 243,A00,087427,Staff,9,0,10,1
1653472794022,MATH 248,A00,087429,Staff,10,0,10,0
1653472794546,MATH 250A,A00,087430,Spolaor; Luca,4,0,8,4
1653472795068,MATH 257A,A00,087431,Spolaor; Luca,7,0,8,1
1653472795593,MATH 258,A00,087432,Staff,9,0,10,1
1653472796117,MATH 264A,A00,087433,Warnke; Lutz Peter,5,0,8,3
1653472796639,MATH 268,A00,087434,Staff,15,0,15,0
1653472797165,MATH 269,A00,087435,Staff,14,0,15,1
1653472797691,MATH 270A,A00,087436,Nie; Jiawang,0,0,8,8
1653472798215,MATH 272A,A00,087437,Tian; Xiaochuan,1,0,8,7
1653472798828,MATH 274,A01,087439,Cheng; Li-Tien,9,0,10,1
1653472798828,MATH 274,A02,087440,Cheng; Li-Tien,10,0,10,0
1653472799355,MATH 278A,A00,087441,Staff,8,0,10,2
1653472799878,MATH 278B,A00,087442,Staff,8,0,10,2
1653472800400,MATH 278C,A00,087443,Staff,8,0,10,2
1653472800940,MATH 280A,A00,087444,Zheng; Tianyi,0,0,8,8
1653472801467,MATH 281A,A00,087445,Bradic; Jelena,0,0,8,8
1653472801995,MATH 282A,A00,087446,Zhang; Danna,0,0,8,8
1653472802517,MATH 283,A00,087447,Tesler; Glenn,0,0,0,14
1653472803039,MATH 286,A00,087448,Kemp; Todd Aahron,5,0,8,3
1653472803566,MATH 287D,A00,087449,Bradic; Jelena,8,0,8,0
1653472804091,MATH 288,A00,087450,Staff,14,0,15,1
1653472804091,MATH 288,B00,087451,Staff,15,0,15,0
1653472804091,MATH 288,C00,087452,Staff,15,0,15,0
1653472804614,MATH 290A,A00,087453,Xu; Zhouli,7,0,8,1
1653472805139,MATH 291A,A00,087454,Xu; Zhouli,7,0,8,1
1653472805663,MATH 292,A00,087455,Staff,10,0,10,0
1653472806187,MATH 295,A00,087456,Staff,50,0,50,0
1653472806709,MATH 297,001,087457,Staff,998,0,999,1
1653473367091,COGS 200,A01,087991,Staff,47,0,50,3
1653473367614,COGS 201,A01,094504,Rangel; Lara M,17,0,25,8
1653473368136,COGS 203,A00,087992,Coulson; Seana M,18,0,20,2
1653473368662,COGS 210A,001,087993,Greene; Deanna Jacquelyn,9998,0,9999,1
1653473368662,COGS 210A,002,087994,Saygin; Ayse P,9999,0,9999,0
1653473368662,COGS 210A,003,087995,Xia; Haijun,9999,0,9999,0
1653473368662,COGS 210A,004,087996,Nitz; Douglas A.,9999,0,9999,0
1653473368662,COGS 210A,005,087997,Hollan; James D.,9999,0,9999,0
1653473368662,COGS 210A,006,087998,Deak; Gedeon O.,9998,0,9999,1
1653473368662,COGS 210A,007,087999,Rossano; Federico,9999,0,9999,0
1653473369187,COGS 211A,A00,088000,Coulson; Seana M,9997,0,9999,2
1653473369710,COGS 229,A00,088002,Staff,23,0,25,2
1653473370233,COGS 260,B00,094231,Staff,17,0,20,3
1653473370233,COGS 260,A00,088004,Nitz; Douglas A.,9998,0,9999,1
1653473370760,CSE 202,A00,090110,Paturi; Ramamohan,0,0,0,0
1653473370760,CSE 202,B00,090111,Paturi; Ramamohan,0,0,0,0
1653473371284,CSE 207B,A00,090112,Heninger; Nadia A,0,0,0,0
1653473371807,CSE 208,A00,094858,Micciancio; Daniele,0,0,0,0
1653473372333,CSE 210,A00,090113,Powell; Thomas Allan,0,0,0,0
1653473372859,CSE 219,A00,090898,Staff,0,0,0,0
1653473373382,CSE 221,A00,090114,Zhou; Yuan-Yuan,0,0,0,0
1653473373908,CSE 229A,A00,090115,Porter; George M,0,0,0,0
1653473374430,CSE 229C,A00,090116,Savage; Stefan,0,0,0,0
1653473374953,CSE 230,A00,090117,Jhala; Ranjit,0,0,0,0
1653473375480,CSE 232,A00,090118,Papakonstantinou; Yannis,0,0,0,0
1653473376004,CSE 239A,A00,090121,Kumar; Arun Kumar,0,0,0,0
1653473376531,CSE 239B,A00,090122,Jhala; Ranjit,0,0,0,0
1653473377070,CSE 240A,A00,090123,Zhao; Jishen,0,0,189,189
1653473377596,CSE 243A,A00,090124,Orailoglu; Alex,0,0,15,15
1653473378121,CSE 249B,A00,090125,Kahng; Andrew Byun,13,0,20,7
1653473378644,CSE 250A,A00,090126,Berg-Kirkpatrick; Taylor D,0,0,0,0
1653473379166,CSE 252A,A00,090127,Ochoa; Benjamin Lawrence,0,0,0,0
1653473379691,CSE 258,A01,090129,McAuley; Julian John,0,0,0,0
1653473380216,CSE 258R,A01,090131,McAuley; Julian John,0,0,0,0
1653473380742,CSE 274,A00,090132,Ramamoorthi; Ravi,0,0,0,0
1653473381264,CSE 276A,A00,090133,Christensen; Henrik I,0,0,0,0
1653473381788,CSE 276C,A00,090134,Christensen; Henrik I,0,0,0,0
1653473382312,CSE 290,A00,090135,Bafna; Vineet,0,0,0,0
1653473382312,CSE 290,B00,090136,Ramamoorthi; Ravi,0,0,0,0
1653473382312,CSE 290,C00,090137,Li; Tzumao,9,0,10,1
1653473382312,CSE 290,D00,090138,Zhou; Yuan-Yuan,10,0,10,0
1653473382312,CSE 290,E00,090139,Christensen; Henrik I,10,0,10,0
1653473382312,CSE 290,F00,094053,Shalev; Aaron D,0,0,0,0
1653473382837,CSE 291,A00,090140,Munyaka; Imani N. S.,0,0,0,0
1653473382837,CSE 291,B00,094880,Yu; Qi,0,0,0,0
1653473382837,CSE 291,C00,090142,Pannuto; Patrick William,0,0,0,0
1653473382837,CSE 291,D00,094881,Zhang; Yiying,0,0,0,0
1653473382837,CSE 291,E00,095118,Su; Hao,0,0,0,0
1653473383387,CSE 293,001,094905,Bafna; Vineet,9999,0,9999,0
1653473383387,CSE 293,002,094906,Bellare; Mihir,9999,0,9999,0
1653473383387,CSE 293,003,094907,Berg-Kirkpatrick; Taylor D,9999,0,9999,0
1653473383387,CSE 293,004,094908,Christensen; Henrik I,9999,0,9999,0
1653473383387,CSE 293,005,094909,Cottrell; Garrison W,9999,0,9999,0
1653473383387,CSE 293,006,094910,Deutsch; Alin Bernard,9999,0,9999,0
1653473383387,CSE 293,007,094911,Esmaeilzadeh; Hadi,9999,0,9999,0
1653473383387,CSE 293,008,094912,Freund; Yoav,9999,0,9999,0
1653473383387,CSE 293,009,094913,Griswold; William G.,9999,0,9999,0
1653473383387,CSE 293,010,094914,Gymrek; Melissa Ann,9999,0,9999,0
1653473383387,CSE 293,011,094915,Heninger; Nadia A,9999,0,9999,0
1653473383387,CSE 293,012,094916,Impagliazzo; Russell,9999,0,9999,0
1653473383387,CSE 293,013,094917,Jhala; Ranjit,9999,0,9999,0
1653473383387,CSE 293,014,094918,Kahng; Andrew Byun,9999,0,9999,0
1653473383387,CSE 293,015,094919,Kane; Daniel Mertz,9999,0,9999,0
1653473383387,CSE 293,016,094920,Kriegman; David J,9999,0,9999,0
1653473383387,CSE 293,017,094921,Kumar; Arun Kumar,9999,0,9999,0
1653473383387,CSE 293,018,094922,Lerner; Sorin,9999,0,9999,0
1653473383387,CSE 293,019,094923,Lovett; Shachar,9999,0,9999,0
1653473383387,CSE 293,020,094924,McAuley; Julian John,9999,0,9999,0
1653473383387,CSE 293,021,094925,Micciancio; Daniele,9999,0,9999,0
1653473383387,CSE 293,022,094926,Orailoglu; Alex,9999,0,9999,0
1653473383387,CSE 293,023,094927,Paturi; Ramamohan,9999,0,9999,0
1653473383387,CSE 293,024,094928,Polikarpova; Nadezhda,9999,0,9999,0
1653473383387,CSE 293,025,094929,Politz; Joseph Gibbs,9999,0,9999,0
1653473383387,CSE 293,026,094930,Porter; George M,9999,0,9999,0
1653473383387,CSE 293,027,094931,Porter; Leonard Emerson,9999,0,9999,0
1653473383387,CSE 293,028,094932,Ramamoorthi; Ravi,9999,0,9999,0
1653473383387,CSE 293,029,094933,Sahoo; Debashis,9999,0,9999,0
1653473383387,CSE 293,030,094934,Saul; Lawrence,9999,0,9999,0
1653473383387,CSE 293,031,094935,Savage; Stefan,9999,0,9999,0
1653473383387,CSE 293,032,094936,Schulze; Jurgen P.,9999,0,9999,0
1653473383387,CSE 293,033,094937,Snoeren; Alex C.,9999,0,9999,0
1653473383387,CSE 293,034,094938,Shang; Jingbo,9999,0,9999,0
1653473383387,CSE 293,035,094939,Stefan; Deian,9999,0,9999,0
1653473383387,CSE 293,036,094940,Su; Hao,9999,0,9999,0
1653473383387,CSE 293,037,094941,Swanson; Steven James,9999,0,9999,0
1653473383387,CSE 293,038,094942,Tullsen; Dean Michael,9999,0,9999,0
1653473383387,CSE 293,039,094943,Voelker; Geoffrey M.,9999,0,9999,0
1653473383387,CSE 293,040,094944,Zhao; Jishen,9999,0,9999,0
1653473383387,CSE 293,041,094945,Zhou; Yuan-Yuan,9999,0,9999,0
1653473383387,CSE 293,042,094946,Gao; Sicun,9998,0,9999,1
1653473383387,CSE 293,043,094947,Weibel; Nadir,9999,0,9999,0
1653473383387,CSE 293,044,094948,Gupta; Rajesh K.,9999,0,9999,0
1653473383913,CSE 294,A00,090143,Porter; George M,9,0,10,1
1653473384434,DSE 200,A00,091799,Staff,50,0,50,0
1653473384961,DSE 203,A00,091800,Gupta; Amarnath,30,0,30,0
1653473385484,DSE 250,A00,091801,Deutsch; Alin Bernard,30,0,30,0
1653473386011,DSE 290,A00,091802,Altintas De Callaf; Ilkay,50,0,50,0
1653473386659,ECE 200,001,091003,Antipa; Nicholas A,9999,0,9999,0
1653473386659,ECE 200,002,091004,Atanasov; Nikolay A.,9999,0,9999,0
1653473386659,ECE 200,003,091005,Bharadia; Dinesh,9999,0,9999,0
1653473386659,ECE 200,004,091006,Cheng; Chung Kuan,9999,0,9999,0
1653473386659,ECE 200,005,091007,Cosman; Pamela C.,9999,0,9999,0
1653473386659,ECE 200,006,091008,Staff,9999,0,9999,0
1653473386659,ECE 200,007,091009,Dayeh; Shadi Ahmad,9999,0,9999,0
1653473386659,ECE 200,008,091010,Fainman; Yeshaiahu,9999,0,9999,0
1653473386659,ECE 200,009,091011,Ford; Joseph Earl,9999,0,9999,0
1653473386659,ECE 200,010,091012,Franceschetti; Massimo,9999,0,9999,0
1653473386659,ECE 200,011,091013,Fullerton; Eric E,9999,0,9999,0
1653473386659,ECE 200,012,091014,Galton; Ian A,9999,0,9999,0
1653473386659,ECE 200,013,091015,Gilja; Vikash,9999,0,9999,0
1653473386659,ECE 200,014,091016,Hall; Drew A.,9999,0,9999,0
1653473386659,ECE 200,015,091017,Hsueh; Tzu-Chien,9999,0,9999,0
1653473386659,ECE 200,016,091018,Javidi; Tara,9999,0,9999,0
1653473386659,ECE 200,017,091019,Kahng; Andrew Byun,9999,0,9999,0
1653473386659,ECE 200,018,091020,Kim; Young-Han,9999,0,9999,0
1653473386659,ECE 200,019,091021,Koushanfar; Farinaz,9999,0,9999,0
1653473386659,ECE 200,020,091022,Kuzum; Duygu,9999,0,9999,0
1653473386659,ECE 200,021,091023,Le; Hanh-Phuc,9999,0,9999,0
1653473386659,ECE 200,022,091024,Lin; Bill,9999,0,9999,0
1653473386659,ECE 200,023,091025,Liu; Zhaowei,9999,0,9999,0
1653473386659,ECE 200,024,091026,Lo; Yu-Hwa,9999,0,9999,0
1653473386659,ECE 200,025,091027,Lomakin; Vitaliy,9999,0,9999,0
1653473386659,ECE 200,026,091028,Mercier; Patrick Philip,9999,0,9999,0
1653473386659,ECE 200,027,091029,Meyer; Florian,9999,0,9999,0
1653473386659,ECE 200,028,091030,Milstein; Laurence B.,9999,0,9999,0
1653473386659,ECE 200,029,091031,Mir Arabbaygi; Siavash,9999,0,9999,0
1653473386659,ECE 200,030,091032,Mookherjea; Shayan,9999,0,9999,0
1653473386659,ECE 200,031,091033,Morris; Karcher William,9999,0,9999,0
1653473386659,ECE 200,032,091034,Ng; Tse Nga,9999,0,9999,0
1653473386659,ECE 200,033,091035,Nguyen; Truong Quang,9999,0,9999,0
1653473386659,ECE 200,034,091036,Nomura; Kenji,9999,0,9999,0
1653473386659,ECE 200,035,091037,Orlitsky; Alon,9999,0,9999,0
1653473386659,ECE 200,036,091038,Pal; Piya,9999,0,9999,0
1653473386659,ECE 200,037,091039,Papen; George C.,9999,0,9999,0
1653473386659,ECE 200,038,091040,Radic; Stojan,9999,0,9999,0
1653473386659,ECE 200,039,091041,Rao; Bhaskar D.,9999,0,9999,0
1653473386659,ECE 200,040,091042,Rao; Ramesh R,9999,0,9999,0
1653473386659,ECE 200,041,091043,Rebeiz; Gabriel,9999,0,9999,0
1653473386659,ECE 200,042,091044,Sanford; John R,9999,0,9999,0
1653473386659,ECE 200,043,091045,Siegel; Paul H.,9999,0,9999,0
1653473386659,ECE 200,044,091046,Sievenpiper; Daniel F.,9999,0,9999,0
1653473386659,ECE 200,045,091047,Sworder; David D.,9999,0,9999,0
1653473386659,ECE 200,046,091048,Taur; Yuan,9999,0,9999,0
1653473386659,ECE 200,047,091049,Touri; Behrouz,9999,0,9999,0
1653473386659,ECE 200,048,091050,Trivedi; Mohan M.,9999,0,9999,0
1653473386659,ECE 200,049,091051,Vardy; Alexander,9999,0,9999,0
1653473386659,ECE 200,050,091052,Vasconcelos; Nuno,9999,0,9999,0
1653473386659,ECE 200,051,091053,Wang; Xiaolong,9999,0,9999,0
1653473386659,ECE 200,052,091054,Xie; Pengtao,9999,0,9999,0
1653473386659,ECE 200,053,091055,Yip; Michael,9999,0,9999,0
1653473386659,ECE 200,054,091056,Zeger; Kenneth A.,9999,0,9999,0
1653473386659,ECE 200,055,091057,Zhang; Xinyu,9999,0,9999,0
1653473386659,ECE 200,056,091058,Turakhia; Yatish Girish,9999,0,9999,0
1653473386659,ECE 200,057,091059,Kang; Mingu,9999,0,9999,0
1653473386659,ECE 200,058,091060,Shi; Yuanyuan,9999,0,9999,0
1653473386659,ECE 200,059,091061,Wang; Edward Jay,9999,0,9999,0
1653473386659,ECE 200,060,091062,Zheng; Yang,9999,0,9999,0
1653473387187,ECE 203,A00,091065,Mercier; Patrick Philip,0,0,0,0
1653473387715,ECE 207A,A00,091605,Liu; Thomas Tao-Ming,0,0,0,0
1653473388238,ECE 212AN,A00,091068,Nomura; Kenji,0,0,0,0
1653473388762,ECE 222A,A00,091069,Rebeiz; Gabriel,0,0,0,0
1653473389286,ECE 225A,A00,091070,Orlitsky; Alon,0,0,0,0
1653473389813,ECE 230A,A00,091071,Nomura; Kenji,0,0,0,0
1653473390351,ECE 236A,A00,091072,Dayeh; Shadi Ahmad,0,0,0,0
1653473390880,ECE 238A,A00,091073,Luo; Jian,0,0,0,0
1653473390880,ECE 238A,B00,091074,Luo; Jian,0,0,0,0
1653473391404,ECE 240A,A00,091075,Radic; Stojan,0,0,0,0
1653473391929,ECE 247A,A00,091592,Shi; Lingyan,0,0,0,0
1653473392455,ECE 250,A00,091076,Touri; Behrouz,0,0,0,0
1653473392979,ECE 251C,A00,091078,Nguyen; Truong Quang,0,0,0,0
1653473393501,ECE 253,A00,091079,Cosman; Pamela C.,0,0,0,0
1653473394024,ECE 255A,A00,091080,Orlitsky; Alon,0,0,0,0
1653473394551,ECE 257A,A00,091081,Zhang; Xinyu,0,0,0,0
1653473395077,ECE 260A,A01,091084,Eldon; John,0,0,0,0
1653473395610,ECE 264C,A00,091085,Galton; Ian A,0,0,0,0
1653473396134,ECE 265C,A00,094889,Presti; Calogero Davide,0,0,0,9
1653473396661,ECE 266,A01,091087,Hall; Drew A.,0,0,0,0
1653473397713,ECE 271A,A00,091090,Vasconcelos; Nuno,0,0,0,0
1653473398234,ECE 272B,A00,091091,Sworder; David D.,0,0,0,0
1653473398758,ECE 275A,A00,091092,Meyer; Florian,0,0,0,0
1653473399286,ECE 277,A00,091093,An; Cheolhong,0,0,0,0
1653473399816,ECE 283,A00,091094,Le; Hanh-Phuc,0,0,0,0
1653473400339,ECE 284,A00,091095,Kang; Mingu,0,0,0,0
1653473400339,ECE 284,B00,091096,Wang; Edward Jay,0,0,0,0
1653473400866,ECE 285,A00,094334,Touri; Behrouz,0,0,0,0
1653473401391,ECE 289,A00,091097,Whelan; David Arthur,0,0,0,0
1653473401914,MATH 200A,A00,087414,Salehi Golsefidy; Alireza,7,0,8,1
1653473402441,MATH 202A,A00,087415,Gill; Philip E.,3,0,8,5
1653473402972,MATH 203A,A00,087416,Oprea; Dragos N.,6,0,8,2
1653473403496,MATH 204A,A00,087417,Kedlaya; Kiran S.,6,0,8,2
1653473404020,MATH 205,A00,087418,Sorensen; Claus M,6,0,8,2
1653473404544,MATH 206A,A00,087419,Izadi; Elham,7,0,8,1
1653473405067,MATH 207A,A00,087420,Mohammadi; Amir,6,0,8,2
1653473405589,MATH 208,A00,087421,Staff,9,0,10,1
1653473406111,MATH 209,A00,087422,Staff,10,0,10,0
1653473406636,MATH 218,A00,087423,Staff,10,0,10,0
1653473407164,MATH 220A,A00,087424,Novak; Jonathan I,7,0,8,1
1653473407688,MATH 231A,A00,087425,Bejenaru; Ioan,3,0,8,5
1653473408217,MATH 240A,A00,087426,Ebenfelt; Peter F,5,0,8,3
1653473408740,MATH 243,A00,087427,Staff,9,0,10,1
1653473409266,MATH 248,A00,087429,Staff,10,0,10,0
1653473409792,MATH 250A,A00,087430,Spolaor; Luca,4,0,8,4
1653473410315,MATH 257A,A00,087431,Spolaor; Luca,7,0,8,1
1653473410837,MATH 258,A00,087432,Staff,9,0,10,1
1653473411359,MATH 264A,A00,087433,Warnke; Lutz Peter,5,0,8,3
1653473411882,MATH 268,A00,087434,Staff,15,0,15,0
1653473412409,MATH 269,A00,087435,Staff,14,0,15,1
1653473412931,MATH 270A,A00,087436,Nie; Jiawang,0,0,8,8
1653473413455,MATH 272A,A00,087437,Tian; Xiaochuan,1,0,8,7
1653473413979,MATH 274,A01,087439,Cheng; Li-Tien,9,0,10,1
1653473413979,MATH 274,A02,087440,Cheng; Li-Tien,10,0,10,0
1653473414503,MATH 278A,A00,087441,Staff,8,0,10,2
1653473415029,MATH 278B,A00,087442,Staff,8,0,10,2
1653473415554,MATH 278C,A00,087443,Staff,8,0,10,2
1653473416105,MATH 280A,A00,087444,Zheng; Tianyi,0,0,8,8
1653473416628,MATH 281A,A00,087445,Bradic; Jelena,0,0,8,8
1653473417152,MATH 282A,A00,087446,Zhang; Danna,0,0,8,8
1653473417674,MATH 283,A00,087447,Tesler; Glenn,0,0,0,14
1653473418199,MATH 286,A00,087448,Kemp; Todd Aahron,5,0,8,3
1653473418729,MATH 287D,A00,087449,Bradic; Jelena,8,0,8,0
1653473419253,MATH 288,A00,087450,Staff,14,0,15,1
1653473419253,MATH 288,B00,087451,Staff,15,0,15,0
1653473419253,MATH 288,C00,087452,Staff,15,0,15,0
1653473419775,MATH 290A,A00,087453,Xu; Zhouli,7,0,8,1
1653473420297,MATH 291A,A00,087454,Xu; Zhouli,7,0,8,1
1653473420822,MATH 292,A00,087455,Staff,10,0,10,0
1653473421345,MATH 295,A00,087456,Staff,50,0,50,0
1653473421870,MATH 297,001,087457,Staff,998,0,999,1
1653473981344,COGS 200,A01,087991,Staff,47,0,50,3
1653473981876,COGS 201,A01,094504,Rangel; Lara M,17,0,25,8
1653473982399,COGS 203,A00,087992,Coulson; Seana M,18,0,20,2
1653473982927,COGS 210A,001,087993,Greene; Deanna Jacquelyn,9998,0,9999,1
1653473982927,COGS 210A,002,087994,Saygin; Ayse P,9999,0,9999,0
1653473982927,COGS 210A,003,087995,Xia; Haijun,9999,0,9999,0
1653473982927,COGS 210A,004,087996,Nitz; Douglas A.,9999,0,9999,0
1653473982927,COGS 210A,005,087997,Hollan; James D.,9999,0,9999,0
1653473982927,COGS 210A,006,087998,Deak; Gedeon O.,9998,0,9999,1
1653473982927,COGS 210A,007,087999,Rossano; Federico,9999,0,9999,0
1653473983453,COGS 211A,A00,088000,Coulson; Seana M,9997,0,9999,2
1653473983980,COGS 229,A00,088002,Staff,23,0,25,2
1653473984505,COGS 260,B00,094231,Staff,17,0,20,3
1653473984505,COGS 260,A00,088004,Nitz; Douglas A.,9998,0,9999,1
1653473985028,CSE 202,A00,090110,Paturi; Ramamohan,0,0,0,0
1653473985028,CSE 202,B00,090111,Paturi; Ramamohan,0,0,0,0
1653473985556,CSE 207B,A00,090112,Heninger; Nadia A,0,0,0,0
1653473986085,CSE 208,A00,094858,Micciancio; Daniele,0,0,0,0
1653473986611,CSE 210,A00,090113,Powell; Thomas Allan,0,0,0,0
1653473987133,CSE 219,A00,090898,Staff,0,0,0,0
1653473987660,CSE 221,A00,090114,Zhou; Yuan-Yuan,0,0,0,0
1653473988186,CSE 229A,A00,090115,Porter; George M,0,0,0,0
1653473988708,CSE 229C,A00,090116,Savage; Stefan,0,0,0,0
1653473989236,CSE 230,A00,090117,Jhala; Ranjit,0,0,0,0
1653473989759,CSE 232,A00,090118,Papakonstantinou; Yannis,0,0,0,0
1653473990285,CSE 239A,A00,090121,Kumar; Arun Kumar,0,0,0,0
1653473990808,CSE 239B,A00,090122,Jhala; Ranjit,0,0,0,0
1653473991332,CSE 240A,A00,090123,Zhao; Jishen,0,0,189,189
1653473991854,CSE 243A,A00,090124,Orailoglu; Alex,0,0,15,15
1653473992380,CSE 249B,A00,090125,Kahng; Andrew Byun,13,0,20,7
1653473992903,CSE 250A,A00,090126,Berg-Kirkpatrick; Taylor D,0,0,0,0
1653473993424,CSE 252A,A00,090127,Ochoa; Benjamin Lawrence,0,0,0,0
1653473993946,CSE 258,A01,090129,McAuley; Julian John,0,0,0,0
1653473994467,CSE 258R,A01,090131,McAuley; Julian John,0,0,0,0
1653473994989,CSE 274,A00,090132,Ramamoorthi; Ravi,0,0,0,0
1653473995512,CSE 276A,A00,090133,Christensen; Henrik I,0,0,0,0
1653473996035,CSE 276C,A00,090134,Christensen; Henrik I,0,0,0,0
1653473996564,CSE 290,A00,090135,Bafna; Vineet,0,0,0,0
1653473996564,CSE 290,B00,090136,Ramamoorthi; Ravi,0,0,0,0
1653473996564,CSE 290,C00,090137,Li; Tzumao,9,0,10,1
1653473996564,CSE 290,D00,090138,Zhou; Yuan-Yuan,10,0,10,0
1653473996564,CSE 290,E00,090139,Christensen; Henrik I,10,0,10,0
1653473996564,CSE 290,F00,094053,Shalev; Aaron D,0,0,0,0
1653473997090,CSE 291,A00,090140,Munyaka; Imani N. S.,0,0,0,0
1653473997090,CSE 291,B00,094880,Yu; Qi,0,0,0,0
1653473997090,CSE 291,C00,090142,Pannuto; Patrick William,0,0,0,0
1653473997090,CSE 291,D00,094881,Zhang; Yiying,0,0,0,0
1653473997090,CSE 291,E00,095118,Su; Hao,0,0,0,0
1653473997636,CSE 293,001,094905,Bafna; Vineet,9999,0,9999,0
1653473997636,CSE 293,002,094906,Bellare; Mihir,9999,0,9999,0
1653473997636,CSE 293,003,094907,Berg-Kirkpatrick; Taylor D,9999,0,9999,0
1653473997636,CSE 293,004,094908,Christensen; Henrik I,9999,0,9999,0
1653473997636,CSE 293,005,094909,Cottrell; Garrison W,9999,0,9999,0
1653473997636,CSE 293,006,094910,Deutsch; Alin Bernard,9999,0,9999,0
1653473997636,CSE 293,007,094911,Esmaeilzadeh; Hadi,9999,0,9999,0
1653473997636,CSE 293,008,094912,Freund; Yoav,9999,0,9999,0
1653473997636,CSE 293,009,094913,Griswold; William G.,9999,0,9999,0
1653473997636,CSE 293,010,094914,Gymrek; Melissa Ann,9999,0,9999,0
1653473997636,CSE 293,011,094915,Heninger; Nadia A,9999,0,9999,0
1653473997636,CSE 293,012,094916,Impagliazzo; Russell,9999,0,9999,0
1653473997636,CSE 293,013,094917,Jhala; Ranjit,9999,0,9999,0
1653473997636,CSE 293,014,094918,Kahng; Andrew Byun,9999,0,9999,0
1653473997636,CSE 293,015,094919,Kane; Daniel Mertz,9999,0,9999,0
1653473997636,CSE 293,016,094920,Kriegman; David J,9999,0,9999,0
1653473997636,CSE 293,017,094921,Kumar; Arun Kumar,9999,0,9999,0
1653473997636,CSE 293,018,094922,Lerner; Sorin,9999,0,9999,0
1653473997636,CSE 293,019,094923,Lovett; Shachar,9999,0,9999,0
1653473997636,CSE 293,020,094924,McAuley; Julian John,9999,0,9999,0
1653473997636,CSE 293,021,094925,Micciancio; Daniele,9999,0,9999,0
1653473997636,CSE 293,022,094926,Orailoglu; Alex,9999,0,9999,0
1653473997636,CSE 293,023,094927,Paturi; Ramamohan,9999,0,9999,0
1653473997636,CSE 293,024,094928,Polikarpova; Nadezhda,9999,0,9999,0
1653473997636,CSE 293,025,094929,Politz; Joseph Gibbs,9999,0,9999,0
1653473997636,CSE 293,026,094930,Porter; George M,9999,0,9999,0
1653473997636,CSE 293,027,094931,Porter; Leonard Emerson,9999,0,9999,0
1653473997636,CSE 293,028,094932,Ramamoorthi; Ravi,9999,0,9999,0
1653473997636,CSE 293,029,094933,Sahoo; Debashis,9999,0,9999,0
1653473997636,CSE 293,030,094934,Saul; Lawrence,9999,0,9999,0
1653473997636,CSE 293,031,094935,Savage; Stefan,9999,0,9999,0
1653473997636,CSE 293,032,094936,Schulze; Jurgen P.,9999,0,9999,0
1653473997636,CSE 293,033,094937,Snoeren; Alex C.,9999,0,9999,0
1653473997636,CSE 293,034,094938,Shang; Jingbo,9999,0,9999,0
1653473997636,CSE 293,035,094939,Stefan; Deian,9999,0,9999,0
1653473997636,CSE 293,036,094940,Su; Hao,9999,0,9999,0
1653473997636,CSE 293,037,094941,Swanson; Steven James,9999,0,9999,0
1653473997636,CSE 293,038,094942,Tullsen; Dean Michael,9999,0,9999,0
1653473997636,CSE 293,039,094943,Voelker; Geoffrey M.,9999,0,9999,0
1653473997636,CSE 293,040,094944,Zhao; Jishen,9999,0,9999,0
1653473997636,CSE 293,041,094945,Zhou; Yuan-Yuan,9999,0,9999,0
1653473997636,CSE 293,042,094946,Gao; Sicun,9998,0,9999,1
1653473997636,CSE 293,043,094947,Weibel; Nadir,9999,0,9999,0
1653473997636,CSE 293,044,094948,Gupta; Rajesh K.,9999,0,9999,0
1653473998160,CSE 294,A00,090143,Porter; George M,9,0,10,1
1653473998684,DSE 200,A00,091799,Staff,50,0,50,0
1653473999207,DSE 203,A00,091800,Gupta; Amarnath,30,0,30,0
1653473999729,DSE 250,A00,091801,Deutsch; Alin Bernard,30,0,30,0
1653474000260,DSE 290,A00,091802,Altintas De Callaf; Ilkay,50,0,50,0
1653474000809,ECE 200,001,091003,Antipa; Nicholas A,9999,0,9999,0
1653474000809,ECE 200,002,091004,Atanasov; Nikolay A.,9999,0,9999,0
1653474000809,ECE 200,003,091005,Bharadia; Dinesh,9999,0,9999,0
1653474000809,ECE 200,004,091006,Cheng; Chung Kuan,9999,0,9999,0
1653474000809,ECE 200,005,091007,Cosman; Pamela C.,9999,0,9999,0
1653474000809,ECE 200,006,091008,Staff,9999,0,9999,0
1653474000809,ECE 200,007,091009,Dayeh; Shadi Ahmad,9999,0,9999,0
1653474000809,ECE 200,008,091010,Fainman; Yeshaiahu,9999,0,9999,0
1653474000809,ECE 200,009,091011,Ford; Joseph Earl,9999,0,9999,0
1653474000809,ECE 200,010,091012,Franceschetti; Massimo,9999,0,9999,0
1653474000809,ECE 200,011,091013,Fullerton; Eric E,9999,0,9999,0
1653474000809,ECE 200,012,091014,Galton; Ian A,9999,0,9999,0
1653474000809,ECE 200,013,091015,Gilja; Vikash,9999,0,9999,0
1653474000809,ECE 200,014,091016,Hall; Drew A.,9999,0,9999,0
1653474000809,ECE 200,015,091017,Hsueh; Tzu-Chien,9999,0,9999,0
1653474000809,ECE 200,016,091018,Javidi; Tara,9999,0,9999,0
1653474000809,ECE 200,017,091019,Kahng; Andrew Byun,9999,0,9999,0
1653474000809,ECE 200,018,091020,Kim; Young-Han,9999,0,9999,0
1653474000809,ECE 200,019,091021,Koushanfar; Farinaz,9999,0,9999,0
1653474000809,ECE 200,020,091022,Kuzum; Duygu,9999,0,9999,0
1653474000809,ECE 200,021,091023,Le; Hanh-Phuc,9999,0,9999,0
1653474000809,ECE 200,022,091024,Lin; Bill,9999,0,9999,0
1653474000809,ECE 200,023,091025,Liu; Zhaowei,9999,0,9999,0
1653474000809,ECE 200,024,091026,Lo; Yu-Hwa,9999,0,9999,0
1653474000809,ECE 200,025,091027,Lomakin; Vitaliy,9999,0,9999,0
1653474000809,ECE 200,026,091028,Mercier; Patrick Philip,9999,0,9999,0
1653474000809,ECE 200,027,091029,Meyer; Florian,9999,0,9999,0
1653474000809,ECE 200,028,091030,Milstein; Laurence B.,9999,0,9999,0
1653474000809,ECE 200,029,091031,Mir Arabbaygi; Siavash,9999,0,9999,0
1653474000809,ECE 200,030,091032,Mookherjea; Shayan,9999,0,9999,0
1653474000809,ECE 200,031,091033,Morris; Karcher William,9999,0,9999,0
1653474000809,ECE 200,032,091034,Ng; Tse Nga,9999,0,9999,0
1653474000809,ECE 200,033,091035,Nguyen; Truong Quang,9999,0,9999,0
1653474000809,ECE 200,034,091036,Nomura; Kenji,9999,0,9999,0
1653474000809,ECE 200,035,091037,Orlitsky; Alon,9999,0,9999,0
1653474000809,ECE 200,036,091038,Pal; Piya,9999,0,9999,0
1653474000809,ECE 200,037,091039,Papen; George C.,9999,0,9999,0
1653474000809,ECE 200,038,091040,Radic; Stojan,9999,0,9999,0
1653474000809,ECE 200,039,091041,Rao; Bhaskar D.,9999,0,9999,0
1653474000809,ECE 200,040,091042,Rao; Ramesh R,9999,0,9999,0
1653474000809,ECE 200,041,091043,Rebeiz; Gabriel,9999,0,9999,0
1653474000809,ECE 200,042,091044,Sanford; John R,9999,0,9999,0
1653474000809,ECE 200,043,091045,Siegel; Paul H.,9999,0,9999,0
1653474000809,ECE 200,044,091046,Sievenpiper; Daniel F.,9999,0,9999,0
1653474000809,ECE 200,045,091047,Sworder; David D.,9999,0,9999,0
1653474000809,ECE 200,046,091048,Taur; Yuan,9999,0,9999,0
1653474000809,ECE 200,047,091049,Touri; Behrouz,9999,0,9999,0
1653474000809,ECE 200,048,091050,Trivedi; Mohan M.,9999,0,9999,0
1653474000809,ECE 200,049,091051,Vardy; Alexander,9999,0,9999,0
1653474000809,ECE 200,050,091052,Vasconcelos; Nuno,9999,0,9999,0
1653474000809,ECE 200,051,091053,Wang; Xiaolong,9999,0,9999,0
1653474000809,ECE 200,052,091054,Xie; Pengtao,9999,0,9999,0
1653474000809,ECE 200,053,091055,Yip; Michael,9999,0,9999,0
1653474000809,ECE 200,054,091056,Zeger; Kenneth A.,9999,0,9999,0
1653474000809,ECE 200,055,091057,Zhang; Xinyu,9999,0,9999,0
1653474000809,ECE 200,056,091058,Turakhia; Yatish Girish,9999,0,9999,0
1653474000809,ECE 200,057,091059,Kang; Mingu,9999,0,9999,0
1653474000809,ECE 200,058,091060,Shi; Yuanyuan,9999,0,9999,0
1653474000809,ECE 200,059,091061,Wang; Edward Jay,9999,0,9999,0
1653474000809,ECE 200,060,091062,Zheng; Yang,9999,0,9999,0
1653474001335,ECE 203,A00,091065,Mercier; Patrick Philip,0,0,0,0
1653474001861,ECE 207A,A00,091605,Liu; Thomas Tao-Ming,0,0,0,0
1653474002384,ECE 212AN,A00,091068,Nomura; Kenji,0,0,0,0
1653474002906,ECE 222A,A00,091069,Rebeiz; Gabriel,0,0,0,0
1653474003433,ECE 225A,A00,091070,Orlitsky; Alon,0,0,0,0
1653474003958,ECE 230A,A00,091071,Nomura; Kenji,0,0,0,0
1653474004484,ECE 236A,A00,091072,Dayeh; Shadi Ahmad,0,0,0,0
1653474005006,ECE 238A,A00,091073,Luo; Jian,0,0,0,0
1653474005006,ECE 238A,B00,091074,Luo; Jian,0,0,0,0
1653474005528,ECE 240A,A00,091075,Radic; Stojan,0,0,0,0
1653474006067,ECE 247A,A00,091592,Shi; Lingyan,0,0,0,0
1653474006592,ECE 250,A00,091076,Touri; Behrouz,0,0,0,0
1653474007119,ECE 251C,A00,091078,Nguyen; Truong Quang,0,0,0,0
1653474007643,ECE 253,A00,091079,Cosman; Pamela C.,0,0,0,0
1653474008166,ECE 255A,A00,091080,Orlitsky; Alon,0,0,0,0
1653474008692,ECE 257A,A00,091081,Zhang; Xinyu,0,0,0,0
1653474009225,ECE 260A,A01,091084,Eldon; John,0,0,0,0
1653474009749,ECE 264C,A00,091085,Galton; Ian A,0,0,0,0
1653474010272,ECE 265C,A00,094889,Presti; Calogero Davide,0,0,0,9
1653474010795,ECE 266,A01,091087,Hall; Drew A.,0,0,0,0
1653474011842,ECE 271A,A00,091090,Vasconcelos; Nuno,0,0,0,0
1653474012365,ECE 272B,A00,091091,Sworder; David D.,0,0,0,0
1653474012887,ECE 275A,A00,091092,Meyer; Florian,0,0,0,0
1653474013411,ECE 277,A00,091093,An; Cheolhong,0,0,0,0
1653474013934,ECE 283,A00,091094,Le; Hanh-Phuc,0,0,0,0
1653474014456,ECE 284,A00,091095,Kang; Mingu,0,0,0,0
1653474014456,ECE 284,B00,091096,Wang; Edward Jay,0,0,0,0
1653474014987,ECE 285,A00,094334,Touri; Behrouz,0,0,0,0
1653474015509,ECE 289,A00,091097,Whelan; David Arthur,0,0,0,0
1653474016040,MATH 200A,A00,087414,Salehi Golsefidy; Alireza,7,0,8,1
1653474016564,MATH 202A,A00,087415,Gill; Philip E.,3,0,8,5
1653474017095,MATH 203A,A00,087416,Oprea; Dragos N.,6,0,8,2
1653474017622,MATH 204A,A00,087417,Kedlaya; Kiran S.,6,0,8,2
1653474018145,MATH 205,A00,087418,Sorensen; Claus M,6,0,8,2
1653474018669,MATH 206A,A00,087419,Izadi; Elham,7,0,8,1
1653474019191,MATH 207A,A00,087420,Mohammadi; Amir,6,0,8,2
1653474019718,MATH 208,A00,087421,Staff,9,0,10,1
1653474020245,MATH 209,A00,087422,Staff,10,0,10,0
1653474020771,MATH 218,A00,087423,Staff,10,0,10,0
1653474021294,MATH 220A,A00,087424,Novak; Jonathan I,7,0,8,1
1653474021821,MATH 231A,A00,087425,Bejenaru; Ioan,3,0,8,5
1653474022349,MATH 240A,A00,087426,Ebenfelt; Peter F,5,0,8,3
1653474022873,MATH 243,A00,087427,Staff,9,0,10,1
1653474023398,MATH 248,A00,087429,Staff,10,0,10,0
1653474023924,MATH 250A,A00,087430,Spolaor; Luca,4,0,8,4
1653474024445,MATH 257A,A00,087431,Spolaor; Luca,7,0,8,1
1653474024969,MATH 258,A00,087432,Staff,9,0,10,1
1653474025492,MATH 264A,A00,087433,Warnke; Lutz Peter,5,0,8,3
1653474026019,MATH 268,A00,087434,Staff,15,0,15,0
1653474026633,MATH 269,A00,087435,Staff,14,0,15,1
1653474027156,MATH 270A,A00,087436,Nie; Jiawang,0,0,8,8
1653474027683,MATH 272A,A00,087437,Tian; Xiaochuan,1,0,8,7
1653474028206,MATH 274,A01,087439,Cheng; Li-Tien,9,0,10,1
1653474028206,MATH 274,A02,087440,Cheng; Li-Tien,10,0,10,0
1653474028728,MATH 278A,A00,087441,Staff,8,0,10,2
1653474029251,MATH 278B,A00,087442,Staff,8,0,10,2
1653474029774,MATH 278C,A00,087443,Staff,8,0,10,2
1653474030295,MATH 280A,A00,087444,Zheng; Tianyi,0,0,8,8
1653474030818,MATH 281A,A00,087445,Bradic; Jelena,0,0,8,8
1653474031342,MATH 282A,A00,087446,Zhang; Danna,0,0,8,8
1653474031864,MATH 283,A00,087447,Tesler; Glenn,0,0,0,14
1653474032389,MATH 286,A00,087448,Kemp; Todd Aahron,5,0,8,3
1653474032914,MATH 287D,A00,087449,Bradic; Jelena,8,0,8,0
1653474033437,MATH 288,A00,087450,Staff,14,0,15,1
1653474033437,MATH 288,B00,087451,Staff,15,0,15,0
1653474033437,MATH 288,C00,087452,Staff,15,0,15,0
1653474033963,MATH 290A,A00,087453,Xu; Zhouli,7,0,8,1
1653474034492,MATH 291A,A00,087454,Xu; Zhouli,7,0,8,1
1653474035013,MATH 292,A00,087455,Staff,10,0,10,0
1653474035539,MATH 295,A00,087456,Staff,50,0,50,0
1653474036063,MATH 297,001,087457,Staff,998,0,999,1
1653474595068,COGS 200,A01,087991,Staff,47,0,50,3
1653474595596,COGS 201,A01,094504,Rangel; Lara M,17,0,25,8
1653474596119,COGS 203,A00,087992,Coulson; Seana M,18,0,20,2
1653474596646,COGS 210A,001,087993,Greene; Deanna Jacquelyn,9998,0,9999,1
1653474596646,COGS 210A,002,087994,Saygin; Ayse P,9999,0,9999,0
1653474596646,COGS 210A,003,087995,Xia; Haijun,9999,0,9999,0
1653474596646,COGS 210A,004,087996,Nitz; Douglas A.,9999,0,9999,0
1653474596646,COGS 210A,005,087997,Hollan; James D.,9999,0,9999,0
1653474596646,COGS 210A,006,087998,Deak; Gedeon O.,9998,0,9999,1
1653474596646,COGS 210A,007,087999,Rossano; Federico,9999,0,9999,0
1653474597171,COGS 211A,A00,088000,Coulson; Seana M,9997,0,9999,2
1653474597694,COGS 229,A00,088002,Staff,23,0,25,2
1653474598219,COGS 260,B00,094231,Staff,17,0,20,3
1653474598219,COGS 260,A00,088004,Nitz; Douglas A.,9998,0,9999,1
1653474598743,CSE 202,A00,090110,Paturi; Ramamohan,0,0,0,0
1653474598743,CSE 202,B00,090111,Paturi; Ramamohan,0,0,0,0
1653474599266,CSE 207B,A00,090112,Heninger; Nadia A,0,0,0,0
1653474599787,CSE 208,A00,094858,Micciancio; Daniele,0,0,0,0
1653474600317,CSE 210,A00,090113,Powell; Thomas Allan,0,0,0,0
1653474600839,CSE 219,A00,090898,Staff,0,0,0,0
1653474601361,CSE 221,A00,090114,Zhou; Yuan-Yuan,0,0,0,0
1653474601883,CSE 229A,A00,090115,Porter; George M,0,0,0,0
1653474602406,CSE 229C,A00,090116,Savage; Stefan,0,0,0,0
1653474602928,CSE 230,A00,090117,Jhala; Ranjit,0,0,0,0
1653474603458,CSE 232,A00,090118,Papakonstantinou; Yannis,0,0,0,0
1653474603980,CSE 239A,A00,090121,Kumar; Arun Kumar,0,0,0,0
1653474604506,CSE 239B,A00,090122,Jhala; Ranjit,0,0,0,0
1653474605034,CSE 240A,A00,090123,Zhao; Jishen,0,0,189,189
1653474605560,CSE 243A,A00,090124,Orailoglu; Alex,0,0,15,15
1653474606082,CSE 249B,A00,090125,Kahng; Andrew Byun,13,0,20,7
1653474606604,CSE 250A,A00,090126,Berg-Kirkpatrick; Taylor D,0,0,0,0
1653474607131,CSE 252A,A00,090127,Ochoa; Benjamin Lawrence,0,0,0,0
1653474607651,CSE 258,A01,090129,McAuley; Julian John,0,0,0,0
1653474608183,CSE 258R,A01,090131,McAuley; Julian John,0,0,0,0
1653474608706,CSE 274,A00,090132,Ramamoorthi; Ravi,0,0,0,0
1653474609229,CSE 276A,A00,090133,Christensen; Henrik I,0,0,0,0
1653474609752,CSE 276C,A00,090134,Christensen; Henrik I,0,0,0,0
1653474610276,CSE 290,A00,090135,Bafna; Vineet,0,0,0,0
1653474610276,CSE 290,B00,090136,Ramamoorthi; Ravi,0,0,0,0
1653474610276,CSE 290,C00,090137,Li; Tzumao,9,0,10,1
1653474610276,CSE 290,D00,090138,Zhou; Yuan-Yuan,10,0,10,0
1653474610276,CSE 290,E00,090139,Christensen; Henrik I,10,0,10,0
1653474610276,CSE 290,F00,094053,Shalev; Aaron D,0,0,0,0
1653474610799,CSE 291,A00,090140,Munyaka; Imani N. S.,0,0,0,0
1653474610799,CSE 291,B00,094880,Yu; Qi,0,0,0,0
1653474610799,CSE 291,C00,090142,Pannuto; Patrick William,0,0,0,0
1653474610799,CSE 291,D00,094881,Zhang; Yiying,0,0,0,0
1653474610799,CSE 291,E00,095118,Su; Hao,0,0,0,0
1653474611339,CSE 293,001,094905,Bafna; Vineet,9999,0,9999,0
1653474611339,CSE 293,002,094906,Bellare; Mihir,9999,0,9999,0
1653474611339,CSE 293,003,094907,Berg-Kirkpatrick; Taylor D,9999,0,9999,0
1653474611339,CSE 293,004,094908,Christensen; Henrik I,9999,0,9999,0
1653474611339,CSE 293,005,094909,Cottrell; Garrison W,9999,0,9999,0
1653474611339,CSE 293,006,094910,Deutsch; Alin Bernard,9999,0,9999,0
1653474611339,CSE 293,007,094911,Esmaeilzadeh; Hadi,9999,0,9999,0
1653474611339,CSE 293,008,094912,Freund; Yoav,9999,0,9999,0
1653474611339,CSE 293,009,094913,Griswold; William G.,9999,0,9999,0
1653474611339,CSE 293,010,094914,Gymrek; Melissa Ann,9999,0,9999,0
1653474611339,CSE 293,011,094915,Heninger; Nadia A,9999,0,9999,0
1653474611339,CSE 293,012,094916,Impagliazzo; Russell,9999,0,9999,0
1653474611339,CSE 293,013,094917,Jhala; Ranjit,9999,0,9999,0
1653474611339,CSE 293,014,094918,Kahng; Andrew Byun,9999,0,9999,0
1653474611339,CSE 293,015,094919,Kane; Daniel Mertz,9999,0,9999,0
1653474611339,CSE 293,016,094920,Kriegman; David J,9999,0,9999,0
1653474611339,CSE 293,017,094921,Kumar; Arun Kumar,9999,0,9999,0
1653474611339,CSE 293,018,094922,Lerner; Sorin,9999,0,9999,0
1653474611339,CSE 293,019,094923,Lovett; Shachar,9999,0,9999,0
1653474611339,CSE 293,020,094924,McAuley; Julian John,9999,0,9999,0
1653474611339,CSE 293,021,094925,Micciancio; Daniele,9999,0,9999,0
1653474611339,CSE 293,022,094926,Orailoglu; Alex,9999,0,9999,0
1653474611339,CSE 293,023,094927,Paturi; Ramamohan,9999,0,9999,0
1653474611339,CSE 293,024,094928,Polikarpova; Nadezhda,9999,0,9999,0
1653474611339,CSE 293,025,094929,Politz; Joseph Gibbs,9999,0,9999,0
1653474611339,CSE 293,026,094930,Porter; George M,9999,0,9999,0
1653474611339,CSE 293,027,094931,Porter; Leonard Emerson,9999,0,9999,0
1653474611339,CSE 293,028,094932,Ramamoorthi; Ravi,9999,0,9999,0
1653474611339,CSE 293,029,094933,Sahoo; Debashis,9999,0,9999,0
1653474611339,CSE 293,030,094934,Saul; Lawrence,9999,0,9999,0
1653474611339,CSE 293,031,094935,Savage; Stefan,9999,0,9999,0
1653474611339,CSE 293,032,094936,Schulze; Jurgen P.,9999,0,9999,0
1653474611339,CSE 293,033,094937,Snoeren; Alex C.,9999,0,9999,0
1653474611339,CSE 293,034,094938,Shang; Jingbo,9999,0,9999,0
1653474611339,CSE 293,035,094939,Stefan; Deian,9999,0,9999,0
1653474611339,CSE 293,036,094940,Su; Hao,9999,0,9999,0
1653474611339,CSE 293,037,094941,Swanson; Steven James,9999,0,9999,0
1653474611339,CSE 293,038,094942,Tullsen; Dean Michael,9999,0,9999,0
1653474611339,CSE 293,039,094943,Voelker; Geoffrey M.,9999,0,9999,0
1653474611339,CSE 293,040,094944,Zhao; Jishen,9999,0,9999,0
1653474611339,CSE 293,041,094945,Zhou; Yuan-Yuan,9999,0,9999,0
1653474611339,CSE 293,042,094946,Gao; Sicun,9998,0,9999,1
1653474611339,CSE 293,043,094947,Weibel; Nadir,9999,0,9999,0
1653474611339,CSE 293,044,094948,Gupta; Rajesh K.,9999,0,9999,0
1653474611865,CSE 294,A00,090143,Porter; George M,9,0,10,1
1653474612388,DSE 200,A00,091799,Staff,50,0,50,0
1653474612980,DSE 203,A00,091800,Gupta; Amarnath,30,0,30,0
1653474613505,DSE 250,A00,091801,Deutsch; Alin Bernard,30,0,30,0
1653474614033,DSE 290,A00,091802,Altintas De Callaf; Ilkay,50,0,50,0
1653474614579,ECE 200,001,091003,Antipa; Nicholas A,9999,0,9999,0
1653474614579,ECE 200,002,091004,Atanasov; Nikolay A.,9999,0,9999,0
1653474614579,ECE 200,003,091005,Bharadia; Dinesh,9999,0,9999,0
1653474614579,ECE 200,004,091006,Cheng; Chung Kuan,9999,0,9999,0
1653474614579,ECE 200,005,091007,Cosman; Pamela C.,9999,0,9999,0
1653474614579,ECE 200,006,091008,Staff,9999,0,9999,0
1653474614579,ECE 200,007,091009,Dayeh; Shadi Ahmad,9999,0,9999,0
1653474614579,ECE 200,008,091010,Fainman; Yeshaiahu,9999,0,9999,0
1653474614579,ECE 200,009,091011,Ford; Joseph Earl,9999,0,9999,0
1653474614579,ECE 200,010,091012,Franceschetti; Massimo,9999,0,9999,0
1653474614579,ECE 200,011,091013,Fullerton; Eric E,9999,0,9999,0
1653474614579,ECE 200,012,091014,Galton; Ian A,9999,0,9999,0
1653474614579,ECE 200,013,091015,Gilja; Vikash,9999,0,9999,0
1653474614579,ECE 200,014,091016,Hall; Drew A.,9999,0,9999,0
1653474614579,ECE 200,015,091017,Hsueh; Tzu-Chien,9999,0,9999,0
1653474614579,ECE 200,016,091018,Javidi; Tara,9999,0,9999,0
1653474614579,ECE 200,017,091019,Kahng; Andrew Byun,9999,0,9999,0
1653474614579,ECE 200,018,091020,Kim; Young-Han,9999,0,9999,0
1653474614579,ECE 200,019,091021,Koushanfar; Farinaz,9999,0,9999,0
1653474614579,ECE 200,020,091022,Kuzum; Duygu,9999,0,9999,0
1653474614579,ECE 200,021,091023,Le; Hanh-Phuc,9999,0,9999,0
1653474614579,ECE 200,022,091024,Lin; Bill,9999,0,9999,0
1653474614579,ECE 200,023,091025,Liu; Zhaowei,9999,0,9999,0
1653474614579,ECE 200,024,091026,Lo; Yu-Hwa,9999,0,9999,0
1653474614579,ECE 200,025,091027,Lomakin; Vitaliy,9999,0,9999,0
1653474614579,ECE 200,026,091028,Mercier; Patrick Philip,9999,0,9999,0
1653474614579,ECE 200,027,091029,Meyer; Florian,9999,0,9999,0
1653474614579,ECE 200,028,091030,Milstein; Laurence B.,9999,0,9999,0
1653474614579,ECE 200,029,091031,Mir Arabbaygi; Siavash,9999,0,9999,0
1653474614579,ECE 200,030,091032,Mookherjea; Shayan,9999,0,9999,0
1653474614579,ECE 200,031,091033,Morris; Karcher William,9999,0,9999,0
1653474614579,ECE 200,032,091034,Ng; Tse Nga,9999,0,9999,0
1653474614579,ECE 200,033,091035,Nguyen; Truong Quang,9999,0,9999,0
1653474614579,ECE 200,034,091036,Nomura; Kenji,9999,0,9999,0
1653474614579,ECE 200,035,091037,Orlitsky; Alon,9999,0,9999,0
1653474614579,ECE 200,036,091038,Pal; Piya,9999,0,9999,0
1653474614579,ECE 200,037,091039,Papen; George C.,9999,0,9999,0
1653474614579,ECE 200,038,091040,Radic; Stojan,9999,0,9999,0
1653474614579,ECE 200,039,091041,Rao; Bhaskar D.,9999,0,9999,0
1653474614579,ECE 200,040,091042,Rao; Ramesh R,9999,0,9999,0
1653474614579,ECE 200,041,091043,Rebeiz; Gabriel,9999,0,9999,0
1653474614579,ECE 200,042,091044,Sanford; John R,9999,0,9999,0
1653474614579,ECE 200,043,091045,Siegel; Paul H.,9999,0,9999,0
1653474614579,ECE 200,044,091046,Sievenpiper; Daniel F.,9999,0,9999,0
1653474614579,ECE 200,045,091047,Sworder; David D.,9999,0,9999,0
1653474614579,ECE 200,046,091048,Taur; Yuan,9999,0,9999,0
1653474614579,ECE 200,047,091049,Touri; Behrouz,9999,0,9999,0
1653474614579,ECE 200,048,091050,Trivedi; Mohan M.,9999,0,9999,0
1653474614579,ECE 200,049,091051,Vardy; Alexander,9999,0,9999,0
1653474614579,ECE 200,050,091052,Vasconcelos; Nuno,9999,0,9999,0
1653474614579,ECE 200,051,091053,Wang; Xiaolong,9999,0,9999,0
1653474614579,ECE 200,052,091054,Xie; Pengtao,9999,0,9999,0
1653474614579,ECE 200,053,091055,Yip; Michael,9999,0,9999,0
1653474614579,ECE 200,054,091056,Zeger; Kenneth A.,9999,0,9999,0
1653474614579,ECE 200,055,091057,Zhang; Xinyu,9999,0,9999,0
1653474614579,ECE 200,056,091058,Turakhia; Yatish Girish,9999,0,9999,0
1653474614579,ECE 200,057,091059,Kang; Mingu,9999,0,9999,0
1653474614579,ECE 200,058,091060,Shi; Yuanyuan,9999,0,9999,0
1653474614579,ECE 200,059,091061,Wang; Edward Jay,9999,0,9999,0
1653474614579,ECE 200,060,091062,Zheng; Yang,9999,0,9999,0
1653474615102,ECE 203,A00,091065,Mercier; Patrick Philip,0,0,0,0
1653474615627,ECE 207A,A00,091605,Liu; Thomas Tao-Ming,0,0,0,0
1653474616150,ECE 212AN,A00,091068,Nomura; Kenji,0,0,0,0
1653474616676,ECE 222A,A00,091069,Rebeiz; Gabriel,0,0,0,0
1653474617199,ECE 225A,A00,091070,Orlitsky; Alon,0,0,0,0
1653474617725,ECE 230A,A00,091071,Nomura; Kenji,0,0,0,0
1653474618249,ECE 236A,A00,091072,Dayeh; Shadi Ahmad,0,0,0,0
1653474618778,ECE 238A,A00,091073,Luo; Jian,0,0,0,0
1653474618778,ECE 238A,B00,091074,Luo; Jian,0,0,0,0
1653474619303,ECE 240A,A00,091075,Radic; Stojan,0,0,0,0
1653474619829,ECE 247A,A00,091592,Shi; Lingyan,0,0,0,0
1653474620352,ECE 250,A00,091076,Touri; Behrouz,0,0,0,0
1653474620875,ECE 251C,A00,091078,Nguyen; Truong Quang,0,0,0,0
1653474621398,ECE 253,A00,091079,Cosman; Pamela C.,0,0,0,0
1653474621921,ECE 255A,A00,091080,Orlitsky; Alon,0,0,0,0
1653474622442,ECE 257A,A00,091081,Zhang; Xinyu,0,0,0,0
1653474622964,ECE 260A,A01,091084,Eldon; John,0,0,0,0
1653474623493,ECE 264C,A00,091085,Galton; Ian A,0,0,0,0
1653474624016,ECE 265C,A00,094889,Presti; Calogero Davide,0,0,0,9
1653474624542,ECE 266,A01,091087,Hall; Drew A.,0,0,0,0
1653474625588,ECE 271A,A00,091090,Vasconcelos; Nuno,0,0,0,0
1653474626111,ECE 272B,A00,091091,Sworder; David D.,0,0,0,0
1653474626632,ECE 275A,A00,091092,Meyer; Florian,0,0,0,0
1653474627156,ECE 277,A00,091093,An; Cheolhong,0,0,0,0
1653474627678,ECE 283,A00,091094,Le; Hanh-Phuc,0,0,0,0
1653474628201,ECE 284,A00,091095,Kang; Mingu,0,0,0,0
1653474628201,ECE 284,B00,091096,Wang; Edward Jay,0,0,0,0
1653474628727,ECE 285,A00,094334,Touri; Behrouz,0,0,0,0
1653474629250,ECE 289,A00,091097,Whelan; David Arthur,0,0,0,0
1653474629773,MATH 200A,A00,087414,Salehi Golsefidy; Alireza,7,0,8,1
1653474630296,MATH 202A,A00,087415,Gill; Philip E.,3,0,8,5
1653474630828,MATH 203A,A00,087416,Oprea; Dragos N.,6,0,8,2
1653474631350,MATH 204A,A00,087417,Kedlaya; Kiran S.,6,0,8,2
1653474631873,MATH 205,A00,087418,Sorensen; Claus M,6,0,8,2
1653474632397,MATH 206A,A00,087419,Izadi; Elham,7,0,8,1
1653474632919,MATH 207A,A00,087420,Mohammadi; Amir,6,0,8,2
1653474633458,MATH 208,A00,087421,Staff,9,0,10,1
1653474633980,MATH 209,A00,087422,Staff,10,0,10,0
1653474634503,MATH 218,A00,087423,Staff,10,0,10,0
1653474635030,MATH 220A,A00,087424,Novak; Jonathan I,7,0,8,1
1653474635551,MATH 231A,A00,087425,Bejenaru; Ioan,3,0,8,5
1653474636074,MATH 240A,A00,087426,Ebenfelt; Peter F,5,0,8,3
1653474636598,MATH 243,A00,087427,Staff,9,0,10,1
1653474637120,MATH 248,A00,087429,Staff,10,0,10,0
1653474637643,MATH 250A,A00,087430,Spolaor; Luca,4,0,8,4
1653474638169,MATH 257A,A00,087431,Spolaor; Luca,7,0,8,1
1653474638696,MATH 258,A00,087432,Staff,9,0,10,1
1653474639226,MATH 264A,A00,087433,Warnke; Lutz Peter,5,0,8,3
1653474639749,MATH 268,A00,087434,Staff,15,0,15,0
1653474640279,MATH 269,A00,087435,Staff,14,0,15,1
1653474640802,MATH 270A,A00,087436,Nie; Jiawang,0,0,8,8
1653474641330,MATH 272A,A00,087437,Tian; Xiaochuan,1,0,8,7
1653474641855,MATH 274,A01,087439,Cheng; Li-Tien,9,0,10,1
1653474641855,MATH 274,A02,087440,Cheng; Li-Tien,10,0,10,0
1653474642379,MATH 278A,A00,087441,Staff,8,0,10,2
1653474642904,MATH 278B,A00,087442,Staff,8,0,10,2
1653474643427,MATH 278C,A00,087443,Staff,8,0,10,2
1653474643954,MATH 280A,A00,087444,Zheng; Tianyi,0,0,8,8
1653474644476,MATH 281A,A00,087445,Bradic; Jelena,0,0,8,8
1653474645004,MATH 282A,A00,087446,Zhang; Danna,0,0,8,8
1653474645528,MATH 283,A00,087447,Tesler; Glenn,0,0,0,14
1653474646049,MATH 286,A00,087448,Kemp; Todd Aahron,5,0,8,3
1653474646575,MATH 287D,A00,087449,Bradic; Jelena,8,0,8,0
1653474647097,MATH 288,A00,087450,Staff,14,0,15,1
1653474647097,MATH 288,B00,087451,Staff,15,0,15,0
1653474647097,MATH 288,C00,087452,Staff,15,0,15,0
1653474647619,MATH 290A,A00,087453,Xu; Zhouli,7,0,8,1
1653474648142,MATH 291A,A00,087454,Xu; Zhouli,7,0,8,1
1653474648665,MATH 292,A00,087455,Staff,10,0,10,0
1653474649192,MATH 295,A00,087456,Staff,50,0,50,0
1653474649716,MATH 297,001,087457,Staff,998,0,999,1
1653475208475,COGS 200,A01,087991,Staff,47,0,50,3
1653475208999,COGS 201,A01,094504,Rangel; Lara M,17,0,25,8
1653475209522,COGS 203,A00,087992,Coulson; Seana M,18,0,20,2
1653475210058,COGS 210A,001,087993,Greene; Deanna Jacquelyn,9998,0,9999,1
1653475210058,COGS 210A,002,087994,Saygin; Ayse P,9999,0,9999,0
1653475210058,COGS 210A,003,087995,Xia; Haijun,9999,0,9999,0
1653475210058,COGS 210A,004,087996,Nitz; Douglas A.,9999,0,9999,0
1653475210058,COGS 210A,005,087997,Hollan; James D.,9999,0,9999,0
1653475210058,COGS 210A,006,087998,Deak; Gedeon O.,9998,0,9999,1
1653475210058,COGS 210A,007,087999,Rossano; Federico,9999,0,9999,0
1653475210581,COGS 211A,A00,088000,Coulson; Seana M,9997,0,9999,2
1653475211105,COGS 229,A00,088002,Staff,23,0,25,2
1653475211634,COGS 260,B00,094231,Staff,17,0,20,3
1653475211634,COGS 260,A00,088004,Nitz; Douglas A.,9998,0,9999,1
1653475212159,CSE 202,A00,090110,Paturi; Ramamohan,0,0,0,0
1653475212159,CSE 202,B00,090111,Paturi; Ramamohan,0,0,0,0
1653475212683,CSE 207B,A00,090112,Heninger; Nadia A,0,0,0,0
1653475213206,CSE 208,A00,094858,Micciancio; Daniele,0,0,0,0
1653475213729,CSE 210,A00,090113,Powell; Thomas Allan,0,0,0,0
1653475214252,CSE 219,A00,090898,Staff,0,0,0,0
1653475214776,CSE 221,A00,090114,Zhou; Yuan-Yuan,0,0,0,0
1653475215303,CSE 229A,A00,090115,Porter; George M,0,0,0,0
1653475215833,CSE 229C,A00,090116,Savage; Stefan,0,0,0,0
1653475216360,CSE 230,A00,090117,Jhala; Ranjit,0,0,0,0
1653475216882,CSE 232,A00,090118,Papakonstantinou; Yannis,0,0,0,0
1653475217405,CSE 239A,A00,090121,Kumar; Arun Kumar,0,0,0,0
1653475217928,CSE 239B,A00,090122,Jhala; Ranjit,0,0,0,0
1653475218452,CSE 240A,A00,090123,Zhao; Jishen,0,0,189,189
1653475218976,CSE 243A,A00,090124,Orailoglu; Alex,0,0,15,15
1653475219498,CSE 249B,A00,090125,Kahng; Andrew Byun,13,0,20,7
1653475220026,CSE 250A,A00,090126,Berg-Kirkpatrick; Taylor D,0,0,0,0
1653475220550,CSE 252A,A00,090127,Ochoa; Benjamin Lawrence,0,0,0,0
1653475221077,CSE 258,A01,090129,McAuley; Julian John,0,0,0,0
1653475221599,CSE 258R,A01,090131,McAuley; Julian John,0,0,0,0
1653475222123,CSE 274,A00,090132,Ramamoorthi; Ravi,0,0,0,0
1653475222654,CSE 276A,A00,090133,Christensen; Henrik I,0,0,0,0
1653475223177,CSE 276C,A00,090134,Christensen; Henrik I,0,0,0,0
1653475223704,CSE 290,A00,090135,Bafna; Vineet,0,0,0,0
1653475223704,CSE 290,B00,090136,Ramamoorthi; Ravi,0,0,0,0
1653475223704,CSE 290,C00,090137,Li; Tzumao,9,0,10,1
1653475223704,CSE 290,D00,090138,Zhou; Yuan-Yuan,10,0,10,0
1653475223704,CSE 290,E00,090139,Christensen; Henrik I,10,0,10,0
1653475223704,CSE 290,F00,094053,Shalev; Aaron D,0,0,0,0
1653475224231,CSE 291,A00,090140,Munyaka; Imani N. S.,0,0,0,0
1653475224231,CSE 291,B00,094880,Yu; Qi,0,0,0,0
1653475224231,CSE 291,C00,090142,Pannuto; Patrick William,0,0,0,0
1653475224231,CSE 291,D00,094881,Zhang; Yiying,0,0,0,0
1653475224231,CSE 291,E00,095118,Su; Hao,0,0,0,0
1653475224789,CSE 293,001,094905,Bafna; Vineet,9999,0,9999,0
1653475224789,CSE 293,002,094906,Bellare; Mihir,9999,0,9999,0
1653475224789,CSE 293,003,094907,Berg-Kirkpatrick; Taylor D,9999,0,9999,0
1653475224789,CSE 293,004,094908,Christensen; Henrik I,9999,0,9999,0
1653475224789,CSE 293,005,094909,Cottrell; Garrison W,9999,0,9999,0
1653475224789,CSE 293,006,094910,Deutsch; Alin Bernard,9999,0,9999,0
1653475224789,CSE 293,007,094911,Esmaeilzadeh; Hadi,9999,0,9999,0
1653475224789,CSE 293,008,094912,Freund; Yoav,9999,0,9999,0
1653475224789,CSE 293,009,094913,Griswold; William G.,9999,0,9999,0
1653475224789,CSE 293,010,094914,Gymrek; Melissa Ann,9999,0,9999,0
1653475224789,CSE 293,011,094915,Heninger; Nadia A,9999,0,9999,0
1653475224789,CSE 293,012,094916,Impagliazzo; Russell,9999,0,9999,0
1653475224789,CSE 293,013,094917,Jhala; Ranjit,9999,0,9999,0
1653475224789,CSE 293,014,094918,Kahng; Andrew Byun,9999,0,9999,0
1653475224789,CSE 293,015,094919,Kane; Daniel Mertz,9999,0,9999,0
1653475224789,CSE 293,016,094920,Kriegman; David J,9999,0,9999,0
1653475224789,CSE 293,017,094921,Kumar; Arun Kumar,9999,0,9999,0
1653475224789,CSE 293,018,094922,Lerner; Sorin,9999,0,9999,0
1653475224789,CSE 293,019,094923,Lovett; Shachar,9999,0,9999,0
1653475224789,CSE 293,020,094924,McAuley; Julian John,9999,0,9999,0
1653475224789,CSE 293,021,094925,Micciancio; Daniele,9999,0,9999,0
1653475224789,CSE 293,022,094926,Orailoglu; Alex,9999,0,9999,0
1653475224789,CSE 293,023,094927,Paturi; Ramamohan,9999,0,9999,0
1653475224789,CSE 293,024,094928,Polikarpova; Nadezhda,9999,0,9999,0
1653475224789,CSE 293,025,094929,Politz; Joseph Gibbs,9999,0,9999,0
1653475224789,CSE 293,026,094930,Porter; George M,9999,0,9999,0
1653475224789,CSE 293,027,094931,Porter; Leonard Emerson,9999,0,9999,0
1653475224789,CSE 293,028,094932,Ramamoorthi; Ravi,9999,0,9999,0
1653475224789,CSE 293,029,094933,Sahoo; Debashis,9999,0,9999,0
1653475224789,CSE 293,030,094934,Saul; Lawrence,9999,0,9999,0
1653475224789,CSE 293,031,094935,Savage; Stefan,9999,0,9999,0
1653475224789,CSE 293,032,094936,Schulze; Jurgen P.,9999,0,9999,0
1653475224789,CSE 293,033,094937,Snoeren; Alex C.,9999,0,9999,0
1653475224789,CSE 293,034,094938,Shang; Jingbo,9999,0,9999,0
1653475224789,CSE 293,035,094939,Stefan; Deian,9999,0,9999,0
1653475224789,CSE 293,036,094940,Su; Hao,9999,0,9999,0
1653475224789,CSE 293,037,094941,Swanson; Steven James,9999,0,9999,0
1653475224789,CSE 293,038,094942,Tullsen; Dean Michael,9999,0,9999,0
1653475224789,CSE 293,039,094943,Voelker; Geoffrey M.,9999,0,9999,0
1653475224789,CSE 293,040,094944,Zhao; Jishen,9999,0,9999,0
1653475224789,CSE 293,041,094945,Zhou; Yuan-Yuan,9999,0,9999,0
1653475224789,CSE 293,042,094946,Gao; Sicun,9998,0,9999,1
1653475224789,CSE 293,043,094947,Weibel; Nadir,9999,0,9999,0
1653475224789,CSE 293,044,094948,Gupta; Rajesh K.,9999,0,9999,0
1653475225312,CSE 294,A00,090143,Porter; George M,9,0,10,1
1653475225837,DSE 200,A00,091799,Staff,50,0,50,0
1653475226360,DSE 203,A00,091800,Gupta; Amarnath,30,0,30,0
1653475226882,DSE 250,A00,091801,Deutsch; Alin Bernard,30,0,30,0
1653475227407,DSE 290,A00,091802,Altintas De Callaf; Ilkay,50,0,50,0
1653475227999,ECE 200,001,091003,Antipa; Nicholas A,9999,0,9999,0
1653475227999,ECE 200,002,091004,Atanasov; Nikolay A.,9999,0,9999,0
1653475227999,ECE 200,003,091005,Bharadia; Dinesh,9999,0,9999,0
1653475227999,ECE 200,004,091006,Cheng; Chung Kuan,9999,0,9999,0
1653475227999,ECE 200,005,091007,Cosman; Pamela C.,9999,0,9999,0
1653475227999,ECE 200,006,091008,Staff,9999,0,9999,0
1653475227999,ECE 200,007,091009,Dayeh; Shadi Ahmad,9999,0,9999,0
1653475227999,ECE 200,008,091010,Fainman; Yeshaiahu,9999,0,9999,0
1653475227999,ECE 200,009,091011,Ford; Joseph Earl,9999,0,9999,0
1653475227999,ECE 200,010,091012,Franceschetti; Massimo,9999,0,9999,0
1653475227999,ECE 200,011,091013,Fullerton; Eric E,9999,0,9999,0
1653475227999,ECE 200,012,091014,Galton; Ian A,9999,0,9999,0
1653475227999,ECE 200,013,091015,Gilja; Vikash,9999,0,9999,0
1653475227999,ECE 200,014,091016,Hall; Drew A.,9999,0,9999,0
1653475227999,ECE 200,015,091017,Hsueh; Tzu-Chien,9999,0,9999,0
1653475227999,ECE 200,016,091018,Javidi; Tara,9999,0,9999,0
1653475227999,ECE 200,017,091019,Kahng; Andrew Byun,9999,0,9999,0
1653475227999,ECE 200,018,091020,Kim; Young-Han,9999,0,9999,0
1653475227999,ECE 200,019,091021,Koushanfar; Farinaz,9999,0,9999,0
1653475227999,ECE 200,020,091022,Kuzum; Duygu,9999,0,9999,0
1653475227999,ECE 200,021,091023,Le; Hanh-Phuc,9999,0,9999,0
1653475227999,ECE 200,022,091024,Lin; Bill,9999,0,9999,0
1653475227999,ECE 200,023,091025,Liu; Zhaowei,9999,0,9999,0
1653475227999,ECE 200,024,091026,Lo; Yu-Hwa,9999,0,9999,0
1653475227999,ECE 200,025,091027,Lomakin; Vitaliy,9999,0,9999,0
1653475227999,ECE 200,026,091028,Mercier; Patrick Philip,9999,0,9999,0
1653475227999,ECE 200,027,091029,Meyer; Florian,9999,0,9999,0
1653475227999,ECE 200,028,091030,Milstein; Laurence B.,9999,0,9999,0
1653475227999,ECE 200,029,091031,Mir Arabbaygi; Siavash,9999,0,9999,0
1653475227999,ECE 200,030,091032,Mookherjea; Shayan,9999,0,9999,0
1653475227999,ECE 200,031,091033,Morris; Karcher William,9999,0,9999,0
1653475227999,ECE 200,032,091034,Ng; Tse Nga,9999,0,9999,0
1653475227999,ECE 200,033,091035,Nguyen; Truong Quang,9999,0,9999,0
1653475227999,ECE 200,034,091036,Nomura; Kenji,9999,0,9999,0
1653475227999,ECE 200,035,091037,Orlitsky; Alon,9999,0,9999,0
1653475227999,ECE 200,036,091038,Pal; Piya,9999,0,9999,0
1653475227999,ECE 200,037,091039,Papen; George C.,9999,0,9999,0
1653475227999,ECE 200,038,091040,Radic; Stojan,9999,0,9999,0
1653475227999,ECE 200,039,091041,Rao; Bhaskar D.,9999,0,9999,0
1653475227999,ECE 200,040,091042,Rao; Ramesh R,9999,0,9999,0
1653475227999,ECE 200,041,091043,Rebeiz; Gabriel,9999,0,9999,0
1653475227999,ECE 200,042,091044,Sanford; John R,9999,0,9999,0
1653475227999,ECE 200,043,091045,Siegel; Paul H.,9999,0,9999,0
1653475227999,ECE 200,044,091046,Sievenpiper; Daniel F.,9999,0,9999,0
1653475227999,ECE 200,045,091047,Sworder; David D.,9999,0,9999,0
1653475227999,ECE 200,046,091048,Taur; Yuan,9999,0,9999,0
1653475227999,ECE 200,047,091049,Touri; Behrouz,9999,0,9999,0
1653475227999,ECE 200,048,091050,Trivedi; Mohan M.,9999,0,9999,0
1653475227999,ECE 200,049,091051,Vardy; Alexander,9999,0,9999,0
1653475227999,ECE 200,050,091052,Vasconcelos; Nuno,9999,0,9999,0
1653475227999,ECE 200,051,091053,Wang; Xiaolong,9999,0,9999,0
1653475227999,ECE 200,052,091054,Xie; Pengtao,9999,0,9999,0
1653475227999,ECE 200,053,091055,Yip; Michael,9999,0,9999,0
1653475227999,ECE 200,054,091056,Zeger; Kenneth A.,9999,0,9999,0
1653475227999,ECE 200,055,091057,Zhang; Xinyu,9999,0,9999,0
1653475227999,ECE 200,056,091058,Turakhia; Yatish Girish,9999,0,9999,0
1653475227999,ECE 200,057,091059,Kang; Mingu,9999,0,9999,0
1653475227999,ECE 200,058,091060,Shi; Yuanyuan,9999,0,9999,0
1653475227999,ECE 200,059,091061,Wang; Edward Jay,9999,0,9999,0
1653475227999,ECE 200,060,091062,Zheng; Yang,9999,0,9999,0
1653475228528,ECE 203,A00,091065,Mercier; Patrick Philip,0,0,0,0
1653475229058,ECE 207A,A00,091605,Liu; Thomas Tao-Ming,0,0,0,0
1653475229581,ECE 212AN,A00,091068,Nomura; Kenji,0,0,0,0
1653475230105,ECE 222A,A00,091069,Rebeiz; Gabriel,0,0,0,0
1653475230628,ECE 225A,A00,091070,Orlitsky; Alon,0,0,0,0
1653475231160,ECE 230A,A00,091071,Nomura; Kenji,0,0,0,0
1653475231684,ECE 236A,A00,091072,Dayeh; Shadi Ahmad,0,0,0,0
1653475232214,ECE 238A,A00,091073,Luo; Jian,0,0,0,0
1653475232214,ECE 238A,B00,091074,Luo; Jian,0,0,0,0
1653475232740,ECE 240A,A00,091075,Radic; Stojan,0,0,0,0
1653475233265,ECE 247A,A00,091592,Shi; Lingyan,0,0,0,0
1653475233792,ECE 250,A00,091076,Touri; Behrouz,0,0,0,0
1653475234319,ECE 251C,A00,091078,Nguyen; Truong Quang,0,0,0,0
1653475234842,ECE 253,A00,091079,Cosman; Pamela C.,0,0,0,0
1653475235365,ECE 255A,A00,091080,Orlitsky; Alon,0,0,0,0
1653475235888,ECE 257A,A00,091081,Zhang; Xinyu,0,0,0,0
1653475236413,ECE 260A,A01,091084,Eldon; John,0,0,0,0
1653475236941,ECE 264C,A00,091085,Galton; Ian A,0,0,0,0
1653475237470,ECE 265C,A00,094889,Presti; Calogero Davide,0,0,0,9
1653475237998,ECE 266,A01,091087,Hall; Drew A.,0,0,0,0
1653475239049,ECE 271A,A00,091090,Vasconcelos; Nuno,0,0,0,0
1653475239577,ECE 272B,A00,091091,Sworder; David D.,0,0,0,0
1653475240098,ECE 275A,A00,091092,Meyer; Florian,0,0,0,0
1653475240626,ECE 277,A00,091093,An; Cheolhong,0,0,0,0
1653475241150,ECE 283,A00,091094,Le; Hanh-Phuc,0,0,0,0
1653475241680,ECE 284,A00,091095,Kang; Mingu,0,0,0,0
1653475241680,ECE 284,B00,091096,Wang; Edward Jay,0,0,0,0
1653475242203,ECE 285,A00,094334,Touri; Behrouz,0,0,0,0
1653475242726,ECE 289,A00,091097,Whelan; David Arthur,0,0,0,0
1653475243255,MATH 200A,A00,087414,Salehi Golsefidy; Alireza,7,0,8,1
1653475243780,MATH 202A,A00,087415,Gill; Philip E.,3,0,8,5
1653475244303,MATH 203A,A00,087416,Oprea; Dragos N.,6,0,8,2
1653475244827,MATH 204A,A00,087417,Kedlaya; Kiran S.,6,0,8,2
1653475245355,MATH 205,A00,087418,Sorensen; Claus M,6,0,8,2
1653475245879,MATH 206A,A00,087419,Izadi; Elham,7,0,8,1
1653475246406,MATH 207A,A00,087420,Mohammadi; Amir,6,0,8,2
1653475246932,MATH 208,A00,087421,Staff,9,0,10,1
1653475247454,MATH 209,A00,087422,Staff,10,0,10,0
1653475247980,MATH 218,A00,087423,Staff,10,0,10,0
1653475248504,MATH 220A,A00,087424,Novak; Jonathan I,7,0,8,1
1653475249026,MATH 231A,A00,087425,Bejenaru; Ioan,3,0,8,5
1653475249549,MATH 240A,A00,087426,Ebenfelt; Peter F,5,0,8,3
1653475250072,MATH 243,A00,087427,Staff,9,0,10,1
1653475250598,MATH 248,A00,087429,Staff,10,0,10,0
1653475251122,MATH 250A,A00,087430,Spolaor; Luca,4,0,8,4
1653475251645,MATH 257A,A00,087431,Spolaor; Luca,7,0,8,1
1653475252241,MATH 258,A00,087432,Staff,9,0,10,1
1653475252764,MATH 264A,A00,087433,Warnke; Lutz Peter,5,0,8,3
1653475253290,MATH 268,A00,087434,Staff,15,0,15,0
1653475253814,MATH 269,A00,087435,Staff,14,0,15,1
1653475254339,MATH 270A,A00,087436,Nie; Jiawang,0,0,8,8
1653475254863,MATH 272A,A00,087437,Tian; Xiaochuan,1,0,8,7
1653475255391,MATH 274,A01,087439,Cheng; Li-Tien,9,0,10,1
1653475255391,MATH 274,A02,087440,Cheng; Li-Tien,10,0,10,0
1653475255913,MATH 278A,A00,087441,Staff,8,0,10,2
1653475256435,MATH 278B,A00,087442,Staff,8,0,10,2
1653475256969,MATH 278C,A00,087443,Staff,8,0,10,2
1653475257493,MATH 280A,A00,087444,Zheng; Tianyi,0,0,8,8
1653475258018,MATH 281A,A00,087445,Bradic; Jelena,0,0,8,8
1653475258547,MATH 282A,A00,087446,Zhang; Danna,0,0,8,8
1653475259074,MATH 283,A00,087447,Tesler; Glenn,0,0,0,14
1653475259597,MATH 286,A00,087448,Kemp; Todd Aahron,5,0,8,3
1653475260119,MATH 287D,A00,087449,Bradic; Jelena,8,0,8,0
1653475260642,MATH 288,A00,087450,Staff,14,0,15,1
1653475260642,MATH 288,B00,087451,Staff,15,0,15,0
1653475260642,MATH 288,C00,087452,Staff,15,0,15,0
1653475261171,MATH 290A,A00,087453,Xu; Zhouli,7,0,8,1
1653475261693,MATH 291A,A00,087454,Xu; Zhouli,7,0,8,1
1653475262219,MATH 292,A00,087455,Staff,10,0,10,0
1653475262746,MATH 295,A00,087456,Staff,50,0,50,0
1653475263271,MATH 297,001,087457,Staff,998,0,999,1
1653475822934,COGS 200,A01,087991,Staff,47,0,50,3
1653475823463,COGS 201,A01,094504,Rangel; Lara M,17,0,25,8
1653475823986,COGS 203,A00,087992,Coulson; Seana M,18,0,20,2
1653475824514,COGS 210A,001,087993,Greene; Deanna Jacquelyn,9998,0,9999,1
1653475824514,COGS 210A,002,087994,Saygin; Ayse P,9999,0,9999,0
1653475824514,COGS 210A,003,087995,Xia; Haijun,9999,0,9999,0
1653475824514,COGS 210A,004,087996,Nitz; Douglas A.,9999,0,9999,0
1653475824514,COGS 210A,005,087997,Hollan; James D.,9999,0,9999,0
1653475824514,COGS 210A,006,087998,Deak; Gedeon O.,9998,0,9999,1
1653475824514,COGS 210A,007,087999,Rossano; Federico,9999,0,9999,0
1653475825036,COGS 211A,A00,088000,Coulson; Seana M,9997,0,9999,2
1653475825562,COGS 229,A00,088002,Staff,23,0,25,2
1653475826086,COGS 260,B00,094231,Staff,17,0,20,3
1653475826086,COGS 260,A00,088004,Nitz; Douglas A.,9998,0,9999,1
1653475826614,CSE 202,A00,090110,Paturi; Ramamohan,0,0,0,0
1653475826614,CSE 202,B00,090111,Paturi; Ramamohan,0,0,0,0
1653475827136,CSE 207B,A00,090112,Heninger; Nadia A,0,0,0,0
1653475827659,CSE 208,A00,094858,Micciancio; Daniele,0,0,0,0
1653475828182,CSE 210,A00,090113,Powell; Thomas Allan,0,0,0,0
1653475828708,CSE 219,A00,090898,Staff,0,0,0,0
1653475829233,CSE 221,A00,090114,Zhou; Yuan-Yuan,0,0,0,0
1653475829756,CSE 229A,A00,090115,Porter; George M,0,0,0,0
1653475830281,CSE 229C,A00,090116,Savage; Stefan,0,0,0,0
1653475830811,CSE 230,A00,090117,Jhala; Ranjit,0,0,0,0
1653475831334,CSE 232,A00,090118,Papakonstantinou; Yannis,0,0,0,0
1653475831878,CSE 239A,A00,090121,Kumar; Arun Kumar,0,0,0,0
1653475832400,CSE 239B,A00,090122,Jhala; Ranjit,0,0,0,0
1653475832925,CSE 240A,A00,090123,Zhao; Jishen,0,0,189,189
1653475833449,CSE 243A,A00,090124,Orailoglu; Alex,0,0,15,15
1653475833977,CSE 249B,A00,090125,Kahng; Andrew Byun,13,0,20,7
1653475834505,CSE 250A,A00,090126,Berg-Kirkpatrick; Taylor D,0,0,0,0
1653475835032,CSE 252A,A00,090127,Ochoa; Benjamin Lawrence,0,0,0,0
1653475835558,CSE 258,A01,090129,McAuley; Julian John,0,0,0,0
1653475836081,CSE 258R,A01,090131,McAuley; Julian John,0,0,0,0
1653475836607,CSE 274,A00,090132,Ramamoorthi; Ravi,0,0,0,0
1653475837131,CSE 276A,A00,090133,Christensen; Henrik I,0,0,0,0
1653475837656,CSE 276C,A00,090134,Christensen; Henrik I,0,0,0,0
1653475838182,CSE 290,A00,090135,Bafna; Vineet,0,0,0,0
1653475838182,CSE 290,B00,090136,Ramamoorthi; Ravi,0,0,0,0
1653475838182,CSE 290,C00,090137,Li; Tzumao,9,0,10,1
1653475838182,CSE 290,D00,090138,Zhou; Yuan-Yuan,10,0,10,0
1653475838182,CSE 290,E00,090139,Christensen; Henrik I,10,0,10,0
1653475838182,CSE 290,F00,094053,Shalev; Aaron D,0,0,0,0
1653475838710,CSE 291,A00,090140,Munyaka; Imani N. S.,0,0,0,0
1653475838710,CSE 291,B00,094880,Yu; Qi,0,0,0,0
1653475838710,CSE 291,C00,090142,Pannuto; Patrick William,0,0,0,0
1653475838710,CSE 291,D00,094881,Zhang; Yiying,0,0,0,0
1653475838710,CSE 291,E00,095118,Su; Hao,0,0,0,0
1653475839340,CSE 293,001,094905,Bafna; Vineet,9999,0,9999,0
1653475839340,CSE 293,002,094906,Bellare; Mihir,9999,0,9999,0
1653475839340,CSE 293,003,094907,Berg-Kirkpatrick; Taylor D,9999,0,9999,0
1653475839340,CSE 293,004,094908,Christensen; Henrik I,9999,0,9999,0
1653475839340,CSE 293,005,094909,Cottrell; Garrison W,9999,0,9999,0
1653475839340,CSE 293,006,094910,Deutsch; Alin Bernard,9999,0,9999,0
1653475839340,CSE 293,007,094911,Esmaeilzadeh; Hadi,9999,0,9999,0
1653475839340,CSE 293,008,094912,Freund; Yoav,9999,0,9999,0
1653475839340,CSE 293,009,094913,Griswold; William G.,9999,0,9999,0
1653475839340,CSE 293,010,094914,Gymrek; Melissa Ann,9999,0,9999,0
1653475839340,CSE 293,011,094915,Heninger; Nadia A,9999,0,9999,0
1653475839340,CSE 293,012,094916,Impagliazzo; Russell,9999,0,9999,0
1653475839340,CSE 293,013,094917,Jhala; Ranjit,9999,0,9999,0
1653475839340,CSE 293,014,094918,Kahng; Andrew Byun,9999,0,9999,0
1653475839340,CSE 293,015,094919,Kane; Daniel Mertz,9999,0,9999,0
1653475839340,CSE 293,016,094920,Kriegman; David J,9999,0,9999,0
1653475839340,CSE 293,017,094921,Kumar; Arun Kumar,9999,0,9999,0
1653475839340,CSE 293,018,094922,Lerner; Sorin,9999,0,9999,0
1653475839340,CSE 293,019,094923,Lovett; Shachar,9999,0,9999,0
1653475839340,CSE 293,020,094924,McAuley; Julian John,9999,0,9999,0
1653475839340,CSE 293,021,094925,Micciancio; Daniele,9999,0,9999,0
1653475839340,CSE 293,022,094926,Orailoglu; Alex,9999,0,9999,0
1653475839340,CSE 293,023,094927,Paturi; Ramamohan,9999,0,9999,0
1653475839340,CSE 293,024,094928,Polikarpova; Nadezhda,9999,0,9999,0
1653475839340,CSE 293,025,094929,Politz; Joseph Gibbs,9999,0,9999,0
1653475839340,CSE 293,026,094930,Porter; George M,9999,0,9999,0
1653475839340,CSE 293,027,094931,Porter; Leonard Emerson,9999,0,9999,0
1653475839340,CSE 293,028,094932,Ramamoorthi; Ravi,9999,0,9999,0
1653475839340,CSE 293,029,094933,Sahoo; Debashis,9999,0,9999,0
1653475839340,CSE 293,030,094934,Saul; Lawrence,9999,0,9999,0
1653475839340,CSE 293,031,094935,Savage; Stefan,9999,0,9999,0
1653475839340,CSE 293,032,094936,Schulze; Jurgen P.,9999,0,9999,0
1653475839340,CSE 293,033,094937,Snoeren; Alex C.,9999,0,9999,0
1653475839340,CSE 293,034,094938,Shang; Jingbo,9999,0,9999,0
1653475839340,CSE 293,035,094939,Stefan; Deian,9999,0,9999,0
1653475839340,CSE 293,036,094940,Su; Hao,9999,0,9999,0
1653475839340,CSE 293,037,094941,Swanson; Steven James,9999,0,9999,0
1653475839340,CSE 293,038,094942,Tullsen; Dean Michael,9999,0,9999,0
1653475839340,CSE 293,039,094943,Voelker; Geoffrey M.,9999,0,9999,0
1653475839340,CSE 293,040,094944,Zhao; Jishen,9999,0,9999,0
1653475839340,CSE 293,041,094945,Zhou; Yuan-Yuan,9999,0,9999,0
1653475839340,CSE 293,042,094946,Gao; Sicun,9998,0,9999,1
1653475839340,CSE 293,043,094947,Weibel; Nadir,9999,0,9999,0
1653475839340,CSE 293,044,094948,Gupta; Rajesh K.,9999,0,9999,0
1653475839870,CSE 294,A00,090143,Porter; George M,9,0,10,1
1653475840397,DSE 200,A00,091799,Staff,50,0,50,0
1653475840918,DSE 203,A00,091800,Gupta; Amarnath,30,0,30,0
1653475841440,DSE 250,A00,091801,Deutsch; Alin Bernard,30,0,30,0
1653475841968,DSE 290,A00,091802,Altintas De Callaf; Ilkay,50,0,50,0
1653475842567,ECE 200,001,091003,Antipa; Nicholas A,9999,0,9999,0
1653475842567,ECE 200,002,091004,Atanasov; Nikolay A.,9999,0,9999,0
1653475842567,ECE 200,003,091005,Bharadia; Dinesh,9999,0,9999,0
1653475842567,ECE 200,004,091006,Cheng; Chung Kuan,9999,0,9999,0
1653475842567,ECE 200,005,091007,Cosman; Pamela C.,9999,0,9999,0
1653475842567,ECE 200,006,091008,Staff,9999,0,9999,0
1653475842567,ECE 200,007,091009,Dayeh; Shadi Ahmad,9999,0,9999,0
1653475842567,ECE 200,008,091010,Fainman; Yeshaiahu,9999,0,9999,0
1653475842567,ECE 200,009,091011,Ford; Joseph Earl,9999,0,9999,0
1653475842567,ECE 200,010,091012,Franceschetti; Massimo,9999,0,9999,0
1653475842567,ECE 200,011,091013,Fullerton; Eric E,9999,0,9999,0
1653475842567,ECE 200,012,091014,Galton; Ian A,9999,0,9999,0
1653475842567,ECE 200,013,091015,Gilja; Vikash,9999,0,9999,0
1653475842567,ECE 200,014,091016,Hall; Drew A.,9999,0,9999,0
1653475842567,ECE 200,015,091017,Hsueh; Tzu-Chien,9999,0,9999,0
1653475842567,ECE 200,016,091018,Javidi; Tara,9999,0,9999,0
1653475842567,ECE 200,017,091019,Kahng; Andrew Byun,9999,0,9999,0
1653475842567,ECE 200,018,091020,Kim; Young-Han,9999,0,9999,0
1653475842567,ECE 200,019,091021,Koushanfar; Farinaz,9999,0,9999,0
1653475842567,ECE 200,020,091022,Kuzum; Duygu,9999,0,9999,0
1653475842567,ECE 200,021,091023,Le; Hanh-Phuc,9999,0,9999,0
1653475842567,ECE 200,022,091024,Lin; Bill,9999,0,9999,0
1653475842567,ECE 200,023,091025,Liu; Zhaowei,9999,0,9999,0
1653475842567,ECE 200,024,091026,Lo; Yu-Hwa,9999,0,9999,0
1653475842567,ECE 200,025,091027,Lomakin; Vitaliy,9999,0,9999,0
1653475842567,ECE 200,026,091028,Mercier; Patrick Philip,9999,0,9999,0
1653475842567,ECE 200,027,091029,Meyer; Florian,9999,0,9999,0
1653475842567,ECE 200,028,091030,Milstein; Laurence B.,9999,0,9999,0
1653475842567,ECE 200,029,091031,Mir Arabbaygi; Siavash,9999,0,9999,0
1653475842567,ECE 200,030,091032,Mookherjea; Shayan,9999,0,9999,0
1653475842567,ECE 200,031,091033,Morris; Karcher William,9999,0,9999,0
1653475842567,ECE 200,032,091034,Ng; Tse Nga,9999,0,9999,0
1653475842567,ECE 200,033,091035,Nguyen; Truong Quang,9999,0,9999,0
1653475842567,ECE 200,034,091036,Nomura; Kenji,9999,0,9999,0
1653475842567,ECE 200,035,091037,Orlitsky; Alon,9999,0,9999,0
1653475842567,ECE 200,036,091038,Pal; Piya,9999,0,9999,0
1653475842567,ECE 200,037,091039,Papen; George C.,9999,0,9999,0
1653475842567,ECE 200,038,091040,Radic; Stojan,9999,0,9999,0
1653475842567,ECE 200,039,091041,Rao; Bhaskar D.,9999,0,9999,0
1653475842567,ECE 200,040,091042,Rao; Ramesh R,9999,0,9999,0
1653475842567,ECE 200,041,091043,Rebeiz; Gabriel,9999,0,9999,0
1653475842567,ECE 200,042,091044,Sanford; John R,9999,0,9999,0
1653475842567,ECE 200,043,091045,Siegel; Paul H.,9999,0,9999,0
1653475842567,ECE 200,044,091046,Sievenpiper; Daniel F.,9999,0,9999,0
1653475842567,ECE 200,045,091047,Sworder; David D.,9999,0,9999,0
1653475842567,ECE 200,046,091048,Taur; Yuan,9999,0,9999,0
1653475842567,ECE 200,047,091049,Touri; Behrouz,9999,0,9999,0
1653475842567,ECE 200,048,091050,Trivedi; Mohan M.,9999,0,9999,0
1653475842567,ECE 200,049,091051,Vardy; Alexander,9999,0,9999,0
1653475842567,ECE 200,050,091052,Vasconcelos; Nuno,9999,0,9999,0
1653475842567,ECE 200,051,091053,Wang; Xiaolong,9999,0,9999,0
1653475842567,ECE 200,052,091054,Xie; Pengtao,9999,0,9999,0
1653475842567,ECE 200,053,091055,Yip; Michael,9999,0,9999,0
1653475842567,ECE 200,054,091056,Zeger; Kenneth A.,9999,0,9999,0
1653475842567,ECE 200,055,091057,Zhang; Xinyu,9999,0,9999,0
1653475842567,ECE 200,056,091058,Turakhia; Yatish Girish,9999,0,9999,0
1653475842567,ECE 200,057,091059,Kang; Mingu,9999,0,9999,0
1653475842567,ECE 200,058,091060,Shi; Yuanyuan,9999,0,9999,0
1653475842567,ECE 200,059,091061,Wang; Edward Jay,9999,0,9999,0
1653475842567,ECE 200,060,091062,Zheng; Yang,9999,0,9999,0
1653475843096,ECE 203,A00,091065,Mercier; Patrick Philip,0,0,0,0
1653475843621,ECE 207A,A00,091605,Liu; Thomas Tao-Ming,0,0,0,0
1653475844145,ECE 212AN,A00,091068,Nomura; Kenji,0,0,0,0
1653475844669,ECE 222A,A00,091069,Rebeiz; Gabriel,0,0,0,0
1653475845197,ECE 225A,A00,091070,Orlitsky; Alon,0,0,0,0
1653475845724,ECE 230A,A00,091071,Nomura; Kenji,0,0,0,0
1653475846248,ECE 236A,A00,091072,Dayeh; Shadi Ahmad,0,0,0,0
1653475846773,ECE 238A,A00,091073,Luo; Jian,0,0,0,0
1653475846773,ECE 238A,B00,091074,Luo; Jian,0,0,0,0
1653475847297,ECE 240A,A00,091075,Radic; Stojan,0,0,0,0
1653475847821,ECE 247A,A00,091592,Shi; Lingyan,0,0,0,0
1653475848344,ECE 250,A00,091076,Touri; Behrouz,0,0,0,0
1653475848873,ECE 251C,A00,091078,Nguyen; Truong Quang,0,0,0,0
1653475849401,ECE 253,A00,091079,Cosman; Pamela C.,0,0,0,0
1653475849925,ECE 255A,A00,091080,Orlitsky; Alon,0,0,0,0
1653475850454,ECE 257A,A00,091081,Zhang; Xinyu,0,0,0,0
1653475850980,ECE 260A,A01,091084,Eldon; John,0,0,0,0
1653475851503,ECE 264C,A00,091085,Galton; Ian A,0,0,0,0
1653475852026,ECE 265C,A00,094889,Presti; Calogero Davide,0,0,0,9
1653475853151,ECE 266,A01,091087,Hall; Drew A.,0,0,0,0
1653475854200,ECE 271A,A00,091090,Vasconcelos; Nuno,0,0,0,0
1653475854722,ECE 272B,A00,091091,Sworder; David D.,0,0,0,0
1653475855249,ECE 275A,A00,091092,Meyer; Florian,0,0,0,0
1653475855785,ECE 277,A00,091093,An; Cheolhong,0,0,0,0
1653475856308,ECE 283,A00,091094,Le; Hanh-Phuc,0,0,0,0
1653475856831,ECE 284,A00,091095,Kang; Mingu,0,0,0,0
1653475856831,ECE 284,B00,091096,Wang; Edward Jay,0,0,0,0
1653475857356,ECE 285,A00,094334,Touri; Behrouz,0,0,0,0
1653475857880,ECE 289,A00,091097,Whelan; David Arthur,0,0,0,0
1653475858405,MATH 200A,A00,087414,Salehi Golsefidy; Alireza,7,0,8,1
1653475858929,MATH 202A,A00,087415,Gill; Philip E.,3,0,8,5
1653475859454,MATH 203A,A00,087416,Oprea; Dragos N.,6,0,8,2
1653475859976,MATH 204A,A00,087417,Kedlaya; Kiran S.,6,0,8,2
1653475860507,MATH 205,A00,087418,Sorensen; Claus M,6,0,8,2
1653475861036,MATH 206A,A00,087419,Izadi; Elham,7,0,8,1
1653475861563,MATH 207A,A00,087420,Mohammadi; Amir,6,0,8,2
1653475862086,MATH 208,A00,087421,Staff,9,0,10,1
1653475862611,MATH 209,A00,087422,Staff,10,0,10,0
1653475863142,MATH 218,A00,087423,Staff,10,0,10,0
1653475863670,MATH 220A,A00,087424,Novak; Jonathan I,7,0,8,1
1653475864194,MATH 231A,A00,087425,Bejenaru; Ioan,3,0,8,5
1653475864716,MATH 240A,A00,087426,Ebenfelt; Peter F,5,0,8,3
1653475865244,MATH 243,A00,087427,Staff,9,0,10,1
1653475865771,MATH 248,A00,087429,Staff,10,0,10,0
1653475866294,MATH 250A,A00,087430,Spolaor; Luca,4,0,8,4
1653475866818,MATH 257A,A00,087431,Spolaor; Luca,7,0,8,1
1653475867344,MATH 258,A00,087432,Staff,9,0,10,1
1653475867868,MATH 264A,A00,087433,Warnke; Lutz Peter,5,0,8,3
1653475868391,MATH 268,A00,087434,Staff,15,0,15,0
1653475868918,MATH 269,A00,087435,Staff,14,0,15,1
1653475869441,MATH 270A,A00,087436,Nie; Jiawang,0,0,8,8
1653475869969,MATH 272A,A00,087437,Tian; Xiaochuan,1,0,8,7
1653475870493,MATH 274,A01,087439,Cheng; Li-Tien,9,0,10,1
1653475870493,MATH 274,A02,087440,Cheng; Li-Tien,10,0,10,0
1653475871016,MATH 278A,A00,087441,Staff,8,0,10,2
1653475871542,MATH 278B,A00,087442,Staff,8,0,10,2
1653475872069,MATH 278C,A00,087443,Staff,8,0,10,2
1653475872592,MATH 280A,A00,087444,Zheng; Tianyi,0,0,8,8
1653475873116,MATH 281A,A00,087445,Bradic; Jelena,0,0,8,8
1653475873640,MATH 282A,A00,087446,Zhang; Danna,0,0,8,8
1653475874163,MATH 283,A00,087447,Tesler; Glenn,0,0,0,14
1653475874690,MATH 286,A00,087448,Kemp; Todd Aahron,5,0,8,3
1653475875227,MATH 287D,A00,087449,Bradic; Jelena,8,0,8,0
1653475875750,MATH 288,A00,087450,Staff,14,0,15,1
1653475875750,MATH 288,B00,087451,Staff,15,0,15,0
1653475875750,MATH 288,C00,087452,Staff,15,0,15,0
1653475876289,MATH 290A,A00,087453,Xu; Zhouli,7,0,8,1
1653475876812,MATH 291A,A00,087454,Xu; Zhouli,7,0,8,1
1653475877336,MATH 292,A00,087455,Staff,10,0,10,0
1653475877862,MATH 295,A00,087456,Staff,50,0,50,0
1653475878385,MATH 297,001,087457,Staff,998,0,999,1
1653476438407,COGS 200,A01,087991,Staff,47,0,50,3
1653476438930,COGS 201,A01,094504,Rangel; Lara M,17,0,25,8
1653476439456,COGS 203,A00,087992,Coulson; Seana M,18,0,20,2
1653476439982,COGS 210A,001,087993,Greene; Deanna Jacquelyn,9998,0,9999,1
1653476439982,COGS 210A,002,087994,Saygin; Ayse P,9999,0,9999,0
1653476439982,COGS 210A,003,087995,Xia; Haijun,9999,0,9999,0
1653476439982,COGS 210A,004,087996,Nitz; Douglas A.,9999,0,9999,0
1653476439982,COGS 210A,005,087997,Hollan; James D.,9999,0,9999,0
1653476439982,COGS 210A,006,087998,Deak; Gedeon O.,9998,0,9999,1
1653476439982,COGS 210A,007,087999,Rossano; Federico,9999,0,9999,0
1653476440508,COGS 211A,A00,088000,Coulson; Seana M,9997,0,9999,2
1653476441031,COGS 229,A00,088002,Staff,23,0,25,2
1653476441553,COGS 260,B00,094231,Staff,17,0,20,3
1653476441553,COGS 260,A00,088004,Nitz; Douglas A.,9998,0,9999,1
1653476442078,CSE 202,A00,090110,Paturi; Ramamohan,0,0,0,0
1653476442078,CSE 202,B00,090111,Paturi; Ramamohan,0,0,0,0
1653476442601,CSE 207B,A00,090112,Heninger; Nadia A,0,0,0,0
1653476443129,CSE 208,A00,094858,Micciancio; Daniele,0,0,0,0
1653476443653,CSE 210,A00,090113,Powell; Thomas Allan,0,0,0,0
1653476444176,CSE 219,A00,090898,Staff,0,0,0,0
1653476444700,CSE 221,A00,090114,Zhou; Yuan-Yuan,0,0,0,0
1653476445224,CSE 229A,A00,090115,Porter; George M,0,0,0,0
1653476445747,CSE 229C,A00,090116,Savage; Stefan,0,0,0,0
1653476446270,CSE 230,A00,090117,Jhala; Ranjit,0,0,0,0
1653476446794,CSE 232,A00,090118,Papakonstantinou; Yannis,0,0,0,0
1653476447317,CSE 239A,A00,090121,Kumar; Arun Kumar,0,0,0,0
1653476447844,CSE 239B,A00,090122,Jhala; Ranjit,0,0,0,0
1653476448368,CSE 240A,A00,090123,Zhao; Jishen,0,0,189,189
1653476448895,CSE 243A,A00,090124,Orailoglu; Alex,0,0,15,15
1653476449418,CSE 249B,A00,090125,Kahng; Andrew Byun,13,0,20,7
1653476449948,CSE 250A,A00,090126,Berg-Kirkpatrick; Taylor D,0,0,0,0
1653476450471,CSE 252A,A00,090127,Ochoa; Benjamin Lawrence,0,0,0,0
1653476451000,CSE 258,A01,090129,McAuley; Julian John,0,0,0,0
1653476451527,CSE 258R,A01,090131,McAuley; Julian John,0,0,0,0
1653476452050,CSE 274,A00,090132,Ramamoorthi; Ravi,0,0,0,0
1653476452573,CSE 276A,A00,090133,Christensen; Henrik I,0,0,0,0
1653476453096,CSE 276C,A00,090134,Christensen; Henrik I,0,0,0,0
1653476453622,CSE 290,A00,090135,Bafna; Vineet,0,0,0,0
1653476453622,CSE 290,B00,090136,Ramamoorthi; Ravi,0,0,0,0
1653476453622,CSE 290,C00,090137,Li; Tzumao,9,0,10,1
1653476453622,CSE 290,D00,090138,Zhou; Yuan-Yuan,10,0,10,0
1653476453622,CSE 290,E00,090139,Christensen; Henrik I,10,0,10,0
1653476453622,CSE 290,F00,094053,Shalev; Aaron D,0,0,0,0
1653476454157,CSE 291,A00,090140,Munyaka; Imani N. S.,0,0,0,0
1653476454157,CSE 291,B00,094880,Yu; Qi,0,0,0,0
1653476454157,CSE 291,C00,090142,Pannuto; Patrick William,0,0,0,0
1653476454157,CSE 291,D00,094881,Zhang; Yiying,0,0,0,0
1653476454157,CSE 291,E00,095118,Su; Hao,0,0,0,0
1653476454693,CSE 293,001,094905,Bafna; Vineet,9999,0,9999,0
1653476454693,CSE 293,002,094906,Bellare; Mihir,9999,0,9999,0
1653476454693,CSE 293,003,094907,Berg-Kirkpatrick; Taylor D,9999,0,9999,0
1653476454693,CSE 293,004,094908,Christensen; Henrik I,9999,0,9999,0
1653476454693,CSE 293,005,094909,Cottrell; Garrison W,9999,0,9999,0
1653476454693,CSE 293,006,094910,Deutsch; Alin Bernard,9999,0,9999,0
1653476454693,CSE 293,007,094911,Esmaeilzadeh; Hadi,9999,0,9999,0
1653476454693,CSE 293,008,094912,Freund; Yoav,9999,0,9999,0
1653476454693,CSE 293,009,094913,Griswold; William G.,9999,0,9999,0
1653476454693,CSE 293,010,094914,Gymrek; Melissa Ann,9999,0,9999,0
1653476454693,CSE 293,011,094915,Heninger; Nadia A,9999,0,9999,0
1653476454693,CSE 293,012,094916,Impagliazzo; Russell,9999,0,9999,0
1653476454693,CSE 293,013,094917,Jhala; Ranjit,9999,0,9999,0
1653476454693,CSE 293,014,094918,Kahng; Andrew Byun,9999,0,9999,0
1653476454693,CSE 293,015,094919,Kane; Daniel Mertz,9999,0,9999,0
1653476454693,CSE 293,016,094920,Kriegman; David J,9999,0,9999,0
1653476454693,CSE 293,017,094921,Kumar; Arun Kumar,9999,0,9999,0
1653476454693,CSE 293,018,094922,Lerner; Sorin,9999,0,9999,0
1653476454693,CSE 293,019,094923,Lovett; Shachar,9999,0,9999,0
1653476454693,CSE 293,020,094924,McAuley; Julian John,9999,0,9999,0
1653476454693,CSE 293,021,094925,Micciancio; Daniele,9999,0,9999,0
1653476454693,CSE 293,022,094926,Orailoglu; Alex,9999,0,9999,0
1653476454693,CSE 293,023,094927,Paturi; Ramamohan,9999,0,9999,0
1653476454693,CSE 293,024,094928,Polikarpova; Nadezhda,9999,0,9999,0
1653476454693,CSE 293,025,094929,Politz; Joseph Gibbs,9999,0,9999,0
1653476454693,CSE 293,026,094930,Porter; George M,9999,0,9999,0
1653476454693,CSE 293,027,094931,Porter; Leonard Emerson,9999,0,9999,0
1653476454693,CSE 293,028,094932,Ramamoorthi; Ravi,9999,0,9999,0
1653476454693,CSE 293,029,094933,Sahoo; Debashis,9999,0,9999,0
1653476454693,CSE 293,030,094934,Saul; Lawrence,9999,0,9999,0
1653476454693,CSE 293,031,094935,Savage; Stefan,9999,0,9999,0
1653476454693,CSE 293,032,094936,Schulze; Jurgen P.,9999,0,9999,0
1653476454693,CSE 293,033,094937,Snoeren; Alex C.,9999,0,9999,0
1653476454693,CSE 293,034,094938,Shang; Jingbo,9999,0,9999,0
1653476454693,CSE 293,035,094939,Stefan; Deian,9999,0,9999,0
1653476454693,CSE 293,036,094940,Su; Hao,9999,0,9999,0
1653476454693,CSE 293,037,094941,Swanson; Steven James,9999,0,9999,0
1653476454693,CSE 293,038,094942,Tullsen; Dean Michael,9999,0,9999,0
1653476454693,CSE 293,039,094943,Voelker; Geoffrey M.,9999,0,9999,0
1653476454693,CSE 293,040,094944,Zhao; Jishen,9999,0,9999,0
1653476454693,CSE 293,041,094945,Zhou; Yuan-Yuan,9999,0,9999,0
1653476454693,CSE 293,042,094946,Gao; Sicun,9998,0,9999,1
1653476454693,CSE 293,043,094947,Weibel; Nadir,9999,0,9999,0
1653476454693,CSE 293,044,094948,Gupta; Rajesh K.,9999,0,9999,0
1653476455218,CSE 294,A00,090143,Porter; George M,9,0,10,1
1653476455747,DSE 200,A00,091799,Staff,50,0,50,0
1653476456276,DSE 203,A00,091800,Gupta; Amarnath,30,0,30,0
1653476456802,DSE 250,A00,091801,Deutsch; Alin Bernard,30,0,30,0
1653476457344,DSE 290,A00,091802,Altintas De Callaf; Ilkay,50,0,50,0
1653476457898,ECE 200,001,091003,Antipa; Nicholas A,9999,0,9999,0
1653476457898,ECE 200,002,091004,Atanasov; Nikolay A.,9999,0,9999,0
1653476457898,ECE 200,003,091005,Bharadia; Dinesh,9999,0,9999,0
1653476457898,ECE 200,004,091006,Cheng; Chung Kuan,9999,0,9999,0
1653476457898,ECE 200,005,091007,Cosman; Pamela C.,9999,0,9999,0
1653476457898,ECE 200,006,091008,Staff,9999,0,9999,0
1653476457898,ECE 200,007,091009,Dayeh; Shadi Ahmad,9999,0,9999,0
1653476457898,ECE 200,008,091010,Fainman; Yeshaiahu,9999,0,9999,0
1653476457898,ECE 200,009,091011,Ford; Joseph Earl,9999,0,9999,0
1653476457898,ECE 200,010,091012,Franceschetti; Massimo,9999,0,9999,0
1653476457898,ECE 200,011,091013,Fullerton; Eric E,9999,0,9999,0
1653476457898,ECE 200,012,091014,Galton; Ian A,9999,0,9999,0
1653476457898,ECE 200,013,091015,Gilja; Vikash,9999,0,9999,0
1653476457898,ECE 200,014,091016,Hall; Drew A.,9999,0,9999,0
1653476457898,ECE 200,015,091017,Hsueh; Tzu-Chien,9999,0,9999,0
1653476457898,ECE 200,016,091018,Javidi; Tara,9999,0,9999,0
1653476457898,ECE 200,017,091019,Kahng; Andrew Byun,9999,0,9999,0
1653476457898,ECE 200,018,091020,Kim; Young-Han,9999,0,9999,0
1653476457898,ECE 200,019,091021,Koushanfar; Farinaz,9999,0,9999,0
1653476457898,ECE 200,020,091022,Kuzum; Duygu,9999,0,9999,0
1653476457898,ECE 200,021,091023,Le; Hanh-Phuc,9999,0,9999,0
1653476457898,ECE 200,022,091024,Lin; Bill,9999,0,9999,0
1653476457898,ECE 200,023,091025,Liu; Zhaowei,9999,0,9999,0
1653476457898,ECE 200,024,091026,Lo; Yu-Hwa,9999,0,9999,0
1653476457898,ECE 200,025,091027,Lomakin; Vitaliy,9999,0,9999,0
1653476457898,ECE 200,026,091028,Mercier; Patrick Philip,9999,0,9999,0
1653476457898,ECE 200,027,091029,Meyer; Florian,9999,0,9999,0
1653476457898,ECE 200,028,091030,Milstein; Laurence B.,9999,0,9999,0
1653476457898,ECE 200,029,091031,Mir Arabbaygi; Siavash,9999,0,9999,0
1653476457898,ECE 200,030,091032,Mookherjea; Shayan,9999,0,9999,0
1653476457898,ECE 200,031,091033,Morris; Karcher William,9999,0,9999,0
1653476457898,ECE 200,032,091034,Ng; Tse Nga,9999,0,9999,0
1653476457898,ECE 200,033,091035,Nguyen; Truong Quang,9999,0,9999,0
1653476457898,ECE 200,034,091036,Nomura; Kenji,9999,0,9999,0
1653476457898,ECE 200,035,091037,Orlitsky; Alon,9999,0,9999,0
1653476457898,ECE 200,036,091038,Pal; Piya,9999,0,9999,0
1653476457898,ECE 200,037,091039,Papen; George C.,9999,0,9999,0
1653476457898,ECE 200,038,091040,Radic; Stojan,9999,0,9999,0
1653476457898,ECE 200,039,091041,Rao; Bhaskar D.,9999,0,9999,0
1653476457898,ECE 200,040,091042,Rao; Ramesh R,9999,0,9999,0
1653476457898,ECE 200,041,091043,Rebeiz; Gabriel,9999,0,9999,0
1653476457898,ECE 200,042,091044,Sanford; John R,9999,0,9999,0
1653476457898,ECE 200,043,091045,Siegel; Paul H.,9999,0,9999,0
1653476457898,ECE 200,044,091046,Sievenpiper; Daniel F.,9999,0,9999,0
1653476457898,ECE 200,045,091047,Sworder; David D.,9999,0,9999,0
1653476457898,ECE 200,046,091048,Taur; Yuan,9999,0,9999,0
1653476457898,ECE 200,047,091049,Touri; Behrouz,9999,0,9999,0
1653476457898,ECE 200,048,091050,Trivedi; Mohan M.,9999,0,9999,0
1653476457898,ECE 200,049,091051,Vardy; Alexander,9999,0,9999,0
1653476457898,ECE 200,050,091052,Vasconcelos; Nuno,9999,0,9999,0
1653476457898,ECE 200,051,091053,Wang; Xiaolong,9999,0,9999,0
1653476457898,ECE 200,052,091054,Xie; Pengtao,9999,0,9999,0
1653476457898,ECE 200,053,091055,Yip; Michael,9999,0,9999,0
1653476457898,ECE 200,054,091056,Zeger; Kenneth A.,9999,0,9999,0
1653476457898,ECE 200,055,091057,Zhang; Xinyu,9999,0,9999,0
1653476457898,ECE 200,056,091058,Turakhia; Yatish Girish,9999,0,9999,0
1653476457898,ECE 200,057,091059,Kang; Mingu,9999,0,9999,0
1653476457898,ECE 200,058,091060,Shi; Yuanyuan,9999,0,9999,0
1653476457898,ECE 200,059,091061,Wang; Edward Jay,9999,0,9999,0
1653476457898,ECE 200,060,091062,Zheng; Yang,9999,0,9999,0
1653476458423,ECE 203,A00,091065,Mercier; Patrick Philip,0,0,0,0
1653476458949,ECE 207A,A00,091605,Liu; Thomas Tao-Ming,0,0,0,0
1653476459473,ECE 212AN,A00,091068,Nomura; Kenji,0,0,0,0
1653476459999,ECE 222A,A00,091069,Rebeiz; Gabriel,0,0,0,0
1653476460532,ECE 225A,A00,091070,Orlitsky; Alon,0,0,0,0
1653476461058,ECE 230A,A00,091071,Nomura; Kenji,0,0,0,0
1653476461583,ECE 236A,A00,091072,Dayeh; Shadi Ahmad,0,0,0,0
1653476462106,ECE 238A,A00,091073,Luo; Jian,0,0,0,0
1653476462106,ECE 238A,B00,091074,Luo; Jian,0,0,0,0
1653476462629,ECE 240A,A00,091075,Radic; Stojan,0,0,0,0
1653476463153,ECE 247A,A00,091592,Shi; Lingyan,0,0,0,0
1653476463684,ECE 250,A00,091076,Touri; Behrouz,0,0,0,0
1653476464207,ECE 251C,A00,091078,Nguyen; Truong Quang,0,0,0,0
1653476464743,ECE 253,A00,091079,Cosman; Pamela C.,0,0,0,0
1653476465285,ECE 255A,A00,091080,Orlitsky; Alon,0,0,0,0
1653476465809,ECE 257A,A00,091081,Zhang; Xinyu,0,0,0,0
1653476466338,ECE 260A,A01,091084,Eldon; John,0,0,0,0
1653476466862,ECE 264C,A00,091085,Galton; Ian A,0,0,0,0
1653476467392,ECE 265C,A00,094889,Presti; Calogero Davide,0,0,0,9
1653476467920,ECE 266,A01,091087,Hall; Drew A.,0,0,0,0
1653476468976,ECE 271A,A00,091090,Vasconcelos; Nuno,0,0,0,0
1653476469503,ECE 272B,A00,091091,Sworder; David D.,0,0,0,0
1653476470027,ECE 275A,A00,091092,Meyer; Florian,0,0,0,0
1653476470557,ECE 277,A00,091093,An; Cheolhong,0,0,0,0
1653476471082,ECE 283,A00,091094,Le; Hanh-Phuc,0,0,0,0
1653476471605,ECE 284,A00,091095,Kang; Mingu,0,0,0,0
1653476471605,ECE 284,B00,091096,Wang; Edward Jay,0,0,0,0
1653476472128,ECE 285,A00,094334,Touri; Behrouz,0,0,0,0
1653476472655,ECE 289,A00,091097,Whelan; David Arthur,0,0,0,0
1653476473179,MATH 200A,A00,087414,Salehi Golsefidy; Alireza,7,0,8,1
1653476473703,MATH 202A,A00,087415,Gill; Philip E.,3,0,8,5
1653476474231,MATH 203A,A00,087416,Oprea; Dragos N.,6,0,8,2
1653476474757,MATH 204A,A00,087417,Kedlaya; Kiran S.,6,0,8,2
1653476475282,MATH 205,A00,087418,Sorensen; Claus M,6,0,8,2
1653476475811,MATH 206A,A00,087419,Izadi; Elham,7,0,8,1
1653476476343,MATH 207A,A00,087420,Mohammadi; Amir,6,0,8,2
1653476476869,MATH 208,A00,087421,Staff,9,0,10,1
1653476477389,MATH 209,A00,087422,Staff,10,0,10,0
1653476477911,MATH 218,A00,087423,Staff,10,0,10,0
1653476478434,MATH 220A,A00,087424,Novak; Jonathan I,7,0,8,1
1653476478967,MATH 231A,A00,087425,Bejenaru; Ioan,3,0,8,5
1653476479493,MATH 240A,A00,087426,Ebenfelt; Peter F,5,0,8,3
1653476480017,MATH 243,A00,087427,Staff,9,0,10,1
1653476480616,MATH 248,A00,087429,Staff,10,0,10,0
1653476481140,MATH 250A,A00,087430,Spolaor; Luca,4,0,8,4
1653476481666,MATH 257A,A00,087431,Spolaor; Luca,7,0,8,1
1653476482188,MATH 258,A00,087432,Staff,9,0,10,1
1653476482716,MATH 264A,A00,087433,Warnke; Lutz Peter,5,0,8,3
1653476483242,MATH 268,A00,087434,Staff,15,0,15,0
1653476483765,MATH 269,A00,087435,Staff,14,0,15,1
1653476484291,MATH 270A,A00,087436,Nie; Jiawang,0,0,8,8
1653476484819,MATH 272A,A00,087437,Tian; Xiaochuan,1,0,8,7
1653476485349,MATH 274,A01,087439,Cheng; Li-Tien,9,0,10,1
1653476485349,MATH 274,A02,087440,Cheng; Li-Tien,10,0,10,0
1653476485872,MATH 278A,A00,087441,Staff,8,0,10,2
1653476486395,MATH 278B,A00,087442,Staff,8,0,10,2
1653476486917,MATH 278C,A00,087443,Staff,8,0,10,2
1653476487441,MATH 280A,A00,087444,Zheng; Tianyi,0,0,8,8
1653476487969,MATH 281A,A00,087445,Bradic; Jelena,0,0,8,8
1653476488493,MATH 282A,A00,087446,Zhang; Danna,0,0,8,8
1653476489020,MATH 283,A00,087447,Tesler; Glenn,0,0,0,14
1653476489543,MATH 286,A00,087448,Kemp; Todd Aahron,5,0,8,3
1653476490069,MATH 287D,A00,087449,Bradic; Jelena,8,0,8,0
1653476490591,MATH 288,A00,087450,Staff,14,0,15,1
1653476490591,MATH 288,B00,087451,Staff,15,0,15,0
1653476490591,MATH 288,C00,087452,Staff,15,0,15,0
1653476491118,MATH 290A,A00,087453,Xu; Zhouli,7,0,8,1
1653476491645,MATH 291A,A00,087454,Xu; Zhouli,7,0,8,1
1653476492168,MATH 292,A00,087455,Staff,10,0,10,0
1653476492692,MATH 295,A00,087456,Staff,50,0,50,0
1653476493217,MATH 297,001,087457,Staff,998,0,999,1
1653477171828,COGS 200,A01,087991,Staff,47,0,50,3
1653477172355,COGS 201,A01,094504,Rangel; Lara M,17,0,25,8
1653477172892,COGS 203,A00,087992,Coulson; Seana M,18,0,20,2
1653477173418,COGS 210A,001,087993,Greene; Deanna Jacquelyn,9998,0,9999,1
1653477173418,COGS 210A,002,087994,Saygin; Ayse P,9999,0,9999,0
1653477173418,COGS 210A,003,087995,Xia; Haijun,9999,0,9999,0
1653477173418,COGS 210A,004,087996,Nitz; Douglas A.,9999,0,9999,0
1653477173418,COGS 210A,005,087997,Hollan; James D.,9999,0,9999,0
1653477173418,COGS 210A,006,087998,Deak; Gedeon O.,9998,0,9999,1
1653477173418,COGS 210A,007,087999,Rossano; Federico,9999,0,9999,0
1653477173949,COGS 211A,A00,088000,Coulson; Seana M,9997,0,9999,2
1653477174475,COGS 229,A00,088002,Staff,23,0,25,2
1653477175012,COGS 260,B00,094231,Staff,17,0,20,3
1653477175012,COGS 260,A00,088004,Nitz; Douglas A.,9998,0,9999,1
1653477175538,CSE 202,A00,090110,Paturi; Ramamohan,0,0,0,0
1653477175538,CSE 202,B00,090111,Paturi; Ramamohan,0,0,0,0
1653477176062,CSE 207B,A00,090112,Heninger; Nadia A,0,0,0,0
1653477176589,CSE 208,A00,094858,Micciancio; Daniele,0,0,0,0
1653477177117,CSE 210,A00,090113,Powell; Thomas Allan,0,0,0,0
1653477177645,CSE 219,A00,090898,Staff,0,0,0,0
1653477178170,CSE 221,A00,090114,Zhou; Yuan-Yuan,0,0,0,0
1653477178693,CSE 229A,A00,090115,Porter; George M,0,0,0,0
1653477179218,CSE 229C,A00,090116,Savage; Stefan,0,0,0,0
1653477179745,CSE 230,A00,090117,Jhala; Ranjit,0,0,0,0
1653477180269,CSE 232,A00,090118,Papakonstantinou; Yannis,0,0,0,0
1653477180793,CSE 239A,A00,090121,Kumar; Arun Kumar,0,0,0,0
1653477181318,CSE 239B,A00,090122,Jhala; Ranjit,0,0,0,0
1653477181844,CSE 240A,A00,090123,Zhao; Jishen,0,0,189,189
1653477182367,CSE 243A,A00,090124,Orailoglu; Alex,0,0,15,15
1653477182893,CSE 249B,A00,090125,Kahng; Andrew Byun,13,0,20,7
1653477183423,CSE 250A,A00,090126,Berg-Kirkpatrick; Taylor D,0,0,0,0
1653477183953,CSE 252A,A00,090127,Ochoa; Benjamin Lawrence,0,0,0,0
1653477184479,CSE 258,A01,090129,McAuley; Julian John,0,0,0,0
1653477185002,CSE 258R,A01,090131,McAuley; Julian John,0,0,0,0
1653477185525,CSE 274,A00,090132,Ramamoorthi; Ravi,0,0,0,0
1653477186061,CSE 276A,A00,090133,Christensen; Henrik I,0,0,0,0
1653477186584,CSE 276C,A00,090134,Christensen; Henrik I,0,0,0,0
1653477187189,CSE 290,A00,090135,Bafna; Vineet,0,0,0,0
1653477187189,CSE 290,B00,090136,Ramamoorthi; Ravi,0,0,0,0
1653477187189,CSE 290,C00,090137,Li; Tzumao,9,0,10,1
1653477187189,CSE 290,D00,090138,Zhou; Yuan-Yuan,10,0,10,0
1653477187189,CSE 290,E00,090139,Christensen; Henrik I,10,0,10,0
1653477187189,CSE 290,F00,094053,Shalev; Aaron D,0,0,0,0
1653477187726,CSE 291,A00,090140,Munyaka; Imani N. S.,0,0,0,0
1653477187726,CSE 291,B00,094880,Yu; Qi,0,0,0,0
1653477187726,CSE 291,C00,090142,Pannuto; Patrick William,0,0,0,0
1653477187726,CSE 291,D00,094881,Zhang; Yiying,0,0,0,0
1653477187726,CSE 291,E00,095118,Su; Hao,0,0,0,0
1653477188262,CSE 293,001,094905,Bafna; Vineet,9999,0,9999,0
1653477188262,CSE 293,002,094906,Bellare; Mihir,9999,0,9999,0
1653477188262,CSE 293,003,094907,Berg-Kirkpatrick; Taylor D,9999,0,9999,0
1653477188262,CSE 293,004,094908,Christensen; Henrik I,9999,0,9999,0
1653477188262,CSE 293,005,094909,Cottrell; Garrison W,9999,0,9999,0
1653477188262,CSE 293,006,094910,Deutsch; Alin Bernard,9999,0,9999,0
1653477188262,CSE 293,007,094911,Esmaeilzadeh; Hadi,9999,0,9999,0
1653477188262,CSE 293,008,094912,Freund; Yoav,9999,0,9999,0
1653477188262,CSE 293,009,094913,Griswold; William G.,9999,0,9999,0
1653477188262,CSE 293,010,094914,Gymrek; Melissa Ann,9999,0,9999,0
1653477188262,CSE 293,011,094915,Heninger; Nadia A,9999,0,9999,0
1653477188262,CSE 293,012,094916,Impagliazzo; Russell,9999,0,9999,0
1653477188262,CSE 293,013,094917,Jhala; Ranjit,9999,0,9999,0
1653477188262,CSE 293,014,094918,Kahng; Andrew Byun,9999,0,9999,0
1653477188262,CSE 293,015,094919,Kane; Daniel Mertz,9999,0,9999,0
1653477188262,CSE 293,016,094920,Kriegman; David J,9999,0,9999,0
1653477188262,CSE 293,017,094921,Kumar; Arun Kumar,9999,0,9999,0
1653477188262,CSE 293,018,094922,Lerner; Sorin,9999,0,9999,0
1653477188262,CSE 293,019,094923,Lovett; Shachar,9999,0,9999,0
1653477188262,CSE 293,020,094924,McAuley; Julian John,9999,0,9999,0
1653477188262,CSE 293,021,094925,Micciancio; Daniele,9999,0,9999,0
1653477188262,CSE 293,022,094926,Orailoglu; Alex,9999,0,9999,0
1653477188262,CSE 293,023,094927,Paturi; Ramamohan,9999,0,9999,0
1653477188262,CSE 293,024,094928,Polikarpova; Nadezhda,9999,0,9999,0
1653477188262,CSE 293,025,094929,Politz; Joseph Gibbs,9999,0,9999,0
1653477188262,CSE 293,026,094930,Porter; George M,9999,0,9999,0
1653477188262,CSE 293,027,094931,Porter; Leonard Emerson,9999,0,9999,0
1653477188262,CSE 293,028,094932,Ramamoorthi; Ravi,9999,0,9999,0
1653477188262,CSE 293,029,094933,Sahoo; Debashis,9999,0,9999,0
1653477188262,CSE 293,030,094934,Saul; Lawrence,9999,0,9999,0
1653477188262,CSE 293,031,094935,Savage; Stefan,9999,0,9999,0
1653477188262,CSE 293,032,094936,Schulze; Jurgen P.,9999,0,9999,0
1653477188262,CSE 293,033,094937,Snoeren; Alex C.,9999,0,9999,0
1653477188262,CSE 293,034,094938,Shang; Jingbo,9999,0,9999,0
1653477188262,CSE 293,035,094939,Stefan; Deian,9999,0,9999,0
1653477188262,CSE 293,036,094940,Su; Hao,9999,0,9999,0
1653477188262,CSE 293,037,094941,Swanson; Steven James,9999,0,9999,0
1653477188262,CSE 293,038,094942,Tullsen; Dean Michael,9999,0,9999,0
1653477188262,CSE 293,039,094943,Voelker; Geoffrey M.,9999,0,9999,0
1653477188262,CSE 293,040,094944,Zhao; Jishen,9999,0,9999,0
1653477188262,CSE 293,041,094945,Zhou; Yuan-Yuan,9999,0,9999,0
1653477188262,CSE 293,042,094946,Gao; Sicun,9998,0,9999,1
1653477188262,CSE 293,043,094947,Weibel; Nadir,9999,0,9999,0
1653477188262,CSE 293,044,094948,Gupta; Rajesh K.,9999,0,9999,0
1653477188788,CSE 294,A00,090143,Porter; George M,9,0,10,1
1653477189312,DSE 200,A00,091799,Staff,50,0,50,0
1653477189835,DSE 203,A00,091800,Gupta; Amarnath,30,0,30,0
1653477190362,DSE 250,A00,091801,Deutsch; Alin Bernard,30,0,30,0
1653477190885,DSE 290,A00,091802,Altintas De Callaf; Ilkay,50,0,50,0
1653477191471,ECE 200,001,091003,Antipa; Nicholas A,9999,0,9999,0
1653477191471,ECE 200,002,091004,Atanasov; Nikolay A.,9999,0,9999,0
1653477191471,ECE 200,003,091005,Bharadia; Dinesh,9999,0,9999,0
1653477191471,ECE 200,004,091006,Cheng; Chung Kuan,9999,0,9999,0
1653477191471,ECE 200,005,091007,Cosman; Pamela C.,9999,0,9999,0
1653477191471,ECE 200,006,091008,Staff,9999,0,9999,0
1653477191471,ECE 200,007,091009,Dayeh; Shadi Ahmad,9999,0,9999,0
1653477191471,ECE 200,008,091010,Fainman; Yeshaiahu,9999,0,9999,0
1653477191471,ECE 200,009,091011,Ford; Joseph Earl,9999,0,9999,0
1653477191471,ECE 200,010,091012,Franceschetti; Massimo,9999,0,9999,0
1653477191471,ECE 200,011,091013,Fullerton; Eric E,9999,0,9999,0
1653477191471,ECE 200,012,091014,Galton; Ian A,9999,0,9999,0
1653477191471,ECE 200,013,091015,Gilja; Vikash,9999,0,9999,0
1653477191471,ECE 200,014,091016,Hall; Drew A.,9999,0,9999,0
1653477191471,ECE 200,015,091017,Hsueh; Tzu-Chien,9999,0,9999,0
1653477191471,ECE 200,016,091018,Javidi; Tara,9999,0,9999,0
1653477191471,ECE 200,017,091019,Kahng; Andrew Byun,9999,0,9999,0
1653477191471,ECE 200,018,091020,Kim; Young-Han,9999,0,9999,0
1653477191471,ECE 200,019,091021,Koushanfar; Farinaz,9999,0,9999,0
1653477191471,ECE 200,020,091022,Kuzum; Duygu,9999,0,9999,0
1653477191471,ECE 200,021,091023,Le; Hanh-Phuc,9999,0,9999,0
1653477191471,ECE 200,022,091024,Lin; Bill,9999,0,9999,0
1653477191471,ECE 200,023,091025,Liu; Zhaowei,9999,0,9999,0
1653477191471,ECE 200,024,091026,Lo; Yu-Hwa,9999,0,9999,0
1653477191471,ECE 200,025,091027,Lomakin; Vitaliy,9999,0,9999,0
1653477191471,ECE 200,026,091028,Mercier; Patrick Philip,9999,0,9999,0
1653477191471,ECE 200,027,091029,Meyer; Florian,9999,0,9999,0
1653477191471,ECE 200,028,091030,Milstein; Laurence B.,9999,0,9999,0
1653477191471,ECE 200,029,091031,Mir Arabbaygi; Siavash,9999,0,9999,0
1653477191471,ECE 200,030,091032,Mookherjea; Shayan,9999,0,9999,0
1653477191471,ECE 200,031,091033,Morris; Karcher William,9999,0,9999,0
1653477191471,ECE 200,032,091034,Ng; Tse Nga,9999,0,9999,0
1653477191471,ECE 200,033,091035,Nguyen; Truong Quang,9999,0,9999,0
1653477191471,ECE 200,034,091036,Nomura; Kenji,9999,0,9999,0
1653477191471,ECE 200,035,091037,Orlitsky; Alon,9999,0,9999,0
1653477191471,ECE 200,036,091038,Pal; Piya,9999,0,9999,0
1653477191471,ECE 200,037,091039,Papen; George C.,9999,0,9999,0
1653477191471,ECE 200,038,091040,Radic; Stojan,9999,0,9999,0
1653477191471,ECE 200,039,091041,Rao; Bhaskar D.,9999,0,9999,0
1653477191471,ECE 200,040,091042,Rao; Ramesh R,9999,0,9999,0
1653477191471,ECE 200,041,091043,Rebeiz; Gabriel,9999,0,9999,0
1653477191471,ECE 200,042,091044,Sanford; John R,9999,0,9999,0
1653477191471,ECE 200,043,091045,Siegel; Paul H.,9999,0,9999,0
1653477191471,ECE 200,044,091046,Sievenpiper; Daniel F.,9999,0,9999,0
1653477191471,ECE 200,045,091047,Sworder; David D.,9999,0,9999,0
1653477191471,ECE 200,046,091048,Taur; Yuan,9999,0,9999,0
1653477191471,ECE 200,047,091049,Touri; Behrouz,9999,0,9999,0
1653477191471,ECE 200,048,091050,Trivedi; Mohan M.,9999,0,9999,0
1653477191471,ECE 200,049,091051,Vardy; Alexander,9999,0,9999,0
1653477191471,ECE 200,050,091052,Vasconcelos; Nuno,9999,0,9999,0
1653477191471,ECE 200,051,091053,Wang; Xiaolong,9999,0,9999,0
1653477191471,ECE 200,052,091054,Xie; Pengtao,9999,0,9999,0
1653477191471,ECE 200,053,091055,Yip; Michael,9999,0,9999,0
1653477191471,ECE 200,054,091056,Zeger; Kenneth A.,9999,0,9999,0
1653477191471,ECE 200,055,091057,Zhang; Xinyu,9999,0,9999,0
1653477191471,ECE 200,056,091058,Turakhia; Yatish Girish,9999,0,9999,0
1653477191471,ECE 200,057,091059,Kang; Mingu,9999,0,9999,0
1653477191471,ECE 200,058,091060,Shi; Yuanyuan,9999,0,9999,0
1653477191471,ECE 200,059,091061,Wang; Edward Jay,9999,0,9999,0
1653477191471,ECE 200,060,091062,Zheng; Yang,9999,0,9999,0
1653477191996,ECE 203,A00,091065,Mercier; Patrick Philip,0,0,0,0
1653477192521,ECE 207A,A00,091605,Liu; Thomas Tao-Ming,0,0,0,0
1653477193047,ECE 212AN,A00,091068,Nomura; Kenji,0,0,0,0
1653477193572,ECE 222A,A00,091069,Rebeiz; Gabriel,0,0,0,0
1653477194098,ECE 225A,A00,091070,Orlitsky; Alon,0,0,0,0
1653477194621,ECE 230A,A00,091071,Nomura; Kenji,0,0,0,0
1653477195145,ECE 236A,A00,091072,Dayeh; Shadi Ahmad,0,0,0,0
1653477195673,ECE 238A,A00,091073,Luo; Jian,0,0,0,0
1653477195673,ECE 238A,B00,091074,Luo; Jian,0,0,0,0
1653477196197,ECE 240A,A00,091075,Radic; Stojan,0,0,0,0
1653477196733,ECE 247A,A00,091592,Shi; Lingyan,0,0,0,0
1653477197256,ECE 250,A00,091076,Touri; Behrouz,0,0,0,0
1653477197780,ECE 251C,A00,091078,Nguyen; Truong Quang,0,0,0,0
1653477198304,ECE 253,A00,091079,Cosman; Pamela C.,0,0,0,0
1653477198829,ECE 255A,A00,091080,Orlitsky; Alon,0,0,0,0
1653477199355,ECE 257A,A00,091081,Zhang; Xinyu,0,0,0,0
1653477199884,ECE 260A,A01,091084,Eldon; John,0,0,0,0
1653477200408,ECE 264C,A00,091085,Galton; Ian A,0,0,0,0
1653477200937,ECE 265C,A00,094889,Presti; Calogero Davide,0,0,0,9
1653477201461,ECE 266,A01,091087,Hall; Drew A.,0,0,0,0
1653477202506,ECE 271A,A00,091090,Vasconcelos; Nuno,0,0,0,0
1653477203031,ECE 272B,A00,091091,Sworder; David D.,0,0,0,0
1653477203557,ECE 275A,A00,091092,Meyer; Florian,0,0,0,0
1653477204086,ECE 277,A00,091093,An; Cheolhong,0,0,0,0
1653477204610,ECE 283,A00,091094,Le; Hanh-Phuc,0,0,0,0
1653477205137,ECE 284,A00,091095,Kang; Mingu,0,0,0,0
1653477205137,ECE 284,B00,091096,Wang; Edward Jay,0,0,0,0
1653477205660,ECE 285,A00,094334,Touri; Behrouz,0,0,0,0
1653477206188,ECE 289,A00,091097,Whelan; David Arthur,0,0,0,0
1653477206712,MATH 200A,A00,087414,Salehi Golsefidy; Alireza,7,0,8,1
1653477207329,MATH 202A,A00,087415,Gill; Philip E.,3,0,8,5
1653477207856,MATH 203A,A00,087416,Oprea; Dragos N.,6,0,8,2
1653477208398,MATH 204A,A00,087417,Kedlaya; Kiran S.,6,0,8,2
1653477208922,MATH 205,A00,087418,Sorensen; Claus M,6,0,8,2
1653477209447,MATH 206A,A00,087419,Izadi; Elham,7,0,8,1
1653477209971,MATH 207A,A00,087420,Mohammadi; Amir,6,0,8,2
1653477210495,MATH 208,A00,087421,Staff,9,0,10,1
1653477211018,MATH 209,A00,087422,Staff,10,0,10,0
1653477211544,MATH 218,A00,087423,Staff,10,0,10,0
1653477212069,MATH 220A,A00,087424,Novak; Jonathan I,7,0,8,1
1653477212592,MATH 231A,A00,087425,Bejenaru; Ioan,3,0,8,5
1653477213120,MATH 240A,A00,087426,Ebenfelt; Peter F,5,0,8,3
1653477213643,MATH 243,A00,087427,Staff,9,0,10,1
1653477214170,MATH 248,A00,087429,Staff,10,0,10,0
1653477214697,MATH 250A,A00,087430,Spolaor; Luca,4,0,8,4
1653477215220,MATH 257A,A00,087431,Spolaor; Luca,7,0,8,1
1653477215743,MATH 258,A00,087432,Staff,9,0,10,1
1653477216266,MATH 264A,A00,087433,Warnke; Lutz Peter,5,0,8,3
1653477216790,MATH 268,A00,087434,Staff,15,0,15,0
1653477217312,MATH 269,A00,087435,Staff,14,0,15,1
1653477217836,MATH 270A,A00,087436,Nie; Jiawang,0,0,8,8
1653477218365,MATH 272A,A00,087437,Tian; Xiaochuan,1,0,8,7
1653477218889,MATH 274,A01,087439,Cheng; Li-Tien,9,0,10,1
1653477218889,MATH 274,A02,087440,Cheng; Li-Tien,10,0,10,0
1653477219417,MATH 278A,A00,087441,Staff,8,0,10,2
1653477219939,MATH 278B,A00,087442,Staff,8,0,10,2
1653477220465,MATH 278C,A00,087443,Staff,8,0,10,2
1653477220992,MATH 280A,A00,087444,Zheng; Tianyi,0,0,8,8
1653477221515,MATH 281A,A00,087445,Bradic; Jelena,0,0,8,8
1653477222039,MATH 282A,A00,087446,Zhang; Danna,0,0,8,8
1653477222562,MATH 283,A00,087447,Tesler; Glenn,0,0,0,14
1653477223084,MATH 286,A00,087448,Kemp; Todd Aahron,5,0,8,3
1653477223608,MATH 287D,A00,087449,Bradic; Jelena,8,0,8,0
1653477224132,MATH 288,A00,087450,Staff,14,0,15,1
1653477224132,MATH 288,B00,087451,Staff,15,0,15,0
1653477224132,MATH 288,C00,087452,Staff,15,0,15,0
1653477224657,MATH 290A,A00,087453,Xu; Zhouli,7,0,8,1
1653477225183,MATH 291A,A00,087454,Xu; Zhouli,7,0,8,1
1653477225707,MATH 292,A00,087455,Staff,10,0,10,0
1653477226230,MATH 295,A00,087456,Staff,50,0,50,0
1653477226753,MATH 297,001,087457,Staff,998,0,999,1
