time,subj_course_id,sec_code,sec_id,prof,available,waitlist,total,enrolled_ct
1653564771179,COGS 200,A01,087991,Staff,47,0,50,3
1653564771706,COGS 201,A01,094504,Rangel; Lara M,17,0,25,8
1653564772231,COGS 203,A00,087992,Coulson; Seana M,18,0,20,2
1653564772768,COGS 210A,001,087993,Greene; Deanna Jacquelyn,9998,0,9999,1
1653564772768,COGS 210A,002,087994,Saygin; Ayse P,9999,0,9999,0
1653564772768,COGS 210A,003,087995,Xia; Haijun,9999,0,9999,0
1653564772768,COGS 210A,004,087996,Nitz; Douglas A.,9999,0,9999,0
1653564772768,COGS 210A,005,087997,Hollan; James D.,9999,0,9999,0
1653564772768,COGS 210A,006,087998,Deak; Gedeon O.,9998,0,9999,1
1653564772768,COGS 210A,007,087999,Rossano; Federico,9999,0,9999,0
1653564773291,COGS 211A,A00,088000,Coulson; Seana M,9997,0,9999,2
1653564773815,COGS 229,A00,088002,Staff,22,0,25,3
1653564774342,COGS 260,B00,094231,Staff,17,0,20,3
1653564774342,COGS 260,A00,088004,Nitz; Douglas A.,9998,0,9999,1
1653564774881,CSE 202,A00,090110,Paturi; Ramamohan,0,0,0,0
1653564774881,CSE 202,B00,090111,Paturi; Ramamohan,0,0,0,0
1653564775405,CSE 207B,A00,090112,Heninger; Nadia A,0,0,0,0
1653564775932,CSE 208,A00,094858,Micciancio; Daniele,0,0,0,0
1653564776455,CSE 210,A00,090113,Powell; Thomas Allan,0,0,0,0
1653564776982,CSE 219,A00,090898,Staff,0,0,0,0
1653564777507,CSE 221,A00,090114,Zhou; Yuan-Yuan,0,0,0,0
1653564778031,CSE 229A,A00,090115,Porter; George M,0,0,0,0
1653564778561,CSE 229C,A00,090116,Savage; Stefan,0,0,0,0
1653564779088,CSE 230,A00,090117,Jhala; Ranjit,0,0,0,0
1653564779616,CSE 232,A00,090118,Papakonstantinou; Yannis,0,0,0,0
1653564780141,CSE 239A,A00,090121,Kumar; Arun Kumar,0,0,0,0
1653564780665,CSE 239B,A00,090122,Jhala; Ranjit,0,0,0,0
1653564781189,CSE 240A,A00,090123,Zhao; Jishen,1,0,189,188
1653564781717,CSE 243A,A00,090124,Orailoglu; Alex,0,0,15,15
1653564782242,CSE 249B,A00,090125,Kahng; Andrew Byun,13,0,20,7
1653564782765,CSE 250A,A00,090126,Berg-Kirkpatrick; Taylor D,0,0,0,0
1653564783291,CSE 252A,A00,090127,Ochoa; Benjamin Lawrence,0,0,0,0
1653564783812,CSE 258,A01,090129,McAuley; Julian John,0,0,0,0
1653564784341,CSE 258R,A01,090131,McAuley; Julian John,0,0,0,0
1653564784866,CSE 274,A00,090132,Ramamoorthi; Ravi,0,0,0,0
1653564785388,CSE 276A,A00,090133,Christensen; Henrik I,0,0,0,0
1653564785915,CSE 276C,A00,090134,Christensen; Henrik I,0,0,0,0
1653564786451,CSE 290,A00,090135,Bafna; Vineet,0,0,0,0
1653564786451,CSE 290,B00,090136,Ramamoorthi; Ravi,0,0,0,0
1653564786451,CSE 290,C00,090137,Li; Tzumao,8,0,10,2
1653564786451,CSE 290,D00,090138,Zhou; Yuan-Yuan,9,0,10,1
1653564786451,CSE 290,E00,090139,Christensen; Henrik I,8,0,10,2
1653564786451,CSE 290,F00,094053,Shalev; Aaron D,0,0,0,0
1653564786980,CSE 291,A00,090140,Munyaka; Imani N. S.,0,0,0,0
1653564786980,CSE 291,B00,094880,Yu; Qi,0,0,0,0
1653564786980,CSE 291,C00,090142,Pannuto; Patrick William,0,0,0,0
1653564786980,CSE 291,D00,094881,Zhang; Yiying,0,0,0,0
1653564786980,CSE 291,E00,095118,Su; Hao,0,0,0,0
1653564787517,CSE 293,001,094905,Bafna; Vineet,9999,0,9999,0
1653564787517,CSE 293,002,094906,Bellare; Mihir,9999,0,9999,0
1653564787517,CSE 293,003,094907,Berg-Kirkpatrick; Taylor D,9999,0,9999,0
1653564787517,CSE 293,004,094908,Christensen; Henrik I,9999,0,9999,0
1653564787517,CSE 293,005,094909,Cottrell; Garrison W,9999,0,9999,0
1653564787517,CSE 293,006,094910,Deutsch; Alin Bernard,9999,0,9999,0
1653564787517,CSE 293,007,094911,Esmaeilzadeh; Hadi,9999,0,9999,0
1653564787517,CSE 293,008,094912,Freund; Yoav,9999,0,9999,0
1653564787517,CSE 293,009,094913,Griswold; William G.,9999,0,9999,0
1653564787517,CSE 293,010,094914,Gymrek; Melissa Ann,9999,0,9999,0
1653564787517,CSE 293,011,094915,Heninger; Nadia A,9999,0,9999,0
1653564787517,CSE 293,012,094916,Impagliazzo; Russell,9999,0,9999,0
1653564787517,CSE 293,013,094917,Jhala; Ranjit,9999,0,9999,0
1653564787517,CSE 293,014,094918,Kahng; Andrew Byun,9999,0,9999,0
1653564787517,CSE 293,015,094919,Kane; Daniel Mertz,9999,0,9999,0
1653564787517,CSE 293,016,094920,Kriegman; David J,9999,0,9999,0
1653564787517,CSE 293,017,094921,Kumar; Arun Kumar,9999,0,9999,0
1653564787517,CSE 293,018,094922,Lerner; Sorin,9999,0,9999,0
1653564787517,CSE 293,019,094923,Lovett; Shachar,9999,0,9999,0
1653564787517,CSE 293,020,094924,McAuley; Julian John,9999,0,9999,0
1653564787517,CSE 293,021,094925,Micciancio; Daniele,9999,0,9999,0
1653564787517,CSE 293,022,094926,Orailoglu; Alex,9999,0,9999,0
1653564787517,CSE 293,023,094927,Paturi; Ramamohan,9999,0,9999,0
1653564787517,CSE 293,024,094928,Polikarpova; Nadezhda,9999,0,9999,0
1653564787517,CSE 293,025,094929,Politz; Joseph Gibbs,9999,0,9999,0
1653564787517,CSE 293,026,094930,Porter; George M,9999,0,9999,0
1653564787517,CSE 293,027,094931,Porter; Leonard Emerson,9999,0,9999,0
1653564787517,CSE 293,028,094932,Ramamoorthi; Ravi,9999,0,9999,0
1653564787517,CSE 293,029,094933,Sahoo; Debashis,9999,0,9999,0
1653564787517,CSE 293,030,094934,Saul; Lawrence,9999,0,9999,0
1653564787517,CSE 293,031,094935,Savage; Stefan,9999,0,9999,0
1653564787517,CSE 293,032,094936,Schulze; Jurgen P.,9999,0,9999,0
1653564787517,CSE 293,033,094937,Snoeren; Alex C.,9999,0,9999,0
1653564787517,CSE 293,034,094938,Shang; Jingbo,9999,0,9999,0
1653564787517,CSE 293,035,094939,Stefan; Deian,9999,0,9999,0
1653564787517,CSE 293,036,094940,Su; Hao,9999,0,9999,0
1653564787517,CSE 293,037,094941,Swanson; Steven James,9999,0,9999,0
1653564787517,CSE 293,038,094942,Tullsen; Dean Michael,9999,0,9999,0
1653564787517,CSE 293,039,094943,Voelker; Geoffrey M.,9999,0,9999,0
1653564787517,CSE 293,040,094944,Zhao; Jishen,9999,0,9999,0
1653564787517,CSE 293,041,094945,Zhou; Yuan-Yuan,9999,0,9999,0
1653564787517,CSE 293,042,094946,Gao; Sicun,9998,0,9999,1
1653564787517,CSE 293,043,094947,Weibel; Nadir,9999,0,9999,0
1653564787517,CSE 293,044,094948,Gupta; Rajesh K.,9999,0,9999,0
1653564788048,CSE 294,A00,090143,Porter; George M,8,0,10,2
1653564788575,DSE 200,A00,091799,Staff,50,0,50,0
1653564789103,DSE 203,A00,091800,Gupta; Amarnath,30,0,30,0
1653564789634,DSE 250,A00,091801,Deutsch; Alin Bernard,30,0,30,0
1653564790159,DSE 290,A00,091802,Altintas De Callaf; Ilkay,50,0,50,0
1653564790714,ECE 200,001,091003,Antipa; Nicholas A,9999,0,9999,0
1653564790714,ECE 200,002,091004,Atanasov; Nikolay A.,9999,0,9999,0
1653564790714,ECE 200,003,091005,Bharadia; Dinesh,9999,0,9999,0
1653564790714,ECE 200,004,091006,Cheng; Chung Kuan,9999,0,9999,0
1653564790714,ECE 200,005,091007,Cosman; Pamela C.,9999,0,9999,0
1653564790714,ECE 200,006,091008,Staff,9999,0,9999,0
1653564790714,ECE 200,007,091009,Dayeh; Shadi Ahmad,9999,0,9999,0
1653564790714,ECE 200,008,091010,Fainman; Yeshaiahu,9999,0,9999,0
1653564790714,ECE 200,009,091011,Ford; Joseph Earl,9999,0,9999,0
1653564790714,ECE 200,010,091012,Franceschetti; Massimo,9999,0,9999,0
1653564790714,ECE 200,011,091013,Fullerton; Eric E,9999,0,9999,0
1653564790714,ECE 200,012,091014,Galton; Ian A,9999,0,9999,0
1653564790714,ECE 200,013,091015,Gilja; Vikash,9999,0,9999,0
1653564790714,ECE 200,014,091016,Hall; Drew A.,9999,0,9999,0
1653564790714,ECE 200,015,091017,Hsueh; Tzu-Chien,9999,0,9999,0
1653564790714,ECE 200,016,091018,Javidi; Tara,9999,0,9999,0
1653564790714,ECE 200,017,091019,Kahng; Andrew Byun,9999,0,9999,0
1653564790714,ECE 200,018,091020,Kim; Young-Han,9999,0,9999,0
1653564790714,ECE 200,019,091021,Koushanfar; Farinaz,9999,0,9999,0
1653564790714,ECE 200,020,091022,Kuzum; Duygu,9999,0,9999,0
1653564790714,ECE 200,021,091023,Le; Hanh-Phuc,9999,0,9999,0
1653564790714,ECE 200,022,091024,Lin; Bill,9999,0,9999,0
1653564790714,ECE 200,023,091025,Liu; Zhaowei,9999,0,9999,0
1653564790714,ECE 200,024,091026,Lo; Yu-Hwa,9999,0,9999,0
1653564790714,ECE 200,025,091027,Lomakin; Vitaliy,9999,0,9999,0
1653564790714,ECE 200,026,091028,Mercier; Patrick Philip,9999,0,9999,0
1653564790714,ECE 200,027,091029,Meyer; Florian,9999,0,9999,0
1653564790714,ECE 200,028,091030,Milstein; Laurence B.,9999,0,9999,0
1653564790714,ECE 200,029,091031,Mir Arabbaygi; Siavash,9999,0,9999,0
1653564790714,ECE 200,030,091032,Mookherjea; Shayan,9999,0,9999,0
1653564790714,ECE 200,031,091033,Morris; Karcher William,9999,0,9999,0
1653564790714,ECE 200,032,091034,Ng; Tse Nga,9999,0,9999,0
1653564790714,ECE 200,033,091035,Nguyen; Truong Quang,9999,0,9999,0
1653564790714,ECE 200,034,091036,Nomura; Kenji,9999,0,9999,0
1653564790714,ECE 200,035,091037,Orlitsky; Alon,9999,0,9999,0
1653564790714,ECE 200,036,091038,Pal; Piya,9999,0,9999,0
1653564790714,ECE 200,037,091039,Papen; George C.,9999,0,9999,0
1653564790714,ECE 200,038,091040,Radic; Stojan,9999,0,9999,0
1653564790714,ECE 200,039,091041,Rao; Bhaskar D.,9999,0,9999,0
1653564790714,ECE 200,040,091042,Rao; Ramesh R,9999,0,9999,0
1653564790714,ECE 200,041,091043,Rebeiz; Gabriel,9999,0,9999,0
1653564790714,ECE 200,042,091044,Sanford; John R,9999,0,9999,0
1653564790714,ECE 200,043,091045,Siegel; Paul H.,9999,0,9999,0
1653564790714,ECE 200,044,091046,Sievenpiper; Daniel F.,9999,0,9999,0
1653564790714,ECE 200,045,091047,Sworder; David D.,9999,0,9999,0
1653564790714,ECE 200,046,091048,Taur; Yuan,9999,0,9999,0
1653564790714,ECE 200,047,091049,Touri; Behrouz,9999,0,9999,0
1653564790714,ECE 200,048,091050,Trivedi; Mohan M.,9999,0,9999,0
1653564790714,ECE 200,049,091051,Vardy; Alexander,9999,0,9999,0
1653564790714,ECE 200,050,091052,Vasconcelos; Nuno,9999,0,9999,0
1653564790714,ECE 200,051,091053,Wang; Xiaolong,9999,0,9999,0
1653564790714,ECE 200,052,091054,Xie; Pengtao,9999,0,9999,0
1653564790714,ECE 200,053,091055,Yip; Michael,9999,0,9999,0
1653564790714,ECE 200,054,091056,Zeger; Kenneth A.,9999,0,9999,0
1653564790714,ECE 200,055,091057,Zhang; Xinyu,9999,0,9999,0
1653564790714,ECE 200,056,091058,Turakhia; Yatish Girish,9999,0,9999,0
1653564790714,ECE 200,057,091059,Kang; Mingu,9999,0,9999,0
1653564790714,ECE 200,058,091060,Shi; Yuanyuan,9999,0,9999,0
1653564790714,ECE 200,059,091061,Wang; Edward Jay,9999,0,9999,0
1653564790714,ECE 200,060,091062,Zheng; Yang,9999,0,9999,0
1653564791241,ECE 201,A00,095526,Lo; Yu-Hwa,0,0,0,0
1653564791766,ECE 203,A00,091065,Mercier; Patrick Philip,0,0,0,0
1653564792293,ECE 207A,A00,091605,Liu; Thomas Tao-Ming,0,0,0,0
1653564792819,ECE 212AN,A00,091068,Nomura; Kenji,0,0,0,0
1653564793343,ECE 222A,A00,091069,Rebeiz; Gabriel,0,0,0,0
1653564793870,ECE 225A,A00,091070,Orlitsky; Alon,0,0,0,0
1653564794393,ECE 230A,A00,091071,Nomura; Kenji,0,0,0,0
1653564794919,ECE 236A,A00,091072,Dayeh; Shadi Ahmad,0,0,0,0
1653564795448,ECE 238A,A00,091073,Luo; Jian,0,0,0,0
1653564795448,ECE 238A,B00,091074,Luo; Jian,0,0,0,0
1653564795977,ECE 240A,A00,091075,Radic; Stojan,0,0,0,0
1653564796502,ECE 247A,A00,091592,Shi; Lingyan,0,0,0,0
1653564797026,ECE 250,A00,091076,Touri; Behrouz,0,0,0,0
1653564797638,ECE 251C,A00,091078,Nguyen; Truong Quang,0,0,0,0
1653564798171,ECE 253,A00,091079,Cosman; Pamela C.,0,0,0,0
1653564798697,ECE 255A,A00,091080,Orlitsky; Alon,0,0,0,0
1653564799223,ECE 257A,A00,091081,Zhang; Xinyu,0,0,0,0
1653564799749,ECE 260A,A01,091084,Eldon; John,0,0,0,0
1653564800278,ECE 264C,A00,091085,Galton; Ian A,0,0,0,0
1653564800808,ECE 265C,A00,094889,Presti; Calogero Davide,0,0,0,9
1653564801337,ECE 266,A01,091087,Hall; Drew A.,0,0,0,0
1653564802385,ECE 271A,A00,091090,Vasconcelos; Nuno,0,0,0,0
1653564802912,ECE 272B,A00,091091,Sworder; David D.,0,0,0,0
1653564803436,ECE 275A,A00,091092,Meyer; Florian,0,0,0,0
1653564803962,ECE 277,A00,091093,An; Cheolhong,0,0,0,0
1653564804486,ECE 283,A00,091094,Le; Hanh-Phuc,0,0,0,0
1653564805011,ECE 284,A00,091095,Kang; Mingu,0,0,0,0
1653564805011,ECE 284,B00,091096,Wang; Edward Jay,0,0,0,0
1653564805535,ECE 285,A00,094334,Touri; Behrouz,0,0,0,0
1653564806059,ECE 289,A00,091097,Whelan; David Arthur,0,0,0,0
1653564806584,MATH 200A,A00,087414,Salehi Golsefidy; Alireza,7,0,8,1
1653564807105,MATH 202A,A00,087415,Gill; Philip E.,2,0,8,6
1653564807631,MATH 203A,A00,087416,Oprea; Dragos N.,6,0,8,2
1653564808158,MATH 204A,A00,087417,Kedlaya; Kiran S.,6,0,8,2
1653564808684,MATH 205,A00,087418,Sorensen; Claus M,6,0,8,2
1653564809210,MATH 206A,A00,087419,Izadi; Elham,7,0,8,1
1653564809737,MATH 207A,A00,087420,Mohammadi; Amir,5,0,8,3
1653564810260,MATH 208,A00,087421,Staff,9,0,10,1
1653564810783,MATH 209,A00,087422,Staff,10,0,10,0
1653564811308,MATH 218,A00,087423,Staff,10,0,10,0
1653564811832,MATH 220A,A00,087424,Novak; Jonathan I,6,0,8,2
1653564812355,MATH 231A,A00,087425,Bejenaru; Ioan,3,0,8,5
1653564812881,MATH 240A,A00,087426,Ebenfelt; Peter F,5,0,8,3
1653564813420,MATH 243,A00,087427,Staff,9,0,10,1
1653564813944,MATH 248,A00,087429,Staff,10,0,10,0
1653564814469,MATH 250A,A00,087430,Spolaor; Luca,4,0,8,4
1653564814993,MATH 257A,A00,087431,Spolaor; Luca,7,0,8,1
1653564815520,MATH 258,A00,087432,Staff,9,0,10,1
1653564816047,MATH 264A,A00,087433,Warnke; Lutz Peter,5,0,8,3
1653564816569,MATH 268,A00,087434,Staff,15,0,15,0
1653564817095,MATH 269,A00,087435,Staff,14,0,15,1
1653564817627,MATH 270A,A00,087436,Nie; Jiawang,0,0,8,8
1653564818156,MATH 272A,A00,087437,Tian; Xiaochuan,1,0,8,7
1653564818685,MATH 274,A01,087439,Cheng; Li-Tien,9,0,10,1
1653564818685,MATH 274,A02,087440,Cheng; Li-Tien,10,0,10,0
1653564819214,MATH 278A,A00,087441,Staff,8,0,10,2
1653564819742,MATH 278B,A00,087442,Staff,8,0,10,2
1653564820269,MATH 278C,A00,087443,Staff,8,0,10,2
1653564820793,MATH 280A,A00,087444,Zheng; Tianyi,0,0,8,8
1653564821317,MATH 281A,A00,087445,Bradic; Jelena,0,0,8,8
1653564821843,MATH 282A,A00,087446,Zhang; Danna,0,0,8,8
1653564822365,MATH 283,A00,087447,Tesler; Glenn,0,0,0,15
1653564822887,MATH 286,A00,087448,Kemp; Todd Aahron,5,0,8,3
1653564823415,MATH 287D,A00,087449,Bradic; Jelena,0,0,0,1
1653564823939,MATH 288,A00,087450,Staff,14,0,15,1
1653564823939,MATH 288,B00,087451,Staff,15,0,15,0
1653564823939,MATH 288,C00,087452,Staff,15,0,15,0
1653564824465,MATH 290A,A00,087453,Xu; Zhouli,6,0,8,2
1653564824990,MATH 291A,A00,087454,Xu; Zhouli,7,0,8,1
1653564825515,MATH 292,A00,087455,Staff,10,0,10,0
1653564826042,MATH 295,A00,087456,Staff,50,0,50,0
1653564826567,MATH 297,001,087457,Staff,998,0,999,1
1653565387437,COGS 200,A01,087991,Staff,47,0,50,3
1653565387972,COGS 201,A01,094504,Rangel; Lara M,17,0,25,8
1653565388498,COGS 203,A00,087992,Coulson; Seana M,18,0,20,2
1653565389035,COGS 210A,001,087993,Greene; Deanna Jacquelyn,9998,0,9999,1
1653565389035,COGS 210A,002,087994,Saygin; Ayse P,9999,0,9999,0
1653565389035,COGS 210A,003,087995,Xia; Haijun,9999,0,9999,0
1653565389035,COGS 210A,004,087996,Nitz; Douglas A.,9999,0,9999,0
1653565389035,COGS 210A,005,087997,Hollan; James D.,9999,0,9999,0
1653565389035,COGS 210A,006,087998,Deak; Gedeon O.,9998,0,9999,1
1653565389035,COGS 210A,007,087999,Rossano; Federico,9999,0,9999,0
1653565389559,COGS 211A,A00,088000,Coulson; Seana M,9997,0,9999,2
1653565390085,COGS 229,A00,088002,Staff,22,0,25,3
1653565390611,COGS 260,B00,094231,Staff,17,0,20,3
1653565390611,COGS 260,A00,088004,Nitz; Douglas A.,9998,0,9999,1
1653565391137,CSE 202,A00,090110,Paturi; Ramamohan,0,0,0,0
1653565391137,CSE 202,B00,090111,Paturi; Ramamohan,0,0,0,0
1653565391660,CSE 207B,A00,090112,Heninger; Nadia A,0,0,0,0
1653565392189,CSE 208,A00,094858,Micciancio; Daniele,0,0,0,0
1653565392714,CSE 210,A00,090113,Powell; Thomas Allan,0,0,0,0
1653565393238,CSE 219,A00,090898,Staff,0,0,0,0
1653565393762,CSE 221,A00,090114,Zhou; Yuan-Yuan,0,0,0,0
1653565394289,CSE 229A,A00,090115,Porter; George M,0,0,0,0
1653565394814,CSE 229C,A00,090116,Savage; Stefan,0,0,0,0
1653565395338,CSE 230,A00,090117,Jhala; Ranjit,0,0,0,0
1653565395871,CSE 232,A00,090118,Papakonstantinou; Yannis,0,0,0,0
1653565396400,CSE 239A,A00,090121,Kumar; Arun Kumar,0,0,0,0
1653565396923,CSE 239B,A00,090122,Jhala; Ranjit,0,0,0,0
1653565397450,CSE 240A,A00,090123,Zhao; Jishen,1,0,189,188
1653565397975,CSE 243A,A00,090124,Orailoglu; Alex,0,0,15,15
1653565398506,CSE 249B,A00,090125,Kahng; Andrew Byun,13,0,20,7
1653565399030,CSE 250A,A00,090126,Berg-Kirkpatrick; Taylor D,0,0,0,0
1653565399555,CSE 252A,A00,090127,Ochoa; Benjamin Lawrence,0,0,0,0
1653565400079,CSE 258,A01,090129,McAuley; Julian John,0,0,0,0
1653565400604,CSE 258R,A01,090131,McAuley; Julian John,0,0,0,0
1653565401129,CSE 274,A00,090132,Ramamoorthi; Ravi,0,0,0,0
1653565401657,CSE 276A,A00,090133,Christensen; Henrik I,0,0,0,0
1653565402181,CSE 276C,A00,090134,Christensen; Henrik I,0,0,0,0
1653565402707,CSE 290,A00,090135,Bafna; Vineet,0,0,0,0
1653565402707,CSE 290,B00,090136,Ramamoorthi; Ravi,0,0,0,0
1653565402707,CSE 290,C00,090137,Li; Tzumao,8,0,10,2
1653565402707,CSE 290,D00,090138,Zhou; Yuan-Yuan,9,0,10,1
1653565402707,CSE 290,E00,090139,Christensen; Henrik I,8,0,10,2
1653565402707,CSE 290,F00,094053,Shalev; Aaron D,0,0,0,0
1653565403235,CSE 291,A00,090140,Munyaka; Imani N. S.,0,0,0,0
1653565403235,CSE 291,B00,094880,Yu; Qi,0,0,0,0
1653565403235,CSE 291,C00,090142,Pannuto; Patrick William,0,0,0,0
1653565403235,CSE 291,D00,094881,Zhang; Yiying,0,0,0,0
1653565403235,CSE 291,E00,095118,Su; Hao,0,0,0,0
1653565403797,CSE 293,001,094905,Bafna; Vineet,9999,0,9999,0
1653565403797,CSE 293,002,094906,Bellare; Mihir,9999,0,9999,0
1653565403797,CSE 293,003,094907,Berg-Kirkpatrick; Taylor D,9999,0,9999,0
1653565403797,CSE 293,004,094908,Christensen; Henrik I,9999,0,9999,0
1653565403797,CSE 293,005,094909,Cottrell; Garrison W,9999,0,9999,0
1653565403797,CSE 293,006,094910,Deutsch; Alin Bernard,9999,0,9999,0
1653565403797,CSE 293,007,094911,Esmaeilzadeh; Hadi,9999,0,9999,0
1653565403797,CSE 293,008,094912,Freund; Yoav,9999,0,9999,0
1653565403797,CSE 293,009,094913,Griswold; William G.,9999,0,9999,0
1653565403797,CSE 293,010,094914,Gymrek; Melissa Ann,9999,0,9999,0
1653565403797,CSE 293,011,094915,Heninger; Nadia A,9999,0,9999,0
1653565403797,CSE 293,012,094916,Impagliazzo; Russell,9999,0,9999,0
1653565403797,CSE 293,013,094917,Jhala; Ranjit,9999,0,9999,0
1653565403797,CSE 293,014,094918,Kahng; Andrew Byun,9999,0,9999,0
1653565403797,CSE 293,015,094919,Kane; Daniel Mertz,9999,0,9999,0
1653565403797,CSE 293,016,094920,Kriegman; David J,9999,0,9999,0
1653565403797,CSE 293,017,094921,Kumar; Arun Kumar,9999,0,9999,0
1653565403797,CSE 293,018,094922,Lerner; Sorin,9999,0,9999,0
1653565403797,CSE 293,019,094923,Lovett; Shachar,9999,0,9999,0
1653565403797,CSE 293,020,094924,McAuley; Julian John,9999,0,9999,0
1653565403797,CSE 293,021,094925,Micciancio; Daniele,9999,0,9999,0
1653565403797,CSE 293,022,094926,Orailoglu; Alex,9999,0,9999,0
1653565403797,CSE 293,023,094927,Paturi; Ramamohan,9999,0,9999,0
1653565403797,CSE 293,024,094928,Polikarpova; Nadezhda,9999,0,9999,0
1653565403797,CSE 293,025,094929,Politz; Joseph Gibbs,9999,0,9999,0
1653565403797,CSE 293,026,094930,Porter; George M,9999,0,9999,0
1653565403797,CSE 293,027,094931,Porter; Leonard Emerson,9999,0,9999,0
1653565403797,CSE 293,028,094932,Ramamoorthi; Ravi,9999,0,9999,0
1653565403797,CSE 293,029,094933,Sahoo; Debashis,9999,0,9999,0
1653565403797,CSE 293,030,094934,Saul; Lawrence,9999,0,9999,0
1653565403797,CSE 293,031,094935,Savage; Stefan,9999,0,9999,0
1653565403797,CSE 293,032,094936,Schulze; Jurgen P.,9999,0,9999,0
1653565403797,CSE 293,033,094937,Snoeren; Alex C.,9999,0,9999,0
1653565403797,CSE 293,034,094938,Shang; Jingbo,9999,0,9999,0
1653565403797,CSE 293,035,094939,Stefan; Deian,9999,0,9999,0
1653565403797,CSE 293,036,094940,Su; Hao,9999,0,9999,0
1653565403797,CSE 293,037,094941,Swanson; Steven James,9999,0,9999,0
1653565403797,CSE 293,038,094942,Tullsen; Dean Michael,9999,0,9999,0
1653565403797,CSE 293,039,094943,Voelker; Geoffrey M.,9999,0,9999,0
1653565403797,CSE 293,040,094944,Zhao; Jishen,9999,0,9999,0
1653565403797,CSE 293,041,094945,Zhou; Yuan-Yuan,9999,0,9999,0
1653565403797,CSE 293,042,094946,Gao; Sicun,9998,0,9999,1
1653565403797,CSE 293,043,094947,Weibel; Nadir,9999,0,9999,0
1653565403797,CSE 293,044,094948,Gupta; Rajesh K.,9999,0,9999,0
1653565404320,CSE 294,A00,090143,Porter; George M,8,0,10,2
1653565404851,DSE 200,A00,091799,Staff,50,0,50,0
1653565405378,DSE 203,A00,091800,Gupta; Amarnath,30,0,30,0
1653565405902,DSE 250,A00,091801,Deutsch; Alin Bernard,30,0,30,0
1653565406426,DSE 290,A00,091802,Altintas De Callaf; Ilkay,50,0,50,0
1653565407011,ECE 200,001,091003,Antipa; Nicholas A,9999,0,9999,0
1653565407011,ECE 200,002,091004,Atanasov; Nikolay A.,9999,0,9999,0
1653565407011,ECE 200,003,091005,Bharadia; Dinesh,9999,0,9999,0
1653565407011,ECE 200,004,091006,Cheng; Chung Kuan,9999,0,9999,0
1653565407011,ECE 200,005,091007,Cosman; Pamela C.,9999,0,9999,0
1653565407011,ECE 200,006,091008,Staff,9999,0,9999,0
1653565407011,ECE 200,007,091009,Dayeh; Shadi Ahmad,9999,0,9999,0
1653565407011,ECE 200,008,091010,Fainman; Yeshaiahu,9999,0,9999,0
1653565407011,ECE 200,009,091011,Ford; Joseph Earl,9999,0,9999,0
1653565407011,ECE 200,010,091012,Franceschetti; Massimo,9999,0,9999,0
1653565407011,ECE 200,011,091013,Fullerton; Eric E,9999,0,9999,0
1653565407011,ECE 200,012,091014,Galton; Ian A,9999,0,9999,0
1653565407011,ECE 200,013,091015,Gilja; Vikash,9999,0,9999,0
1653565407011,ECE 200,014,091016,Hall; Drew A.,9999,0,9999,0
1653565407011,ECE 200,015,091017,Hsueh; Tzu-Chien,9999,0,9999,0
1653565407011,ECE 200,016,091018,Javidi; Tara,9999,0,9999,0
1653565407011,ECE 200,017,091019,Kahng; Andrew Byun,9999,0,9999,0
1653565407011,ECE 200,018,091020,Kim; Young-Han,9999,0,9999,0
1653565407011,ECE 200,019,091021,Koushanfar; Farinaz,9999,0,9999,0
1653565407011,ECE 200,020,091022,Kuzum; Duygu,9999,0,9999,0
1653565407011,ECE 200,021,091023,Le; Hanh-Phuc,9999,0,9999,0
1653565407011,ECE 200,022,091024,Lin; Bill,9999,0,9999,0
1653565407011,ECE 200,023,091025,Liu; Zhaowei,9999,0,9999,0
1653565407011,ECE 200,024,091026,Lo; Yu-Hwa,9999,0,9999,0
1653565407011,ECE 200,025,091027,Lomakin; Vitaliy,9999,0,9999,0
1653565407011,ECE 200,026,091028,Mercier; Patrick Philip,9999,0,9999,0
1653565407011,ECE 200,027,091029,Meyer; Florian,9999,0,9999,0
1653565407011,ECE 200,028,091030,Milstein; Laurence B.,9999,0,9999,0
1653565407011,ECE 200,029,091031,Mir Arabbaygi; Siavash,9999,0,9999,0
1653565407011,ECE 200,030,091032,Mookherjea; Shayan,9999,0,9999,0
1653565407011,ECE 200,031,091033,Morris; Karcher William,9999,0,9999,0
1653565407011,ECE 200,032,091034,Ng; Tse Nga,9999,0,9999,0
1653565407011,ECE 200,033,091035,Nguyen; Truong Quang,9999,0,9999,0
1653565407011,ECE 200,034,091036,Nomura; Kenji,9999,0,9999,0
1653565407011,ECE 200,035,091037,Orlitsky; Alon,9999,0,9999,0
1653565407011,ECE 200,036,091038,Pal; Piya,9999,0,9999,0
1653565407011,ECE 200,037,091039,Papen; George C.,9999,0,9999,0
1653565407011,ECE 200,038,091040,Radic; Stojan,9999,0,9999,0
1653565407011,ECE 200,039,091041,Rao; Bhaskar D.,9999,0,9999,0
1653565407011,ECE 200,040,091042,Rao; Ramesh R,9999,0,9999,0
1653565407011,ECE 200,041,091043,Rebeiz; Gabriel,9999,0,9999,0
1653565407011,ECE 200,042,091044,Sanford; John R,9999,0,9999,0
1653565407011,ECE 200,043,091045,Siegel; Paul H.,9999,0,9999,0
1653565407011,ECE 200,044,091046,Sievenpiper; Daniel F.,9999,0,9999,0
1653565407011,ECE 200,045,091047,Sworder; David D.,9999,0,9999,0
1653565407011,ECE 200,046,091048,Taur; Yuan,9999,0,9999,0
1653565407011,ECE 200,047,091049,Touri; Behrouz,9999,0,9999,0
1653565407011,ECE 200,048,091050,Trivedi; Mohan M.,9999,0,9999,0
1653565407011,ECE 200,049,091051,Vardy; Alexander,9999,0,9999,0
1653565407011,ECE 200,050,091052,Vasconcelos; Nuno,9999,0,9999,0
1653565407011,ECE 200,051,091053,Wang; Xiaolong,9999,0,9999,0
1653565407011,ECE 200,052,091054,Xie; Pengtao,9999,0,9999,0
1653565407011,ECE 200,053,091055,Yip; Michael,9999,0,9999,0
1653565407011,ECE 200,054,091056,Zeger; Kenneth A.,9999,0,9999,0
1653565407011,ECE 200,055,091057,Zhang; Xinyu,9999,0,9999,0
1653565407011,ECE 200,056,091058,Turakhia; Yatish Girish,9999,0,9999,0
1653565407011,ECE 200,057,091059,Kang; Mingu,9999,0,9999,0
1653565407011,ECE 200,058,091060,Shi; Yuanyuan,9999,0,9999,0
1653565407011,ECE 200,059,091061,Wang; Edward Jay,9999,0,9999,0
1653565407011,ECE 200,060,091062,Zheng; Yang,9999,0,9999,0
1653565407539,ECE 201,A00,095526,Lo; Yu-Hwa,0,0,0,0
1653565408075,ECE 203,A00,091065,Mercier; Patrick Philip,0,0,0,0
1653565408599,ECE 207A,A00,091605,Liu; Thomas Tao-Ming,0,0,0,0
1653565409129,ECE 212AN,A00,091068,Nomura; Kenji,0,0,0,0
1653565409652,ECE 222A,A00,091069,Rebeiz; Gabriel,0,0,0,0
1653565410177,ECE 225A,A00,091070,Orlitsky; Alon,0,0,0,0
1653565410701,ECE 230A,A00,091071,Nomura; Kenji,0,0,0,0
1653565411229,ECE 236A,A00,091072,Dayeh; Shadi Ahmad,0,0,0,0
1653565411754,ECE 238A,A00,091073,Luo; Jian,0,0,0,0
1653565411754,ECE 238A,B00,091074,Luo; Jian,0,0,0,0
1653565412278,ECE 240A,A00,091075,Radic; Stojan,0,0,0,0
1653565412803,ECE 247A,A00,091592,Shi; Lingyan,0,0,0,0
1653565413330,ECE 250,A00,091076,Touri; Behrouz,0,0,0,0
1653565413854,ECE 251C,A00,091078,Nguyen; Truong Quang,0,0,0,0
1653565414382,ECE 253,A00,091079,Cosman; Pamela C.,0,0,0,0
1653565414907,ECE 255A,A00,091080,Orlitsky; Alon,0,0,0,0
1653565415445,ECE 257A,A00,091081,Zhang; Xinyu,0,0,0,0
1653565415970,ECE 260A,A01,091084,Eldon; John,0,0,0,0
1653565416498,ECE 264C,A00,091085,Galton; Ian A,0,0,0,0
1653565417046,ECE 265C,A00,094889,Presti; Calogero Davide,0,0,0,9
1653565417571,ECE 266,A01,091087,Hall; Drew A.,0,0,0,0
1653565418624,ECE 271A,A00,091090,Vasconcelos; Nuno,0,0,0,0
1653565419146,ECE 272B,A00,091091,Sworder; David D.,0,0,0,0
1653565419672,ECE 275A,A00,091092,Meyer; Florian,0,0,0,0
1653565420202,ECE 277,A00,091093,An; Cheolhong,0,0,0,0
1653565420728,ECE 283,A00,091094,Le; Hanh-Phuc,0,0,0,0
1653565421254,ECE 284,A00,091095,Kang; Mingu,0,0,0,0
1653565421254,ECE 284,B00,091096,Wang; Edward Jay,0,0,0,0
1653565421782,ECE 285,A00,094334,Touri; Behrouz,0,0,0,0
1653565422308,ECE 289,A00,091097,Whelan; David Arthur,0,0,0,0
1653565422833,MATH 200A,A00,087414,Salehi Golsefidy; Alireza,7,0,8,1
1653565423358,MATH 202A,A00,087415,Gill; Philip E.,2,0,8,6
1653565423881,MATH 203A,A00,087416,Oprea; Dragos N.,6,0,8,2
1653565424407,MATH 204A,A00,087417,Kedlaya; Kiran S.,6,0,8,2
1653565424931,MATH 205,A00,087418,Sorensen; Claus M,6,0,8,2
1653565425459,MATH 206A,A00,087419,Izadi; Elham,7,0,8,1
1653565425983,MATH 207A,A00,087420,Mohammadi; Amir,5,0,8,3
1653565426510,MATH 208,A00,087421,Staff,9,0,10,1
1653565427039,MATH 209,A00,087422,Staff,10,0,10,0
1653565427563,MATH 218,A00,087423,Staff,10,0,10,0
1653565428130,MATH 220A,A00,087424,Novak; Jonathan I,6,0,8,2
1653565428655,MATH 231A,A00,087425,Bejenaru; Ioan,3,0,8,5
1653565429180,MATH 240A,A00,087426,Ebenfelt; Peter F,5,0,8,3
1653565429705,MATH 243,A00,087427,Staff,9,0,10,1
1653565430230,MATH 248,A00,087429,Staff,10,0,10,0
1653565430759,MATH 250A,A00,087430,Spolaor; Luca,4,0,8,4
1653565431287,MATH 257A,A00,087431,Spolaor; Luca,7,0,8,1
1653565431811,MATH 258,A00,087432,Staff,9,0,10,1
1653565432341,MATH 264A,A00,087433,Warnke; Lutz Peter,5,0,8,3
1653565432864,MATH 268,A00,087434,Staff,15,0,15,0
1653565433391,MATH 269,A00,087435,Staff,14,0,15,1
1653565433916,MATH 270A,A00,087436,Nie; Jiawang,0,0,8,8
1653565434445,MATH 272A,A00,087437,Tian; Xiaochuan,1,0,8,7
1653565434971,MATH 274,A01,087439,Cheng; Li-Tien,9,0,10,1
1653565434971,MATH 274,A02,087440,Cheng; Li-Tien,10,0,10,0
1653565435499,MATH 278A,A00,087441,Staff,8,0,10,2
1653565436024,MATH 278B,A00,087442,Staff,8,0,10,2
1653565436548,MATH 278C,A00,087443,Staff,8,0,10,2
1653565437075,MATH 280A,A00,087444,Zheng; Tianyi,0,0,8,8
1653565437598,MATH 281A,A00,087445,Bradic; Jelena,0,0,8,8
1653565438123,MATH 282A,A00,087446,Zhang; Danna,0,0,8,8
1653565438653,MATH 283,A00,087447,Tesler; Glenn,0,0,0,15
1653565439281,MATH 286,A00,087448,Kemp; Todd Aahron,5,0,8,3
1653565439808,MATH 287D,A00,087449,Bradic; Jelena,0,0,0,1
1653565440334,MATH 288,A00,087450,Staff,14,0,15,1
1653565440334,MATH 288,B00,087451,Staff,15,0,15,0
1653565440334,MATH 288,C00,087452,Staff,15,0,15,0
1653565440858,MATH 290A,A00,087453,Xu; Zhouli,6,0,8,2
1653565441384,MATH 291A,A00,087454,Xu; Zhouli,7,0,8,1
1653565441907,MATH 292,A00,087455,Staff,10,0,10,0
1653565442434,MATH 295,A00,087456,Staff,50,0,50,0
1653565442959,MATH 297,001,087457,Staff,998,0,999,1
1653566003915,COGS 200,A01,087991,Staff,47,0,50,3
1653566004441,COGS 201,A01,094504,Rangel; Lara M,17,0,25,8
1653566004970,COGS 203,A00,087992,Coulson; Seana M,18,0,20,2
1653566005497,COGS 210A,001,087993,Greene; Deanna Jacquelyn,9998,0,9999,1
1653566005497,COGS 210A,002,087994,Saygin; Ayse P,9999,0,9999,0
1653566005497,COGS 210A,003,087995,Xia; Haijun,9999,0,9999,0
1653566005497,COGS 210A,004,087996,Nitz; Douglas A.,9999,0,9999,0
1653566005497,COGS 210A,005,087997,Hollan; James D.,9999,0,9999,0
1653566005497,COGS 210A,006,087998,Deak; Gedeon O.,9998,0,9999,1
1653566005497,COGS 210A,007,087999,Rossano; Federico,9999,0,9999,0
1653566006020,COGS 211A,A00,088000,Coulson; Seana M,9997,0,9999,2
1653566006547,COGS 229,A00,088002,Staff,22,0,25,3
1653566007072,COGS 260,B00,094231,Staff,17,0,20,3
1653566007072,COGS 260,A00,088004,Nitz; Douglas A.,9998,0,9999,1
1653566007597,CSE 202,A00,090110,Paturi; Ramamohan,0,0,0,0
1653566007597,CSE 202,B00,090111,Paturi; Ramamohan,0,0,0,0
1653566008123,CSE 207B,A00,090112,Heninger; Nadia A,0,0,0,0
1653566008652,CSE 208,A00,094858,Micciancio; Daniele,0,0,0,0
1653566009181,CSE 210,A00,090113,Powell; Thomas Allan,0,0,0,0
1653566009706,CSE 219,A00,090898,Staff,0,0,0,0
1653566010231,CSE 221,A00,090114,Zhou; Yuan-Yuan,0,0,0,0
1653566010755,CSE 229A,A00,090115,Porter; George M,0,0,0,0
1653566011279,CSE 229C,A00,090116,Savage; Stefan,0,0,0,0
1653566011807,CSE 230,A00,090117,Jhala; Ranjit,0,0,0,0
1653566012331,CSE 232,A00,090118,Papakonstantinou; Yannis,0,0,0,0
1653566012857,CSE 239A,A00,090121,Kumar; Arun Kumar,0,0,0,0
1653566013381,CSE 239B,A00,090122,Jhala; Ranjit,0,0,0,0
1653566013911,CSE 240A,A00,090123,Zhao; Jishen,1,0,189,188
1653566014441,CSE 243A,A00,090124,Orailoglu; Alex,0,0,15,15
1653566014965,CSE 249B,A00,090125,Kahng; Andrew Byun,13,0,20,7
1653566015489,CSE 250A,A00,090126,Berg-Kirkpatrick; Taylor D,0,0,0,0
1653566016017,CSE 252A,A00,090127,Ochoa; Benjamin Lawrence,0,0,0,0
1653566016542,CSE 258,A01,090129,McAuley; Julian John,0,0,0,0
1653566017069,CSE 258R,A01,090131,McAuley; Julian John,0,0,0,0
1653566017593,CSE 274,A00,090132,Ramamoorthi; Ravi,0,0,0,0
1653566018121,CSE 276A,A00,090133,Christensen; Henrik I,0,0,0,0
1653566018647,CSE 276C,A00,090134,Christensen; Henrik I,0,0,0,0
1653566019172,CSE 290,A00,090135,Bafna; Vineet,0,0,0,0
1653566019172,CSE 290,B00,090136,Ramamoorthi; Ravi,0,0,0,0
1653566019172,CSE 290,C00,090137,Li; Tzumao,8,0,10,2
1653566019172,CSE 290,D00,090138,Zhou; Yuan-Yuan,9,0,10,1
1653566019172,CSE 290,E00,090139,Christensen; Henrik I,8,0,10,2
1653566019172,CSE 290,F00,094053,Shalev; Aaron D,0,0,0,0
1653566019700,CSE 291,A00,090140,Munyaka; Imani N. S.,0,0,0,0
1653566019700,CSE 291,B00,094880,Yu; Qi,0,0,0,0
1653566019700,CSE 291,C00,090142,Pannuto; Patrick William,0,0,0,0
1653566019700,CSE 291,D00,094881,Zhang; Yiying,0,0,0,0
1653566019700,CSE 291,E00,095118,Su; Hao,0,0,0,0
1653566020266,CSE 293,001,094905,Bafna; Vineet,9999,0,9999,0
1653566020266,CSE 293,002,094906,Bellare; Mihir,9999,0,9999,0
1653566020266,CSE 293,003,094907,Berg-Kirkpatrick; Taylor D,9999,0,9999,0
1653566020266,CSE 293,004,094908,Christensen; Henrik I,9999,0,9999,0
1653566020266,CSE 293,005,094909,Cottrell; Garrison W,9999,0,9999,0
1653566020266,CSE 293,006,094910,Deutsch; Alin Bernard,9999,0,9999,0
1653566020266,CSE 293,007,094911,Esmaeilzadeh; Hadi,9999,0,9999,0
1653566020266,CSE 293,008,094912,Freund; Yoav,9999,0,9999,0
1653566020266,CSE 293,009,094913,Griswold; William G.,9999,0,9999,0
1653566020266,CSE 293,010,094914,Gymrek; Melissa Ann,9999,0,9999,0
1653566020266,CSE 293,011,094915,Heninger; Nadia A,9999,0,9999,0
1653566020266,CSE 293,012,094916,Impagliazzo; Russell,9999,0,9999,0
1653566020266,CSE 293,013,094917,Jhala; Ranjit,9999,0,9999,0
1653566020266,CSE 293,014,094918,Kahng; Andrew Byun,9999,0,9999,0
1653566020266,CSE 293,015,094919,Kane; Daniel Mertz,9999,0,9999,0
1653566020266,CSE 293,016,094920,Kriegman; David J,9999,0,9999,0
1653566020266,CSE 293,017,094921,Kumar; Arun Kumar,9999,0,9999,0
1653566020266,CSE 293,018,094922,Lerner; Sorin,9999,0,9999,0
1653566020266,CSE 293,019,094923,Lovett; Shachar,9999,0,9999,0
1653566020266,CSE 293,020,094924,McAuley; Julian John,9999,0,9999,0
1653566020266,CSE 293,021,094925,Micciancio; Daniele,9999,0,9999,0
1653566020266,CSE 293,022,094926,Orailoglu; Alex,9999,0,9999,0
1653566020266,CSE 293,023,094927,Paturi; Ramamohan,9999,0,9999,0
1653566020266,CSE 293,024,094928,Polikarpova; Nadezhda,9999,0,9999,0
1653566020266,CSE 293,025,094929,Politz; Joseph Gibbs,9999,0,9999,0
1653566020266,CSE 293,026,094930,Porter; George M,9999,0,9999,0
1653566020266,CSE 293,027,094931,Porter; Leonard Emerson,9999,0,9999,0
1653566020266,CSE 293,028,094932,Ramamoorthi; Ravi,9999,0,9999,0
1653566020266,CSE 293,029,094933,Sahoo; Debashis,9999,0,9999,0
1653566020266,CSE 293,030,094934,Saul; Lawrence,9999,0,9999,0
1653566020266,CSE 293,031,094935,Savage; Stefan,9999,0,9999,0
1653566020266,CSE 293,032,094936,Schulze; Jurgen P.,9999,0,9999,0
1653566020266,CSE 293,033,094937,Snoeren; Alex C.,9999,0,9999,0
1653566020266,CSE 293,034,094938,Shang; Jingbo,9999,0,9999,0
1653566020266,CSE 293,035,094939,Stefan; Deian,9999,0,9999,0
1653566020266,CSE 293,036,094940,Su; Hao,9999,0,9999,0
1653566020266,CSE 293,037,094941,Swanson; Steven James,9999,0,9999,0
1653566020266,CSE 293,038,094942,Tullsen; Dean Michael,9999,0,9999,0
1653566020266,CSE 293,039,094943,Voelker; Geoffrey M.,9999,0,9999,0
1653566020266,CSE 293,040,094944,Zhao; Jishen,9999,0,9999,0
1653566020266,CSE 293,041,094945,Zhou; Yuan-Yuan,9999,0,9999,0
1653566020266,CSE 293,042,094946,Gao; Sicun,9998,0,9999,1
1653566020266,CSE 293,043,094947,Weibel; Nadir,9999,0,9999,0
1653566020266,CSE 293,044,094948,Gupta; Rajesh K.,9999,0,9999,0
1653566020793,CSE 294,A00,090143,Porter; George M,8,0,10,2
1653566021321,DSE 200,A00,091799,Staff,50,0,50,0
1653566021845,DSE 203,A00,091800,Gupta; Amarnath,30,0,30,0
1653566022368,DSE 250,A00,091801,Deutsch; Alin Bernard,30,0,30,0
1653566022896,DSE 290,A00,091802,Altintas De Callaf; Ilkay,50,0,50,0
1653566023451,ECE 200,001,091003,Antipa; Nicholas A,9999,0,9999,0
1653566023451,ECE 200,002,091004,Atanasov; Nikolay A.,9999,0,9999,0
1653566023451,ECE 200,003,091005,Bharadia; Dinesh,9999,0,9999,0
1653566023451,ECE 200,004,091006,Cheng; Chung Kuan,9999,0,9999,0
1653566023451,ECE 200,005,091007,Cosman; Pamela C.,9999,0,9999,0
1653566023451,ECE 200,006,091008,Staff,9999,0,9999,0
1653566023451,ECE 200,007,091009,Dayeh; Shadi Ahmad,9999,0,9999,0
1653566023451,ECE 200,008,091010,Fainman; Yeshaiahu,9999,0,9999,0
1653566023451,ECE 200,009,091011,Ford; Joseph Earl,9999,0,9999,0
1653566023451,ECE 200,010,091012,Franceschetti; Massimo,9999,0,9999,0
1653566023451,ECE 200,011,091013,Fullerton; Eric E,9999,0,9999,0
1653566023451,ECE 200,012,091014,Galton; Ian A,9999,0,9999,0
1653566023451,ECE 200,013,091015,Gilja; Vikash,9999,0,9999,0
1653566023451,ECE 200,014,091016,Hall; Drew A.,9999,0,9999,0
1653566023451,ECE 200,015,091017,Hsueh; Tzu-Chien,9999,0,9999,0
1653566023451,ECE 200,016,091018,Javidi; Tara,9999,0,9999,0
1653566023451,ECE 200,017,091019,Kahng; Andrew Byun,9999,0,9999,0
1653566023451,ECE 200,018,091020,Kim; Young-Han,9999,0,9999,0
1653566023451,ECE 200,019,091021,Koushanfar; Farinaz,9999,0,9999,0
1653566023451,ECE 200,020,091022,Kuzum; Duygu,9999,0,9999,0
1653566023451,ECE 200,021,091023,Le; Hanh-Phuc,9999,0,9999,0
1653566023451,ECE 200,022,091024,Lin; Bill,9999,0,9999,0
1653566023451,ECE 200,023,091025,Liu; Zhaowei,9999,0,9999,0
1653566023451,ECE 200,024,091026,Lo; Yu-Hwa,9999,0,9999,0
1653566023451,ECE 200,025,091027,Lomakin; Vitaliy,9999,0,9999,0
1653566023451,ECE 200,026,091028,Mercier; Patrick Philip,9999,0,9999,0
1653566023451,ECE 200,027,091029,Meyer; Florian,9999,0,9999,0
1653566023451,ECE 200,028,091030,Milstein; Laurence B.,9999,0,9999,0
1653566023451,ECE 200,029,091031,Mir Arabbaygi; Siavash,9999,0,9999,0
1653566023451,ECE 200,030,091032,Mookherjea; Shayan,9999,0,9999,0
1653566023451,ECE 200,031,091033,Morris; Karcher William,9999,0,9999,0
1653566023451,ECE 200,032,091034,Ng; Tse Nga,9999,0,9999,0
1653566023451,ECE 200,033,091035,Nguyen; Truong Quang,9999,0,9999,0
1653566023451,ECE 200,034,091036,Nomura; Kenji,9999,0,9999,0
1653566023451,ECE 200,035,091037,Orlitsky; Alon,9999,0,9999,0
1653566023451,ECE 200,036,091038,Pal; Piya,9999,0,9999,0
1653566023451,ECE 200,037,091039,Papen; George C.,9999,0,9999,0
1653566023451,ECE 200,038,091040,Radic; Stojan,9999,0,9999,0
1653566023451,ECE 200,039,091041,Rao; Bhaskar D.,9999,0,9999,0
1653566023451,ECE 200,040,091042,Rao; Ramesh R,9999,0,9999,0
1653566023451,ECE 200,041,091043,Rebeiz; Gabriel,9999,0,9999,0
1653566023451,ECE 200,042,091044,Sanford; John R,9999,0,9999,0
1653566023451,ECE 200,043,091045,Siegel; Paul H.,9999,0,9999,0
1653566023451,ECE 200,044,091046,Sievenpiper; Daniel F.,9999,0,9999,0
1653566023451,ECE 200,045,091047,Sworder; David D.,9999,0,9999,0
1653566023451,ECE 200,046,091048,Taur; Yuan,9999,0,9999,0
1653566023451,ECE 200,047,091049,Touri; Behrouz,9999,0,9999,0
1653566023451,ECE 200,048,091050,Trivedi; Mohan M.,9999,0,9999,0
1653566023451,ECE 200,049,091051,Vardy; Alexander,9999,0,9999,0
1653566023451,ECE 200,050,091052,Vasconcelos; Nuno,9999,0,9999,0
1653566023451,ECE 200,051,091053,Wang; Xiaolong,9999,0,9999,0
1653566023451,ECE 200,052,091054,Xie; Pengtao,9999,0,9999,0
1653566023451,ECE 200,053,091055,Yip; Michael,9999,0,9999,0
1653566023451,ECE 200,054,091056,Zeger; Kenneth A.,9999,0,9999,0
1653566023451,ECE 200,055,091057,Zhang; Xinyu,9999,0,9999,0
1653566023451,ECE 200,056,091058,Turakhia; Yatish Girish,9999,0,9999,0
1653566023451,ECE 200,057,091059,Kang; Mingu,9999,0,9999,0
1653566023451,ECE 200,058,091060,Shi; Yuanyuan,9999,0,9999,0
1653566023451,ECE 200,059,091061,Wang; Edward Jay,9999,0,9999,0
1653566023451,ECE 200,060,091062,Zheng; Yang,9999,0,9999,0
1653566023976,ECE 201,A00,095526,Lo; Yu-Hwa,0,0,0,0
1653566024504,ECE 203,A00,091065,Mercier; Patrick Philip,0,0,0,0
1653566025029,ECE 207A,A00,091605,Liu; Thomas Tao-Ming,0,0,0,0
1653566025554,ECE 212AN,A00,091068,Nomura; Kenji,0,0,0,0
1653566026082,ECE 222A,A00,091069,Rebeiz; Gabriel,0,0,0,0
1653566026606,ECE 225A,A00,091070,Orlitsky; Alon,0,0,0,0
1653566027135,ECE 230A,A00,091071,Nomura; Kenji,0,0,0,0
1653566027752,ECE 236A,A00,091072,Dayeh; Shadi Ahmad,0,0,0,0
1653566028279,ECE 238A,A00,091073,Luo; Jian,0,0,0,0
1653566028279,ECE 238A,B00,091074,Luo; Jian,0,0,0,0
1653566028804,ECE 240A,A00,091075,Radic; Stojan,0,0,0,0
1653566029329,ECE 247A,A00,091592,Shi; Lingyan,0,0,0,0
1653566029853,ECE 250,A00,091076,Touri; Behrouz,0,0,0,0
1653566030384,ECE 251C,A00,091078,Nguyen; Truong Quang,0,0,0,0
1653566030908,ECE 253,A00,091079,Cosman; Pamela C.,0,0,0,0
1653566031437,ECE 255A,A00,091080,Orlitsky; Alon,0,0,0,0
1653566031965,ECE 257A,A00,091081,Zhang; Xinyu,0,0,0,0
1653566032489,ECE 260A,A01,091084,Eldon; John,0,0,0,0
1653566033013,ECE 264C,A00,091085,Galton; Ian A,0,0,0,0
1653566033541,ECE 265C,A00,094889,Presti; Calogero Davide,0,0,0,9
1653566034069,ECE 266,A01,091087,Hall; Drew A.,0,0,0,0
1653566035119,ECE 271A,A00,091090,Vasconcelos; Nuno,0,0,0,0
1653566035643,ECE 272B,A00,091091,Sworder; David D.,0,0,0,0
1653566036170,ECE 275A,A00,091092,Meyer; Florian,0,0,0,0
1653566036699,ECE 277,A00,091093,An; Cheolhong,0,0,0,0
1653566037227,ECE 283,A00,091094,Le; Hanh-Phuc,0,0,0,0
1653566037757,ECE 284,A00,091095,Kang; Mingu,0,0,0,0
1653566037757,ECE 284,B00,091096,Wang; Edward Jay,0,0,0,0
1653566038284,ECE 285,A00,094334,Touri; Behrouz,0,0,0,0
1653566038812,ECE 289,A00,091097,Whelan; David Arthur,0,0,0,0
1653566039342,MATH 200A,A00,087414,Salehi Golsefidy; Alireza,7,0,8,1
1653566039871,MATH 202A,A00,087415,Gill; Philip E.,2,0,8,6
1653566040399,MATH 203A,A00,087416,Oprea; Dragos N.,6,0,8,2
1653566040937,MATH 204A,A00,087417,Kedlaya; Kiran S.,6,0,8,2
1653566041464,MATH 205,A00,087418,Sorensen; Claus M,6,0,8,2
1653566041991,MATH 206A,A00,087419,Izadi; Elham,7,0,8,1
1653566042515,MATH 207A,A00,087420,Mohammadi; Amir,5,0,8,3
1653566043042,MATH 208,A00,087421,Staff,9,0,10,1
1653566043567,MATH 209,A00,087422,Staff,10,0,10,0
1653566044091,MATH 218,A00,087423,Staff,10,0,10,0
1653566044617,MATH 220A,A00,087424,Novak; Jonathan I,6,0,8,2
1653566045145,MATH 231A,A00,087425,Bejenaru; Ioan,3,0,8,5
1653566045674,MATH 240A,A00,087426,Ebenfelt; Peter F,5,0,8,3
1653566046198,MATH 243,A00,087427,Staff,9,0,10,1
1653566046727,MATH 248,A00,087429,Staff,10,0,10,0
1653566047251,MATH 250A,A00,087430,Spolaor; Luca,4,0,8,4
1653566047776,MATH 257A,A00,087431,Spolaor; Luca,7,0,8,1
1653566048303,MATH 258,A00,087432,Staff,9,0,10,1
1653566048831,MATH 264A,A00,087433,Warnke; Lutz Peter,5,0,8,3
1653566049355,MATH 268,A00,087434,Staff,15,0,15,0
1653566049882,MATH 269,A00,087435,Staff,14,0,15,1
1653566050409,MATH 270A,A00,087436,Nie; Jiawang,0,0,8,8
1653566050939,MATH 272A,A00,087437,Tian; Xiaochuan,1,0,8,7
1653566051464,MATH 274,A01,087439,Cheng; Li-Tien,9,0,10,1
1653566051464,MATH 274,A02,087440,Cheng; Li-Tien,10,0,10,0
1653566051992,MATH 278A,A00,087441,Staff,8,0,10,2
1653566052518,MATH 278B,A00,087442,Staff,8,0,10,2
1653566053042,MATH 278C,A00,087443,Staff,8,0,10,2
1653566053566,MATH 280A,A00,087444,Zheng; Tianyi,0,0,8,8
1653566054090,MATH 281A,A00,087445,Bradic; Jelena,0,0,8,8
1653566054614,MATH 282A,A00,087446,Zhang; Danna,0,0,8,8
1653566055138,MATH 283,A00,087447,Tesler; Glenn,0,0,0,15
1653566055664,MATH 286,A00,087448,Kemp; Todd Aahron,5,0,8,3
1653566056189,MATH 287D,A00,087449,Bradic; Jelena,0,0,0,1
1653566056715,MATH 288,A00,087450,Staff,14,0,15,1
1653566056715,MATH 288,B00,087451,Staff,15,0,15,0
1653566056715,MATH 288,C00,087452,Staff,15,0,15,0
1653566057238,MATH 290A,A00,087453,Xu; Zhouli,6,0,8,2
1653566057768,MATH 291A,A00,087454,Xu; Zhouli,7,0,8,1
1653566058292,MATH 292,A00,087455,Staff,10,0,10,0
1653566058815,MATH 295,A00,087456,Staff,50,0,50,0
1653566059339,MATH 297,001,087457,Staff,998,0,999,1
1653566621630,COGS 200,A01,087991,Staff,47,0,50,3
1653566622157,COGS 201,A01,094504,Rangel; Lara M,17,0,25,8
1653566622681,COGS 203,A00,087992,Coulson; Seana M,18,0,20,2
1653566623209,COGS 210A,001,087993,Greene; Deanna Jacquelyn,9998,0,9999,1
1653566623209,COGS 210A,002,087994,Saygin; Ayse P,9999,0,9999,0
1653566623209,COGS 210A,003,087995,Xia; Haijun,9999,0,9999,0
1653566623209,COGS 210A,004,087996,Nitz; Douglas A.,9999,0,9999,0
1653566623209,COGS 210A,005,087997,Hollan; James D.,9999,0,9999,0
1653566623209,COGS 210A,006,087998,Deak; Gedeon O.,9998,0,9999,1
1653566623209,COGS 210A,007,087999,Rossano; Federico,9999,0,9999,0
1653566623735,COGS 211A,A00,088000,Coulson; Seana M,9997,0,9999,2
1653566624259,COGS 229,A00,088002,Staff,22,0,25,3
1653566624787,COGS 260,B00,094231,Staff,17,0,20,3
1653566624787,COGS 260,A00,088004,Nitz; Douglas A.,9998,0,9999,1
1653566625314,CSE 202,A00,090110,Paturi; Ramamohan,0,0,0,0
1653566625314,CSE 202,B00,090111,Paturi; Ramamohan,0,0,0,0
1653566625843,CSE 207B,A00,090112,Heninger; Nadia A,0,0,0,0
1653566626371,CSE 208,A00,094858,Micciancio; Daniele,0,0,0,0
1653566626896,CSE 210,A00,090113,Powell; Thomas Allan,0,0,0,0
1653566627419,CSE 219,A00,090898,Staff,0,0,0,0
1653566627944,CSE 221,A00,090114,Zhou; Yuan-Yuan,0,0,0,0
1653566628468,CSE 229A,A00,090115,Porter; George M,0,0,0,0
1653566628991,CSE 229C,A00,090116,Savage; Stefan,0,0,0,0
1653566629519,CSE 230,A00,090117,Jhala; Ranjit,0,0,0,0
1653566630047,CSE 232,A00,090118,Papakonstantinou; Yannis,0,0,0,0
1653566630574,CSE 239A,A00,090121,Kumar; Arun Kumar,0,0,0,0
1653566631096,CSE 239B,A00,090122,Jhala; Ranjit,0,0,0,0
1653566631620,CSE 240A,A00,090123,Zhao; Jishen,1,0,189,188
1653566632148,CSE 243A,A00,090124,Orailoglu; Alex,0,0,15,15
1653566632683,CSE 249B,A00,090125,Kahng; Andrew Byun,13,0,20,7
1653566633211,CSE 250A,A00,090126,Berg-Kirkpatrick; Taylor D,0,0,0,0
1653566633743,CSE 252A,A00,090127,Ochoa; Benjamin Lawrence,0,0,0,0
1653566634270,CSE 258,A01,090129,McAuley; Julian John,0,0,0,0
1653566634796,CSE 258R,A01,090131,McAuley; Julian John,0,0,0,0
1653566635327,CSE 274,A00,090132,Ramamoorthi; Ravi,0,0,0,0
1653566635855,CSE 276A,A00,090133,Christensen; Henrik I,0,0,0,0
1653566636389,CSE 276C,A00,090134,Christensen; Henrik I,0,0,0,0
1653566636916,CSE 290,A00,090135,Bafna; Vineet,0,0,0,0
1653566636916,CSE 290,B00,090136,Ramamoorthi; Ravi,0,0,0,0
1653566636916,CSE 290,C00,090137,Li; Tzumao,8,0,10,2
1653566636916,CSE 290,D00,090138,Zhou; Yuan-Yuan,9,0,10,1
1653566636916,CSE 290,E00,090139,Christensen; Henrik I,8,0,10,2
1653566636916,CSE 290,F00,094053,Shalev; Aaron D,0,0,0,0
1653566637451,CSE 291,A00,090140,Munyaka; Imani N. S.,0,0,0,0
1653566637451,CSE 291,B00,094880,Yu; Qi,0,0,0,0
1653566637451,CSE 291,C00,090142,Pannuto; Patrick William,0,0,0,0
1653566637451,CSE 291,D00,094881,Zhang; Yiying,0,0,0,0
1653566637451,CSE 291,E00,095118,Su; Hao,0,0,0,0
1653566637992,CSE 293,001,094905,Bafna; Vineet,9999,0,9999,0
1653566637992,CSE 293,002,094906,Bellare; Mihir,9999,0,9999,0
1653566637992,CSE 293,003,094907,Berg-Kirkpatrick; Taylor D,9999,0,9999,0
1653566637992,CSE 293,004,094908,Christensen; Henrik I,9999,0,9999,0
1653566637992,CSE 293,005,094909,Cottrell; Garrison W,9999,0,9999,0
1653566637992,CSE 293,006,094910,Deutsch; Alin Bernard,9999,0,9999,0
1653566637992,CSE 293,007,094911,Esmaeilzadeh; Hadi,9999,0,9999,0
1653566637992,CSE 293,008,094912,Freund; Yoav,9999,0,9999,0
1653566637992,CSE 293,009,094913,Griswold; William G.,9999,0,9999,0
1653566637992,CSE 293,010,094914,Gymrek; Melissa Ann,9999,0,9999,0
1653566637992,CSE 293,011,094915,Heninger; Nadia A,9999,0,9999,0
1653566637992,CSE 293,012,094916,Impagliazzo; Russell,9999,0,9999,0
1653566637992,CSE 293,013,094917,Jhala; Ranjit,9999,0,9999,0
1653566637992,CSE 293,014,094918,Kahng; Andrew Byun,9999,0,9999,0
1653566637992,CSE 293,015,094919,Kane; Daniel Mertz,9999,0,9999,0
1653566637992,CSE 293,016,094920,Kriegman; David J,9999,0,9999,0
1653566637992,CSE 293,017,094921,Kumar; Arun Kumar,9999,0,9999,0
1653566637992,CSE 293,018,094922,Lerner; Sorin,9999,0,9999,0
1653566637992,CSE 293,019,094923,Lovett; Shachar,9999,0,9999,0
1653566637992,CSE 293,020,094924,McAuley; Julian John,9999,0,9999,0
1653566637992,CSE 293,021,094925,Micciancio; Daniele,9999,0,9999,0
1653566637992,CSE 293,022,094926,Orailoglu; Alex,9999,0,9999,0
1653566637992,CSE 293,023,094927,Paturi; Ramamohan,9999,0,9999,0
1653566637992,CSE 293,024,094928,Polikarpova; Nadezhda,9999,0,9999,0
1653566637992,CSE 293,025,094929,Politz; Joseph Gibbs,9999,0,9999,0
1653566637992,CSE 293,026,094930,Porter; George M,9999,0,9999,0
1653566637992,CSE 293,027,094931,Porter; Leonard Emerson,9999,0,9999,0
1653566637992,CSE 293,028,094932,Ramamoorthi; Ravi,9999,0,9999,0
1653566637992,CSE 293,029,094933,Sahoo; Debashis,9999,0,9999,0
1653566637992,CSE 293,030,094934,Saul; Lawrence,9999,0,9999,0
1653566637992,CSE 293,031,094935,Savage; Stefan,9999,0,9999,0
1653566637992,CSE 293,032,094936,Schulze; Jurgen P.,9999,0,9999,0
1653566637992,CSE 293,033,094937,Snoeren; Alex C.,9999,0,9999,0
1653566637992,CSE 293,034,094938,Shang; Jingbo,9999,0,9999,0
1653566637992,CSE 293,035,094939,Stefan; Deian,9999,0,9999,0
1653566637992,CSE 293,036,094940,Su; Hao,9999,0,9999,0
1653566637992,CSE 293,037,094941,Swanson; Steven James,9999,0,9999,0
1653566637992,CSE 293,038,094942,Tullsen; Dean Michael,9999,0,9999,0
1653566637992,CSE 293,039,094943,Voelker; Geoffrey M.,9999,0,9999,0
1653566637992,CSE 293,040,094944,Zhao; Jishen,9999,0,9999,0
1653566637992,CSE 293,041,094945,Zhou; Yuan-Yuan,9999,0,9999,0
1653566637992,CSE 293,042,094946,Gao; Sicun,9998,0,9999,1
1653566637992,CSE 293,043,094947,Weibel; Nadir,9999,0,9999,0
1653566637992,CSE 293,044,094948,Gupta; Rajesh K.,9999,0,9999,0
1653566638522,CSE 294,A00,090143,Porter; George M,8,0,10,2
1653566639047,DSE 200,A00,091799,Staff,50,0,50,0
1653566639571,DSE 203,A00,091800,Gupta; Amarnath,30,0,30,0
1653566640099,DSE 250,A00,091801,Deutsch; Alin Bernard,30,0,30,0
1653566640627,DSE 290,A00,091802,Altintas De Callaf; Ilkay,50,0,50,0
1653566641183,ECE 200,001,091003,Antipa; Nicholas A,9999,0,9999,0
1653566641183,ECE 200,002,091004,Atanasov; Nikolay A.,9999,0,9999,0
1653566641183,ECE 200,003,091005,Bharadia; Dinesh,9999,0,9999,0
1653566641183,ECE 200,004,091006,Cheng; Chung Kuan,9999,0,9999,0
1653566641183,ECE 200,005,091007,Cosman; Pamela C.,9999,0,9999,0
1653566641183,ECE 200,006,091008,Staff,9999,0,9999,0
1653566641183,ECE 200,007,091009,Dayeh; Shadi Ahmad,9999,0,9999,0
1653566641183,ECE 200,008,091010,Fainman; Yeshaiahu,9999,0,9999,0
1653566641183,ECE 200,009,091011,Ford; Joseph Earl,9999,0,9999,0
1653566641183,ECE 200,010,091012,Franceschetti; Massimo,9999,0,9999,0
1653566641183,ECE 200,011,091013,Fullerton; Eric E,9999,0,9999,0
1653566641183,ECE 200,012,091014,Galton; Ian A,9999,0,9999,0
1653566641183,ECE 200,013,091015,Gilja; Vikash,9999,0,9999,0
1653566641183,ECE 200,014,091016,Hall; Drew A.,9999,0,9999,0
1653566641183,ECE 200,015,091017,Hsueh; Tzu-Chien,9999,0,9999,0
1653566641183,ECE 200,016,091018,Javidi; Tara,9999,0,9999,0
1653566641183,ECE 200,017,091019,Kahng; Andrew Byun,9999,0,9999,0
1653566641183,ECE 200,018,091020,Kim; Young-Han,9999,0,9999,0
1653566641183,ECE 200,019,091021,Koushanfar; Farinaz,9999,0,9999,0
1653566641183,ECE 200,020,091022,Kuzum; Duygu,9999,0,9999,0
1653566641183,ECE 200,021,091023,Le; Hanh-Phuc,9999,0,9999,0
1653566641183,ECE 200,022,091024,Lin; Bill,9999,0,9999,0
1653566641183,ECE 200,023,091025,Liu; Zhaowei,9999,0,9999,0
1653566641183,ECE 200,024,091026,Lo; Yu-Hwa,9999,0,9999,0
1653566641183,ECE 200,025,091027,Lomakin; Vitaliy,9999,0,9999,0
1653566641183,ECE 200,026,091028,Mercier; Patrick Philip,9999,0,9999,0
1653566641183,ECE 200,027,091029,Meyer; Florian,9999,0,9999,0
1653566641183,ECE 200,028,091030,Milstein; Laurence B.,9999,0,9999,0
1653566641183,ECE 200,029,091031,Mir Arabbaygi; Siavash,9999,0,9999,0
1653566641183,ECE 200,030,091032,Mookherjea; Shayan,9999,0,9999,0
1653566641183,ECE 200,031,091033,Morris; Karcher William,9999,0,9999,0
1653566641183,ECE 200,032,091034,Ng; Tse Nga,9999,0,9999,0
1653566641183,ECE 200,033,091035,Nguyen; Truong Quang,9999,0,9999,0
1653566641183,ECE 200,034,091036,Nomura; Kenji,9999,0,9999,0
1653566641183,ECE 200,035,091037,Orlitsky; Alon,9999,0,9999,0
1653566641183,ECE 200,036,091038,Pal; Piya,9999,0,9999,0
1653566641183,ECE 200,037,091039,Papen; George C.,9999,0,9999,0
1653566641183,ECE 200,038,091040,Radic; Stojan,9999,0,9999,0
1653566641183,ECE 200,039,091041,Rao; Bhaskar D.,9999,0,9999,0
1653566641183,ECE 200,040,091042,Rao; Ramesh R,9999,0,9999,0
1653566641183,ECE 200,041,091043,Rebeiz; Gabriel,9999,0,9999,0
1653566641183,ECE 200,042,091044,Sanford; John R,9999,0,9999,0
1653566641183,ECE 200,043,091045,Siegel; Paul H.,9999,0,9999,0
1653566641183,ECE 200,044,091046,Sievenpiper; Daniel F.,9999,0,9999,0
1653566641183,ECE 200,045,091047,Sworder; David D.,9999,0,9999,0
1653566641183,ECE 200,046,091048,Taur; Yuan,9999,0,9999,0
1653566641183,ECE 200,047,091049,Touri; Behrouz,9999,0,9999,0
1653566641183,ECE 200,048,091050,Trivedi; Mohan M.,9999,0,9999,0
1653566641183,ECE 200,049,091051,Vardy; Alexander,9999,0,9999,0
1653566641183,ECE 200,050,091052,Vasconcelos; Nuno,9999,0,9999,0
1653566641183,ECE 200,051,091053,Wang; Xiaolong,9999,0,9999,0
1653566641183,ECE 200,052,091054,Xie; Pengtao,9999,0,9999,0
1653566641183,ECE 200,053,091055,Yip; Michael,9999,0,9999,0
1653566641183,ECE 200,054,091056,Zeger; Kenneth A.,9999,0,9999,0
1653566641183,ECE 200,055,091057,Zhang; Xinyu,9999,0,9999,0
1653566641183,ECE 200,056,091058,Turakhia; Yatish Girish,9999,0,9999,0
1653566641183,ECE 200,057,091059,Kang; Mingu,9999,0,9999,0
1653566641183,ECE 200,058,091060,Shi; Yuanyuan,9999,0,9999,0
1653566641183,ECE 200,059,091061,Wang; Edward Jay,9999,0,9999,0
1653566641183,ECE 200,060,091062,Zheng; Yang,9999,0,9999,0
1653566641712,ECE 201,A00,095526,Lo; Yu-Hwa,0,0,0,0
1653566642241,ECE 203,A00,091065,Mercier; Patrick Philip,0,0,0,0
1653566642773,ECE 207A,A00,091605,Liu; Thomas Tao-Ming,0,0,0,0
1653566643299,ECE 212AN,A00,091068,Nomura; Kenji,0,0,0,0
1653566643826,ECE 222A,A00,091069,Rebeiz; Gabriel,0,0,0,0
1653566644349,ECE 225A,A00,091070,Orlitsky; Alon,0,0,0,0
1653566644872,ECE 230A,A00,091071,Nomura; Kenji,0,0,0,0
1653566645396,ECE 236A,A00,091072,Dayeh; Shadi Ahmad,0,0,0,0
1653566645926,ECE 238A,A00,091073,Luo; Jian,0,0,0,0
1653566645926,ECE 238A,B00,091074,Luo; Jian,0,0,0,0
1653566646454,ECE 240A,A00,091075,Radic; Stojan,0,0,0,0
1653566646979,ECE 247A,A00,091592,Shi; Lingyan,0,0,0,0
1653566647507,ECE 250,A00,091076,Touri; Behrouz,0,0,0,0
1653566648037,ECE 251C,A00,091078,Nguyen; Truong Quang,0,0,0,0
1653566648563,ECE 253,A00,091079,Cosman; Pamela C.,0,0,0,0
1653566649090,ECE 255A,A00,091080,Orlitsky; Alon,0,0,0,0
1653566649618,ECE 257A,A00,091081,Zhang; Xinyu,0,0,0,0
1653566650148,ECE 260A,A01,091084,Eldon; John,0,0,0,0
1653566650673,ECE 264C,A00,091085,Galton; Ian A,0,0,0,0
1653566651201,ECE 265C,A00,094889,Presti; Calogero Davide,0,0,0,9
1653566651729,ECE 266,A01,091087,Hall; Drew A.,0,0,0,0
1653566652779,ECE 271A,A00,091090,Vasconcelos; Nuno,0,0,0,0
1653566653305,ECE 272B,A00,091091,Sworder; David D.,0,0,0,0
1653566653829,ECE 275A,A00,091092,Meyer; Florian,0,0,0,0
1653566654357,ECE 277,A00,091093,An; Cheolhong,0,0,0,0
1653566654881,ECE 283,A00,091094,Le; Hanh-Phuc,0,0,0,0
1653566655406,ECE 284,A00,091095,Kang; Mingu,0,0,0,0
1653566655406,ECE 284,B00,091096,Wang; Edward Jay,0,0,0,0
1653566655929,ECE 285,A00,094334,Touri; Behrouz,0,0,0,0
1653566656454,ECE 289,A00,091097,Whelan; David Arthur,0,0,0,0
1653566656984,MATH 200A,A00,087414,Salehi Golsefidy; Alireza,7,0,8,1
1653566657515,MATH 202A,A00,087415,Gill; Philip E.,2,0,8,6
1653566658038,MATH 203A,A00,087416,Oprea; Dragos N.,6,0,8,2
1653566658567,MATH 204A,A00,087417,Kedlaya; Kiran S.,6,0,8,2
1653566659091,MATH 205,A00,087418,Sorensen; Claus M,6,0,8,2
1653566659615,MATH 206A,A00,087419,Izadi; Elham,7,0,8,1
1653566660139,MATH 207A,A00,087420,Mohammadi; Amir,5,0,8,3
1653566660667,MATH 208,A00,087421,Staff,9,0,10,1
1653566661191,MATH 209,A00,087422,Staff,10,0,10,0
1653566661718,MATH 218,A00,087423,Staff,10,0,10,0
1653566662257,MATH 220A,A00,087424,Novak; Jonathan I,6,0,8,2
1653566662781,MATH 231A,A00,087425,Bejenaru; Ioan,3,0,8,5
1653566663306,MATH 240A,A00,087426,Ebenfelt; Peter F,5,0,8,3
1653566663832,MATH 243,A00,087427,Staff,9,0,10,1
1653566664360,MATH 248,A00,087429,Staff,10,0,10,0
1653566664888,MATH 250A,A00,087430,Spolaor; Luca,4,0,8,4
1653566665413,MATH 257A,A00,087431,Spolaor; Luca,7,0,8,1
1653566665939,MATH 258,A00,087432,Staff,9,0,10,1
1653566666464,MATH 264A,A00,087433,Warnke; Lutz Peter,5,0,8,3
1653566666988,MATH 268,A00,087434,Staff,15,0,15,0
1653566667523,MATH 269,A00,087435,Staff,14,0,15,1
1653566668051,MATH 270A,A00,087436,Nie; Jiawang,0,0,8,8
1653566668574,MATH 272A,A00,087437,Tian; Xiaochuan,1,0,8,7
1653566669106,MATH 274,A01,087439,Cheng; Li-Tien,9,0,10,1
1653566669106,MATH 274,A02,087440,Cheng; Li-Tien,10,0,10,0
1653566669631,MATH 278A,A00,087441,Staff,8,0,10,2
1653566670152,MATH 278B,A00,087442,Staff,8,0,10,2
1653566670767,MATH 278C,A00,087443,Staff,8,0,10,2
1653566671291,MATH 280A,A00,087444,Zheng; Tianyi,0,0,8,8
1653566671824,MATH 281A,A00,087445,Bradic; Jelena,0,0,8,8
1653566672351,MATH 282A,A00,087446,Zhang; Danna,0,0,8,8
1653566672878,MATH 283,A00,087447,Tesler; Glenn,0,0,0,15
1653566673406,MATH 286,A00,087448,Kemp; Todd Aahron,5,0,8,3
1653566673929,MATH 287D,A00,087449,Bradic; Jelena,0,0,0,1
1653566674453,MATH 288,A00,087450,Staff,14,0,15,1
1653566674453,MATH 288,B00,087451,Staff,15,0,15,0
1653566674453,MATH 288,C00,087452,Staff,15,0,15,0
1653566674981,MATH 290A,A00,087453,Xu; Zhouli,6,0,8,2
1653566675510,MATH 291A,A00,087454,Xu; Zhouli,7,0,8,1
1653566676035,MATH 292,A00,087455,Staff,10,0,10,0
1653566676566,MATH 295,A00,087456,Staff,50,0,50,0
1653566677092,MATH 297,001,087457,Staff,998,0,999,1
1653567239065,COGS 200,A01,087991,Staff,47,0,50,3
1653567239597,COGS 201,A01,094504,Rangel; Lara M,17,0,25,8
1653567240123,COGS 203,A00,087992,Coulson; Seana M,18,0,20,2
1653567240661,COGS 210A,001,087993,Greene; Deanna Jacquelyn,9998,0,9999,1
1653567240661,COGS 210A,002,087994,Saygin; Ayse P,9999,0,9999,0
1653567240661,COGS 210A,003,087995,Xia; Haijun,9999,0,9999,0
1653567240661,COGS 210A,004,087996,Nitz; Douglas A.,9999,0,9999,0
1653567240661,COGS 210A,005,087997,Hollan; James D.,9999,0,9999,0
1653567240661,COGS 210A,006,087998,Deak; Gedeon O.,9998,0,9999,1
1653567240661,COGS 210A,007,087999,Rossano; Federico,9999,0,9999,0
1653567241196,COGS 211A,A00,088000,Coulson; Seana M,9997,0,9999,2
1653567241719,COGS 229,A00,088002,Staff,22,0,25,3
1653567242248,COGS 260,B00,094231,Staff,17,0,20,3
1653567242248,COGS 260,A00,088004,Nitz; Douglas A.,9998,0,9999,1
1653567242781,CSE 202,A00,090110,Paturi; Ramamohan,0,0,0,0
1653567242781,CSE 202,B00,090111,Paturi; Ramamohan,0,0,0,0
1653567243308,CSE 207B,A00,090112,Heninger; Nadia A,0,0,0,0
1653567243838,CSE 208,A00,094858,Micciancio; Daniele,0,0,0,0
1653567244365,CSE 210,A00,090113,Powell; Thomas Allan,0,0,0,0
1653567244893,CSE 219,A00,090898,Staff,0,0,0,0
1653567245417,CSE 221,A00,090114,Zhou; Yuan-Yuan,0,0,0,0
1653567245944,CSE 229A,A00,090115,Porter; George M,0,0,0,0
1653567246471,CSE 229C,A00,090116,Savage; Stefan,0,0,0,0
1653567246995,CSE 230,A00,090117,Jhala; Ranjit,0,0,0,0
1653567247525,CSE 232,A00,090118,Papakonstantinou; Yannis,0,0,0,0
1653567248050,CSE 239A,A00,090121,Kumar; Arun Kumar,0,0,0,0
1653567248579,CSE 239B,A00,090122,Jhala; Ranjit,0,0,0,0
1653567249103,CSE 240A,A00,090123,Zhao; Jishen,1,0,189,188
1653567249630,CSE 243A,A00,090124,Orailoglu; Alex,0,0,15,15
1653567250161,CSE 249B,A00,090125,Kahng; Andrew Byun,13,0,20,7
1653567250685,CSE 250A,A00,090126,Berg-Kirkpatrick; Taylor D,0,0,0,0
1653567251210,CSE 252A,A00,090127,Ochoa; Benjamin Lawrence,0,0,0,0
1653567251734,CSE 258,A01,090129,McAuley; Julian John,0,0,0,0
1653567252258,CSE 258R,A01,090131,McAuley; Julian John,0,0,0,0
1653567252786,CSE 274,A00,090132,Ramamoorthi; Ravi,0,0,0,0
1653567253313,CSE 276A,A00,090133,Christensen; Henrik I,0,0,0,0
1653567253844,CSE 276C,A00,090134,Christensen; Henrik I,0,0,0,0
1653567254375,CSE 290,A00,090135,Bafna; Vineet,0,0,0,0
1653567254375,CSE 290,B00,090136,Ramamoorthi; Ravi,0,0,0,0
1653567254375,CSE 290,C00,090137,Li; Tzumao,8,0,10,2
1653567254375,CSE 290,D00,090138,Zhou; Yuan-Yuan,9,0,10,1
1653567254375,CSE 290,E00,090139,Christensen; Henrik I,8,0,10,2
1653567254375,CSE 290,F00,094053,Shalev; Aaron D,0,0,0,0
1653567254905,CSE 291,A00,090140,Munyaka; Imani N. S.,0,0,0,0
1653567254905,CSE 291,B00,094880,Yu; Qi,0,0,0,0
1653567254905,CSE 291,C00,090142,Pannuto; Patrick William,0,0,0,0
1653567254905,CSE 291,D00,094881,Zhang; Yiying,0,0,0,0
1653567254905,CSE 291,E00,095118,Su; Hao,0,0,0,0
1653567255463,CSE 293,001,094905,Bafna; Vineet,9999,0,9999,0
1653567255463,CSE 293,002,094906,Bellare; Mihir,9999,0,9999,0
1653567255463,CSE 293,003,094907,Berg-Kirkpatrick; Taylor D,9999,0,9999,0
1653567255463,CSE 293,004,094908,Christensen; Henrik I,9999,0,9999,0
1653567255463,CSE 293,005,094909,Cottrell; Garrison W,9999,0,9999,0
1653567255463,CSE 293,006,094910,Deutsch; Alin Bernard,9999,0,9999,0
1653567255463,CSE 293,007,094911,Esmaeilzadeh; Hadi,9999,0,9999,0
1653567255463,CSE 293,008,094912,Freund; Yoav,9999,0,9999,0
1653567255463,CSE 293,009,094913,Griswold; William G.,9999,0,9999,0
1653567255463,CSE 293,010,094914,Gymrek; Melissa Ann,9999,0,9999,0
1653567255463,CSE 293,011,094915,Heninger; Nadia A,9999,0,9999,0
1653567255463,CSE 293,012,094916,Impagliazzo; Russell,9999,0,9999,0
1653567255463,CSE 293,013,094917,Jhala; Ranjit,9999,0,9999,0
1653567255463,CSE 293,014,094918,Kahng; Andrew Byun,9999,0,9999,0
1653567255463,CSE 293,015,094919,Kane; Daniel Mertz,9999,0,9999,0
1653567255463,CSE 293,016,094920,Kriegman; David J,9999,0,9999,0
1653567255463,CSE 293,017,094921,Kumar; Arun Kumar,9999,0,9999,0
1653567255463,CSE 293,018,094922,Lerner; Sorin,9999,0,9999,0
1653567255463,CSE 293,019,094923,Lovett; Shachar,9999,0,9999,0
1653567255463,CSE 293,020,094924,McAuley; Julian John,9999,0,9999,0
1653567255463,CSE 293,021,094925,Micciancio; Daniele,9999,0,9999,0
1653567255463,CSE 293,022,094926,Orailoglu; Alex,9999,0,9999,0
1653567255463,CSE 293,023,094927,Paturi; Ramamohan,9999,0,9999,0
1653567255463,CSE 293,024,094928,Polikarpova; Nadezhda,9999,0,9999,0
1653567255463,CSE 293,025,094929,Politz; Joseph Gibbs,9999,0,9999,0
1653567255463,CSE 293,026,094930,Porter; George M,9999,0,9999,0
1653567255463,CSE 293,027,094931,Porter; Leonard Emerson,9999,0,9999,0
1653567255463,CSE 293,028,094932,Ramamoorthi; Ravi,9999,0,9999,0
1653567255463,CSE 293,029,094933,Sahoo; Debashis,9999,0,9999,0
1653567255463,CSE 293,030,094934,Saul; Lawrence,9999,0,9999,0
1653567255463,CSE 293,031,094935,Savage; Stefan,9999,0,9999,0
1653567255463,CSE 293,032,094936,Schulze; Jurgen P.,9999,0,9999,0
1653567255463,CSE 293,033,094937,Snoeren; Alex C.,9999,0,9999,0
1653567255463,CSE 293,034,094938,Shang; Jingbo,9999,0,9999,0
1653567255463,CSE 293,035,094939,Stefan; Deian,9999,0,9999,0
1653567255463,CSE 293,036,094940,Su; Hao,9999,0,9999,0
1653567255463,CSE 293,037,094941,Swanson; Steven James,9999,0,9999,0
1653567255463,CSE 293,038,094942,Tullsen; Dean Michael,9999,0,9999,0
1653567255463,CSE 293,039,094943,Voelker; Geoffrey M.,9999,0,9999,0
1653567255463,CSE 293,040,094944,Zhao; Jishen,9999,0,9999,0
1653567255463,CSE 293,041,094945,Zhou; Yuan-Yuan,9999,0,9999,0
1653567255463,CSE 293,042,094946,Gao; Sicun,9998,0,9999,1
1653567255463,CSE 293,043,094947,Weibel; Nadir,9999,0,9999,0
1653567255463,CSE 293,044,094948,Gupta; Rajesh K.,9999,0,9999,0
1653567255987,CSE 294,A00,090143,Porter; George M,8,0,10,2
1653567256516,DSE 200,A00,091799,Staff,50,0,50,0
1653567257046,DSE 203,A00,091800,Gupta; Amarnath,30,0,30,0
1653567257580,DSE 250,A00,091801,Deutsch; Alin Bernard,30,0,30,0
1653567258108,DSE 290,A00,091802,Altintas De Callaf; Ilkay,50,0,50,0
1653567258704,ECE 200,001,091003,Antipa; Nicholas A,9999,0,9999,0
1653567258704,ECE 200,002,091004,Atanasov; Nikolay A.,9999,0,9999,0
1653567258704,ECE 200,003,091005,Bharadia; Dinesh,9999,0,9999,0
1653567258704,ECE 200,004,091006,Cheng; Chung Kuan,9999,0,9999,0
1653567258704,ECE 200,005,091007,Cosman; Pamela C.,9999,0,9999,0
1653567258704,ECE 200,006,091008,Staff,9999,0,9999,0
1653567258704,ECE 200,007,091009,Dayeh; Shadi Ahmad,9999,0,9999,0
1653567258704,ECE 200,008,091010,Fainman; Yeshaiahu,9999,0,9999,0
1653567258704,ECE 200,009,091011,Ford; Joseph Earl,9999,0,9999,0
1653567258704,ECE 200,010,091012,Franceschetti; Massimo,9999,0,9999,0
1653567258704,ECE 200,011,091013,Fullerton; Eric E,9999,0,9999,0
1653567258704,ECE 200,012,091014,Galton; Ian A,9999,0,9999,0
1653567258704,ECE 200,013,091015,Gilja; Vikash,9999,0,9999,0
1653567258704,ECE 200,014,091016,Hall; Drew A.,9999,0,9999,0
1653567258704,ECE 200,015,091017,Hsueh; Tzu-Chien,9999,0,9999,0
1653567258704,ECE 200,016,091018,Javidi; Tara,9999,0,9999,0
1653567258704,ECE 200,017,091019,Kahng; Andrew Byun,9999,0,9999,0
1653567258704,ECE 200,018,091020,Kim; Young-Han,9999,0,9999,0
1653567258704,ECE 200,019,091021,Koushanfar; Farinaz,9999,0,9999,0
1653567258704,ECE 200,020,091022,Kuzum; Duygu,9999,0,9999,0
1653567258704,ECE 200,021,091023,Le; Hanh-Phuc,9999,0,9999,0
1653567258704,ECE 200,022,091024,Lin; Bill,9999,0,9999,0
1653567258704,ECE 200,023,091025,Liu; Zhaowei,9999,0,9999,0
1653567258704,ECE 200,024,091026,Lo; Yu-Hwa,9999,0,9999,0
1653567258704,ECE 200,025,091027,Lomakin; Vitaliy,9999,0,9999,0
1653567258704,ECE 200,026,091028,Mercier; Patrick Philip,9999,0,9999,0
1653567258704,ECE 200,027,091029,Meyer; Florian,9999,0,9999,0
1653567258704,ECE 200,028,091030,Milstein; Laurence B.,9999,0,9999,0
1653567258704,ECE 200,029,091031,Mir Arabbaygi; Siavash,9999,0,9999,0
1653567258704,ECE 200,030,091032,Mookherjea; Shayan,9999,0,9999,0
1653567258704,ECE 200,031,091033,Morris; Karcher William,9999,0,9999,0
1653567258704,ECE 200,032,091034,Ng; Tse Nga,9999,0,9999,0
1653567258704,ECE 200,033,091035,Nguyen; Truong Quang,9999,0,9999,0
1653567258704,ECE 200,034,091036,Nomura; Kenji,9999,0,9999,0
1653567258704,ECE 200,035,091037,Orlitsky; Alon,9999,0,9999,0
1653567258704,ECE 200,036,091038,Pal; Piya,9999,0,9999,0
1653567258704,ECE 200,037,091039,Papen; George C.,9999,0,9999,0
1653567258704,ECE 200,038,091040,Radic; Stojan,9999,0,9999,0
1653567258704,ECE 200,039,091041,Rao; Bhaskar D.,9999,0,9999,0
1653567258704,ECE 200,040,091042,Rao; Ramesh R,9999,0,9999,0
1653567258704,ECE 200,041,091043,Rebeiz; Gabriel,9999,0,9999,0
1653567258704,ECE 200,042,091044,Sanford; John R,9999,0,9999,0
1653567258704,ECE 200,043,091045,Siegel; Paul H.,9999,0,9999,0
1653567258704,ECE 200,044,091046,Sievenpiper; Daniel F.,9999,0,9999,0
1653567258704,ECE 200,045,091047,Sworder; David D.,9999,0,9999,0
1653567258704,ECE 200,046,091048,Taur; Yuan,9999,0,9999,0
1653567258704,ECE 200,047,091049,Touri; Behrouz,9999,0,9999,0
1653567258704,ECE 200,048,091050,Trivedi; Mohan M.,9999,0,9999,0
1653567258704,ECE 200,049,091051,Vardy; Alexander,9999,0,9999,0
1653567258704,ECE 200,050,091052,Vasconcelos; Nuno,9999,0,9999,0
1653567258704,ECE 200,051,091053,Wang; Xiaolong,9999,0,9999,0
1653567258704,ECE 200,052,091054,Xie; Pengtao,9999,0,9999,0
1653567258704,ECE 200,053,091055,Yip; Michael,9999,0,9999,0
1653567258704,ECE 200,054,091056,Zeger; Kenneth A.,9999,0,9999,0
1653567258704,ECE 200,055,091057,Zhang; Xinyu,9999,0,9999,0
1653567258704,ECE 200,056,091058,Turakhia; Yatish Girish,9999,0,9999,0
1653567258704,ECE 200,057,091059,Kang; Mingu,9999,0,9999,0
1653567258704,ECE 200,058,091060,Shi; Yuanyuan,9999,0,9999,0
1653567258704,ECE 200,059,091061,Wang; Edward Jay,9999,0,9999,0
1653567258704,ECE 200,060,091062,Zheng; Yang,9999,0,9999,0
1653567259234,ECE 201,A00,095526,Lo; Yu-Hwa,0,0,0,0
1653567259764,ECE 203,A00,091065,Mercier; Patrick Philip,0,0,0,0
1653567260366,ECE 207A,A00,091605,Liu; Thomas Tao-Ming,0,0,0,0
1653567260893,ECE 212AN,A00,091068,Nomura; Kenji,0,0,0,0
1653567261417,ECE 222A,A00,091069,Rebeiz; Gabriel,0,0,0,0
1653567261945,ECE 225A,A00,091070,Orlitsky; Alon,0,0,0,0
1653567262471,ECE 230A,A00,091071,Nomura; Kenji,0,0,0,0
1653567262996,ECE 236A,A00,091072,Dayeh; Shadi Ahmad,0,0,0,0
1653567263519,ECE 238A,A00,091073,Luo; Jian,0,0,0,0
1653567263519,ECE 238A,B00,091074,Luo; Jian,0,0,0,0
1653567264047,ECE 240A,A00,091075,Radic; Stojan,0,0,0,0
1653567264573,ECE 247A,A00,091592,Shi; Lingyan,0,0,0,0
1653567265098,ECE 250,A00,091076,Touri; Behrouz,0,0,0,0
1653567265621,ECE 251C,A00,091078,Nguyen; Truong Quang,0,0,0,0
1653567266146,ECE 253,A00,091079,Cosman; Pamela C.,0,0,0,0
1653567266675,ECE 255A,A00,091080,Orlitsky; Alon,0,0,0,0
1653567267208,ECE 257A,A00,091081,Zhang; Xinyu,0,0,0,0
1653567267739,ECE 260A,A01,091084,Eldon; John,0,0,0,0
1653567268263,ECE 264C,A00,091085,Galton; Ian A,0,0,0,0
1653567268795,ECE 265C,A00,094889,Presti; Calogero Davide,0,0,0,9
1653567269324,ECE 266,A01,091087,Hall; Drew A.,0,0,0,0
1653567270376,ECE 271A,A00,091090,Vasconcelos; Nuno,0,0,0,0
1653567270903,ECE 272B,A00,091091,Sworder; David D.,0,0,0,0
1653567271439,ECE 275A,A00,091092,Meyer; Florian,0,0,0,0
1653567271963,ECE 277,A00,091093,An; Cheolhong,0,0,0,0
1653567272494,ECE 283,A00,091094,Le; Hanh-Phuc,0,0,0,0
1653567273033,ECE 284,A00,091095,Kang; Mingu,0,0,0,0
1653567273033,ECE 284,B00,091096,Wang; Edward Jay,0,0,0,0
1653567273557,ECE 285,A00,094334,Touri; Behrouz,0,0,0,0
1653567274095,ECE 289,A00,091097,Whelan; David Arthur,0,0,0,0
1653567274627,MATH 200A,A00,087414,Salehi Golsefidy; Alireza,7,0,8,1
1653567275152,MATH 202A,A00,087415,Gill; Philip E.,2,0,8,6
1653567275677,MATH 203A,A00,087416,Oprea; Dragos N.,6,0,8,2
1653567276204,MATH 204A,A00,087417,Kedlaya; Kiran S.,6,0,8,2
1653567276728,MATH 205,A00,087418,Sorensen; Claus M,6,0,8,2
1653567277255,MATH 206A,A00,087419,Izadi; Elham,7,0,8,1
1653567277778,MATH 207A,A00,087420,Mohammadi; Amir,5,0,8,3
1653567278306,MATH 208,A00,087421,Staff,9,0,10,1
1653567278829,MATH 209,A00,087422,Staff,10,0,10,0
1653567279352,MATH 218,A00,087423,Staff,10,0,10,0
1653567279876,MATH 220A,A00,087424,Novak; Jonathan I,6,0,8,2
1653567280406,MATH 231A,A00,087425,Bejenaru; Ioan,3,0,8,5
1653567280936,MATH 240A,A00,087426,Ebenfelt; Peter F,5,0,8,3
1653567281462,MATH 243,A00,087427,Staff,9,0,10,1
1653567281989,MATH 248,A00,087429,Staff,10,0,10,0
1653567282513,MATH 250A,A00,087430,Spolaor; Luca,4,0,8,4
1653567283039,MATH 257A,A00,087431,Spolaor; Luca,7,0,8,1
1653567283563,MATH 258,A00,087432,Staff,9,0,10,1
1653567284087,MATH 264A,A00,087433,Warnke; Lutz Peter,5,0,8,3
1653567284610,MATH 268,A00,087434,Staff,15,0,15,0
1653567285136,MATH 269,A00,087435,Staff,14,0,15,1
1653567285661,MATH 270A,A00,087436,Nie; Jiawang,0,0,8,8
1653567286185,MATH 272A,A00,087437,Tian; Xiaochuan,1,0,8,7
1653567286714,MATH 274,A01,087439,Cheng; Li-Tien,9,0,10,1
1653567286714,MATH 274,A02,087440,Cheng; Li-Tien,10,0,10,0
1653567287239,MATH 278A,A00,087441,Staff,8,0,10,2
1653567287764,MATH 278B,A00,087442,Staff,8,0,10,2
1653567288292,MATH 278C,A00,087443,Staff,8,0,10,2
1653567288816,MATH 280A,A00,087444,Zheng; Tianyi,0,0,8,8
1653567289343,MATH 281A,A00,087445,Bradic; Jelena,0,0,8,8
1653567289872,MATH 282A,A00,087446,Zhang; Danna,0,0,8,8
1653567290401,MATH 283,A00,087447,Tesler; Glenn,0,0,0,15
1653567290925,MATH 286,A00,087448,Kemp; Todd Aahron,5,0,8,3
1653567291452,MATH 287D,A00,087449,Bradic; Jelena,0,0,0,1
1653567291976,MATH 288,A00,087450,Staff,14,0,15,1
1653567291976,MATH 288,B00,087451,Staff,15,0,15,0
1653567291976,MATH 288,C00,087452,Staff,15,0,15,0
1653567292506,MATH 290A,A00,087453,Xu; Zhouli,6,0,8,2
1653567293032,MATH 291A,A00,087454,Xu; Zhouli,7,0,8,1
1653567293560,MATH 292,A00,087455,Staff,10,0,10,0
1653567294082,MATH 295,A00,087456,Staff,50,0,50,0
1653567294610,MATH 297,001,087457,Staff,998,0,999,1
1653567855087,COGS 200,A01,087991,Staff,47,0,50,3
1653567855610,COGS 201,A01,094504,Rangel; Lara M,17,0,25,8
1653567856134,COGS 203,A00,087992,Coulson; Seana M,18,0,20,2
1653567856661,COGS 210A,001,087993,Greene; Deanna Jacquelyn,9998,0,9999,1
1653567856661,COGS 210A,002,087994,Saygin; Ayse P,9999,0,9999,0
1653567856661,COGS 210A,003,087995,Xia; Haijun,9999,0,9999,0
1653567856661,COGS 210A,004,087996,Nitz; Douglas A.,9999,0,9999,0
1653567856661,COGS 210A,005,087997,Hollan; James D.,9999,0,9999,0
1653567856661,COGS 210A,006,087998,Deak; Gedeon O.,9998,0,9999,1
1653567856661,COGS 210A,007,087999,Rossano; Federico,9999,0,9999,0
1653567857187,COGS 211A,A00,088000,Coulson; Seana M,9997,0,9999,2
1653567857712,COGS 229,A00,088002,Staff,22,0,25,3
1653567858234,COGS 260,B00,094231,Staff,17,0,20,3
1653567858234,COGS 260,A00,088004,Nitz; Douglas A.,9998,0,9999,1
1653567858766,CSE 202,A00,090110,Paturi; Ramamohan,0,0,0,0
1653567858766,CSE 202,B00,090111,Paturi; Ramamohan,0,0,0,0
1653567859290,CSE 207B,A00,090112,Heninger; Nadia A,0,0,0,0
1653567859814,CSE 208,A00,094858,Micciancio; Daniele,0,0,0,0
1653567860342,CSE 210,A00,090113,Powell; Thomas Allan,0,0,0,0
1653567860869,CSE 219,A00,090898,Staff,0,0,0,0
1653567861392,CSE 221,A00,090114,Zhou; Yuan-Yuan,0,0,0,0
1653567861916,CSE 229A,A00,090115,Porter; George M,0,0,0,0
1653567862445,CSE 229C,A00,090116,Savage; Stefan,0,0,0,0
1653567862969,CSE 230,A00,090117,Jhala; Ranjit,0,0,0,0
1653567863493,CSE 232,A00,090118,Papakonstantinou; Yannis,0,0,0,0
1653567864022,CSE 239A,A00,090121,Kumar; Arun Kumar,0,0,0,0
1653567864545,CSE 239B,A00,090122,Jhala; Ranjit,0,0,0,0
1653567865073,CSE 240A,A00,090123,Zhao; Jishen,1,0,189,188
1653567865601,CSE 243A,A00,090124,Orailoglu; Alex,0,0,15,15
1653567866127,CSE 249B,A00,090125,Kahng; Andrew Byun,13,0,20,7
1653567866653,CSE 250A,A00,090126,Berg-Kirkpatrick; Taylor D,0,0,0,0
1653567867181,CSE 252A,A00,090127,Ochoa; Benjamin Lawrence,0,0,0,0
1653567867705,CSE 258,A01,090129,McAuley; Julian John,0,0,0,0
1653567868231,CSE 258R,A01,090131,McAuley; Julian John,0,0,0,0
1653567868756,CSE 274,A00,090132,Ramamoorthi; Ravi,0,0,0,0
1653567869280,CSE 276A,A00,090133,Christensen; Henrik I,0,0,0,0
1653567869808,CSE 276C,A00,090134,Christensen; Henrik I,0,0,0,0
1653567870334,CSE 290,A00,090135,Bafna; Vineet,0,0,0,0
1653567870334,CSE 290,B00,090136,Ramamoorthi; Ravi,0,0,0,0
1653567870334,CSE 290,C00,090137,Li; Tzumao,8,0,10,2
1653567870334,CSE 290,D00,090138,Zhou; Yuan-Yuan,9,0,10,1
1653567870334,CSE 290,E00,090139,Christensen; Henrik I,8,0,10,2
1653567870334,CSE 290,F00,094053,Shalev; Aaron D,0,0,0,0
1653567870863,CSE 291,A00,090140,Munyaka; Imani N. S.,0,0,0,0
1653567870863,CSE 291,B00,094880,Yu; Qi,0,0,0,0
1653567870863,CSE 291,C00,090142,Pannuto; Patrick William,0,0,0,0
1653567870863,CSE 291,D00,094881,Zhang; Yiying,0,0,0,0
1653567870863,CSE 291,E00,095118,Su; Hao,0,0,0,0
1653567871413,CSE 293,001,094905,Bafna; Vineet,9999,0,9999,0
1653567871413,CSE 293,002,094906,Bellare; Mihir,9999,0,9999,0
1653567871413,CSE 293,003,094907,Berg-Kirkpatrick; Taylor D,9999,0,9999,0
1653567871413,CSE 293,004,094908,Christensen; Henrik I,9999,0,9999,0
1653567871413,CSE 293,005,094909,Cottrell; Garrison W,9999,0,9999,0
1653567871413,CSE 293,006,094910,Deutsch; Alin Bernard,9999,0,9999,0
1653567871413,CSE 293,007,094911,Esmaeilzadeh; Hadi,9999,0,9999,0
1653567871413,CSE 293,008,094912,Freund; Yoav,9999,0,9999,0
1653567871413,CSE 293,009,094913,Griswold; William G.,9999,0,9999,0
1653567871413,CSE 293,010,094914,Gymrek; Melissa Ann,9999,0,9999,0
1653567871413,CSE 293,011,094915,Heninger; Nadia A,9999,0,9999,0
1653567871413,CSE 293,012,094916,Impagliazzo; Russell,9999,0,9999,0
1653567871413,CSE 293,013,094917,Jhala; Ranjit,9999,0,9999,0
1653567871413,CSE 293,014,094918,Kahng; Andrew Byun,9999,0,9999,0
1653567871413,CSE 293,015,094919,Kane; Daniel Mertz,9999,0,9999,0
1653567871413,CSE 293,016,094920,Kriegman; David J,9999,0,9999,0
1653567871413,CSE 293,017,094921,Kumar; Arun Kumar,9999,0,9999,0
1653567871413,CSE 293,018,094922,Lerner; Sorin,9999,0,9999,0
1653567871413,CSE 293,019,094923,Lovett; Shachar,9999,0,9999,0
1653567871413,CSE 293,020,094924,McAuley; Julian John,9999,0,9999,0
1653567871413,CSE 293,021,094925,Micciancio; Daniele,9999,0,9999,0
1653567871413,CSE 293,022,094926,Orailoglu; Alex,9999,0,9999,0
1653567871413,CSE 293,023,094927,Paturi; Ramamohan,9999,0,9999,0
1653567871413,CSE 293,024,094928,Polikarpova; Nadezhda,9999,0,9999,0
1653567871413,CSE 293,025,094929,Politz; Joseph Gibbs,9999,0,9999,0
1653567871413,CSE 293,026,094930,Porter; George M,9999,0,9999,0
1653567871413,CSE 293,027,094931,Porter; Leonard Emerson,9999,0,9999,0
1653567871413,CSE 293,028,094932,Ramamoorthi; Ravi,9999,0,9999,0
1653567871413,CSE 293,029,094933,Sahoo; Debashis,9999,0,9999,0
1653567871413,CSE 293,030,094934,Saul; Lawrence,9999,0,9999,0
1653567871413,CSE 293,031,094935,Savage; Stefan,9999,0,9999,0
1653567871413,CSE 293,032,094936,Schulze; Jurgen P.,9999,0,9999,0
1653567871413,CSE 293,033,094937,Snoeren; Alex C.,9999,0,9999,0
1653567871413,CSE 293,034,094938,Shang; Jingbo,9999,0,9999,0
1653567871413,CSE 293,035,094939,Stefan; Deian,9999,0,9999,0
1653567871413,CSE 293,036,094940,Su; Hao,9999,0,9999,0
1653567871413,CSE 293,037,094941,Swanson; Steven James,9999,0,9999,0
1653567871413,CSE 293,038,094942,Tullsen; Dean Michael,9999,0,9999,0
1653567871413,CSE 293,039,094943,Voelker; Geoffrey M.,9999,0,9999,0
1653567871413,CSE 293,040,094944,Zhao; Jishen,9999,0,9999,0
1653567871413,CSE 293,041,094945,Zhou; Yuan-Yuan,9999,0,9999,0
1653567871413,CSE 293,042,094946,Gao; Sicun,9998,0,9999,1
1653567871413,CSE 293,043,094947,Weibel; Nadir,9999,0,9999,0
1653567871413,CSE 293,044,094948,Gupta; Rajesh K.,9999,0,9999,0
1653567871938,CSE 294,A00,090143,Porter; George M,8,0,10,2
1653567872464,DSE 200,A00,091799,Staff,50,0,50,0
1653567872996,DSE 203,A00,091800,Gupta; Amarnath,30,0,30,0
1653567873520,DSE 250,A00,091801,Deutsch; Alin Bernard,30,0,30,0
1653567874044,DSE 290,A00,091802,Altintas De Callaf; Ilkay,50,0,50,0
1653567874632,ECE 200,001,091003,Antipa; Nicholas A,9999,0,9999,0
1653567874632,ECE 200,002,091004,Atanasov; Nikolay A.,9999,0,9999,0
1653567874632,ECE 200,003,091005,Bharadia; Dinesh,9999,0,9999,0
1653567874632,ECE 200,004,091006,Cheng; Chung Kuan,9999,0,9999,0
1653567874632,ECE 200,005,091007,Cosman; Pamela C.,9999,0,9999,0
1653567874632,ECE 200,006,091008,Staff,9999,0,9999,0
1653567874632,ECE 200,007,091009,Dayeh; Shadi Ahmad,9999,0,9999,0
1653567874632,ECE 200,008,091010,Fainman; Yeshaiahu,9999,0,9999,0
1653567874632,ECE 200,009,091011,Ford; Joseph Earl,9999,0,9999,0
1653567874632,ECE 200,010,091012,Franceschetti; Massimo,9999,0,9999,0
1653567874632,ECE 200,011,091013,Fullerton; Eric E,9999,0,9999,0
1653567874632,ECE 200,012,091014,Galton; Ian A,9999,0,9999,0
1653567874632,ECE 200,013,091015,Gilja; Vikash,9999,0,9999,0
1653567874632,ECE 200,014,091016,Hall; Drew A.,9999,0,9999,0
1653567874632,ECE 200,015,091017,Hsueh; Tzu-Chien,9999,0,9999,0
1653567874632,ECE 200,016,091018,Javidi; Tara,9999,0,9999,0
1653567874632,ECE 200,017,091019,Kahng; Andrew Byun,9999,0,9999,0
1653567874632,ECE 200,018,091020,Kim; Young-Han,9999,0,9999,0
1653567874632,ECE 200,019,091021,Koushanfar; Farinaz,9999,0,9999,0
1653567874632,ECE 200,020,091022,Kuzum; Duygu,9999,0,9999,0
1653567874632,ECE 200,021,091023,Le; Hanh-Phuc,9999,0,9999,0
1653567874632,ECE 200,022,091024,Lin; Bill,9999,0,9999,0
1653567874632,ECE 200,023,091025,Liu; Zhaowei,9999,0,9999,0
1653567874632,ECE 200,024,091026,Lo; Yu-Hwa,9999,0,9999,0
1653567874632,ECE 200,025,091027,Lomakin; Vitaliy,9999,0,9999,0
1653567874632,ECE 200,026,091028,Mercier; Patrick Philip,9999,0,9999,0
1653567874632,ECE 200,027,091029,Meyer; Florian,9999,0,9999,0
1653567874632,ECE 200,028,091030,Milstein; Laurence B.,9999,0,9999,0
1653567874632,ECE 200,029,091031,Mir Arabbaygi; Siavash,9999,0,9999,0
1653567874632,ECE 200,030,091032,Mookherjea; Shayan,9999,0,9999,0
1653567874632,ECE 200,031,091033,Morris; Karcher William,9999,0,9999,0
1653567874632,ECE 200,032,091034,Ng; Tse Nga,9999,0,9999,0
1653567874632,ECE 200,033,091035,Nguyen; Truong Quang,9999,0,9999,0
1653567874632,ECE 200,034,091036,Nomura; Kenji,9999,0,9999,0
1653567874632,ECE 200,035,091037,Orlitsky; Alon,9999,0,9999,0
1653567874632,ECE 200,036,091038,Pal; Piya,9999,0,9999,0
1653567874632,ECE 200,037,091039,Papen; George C.,9999,0,9999,0
1653567874632,ECE 200,038,091040,Radic; Stojan,9999,0,9999,0
1653567874632,ECE 200,039,091041,Rao; Bhaskar D.,9999,0,9999,0
1653567874632,ECE 200,040,091042,Rao; Ramesh R,9999,0,9999,0
1653567874632,ECE 200,041,091043,Rebeiz; Gabriel,9999,0,9999,0
1653567874632,ECE 200,042,091044,Sanford; John R,9999,0,9999,0
1653567874632,ECE 200,043,091045,Siegel; Paul H.,9999,0,9999,0
1653567874632,ECE 200,044,091046,Sievenpiper; Daniel F.,9999,0,9999,0
1653567874632,ECE 200,045,091047,Sworder; David D.,9999,0,9999,0
1653567874632,ECE 200,046,091048,Taur; Yuan,9999,0,9999,0
1653567874632,ECE 200,047,091049,Touri; Behrouz,9999,0,9999,0
1653567874632,ECE 200,048,091050,Trivedi; Mohan M.,9999,0,9999,0
1653567874632,ECE 200,049,091051,Vardy; Alexander,9999,0,9999,0
1653567874632,ECE 200,050,091052,Vasconcelos; Nuno,9999,0,9999,0
1653567874632,ECE 200,051,091053,Wang; Xiaolong,9999,0,9999,0
1653567874632,ECE 200,052,091054,Xie; Pengtao,9999,0,9999,0
1653567874632,ECE 200,053,091055,Yip; Michael,9999,0,9999,0
1653567874632,ECE 200,054,091056,Zeger; Kenneth A.,9999,0,9999,0
1653567874632,ECE 200,055,091057,Zhang; Xinyu,9999,0,9999,0
1653567874632,ECE 200,056,091058,Turakhia; Yatish Girish,9999,0,9999,0
1653567874632,ECE 200,057,091059,Kang; Mingu,9999,0,9999,0
1653567874632,ECE 200,058,091060,Shi; Yuanyuan,9999,0,9999,0
1653567874632,ECE 200,059,091061,Wang; Edward Jay,9999,0,9999,0
1653567874632,ECE 200,060,091062,Zheng; Yang,9999,0,9999,0
1653567875156,ECE 201,A00,095526,Lo; Yu-Hwa,0,0,0,0
1653567875680,ECE 203,A00,091065,Mercier; Patrick Philip,0,0,0,0
1653567876209,ECE 207A,A00,091605,Liu; Thomas Tao-Ming,0,0,0,0
1653567876736,ECE 212AN,A00,091068,Nomura; Kenji,0,0,0,0
1653567877260,ECE 222A,A00,091069,Rebeiz; Gabriel,0,0,0,0
1653567877784,ECE 225A,A00,091070,Orlitsky; Alon,0,0,0,0
1653567878315,ECE 230A,A00,091071,Nomura; Kenji,0,0,0,0
1653567878843,ECE 236A,A00,091072,Dayeh; Shadi Ahmad,0,0,0,0
1653567879367,ECE 238A,A00,091073,Luo; Jian,0,0,0,0
1653567879367,ECE 238A,B00,091074,Luo; Jian,0,0,0,0
1653567879892,ECE 240A,A00,091075,Radic; Stojan,0,0,0,0
1653567880428,ECE 247A,A00,091592,Shi; Lingyan,0,0,0,0
1653567880951,ECE 250,A00,091076,Touri; Behrouz,0,0,0,0
1653567881479,ECE 251C,A00,091078,Nguyen; Truong Quang,0,0,0,0
1653567882005,ECE 253,A00,091079,Cosman; Pamela C.,0,0,0,0
1653567882533,ECE 255A,A00,091080,Orlitsky; Alon,0,0,0,0
1653567883056,ECE 257A,A00,091081,Zhang; Xinyu,0,0,0,0
1653567883581,ECE 260A,A01,091084,Eldon; John,0,0,0,0
1653567884109,ECE 264C,A00,091085,Galton; Ian A,0,0,0,0
1653567884638,ECE 265C,A00,094889,Presti; Calogero Davide,0,0,0,9
1653567885163,ECE 266,A01,091087,Hall; Drew A.,0,0,0,0
1653567886214,ECE 271A,A00,091090,Vasconcelos; Nuno,0,0,0,0
1653567886741,ECE 272B,A00,091091,Sworder; David D.,0,0,0,0
1653567887264,ECE 275A,A00,091092,Meyer; Florian,0,0,0,0
1653567887792,ECE 277,A00,091093,An; Cheolhong,0,0,0,0
1653567888314,ECE 283,A00,091094,Le; Hanh-Phuc,0,0,0,0
1653567888840,ECE 284,A00,091095,Kang; Mingu,0,0,0,0
1653567888840,ECE 284,B00,091096,Wang; Edward Jay,0,0,0,0
1653567889363,ECE 285,A00,094334,Touri; Behrouz,0,0,0,0
1653567889887,ECE 289,A00,091097,Whelan; David Arthur,0,0,0,0
1653567890412,MATH 200A,A00,087414,Salehi Golsefidy; Alireza,7,0,8,1
1653567890940,MATH 202A,A00,087415,Gill; Philip E.,2,0,8,6
1653567891464,MATH 203A,A00,087416,Oprea; Dragos N.,6,0,8,2
1653567891990,MATH 204A,A00,087417,Kedlaya; Kiran S.,6,0,8,2
1653567892514,MATH 205,A00,087418,Sorensen; Claus M,6,0,8,2
1653567893042,MATH 206A,A00,087419,Izadi; Elham,7,0,8,1
1653567893565,MATH 207A,A00,087420,Mohammadi; Amir,5,0,8,3
1653567894088,MATH 208,A00,087421,Staff,9,0,10,1
1653567894611,MATH 209,A00,087422,Staff,10,0,10,0
1653567895137,MATH 218,A00,087423,Staff,10,0,10,0
1653567895661,MATH 220A,A00,087424,Novak; Jonathan I,6,0,8,2
1653567896191,MATH 231A,A00,087425,Bejenaru; Ioan,3,0,8,5
1653567896719,MATH 240A,A00,087426,Ebenfelt; Peter F,5,0,8,3
1653567897241,MATH 243,A00,087427,Staff,9,0,10,1
1653567897764,MATH 248,A00,087429,Staff,10,0,10,0
1653567898292,MATH 250A,A00,087430,Spolaor; Luca,4,0,8,4
1653567898815,MATH 257A,A00,087431,Spolaor; Luca,7,0,8,1
1653567899341,MATH 258,A00,087432,Staff,9,0,10,1
1653567899864,MATH 264A,A00,087433,Warnke; Lutz Peter,5,0,8,3
1653567900388,MATH 268,A00,087434,Staff,15,0,15,0
1653567900914,MATH 269,A00,087435,Staff,14,0,15,1
1653567901511,MATH 270A,A00,087436,Nie; Jiawang,0,0,8,8
1653567902036,MATH 272A,A00,087437,Tian; Xiaochuan,1,0,8,7
1653567902568,MATH 274,A01,087439,Cheng; Li-Tien,9,0,10,1
1653567902568,MATH 274,A02,087440,Cheng; Li-Tien,10,0,10,0
1653567903094,MATH 278A,A00,087441,Staff,8,0,10,2
1653567903618,MATH 278B,A00,087442,Staff,8,0,10,2
1653567904144,MATH 278C,A00,087443,Staff,8,0,10,2
1653567904667,MATH 280A,A00,087444,Zheng; Tianyi,0,0,8,8
1653567905191,MATH 281A,A00,087445,Bradic; Jelena,0,0,8,8
1653567905716,MATH 282A,A00,087446,Zhang; Danna,0,0,8,8
1653567906242,MATH 283,A00,087447,Tesler; Glenn,0,0,0,15
1653567906767,MATH 286,A00,087448,Kemp; Todd Aahron,5,0,8,3
1653567907294,MATH 287D,A00,087449,Bradic; Jelena,0,0,0,1
1653567907818,MATH 288,A00,087450,Staff,14,0,15,1
1653567907818,MATH 288,B00,087451,Staff,15,0,15,0
1653567907818,MATH 288,C00,087452,Staff,15,0,15,0
1653567908346,MATH 290A,A00,087453,Xu; Zhouli,6,0,8,2
1653567908870,MATH 291A,A00,087454,Xu; Zhouli,7,0,8,1
1653567909395,MATH 292,A00,087455,Staff,10,0,10,0
1653567909918,MATH 295,A00,087456,Staff,50,0,50,0
1653567910443,MATH 297,001,087457,Staff,998,0,999,1
1653568471060,COGS 200,A01,087991,Staff,47,0,50,3
1653568471588,COGS 201,A01,094504,Rangel; Lara M,17,0,25,8
1653568472115,COGS 203,A00,087992,Coulson; Seana M,18,0,20,2
1653568472641,COGS 210A,001,087993,Greene; Deanna Jacquelyn,9998,0,9999,1
1653568472641,COGS 210A,002,087994,Saygin; Ayse P,9999,0,9999,0
1653568472641,COGS 210A,003,087995,Xia; Haijun,9999,0,9999,0
1653568472641,COGS 210A,004,087996,Nitz; Douglas A.,9999,0,9999,0
1653568472641,COGS 210A,005,087997,Hollan; James D.,9999,0,9999,0
1653568472641,COGS 210A,006,087998,Deak; Gedeon O.,9998,0,9999,1
1653568472641,COGS 210A,007,087999,Rossano; Federico,9999,0,9999,0
1653568473163,COGS 211A,A00,088000,Coulson; Seana M,9997,0,9999,2
1653568473687,COGS 229,A00,088002,Staff,22,0,25,3
1653568474210,COGS 260,B00,094231,Staff,17,0,20,3
1653568474210,COGS 260,A00,088004,Nitz; Douglas A.,9998,0,9999,1
1653568474740,CSE 202,A00,090110,Paturi; Ramamohan,0,0,0,0
1653568474740,CSE 202,B00,090111,Paturi; Ramamohan,0,0,0,0
1653568475267,CSE 207B,A00,090112,Heninger; Nadia A,0,0,0,0
1653568475792,CSE 208,A00,094858,Micciancio; Daniele,0,0,0,0
1653568476318,CSE 210,A00,090113,Powell; Thomas Allan,0,0,0,0
1653568476844,CSE 219,A00,090898,Staff,0,0,0,0
1653568477375,CSE 221,A00,090114,Zhou; Yuan-Yuan,0,0,0,0
1653568477898,CSE 229A,A00,090115,Porter; George M,0,0,0,0
1653568478421,CSE 229C,A00,090116,Savage; Stefan,0,0,0,0
1653568478953,CSE 230,A00,090117,Jhala; Ranjit,0,0,0,0
1653568479476,CSE 232,A00,090118,Papakonstantinou; Yannis,0,0,0,0
1653568480001,CSE 239A,A00,090121,Kumar; Arun Kumar,0,0,0,0
1653568480525,CSE 239B,A00,090122,Jhala; Ranjit,0,0,0,0
1653568481049,CSE 240A,A00,090123,Zhao; Jishen,1,0,189,188
1653568481582,CSE 243A,A00,090124,Orailoglu; Alex,0,0,15,15
1653568482104,CSE 249B,A00,090125,Kahng; Andrew Byun,13,0,20,7
1653568482627,CSE 250A,A00,090126,Berg-Kirkpatrick; Taylor D,0,0,0,0
1653568483158,CSE 252A,A00,090127,Ochoa; Benjamin Lawrence,0,0,0,0
1653568483687,CSE 258,A01,090129,McAuley; Julian John,0,0,0,0
1653568484210,CSE 258R,A01,090131,McAuley; Julian John,0,0,0,0
1653568484735,CSE 274,A00,090132,Ramamoorthi; Ravi,0,0,0,0
1653568485261,CSE 276A,A00,090133,Christensen; Henrik I,0,0,0,0
1653568485783,CSE 276C,A00,090134,Christensen; Henrik I,0,0,0,0
1653568486309,CSE 290,A00,090135,Bafna; Vineet,0,0,0,0
1653568486309,CSE 290,B00,090136,Ramamoorthi; Ravi,0,0,0,0
1653568486309,CSE 290,C00,090137,Li; Tzumao,8,0,10,2
1653568486309,CSE 290,D00,090138,Zhou; Yuan-Yuan,9,0,10,1
1653568486309,CSE 290,E00,090139,Christensen; Henrik I,8,0,10,2
1653568486309,CSE 290,F00,094053,Shalev; Aaron D,0,0,0,0
1653568486837,CSE 291,A00,090140,Munyaka; Imani N. S.,0,0,0,0
1653568486837,CSE 291,B00,094880,Yu; Qi,0,0,0,0
1653568486837,CSE 291,C00,090142,Pannuto; Patrick William,0,0,0,0
1653568486837,CSE 291,D00,094881,Zhang; Yiying,0,0,0,0
1653568486837,CSE 291,E00,095118,Su; Hao,0,0,0,0
1653568487393,CSE 293,001,094905,Bafna; Vineet,9999,0,9999,0
1653568487393,CSE 293,002,094906,Bellare; Mihir,9999,0,9999,0
1653568487393,CSE 293,003,094907,Berg-Kirkpatrick; Taylor D,9999,0,9999,0
1653568487393,CSE 293,004,094908,Christensen; Henrik I,9999,0,9999,0
1653568487393,CSE 293,005,094909,Cottrell; Garrison W,9999,0,9999,0
1653568487393,CSE 293,006,094910,Deutsch; Alin Bernard,9999,0,9999,0
1653568487393,CSE 293,007,094911,Esmaeilzadeh; Hadi,9999,0,9999,0
1653568487393,CSE 293,008,094912,Freund; Yoav,9999,0,9999,0
1653568487393,CSE 293,009,094913,Griswold; William G.,9999,0,9999,0
1653568487393,CSE 293,010,094914,Gymrek; Melissa Ann,9999,0,9999,0
1653568487393,CSE 293,011,094915,Heninger; Nadia A,9999,0,9999,0
1653568487393,CSE 293,012,094916,Impagliazzo; Russell,9999,0,9999,0
1653568487393,CSE 293,013,094917,Jhala; Ranjit,9999,0,9999,0
1653568487393,CSE 293,014,094918,Kahng; Andrew Byun,9999,0,9999,0
1653568487393,CSE 293,015,094919,Kane; Daniel Mertz,9999,0,9999,0
1653568487393,CSE 293,016,094920,Kriegman; David J,9999,0,9999,0
1653568487393,CSE 293,017,094921,Kumar; Arun Kumar,9999,0,9999,0
1653568487393,CSE 293,018,094922,Lerner; Sorin,9999,0,9999,0
1653568487393,CSE 293,019,094923,Lovett; Shachar,9999,0,9999,0
1653568487393,CSE 293,020,094924,McAuley; Julian John,9999,0,9999,0
1653568487393,CSE 293,021,094925,Micciancio; Daniele,9999,0,9999,0
1653568487393,CSE 293,022,094926,Orailoglu; Alex,9999,0,9999,0
1653568487393,CSE 293,023,094927,Paturi; Ramamohan,9999,0,9999,0
1653568487393,CSE 293,024,094928,Polikarpova; Nadezhda,9999,0,9999,0
1653568487393,CSE 293,025,094929,Politz; Joseph Gibbs,9999,0,9999,0
1653568487393,CSE 293,026,094930,Porter; George M,9999,0,9999,0
1653568487393,CSE 293,027,094931,Porter; Leonard Emerson,9999,0,9999,0
1653568487393,CSE 293,028,094932,Ramamoorthi; Ravi,9999,0,9999,0
1653568487393,CSE 293,029,094933,Sahoo; Debashis,9999,0,9999,0
1653568487393,CSE 293,030,094934,Saul; Lawrence,9999,0,9999,0
1653568487393,CSE 293,031,094935,Savage; Stefan,9999,0,9999,0
1653568487393,CSE 293,032,094936,Schulze; Jurgen P.,9999,0,9999,0
1653568487393,CSE 293,033,094937,Snoeren; Alex C.,9999,0,9999,0
1653568487393,CSE 293,034,094938,Shang; Jingbo,9999,0,9999,0
1653568487393,CSE 293,035,094939,Stefan; Deian,9999,0,9999,0
1653568487393,CSE 293,036,094940,Su; Hao,9999,0,9999,0
1653568487393,CSE 293,037,094941,Swanson; Steven James,9999,0,9999,0
1653568487393,CSE 293,038,094942,Tullsen; Dean Michael,9999,0,9999,0
1653568487393,CSE 293,039,094943,Voelker; Geoffrey M.,9999,0,9999,0
1653568487393,CSE 293,040,094944,Zhao; Jishen,9999,0,9999,0
1653568487393,CSE 293,041,094945,Zhou; Yuan-Yuan,9999,0,9999,0
1653568487393,CSE 293,042,094946,Gao; Sicun,9998,0,9999,1
1653568487393,CSE 293,043,094947,Weibel; Nadir,9999,0,9999,0
1653568487393,CSE 293,044,094948,Gupta; Rajesh K.,9999,0,9999,0
1653568487927,CSE 294,A00,090143,Porter; George M,8,0,10,2
1653568488458,DSE 200,A00,091799,Staff,50,0,50,0
1653568488981,DSE 203,A00,091800,Gupta; Amarnath,30,0,30,0
1653568489595,DSE 250,A00,091801,Deutsch; Alin Bernard,30,0,30,0
1653568490131,DSE 290,A00,091802,Altintas De Callaf; Ilkay,50,0,50,0
1653568490721,ECE 200,001,091003,Antipa; Nicholas A,9999,0,9999,0
1653568490721,ECE 200,002,091004,Atanasov; Nikolay A.,9999,0,9999,0
1653568490721,ECE 200,003,091005,Bharadia; Dinesh,9999,0,9999,0
1653568490721,ECE 200,004,091006,Cheng; Chung Kuan,9999,0,9999,0
1653568490721,ECE 200,005,091007,Cosman; Pamela C.,9999,0,9999,0
1653568490721,ECE 200,006,091008,Staff,9999,0,9999,0
1653568490721,ECE 200,007,091009,Dayeh; Shadi Ahmad,9999,0,9999,0
1653568490721,ECE 200,008,091010,Fainman; Yeshaiahu,9999,0,9999,0
1653568490721,ECE 200,009,091011,Ford; Joseph Earl,9999,0,9999,0
1653568490721,ECE 200,010,091012,Franceschetti; Massimo,9999,0,9999,0
1653568490721,ECE 200,011,091013,Fullerton; Eric E,9999,0,9999,0
1653568490721,ECE 200,012,091014,Galton; Ian A,9999,0,9999,0
1653568490721,ECE 200,013,091015,Gilja; Vikash,9999,0,9999,0
1653568490721,ECE 200,014,091016,Hall; Drew A.,9999,0,9999,0
1653568490721,ECE 200,015,091017,Hsueh; Tzu-Chien,9999,0,9999,0
1653568490721,ECE 200,016,091018,Javidi; Tara,9999,0,9999,0
1653568490721,ECE 200,017,091019,Kahng; Andrew Byun,9999,0,9999,0
1653568490721,ECE 200,018,091020,Kim; Young-Han,9999,0,9999,0
1653568490721,ECE 200,019,091021,Koushanfar; Farinaz,9999,0,9999,0
1653568490721,ECE 200,020,091022,Kuzum; Duygu,9999,0,9999,0
1653568490721,ECE 200,021,091023,Le; Hanh-Phuc,9999,0,9999,0
1653568490721,ECE 200,022,091024,Lin; Bill,9999,0,9999,0
1653568490721,ECE 200,023,091025,Liu; Zhaowei,9999,0,9999,0
1653568490721,ECE 200,024,091026,Lo; Yu-Hwa,9999,0,9999,0
1653568490721,ECE 200,025,091027,Lomakin; Vitaliy,9999,0,9999,0
1653568490721,ECE 200,026,091028,Mercier; Patrick Philip,9999,0,9999,0
1653568490721,ECE 200,027,091029,Meyer; Florian,9999,0,9999,0
1653568490721,ECE 200,028,091030,Milstein; Laurence B.,9999,0,9999,0
1653568490721,ECE 200,029,091031,Mir Arabbaygi; Siavash,9999,0,9999,0
1653568490721,ECE 200,030,091032,Mookherjea; Shayan,9999,0,9999,0
1653568490721,ECE 200,031,091033,Morris; Karcher William,9999,0,9999,0
1653568490721,ECE 200,032,091034,Ng; Tse Nga,9999,0,9999,0
1653568490721,ECE 200,033,091035,Nguyen; Truong Quang,9999,0,9999,0
1653568490721,ECE 200,034,091036,Nomura; Kenji,9999,0,9999,0
1653568490721,ECE 200,035,091037,Orlitsky; Alon,9999,0,9999,0
1653568490721,ECE 200,036,091038,Pal; Piya,9999,0,9999,0
1653568490721,ECE 200,037,091039,Papen; George C.,9999,0,9999,0
1653568490721,ECE 200,038,091040,Radic; Stojan,9999,0,9999,0
1653568490721,ECE 200,039,091041,Rao; Bhaskar D.,9999,0,9999,0
1653568490721,ECE 200,040,091042,Rao; Ramesh R,9999,0,9999,0
1653568490721,ECE 200,041,091043,Rebeiz; Gabriel,9999,0,9999,0
1653568490721,ECE 200,042,091044,Sanford; John R,9999,0,9999,0
1653568490721,ECE 200,043,091045,Siegel; Paul H.,9999,0,9999,0
1653568490721,ECE 200,044,091046,Sievenpiper; Daniel F.,9999,0,9999,0
1653568490721,ECE 200,045,091047,Sworder; David D.,9999,0,9999,0
1653568490721,ECE 200,046,091048,Taur; Yuan,9999,0,9999,0
1653568490721,ECE 200,047,091049,Touri; Behrouz,9999,0,9999,0
1653568490721,ECE 200,048,091050,Trivedi; Mohan M.,9999,0,9999,0
1653568490721,ECE 200,049,091051,Vardy; Alexander,9999,0,9999,0
1653568490721,ECE 200,050,091052,Vasconcelos; Nuno,9999,0,9999,0
1653568490721,ECE 200,051,091053,Wang; Xiaolong,9999,0,9999,0
1653568490721,ECE 200,052,091054,Xie; Pengtao,9999,0,9999,0
1653568490721,ECE 200,053,091055,Yip; Michael,9999,0,9999,0
1653568490721,ECE 200,054,091056,Zeger; Kenneth A.,9999,0,9999,0
1653568490721,ECE 200,055,091057,Zhang; Xinyu,9999,0,9999,0
1653568490721,ECE 200,056,091058,Turakhia; Yatish Girish,9999,0,9999,0
1653568490721,ECE 200,057,091059,Kang; Mingu,9999,0,9999,0
1653568490721,ECE 200,058,091060,Shi; Yuanyuan,9999,0,9999,0
1653568490721,ECE 200,059,091061,Wang; Edward Jay,9999,0,9999,0
1653568490721,ECE 200,060,091062,Zheng; Yang,9999,0,9999,0
1653568491244,ECE 201,A00,095526,Lo; Yu-Hwa,0,0,0,0
1653568491772,ECE 203,A00,091065,Mercier; Patrick Philip,0,0,0,0
1653568492297,ECE 207A,A00,091605,Liu; Thomas Tao-Ming,0,0,0,0
1653568492825,ECE 212AN,A00,091068,Nomura; Kenji,0,0,0,0
1653568493349,ECE 222A,A00,091069,Rebeiz; Gabriel,0,0,0,0
1653568493872,ECE 225A,A00,091070,Orlitsky; Alon,0,0,0,0
1653568494396,ECE 230A,A00,091071,Nomura; Kenji,0,0,0,0
1653568494921,ECE 236A,A00,091072,Dayeh; Shadi Ahmad,0,0,0,0
1653568495451,ECE 238A,A00,091073,Luo; Jian,0,0,0,0
1653568495451,ECE 238A,B00,091074,Luo; Jian,0,0,0,0
1653568495978,ECE 240A,A00,091075,Radic; Stojan,0,0,0,0
1653568496507,ECE 247A,A00,091592,Shi; Lingyan,0,0,0,0
1653568497031,ECE 250,A00,091076,Touri; Behrouz,0,0,0,0
1653568497559,ECE 251C,A00,091078,Nguyen; Truong Quang,0,0,0,0
1653568498086,ECE 253,A00,091079,Cosman; Pamela C.,0,0,0,0
1653568498614,ECE 255A,A00,091080,Orlitsky; Alon,0,0,0,0
1653568499143,ECE 257A,A00,091081,Zhang; Xinyu,0,0,0,0
1653568499667,ECE 260A,A01,091084,Eldon; John,0,0,0,0
1653568500190,ECE 264C,A00,091085,Galton; Ian A,0,0,0,0
1653568500716,ECE 265C,A00,094889,Presti; Calogero Davide,0,0,0,9
1653568501245,ECE 266,A01,091087,Hall; Drew A.,0,0,0,0
1653568502299,ECE 271A,A00,091090,Vasconcelos; Nuno,0,0,0,0
1653568502823,ECE 272B,A00,091091,Sworder; David D.,0,0,0,0
1653568503347,ECE 275A,A00,091092,Meyer; Florian,0,0,0,0
1653568503877,ECE 277,A00,091093,An; Cheolhong,0,0,0,0
1653568504404,ECE 283,A00,091094,Le; Hanh-Phuc,0,0,0,0
1653568504936,ECE 284,A00,091095,Kang; Mingu,0,0,0,0
1653568504936,ECE 284,B00,091096,Wang; Edward Jay,0,0,0,0
1653568505459,ECE 285,A00,094334,Touri; Behrouz,0,0,0,0
1653568505989,ECE 289,A00,091097,Whelan; David Arthur,0,0,0,0
1653568506514,MATH 200A,A00,087414,Salehi Golsefidy; Alireza,7,0,8,1
1653568507039,MATH 202A,A00,087415,Gill; Philip E.,2,0,8,6
1653568507563,MATH 203A,A00,087416,Oprea; Dragos N.,6,0,8,2
1653568508088,MATH 204A,A00,087417,Kedlaya; Kiran S.,6,0,8,2
1653568508612,MATH 205,A00,087418,Sorensen; Claus M,6,0,8,2
1653568509187,MATH 206A,A00,087419,Izadi; Elham,7,0,8,1
1653568509712,MATH 207A,A00,087420,Mohammadi; Amir,5,0,8,3
1653568510238,MATH 208,A00,087421,Staff,9,0,10,1
1653568510763,MATH 209,A00,087422,Staff,10,0,10,0
1653568511288,MATH 218,A00,087423,Staff,10,0,10,0
1653568511813,MATH 220A,A00,087424,Novak; Jonathan I,6,0,8,2
1653568512340,MATH 231A,A00,087425,Bejenaru; Ioan,3,0,8,5
1653568512868,MATH 240A,A00,087426,Ebenfelt; Peter F,5,0,8,3
1653568513393,MATH 243,A00,087427,Staff,9,0,10,1
1653568513918,MATH 248,A00,087429,Staff,10,0,10,0
1653568514442,MATH 250A,A00,087430,Spolaor; Luca,4,0,8,4
1653568514965,MATH 257A,A00,087431,Spolaor; Luca,7,0,8,1
1653568515491,MATH 258,A00,087432,Staff,9,0,10,1
1653568516015,MATH 264A,A00,087433,Warnke; Lutz Peter,5,0,8,3
1653568516539,MATH 268,A00,087434,Staff,15,0,15,0
1653568517064,MATH 269,A00,087435,Staff,14,0,15,1
1653568517588,MATH 270A,A00,087436,Nie; Jiawang,0,0,8,8
1653568518111,MATH 272A,A00,087437,Tian; Xiaochuan,1,0,8,7
1653568518641,MATH 274,A01,087439,Cheng; Li-Tien,9,0,10,1
1653568518641,MATH 274,A02,087440,Cheng; Li-Tien,10,0,10,0
1653568519163,MATH 278A,A00,087441,Staff,8,0,10,2
1653568519687,MATH 278B,A00,087442,Staff,8,0,10,2
1653568520214,MATH 278C,A00,087443,Staff,8,0,10,2
1653568520740,MATH 280A,A00,087444,Zheng; Tianyi,0,0,8,8
1653568521267,MATH 281A,A00,087445,Bradic; Jelena,0,0,8,8
1653568521795,MATH 282A,A00,087446,Zhang; Danna,0,0,8,8
1653568522322,MATH 283,A00,087447,Tesler; Glenn,0,0,0,15
1653568522849,MATH 286,A00,087448,Kemp; Todd Aahron,5,0,8,3
1653568523377,MATH 287D,A00,087449,Bradic; Jelena,0,0,0,1
1653568523904,MATH 288,A00,087450,Staff,14,0,15,1
1653568523904,MATH 288,B00,087451,Staff,15,0,15,0
1653568523904,MATH 288,C00,087452,Staff,15,0,15,0
1653568524428,MATH 290A,A00,087453,Xu; Zhouli,6,0,8,2
1653568524954,MATH 291A,A00,087454,Xu; Zhouli,7,0,8,1
1653568525478,MATH 292,A00,087455,Staff,10,0,10,0
1653568526003,MATH 295,A00,087456,Staff,50,0,50,0
1653568526531,MATH 297,001,087457,Staff,998,0,999,1
1653569088809,COGS 200,A01,087991,Staff,47,0,50,3
1653569089339,COGS 201,A01,094504,Rangel; Lara M,17,0,25,8
1653569089869,COGS 203,A00,087992,Coulson; Seana M,18,0,20,2
1653569090405,COGS 210A,001,087993,Greene; Deanna Jacquelyn,9998,0,9999,1
1653569090405,COGS 210A,002,087994,Saygin; Ayse P,9999,0,9999,0
1653569090405,COGS 210A,003,087995,Xia; Haijun,9999,0,9999,0
1653569090405,COGS 210A,004,087996,Nitz; Douglas A.,9999,0,9999,0
1653569090405,COGS 210A,005,087997,Hollan; James D.,9999,0,9999,0
1653569090405,COGS 210A,006,087998,Deak; Gedeon O.,9998,0,9999,1
1653569090405,COGS 210A,007,087999,Rossano; Federico,9999,0,9999,0
1653569090932,COGS 211A,A00,088000,Coulson; Seana M,9997,0,9999,2
1653569091455,COGS 229,A00,088002,Staff,22,0,25,3
1653569091980,COGS 260,B00,094231,Staff,17,0,20,3
1653569091980,COGS 260,A00,088004,Nitz; Douglas A.,9998,0,9999,1
1653569092507,CSE 202,A00,090110,Paturi; Ramamohan,0,0,0,0
1653569092507,CSE 202,B00,090111,Paturi; Ramamohan,0,0,0,0
1653569093039,CSE 207B,A00,090112,Heninger; Nadia A,0,0,0,0
1653569093565,CSE 208,A00,094858,Micciancio; Daniele,0,0,0,0
1653569094092,CSE 210,A00,090113,Powell; Thomas Allan,0,0,0,0
1653569094616,CSE 219,A00,090898,Staff,0,0,0,0
1653569095143,CSE 221,A00,090114,Zhou; Yuan-Yuan,0,0,0,0
1653569095667,CSE 229A,A00,090115,Porter; George M,0,0,0,0
1653569096203,CSE 229C,A00,090116,Savage; Stefan,0,0,0,0
1653569096729,CSE 230,A00,090117,Jhala; Ranjit,0,0,0,0
1653569097265,CSE 232,A00,090118,Papakonstantinou; Yannis,0,0,0,0
1653569097789,CSE 239A,A00,090121,Kumar; Arun Kumar,0,0,0,0
1653569098312,CSE 239B,A00,090122,Jhala; Ranjit,0,0,0,0
1653569098843,CSE 240A,A00,090123,Zhao; Jishen,1,0,189,188
1653569099372,CSE 243A,A00,090124,Orailoglu; Alex,0,0,15,15
1653569099903,CSE 249B,A00,090125,Kahng; Andrew Byun,13,0,20,7
1653569100435,CSE 250A,A00,090126,Berg-Kirkpatrick; Taylor D,0,0,0,0
1653569100960,CSE 252A,A00,090127,Ochoa; Benjamin Lawrence,0,0,0,0
1653569101487,CSE 258,A01,090129,McAuley; Julian John,0,0,0,0
1653569102015,CSE 258R,A01,090131,McAuley; Julian John,0,0,0,0
1653569102543,CSE 274,A00,090132,Ramamoorthi; Ravi,0,0,0,0
1653569103070,CSE 276A,A00,090133,Christensen; Henrik I,0,0,0,0
1653569103607,CSE 276C,A00,090134,Christensen; Henrik I,0,0,0,0
1653569104134,CSE 290,A00,090135,Bafna; Vineet,0,0,0,0
1653569104134,CSE 290,B00,090136,Ramamoorthi; Ravi,0,0,0,0
1653569104134,CSE 290,C00,090137,Li; Tzumao,8,0,10,2
1653569104134,CSE 290,D00,090138,Zhou; Yuan-Yuan,9,0,10,1
1653569104134,CSE 290,E00,090139,Christensen; Henrik I,8,0,10,2
1653569104134,CSE 290,F00,094053,Shalev; Aaron D,0,0,0,0
1653569104676,CSE 291,A00,090140,Munyaka; Imani N. S.,0,0,0,0
1653569104676,CSE 291,B00,094880,Yu; Qi,0,0,0,0
1653569104676,CSE 291,C00,090142,Pannuto; Patrick William,0,0,0,0
1653569104676,CSE 291,D00,094881,Zhang; Yiying,0,0,0,0
1653569104676,CSE 291,E00,095118,Su; Hao,0,0,0,0
1653569105220,CSE 293,001,094905,Bafna; Vineet,9999,0,9999,0
1653569105220,CSE 293,002,094906,Bellare; Mihir,9999,0,9999,0
1653569105220,CSE 293,003,094907,Berg-Kirkpatrick; Taylor D,9999,0,9999,0
1653569105220,CSE 293,004,094908,Christensen; Henrik I,9999,0,9999,0
1653569105220,CSE 293,005,094909,Cottrell; Garrison W,9999,0,9999,0
1653569105220,CSE 293,006,094910,Deutsch; Alin Bernard,9999,0,9999,0
1653569105220,CSE 293,007,094911,Esmaeilzadeh; Hadi,9999,0,9999,0
1653569105220,CSE 293,008,094912,Freund; Yoav,9999,0,9999,0
1653569105220,CSE 293,009,094913,Griswold; William G.,9999,0,9999,0
1653569105220,CSE 293,010,094914,Gymrek; Melissa Ann,9999,0,9999,0
1653569105220,CSE 293,011,094915,Heninger; Nadia A,9999,0,9999,0
1653569105220,CSE 293,012,094916,Impagliazzo; Russell,9999,0,9999,0
1653569105220,CSE 293,013,094917,Jhala; Ranjit,9999,0,9999,0
1653569105220,CSE 293,014,094918,Kahng; Andrew Byun,9999,0,9999,0
1653569105220,CSE 293,015,094919,Kane; Daniel Mertz,9999,0,9999,0
1653569105220,CSE 293,016,094920,Kriegman; David J,9999,0,9999,0
1653569105220,CSE 293,017,094921,Kumar; Arun Kumar,9999,0,9999,0
1653569105220,CSE 293,018,094922,Lerner; Sorin,9999,0,9999,0
1653569105220,CSE 293,019,094923,Lovett; Shachar,9999,0,9999,0
1653569105220,CSE 293,020,094924,McAuley; Julian John,9999,0,9999,0
1653569105220,CSE 293,021,094925,Micciancio; Daniele,9999,0,9999,0
1653569105220,CSE 293,022,094926,Orailoglu; Alex,9999,0,9999,0
1653569105220,CSE 293,023,094927,Paturi; Ramamohan,9999,0,9999,0
1653569105220,CSE 293,024,094928,Polikarpova; Nadezhda,9999,0,9999,0
1653569105220,CSE 293,025,094929,Politz; Joseph Gibbs,9999,0,9999,0
1653569105220,CSE 293,026,094930,Porter; George M,9999,0,9999,0
1653569105220,CSE 293,027,094931,Porter; Leonard Emerson,9999,0,9999,0
1653569105220,CSE 293,028,094932,Ramamoorthi; Ravi,9999,0,9999,0
1653569105220,CSE 293,029,094933,Sahoo; Debashis,9999,0,9999,0
1653569105220,CSE 293,030,094934,Saul; Lawrence,9999,0,9999,0
1653569105220,CSE 293,031,094935,Savage; Stefan,9999,0,9999,0
1653569105220,CSE 293,032,094936,Schulze; Jurgen P.,9999,0,9999,0
1653569105220,CSE 293,033,094937,Snoeren; Alex C.,9999,0,9999,0
1653569105220,CSE 293,034,094938,Shang; Jingbo,9999,0,9999,0
1653569105220,CSE 293,035,094939,Stefan; Deian,9999,0,9999,0
1653569105220,CSE 293,036,094940,Su; Hao,9999,0,9999,0
1653569105220,CSE 293,037,094941,Swanson; Steven James,9999,0,9999,0
1653569105220,CSE 293,038,094942,Tullsen; Dean Michael,9999,0,9999,0
1653569105220,CSE 293,039,094943,Voelker; Geoffrey M.,9999,0,9999,0
1653569105220,CSE 293,040,094944,Zhao; Jishen,9999,0,9999,0
1653569105220,CSE 293,041,094945,Zhou; Yuan-Yuan,9999,0,9999,0
1653569105220,CSE 293,042,094946,Gao; Sicun,9998,0,9999,1
1653569105220,CSE 293,043,094947,Weibel; Nadir,9999,0,9999,0
1653569105220,CSE 293,044,094948,Gupta; Rajesh K.,9999,0,9999,0
1653569105749,CSE 294,A00,090143,Porter; George M,8,0,10,2
1653569106281,DSE 200,A00,091799,Staff,50,0,50,0
1653569106806,DSE 203,A00,091800,Gupta; Amarnath,30,0,30,0
1653569107329,DSE 250,A00,091801,Deutsch; Alin Bernard,30,0,30,0
1653569107853,DSE 290,A00,091802,Altintas De Callaf; Ilkay,50,0,50,0
1653569108477,ECE 200,001,091003,Antipa; Nicholas A,9999,0,9999,0
1653569108477,ECE 200,002,091004,Atanasov; Nikolay A.,9999,0,9999,0
1653569108477,ECE 200,003,091005,Bharadia; Dinesh,9999,0,9999,0
1653569108477,ECE 200,004,091006,Cheng; Chung Kuan,9999,0,9999,0
1653569108477,ECE 200,005,091007,Cosman; Pamela C.,9999,0,9999,0
1653569108477,ECE 200,006,091008,Staff,9999,0,9999,0
1653569108477,ECE 200,007,091009,Dayeh; Shadi Ahmad,9999,0,9999,0
1653569108477,ECE 200,008,091010,Fainman; Yeshaiahu,9999,0,9999,0
1653569108477,ECE 200,009,091011,Ford; Joseph Earl,9999,0,9999,0
1653569108477,ECE 200,010,091012,Franceschetti; Massimo,9999,0,9999,0
1653569108477,ECE 200,011,091013,Fullerton; Eric E,9999,0,9999,0
1653569108477,ECE 200,012,091014,Galton; Ian A,9999,0,9999,0
1653569108477,ECE 200,013,091015,Gilja; Vikash,9999,0,9999,0
1653569108477,ECE 200,014,091016,Hall; Drew A.,9999,0,9999,0
1653569108477,ECE 200,015,091017,Hsueh; Tzu-Chien,9999,0,9999,0
1653569108477,ECE 200,016,091018,Javidi; Tara,9999,0,9999,0
1653569108477,ECE 200,017,091019,Kahng; Andrew Byun,9999,0,9999,0
1653569108477,ECE 200,018,091020,Kim; Young-Han,9999,0,9999,0
1653569108477,ECE 200,019,091021,Koushanfar; Farinaz,9999,0,9999,0
1653569108477,ECE 200,020,091022,Kuzum; Duygu,9999,0,9999,0
1653569108477,ECE 200,021,091023,Le; Hanh-Phuc,9999,0,9999,0
1653569108477,ECE 200,022,091024,Lin; Bill,9999,0,9999,0
1653569108477,ECE 200,023,091025,Liu; Zhaowei,9999,0,9999,0
1653569108477,ECE 200,024,091026,Lo; Yu-Hwa,9999,0,9999,0
1653569108477,ECE 200,025,091027,Lomakin; Vitaliy,9999,0,9999,0
1653569108477,ECE 200,026,091028,Mercier; Patrick Philip,9999,0,9999,0
1653569108477,ECE 200,027,091029,Meyer; Florian,9999,0,9999,0
1653569108477,ECE 200,028,091030,Milstein; Laurence B.,9999,0,9999,0
1653569108477,ECE 200,029,091031,Mir Arabbaygi; Siavash,9999,0,9999,0
1653569108477,ECE 200,030,091032,Mookherjea; Shayan,9999,0,9999,0
1653569108477,ECE 200,031,091033,Morris; Karcher William,9999,0,9999,0
1653569108477,ECE 200,032,091034,Ng; Tse Nga,9999,0,9999,0
1653569108477,ECE 200,033,091035,Nguyen; Truong Quang,9999,0,9999,0
1653569108477,ECE 200,034,091036,Nomura; Kenji,9999,0,9999,0
1653569108477,ECE 200,035,091037,Orlitsky; Alon,9999,0,9999,0
1653569108477,ECE 200,036,091038,Pal; Piya,9999,0,9999,0
1653569108477,ECE 200,037,091039,Papen; George C.,9999,0,9999,0
1653569108477,ECE 200,038,091040,Radic; Stojan,9999,0,9999,0
1653569108477,ECE 200,039,091041,Rao; Bhaskar D.,9999,0,9999,0
1653569108477,ECE 200,040,091042,Rao; Ramesh R,9999,0,9999,0
1653569108477,ECE 200,041,091043,Rebeiz; Gabriel,9999,0,9999,0
1653569108477,ECE 200,042,091044,Sanford; John R,9999,0,9999,0
1653569108477,ECE 200,043,091045,Siegel; Paul H.,9999,0,9999,0
1653569108477,ECE 200,044,091046,Sievenpiper; Daniel F.,9999,0,9999,0
1653569108477,ECE 200,045,091047,Sworder; David D.,9999,0,9999,0
1653569108477,ECE 200,046,091048,Taur; Yuan,9999,0,9999,0
1653569108477,ECE 200,047,091049,Touri; Behrouz,9999,0,9999,0
1653569108477,ECE 200,048,091050,Trivedi; Mohan M.,9999,0,9999,0
1653569108477,ECE 200,049,091051,Vardy; Alexander,9999,0,9999,0
1653569108477,ECE 200,050,091052,Vasconcelos; Nuno,9999,0,9999,0
1653569108477,ECE 200,051,091053,Wang; Xiaolong,9999,0,9999,0
1653569108477,ECE 200,052,091054,Xie; Pengtao,9999,0,9999,0
1653569108477,ECE 200,053,091055,Yip; Michael,9999,0,9999,0
1653569108477,ECE 200,054,091056,Zeger; Kenneth A.,9999,0,9999,0
1653569108477,ECE 200,055,091057,Zhang; Xinyu,9999,0,9999,0
1653569108477,ECE 200,056,091058,Turakhia; Yatish Girish,9999,0,9999,0
1653569108477,ECE 200,057,091059,Kang; Mingu,9999,0,9999,0
1653569108477,ECE 200,058,091060,Shi; Yuanyuan,9999,0,9999,0
1653569108477,ECE 200,059,091061,Wang; Edward Jay,9999,0,9999,0
1653569108477,ECE 200,060,091062,Zheng; Yang,9999,0,9999,0
1653569109002,ECE 201,A00,095526,Lo; Yu-Hwa,0,0,0,0
1653569109538,ECE 203,A00,091065,Mercier; Patrick Philip,0,0,0,0
1653569110070,ECE 207A,A00,091605,Liu; Thomas Tao-Ming,0,0,0,0
1653569110597,ECE 212AN,A00,091068,Nomura; Kenji,0,0,0,0
1653569111124,ECE 222A,A00,091069,Rebeiz; Gabriel,0,0,0,0
1653569111660,ECE 225A,A00,091070,Orlitsky; Alon,0,0,0,0
1653569112185,ECE 230A,A00,091071,Nomura; Kenji,0,0,0,0
1653569112716,ECE 236A,A00,091072,Dayeh; Shadi Ahmad,0,0,0,0
1653569113245,ECE 238A,A00,091073,Luo; Jian,0,0,0,0
1653569113245,ECE 238A,B00,091074,Luo; Jian,0,0,0,0
1653569113773,ECE 240A,A00,091075,Radic; Stojan,0,0,0,0
1653569114314,ECE 247A,A00,091592,Shi; Lingyan,0,0,0,0
1653569114838,ECE 250,A00,091076,Touri; Behrouz,0,0,0,0
1653569115370,ECE 251C,A00,091078,Nguyen; Truong Quang,0,0,0,0
1653569115894,ECE 253,A00,091079,Cosman; Pamela C.,0,0,0,0
1653569116418,ECE 255A,A00,091080,Orlitsky; Alon,0,0,0,0
1653569116943,ECE 257A,A00,091081,Zhang; Xinyu,0,0,0,0
1653569117467,ECE 260A,A01,091084,Eldon; John,0,0,0,0
1653569117992,ECE 264C,A00,091085,Galton; Ian A,0,0,0,0
1653569118516,ECE 265C,A00,094889,Presti; Calogero Davide,0,0,0,9
1653569119041,ECE 266,A01,091087,Hall; Drew A.,0,0,0,0
1653569120092,ECE 271A,A00,091090,Vasconcelos; Nuno,0,0,0,0
1653569120626,ECE 272B,A00,091091,Sworder; David D.,0,0,0,0
1653569121155,ECE 275A,A00,091092,Meyer; Florian,0,0,0,0
1653569121680,ECE 277,A00,091093,An; Cheolhong,0,0,0,0
1653569122205,ECE 283,A00,091094,Le; Hanh-Phuc,0,0,0,0
1653569122732,ECE 284,A00,091095,Kang; Mingu,0,0,0,0
1653569122732,ECE 284,B00,091096,Wang; Edward Jay,0,0,0,0
1653569123255,ECE 285,A00,094334,Touri; Behrouz,0,0,0,0
1653569123784,ECE 289,A00,091097,Whelan; David Arthur,0,0,0,0
1653569124309,MATH 200A,A00,087414,Salehi Golsefidy; Alireza,7,0,8,1
1653569124835,MATH 202A,A00,087415,Gill; Philip E.,2,0,8,6
1653569125362,MATH 203A,A00,087416,Oprea; Dragos N.,6,0,8,2
1653569125885,MATH 204A,A00,087417,Kedlaya; Kiran S.,6,0,8,2
1653569126412,MATH 205,A00,087418,Sorensen; Claus M,6,0,8,2
1653569126943,MATH 206A,A00,087419,Izadi; Elham,7,0,8,1
1653569127475,MATH 207A,A00,087420,Mohammadi; Amir,5,0,8,3
1653569127999,MATH 208,A00,087421,Staff,9,0,10,1
1653569128523,MATH 209,A00,087422,Staff,10,0,10,0
1653569129060,MATH 218,A00,087423,Staff,10,0,10,0
1653569129590,MATH 220A,A00,087424,Novak; Jonathan I,6,0,8,2
1653569130114,MATH 231A,A00,087425,Bejenaru; Ioan,3,0,8,5
1653569130639,MATH 240A,A00,087426,Ebenfelt; Peter F,5,0,8,3
1653569131164,MATH 243,A00,087427,Staff,9,0,10,1
1653569131690,MATH 248,A00,087429,Staff,10,0,10,0
1653569132220,MATH 250A,A00,087430,Spolaor; Luca,4,0,8,4
1653569132821,MATH 257A,A00,087431,Spolaor; Luca,7,0,8,1
1653569133345,MATH 258,A00,087432,Staff,9,0,10,1
1653569133881,MATH 264A,A00,087433,Warnke; Lutz Peter,5,0,8,3
1653569134406,MATH 268,A00,087434,Staff,15,0,15,0
1653569134929,MATH 269,A00,087435,Staff,14,0,15,1
1653569135454,MATH 270A,A00,087436,Nie; Jiawang,0,0,8,8
1653569135983,MATH 272A,A00,087437,Tian; Xiaochuan,1,0,8,7
1653569136508,MATH 274,A01,087439,Cheng; Li-Tien,9,0,10,1
1653569136508,MATH 274,A02,087440,Cheng; Li-Tien,10,0,10,0
1653569137031,MATH 278A,A00,087441,Staff,8,0,10,2
1653569137557,MATH 278B,A00,087442,Staff,8,0,10,2
1653569138083,MATH 278C,A00,087443,Staff,8,0,10,2
1653569138607,MATH 280A,A00,087444,Zheng; Tianyi,0,0,8,8
1653569139136,MATH 281A,A00,087445,Bradic; Jelena,0,0,8,8
1653569139661,MATH 282A,A00,087446,Zhang; Danna,0,0,8,8
1653569140188,MATH 283,A00,087447,Tesler; Glenn,0,0,0,15
1653569140712,MATH 286,A00,087448,Kemp; Todd Aahron,5,0,8,3
1653569141236,MATH 287D,A00,087449,Bradic; Jelena,0,0,0,1
1653569141762,MATH 288,A00,087450,Staff,14,0,15,1
1653569141762,MATH 288,B00,087451,Staff,15,0,15,0
1653569141762,MATH 288,C00,087452,Staff,15,0,15,0
1653569142380,MATH 290A,A00,087453,Xu; Zhouli,6,0,8,2
1653569142908,MATH 291A,A00,087454,Xu; Zhouli,7,0,8,1
1653569143430,MATH 292,A00,087455,Staff,10,0,10,0
1653569143956,MATH 295,A00,087456,Staff,50,0,50,0
1653569144479,MATH 297,001,087457,Staff,998,0,999,1
1653569706763,COGS 200,A01,087991,Staff,47,0,50,3
1653569707299,COGS 201,A01,094504,Rangel; Lara M,17,0,25,8
1653569707825,COGS 203,A00,087992,Coulson; Seana M,18,0,20,2
1653569708352,COGS 210A,001,087993,Greene; Deanna Jacquelyn,9998,0,9999,1
1653569708352,COGS 210A,002,087994,Saygin; Ayse P,9999,0,9999,0
1653569708352,COGS 210A,003,087995,Xia; Haijun,9999,0,9999,0
1653569708352,COGS 210A,004,087996,Nitz; Douglas A.,9999,0,9999,0
1653569708352,COGS 210A,005,087997,Hollan; James D.,9999,0,9999,0
1653569708352,COGS 210A,006,087998,Deak; Gedeon O.,9998,0,9999,1
1653569708352,COGS 210A,007,087999,Rossano; Federico,9999,0,9999,0
1653569708879,COGS 211A,A00,088000,Coulson; Seana M,9997,0,9999,2
1653569709403,COGS 229,A00,088002,Staff,22,0,25,3
1653569709932,COGS 260,B00,094231,Staff,17,0,20,3
1653569709932,COGS 260,A00,088004,Nitz; Douglas A.,9998,0,9999,1
1653569710465,CSE 202,A00,090110,Paturi; Ramamohan,0,0,0,0
1653569710465,CSE 202,B00,090111,Paturi; Ramamohan,0,0,0,0
1653569711008,CSE 207B,A00,090112,Heninger; Nadia A,0,0,0,0
1653569711539,CSE 208,A00,094858,Micciancio; Daniele,0,0,0,0
1653569712066,CSE 210,A00,090113,Powell; Thomas Allan,0,0,0,0
1653569712618,CSE 219,A00,090898,Staff,0,0,0,0
1653569713146,CSE 221,A00,090114,Zhou; Yuan-Yuan,0,0,0,0
1653569713673,CSE 229A,A00,090115,Porter; George M,0,0,0,0
1653569714196,CSE 229C,A00,090116,Savage; Stefan,0,0,0,0
1653569714720,CSE 230,A00,090117,Jhala; Ranjit,0,0,0,0
1653569715247,CSE 232,A00,090118,Papakonstantinou; Yannis,0,0,0,0
1653569715782,CSE 239A,A00,090121,Kumar; Arun Kumar,0,0,0,0
1653569716314,CSE 239B,A00,090122,Jhala; Ranjit,0,0,0,0
1653569716843,CSE 240A,A00,090123,Zhao; Jishen,1,0,189,188
1653569717367,CSE 243A,A00,090124,Orailoglu; Alex,0,0,15,15
1653569717894,CSE 249B,A00,090125,Kahng; Andrew Byun,13,0,20,7
1653569718421,CSE 250A,A00,090126,Berg-Kirkpatrick; Taylor D,0,0,0,0
1653569718955,CSE 252A,A00,090127,Ochoa; Benjamin Lawrence,0,0,0,0
1653569719483,CSE 258,A01,090129,McAuley; Julian John,0,0,0,0
1653569720006,CSE 258R,A01,090131,McAuley; Julian John,0,0,0,0
1653569720533,CSE 274,A00,090132,Ramamoorthi; Ravi,0,0,0,0
1653569721059,CSE 276A,A00,090133,Christensen; Henrik I,0,0,0,0
1653569721582,CSE 276C,A00,090134,Christensen; Henrik I,0,0,0,0
1653569722109,CSE 290,A00,090135,Bafna; Vineet,0,0,0,0
1653569722109,CSE 290,B00,090136,Ramamoorthi; Ravi,0,0,0,0
1653569722109,CSE 290,C00,090137,Li; Tzumao,8,0,10,2
1653569722109,CSE 290,D00,090138,Zhou; Yuan-Yuan,9,0,10,1
1653569722109,CSE 290,E00,090139,Christensen; Henrik I,8,0,10,2
1653569722109,CSE 290,F00,094053,Shalev; Aaron D,0,0,0,0
1653569722727,CSE 291,A00,090140,Munyaka; Imani N. S.,0,0,0,0
1653569722727,CSE 291,B00,094880,Yu; Qi,0,0,0,0
1653569722727,CSE 291,C00,090142,Pannuto; Patrick William,0,0,0,0
1653569722727,CSE 291,D00,094881,Zhang; Yiying,0,0,0,0
1653569722727,CSE 291,E00,095118,Su; Hao,0,0,0,0
1653569723292,CSE 293,001,094905,Bafna; Vineet,9999,0,9999,0
1653569723292,CSE 293,002,094906,Bellare; Mihir,9999,0,9999,0
1653569723292,CSE 293,003,094907,Berg-Kirkpatrick; Taylor D,9999,0,9999,0
1653569723292,CSE 293,004,094908,Christensen; Henrik I,9999,0,9999,0
1653569723292,CSE 293,005,094909,Cottrell; Garrison W,9999,0,9999,0
1653569723292,CSE 293,006,094910,Deutsch; Alin Bernard,9999,0,9999,0
1653569723292,CSE 293,007,094911,Esmaeilzadeh; Hadi,9999,0,9999,0
1653569723292,CSE 293,008,094912,Freund; Yoav,9999,0,9999,0
1653569723292,CSE 293,009,094913,Griswold; William G.,9999,0,9999,0
1653569723292,CSE 293,010,094914,Gymrek; Melissa Ann,9999,0,9999,0
1653569723292,CSE 293,011,094915,Heninger; Nadia A,9999,0,9999,0
1653569723292,CSE 293,012,094916,Impagliazzo; Russell,9999,0,9999,0
1653569723292,CSE 293,013,094917,Jhala; Ranjit,9999,0,9999,0
1653569723292,CSE 293,014,094918,Kahng; Andrew Byun,9999,0,9999,0
1653569723292,CSE 293,015,094919,Kane; Daniel Mertz,9999,0,9999,0
1653569723292,CSE 293,016,094920,Kriegman; David J,9999,0,9999,0
1653569723292,CSE 293,017,094921,Kumar; Arun Kumar,9999,0,9999,0
1653569723292,CSE 293,018,094922,Lerner; Sorin,9999,0,9999,0
1653569723292,CSE 293,019,094923,Lovett; Shachar,9999,0,9999,0
1653569723292,CSE 293,020,094924,McAuley; Julian John,9999,0,9999,0
1653569723292,CSE 293,021,094925,Micciancio; Daniele,9999,0,9999,0
1653569723292,CSE 293,022,094926,Orailoglu; Alex,9999,0,9999,0
1653569723292,CSE 293,023,094927,Paturi; Ramamohan,9999,0,9999,0
1653569723292,CSE 293,024,094928,Polikarpova; Nadezhda,9999,0,9999,0
1653569723292,CSE 293,025,094929,Politz; Joseph Gibbs,9999,0,9999,0
1653569723292,CSE 293,026,094930,Porter; George M,9999,0,9999,0
1653569723292,CSE 293,027,094931,Porter; Leonard Emerson,9999,0,9999,0
1653569723292,CSE 293,028,094932,Ramamoorthi; Ravi,9999,0,9999,0
1653569723292,CSE 293,029,094933,Sahoo; Debashis,9999,0,9999,0
1653569723292,CSE 293,030,094934,Saul; Lawrence,9999,0,9999,0
1653569723292,CSE 293,031,094935,Savage; Stefan,9999,0,9999,0
1653569723292,CSE 293,032,094936,Schulze; Jurgen P.,9999,0,9999,0
1653569723292,CSE 293,033,094937,Snoeren; Alex C.,9999,0,9999,0
1653569723292,CSE 293,034,094938,Shang; Jingbo,9999,0,9999,0
1653569723292,CSE 293,035,094939,Stefan; Deian,9999,0,9999,0
1653569723292,CSE 293,036,094940,Su; Hao,9999,0,9999,0
1653569723292,CSE 293,037,094941,Swanson; Steven James,9999,0,9999,0
1653569723292,CSE 293,038,094942,Tullsen; Dean Michael,9999,0,9999,0
1653569723292,CSE 293,039,094943,Voelker; Geoffrey M.,9999,0,9999,0
1653569723292,CSE 293,040,094944,Zhao; Jishen,9999,0,9999,0
1653569723292,CSE 293,041,094945,Zhou; Yuan-Yuan,9999,0,9999,0
1653569723292,CSE 293,042,094946,Gao; Sicun,9998,0,9999,1
1653569723292,CSE 293,043,094947,Weibel; Nadir,9999,0,9999,0
1653569723292,CSE 293,044,094948,Gupta; Rajesh K.,9999,0,9999,0
1653569723822,CSE 294,A00,090143,Porter; George M,8,0,10,2
1653569724346,DSE 200,A00,091799,Staff,50,0,50,0
1653569724881,DSE 203,A00,091800,Gupta; Amarnath,30,0,30,0
1653569725412,DSE 250,A00,091801,Deutsch; Alin Bernard,30,0,30,0
1653569725939,DSE 290,A00,091802,Altintas De Callaf; Ilkay,50,0,50,0
1653569726492,ECE 200,001,091003,Antipa; Nicholas A,9999,0,9999,0
1653569726492,ECE 200,002,091004,Atanasov; Nikolay A.,9999,0,9999,0
1653569726492,ECE 200,003,091005,Bharadia; Dinesh,9999,0,9999,0
1653569726492,ECE 200,004,091006,Cheng; Chung Kuan,9999,0,9999,0
1653569726492,ECE 200,005,091007,Cosman; Pamela C.,9999,0,9999,0
1653569726492,ECE 200,006,091008,Staff,9999,0,9999,0
1653569726492,ECE 200,007,091009,Dayeh; Shadi Ahmad,9999,0,9999,0
1653569726492,ECE 200,008,091010,Fainman; Yeshaiahu,9999,0,9999,0
1653569726492,ECE 200,009,091011,Ford; Joseph Earl,9999,0,9999,0
1653569726492,ECE 200,010,091012,Franceschetti; Massimo,9999,0,9999,0
1653569726492,ECE 200,011,091013,Fullerton; Eric E,9999,0,9999,0
1653569726492,ECE 200,012,091014,Galton; Ian A,9999,0,9999,0
1653569726492,ECE 200,013,091015,Gilja; Vikash,9999,0,9999,0
1653569726492,ECE 200,014,091016,Hall; Drew A.,9999,0,9999,0
1653569726492,ECE 200,015,091017,Hsueh; Tzu-Chien,9999,0,9999,0
1653569726492,ECE 200,016,091018,Javidi; Tara,9999,0,9999,0
1653569726492,ECE 200,017,091019,Kahng; Andrew Byun,9999,0,9999,0
1653569726492,ECE 200,018,091020,Kim; Young-Han,9999,0,9999,0
1653569726492,ECE 200,019,091021,Koushanfar; Farinaz,9999,0,9999,0
1653569726492,ECE 200,020,091022,Kuzum; Duygu,9999,0,9999,0
1653569726492,ECE 200,021,091023,Le; Hanh-Phuc,9999,0,9999,0
1653569726492,ECE 200,022,091024,Lin; Bill,9999,0,9999,0
1653569726492,ECE 200,023,091025,Liu; Zhaowei,9999,0,9999,0
1653569726492,ECE 200,024,091026,Lo; Yu-Hwa,9999,0,9999,0
1653569726492,ECE 200,025,091027,Lomakin; Vitaliy,9999,0,9999,0
1653569726492,ECE 200,026,091028,Mercier; Patrick Philip,9999,0,9999,0
1653569726492,ECE 200,027,091029,Meyer; Florian,9999,0,9999,0
1653569726492,ECE 200,028,091030,Milstein; Laurence B.,9999,0,9999,0
1653569726492,ECE 200,029,091031,Mir Arabbaygi; Siavash,9999,0,9999,0
1653569726492,ECE 200,030,091032,Mookherjea; Shayan,9999,0,9999,0
1653569726492,ECE 200,031,091033,Morris; Karcher William,9999,0,9999,0
1653569726492,ECE 200,032,091034,Ng; Tse Nga,9999,0,9999,0
1653569726492,ECE 200,033,091035,Nguyen; Truong Quang,9999,0,9999,0
1653569726492,ECE 200,034,091036,Nomura; Kenji,9999,0,9999,0
1653569726492,ECE 200,035,091037,Orlitsky; Alon,9999,0,9999,0
1653569726492,ECE 200,036,091038,Pal; Piya,9999,0,9999,0
1653569726492,ECE 200,037,091039,Papen; George C.,9999,0,9999,0
1653569726492,ECE 200,038,091040,Radic; Stojan,9999,0,9999,0
1653569726492,ECE 200,039,091041,Rao; Bhaskar D.,9999,0,9999,0
1653569726492,ECE 200,040,091042,Rao; Ramesh R,9999,0,9999,0
1653569726492,ECE 200,041,091043,Rebeiz; Gabriel,9999,0,9999,0
1653569726492,ECE 200,042,091044,Sanford; John R,9999,0,9999,0
1653569726492,ECE 200,043,091045,Siegel; Paul H.,9999,0,9999,0
1653569726492,ECE 200,044,091046,Sievenpiper; Daniel F.,9999,0,9999,0
1653569726492,ECE 200,045,091047,Sworder; David D.,9999,0,9999,0
1653569726492,ECE 200,046,091048,Taur; Yuan,9999,0,9999,0
1653569726492,ECE 200,047,091049,Touri; Behrouz,9999,0,9999,0
1653569726492,ECE 200,048,091050,Trivedi; Mohan M.,9999,0,9999,0
1653569726492,ECE 200,049,091051,Vardy; Alexander,9999,0,9999,0
1653569726492,ECE 200,050,091052,Vasconcelos; Nuno,9999,0,9999,0
1653569726492,ECE 200,051,091053,Wang; Xiaolong,9999,0,9999,0
1653569726492,ECE 200,052,091054,Xie; Pengtao,9999,0,9999,0
1653569726492,ECE 200,053,091055,Yip; Michael,9999,0,9999,0
1653569726492,ECE 200,054,091056,Zeger; Kenneth A.,9999,0,9999,0
1653569726492,ECE 200,055,091057,Zhang; Xinyu,9999,0,9999,0
1653569726492,ECE 200,056,091058,Turakhia; Yatish Girish,9999,0,9999,0
1653569726492,ECE 200,057,091059,Kang; Mingu,9999,0,9999,0
1653569726492,ECE 200,058,091060,Shi; Yuanyuan,9999,0,9999,0
1653569726492,ECE 200,059,091061,Wang; Edward Jay,9999,0,9999,0
1653569726492,ECE 200,060,091062,Zheng; Yang,9999,0,9999,0
1653569727021,ECE 201,A00,095526,Lo; Yu-Hwa,0,0,0,0
1653569727552,ECE 203,A00,091065,Mercier; Patrick Philip,0,0,0,0
1653569728082,ECE 207A,A00,091605,Liu; Thomas Tao-Ming,0,0,0,0
1653569728607,ECE 212AN,A00,091068,Nomura; Kenji,0,0,0,0
1653569729131,ECE 222A,A00,091069,Rebeiz; Gabriel,0,0,0,0
1653569729655,ECE 225A,A00,091070,Orlitsky; Alon,0,0,0,0
1653569730178,ECE 230A,A00,091071,Nomura; Kenji,0,0,0,0
1653569730706,ECE 236A,A00,091072,Dayeh; Shadi Ahmad,0,0,0,0
1653569731230,ECE 238A,A00,091073,Luo; Jian,0,0,0,0
1653569731230,ECE 238A,B00,091074,Luo; Jian,0,0,0,0
1653569731754,ECE 240A,A00,091075,Radic; Stojan,0,0,0,0
1653569732283,ECE 247A,A00,091592,Shi; Lingyan,0,0,0,0
1653569732807,ECE 250,A00,091076,Touri; Behrouz,0,0,0,0
1653569733335,ECE 251C,A00,091078,Nguyen; Truong Quang,0,0,0,0
1653569733859,ECE 253,A00,091079,Cosman; Pamela C.,0,0,0,0
1653569734383,ECE 255A,A00,091080,Orlitsky; Alon,0,0,0,0
1653569734908,ECE 257A,A00,091081,Zhang; Xinyu,0,0,0,0
1653569735436,ECE 260A,A01,091084,Eldon; John,0,0,0,0
1653569735961,ECE 264C,A00,091085,Galton; Ian A,0,0,0,0
1653569736487,ECE 265C,A00,094889,Presti; Calogero Davide,0,0,0,9
1653569737022,ECE 266,A01,091087,Hall; Drew A.,0,0,0,0
1653569738074,ECE 271A,A00,091090,Vasconcelos; Nuno,0,0,0,0
1653569738600,ECE 272B,A00,091091,Sworder; David D.,0,0,0,0
1653569739124,ECE 275A,A00,091092,Meyer; Florian,0,0,0,0
1653569739668,ECE 277,A00,091093,An; Cheolhong,0,0,0,0
1653569740191,ECE 283,A00,091094,Le; Hanh-Phuc,0,0,0,0
1653569740726,ECE 284,A00,091095,Kang; Mingu,0,0,0,0
1653569740726,ECE 284,B00,091096,Wang; Edward Jay,0,0,0,0
1653569741251,ECE 285,A00,094334,Touri; Behrouz,0,0,0,0
1653569741776,ECE 289,A00,091097,Whelan; David Arthur,0,0,0,0
1653569742304,MATH 200A,A00,087414,Salehi Golsefidy; Alireza,7,0,8,1
1653569742828,MATH 202A,A00,087415,Gill; Philip E.,2,0,8,6
1653569743356,MATH 203A,A00,087416,Oprea; Dragos N.,6,0,8,2
1653569743880,MATH 204A,A00,087417,Kedlaya; Kiran S.,6,0,8,2
1653569744411,MATH 205,A00,087418,Sorensen; Claus M,6,0,8,2
1653569744942,MATH 206A,A00,087419,Izadi; Elham,7,0,8,1
1653569745465,MATH 207A,A00,087420,Mohammadi; Amir,5,0,8,3
1653569745994,MATH 208,A00,087421,Staff,9,0,10,1
1653569746517,MATH 209,A00,087422,Staff,10,0,10,0
1653569747040,MATH 218,A00,087423,Staff,10,0,10,0
1653569747568,MATH 220A,A00,087424,Novak; Jonathan I,6,0,8,2
1653569748095,MATH 231A,A00,087425,Bejenaru; Ioan,3,0,8,5
1653569748620,MATH 240A,A00,087426,Ebenfelt; Peter F,5,0,8,3
1653569749145,MATH 243,A00,087427,Staff,9,0,10,1
1653569749671,MATH 248,A00,087429,Staff,10,0,10,0
1653569750196,MATH 250A,A00,087430,Spolaor; Luca,4,0,8,4
1653569750723,MATH 257A,A00,087431,Spolaor; Luca,7,0,8,1
1653569751257,MATH 258,A00,087432,Staff,9,0,10,1
1653569751784,MATH 264A,A00,087433,Warnke; Lutz Peter,5,0,8,3
1653569752310,MATH 268,A00,087434,Staff,15,0,15,0
1653569752841,MATH 269,A00,087435,Staff,14,0,15,1
1653569753368,MATH 270A,A00,087436,Nie; Jiawang,0,0,8,8
1653569753893,MATH 272A,A00,087437,Tian; Xiaochuan,1,0,8,7
1653569754421,MATH 274,A01,087439,Cheng; Li-Tien,9,0,10,1
1653569754421,MATH 274,A02,087440,Cheng; Li-Tien,10,0,10,0
1653569754944,MATH 278A,A00,087441,Staff,8,0,10,2
1653569755470,MATH 278B,A00,087442,Staff,8,0,10,2
1653569755998,MATH 278C,A00,087443,Staff,8,0,10,2
1653569756522,MATH 280A,A00,087444,Zheng; Tianyi,0,0,8,8
1653569757045,MATH 281A,A00,087445,Bradic; Jelena,0,0,8,8
1653569757572,MATH 282A,A00,087446,Zhang; Danna,0,0,8,8
1653569758109,MATH 283,A00,087447,Tesler; Glenn,0,0,0,15
1653569758636,MATH 286,A00,087448,Kemp; Todd Aahron,5,0,8,3
1653569759159,MATH 287D,A00,087449,Bradic; Jelena,0,0,0,1
1653569759682,MATH 288,A00,087450,Staff,14,0,15,1
1653569759682,MATH 288,B00,087451,Staff,15,0,15,0
1653569759682,MATH 288,C00,087452,Staff,15,0,15,0
1653569760213,MATH 290A,A00,087453,Xu; Zhouli,6,0,8,2
1653569760738,MATH 291A,A00,087454,Xu; Zhouli,7,0,8,1
1653569761261,MATH 292,A00,087455,Staff,10,0,10,0
1653569761790,MATH 295,A00,087456,Staff,50,0,50,0
1653569762313,MATH 297,001,087457,Staff,998,0,999,1
1653570324667,COGS 200,A01,087991,Staff,47,0,50,3
1653570325195,COGS 201,A01,094504,Rangel; Lara M,17,0,25,8
1653570325724,COGS 203,A00,087992,Coulson; Seana M,18,0,20,2
1653570326259,COGS 210A,001,087993,Greene; Deanna Jacquelyn,9998,0,9999,1
1653570326259,COGS 210A,002,087994,Saygin; Ayse P,9999,0,9999,0
1653570326259,COGS 210A,003,087995,Xia; Haijun,9999,0,9999,0
1653570326259,COGS 210A,004,087996,Nitz; Douglas A.,9999,0,9999,0
1653570326259,COGS 210A,005,087997,Hollan; James D.,9999,0,9999,0
1653570326259,COGS 210A,006,087998,Deak; Gedeon O.,9998,0,9999,1
1653570326259,COGS 210A,007,087999,Rossano; Federico,9999,0,9999,0
1653570326782,COGS 211A,A00,088000,Coulson; Seana M,9997,0,9999,2
1653570327308,COGS 229,A00,088002,Staff,22,0,25,3
1653570327836,COGS 260,B00,094231,Staff,17,0,20,3
1653570327836,COGS 260,A00,088004,Nitz; Douglas A.,9998,0,9999,1
1653570328364,CSE 202,A00,090110,Paturi; Ramamohan,0,0,0,0
1653570328364,CSE 202,B00,090111,Paturi; Ramamohan,0,0,0,0
1653570328891,CSE 207B,A00,090112,Heninger; Nadia A,0,0,0,0
1653570329420,CSE 208,A00,094858,Micciancio; Daniele,0,0,0,0
1653570329943,CSE 210,A00,090113,Powell; Thomas Allan,0,0,0,0
1653570330470,CSE 219,A00,090898,Staff,0,0,0,0
1653570330994,CSE 221,A00,090114,Zhou; Yuan-Yuan,0,0,0,0
1653570331517,CSE 229A,A00,090115,Porter; George M,0,0,0,0
1653570332043,CSE 229C,A00,090116,Savage; Stefan,0,0,0,0
1653570332568,CSE 230,A00,090117,Jhala; Ranjit,0,0,0,0
1653570333109,CSE 232,A00,090118,Papakonstantinou; Yannis,0,0,0,0
1653570333634,CSE 239A,A00,090121,Kumar; Arun Kumar,0,0,0,0
1653570334159,CSE 239B,A00,090122,Jhala; Ranjit,0,0,0,0
1653570334687,CSE 240A,A00,090123,Zhao; Jishen,1,0,189,188
1653570335224,CSE 243A,A00,090124,Orailoglu; Alex,0,0,15,15
1653570335746,CSE 249B,A00,090125,Kahng; Andrew Byun,13,0,20,7
1653570336271,CSE 250A,A00,090126,Berg-Kirkpatrick; Taylor D,0,0,0,0
1653570336799,CSE 252A,A00,090127,Ochoa; Benjamin Lawrence,0,0,0,0
1653570337329,CSE 258,A01,090129,McAuley; Julian John,0,0,0,0
1653570337855,CSE 258R,A01,090131,McAuley; Julian John,0,0,0,0
1653570338386,CSE 274,A00,090132,Ramamoorthi; Ravi,0,0,0,0
1653570338910,CSE 276A,A00,090133,Christensen; Henrik I,0,0,0,0
1653570339433,CSE 276C,A00,090134,Christensen; Henrik I,0,0,0,0
1653570339958,CSE 290,A00,090135,Bafna; Vineet,0,0,0,0
1653570339958,CSE 290,B00,090136,Ramamoorthi; Ravi,0,0,0,0
1653570339958,CSE 290,C00,090137,Li; Tzumao,8,0,10,2
1653570339958,CSE 290,D00,090138,Zhou; Yuan-Yuan,9,0,10,1
1653570339958,CSE 290,E00,090139,Christensen; Henrik I,8,0,10,2
1653570339958,CSE 290,F00,094053,Shalev; Aaron D,0,0,0,0
1653570340487,CSE 291,A00,090140,Munyaka; Imani N. S.,0,0,0,0
1653570340487,CSE 291,B00,094880,Yu; Qi,0,0,0,0
1653570340487,CSE 291,C00,090142,Pannuto; Patrick William,0,0,0,0
1653570340487,CSE 291,D00,094881,Zhang; Yiying,0,0,0,0
1653570340487,CSE 291,E00,095118,Su; Hao,0,0,0,0
1653570341043,CSE 293,001,094905,Bafna; Vineet,9999,0,9999,0
1653570341043,CSE 293,002,094906,Bellare; Mihir,9999,0,9999,0
1653570341043,CSE 293,003,094907,Berg-Kirkpatrick; Taylor D,9999,0,9999,0
1653570341043,CSE 293,004,094908,Christensen; Henrik I,9999,0,9999,0
1653570341043,CSE 293,005,094909,Cottrell; Garrison W,9999,0,9999,0
1653570341043,CSE 293,006,094910,Deutsch; Alin Bernard,9999,0,9999,0
1653570341043,CSE 293,007,094911,Esmaeilzadeh; Hadi,9999,0,9999,0
1653570341043,CSE 293,008,094912,Freund; Yoav,9999,0,9999,0
1653570341043,CSE 293,009,094913,Griswold; William G.,9999,0,9999,0
1653570341043,CSE 293,010,094914,Gymrek; Melissa Ann,9999,0,9999,0
1653570341043,CSE 293,011,094915,Heninger; Nadia A,9999,0,9999,0
1653570341043,CSE 293,012,094916,Impagliazzo; Russell,9999,0,9999,0
1653570341043,CSE 293,013,094917,Jhala; Ranjit,9999,0,9999,0
1653570341043,CSE 293,014,094918,Kahng; Andrew Byun,9999,0,9999,0
1653570341043,CSE 293,015,094919,Kane; Daniel Mertz,9999,0,9999,0
1653570341043,CSE 293,016,094920,Kriegman; David J,9999,0,9999,0
1653570341043,CSE 293,017,094921,Kumar; Arun Kumar,9999,0,9999,0
1653570341043,CSE 293,018,094922,Lerner; Sorin,9999,0,9999,0
1653570341043,CSE 293,019,094923,Lovett; Shachar,9999,0,9999,0
1653570341043,CSE 293,020,094924,McAuley; Julian John,9999,0,9999,0
1653570341043,CSE 293,021,094925,Micciancio; Daniele,9999,0,9999,0
1653570341043,CSE 293,022,094926,Orailoglu; Alex,9999,0,9999,0
1653570341043,CSE 293,023,094927,Paturi; Ramamohan,9999,0,9999,0
1653570341043,CSE 293,024,094928,Polikarpova; Nadezhda,9999,0,9999,0
1653570341043,CSE 293,025,094929,Politz; Joseph Gibbs,9999,0,9999,0
1653570341043,CSE 293,026,094930,Porter; George M,9999,0,9999,0
1653570341043,CSE 293,027,094931,Porter; Leonard Emerson,9999,0,9999,0
1653570341043,CSE 293,028,094932,Ramamoorthi; Ravi,9999,0,9999,0
1653570341043,CSE 293,029,094933,Sahoo; Debashis,9999,0,9999,0
1653570341043,CSE 293,030,094934,Saul; Lawrence,9999,0,9999,0
1653570341043,CSE 293,031,094935,Savage; Stefan,9999,0,9999,0
1653570341043,CSE 293,032,094936,Schulze; Jurgen P.,9999,0,9999,0
1653570341043,CSE 293,033,094937,Snoeren; Alex C.,9999,0,9999,0
1653570341043,CSE 293,034,094938,Shang; Jingbo,9999,0,9999,0
1653570341043,CSE 293,035,094939,Stefan; Deian,9999,0,9999,0
1653570341043,CSE 293,036,094940,Su; Hao,9999,0,9999,0
1653570341043,CSE 293,037,094941,Swanson; Steven James,9999,0,9999,0
1653570341043,CSE 293,038,094942,Tullsen; Dean Michael,9999,0,9999,0
1653570341043,CSE 293,039,094943,Voelker; Geoffrey M.,9999,0,9999,0
1653570341043,CSE 293,040,094944,Zhao; Jishen,9999,0,9999,0
1653570341043,CSE 293,041,094945,Zhou; Yuan-Yuan,9999,0,9999,0
1653570341043,CSE 293,042,094946,Gao; Sicun,9998,0,9999,1
1653570341043,CSE 293,043,094947,Weibel; Nadir,9999,0,9999,0
1653570341043,CSE 293,044,094948,Gupta; Rajesh K.,9999,0,9999,0
1653570341566,CSE 294,A00,090143,Porter; George M,8,0,10,2
1653570342090,DSE 200,A00,091799,Staff,50,0,50,0
1653570342614,DSE 203,A00,091800,Gupta; Amarnath,30,0,30,0
1653570343137,DSE 250,A00,091801,Deutsch; Alin Bernard,30,0,30,0
1653570343678,DSE 290,A00,091802,Altintas De Callaf; Ilkay,50,0,50,0
1653570344232,ECE 200,001,091003,Antipa; Nicholas A,9999,0,9999,0
1653570344232,ECE 200,002,091004,Atanasov; Nikolay A.,9999,0,9999,0
1653570344232,ECE 200,003,091005,Bharadia; Dinesh,9999,0,9999,0
1653570344232,ECE 200,004,091006,Cheng; Chung Kuan,9999,0,9999,0
1653570344232,ECE 200,005,091007,Cosman; Pamela C.,9999,0,9999,0
1653570344232,ECE 200,006,091008,Staff,9999,0,9999,0
1653570344232,ECE 200,007,091009,Dayeh; Shadi Ahmad,9999,0,9999,0
1653570344232,ECE 200,008,091010,Fainman; Yeshaiahu,9999,0,9999,0
1653570344232,ECE 200,009,091011,Ford; Joseph Earl,9999,0,9999,0
1653570344232,ECE 200,010,091012,Franceschetti; Massimo,9999,0,9999,0
1653570344232,ECE 200,011,091013,Fullerton; Eric E,9999,0,9999,0
1653570344232,ECE 200,012,091014,Galton; Ian A,9999,0,9999,0
1653570344232,ECE 200,013,091015,Gilja; Vikash,9999,0,9999,0
1653570344232,ECE 200,014,091016,Hall; Drew A.,9999,0,9999,0
1653570344232,ECE 200,015,091017,Hsueh; Tzu-Chien,9999,0,9999,0
1653570344232,ECE 200,016,091018,Javidi; Tara,9999,0,9999,0
1653570344232,ECE 200,017,091019,Kahng; Andrew Byun,9999,0,9999,0
1653570344232,ECE 200,018,091020,Kim; Young-Han,9999,0,9999,0
1653570344232,ECE 200,019,091021,Koushanfar; Farinaz,9999,0,9999,0
1653570344232,ECE 200,020,091022,Kuzum; Duygu,9999,0,9999,0
1653570344232,ECE 200,021,091023,Le; Hanh-Phuc,9999,0,9999,0
1653570344232,ECE 200,022,091024,Lin; Bill,9999,0,9999,0
1653570344232,ECE 200,023,091025,Liu; Zhaowei,9999,0,9999,0
1653570344232,ECE 200,024,091026,Lo; Yu-Hwa,9999,0,9999,0
1653570344232,ECE 200,025,091027,Lomakin; Vitaliy,9999,0,9999,0
1653570344232,ECE 200,026,091028,Mercier; Patrick Philip,9999,0,9999,0
1653570344232,ECE 200,027,091029,Meyer; Florian,9999,0,9999,0
1653570344232,ECE 200,028,091030,Milstein; Laurence B.,9999,0,9999,0
1653570344232,ECE 200,029,091031,Mir Arabbaygi; Siavash,9999,0,9999,0
1653570344232,ECE 200,030,091032,Mookherjea; Shayan,9999,0,9999,0
1653570344232,ECE 200,031,091033,Morris; Karcher William,9999,0,9999,0
1653570344232,ECE 200,032,091034,Ng; Tse Nga,9999,0,9999,0
1653570344232,ECE 200,033,091035,Nguyen; Truong Quang,9999,0,9999,0
1653570344232,ECE 200,034,091036,Nomura; Kenji,9999,0,9999,0
1653570344232,ECE 200,035,091037,Orlitsky; Alon,9999,0,9999,0
1653570344232,ECE 200,036,091038,Pal; Piya,9999,0,9999,0
1653570344232,ECE 200,037,091039,Papen; George C.,9999,0,9999,0
1653570344232,ECE 200,038,091040,Radic; Stojan,9999,0,9999,0
1653570344232,ECE 200,039,091041,Rao; Bhaskar D.,9999,0,9999,0
1653570344232,ECE 200,040,091042,Rao; Ramesh R,9999,0,9999,0
1653570344232,ECE 200,041,091043,Rebeiz; Gabriel,9999,0,9999,0
1653570344232,ECE 200,042,091044,Sanford; John R,9999,0,9999,0
1653570344232,ECE 200,043,091045,Siegel; Paul H.,9999,0,9999,0
1653570344232,ECE 200,044,091046,Sievenpiper; Daniel F.,9999,0,9999,0
1653570344232,ECE 200,045,091047,Sworder; David D.,9999,0,9999,0
1653570344232,ECE 200,046,091048,Taur; Yuan,9999,0,9999,0
1653570344232,ECE 200,047,091049,Touri; Behrouz,9999,0,9999,0
1653570344232,ECE 200,048,091050,Trivedi; Mohan M.,9999,0,9999,0
1653570344232,ECE 200,049,091051,Vardy; Alexander,9999,0,9999,0
1653570344232,ECE 200,050,091052,Vasconcelos; Nuno,9999,0,9999,0
1653570344232,ECE 200,051,091053,Wang; Xiaolong,9999,0,9999,0
1653570344232,ECE 200,052,091054,Xie; Pengtao,9999,0,9999,0
1653570344232,ECE 200,053,091055,Yip; Michael,9999,0,9999,0
1653570344232,ECE 200,054,091056,Zeger; Kenneth A.,9999,0,9999,0
1653570344232,ECE 200,055,091057,Zhang; Xinyu,9999,0,9999,0
1653570344232,ECE 200,056,091058,Turakhia; Yatish Girish,9999,0,9999,0
1653570344232,ECE 200,057,091059,Kang; Mingu,9999,0,9999,0
1653570344232,ECE 200,058,091060,Shi; Yuanyuan,9999,0,9999,0
1653570344232,ECE 200,059,091061,Wang; Edward Jay,9999,0,9999,0
1653570344232,ECE 200,060,091062,Zheng; Yang,9999,0,9999,0
1653570344758,ECE 201,A00,095526,Lo; Yu-Hwa,0,0,0,0
1653570345284,ECE 203,A00,091065,Mercier; Patrick Philip,0,0,0,0
1653570345820,ECE 207A,A00,091605,Liu; Thomas Tao-Ming,0,0,0,0
1653570346345,ECE 212AN,A00,091068,Nomura; Kenji,0,0,0,0
1653570346868,ECE 222A,A00,091069,Rebeiz; Gabriel,0,0,0,0
1653570347392,ECE 225A,A00,091070,Orlitsky; Alon,0,0,0,0
1653570347917,ECE 230A,A00,091071,Nomura; Kenji,0,0,0,0
1653570348442,ECE 236A,A00,091072,Dayeh; Shadi Ahmad,0,0,0,0
1653570348973,ECE 238A,A00,091073,Luo; Jian,0,0,0,0
1653570348973,ECE 238A,B00,091074,Luo; Jian,0,0,0,0
1653570349501,ECE 240A,A00,091075,Radic; Stojan,0,0,0,0
1653570350034,ECE 247A,A00,091592,Shi; Lingyan,0,0,0,0
1653570350558,ECE 250,A00,091076,Touri; Behrouz,0,0,0,0
1653570351081,ECE 251C,A00,091078,Nguyen; Truong Quang,0,0,0,0
1653570351611,ECE 253,A00,091079,Cosman; Pamela C.,0,0,0,0
1653570352141,ECE 255A,A00,091080,Orlitsky; Alon,0,0,0,0
1653570352667,ECE 257A,A00,091081,Zhang; Xinyu,0,0,0,0
1653570353200,ECE 260A,A01,091084,Eldon; John,0,0,0,0
1653570353729,ECE 264C,A00,091085,Galton; Ian A,0,0,0,0
1653570354260,ECE 265C,A00,094889,Presti; Calogero Davide,0,0,0,9
1653570354784,ECE 266,A01,091087,Hall; Drew A.,0,0,0,0
1653570355834,ECE 271A,A00,091090,Vasconcelos; Nuno,0,0,0,0
1653570356358,ECE 272B,A00,091091,Sworder; David D.,0,0,0,0
1653570356882,ECE 275A,A00,091092,Meyer; Florian,0,0,0,0
1653570357406,ECE 277,A00,091093,An; Cheolhong,0,0,0,0
1653570357931,ECE 283,A00,091094,Le; Hanh-Phuc,0,0,0,0
1653570358470,ECE 284,A00,091095,Kang; Mingu,0,0,0,0
1653570358470,ECE 284,B00,091096,Wang; Edward Jay,0,0,0,0
1653570358994,ECE 285,A00,094334,Touri; Behrouz,0,0,0,0
1653570359529,ECE 289,A00,091097,Whelan; David Arthur,0,0,0,0
1653570360052,MATH 200A,A00,087414,Salehi Golsefidy; Alireza,7,0,8,1
1653570360576,MATH 202A,A00,087415,Gill; Philip E.,2,0,8,6
1653570361106,MATH 203A,A00,087416,Oprea; Dragos N.,6,0,8,2
1653570361630,MATH 204A,A00,087417,Kedlaya; Kiran S.,6,0,8,2
1653570362157,MATH 205,A00,087418,Sorensen; Claus M,6,0,8,2
1653570362688,MATH 206A,A00,087419,Izadi; Elham,7,0,8,1
1653570363210,MATH 207A,A00,087420,Mohammadi; Amir,5,0,8,3
1653570363742,MATH 208,A00,087421,Staff,9,0,10,1
1653570364266,MATH 209,A00,087422,Staff,10,0,10,0
1653570364789,MATH 218,A00,087423,Staff,10,0,10,0
1653570365314,MATH 220A,A00,087424,Novak; Jonathan I,6,0,8,2
1653570365927,MATH 231A,A00,087425,Bejenaru; Ioan,3,0,8,5
1653570366463,MATH 240A,A00,087426,Ebenfelt; Peter F,5,0,8,3
1653570366988,MATH 243,A00,087427,Staff,9,0,10,1
1653570367510,MATH 248,A00,087429,Staff,10,0,10,0
1653570368033,MATH 250A,A00,087430,Spolaor; Luca,4,0,8,4
1653570368560,MATH 257A,A00,087431,Spolaor; Luca,7,0,8,1
1653570369086,MATH 258,A00,087432,Staff,9,0,10,1
1653570369614,MATH 264A,A00,087433,Warnke; Lutz Peter,5,0,8,3
1653570370151,MATH 268,A00,087434,Staff,15,0,15,0
1653570370675,MATH 269,A00,087435,Staff,14,0,15,1
1653570371201,MATH 270A,A00,087436,Nie; Jiawang,0,0,8,8
1653570371724,MATH 272A,A00,087437,Tian; Xiaochuan,1,0,8,7
1653570372252,MATH 274,A01,087439,Cheng; Li-Tien,9,0,10,1
1653570372252,MATH 274,A02,087440,Cheng; Li-Tien,10,0,10,0
1653570372777,MATH 278A,A00,087441,Staff,8,0,10,2
1653570373302,MATH 278B,A00,087442,Staff,8,0,10,2
1653570373825,MATH 278C,A00,087443,Staff,8,0,10,2
1653570374354,MATH 280A,A00,087444,Zheng; Tianyi,0,0,8,8
1653570374884,MATH 281A,A00,087445,Bradic; Jelena,0,0,8,8
1653570375421,MATH 282A,A00,087446,Zhang; Danna,0,0,8,8
1653570375944,MATH 283,A00,087447,Tesler; Glenn,0,0,0,15
1653570376470,MATH 286,A00,087448,Kemp; Todd Aahron,5,0,8,3
1653570376994,MATH 287D,A00,087449,Bradic; Jelena,0,0,0,1
1653570377518,MATH 288,A00,087450,Staff,14,0,15,1
1653570377518,MATH 288,B00,087451,Staff,15,0,15,0
1653570377518,MATH 288,C00,087452,Staff,15,0,15,0
1653570378043,MATH 290A,A00,087453,Xu; Zhouli,6,0,8,2
1653570378571,MATH 291A,A00,087454,Xu; Zhouli,7,0,8,1
1653570379095,MATH 292,A00,087455,Staff,10,0,10,0
1653570379620,MATH 295,A00,087456,Staff,50,0,50,0
1653570380146,MATH 297,001,087457,Staff,998,0,999,1
1653570940522,COGS 200,A01,087991,Staff,47,0,50,3
1653570941048,COGS 201,A01,094504,Rangel; Lara M,17,0,25,8
1653570941572,COGS 203,A00,087992,Coulson; Seana M,18,0,20,2
1653570942099,COGS 210A,001,087993,Greene; Deanna Jacquelyn,9998,0,9999,1
1653570942099,COGS 210A,002,087994,Saygin; Ayse P,9999,0,9999,0
1653570942099,COGS 210A,003,087995,Xia; Haijun,9999,0,9999,0
1653570942099,COGS 210A,004,087996,Nitz; Douglas A.,9999,0,9999,0
1653570942099,COGS 210A,005,087997,Hollan; James D.,9999,0,9999,0
1653570942099,COGS 210A,006,087998,Deak; Gedeon O.,9998,0,9999,1
1653570942099,COGS 210A,007,087999,Rossano; Federico,9999,0,9999,0
1653570942625,COGS 211A,A00,088000,Coulson; Seana M,9997,0,9999,2
1653570943151,COGS 229,A00,088002,Staff,22,0,25,3
1653570943674,COGS 260,B00,094231,Staff,17,0,20,3
1653570943674,COGS 260,A00,088004,Nitz; Douglas A.,9998,0,9999,1
1653570944206,CSE 202,A00,090110,Paturi; Ramamohan,0,0,0,0
1653570944206,CSE 202,B00,090111,Paturi; Ramamohan,0,0,0,0
1653570944734,CSE 207B,A00,090112,Heninger; Nadia A,0,0,0,0
1653570945258,CSE 208,A00,094858,Micciancio; Daniele,0,0,0,0
1653570945787,CSE 210,A00,090113,Powell; Thomas Allan,0,0,0,0
1653570946310,CSE 219,A00,090898,Staff,0,0,0,0
1653570946834,CSE 221,A00,090114,Zhou; Yuan-Yuan,0,0,0,0
1653570947358,CSE 229A,A00,090115,Porter; George M,0,0,0,0
1653570947885,CSE 229C,A00,090116,Savage; Stefan,0,0,0,0
1653570948410,CSE 230,A00,090117,Jhala; Ranjit,0,0,0,0
1653570948934,CSE 232,A00,090118,Papakonstantinou; Yannis,0,0,0,0
1653570949461,CSE 239A,A00,090121,Kumar; Arun Kumar,0,0,0,0
1653570949994,CSE 239B,A00,090122,Jhala; Ranjit,0,0,0,0
1653570950517,CSE 240A,A00,090123,Zhao; Jishen,1,0,189,188
1653570951040,CSE 243A,A00,090124,Orailoglu; Alex,0,0,15,15
1653570951565,CSE 249B,A00,090125,Kahng; Andrew Byun,13,0,20,7
1653570952095,CSE 250A,A00,090126,Berg-Kirkpatrick; Taylor D,0,0,0,0
1653570952623,CSE 252A,A00,090127,Ochoa; Benjamin Lawrence,0,0,0,0
1653570953149,CSE 258,A01,090129,McAuley; Julian John,0,0,0,0
1653570953744,CSE 258R,A01,090131,McAuley; Julian John,0,0,0,0
1653570954276,CSE 274,A00,090132,Ramamoorthi; Ravi,0,0,0,0
1653570954802,CSE 276A,A00,090133,Christensen; Henrik I,0,0,0,0
1653570955329,CSE 276C,A00,090134,Christensen; Henrik I,0,0,0,0
1653570955856,CSE 290,A00,090135,Bafna; Vineet,0,0,0,0
1653570955856,CSE 290,B00,090136,Ramamoorthi; Ravi,0,0,0,0
1653570955856,CSE 290,C00,090137,Li; Tzumao,8,0,10,2
1653570955856,CSE 290,D00,090138,Zhou; Yuan-Yuan,9,0,10,1
1653570955856,CSE 290,E00,090139,Christensen; Henrik I,8,0,10,2
1653570955856,CSE 290,F00,094053,Shalev; Aaron D,0,0,0,0
1653570956383,CSE 291,A00,090140,Munyaka; Imani N. S.,0,0,0,0
1653570956383,CSE 291,B00,094880,Yu; Qi,0,0,0,0
1653570956383,CSE 291,C00,090142,Pannuto; Patrick William,0,0,0,0
1653570956383,CSE 291,D00,094881,Zhang; Yiying,0,0,0,0
1653570956383,CSE 291,E00,095118,Su; Hao,0,0,0,0
1653570956923,CSE 293,001,094905,Bafna; Vineet,9999,0,9999,0
1653570956923,CSE 293,002,094906,Bellare; Mihir,9999,0,9999,0
1653570956923,CSE 293,003,094907,Berg-Kirkpatrick; Taylor D,9999,0,9999,0
1653570956923,CSE 293,004,094908,Christensen; Henrik I,9999,0,9999,0
1653570956923,CSE 293,005,094909,Cottrell; Garrison W,9999,0,9999,0
1653570956923,CSE 293,006,094910,Deutsch; Alin Bernard,9999,0,9999,0
1653570956923,CSE 293,007,094911,Esmaeilzadeh; Hadi,9999,0,9999,0
1653570956923,CSE 293,008,094912,Freund; Yoav,9999,0,9999,0
1653570956923,CSE 293,009,094913,Griswold; William G.,9999,0,9999,0
1653570956923,CSE 293,010,094914,Gymrek; Melissa Ann,9999,0,9999,0
1653570956923,CSE 293,011,094915,Heninger; Nadia A,9999,0,9999,0
1653570956923,CSE 293,012,094916,Impagliazzo; Russell,9999,0,9999,0
1653570956923,CSE 293,013,094917,Jhala; Ranjit,9999,0,9999,0
1653570956923,CSE 293,014,094918,Kahng; Andrew Byun,9999,0,9999,0
1653570956923,CSE 293,015,094919,Kane; Daniel Mertz,9999,0,9999,0
1653570956923,CSE 293,016,094920,Kriegman; David J,9999,0,9999,0
1653570956923,CSE 293,017,094921,Kumar; Arun Kumar,9999,0,9999,0
1653570956923,CSE 293,018,094922,Lerner; Sorin,9999,0,9999,0
1653570956923,CSE 293,019,094923,Lovett; Shachar,9999,0,9999,0
1653570956923,CSE 293,020,094924,McAuley; Julian John,9999,0,9999,0
1653570956923,CSE 293,021,094925,Micciancio; Daniele,9999,0,9999,0
1653570956923,CSE 293,022,094926,Orailoglu; Alex,9999,0,9999,0
1653570956923,CSE 293,023,094927,Paturi; Ramamohan,9999,0,9999,0
1653570956923,CSE 293,024,094928,Polikarpova; Nadezhda,9999,0,9999,0
1653570956923,CSE 293,025,094929,Politz; Joseph Gibbs,9999,0,9999,0
1653570956923,CSE 293,026,094930,Porter; George M,9999,0,9999,0
1653570956923,CSE 293,027,094931,Porter; Leonard Emerson,9999,0,9999,0
1653570956923,CSE 293,028,094932,Ramamoorthi; Ravi,9999,0,9999,0
1653570956923,CSE 293,029,094933,Sahoo; Debashis,9999,0,9999,0
1653570956923,CSE 293,030,094934,Saul; Lawrence,9999,0,9999,0
1653570956923,CSE 293,031,094935,Savage; Stefan,9999,0,9999,0
1653570956923,CSE 293,032,094936,Schulze; Jurgen P.,9999,0,9999,0
1653570956923,CSE 293,033,094937,Snoeren; Alex C.,9999,0,9999,0
1653570956923,CSE 293,034,094938,Shang; Jingbo,9999,0,9999,0
1653570956923,CSE 293,035,094939,Stefan; Deian,9999,0,9999,0
1653570956923,CSE 293,036,094940,Su; Hao,9999,0,9999,0
1653570956923,CSE 293,037,094941,Swanson; Steven James,9999,0,9999,0
1653570956923,CSE 293,038,094942,Tullsen; Dean Michael,9999,0,9999,0
1653570956923,CSE 293,039,094943,Voelker; Geoffrey M.,9999,0,9999,0
1653570956923,CSE 293,040,094944,Zhao; Jishen,9999,0,9999,0
1653570956923,CSE 293,041,094945,Zhou; Yuan-Yuan,9999,0,9999,0
1653570956923,CSE 293,042,094946,Gao; Sicun,9998,0,9999,1
1653570956923,CSE 293,043,094947,Weibel; Nadir,9999,0,9999,0
1653570956923,CSE 293,044,094948,Gupta; Rajesh K.,9999,0,9999,0
1653570957452,CSE 294,A00,090143,Porter; George M,8,0,10,2
1653570957977,DSE 200,A00,091799,Staff,50,0,50,0
1653570958508,DSE 203,A00,091800,Gupta; Amarnath,30,0,30,0
1653570959038,DSE 250,A00,091801,Deutsch; Alin Bernard,30,0,30,0
1653570959565,DSE 290,A00,091802,Altintas De Callaf; Ilkay,50,0,50,0
1653570960116,ECE 200,001,091003,Antipa; Nicholas A,9999,0,9999,0
1653570960116,ECE 200,002,091004,Atanasov; Nikolay A.,9999,0,9999,0
1653570960116,ECE 200,003,091005,Bharadia; Dinesh,9999,0,9999,0
1653570960116,ECE 200,004,091006,Cheng; Chung Kuan,9999,0,9999,0
1653570960116,ECE 200,005,091007,Cosman; Pamela C.,9999,0,9999,0
1653570960116,ECE 200,006,091008,Staff,9999,0,9999,0
1653570960116,ECE 200,007,091009,Dayeh; Shadi Ahmad,9999,0,9999,0
1653570960116,ECE 200,008,091010,Fainman; Yeshaiahu,9999,0,9999,0
1653570960116,ECE 200,009,091011,Ford; Joseph Earl,9999,0,9999,0
1653570960116,ECE 200,010,091012,Franceschetti; Massimo,9999,0,9999,0
1653570960116,ECE 200,011,091013,Fullerton; Eric E,9999,0,9999,0
1653570960116,ECE 200,012,091014,Galton; Ian A,9999,0,9999,0
1653570960116,ECE 200,013,091015,Gilja; Vikash,9999,0,9999,0
1653570960116,ECE 200,014,091016,Hall; Drew A.,9999,0,9999,0
1653570960116,ECE 200,015,091017,Hsueh; Tzu-Chien,9999,0,9999,0
1653570960116,ECE 200,016,091018,Javidi; Tara,9999,0,9999,0
1653570960116,ECE 200,017,091019,Kahng; Andrew Byun,9999,0,9999,0
1653570960116,ECE 200,018,091020,Kim; Young-Han,9999,0,9999,0
1653570960116,ECE 200,019,091021,Koushanfar; Farinaz,9999,0,9999,0
1653570960116,ECE 200,020,091022,Kuzum; Duygu,9999,0,9999,0
1653570960116,ECE 200,021,091023,Le; Hanh-Phuc,9999,0,9999,0
1653570960116,ECE 200,022,091024,Lin; Bill,9999,0,9999,0
1653570960116,ECE 200,023,091025,Liu; Zhaowei,9999,0,9999,0
1653570960116,ECE 200,024,091026,Lo; Yu-Hwa,9999,0,9999,0
1653570960116,ECE 200,025,091027,Lomakin; Vitaliy,9999,0,9999,0
1653570960116,ECE 200,026,091028,Mercier; Patrick Philip,9999,0,9999,0
1653570960116,ECE 200,027,091029,Meyer; Florian,9999,0,9999,0
1653570960116,ECE 200,028,091030,Milstein; Laurence B.,9999,0,9999,0
1653570960116,ECE 200,029,091031,Mir Arabbaygi; Siavash,9999,0,9999,0
1653570960116,ECE 200,030,091032,Mookherjea; Shayan,9999,0,9999,0
1653570960116,ECE 200,031,091033,Morris; Karcher William,9999,0,9999,0
1653570960116,ECE 200,032,091034,Ng; Tse Nga,9999,0,9999,0
1653570960116,ECE 200,033,091035,Nguyen; Truong Quang,9999,0,9999,0
1653570960116,ECE 200,034,091036,Nomura; Kenji,9999,0,9999,0
1653570960116,ECE 200,035,091037,Orlitsky; Alon,9999,0,9999,0
1653570960116,ECE 200,036,091038,Pal; Piya,9999,0,9999,0
1653570960116,ECE 200,037,091039,Papen; George C.,9999,0,9999,0
1653570960116,ECE 200,038,091040,Radic; Stojan,9999,0,9999,0
1653570960116,ECE 200,039,091041,Rao; Bhaskar D.,9999,0,9999,0
1653570960116,ECE 200,040,091042,Rao; Ramesh R,9999,0,9999,0
1653570960116,ECE 200,041,091043,Rebeiz; Gabriel,9999,0,9999,0
1653570960116,ECE 200,042,091044,Sanford; John R,9999,0,9999,0
1653570960116,ECE 200,043,091045,Siegel; Paul H.,9999,0,9999,0
1653570960116,ECE 200,044,091046,Sievenpiper; Daniel F.,9999,0,9999,0
1653570960116,ECE 200,045,091047,Sworder; David D.,9999,0,9999,0
1653570960116,ECE 200,046,091048,Taur; Yuan,9999,0,9999,0
1653570960116,ECE 200,047,091049,Touri; Behrouz,9999,0,9999,0
1653570960116,ECE 200,048,091050,Trivedi; Mohan M.,9999,0,9999,0
1653570960116,ECE 200,049,091051,Vardy; Alexander,9999,0,9999,0
1653570960116,ECE 200,050,091052,Vasconcelos; Nuno,9999,0,9999,0
1653570960116,ECE 200,051,091053,Wang; Xiaolong,9999,0,9999,0
1653570960116,ECE 200,052,091054,Xie; Pengtao,9999,0,9999,0
1653570960116,ECE 200,053,091055,Yip; Michael,9999,0,9999,0
1653570960116,ECE 200,054,091056,Zeger; Kenneth A.,9999,0,9999,0
1653570960116,ECE 200,055,091057,Zhang; Xinyu,9999,0,9999,0
1653570960116,ECE 200,056,091058,Turakhia; Yatish Girish,9999,0,9999,0
1653570960116,ECE 200,057,091059,Kang; Mingu,9999,0,9999,0
1653570960116,ECE 200,058,091060,Shi; Yuanyuan,9999,0,9999,0
1653570960116,ECE 200,059,091061,Wang; Edward Jay,9999,0,9999,0
1653570960116,ECE 200,060,091062,Zheng; Yang,9999,0,9999,0
1653570960645,ECE 201,A00,095526,Lo; Yu-Hwa,0,0,0,0
1653570961170,ECE 203,A00,091065,Mercier; Patrick Philip,0,0,0,0
1653570961702,ECE 207A,A00,091605,Liu; Thomas Tao-Ming,0,0,0,0
1653570962227,ECE 212AN,A00,091068,Nomura; Kenji,0,0,0,0
1653570962752,ECE 222A,A00,091069,Rebeiz; Gabriel,0,0,0,0
1653570963280,ECE 225A,A00,091070,Orlitsky; Alon,0,0,0,0
1653570963803,ECE 230A,A00,091071,Nomura; Kenji,0,0,0,0
1653570964327,ECE 236A,A00,091072,Dayeh; Shadi Ahmad,0,0,0,0
1653570964852,ECE 238A,A00,091073,Luo; Jian,0,0,0,0
1653570964852,ECE 238A,B00,091074,Luo; Jian,0,0,0,0
1653570965381,ECE 240A,A00,091075,Radic; Stojan,0,0,0,0
1653570965911,ECE 247A,A00,091592,Shi; Lingyan,0,0,0,0
1653570966438,ECE 250,A00,091076,Touri; Behrouz,0,0,0,0
1653570966961,ECE 251C,A00,091078,Nguyen; Truong Quang,0,0,0,0
1653570967488,ECE 253,A00,091079,Cosman; Pamela C.,0,0,0,0
1653570968014,ECE 255A,A00,091080,Orlitsky; Alon,0,0,0,0
1653570968538,ECE 257A,A00,091081,Zhang; Xinyu,0,0,0,0
1653570969071,ECE 260A,A01,091084,Eldon; John,0,0,0,0
1653570969596,ECE 264C,A00,091085,Galton; Ian A,0,0,0,0
1653570970122,ECE 265C,A00,094889,Presti; Calogero Davide,0,0,0,9
1653570970653,ECE 266,A01,091087,Hall; Drew A.,0,0,0,0
1653570971700,ECE 271A,A00,091090,Vasconcelos; Nuno,0,0,0,0
1653570972228,ECE 272B,A00,091091,Sworder; David D.,0,0,0,0
1653570972753,ECE 275A,A00,091092,Meyer; Florian,0,0,0,0
1653570973279,ECE 277,A00,091093,An; Cheolhong,0,0,0,0
1653570973822,ECE 283,A00,091094,Le; Hanh-Phuc,0,0,0,0
1653570974346,ECE 284,A00,091095,Kang; Mingu,0,0,0,0
1653570974346,ECE 284,B00,091096,Wang; Edward Jay,0,0,0,0
1653570974870,ECE 285,A00,094334,Touri; Behrouz,0,0,0,0
1653570975399,ECE 289,A00,091097,Whelan; David Arthur,0,0,0,0
1653570975925,MATH 200A,A00,087414,Salehi Golsefidy; Alireza,7,0,8,1
1653570976455,MATH 202A,A00,087415,Gill; Philip E.,2,0,8,6
1653570976979,MATH 203A,A00,087416,Oprea; Dragos N.,6,0,8,2
1653570977504,MATH 204A,A00,087417,Kedlaya; Kiran S.,6,0,8,2
1653570978026,MATH 205,A00,087418,Sorensen; Claus M,6,0,8,2
1653570978549,MATH 206A,A00,087419,Izadi; Elham,7,0,8,1
1653570979080,MATH 207A,A00,087420,Mohammadi; Amir,5,0,8,3
1653570979608,MATH 208,A00,087421,Staff,9,0,10,1
1653570980131,MATH 209,A00,087422,Staff,10,0,10,0
1653570980654,MATH 218,A00,087423,Staff,10,0,10,0
1653570981183,MATH 220A,A00,087424,Novak; Jonathan I,6,0,8,2
1653570981707,MATH 231A,A00,087425,Bejenaru; Ioan,3,0,8,5
1653570982232,MATH 240A,A00,087426,Ebenfelt; Peter F,5,0,8,3
1653570982755,MATH 243,A00,087427,Staff,9,0,10,1
1653570983278,MATH 248,A00,087429,Staff,10,0,10,0
1653570983803,MATH 250A,A00,087430,Spolaor; Luca,4,0,8,4
1653570984329,MATH 257A,A00,087431,Spolaor; Luca,7,0,8,1
1653570984853,MATH 258,A00,087432,Staff,9,0,10,1
1653570985376,MATH 264A,A00,087433,Warnke; Lutz Peter,5,0,8,3
1653570985899,MATH 268,A00,087434,Staff,15,0,15,0
1653570986422,MATH 269,A00,087435,Staff,14,0,15,1
1653570986948,MATH 270A,A00,087436,Nie; Jiawang,0,0,8,8
1653570987477,MATH 272A,A00,087437,Tian; Xiaochuan,1,0,8,7
1653570988003,MATH 274,A01,087439,Cheng; Li-Tien,9,0,10,1
1653570988003,MATH 274,A02,087440,Cheng; Li-Tien,10,0,10,0
1653570988539,MATH 278A,A00,087441,Staff,8,0,10,2
1653570989077,MATH 278B,A00,087442,Staff,8,0,10,2
1653570989608,MATH 278C,A00,087443,Staff,8,0,10,2
1653570990134,MATH 280A,A00,087444,Zheng; Tianyi,0,0,8,8
1653570990657,MATH 281A,A00,087445,Bradic; Jelena,0,0,8,8
1653570991182,MATH 282A,A00,087446,Zhang; Danna,0,0,8,8
1653570991707,MATH 283,A00,087447,Tesler; Glenn,0,0,0,15
1653570992230,MATH 286,A00,087448,Kemp; Todd Aahron,5,0,8,3
1653570992762,MATH 287D,A00,087449,Bradic; Jelena,0,0,0,1
1653570993287,MATH 288,A00,087450,Staff,14,0,15,1
1653570993287,MATH 288,B00,087451,Staff,15,0,15,0
1653570993287,MATH 288,C00,087452,Staff,15,0,15,0
1653570993824,MATH 290A,A00,087453,Xu; Zhouli,6,0,8,2
1653570994347,MATH 291A,A00,087454,Xu; Zhouli,7,0,8,1
1653570994870,MATH 292,A00,087455,Staff,10,0,10,0
1653570995396,MATH 295,A00,087456,Staff,50,0,50,0
1653570995920,MATH 297,001,087457,Staff,998,0,999,1
1653571556748,COGS 200,A01,087991,Staff,47,0,50,3
1653571557285,COGS 201,A01,094504,Rangel; Lara M,17,0,25,8
1653571557810,COGS 203,A00,087992,Coulson; Seana M,18,0,20,2
1653571558347,COGS 210A,001,087993,Greene; Deanna Jacquelyn,9998,0,9999,1
1653571558347,COGS 210A,002,087994,Saygin; Ayse P,9999,0,9999,0
1653571558347,COGS 210A,003,087995,Xia; Haijun,9999,0,9999,0
1653571558347,COGS 210A,004,087996,Nitz; Douglas A.,9999,0,9999,0
1653571558347,COGS 210A,005,087997,Hollan; James D.,9999,0,9999,0
1653571558347,COGS 210A,006,087998,Deak; Gedeon O.,9998,0,9999,1
1653571558347,COGS 210A,007,087999,Rossano; Federico,9999,0,9999,0
1653571558880,COGS 211A,A00,088000,Coulson; Seana M,9997,0,9999,2
1653571559404,COGS 229,A00,088002,Staff,22,0,25,3
1653571559929,COGS 260,B00,094231,Staff,17,0,20,3
1653571559929,COGS 260,A00,088004,Nitz; Douglas A.,9998,0,9999,1
1653571560455,CSE 202,A00,090110,Paturi; Ramamohan,0,0,0,0
1653571560455,CSE 202,B00,090111,Paturi; Ramamohan,0,0,0,0
1653571560979,CSE 207B,A00,090112,Heninger; Nadia A,0,0,0,0
1653571561503,CSE 208,A00,094858,Micciancio; Daniele,0,0,0,0
1653571562027,CSE 210,A00,090113,Powell; Thomas Allan,0,0,0,0
1653571562554,CSE 219,A00,090898,Staff,0,0,0,0
1653571563077,CSE 221,A00,090114,Zhou; Yuan-Yuan,0,0,0,0
1653571563603,CSE 229A,A00,090115,Porter; George M,0,0,0,0
1653571564129,CSE 229C,A00,090116,Savage; Stefan,0,0,0,0
1653571564658,CSE 230,A00,090117,Jhala; Ranjit,0,0,0,0
1653571565185,CSE 232,A00,090118,Papakonstantinou; Yannis,0,0,0,0
1653571565720,CSE 239A,A00,090121,Kumar; Arun Kumar,0,0,0,0
1653571566245,CSE 239B,A00,090122,Jhala; Ranjit,0,0,0,0
1653571566768,CSE 240A,A00,090123,Zhao; Jishen,1,0,189,188
1653571567297,CSE 243A,A00,090124,Orailoglu; Alex,0,0,15,15
1653571567822,CSE 249B,A00,090125,Kahng; Andrew Byun,13,0,20,7
1653571568347,CSE 250A,A00,090126,Berg-Kirkpatrick; Taylor D,0,0,0,0
1653571568870,CSE 252A,A00,090127,Ochoa; Benjamin Lawrence,0,0,0,0
1653571569392,CSE 258,A01,090129,McAuley; Julian John,0,0,0,0
1653571569921,CSE 258R,A01,090131,McAuley; Julian John,0,0,0,0
1653571570445,CSE 274,A00,090132,Ramamoorthi; Ravi,0,0,0,0
1653571570974,CSE 276A,A00,090133,Christensen; Henrik I,0,0,0,0
1653571571498,CSE 276C,A00,090134,Christensen; Henrik I,0,0,0,0
1653571572030,CSE 290,A00,090135,Bafna; Vineet,0,0,0,0
1653571572030,CSE 290,B00,090136,Ramamoorthi; Ravi,0,0,0,0
1653571572030,CSE 290,C00,090137,Li; Tzumao,8,0,10,2
1653571572030,CSE 290,D00,090138,Zhou; Yuan-Yuan,9,0,10,1
1653571572030,CSE 290,E00,090139,Christensen; Henrik I,8,0,10,2
1653571572030,CSE 290,F00,094053,Shalev; Aaron D,0,0,0,0
1653571572559,CSE 291,A00,090140,Munyaka; Imani N. S.,0,0,0,0
1653571572559,CSE 291,B00,094880,Yu; Qi,0,0,0,0
1653571572559,CSE 291,C00,090142,Pannuto; Patrick William,0,0,0,0
1653571572559,CSE 291,D00,094881,Zhang; Yiying,0,0,0,0
1653571572559,CSE 291,E00,095118,Su; Hao,0,0,0,0
1653571573102,CSE 293,001,094905,Bafna; Vineet,9999,0,9999,0
1653571573102,CSE 293,002,094906,Bellare; Mihir,9999,0,9999,0
1653571573102,CSE 293,003,094907,Berg-Kirkpatrick; Taylor D,9999,0,9999,0
1653571573102,CSE 293,004,094908,Christensen; Henrik I,9999,0,9999,0
1653571573102,CSE 293,005,094909,Cottrell; Garrison W,9999,0,9999,0
1653571573102,CSE 293,006,094910,Deutsch; Alin Bernard,9999,0,9999,0
1653571573102,CSE 293,007,094911,Esmaeilzadeh; Hadi,9999,0,9999,0
1653571573102,CSE 293,008,094912,Freund; Yoav,9999,0,9999,0
1653571573102,CSE 293,009,094913,Griswold; William G.,9999,0,9999,0
1653571573102,CSE 293,010,094914,Gymrek; Melissa Ann,9999,0,9999,0
1653571573102,CSE 293,011,094915,Heninger; Nadia A,9999,0,9999,0
1653571573102,CSE 293,012,094916,Impagliazzo; Russell,9999,0,9999,0
1653571573102,CSE 293,013,094917,Jhala; Ranjit,9999,0,9999,0
1653571573102,CSE 293,014,094918,Kahng; Andrew Byun,9999,0,9999,0
1653571573102,CSE 293,015,094919,Kane; Daniel Mertz,9999,0,9999,0
1653571573102,CSE 293,016,094920,Kriegman; David J,9999,0,9999,0
1653571573102,CSE 293,017,094921,Kumar; Arun Kumar,9999,0,9999,0
1653571573102,CSE 293,018,094922,Lerner; Sorin,9999,0,9999,0
1653571573102,CSE 293,019,094923,Lovett; Shachar,9999,0,9999,0
1653571573102,CSE 293,020,094924,McAuley; Julian John,9999,0,9999,0
1653571573102,CSE 293,021,094925,Micciancio; Daniele,9999,0,9999,0
1653571573102,CSE 293,022,094926,Orailoglu; Alex,9999,0,9999,0
1653571573102,CSE 293,023,094927,Paturi; Ramamohan,9999,0,9999,0
1653571573102,CSE 293,024,094928,Polikarpova; Nadezhda,9999,0,9999,0
1653571573102,CSE 293,025,094929,Politz; Joseph Gibbs,9999,0,9999,0
1653571573102,CSE 293,026,094930,Porter; George M,9999,0,9999,0
1653571573102,CSE 293,027,094931,Porter; Leonard Emerson,9999,0,9999,0
1653571573102,CSE 293,028,094932,Ramamoorthi; Ravi,9999,0,9999,0
1653571573102,CSE 293,029,094933,Sahoo; Debashis,9999,0,9999,0
1653571573102,CSE 293,030,094934,Saul; Lawrence,9999,0,9999,0
1653571573102,CSE 293,031,094935,Savage; Stefan,9999,0,9999,0
1653571573102,CSE 293,032,094936,Schulze; Jurgen P.,9999,0,9999,0
1653571573102,CSE 293,033,094937,Snoeren; Alex C.,9999,0,9999,0
1653571573102,CSE 293,034,094938,Shang; Jingbo,9999,0,9999,0
1653571573102,CSE 293,035,094939,Stefan; Deian,9999,0,9999,0
1653571573102,CSE 293,036,094940,Su; Hao,9999,0,9999,0
1653571573102,CSE 293,037,094941,Swanson; Steven James,9999,0,9999,0
1653571573102,CSE 293,038,094942,Tullsen; Dean Michael,9999,0,9999,0
1653571573102,CSE 293,039,094943,Voelker; Geoffrey M.,9999,0,9999,0
1653571573102,CSE 293,040,094944,Zhao; Jishen,9999,0,9999,0
1653571573102,CSE 293,041,094945,Zhou; Yuan-Yuan,9999,0,9999,0
1653571573102,CSE 293,042,094946,Gao; Sicun,9998,0,9999,1
1653571573102,CSE 293,043,094947,Weibel; Nadir,9999,0,9999,0
1653571573102,CSE 293,044,094948,Gupta; Rajesh K.,9999,0,9999,0
1653571573637,CSE 294,A00,090143,Porter; George M,8,0,10,2
1653571574162,DSE 200,A00,091799,Staff,50,0,50,0
1653571574687,DSE 203,A00,091800,Gupta; Amarnath,30,0,30,0
1653571575212,DSE 250,A00,091801,Deutsch; Alin Bernard,30,0,30,0
1653571575740,DSE 290,A00,091802,Altintas De Callaf; Ilkay,50,0,50,0
1653571576303,ECE 200,001,091003,Antipa; Nicholas A,9999,0,9999,0
1653571576303,ECE 200,002,091004,Atanasov; Nikolay A.,9999,0,9999,0
1653571576303,ECE 200,003,091005,Bharadia; Dinesh,9999,0,9999,0
1653571576303,ECE 200,004,091006,Cheng; Chung Kuan,9999,0,9999,0
1653571576303,ECE 200,005,091007,Cosman; Pamela C.,9999,0,9999,0
1653571576303,ECE 200,006,091008,Staff,9999,0,9999,0
1653571576303,ECE 200,007,091009,Dayeh; Shadi Ahmad,9999,0,9999,0
1653571576303,ECE 200,008,091010,Fainman; Yeshaiahu,9999,0,9999,0
1653571576303,ECE 200,009,091011,Ford; Joseph Earl,9999,0,9999,0
1653571576303,ECE 200,010,091012,Franceschetti; Massimo,9999,0,9999,0
1653571576303,ECE 200,011,091013,Fullerton; Eric E,9999,0,9999,0
1653571576303,ECE 200,012,091014,Galton; Ian A,9999,0,9999,0
1653571576303,ECE 200,013,091015,Gilja; Vikash,9999,0,9999,0
1653571576303,ECE 200,014,091016,Hall; Drew A.,9999,0,9999,0
1653571576303,ECE 200,015,091017,Hsueh; Tzu-Chien,9999,0,9999,0
1653571576303,ECE 200,016,091018,Javidi; Tara,9999,0,9999,0
1653571576303,ECE 200,017,091019,Kahng; Andrew Byun,9999,0,9999,0
1653571576303,ECE 200,018,091020,Kim; Young-Han,9999,0,9999,0
1653571576303,ECE 200,019,091021,Koushanfar; Farinaz,9999,0,9999,0
1653571576303,ECE 200,020,091022,Kuzum; Duygu,9999,0,9999,0
1653571576303,ECE 200,021,091023,Le; Hanh-Phuc,9999,0,9999,0
1653571576303,ECE 200,022,091024,Lin; Bill,9999,0,9999,0
1653571576303,ECE 200,023,091025,Liu; Zhaowei,9999,0,9999,0
1653571576303,ECE 200,024,091026,Lo; Yu-Hwa,9999,0,9999,0
1653571576303,ECE 200,025,091027,Lomakin; Vitaliy,9999,0,9999,0
1653571576303,ECE 200,026,091028,Mercier; Patrick Philip,9999,0,9999,0
1653571576303,ECE 200,027,091029,Meyer; Florian,9999,0,9999,0
1653571576303,ECE 200,028,091030,Milstein; Laurence B.,9999,0,9999,0
1653571576303,ECE 200,029,091031,Mir Arabbaygi; Siavash,9999,0,9999,0
1653571576303,ECE 200,030,091032,Mookherjea; Shayan,9999,0,9999,0
1653571576303,ECE 200,031,091033,Morris; Karcher William,9999,0,9999,0
1653571576303,ECE 200,032,091034,Ng; Tse Nga,9999,0,9999,0
1653571576303,ECE 200,033,091035,Nguyen; Truong Quang,9999,0,9999,0
1653571576303,ECE 200,034,091036,Nomura; Kenji,9999,0,9999,0
1653571576303,ECE 200,035,091037,Orlitsky; Alon,9999,0,9999,0
1653571576303,ECE 200,036,091038,Pal; Piya,9999,0,9999,0
1653571576303,ECE 200,037,091039,Papen; George C.,9999,0,9999,0
1653571576303,ECE 200,038,091040,Radic; Stojan,9999,0,9999,0
1653571576303,ECE 200,039,091041,Rao; Bhaskar D.,9999,0,9999,0
1653571576303,ECE 200,040,091042,Rao; Ramesh R,9999,0,9999,0
1653571576303,ECE 200,041,091043,Rebeiz; Gabriel,9999,0,9999,0
1653571576303,ECE 200,042,091044,Sanford; John R,9999,0,9999,0
1653571576303,ECE 200,043,091045,Siegel; Paul H.,9999,0,9999,0
1653571576303,ECE 200,044,091046,Sievenpiper; Daniel F.,9999,0,9999,0
1653571576303,ECE 200,045,091047,Sworder; David D.,9999,0,9999,0
1653571576303,ECE 200,046,091048,Taur; Yuan,9999,0,9999,0
1653571576303,ECE 200,047,091049,Touri; Behrouz,9999,0,9999,0
1653571576303,ECE 200,048,091050,Trivedi; Mohan M.,9999,0,9999,0
1653571576303,ECE 200,049,091051,Vardy; Alexander,9999,0,9999,0
1653571576303,ECE 200,050,091052,Vasconcelos; Nuno,9999,0,9999,0
1653571576303,ECE 200,051,091053,Wang; Xiaolong,9999,0,9999,0
1653571576303,ECE 200,052,091054,Xie; Pengtao,9999,0,9999,0
1653571576303,ECE 200,053,091055,Yip; Michael,9999,0,9999,0
1653571576303,ECE 200,054,091056,Zeger; Kenneth A.,9999,0,9999,0
1653571576303,ECE 200,055,091057,Zhang; Xinyu,9999,0,9999,0
1653571576303,ECE 200,056,091058,Turakhia; Yatish Girish,9999,0,9999,0
1653571576303,ECE 200,057,091059,Kang; Mingu,9999,0,9999,0
1653571576303,ECE 200,058,091060,Shi; Yuanyuan,9999,0,9999,0
1653571576303,ECE 200,059,091061,Wang; Edward Jay,9999,0,9999,0
1653571576303,ECE 200,060,091062,Zheng; Yang,9999,0,9999,0
1653571576828,ECE 201,A00,095526,Lo; Yu-Hwa,0,0,0,0
1653571577359,ECE 203,A00,091065,Mercier; Patrick Philip,0,0,0,0
1653571577885,ECE 207A,A00,091605,Liu; Thomas Tao-Ming,0,0,0,0
1653571578410,ECE 212AN,A00,091068,Nomura; Kenji,0,0,0,0
1653571578933,ECE 222A,A00,091069,Rebeiz; Gabriel,0,0,0,0
1653571579458,ECE 225A,A00,091070,Orlitsky; Alon,0,0,0,0
1653571579983,ECE 230A,A00,091071,Nomura; Kenji,0,0,0,0
1653571580519,ECE 236A,A00,091072,Dayeh; Shadi Ahmad,0,0,0,0
1653571581071,ECE 238A,A00,091073,Luo; Jian,0,0,0,0
1653571581071,ECE 238A,B00,091074,Luo; Jian,0,0,0,0
1653571581596,ECE 240A,A00,091075,Radic; Stojan,0,0,0,0
1653571582128,ECE 247A,A00,091592,Shi; Lingyan,0,0,0,0
1653571582656,ECE 250,A00,091076,Touri; Behrouz,0,0,0,0
1653571583184,ECE 251C,A00,091078,Nguyen; Truong Quang,0,0,0,0
1653571583710,ECE 253,A00,091079,Cosman; Pamela C.,0,0,0,0
1653571584247,ECE 255A,A00,091080,Orlitsky; Alon,0,0,0,0
1653571584769,ECE 257A,A00,091081,Zhang; Xinyu,0,0,0,0
1653571585297,ECE 260A,A01,091084,Eldon; John,0,0,0,0
1653571585823,ECE 264C,A00,091085,Galton; Ian A,0,0,0,0
1653571586350,ECE 265C,A00,094889,Presti; Calogero Davide,0,0,0,9
1653571586879,ECE 266,A01,091087,Hall; Drew A.,0,0,0,0
1653571587927,ECE 271A,A00,091090,Vasconcelos; Nuno,0,0,0,0
1653571588451,ECE 272B,A00,091091,Sworder; David D.,0,0,0,0
1653571588980,ECE 275A,A00,091092,Meyer; Florian,0,0,0,0
1653571589506,ECE 277,A00,091093,An; Cheolhong,0,0,0,0
1653571590040,ECE 283,A00,091094,Le; Hanh-Phuc,0,0,0,0
1653571590571,ECE 284,A00,091095,Kang; Mingu,0,0,0,0
1653571590571,ECE 284,B00,091096,Wang; Edward Jay,0,0,0,0
1653571591096,ECE 285,A00,094334,Touri; Behrouz,0,0,0,0
1653571591620,ECE 289,A00,091097,Whelan; David Arthur,0,0,0,0
1653571592152,MATH 200A,A00,087414,Salehi Golsefidy; Alireza,7,0,8,1
1653571592682,MATH 202A,A00,087415,Gill; Philip E.,2,0,8,6
1653571593205,MATH 203A,A00,087416,Oprea; Dragos N.,6,0,8,2
1653571593728,MATH 204A,A00,087417,Kedlaya; Kiran S.,6,0,8,2
1653571594258,MATH 205,A00,087418,Sorensen; Claus M,6,0,8,2
1653571594783,MATH 206A,A00,087419,Izadi; Elham,7,0,8,1
1653571595388,MATH 207A,A00,087420,Mohammadi; Amir,5,0,8,3
1653571595912,MATH 208,A00,087421,Staff,9,0,10,1
1653571596435,MATH 209,A00,087422,Staff,10,0,10,0
1653571596973,MATH 218,A00,087423,Staff,10,0,10,0
1653571597497,MATH 220A,A00,087424,Novak; Jonathan I,6,0,8,2
1653571598036,MATH 231A,A00,087425,Bejenaru; Ioan,3,0,8,5
1653571598559,MATH 240A,A00,087426,Ebenfelt; Peter F,5,0,8,3
1653571599081,MATH 243,A00,087427,Staff,9,0,10,1
1653571599607,MATH 248,A00,087429,Staff,10,0,10,0
1653571600137,MATH 250A,A00,087430,Spolaor; Luca,4,0,8,4
1653571600665,MATH 257A,A00,087431,Spolaor; Luca,7,0,8,1
1653571601192,MATH 258,A00,087432,Staff,9,0,10,1
1653571601717,MATH 264A,A00,087433,Warnke; Lutz Peter,5,0,8,3
1653571602263,MATH 268,A00,087434,Staff,15,0,15,0
1653571602788,MATH 269,A00,087435,Staff,14,0,15,1
1653571603314,MATH 270A,A00,087436,Nie; Jiawang,0,0,8,8
1653571603846,MATH 272A,A00,087437,Tian; Xiaochuan,1,0,8,7
1653571604384,MATH 274,A01,087439,Cheng; Li-Tien,9,0,10,1
1653571604384,MATH 274,A02,087440,Cheng; Li-Tien,10,0,10,0
1653571604908,MATH 278A,A00,087441,Staff,8,0,10,2
1653571605450,MATH 278B,A00,087442,Staff,8,0,10,2
1653571605974,MATH 278C,A00,087443,Staff,8,0,10,2
1653571606497,MATH 280A,A00,087444,Zheng; Tianyi,0,0,8,8
1653571607019,MATH 281A,A00,087445,Bradic; Jelena,0,0,8,8
1653571607544,MATH 282A,A00,087446,Zhang; Danna,0,0,8,8
1653571608071,MATH 283,A00,087447,Tesler; Glenn,0,0,0,15
1653571608595,MATH 286,A00,087448,Kemp; Todd Aahron,5,0,8,3
1653571609124,MATH 287D,A00,087449,Bradic; Jelena,0,0,0,1
1653571609648,MATH 288,A00,087450,Staff,14,0,15,1
1653571609648,MATH 288,B00,087451,Staff,15,0,15,0
1653571609648,MATH 288,C00,087452,Staff,15,0,15,0
1653571610174,MATH 290A,A00,087453,Xu; Zhouli,6,0,8,2
1653571610697,MATH 291A,A00,087454,Xu; Zhouli,7,0,8,1
1653571611235,MATH 292,A00,087455,Staff,10,0,10,0
1653571611756,MATH 295,A00,087456,Staff,50,0,50,0
1653571612281,MATH 297,001,087457,Staff,998,0,999,1
1653572173934,COGS 200,A01,087991,Staff,47,0,50,3
1653572174460,COGS 201,A01,094504,Rangel; Lara M,17,0,25,8
1653572174985,COGS 203,A00,087992,Coulson; Seana M,18,0,20,2
1653572175514,COGS 210A,001,087993,Greene; Deanna Jacquelyn,9998,0,9999,1
1653572175514,COGS 210A,002,087994,Saygin; Ayse P,9999,0,9999,0
1653572175514,COGS 210A,003,087995,Xia; Haijun,9999,0,9999,0
1653572175514,COGS 210A,004,087996,Nitz; Douglas A.,9999,0,9999,0
1653572175514,COGS 210A,005,087997,Hollan; James D.,9999,0,9999,0
1653572175514,COGS 210A,006,087998,Deak; Gedeon O.,9998,0,9999,1
1653572175514,COGS 210A,007,087999,Rossano; Federico,9999,0,9999,0
1653572176038,COGS 211A,A00,088000,Coulson; Seana M,9997,0,9999,2
1653572176565,COGS 229,A00,088002,Staff,22,0,25,3
1653572177100,COGS 260,B00,094231,Staff,17,0,20,3
1653572177100,COGS 260,A00,088004,Nitz; Douglas A.,9998,0,9999,1
1653572177634,CSE 202,A00,090110,Paturi; Ramamohan,0,0,0,0
1653572177634,CSE 202,B00,090111,Paturi; Ramamohan,0,0,0,0
1653572178161,CSE 207B,A00,090112,Heninger; Nadia A,0,0,0,0
1653572178690,CSE 208,A00,094858,Micciancio; Daniele,0,0,0,0
1653572179219,CSE 210,A00,090113,Powell; Thomas Allan,0,0,0,0
1653572179750,CSE 219,A00,090898,Staff,0,0,0,0
1653572180273,CSE 221,A00,090114,Zhou; Yuan-Yuan,0,0,0,0
1653572180797,CSE 229A,A00,090115,Porter; George M,0,0,0,0
1653572181320,CSE 229C,A00,090116,Savage; Stefan,0,0,0,0
1653572181845,CSE 230,A00,090117,Jhala; Ranjit,0,0,0,0
1653572182370,CSE 232,A00,090118,Papakonstantinou; Yannis,0,0,0,0
1653572182898,CSE 239A,A00,090121,Kumar; Arun Kumar,0,0,0,0
1653572183423,CSE 239B,A00,090122,Jhala; Ranjit,0,0,0,0
1653572183952,CSE 240A,A00,090123,Zhao; Jishen,1,0,189,188
1653572184578,CSE 243A,A00,090124,Orailoglu; Alex,0,0,15,15
1653572185102,CSE 249B,A00,090125,Kahng; Andrew Byun,13,0,20,7
1653572185626,CSE 250A,A00,090126,Berg-Kirkpatrick; Taylor D,0,0,0,0
1653572186151,CSE 252A,A00,090127,Ochoa; Benjamin Lawrence,0,0,0,0
1653572186675,CSE 258,A01,090129,McAuley; Julian John,0,0,0,0
1653572187198,CSE 258R,A01,090131,McAuley; Julian John,0,0,0,0
1653572187722,CSE 274,A00,090132,Ramamoorthi; Ravi,0,0,0,0
1653572188248,CSE 276A,A00,090133,Christensen; Henrik I,0,0,0,0
1653572188772,CSE 276C,A00,090134,Christensen; Henrik I,0,0,0,0
1653572189299,CSE 290,A00,090135,Bafna; Vineet,0,0,0,0
1653572189299,CSE 290,B00,090136,Ramamoorthi; Ravi,0,0,0,0
1653572189299,CSE 290,C00,090137,Li; Tzumao,8,0,10,2
1653572189299,CSE 290,D00,090138,Zhou; Yuan-Yuan,9,0,10,1
1653572189299,CSE 290,E00,090139,Christensen; Henrik I,8,0,10,2
1653572189299,CSE 290,F00,094053,Shalev; Aaron D,0,0,0,0
1653572189836,CSE 291,A00,090140,Munyaka; Imani N. S.,0,0,0,0
1653572189836,CSE 291,B00,094880,Yu; Qi,0,0,0,0
1653572189836,CSE 291,C00,090142,Pannuto; Patrick William,0,0,0,0
1653572189836,CSE 291,D00,094881,Zhang; Yiying,0,0,0,0
1653572189836,CSE 291,E00,095118,Su; Hao,0,0,0,0
1653572190373,CSE 293,001,094905,Bafna; Vineet,9999,0,9999,0
1653572190373,CSE 293,002,094906,Bellare; Mihir,9999,0,9999,0
1653572190373,CSE 293,003,094907,Berg-Kirkpatrick; Taylor D,9999,0,9999,0
1653572190373,CSE 293,004,094908,Christensen; Henrik I,9999,0,9999,0
1653572190373,CSE 293,005,094909,Cottrell; Garrison W,9999,0,9999,0
1653572190373,CSE 293,006,094910,Deutsch; Alin Bernard,9999,0,9999,0
1653572190373,CSE 293,007,094911,Esmaeilzadeh; Hadi,9999,0,9999,0
1653572190373,CSE 293,008,094912,Freund; Yoav,9999,0,9999,0
1653572190373,CSE 293,009,094913,Griswold; William G.,9999,0,9999,0
1653572190373,CSE 293,010,094914,Gymrek; Melissa Ann,9999,0,9999,0
1653572190373,CSE 293,011,094915,Heninger; Nadia A,9999,0,9999,0
1653572190373,CSE 293,012,094916,Impagliazzo; Russell,9999,0,9999,0
1653572190373,CSE 293,013,094917,Jhala; Ranjit,9999,0,9999,0
1653572190373,CSE 293,014,094918,Kahng; Andrew Byun,9999,0,9999,0
1653572190373,CSE 293,015,094919,Kane; Daniel Mertz,9999,0,9999,0
1653572190373,CSE 293,016,094920,Kriegman; David J,9999,0,9999,0
1653572190373,CSE 293,017,094921,Kumar; Arun Kumar,9999,0,9999,0
1653572190373,CSE 293,018,094922,Lerner; Sorin,9999,0,9999,0
1653572190373,CSE 293,019,094923,Lovett; Shachar,9999,0,9999,0
1653572190373,CSE 293,020,094924,McAuley; Julian John,9999,0,9999,0
1653572190373,CSE 293,021,094925,Micciancio; Daniele,9999,0,9999,0
1653572190373,CSE 293,022,094926,Orailoglu; Alex,9999,0,9999,0
1653572190373,CSE 293,023,094927,Paturi; Ramamohan,9999,0,9999,0
1653572190373,CSE 293,024,094928,Polikarpova; Nadezhda,9999,0,9999,0
1653572190373,CSE 293,025,094929,Politz; Joseph Gibbs,9999,0,9999,0
1653572190373,CSE 293,026,094930,Porter; George M,9999,0,9999,0
1653572190373,CSE 293,027,094931,Porter; Leonard Emerson,9999,0,9999,0
1653572190373,CSE 293,028,094932,Ramamoorthi; Ravi,9999,0,9999,0
1653572190373,CSE 293,029,094933,Sahoo; Debashis,9999,0,9999,0
1653572190373,CSE 293,030,094934,Saul; Lawrence,9999,0,9999,0
1653572190373,CSE 293,031,094935,Savage; Stefan,9999,0,9999,0
1653572190373,CSE 293,032,094936,Schulze; Jurgen P.,9999,0,9999,0
1653572190373,CSE 293,033,094937,Snoeren; Alex C.,9999,0,9999,0
1653572190373,CSE 293,034,094938,Shang; Jingbo,9999,0,9999,0
1653572190373,CSE 293,035,094939,Stefan; Deian,9999,0,9999,0
1653572190373,CSE 293,036,094940,Su; Hao,9999,0,9999,0
1653572190373,CSE 293,037,094941,Swanson; Steven James,9999,0,9999,0
1653572190373,CSE 293,038,094942,Tullsen; Dean Michael,9999,0,9999,0
1653572190373,CSE 293,039,094943,Voelker; Geoffrey M.,9999,0,9999,0
1653572190373,CSE 293,040,094944,Zhao; Jishen,9999,0,9999,0
1653572190373,CSE 293,041,094945,Zhou; Yuan-Yuan,9999,0,9999,0
1653572190373,CSE 293,042,094946,Gao; Sicun,9998,0,9999,1
1653572190373,CSE 293,043,094947,Weibel; Nadir,9999,0,9999,0
1653572190373,CSE 293,044,094948,Gupta; Rajesh K.,9999,0,9999,0
1653572190902,CSE 294,A00,090143,Porter; George M,8,0,10,2
1653572191431,DSE 200,A00,091799,Staff,50,0,50,0
1653572191956,DSE 203,A00,091800,Gupta; Amarnath,30,0,30,0
1653572192483,DSE 250,A00,091801,Deutsch; Alin Bernard,30,0,30,0
1653572193009,DSE 290,A00,091802,Altintas De Callaf; Ilkay,50,0,50,0
1653572193569,ECE 200,001,091003,Antipa; Nicholas A,9999,0,9999,0
1653572193569,ECE 200,002,091004,Atanasov; Nikolay A.,9999,0,9999,0
1653572193569,ECE 200,003,091005,Bharadia; Dinesh,9999,0,9999,0
1653572193569,ECE 200,004,091006,Cheng; Chung Kuan,9999,0,9999,0
1653572193569,ECE 200,005,091007,Cosman; Pamela C.,9999,0,9999,0
1653572193569,ECE 200,006,091008,Staff,9999,0,9999,0
1653572193569,ECE 200,007,091009,Dayeh; Shadi Ahmad,9999,0,9999,0
1653572193569,ECE 200,008,091010,Fainman; Yeshaiahu,9999,0,9999,0
1653572193569,ECE 200,009,091011,Ford; Joseph Earl,9999,0,9999,0
1653572193569,ECE 200,010,091012,Franceschetti; Massimo,9999,0,9999,0
1653572193569,ECE 200,011,091013,Fullerton; Eric E,9999,0,9999,0
1653572193569,ECE 200,012,091014,Galton; Ian A,9999,0,9999,0
1653572193569,ECE 200,013,091015,Gilja; Vikash,9999,0,9999,0
1653572193569,ECE 200,014,091016,Hall; Drew A.,9999,0,9999,0
1653572193569,ECE 200,015,091017,Hsueh; Tzu-Chien,9999,0,9999,0
1653572193569,ECE 200,016,091018,Javidi; Tara,9999,0,9999,0
1653572193569,ECE 200,017,091019,Kahng; Andrew Byun,9999,0,9999,0
1653572193569,ECE 200,018,091020,Kim; Young-Han,9999,0,9999,0
1653572193569,ECE 200,019,091021,Koushanfar; Farinaz,9999,0,9999,0
1653572193569,ECE 200,020,091022,Kuzum; Duygu,9999,0,9999,0
1653572193569,ECE 200,021,091023,Le; Hanh-Phuc,9999,0,9999,0
1653572193569,ECE 200,022,091024,Lin; Bill,9999,0,9999,0
1653572193569,ECE 200,023,091025,Liu; Zhaowei,9999,0,9999,0
1653572193569,ECE 200,024,091026,Lo; Yu-Hwa,9999,0,9999,0
1653572193569,ECE 200,025,091027,Lomakin; Vitaliy,9999,0,9999,0
1653572193569,ECE 200,026,091028,Mercier; Patrick Philip,9999,0,9999,0
1653572193569,ECE 200,027,091029,Meyer; Florian,9999,0,9999,0
1653572193569,ECE 200,028,091030,Milstein; Laurence B.,9999,0,9999,0
1653572193569,ECE 200,029,091031,Mir Arabbaygi; Siavash,9999,0,9999,0
1653572193569,ECE 200,030,091032,Mookherjea; Shayan,9999,0,9999,0
1653572193569,ECE 200,031,091033,Morris; Karcher William,9999,0,9999,0
1653572193569,ECE 200,032,091034,Ng; Tse Nga,9999,0,9999,0
1653572193569,ECE 200,033,091035,Nguyen; Truong Quang,9999,0,9999,0
1653572193569,ECE 200,034,091036,Nomura; Kenji,9999,0,9999,0
1653572193569,ECE 200,035,091037,Orlitsky; Alon,9999,0,9999,0
1653572193569,ECE 200,036,091038,Pal; Piya,9999,0,9999,0
1653572193569,ECE 200,037,091039,Papen; George C.,9999,0,9999,0
1653572193569,ECE 200,038,091040,Radic; Stojan,9999,0,9999,0
1653572193569,ECE 200,039,091041,Rao; Bhaskar D.,9999,0,9999,0
1653572193569,ECE 200,040,091042,Rao; Ramesh R,9999,0,9999,0
1653572193569,ECE 200,041,091043,Rebeiz; Gabriel,9999,0,9999,0
1653572193569,ECE 200,042,091044,Sanford; John R,9999,0,9999,0
1653572193569,ECE 200,043,091045,Siegel; Paul H.,9999,0,9999,0
1653572193569,ECE 200,044,091046,Sievenpiper; Daniel F.,9999,0,9999,0
1653572193569,ECE 200,045,091047,Sworder; David D.,9999,0,9999,0
1653572193569,ECE 200,046,091048,Taur; Yuan,9999,0,9999,0
1653572193569,ECE 200,047,091049,Touri; Behrouz,9999,0,9999,0
1653572193569,ECE 200,048,091050,Trivedi; Mohan M.,9999,0,9999,0
1653572193569,ECE 200,049,091051,Vardy; Alexander,9999,0,9999,0
1653572193569,ECE 200,050,091052,Vasconcelos; Nuno,9999,0,9999,0
1653572193569,ECE 200,051,091053,Wang; Xiaolong,9999,0,9999,0
1653572193569,ECE 200,052,091054,Xie; Pengtao,9999,0,9999,0
1653572193569,ECE 200,053,091055,Yip; Michael,9999,0,9999,0
1653572193569,ECE 200,054,091056,Zeger; Kenneth A.,9999,0,9999,0
1653572193569,ECE 200,055,091057,Zhang; Xinyu,9999,0,9999,0
1653572193569,ECE 200,056,091058,Turakhia; Yatish Girish,9999,0,9999,0
1653572193569,ECE 200,057,091059,Kang; Mingu,9999,0,9999,0
1653572193569,ECE 200,058,091060,Shi; Yuanyuan,9999,0,9999,0
1653572193569,ECE 200,059,091061,Wang; Edward Jay,9999,0,9999,0
1653572193569,ECE 200,060,091062,Zheng; Yang,9999,0,9999,0
1653572194098,ECE 201,A00,095526,Lo; Yu-Hwa,0,0,0,0
1653572194643,ECE 203,A00,091065,Mercier; Patrick Philip,0,0,0,0
1653572195175,ECE 207A,A00,091605,Liu; Thomas Tao-Ming,0,0,0,0
1653572195700,ECE 212AN,A00,091068,Nomura; Kenji,0,0,0,0
1653572196227,ECE 222A,A00,091069,Rebeiz; Gabriel,0,0,0,0
1653572196755,ECE 225A,A00,091070,Orlitsky; Alon,0,0,0,0
1653572197296,ECE 230A,A00,091071,Nomura; Kenji,0,0,0,0
1653572197821,ECE 236A,A00,091072,Dayeh; Shadi Ahmad,0,0,0,0
1653572198353,ECE 238A,A00,091073,Luo; Jian,0,0,0,0
1653572198353,ECE 238A,B00,091074,Luo; Jian,0,0,0,0
1653572198883,ECE 240A,A00,091075,Radic; Stojan,0,0,0,0
1653572199412,ECE 247A,A00,091592,Shi; Lingyan,0,0,0,0
1653572199940,ECE 250,A00,091076,Touri; Behrouz,0,0,0,0
1653572200464,ECE 251C,A00,091078,Nguyen; Truong Quang,0,0,0,0
1653572200992,ECE 253,A00,091079,Cosman; Pamela C.,0,0,0,0
1653572201535,ECE 255A,A00,091080,Orlitsky; Alon,0,0,0,0
1653572202064,ECE 257A,A00,091081,Zhang; Xinyu,0,0,0,0
1653572202591,ECE 260A,A01,091084,Eldon; John,0,0,0,0
1653572203116,ECE 264C,A00,091085,Galton; Ian A,0,0,0,0
1653572203651,ECE 265C,A00,094889,Presti; Calogero Davide,0,0,0,9
1653572204194,ECE 266,A01,091087,Hall; Drew A.,0,0,0,0
1653572205258,ECE 271A,A00,091090,Vasconcelos; Nuno,0,0,0,0
1653572205782,ECE 272B,A00,091091,Sworder; David D.,0,0,0,0
1653572206305,ECE 275A,A00,091092,Meyer; Florian,0,0,0,0
1653572206828,ECE 277,A00,091093,An; Cheolhong,0,0,0,0
1653572207356,ECE 283,A00,091094,Le; Hanh-Phuc,0,0,0,0
1653572207886,ECE 284,A00,091095,Kang; Mingu,0,0,0,0
1653572207886,ECE 284,B00,091096,Wang; Edward Jay,0,0,0,0
1653572208411,ECE 285,A00,094334,Touri; Behrouz,0,0,0,0
1653572208935,ECE 289,A00,091097,Whelan; David Arthur,0,0,0,0
1653572209460,MATH 200A,A00,087414,Salehi Golsefidy; Alireza,7,0,8,1
1653572209988,MATH 202A,A00,087415,Gill; Philip E.,2,0,8,6
1653572210517,MATH 203A,A00,087416,Oprea; Dragos N.,6,0,8,2
1653572211041,MATH 204A,A00,087417,Kedlaya; Kiran S.,6,0,8,2
1653572211564,MATH 205,A00,087418,Sorensen; Claus M,6,0,8,2
1653572212091,MATH 206A,A00,087419,Izadi; Elham,7,0,8,1
1653572212616,MATH 207A,A00,087420,Mohammadi; Amir,5,0,8,3
1653572213139,MATH 208,A00,087421,Staff,9,0,10,1
1653572213663,MATH 209,A00,087422,Staff,10,0,10,0
1653572214190,MATH 218,A00,087423,Staff,10,0,10,0
1653572214714,MATH 220A,A00,087424,Novak; Jonathan I,6,0,8,2
1653572215238,MATH 231A,A00,087425,Bejenaru; Ioan,3,0,8,5
1653572215771,MATH 240A,A00,087426,Ebenfelt; Peter F,5,0,8,3
1653572216294,MATH 243,A00,087427,Staff,9,0,10,1
1653572216820,MATH 248,A00,087429,Staff,10,0,10,0
1653572217347,MATH 250A,A00,087430,Spolaor; Luca,4,0,8,4
1653572217871,MATH 257A,A00,087431,Spolaor; Luca,7,0,8,1
1653572218401,MATH 258,A00,087432,Staff,9,0,10,1
1653572218929,MATH 264A,A00,087433,Warnke; Lutz Peter,5,0,8,3
1653572219453,MATH 268,A00,087434,Staff,15,0,15,0
1653572219976,MATH 269,A00,087435,Staff,14,0,15,1
1653572220501,MATH 270A,A00,087436,Nie; Jiawang,0,0,8,8
1653572221030,MATH 272A,A00,087437,Tian; Xiaochuan,1,0,8,7
1653572221557,MATH 274,A01,087439,Cheng; Li-Tien,9,0,10,1
1653572221557,MATH 274,A02,087440,Cheng; Li-Tien,10,0,10,0
1653572222084,MATH 278A,A00,087441,Staff,8,0,10,2
1653572222609,MATH 278B,A00,087442,Staff,8,0,10,2
1653572223137,MATH 278C,A00,087443,Staff,8,0,10,2
1653572223660,MATH 280A,A00,087444,Zheng; Tianyi,0,0,8,8
1653572224186,MATH 281A,A00,087445,Bradic; Jelena,0,0,8,8
1653572224717,MATH 282A,A00,087446,Zhang; Danna,0,0,8,8
1653572225244,MATH 283,A00,087447,Tesler; Glenn,0,0,0,15
1653572225768,MATH 286,A00,087448,Kemp; Todd Aahron,5,0,8,3
1653572226289,MATH 287D,A00,087449,Bradic; Jelena,0,0,0,1
1653572226817,MATH 288,A00,087450,Staff,14,0,15,1
1653572226817,MATH 288,B00,087451,Staff,15,0,15,0
1653572226817,MATH 288,C00,087452,Staff,15,0,15,0
1653572227344,MATH 290A,A00,087453,Xu; Zhouli,6,0,8,2
1653572227871,MATH 291A,A00,087454,Xu; Zhouli,7,0,8,1
1653572228404,MATH 292,A00,087455,Staff,10,0,10,0
1653572228927,MATH 295,A00,087456,Staff,50,0,50,0
1653572229458,MATH 297,001,087457,Staff,998,0,999,1
1653572791050,COGS 200,A01,087991,Staff,47,0,50,3
1653572791574,COGS 201,A01,094504,Rangel; Lara M,17,0,25,8
1653572792105,COGS 203,A00,087992,Coulson; Seana M,18,0,20,2
1653572792632,COGS 210A,001,087993,Greene; Deanna Jacquelyn,9998,0,9999,1
1653572792632,COGS 210A,002,087994,Saygin; Ayse P,9999,0,9999,0
1653572792632,COGS 210A,003,087995,Xia; Haijun,9999,0,9999,0
1653572792632,COGS 210A,004,087996,Nitz; Douglas A.,9999,0,9999,0
1653572792632,COGS 210A,005,087997,Hollan; James D.,9999,0,9999,0
1653572792632,COGS 210A,006,087998,Deak; Gedeon O.,9998,0,9999,1
1653572792632,COGS 210A,007,087999,Rossano; Federico,9999,0,9999,0
1653572793158,COGS 211A,A00,088000,Coulson; Seana M,9997,0,9999,2
1653572793685,COGS 229,A00,088002,Staff,22,0,25,3
1653572794212,COGS 260,B00,094231,Staff,17,0,20,3
1653572794212,COGS 260,A00,088004,Nitz; Douglas A.,9998,0,9999,1
1653572794744,CSE 202,A00,090110,Paturi; Ramamohan,0,0,0,0
1653572794744,CSE 202,B00,090111,Paturi; Ramamohan,0,0,0,0
1653572795270,CSE 207B,A00,090112,Heninger; Nadia A,0,0,0,0
1653572795794,CSE 208,A00,094858,Micciancio; Daniele,0,0,0,0
1653572796321,CSE 210,A00,090113,Powell; Thomas Allan,0,0,0,0
1653572796845,CSE 219,A00,090898,Staff,0,0,0,0
1653572797369,CSE 221,A00,090114,Zhou; Yuan-Yuan,0,0,0,0
1653572797894,CSE 229A,A00,090115,Porter; George M,0,0,0,0
1653572798425,CSE 229C,A00,090116,Savage; Stefan,0,0,0,0
1653572798948,CSE 230,A00,090117,Jhala; Ranjit,0,0,0,0
1653572799483,CSE 232,A00,090118,Papakonstantinou; Yannis,0,0,0,0
1653572800018,CSE 239A,A00,090121,Kumar; Arun Kumar,0,0,0,0
1653572800547,CSE 239B,A00,090122,Jhala; Ranjit,0,0,0,0
1653572801070,CSE 240A,A00,090123,Zhao; Jishen,1,0,189,188
1653572801593,CSE 243A,A00,090124,Orailoglu; Alex,0,0,15,15
1653572802117,CSE 249B,A00,090125,Kahng; Andrew Byun,13,0,20,7
1653572802643,CSE 250A,A00,090126,Berg-Kirkpatrick; Taylor D,0,0,0,0
1653572803167,CSE 252A,A00,090127,Ochoa; Benjamin Lawrence,0,0,0,0
1653572803691,CSE 258,A01,090129,McAuley; Julian John,0,0,0,0
1653572804215,CSE 258R,A01,090131,McAuley; Julian John,0,0,0,0
1653572804739,CSE 274,A00,090132,Ramamoorthi; Ravi,0,0,0,0
1653572805265,CSE 276A,A00,090133,Christensen; Henrik I,0,0,0,0
1653572805789,CSE 276C,A00,090134,Christensen; Henrik I,0,0,0,0
1653572806329,CSE 290,A00,090135,Bafna; Vineet,0,0,0,0
1653572806329,CSE 290,B00,090136,Ramamoorthi; Ravi,0,0,0,0
1653572806329,CSE 290,C00,090137,Li; Tzumao,8,0,10,2
1653572806329,CSE 290,D00,090138,Zhou; Yuan-Yuan,9,0,10,1
1653572806329,CSE 290,E00,090139,Christensen; Henrik I,8,0,10,2
1653572806329,CSE 290,F00,094053,Shalev; Aaron D,0,0,0,0
1653572806870,CSE 291,A00,090140,Munyaka; Imani N. S.,0,0,0,0
1653572806870,CSE 291,B00,094880,Yu; Qi,0,0,0,0
1653572806870,CSE 291,C00,090142,Pannuto; Patrick William,0,0,0,0
1653572806870,CSE 291,D00,094881,Zhang; Yiying,0,0,0,0
1653572806870,CSE 291,E00,095118,Su; Hao,0,0,0,0
1653572807432,CSE 293,001,094905,Bafna; Vineet,9999,0,9999,0
1653572807432,CSE 293,002,094906,Bellare; Mihir,9999,0,9999,0
1653572807432,CSE 293,003,094907,Berg-Kirkpatrick; Taylor D,9999,0,9999,0
1653572807432,CSE 293,004,094908,Christensen; Henrik I,9999,0,9999,0
1653572807432,CSE 293,005,094909,Cottrell; Garrison W,9999,0,9999,0
1653572807432,CSE 293,006,094910,Deutsch; Alin Bernard,9999,0,9999,0
1653572807432,CSE 293,007,094911,Esmaeilzadeh; Hadi,9999,0,9999,0
1653572807432,CSE 293,008,094912,Freund; Yoav,9999,0,9999,0
1653572807432,CSE 293,009,094913,Griswold; William G.,9999,0,9999,0
1653572807432,CSE 293,010,094914,Gymrek; Melissa Ann,9999,0,9999,0
1653572807432,CSE 293,011,094915,Heninger; Nadia A,9999,0,9999,0
1653572807432,CSE 293,012,094916,Impagliazzo; Russell,9999,0,9999,0
1653572807432,CSE 293,013,094917,Jhala; Ranjit,9999,0,9999,0
1653572807432,CSE 293,014,094918,Kahng; Andrew Byun,9999,0,9999,0
1653572807432,CSE 293,015,094919,Kane; Daniel Mertz,9999,0,9999,0
1653572807432,CSE 293,016,094920,Kriegman; David J,9999,0,9999,0
1653572807432,CSE 293,017,094921,Kumar; Arun Kumar,9999,0,9999,0
1653572807432,CSE 293,018,094922,Lerner; Sorin,9999,0,9999,0
1653572807432,CSE 293,019,094923,Lovett; Shachar,9999,0,9999,0
1653572807432,CSE 293,020,094924,McAuley; Julian John,9999,0,9999,0
1653572807432,CSE 293,021,094925,Micciancio; Daniele,9999,0,9999,0
1653572807432,CSE 293,022,094926,Orailoglu; Alex,9999,0,9999,0
1653572807432,CSE 293,023,094927,Paturi; Ramamohan,9999,0,9999,0
1653572807432,CSE 293,024,094928,Polikarpova; Nadezhda,9999,0,9999,0
1653572807432,CSE 293,025,094929,Politz; Joseph Gibbs,9999,0,9999,0
1653572807432,CSE 293,026,094930,Porter; George M,9999,0,9999,0
1653572807432,CSE 293,027,094931,Porter; Leonard Emerson,9999,0,9999,0
1653572807432,CSE 293,028,094932,Ramamoorthi; Ravi,9999,0,9999,0
1653572807432,CSE 293,029,094933,Sahoo; Debashis,9999,0,9999,0
1653572807432,CSE 293,030,094934,Saul; Lawrence,9999,0,9999,0
1653572807432,CSE 293,031,094935,Savage; Stefan,9999,0,9999,0
1653572807432,CSE 293,032,094936,Schulze; Jurgen P.,9999,0,9999,0
1653572807432,CSE 293,033,094937,Snoeren; Alex C.,9999,0,9999,0
1653572807432,CSE 293,034,094938,Shang; Jingbo,9999,0,9999,0
1653572807432,CSE 293,035,094939,Stefan; Deian,9999,0,9999,0
1653572807432,CSE 293,036,094940,Su; Hao,9999,0,9999,0
1653572807432,CSE 293,037,094941,Swanson; Steven James,9999,0,9999,0
1653572807432,CSE 293,038,094942,Tullsen; Dean Michael,9999,0,9999,0
1653572807432,CSE 293,039,094943,Voelker; Geoffrey M.,9999,0,9999,0
1653572807432,CSE 293,040,094944,Zhao; Jishen,9999,0,9999,0
1653572807432,CSE 293,041,094945,Zhou; Yuan-Yuan,9999,0,9999,0
1653572807432,CSE 293,042,094946,Gao; Sicun,9998,0,9999,1
1653572807432,CSE 293,043,094947,Weibel; Nadir,9999,0,9999,0
1653572807432,CSE 293,044,094948,Gupta; Rajesh K.,9999,0,9999,0
1653572807956,CSE 294,A00,090143,Porter; George M,8,0,10,2
1653572808484,DSE 200,A00,091799,Staff,50,0,50,0
1653572809010,DSE 203,A00,091800,Gupta; Amarnath,30,0,30,0
1653572809546,DSE 250,A00,091801,Deutsch; Alin Bernard,30,0,30,0
1653572810081,DSE 290,A00,091802,Altintas De Callaf; Ilkay,50,0,50,0
1653572810648,ECE 200,001,091003,Antipa; Nicholas A,9999,0,9999,0
1653572810648,ECE 200,002,091004,Atanasov; Nikolay A.,9999,0,9999,0
1653572810648,ECE 200,003,091005,Bharadia; Dinesh,9999,0,9999,0
1653572810648,ECE 200,004,091006,Cheng; Chung Kuan,9999,0,9999,0
1653572810648,ECE 200,005,091007,Cosman; Pamela C.,9999,0,9999,0
1653572810648,ECE 200,006,091008,Staff,9999,0,9999,0
1653572810648,ECE 200,007,091009,Dayeh; Shadi Ahmad,9999,0,9999,0
1653572810648,ECE 200,008,091010,Fainman; Yeshaiahu,9999,0,9999,0
1653572810648,ECE 200,009,091011,Ford; Joseph Earl,9999,0,9999,0
1653572810648,ECE 200,010,091012,Franceschetti; Massimo,9999,0,9999,0
1653572810648,ECE 200,011,091013,Fullerton; Eric E,9999,0,9999,0
1653572810648,ECE 200,012,091014,Galton; Ian A,9999,0,9999,0
1653572810648,ECE 200,013,091015,Gilja; Vikash,9999,0,9999,0
1653572810648,ECE 200,014,091016,Hall; Drew A.,9999,0,9999,0
1653572810648,ECE 200,015,091017,Hsueh; Tzu-Chien,9999,0,9999,0
1653572810648,ECE 200,016,091018,Javidi; Tara,9999,0,9999,0
1653572810648,ECE 200,017,091019,Kahng; Andrew Byun,9999,0,9999,0
1653572810648,ECE 200,018,091020,Kim; Young-Han,9999,0,9999,0
1653572810648,ECE 200,019,091021,Koushanfar; Farinaz,9999,0,9999,0
1653572810648,ECE 200,020,091022,Kuzum; Duygu,9999,0,9999,0
1653572810648,ECE 200,021,091023,Le; Hanh-Phuc,9999,0,9999,0
1653572810648,ECE 200,022,091024,Lin; Bill,9999,0,9999,0
1653572810648,ECE 200,023,091025,Liu; Zhaowei,9999,0,9999,0
1653572810648,ECE 200,024,091026,Lo; Yu-Hwa,9999,0,9999,0
1653572810648,ECE 200,025,091027,Lomakin; Vitaliy,9999,0,9999,0
1653572810648,ECE 200,026,091028,Mercier; Patrick Philip,9999,0,9999,0
1653572810648,ECE 200,027,091029,Meyer; Florian,9999,0,9999,0
1653572810648,ECE 200,028,091030,Milstein; Laurence B.,9999,0,9999,0
1653572810648,ECE 200,029,091031,Mir Arabbaygi; Siavash,9999,0,9999,0
1653572810648,ECE 200,030,091032,Mookherjea; Shayan,9999,0,9999,0
1653572810648,ECE 200,031,091033,Morris; Karcher William,9999,0,9999,0
1653572810648,ECE 200,032,091034,Ng; Tse Nga,9999,0,9999,0
1653572810648,ECE 200,033,091035,Nguyen; Truong Quang,9999,0,9999,0
1653572810648,ECE 200,034,091036,Nomura; Kenji,9999,0,9999,0
1653572810648,ECE 200,035,091037,Orlitsky; Alon,9999,0,9999,0
1653572810648,ECE 200,036,091038,Pal; Piya,9999,0,9999,0
1653572810648,ECE 200,037,091039,Papen; George C.,9999,0,9999,0
1653572810648,ECE 200,038,091040,Radic; Stojan,9999,0,9999,0
1653572810648,ECE 200,039,091041,Rao; Bhaskar D.,9999,0,9999,0
1653572810648,ECE 200,040,091042,Rao; Ramesh R,9999,0,9999,0
1653572810648,ECE 200,041,091043,Rebeiz; Gabriel,9999,0,9999,0
1653572810648,ECE 200,042,091044,Sanford; John R,9999,0,9999,0
1653572810648,ECE 200,043,091045,Siegel; Paul H.,9999,0,9999,0
1653572810648,ECE 200,044,091046,Sievenpiper; Daniel F.,9999,0,9999,0
1653572810648,ECE 200,045,091047,Sworder; David D.,9999,0,9999,0
1653572810648,ECE 200,046,091048,Taur; Yuan,9999,0,9999,0
1653572810648,ECE 200,047,091049,Touri; Behrouz,9999,0,9999,0
1653572810648,ECE 200,048,091050,Trivedi; Mohan M.,9999,0,9999,0
1653572810648,ECE 200,049,091051,Vardy; Alexander,9999,0,9999,0
1653572810648,ECE 200,050,091052,Vasconcelos; Nuno,9999,0,9999,0
1653572810648,ECE 200,051,091053,Wang; Xiaolong,9999,0,9999,0
1653572810648,ECE 200,052,091054,Xie; Pengtao,9999,0,9999,0
1653572810648,ECE 200,053,091055,Yip; Michael,9999,0,9999,0
1653572810648,ECE 200,054,091056,Zeger; Kenneth A.,9999,0,9999,0
1653572810648,ECE 200,055,091057,Zhang; Xinyu,9999,0,9999,0
1653572810648,ECE 200,056,091058,Turakhia; Yatish Girish,9999,0,9999,0
1653572810648,ECE 200,057,091059,Kang; Mingu,9999,0,9999,0
1653572810648,ECE 200,058,091060,Shi; Yuanyuan,9999,0,9999,0
1653572810648,ECE 200,059,091061,Wang; Edward Jay,9999,0,9999,0
1653572810648,ECE 200,060,091062,Zheng; Yang,9999,0,9999,0
1653572811174,ECE 201,A00,095526,Lo; Yu-Hwa,0,0,0,0
1653572811705,ECE 203,A00,091065,Mercier; Patrick Philip,0,0,0,0
1653572812230,ECE 207A,A00,091605,Liu; Thomas Tao-Ming,0,0,0,0
1653572812760,ECE 212AN,A00,091068,Nomura; Kenji,0,0,0,0
1653572813284,ECE 222A,A00,091069,Rebeiz; Gabriel,0,0,0,0
1653572813816,ECE 225A,A00,091070,Orlitsky; Alon,0,0,0,0
1653572814339,ECE 230A,A00,091071,Nomura; Kenji,0,0,0,0
1653572814867,ECE 236A,A00,091072,Dayeh; Shadi Ahmad,0,0,0,0
1653572815404,ECE 238A,A00,091073,Luo; Jian,0,0,0,0
1653572815404,ECE 238A,B00,091074,Luo; Jian,0,0,0,0
1653572815928,ECE 240A,A00,091075,Radic; Stojan,0,0,0,0
1653572816455,ECE 247A,A00,091592,Shi; Lingyan,0,0,0,0
1653572816983,ECE 250,A00,091076,Touri; Behrouz,0,0,0,0
1653572817510,ECE 251C,A00,091078,Nguyen; Truong Quang,0,0,0,0
1653572818034,ECE 253,A00,091079,Cosman; Pamela C.,0,0,0,0
1653572818557,ECE 255A,A00,091080,Orlitsky; Alon,0,0,0,0
1653572819085,ECE 257A,A00,091081,Zhang; Xinyu,0,0,0,0
1653572819610,ECE 260A,A01,091084,Eldon; John,0,0,0,0
1653572820139,ECE 264C,A00,091085,Galton; Ian A,0,0,0,0
1653572820665,ECE 265C,A00,094889,Presti; Calogero Davide,0,0,0,9
1653572821192,ECE 266,A01,091087,Hall; Drew A.,0,0,0,0
1653572822240,ECE 271A,A00,091090,Vasconcelos; Nuno,0,0,0,0
1653572822764,ECE 272B,A00,091091,Sworder; David D.,0,0,0,0
1653572823299,ECE 275A,A00,091092,Meyer; Florian,0,0,0,0
1653572823827,ECE 277,A00,091093,An; Cheolhong,0,0,0,0
1653572824355,ECE 283,A00,091094,Le; Hanh-Phuc,0,0,0,0
1653572824880,ECE 284,A00,091095,Kang; Mingu,0,0,0,0
1653572824880,ECE 284,B00,091096,Wang; Edward Jay,0,0,0,0
1653572825408,ECE 285,A00,094334,Touri; Behrouz,0,0,0,0
1653572825937,ECE 289,A00,091097,Whelan; David Arthur,0,0,0,0
1653572826462,MATH 200A,A00,087414,Salehi Golsefidy; Alireza,7,0,8,1
1653572827084,MATH 202A,A00,087415,Gill; Philip E.,2,0,8,6
1653572827609,MATH 203A,A00,087416,Oprea; Dragos N.,6,0,8,2
1653572828135,MATH 204A,A00,087417,Kedlaya; Kiran S.,6,0,8,2
1653572828663,MATH 205,A00,087418,Sorensen; Claus M,6,0,8,2
1653572829185,MATH 206A,A00,087419,Izadi; Elham,7,0,8,1
1653572829708,MATH 207A,A00,087420,Mohammadi; Amir,5,0,8,3
1653572830234,MATH 208,A00,087421,Staff,9,0,10,1
1653572830757,MATH 209,A00,087422,Staff,10,0,10,0
1653572831282,MATH 218,A00,087423,Staff,10,0,10,0
1653572831814,MATH 220A,A00,087424,Novak; Jonathan I,6,0,8,2
1653572832338,MATH 231A,A00,087425,Bejenaru; Ioan,3,0,8,5
1653572832873,MATH 240A,A00,087426,Ebenfelt; Peter F,5,0,8,3
1653572833396,MATH 243,A00,087427,Staff,9,0,10,1
1653572833919,MATH 248,A00,087429,Staff,10,0,10,0
1653572834442,MATH 250A,A00,087430,Spolaor; Luca,4,0,8,4
1653572834965,MATH 257A,A00,087431,Spolaor; Luca,7,0,8,1
1653572835491,MATH 258,A00,087432,Staff,9,0,10,1
1653572836014,MATH 264A,A00,087433,Warnke; Lutz Peter,5,0,8,3
1653572836537,MATH 268,A00,087434,Staff,15,0,15,0
1653572837059,MATH 269,A00,087435,Staff,14,0,15,1
1653572837581,MATH 270A,A00,087436,Nie; Jiawang,0,0,8,8
1653572838103,MATH 272A,A00,087437,Tian; Xiaochuan,1,0,8,7
1653572838627,MATH 274,A01,087439,Cheng; Li-Tien,9,0,10,1
1653572838627,MATH 274,A02,087440,Cheng; Li-Tien,10,0,10,0
1653572839149,MATH 278A,A00,087441,Staff,8,0,10,2
1653572839672,MATH 278B,A00,087442,Staff,8,0,10,2
1653572840198,MATH 278C,A00,087443,Staff,8,0,10,2
1653572840721,MATH 280A,A00,087444,Zheng; Tianyi,0,0,8,8
1653572841248,MATH 281A,A00,087445,Bradic; Jelena,0,0,8,8
1653572841775,MATH 282A,A00,087446,Zhang; Danna,0,0,8,8
1653572842298,MATH 283,A00,087447,Tesler; Glenn,0,0,0,15
1653572842824,MATH 286,A00,087448,Kemp; Todd Aahron,5,0,8,3
1653572843351,MATH 287D,A00,087449,Bradic; Jelena,0,0,0,1
1653572843874,MATH 288,A00,087450,Staff,14,0,15,1
1653572843874,MATH 288,B00,087451,Staff,15,0,15,0
1653572843874,MATH 288,C00,087452,Staff,15,0,15,0
1653572844396,MATH 290A,A00,087453,Xu; Zhouli,6,0,8,2
1653572844920,MATH 291A,A00,087454,Xu; Zhouli,7,0,8,1
1653572845442,MATH 292,A00,087455,Staff,10,0,10,0
1653572845967,MATH 295,A00,087456,Staff,50,0,50,0
1653572846492,MATH 297,001,087457,Staff,998,0,999,1
1653573406666,COGS 200,A01,087991,Staff,47,0,50,3
1653573407192,COGS 201,A01,094504,Rangel; Lara M,17,0,25,8
1653573407719,COGS 203,A00,087992,Coulson; Seana M,18,0,20,2
1653573408244,COGS 210A,001,087993,Greene; Deanna Jacquelyn,9998,0,9999,1
1653573408244,COGS 210A,002,087994,Saygin; Ayse P,9999,0,9999,0
1653573408244,COGS 210A,003,087995,Xia; Haijun,9999,0,9999,0
1653573408244,COGS 210A,004,087996,Nitz; Douglas A.,9999,0,9999,0
1653573408244,COGS 210A,005,087997,Hollan; James D.,9999,0,9999,0
1653573408244,COGS 210A,006,087998,Deak; Gedeon O.,9998,0,9999,1
1653573408244,COGS 210A,007,087999,Rossano; Federico,9999,0,9999,0
1653573408772,COGS 211A,A00,088000,Coulson; Seana M,9997,0,9999,2
1653573409297,COGS 229,A00,088002,Staff,22,0,25,3
1653573409825,COGS 260,B00,094231,Staff,17,0,20,3
1653573409825,COGS 260,A00,088004,Nitz; Douglas A.,9998,0,9999,1
1653573410350,CSE 202,A00,090110,Paturi; Ramamohan,0,0,0,0
1653573410350,CSE 202,B00,090111,Paturi; Ramamohan,0,0,0,0
1653573410876,CSE 207B,A00,090112,Heninger; Nadia A,0,0,0,0
1653573411400,CSE 208,A00,094858,Micciancio; Daniele,0,0,0,0
1653573411924,CSE 210,A00,090113,Powell; Thomas Allan,0,0,0,0
1653573412446,CSE 219,A00,090898,Staff,0,0,0,0
1653573412970,CSE 221,A00,090114,Zhou; Yuan-Yuan,0,0,0,0
1653573413493,CSE 229A,A00,090115,Porter; George M,0,0,0,0
1653573414016,CSE 229C,A00,090116,Savage; Stefan,0,0,0,0
1653573414638,CSE 230,A00,090117,Jhala; Ranjit,0,0,0,0
1653573415162,CSE 232,A00,090118,Papakonstantinou; Yannis,0,0,0,0
1653573415690,CSE 239A,A00,090121,Kumar; Arun Kumar,0,0,0,0
1653573416217,CSE 239B,A00,090122,Jhala; Ranjit,0,0,0,0
1653573416753,CSE 240A,A00,090123,Zhao; Jishen,1,0,189,188
1653573417277,CSE 243A,A00,090124,Orailoglu; Alex,0,0,15,15
1653573417801,CSE 249B,A00,090125,Kahng; Andrew Byun,13,0,20,7
1653573418333,CSE 250A,A00,090126,Berg-Kirkpatrick; Taylor D,0,0,0,0
1653573418858,CSE 252A,A00,090127,Ochoa; Benjamin Lawrence,0,0,0,0
1653573419383,CSE 258,A01,090129,McAuley; Julian John,0,0,0,0
1653573419907,CSE 258R,A01,090131,McAuley; Julian John,0,0,0,0
1653573420435,CSE 274,A00,090132,Ramamoorthi; Ravi,0,0,0,0
1653573420962,CSE 276A,A00,090133,Christensen; Henrik I,0,0,0,0
1653573421503,CSE 276C,A00,090134,Christensen; Henrik I,0,0,0,0
1653573422035,CSE 290,A00,090135,Bafna; Vineet,0,0,0,0
1653573422035,CSE 290,B00,090136,Ramamoorthi; Ravi,0,0,0,0
1653573422035,CSE 290,C00,090137,Li; Tzumao,8,0,10,2
1653573422035,CSE 290,D00,090138,Zhou; Yuan-Yuan,9,0,10,1
1653573422035,CSE 290,E00,090139,Christensen; Henrik I,8,0,10,2
1653573422035,CSE 290,F00,094053,Shalev; Aaron D,0,0,0,0
1653573422568,CSE 291,A00,090140,Munyaka; Imani N. S.,0,0,0,0
1653573422568,CSE 291,B00,094880,Yu; Qi,0,0,0,0
1653573422568,CSE 291,C00,090142,Pannuto; Patrick William,0,0,0,0
1653573422568,CSE 291,D00,094881,Zhang; Yiying,0,0,0,0
1653573422568,CSE 291,E00,095118,Su; Hao,0,0,0,0
1653573423122,CSE 293,001,094905,Bafna; Vineet,9999,0,9999,0
1653573423122,CSE 293,002,094906,Bellare; Mihir,9999,0,9999,0
1653573423122,CSE 293,003,094907,Berg-Kirkpatrick; Taylor D,9999,0,9999,0
1653573423122,CSE 293,004,094908,Christensen; Henrik I,9999,0,9999,0
1653573423122,CSE 293,005,094909,Cottrell; Garrison W,9999,0,9999,0
1653573423122,CSE 293,006,094910,Deutsch; Alin Bernard,9999,0,9999,0
1653573423122,CSE 293,007,094911,Esmaeilzadeh; Hadi,9999,0,9999,0
1653573423122,CSE 293,008,094912,Freund; Yoav,9999,0,9999,0
1653573423122,CSE 293,009,094913,Griswold; William G.,9999,0,9999,0
1653573423122,CSE 293,010,094914,Gymrek; Melissa Ann,9999,0,9999,0
1653573423122,CSE 293,011,094915,Heninger; Nadia A,9999,0,9999,0
1653573423122,CSE 293,012,094916,Impagliazzo; Russell,9999,0,9999,0
1653573423122,CSE 293,013,094917,Jhala; Ranjit,9999,0,9999,0
1653573423122,CSE 293,014,094918,Kahng; Andrew Byun,9999,0,9999,0
1653573423122,CSE 293,015,094919,Kane; Daniel Mertz,9999,0,9999,0
1653573423122,CSE 293,016,094920,Kriegman; David J,9999,0,9999,0
1653573423122,CSE 293,017,094921,Kumar; Arun Kumar,9999,0,9999,0
1653573423122,CSE 293,018,094922,Lerner; Sorin,9999,0,9999,0
1653573423122,CSE 293,019,094923,Lovett; Shachar,9999,0,9999,0
1653573423122,CSE 293,020,094924,McAuley; Julian John,9999,0,9999,0
1653573423122,CSE 293,021,094925,Micciancio; Daniele,9999,0,9999,0
1653573423122,CSE 293,022,094926,Orailoglu; Alex,9999,0,9999,0
1653573423122,CSE 293,023,094927,Paturi; Ramamohan,9999,0,9999,0
1653573423122,CSE 293,024,094928,Polikarpova; Nadezhda,9999,0,9999,0
1653573423122,CSE 293,025,094929,Politz; Joseph Gibbs,9999,0,9999,0
1653573423122,CSE 293,026,094930,Porter; George M,9999,0,9999,0
1653573423122,CSE 293,027,094931,Porter; Leonard Emerson,9999,0,9999,0
1653573423122,CSE 293,028,094932,Ramamoorthi; Ravi,9999,0,9999,0
1653573423122,CSE 293,029,094933,Sahoo; Debashis,9999,0,9999,0
1653573423122,CSE 293,030,094934,Saul; Lawrence,9999,0,9999,0
1653573423122,CSE 293,031,094935,Savage; Stefan,9999,0,9999,0
1653573423122,CSE 293,032,094936,Schulze; Jurgen P.,9999,0,9999,0
1653573423122,CSE 293,033,094937,Snoeren; Alex C.,9999,0,9999,0
1653573423122,CSE 293,034,094938,Shang; Jingbo,9999,0,9999,0
1653573423122,CSE 293,035,094939,Stefan; Deian,9999,0,9999,0
1653573423122,CSE 293,036,094940,Su; Hao,9999,0,9999,0
1653573423122,CSE 293,037,094941,Swanson; Steven James,9999,0,9999,0
1653573423122,CSE 293,038,094942,Tullsen; Dean Michael,9999,0,9999,0
1653573423122,CSE 293,039,094943,Voelker; Geoffrey M.,9999,0,9999,0
1653573423122,CSE 293,040,094944,Zhao; Jishen,9999,0,9999,0
1653573423122,CSE 293,041,094945,Zhou; Yuan-Yuan,9999,0,9999,0
1653573423122,CSE 293,042,094946,Gao; Sicun,9998,0,9999,1
1653573423122,CSE 293,043,094947,Weibel; Nadir,9999,0,9999,0
1653573423122,CSE 293,044,094948,Gupta; Rajesh K.,9999,0,9999,0
1653573423646,CSE 294,A00,090143,Porter; George M,8,0,10,2
1653573424172,DSE 200,A00,091799,Staff,50,0,50,0
1653573424697,DSE 203,A00,091800,Gupta; Amarnath,30,0,30,0
1653573425219,DSE 250,A00,091801,Deutsch; Alin Bernard,30,0,30,0
1653573425745,DSE 290,A00,091802,Altintas De Callaf; Ilkay,50,0,50,0
1653573426293,ECE 200,001,091003,Antipa; Nicholas A,9999,0,9999,0
1653573426293,ECE 200,002,091004,Atanasov; Nikolay A.,9999,0,9999,0
1653573426293,ECE 200,003,091005,Bharadia; Dinesh,9999,0,9999,0
1653573426293,ECE 200,004,091006,Cheng; Chung Kuan,9999,0,9999,0
1653573426293,ECE 200,005,091007,Cosman; Pamela C.,9999,0,9999,0
1653573426293,ECE 200,006,091008,Staff,9999,0,9999,0
1653573426293,ECE 200,007,091009,Dayeh; Shadi Ahmad,9999,0,9999,0
1653573426293,ECE 200,008,091010,Fainman; Yeshaiahu,9999,0,9999,0
1653573426293,ECE 200,009,091011,Ford; Joseph Earl,9999,0,9999,0
1653573426293,ECE 200,010,091012,Franceschetti; Massimo,9999,0,9999,0
1653573426293,ECE 200,011,091013,Fullerton; Eric E,9999,0,9999,0
1653573426293,ECE 200,012,091014,Galton; Ian A,9999,0,9999,0
1653573426293,ECE 200,013,091015,Gilja; Vikash,9999,0,9999,0
1653573426293,ECE 200,014,091016,Hall; Drew A.,9999,0,9999,0
1653573426293,ECE 200,015,091017,Hsueh; Tzu-Chien,9999,0,9999,0
1653573426293,ECE 200,016,091018,Javidi; Tara,9999,0,9999,0
1653573426293,ECE 200,017,091019,Kahng; Andrew Byun,9999,0,9999,0
1653573426293,ECE 200,018,091020,Kim; Young-Han,9999,0,9999,0
1653573426293,ECE 200,019,091021,Koushanfar; Farinaz,9999,0,9999,0
1653573426293,ECE 200,020,091022,Kuzum; Duygu,9999,0,9999,0
1653573426293,ECE 200,021,091023,Le; Hanh-Phuc,9999,0,9999,0
1653573426293,ECE 200,022,091024,Lin; Bill,9999,0,9999,0
1653573426293,ECE 200,023,091025,Liu; Zhaowei,9999,0,9999,0
1653573426293,ECE 200,024,091026,Lo; Yu-Hwa,9999,0,9999,0
1653573426293,ECE 200,025,091027,Lomakin; Vitaliy,9999,0,9999,0
1653573426293,ECE 200,026,091028,Mercier; Patrick Philip,9999,0,9999,0
1653573426293,ECE 200,027,091029,Meyer; Florian,9999,0,9999,0
1653573426293,ECE 200,028,091030,Milstein; Laurence B.,9999,0,9999,0
1653573426293,ECE 200,029,091031,Mir Arabbaygi; Siavash,9999,0,9999,0
1653573426293,ECE 200,030,091032,Mookherjea; Shayan,9999,0,9999,0
1653573426293,ECE 200,031,091033,Morris; Karcher William,9999,0,9999,0
1653573426293,ECE 200,032,091034,Ng; Tse Nga,9999,0,9999,0
1653573426293,ECE 200,033,091035,Nguyen; Truong Quang,9999,0,9999,0
1653573426293,ECE 200,034,091036,Nomura; Kenji,9999,0,9999,0
1653573426293,ECE 200,035,091037,Orlitsky; Alon,9999,0,9999,0
1653573426293,ECE 200,036,091038,Pal; Piya,9999,0,9999,0
1653573426293,ECE 200,037,091039,Papen; George C.,9999,0,9999,0
1653573426293,ECE 200,038,091040,Radic; Stojan,9999,0,9999,0
1653573426293,ECE 200,039,091041,Rao; Bhaskar D.,9999,0,9999,0
1653573426293,ECE 200,040,091042,Rao; Ramesh R,9999,0,9999,0
1653573426293,ECE 200,041,091043,Rebeiz; Gabriel,9999,0,9999,0
1653573426293,ECE 200,042,091044,Sanford; John R,9999,0,9999,0
1653573426293,ECE 200,043,091045,Siegel; Paul H.,9999,0,9999,0
1653573426293,ECE 200,044,091046,Sievenpiper; Daniel F.,9999,0,9999,0
1653573426293,ECE 200,045,091047,Sworder; David D.,9999,0,9999,0
1653573426293,ECE 200,046,091048,Taur; Yuan,9999,0,9999,0
1653573426293,ECE 200,047,091049,Touri; Behrouz,9999,0,9999,0
1653573426293,ECE 200,048,091050,Trivedi; Mohan M.,9999,0,9999,0
1653573426293,ECE 200,049,091051,Vardy; Alexander,9999,0,9999,0
1653573426293,ECE 200,050,091052,Vasconcelos; Nuno,9999,0,9999,0
1653573426293,ECE 200,051,091053,Wang; Xiaolong,9999,0,9999,0
1653573426293,ECE 200,052,091054,Xie; Pengtao,9999,0,9999,0
1653573426293,ECE 200,053,091055,Yip; Michael,9999,0,9999,0
1653573426293,ECE 200,054,091056,Zeger; Kenneth A.,9999,0,9999,0
1653573426293,ECE 200,055,091057,Zhang; Xinyu,9999,0,9999,0
1653573426293,ECE 200,056,091058,Turakhia; Yatish Girish,9999,0,9999,0
1653573426293,ECE 200,057,091059,Kang; Mingu,9999,0,9999,0
1653573426293,ECE 200,058,091060,Shi; Yuanyuan,9999,0,9999,0
1653573426293,ECE 200,059,091061,Wang; Edward Jay,9999,0,9999,0
1653573426293,ECE 200,060,091062,Zheng; Yang,9999,0,9999,0
1653573426815,ECE 201,A00,095526,Lo; Yu-Hwa,0,0,0,0
1653573427338,ECE 203,A00,091065,Mercier; Patrick Philip,0,0,0,0
1653573427866,ECE 207A,A00,091605,Liu; Thomas Tao-Ming,0,0,0,0
1653573428389,ECE 212AN,A00,091068,Nomura; Kenji,0,0,0,0
1653573428916,ECE 222A,A00,091069,Rebeiz; Gabriel,0,0,0,0
1653573429442,ECE 225A,A00,091070,Orlitsky; Alon,0,0,0,0
1653573429965,ECE 230A,A00,091071,Nomura; Kenji,0,0,0,0
1653573430499,ECE 236A,A00,091072,Dayeh; Shadi Ahmad,0,0,0,0
1653573431023,ECE 238A,A00,091073,Luo; Jian,0,0,0,0
1653573431023,ECE 238A,B00,091074,Luo; Jian,0,0,0,0
1653573431547,ECE 240A,A00,091075,Radic; Stojan,0,0,0,0
1653573432070,ECE 247A,A00,091592,Shi; Lingyan,0,0,0,0
1653573432605,ECE 250,A00,091076,Touri; Behrouz,0,0,0,0
1653573433135,ECE 251C,A00,091078,Nguyen; Truong Quang,0,0,0,0
1653573433657,ECE 253,A00,091079,Cosman; Pamela C.,0,0,0,0
1653573434181,ECE 255A,A00,091080,Orlitsky; Alon,0,0,0,0
1653573434705,ECE 257A,A00,091081,Zhang; Xinyu,0,0,0,0
1653573435229,ECE 260A,A01,091084,Eldon; John,0,0,0,0
1653573435759,ECE 264C,A00,091085,Galton; Ian A,0,0,0,0
1653573436284,ECE 265C,A00,094889,Presti; Calogero Davide,0,0,0,9
1653573436812,ECE 266,A01,091087,Hall; Drew A.,0,0,0,0
1653573437881,ECE 271A,A00,091090,Vasconcelos; Nuno,0,0,0,0
1653573438403,ECE 272B,A00,091091,Sworder; David D.,0,0,0,0
1653573438928,ECE 275A,A00,091092,Meyer; Florian,0,0,0,0
1653573439458,ECE 277,A00,091093,An; Cheolhong,0,0,0,0
1653573439988,ECE 283,A00,091094,Le; Hanh-Phuc,0,0,0,0
1653573440515,ECE 284,A00,091095,Kang; Mingu,0,0,0,0
1653573440515,ECE 284,B00,091096,Wang; Edward Jay,0,0,0,0
1653573441042,ECE 285,A00,094334,Touri; Behrouz,0,0,0,0
1653573441566,ECE 289,A00,091097,Whelan; David Arthur,0,0,0,0
1653573442094,MATH 200A,A00,087414,Salehi Golsefidy; Alireza,7,0,8,1
1653573442618,MATH 202A,A00,087415,Gill; Philip E.,2,0,8,6
1653573443141,MATH 203A,A00,087416,Oprea; Dragos N.,6,0,8,2
1653573443668,MATH 204A,A00,087417,Kedlaya; Kiran S.,6,0,8,2
1653573444194,MATH 205,A00,087418,Sorensen; Claus M,6,0,8,2
1653573444721,MATH 206A,A00,087419,Izadi; Elham,7,0,8,1
1653573445244,MATH 207A,A00,087420,Mohammadi; Amir,5,0,8,3
1653573445771,MATH 208,A00,087421,Staff,9,0,10,1
1653573446298,MATH 209,A00,087422,Staff,10,0,10,0
1653573446821,MATH 218,A00,087423,Staff,10,0,10,0
1653573447348,MATH 220A,A00,087424,Novak; Jonathan I,6,0,8,2
1653573447881,MATH 231A,A00,087425,Bejenaru; Ioan,3,0,8,5
1653573448405,MATH 240A,A00,087426,Ebenfelt; Peter F,5,0,8,3
1653573448939,MATH 243,A00,087427,Staff,9,0,10,1
1653573449466,MATH 248,A00,087429,Staff,10,0,10,0
1653573449988,MATH 250A,A00,087430,Spolaor; Luca,4,0,8,4
1653573450513,MATH 257A,A00,087431,Spolaor; Luca,7,0,8,1
1653573451039,MATH 258,A00,087432,Staff,9,0,10,1
1653573451569,MATH 264A,A00,087433,Warnke; Lutz Peter,5,0,8,3
1653573452092,MATH 268,A00,087434,Staff,15,0,15,0
1653573452622,MATH 269,A00,087435,Staff,14,0,15,1
1653573453149,MATH 270A,A00,087436,Nie; Jiawang,0,0,8,8
1653573453672,MATH 272A,A00,087437,Tian; Xiaochuan,1,0,8,7
1653573454196,MATH 274,A01,087439,Cheng; Li-Tien,9,0,10,1
1653573454196,MATH 274,A02,087440,Cheng; Li-Tien,10,0,10,0
1653573454733,MATH 278A,A00,087441,Staff,8,0,10,2
1653573455258,MATH 278B,A00,087442,Staff,8,0,10,2
1653573455792,MATH 278C,A00,087443,Staff,8,0,10,2
1653573456315,MATH 280A,A00,087444,Zheng; Tianyi,0,0,8,8
1653573456839,MATH 281A,A00,087445,Bradic; Jelena,0,0,8,8
1653573457366,MATH 282A,A00,087446,Zhang; Danna,0,0,8,8
1653573457893,MATH 283,A00,087447,Tesler; Glenn,0,0,0,15
1653573458416,MATH 286,A00,087448,Kemp; Todd Aahron,5,0,8,3
1653573458939,MATH 287D,A00,087449,Bradic; Jelena,0,0,0,1
1653573459464,MATH 288,A00,087450,Staff,14,0,15,1
1653573459464,MATH 288,B00,087451,Staff,15,0,15,0
1653573459464,MATH 288,C00,087452,Staff,15,0,15,0
1653573459990,MATH 290A,A00,087453,Xu; Zhouli,6,0,8,2
1653573460512,MATH 291A,A00,087454,Xu; Zhouli,7,0,8,1
1653573461034,MATH 292,A00,087455,Staff,10,0,10,0
1653573461561,MATH 295,A00,087456,Staff,50,0,50,0
1653573462086,MATH 297,001,087457,Staff,998,0,999,1
1653574025070,COGS 200,A01,087991,Staff,47,0,50,3
1653574025594,COGS 201,A01,094504,Rangel; Lara M,17,0,25,8
1653574026116,COGS 203,A00,087992,Coulson; Seana M,18,0,20,2
1653574026647,COGS 210A,001,087993,Greene; Deanna Jacquelyn,9998,0,9999,1
1653574026647,COGS 210A,002,087994,Saygin; Ayse P,9999,0,9999,0
1653574026647,COGS 210A,003,087995,Xia; Haijun,9999,0,9999,0
1653574026647,COGS 210A,004,087996,Nitz; Douglas A.,9999,0,9999,0
1653574026647,COGS 210A,005,087997,Hollan; James D.,9999,0,9999,0
1653574026647,COGS 210A,006,087998,Deak; Gedeon O.,9998,0,9999,1
1653574026647,COGS 210A,007,087999,Rossano; Federico,9999,0,9999,0
1653574027169,COGS 211A,A00,088000,Coulson; Seana M,9997,0,9999,2
1653574027696,COGS 229,A00,088002,Staff,22,0,25,3
1653574028223,COGS 260,B00,094231,Staff,17,0,20,3
1653574028223,COGS 260,A00,088004,Nitz; Douglas A.,9998,0,9999,1
1653574028759,CSE 202,A00,090110,Paturi; Ramamohan,0,0,0,0
1653574028759,CSE 202,B00,090111,Paturi; Ramamohan,0,0,0,0
1653574029280,CSE 207B,A00,090112,Heninger; Nadia A,0,0,0,0
1653574029812,CSE 208,A00,094858,Micciancio; Daniele,0,0,0,0
1653574030342,CSE 210,A00,090113,Powell; Thomas Allan,0,0,0,0
1653574030868,CSE 219,A00,090898,Staff,0,0,0,0
1653574031402,CSE 221,A00,090114,Zhou; Yuan-Yuan,0,0,0,0
1653574031925,CSE 229A,A00,090115,Porter; George M,0,0,0,0
1653574032447,CSE 229C,A00,090116,Savage; Stefan,0,0,0,0
1653574032970,CSE 230,A00,090117,Jhala; Ranjit,0,0,0,0
1653574033496,CSE 232,A00,090118,Papakonstantinou; Yannis,0,0,0,0
1653574034020,CSE 239A,A00,090121,Kumar; Arun Kumar,0,0,0,0
1653574034545,CSE 239B,A00,090122,Jhala; Ranjit,0,0,0,0
1653574035068,CSE 240A,A00,090123,Zhao; Jishen,1,0,189,188
1653574035599,CSE 243A,A00,090124,Orailoglu; Alex,0,0,15,15
1653574036130,CSE 249B,A00,090125,Kahng; Andrew Byun,13,0,20,7
1653574036658,CSE 250A,A00,090126,Berg-Kirkpatrick; Taylor D,0,0,0,0
1653574037183,CSE 252A,A00,090127,Ochoa; Benjamin Lawrence,0,0,0,0
1653574037710,CSE 258,A01,090129,McAuley; Julian John,0,0,0,0
1653574038239,CSE 258R,A01,090131,McAuley; Julian John,0,0,0,0
1653574038766,CSE 274,A00,090132,Ramamoorthi; Ravi,0,0,0,0
1653574039295,CSE 276A,A00,090133,Christensen; Henrik I,0,0,0,0
1653574039818,CSE 276C,A00,090134,Christensen; Henrik I,0,0,0,0
1653574040342,CSE 290,A00,090135,Bafna; Vineet,0,0,0,0
1653574040342,CSE 290,B00,090136,Ramamoorthi; Ravi,0,0,0,0
1653574040342,CSE 290,C00,090137,Li; Tzumao,8,0,10,2
1653574040342,CSE 290,D00,090138,Zhou; Yuan-Yuan,9,0,10,1
1653574040342,CSE 290,E00,090139,Christensen; Henrik I,8,0,10,2
1653574040342,CSE 290,F00,094053,Shalev; Aaron D,0,0,0,0
1653574040882,CSE 291,A00,090140,Munyaka; Imani N. S.,0,0,0,0
1653574040882,CSE 291,B00,094880,Yu; Qi,0,0,0,0
1653574040882,CSE 291,C00,090142,Pannuto; Patrick William,0,0,0,0
1653574040882,CSE 291,D00,094881,Zhang; Yiying,0,0,0,0
1653574040882,CSE 291,E00,095118,Su; Hao,0,0,0,0
1653574041436,CSE 293,001,094905,Bafna; Vineet,9999,0,9999,0
1653574041436,CSE 293,002,094906,Bellare; Mihir,9999,0,9999,0
1653574041436,CSE 293,003,094907,Berg-Kirkpatrick; Taylor D,9999,0,9999,0
1653574041436,CSE 293,004,094908,Christensen; Henrik I,9999,0,9999,0
1653574041436,CSE 293,005,094909,Cottrell; Garrison W,9999,0,9999,0
1653574041436,CSE 293,006,094910,Deutsch; Alin Bernard,9999,0,9999,0
1653574041436,CSE 293,007,094911,Esmaeilzadeh; Hadi,9999,0,9999,0
1653574041436,CSE 293,008,094912,Freund; Yoav,9999,0,9999,0
1653574041436,CSE 293,009,094913,Griswold; William G.,9999,0,9999,0
1653574041436,CSE 293,010,094914,Gymrek; Melissa Ann,9999,0,9999,0
1653574041436,CSE 293,011,094915,Heninger; Nadia A,9999,0,9999,0
1653574041436,CSE 293,012,094916,Impagliazzo; Russell,9999,0,9999,0
1653574041436,CSE 293,013,094917,Jhala; Ranjit,9999,0,9999,0
1653574041436,CSE 293,014,094918,Kahng; Andrew Byun,9999,0,9999,0
1653574041436,CSE 293,015,094919,Kane; Daniel Mertz,9999,0,9999,0
1653574041436,CSE 293,016,094920,Kriegman; David J,9999,0,9999,0
1653574041436,CSE 293,017,094921,Kumar; Arun Kumar,9999,0,9999,0
1653574041436,CSE 293,018,094922,Lerner; Sorin,9999,0,9999,0
1653574041436,CSE 293,019,094923,Lovett; Shachar,9999,0,9999,0
1653574041436,CSE 293,020,094924,McAuley; Julian John,9999,0,9999,0
1653574041436,CSE 293,021,094925,Micciancio; Daniele,9999,0,9999,0
1653574041436,CSE 293,022,094926,Orailoglu; Alex,9999,0,9999,0
1653574041436,CSE 293,023,094927,Paturi; Ramamohan,9999,0,9999,0
1653574041436,CSE 293,024,094928,Polikarpova; Nadezhda,9999,0,9999,0
1653574041436,CSE 293,025,094929,Politz; Joseph Gibbs,9999,0,9999,0
1653574041436,CSE 293,026,094930,Porter; George M,9999,0,9999,0
1653574041436,CSE 293,027,094931,Porter; Leonard Emerson,9999,0,9999,0
1653574041436,CSE 293,028,094932,Ramamoorthi; Ravi,9999,0,9999,0
1653574041436,CSE 293,029,094933,Sahoo; Debashis,9999,0,9999,0
1653574041436,CSE 293,030,094934,Saul; Lawrence,9999,0,9999,0
1653574041436,CSE 293,031,094935,Savage; Stefan,9999,0,9999,0
1653574041436,CSE 293,032,094936,Schulze; Jurgen P.,9999,0,9999,0
1653574041436,CSE 293,033,094937,Snoeren; Alex C.,9999,0,9999,0
1653574041436,CSE 293,034,094938,Shang; Jingbo,9999,0,9999,0
1653574041436,CSE 293,035,094939,Stefan; Deian,9999,0,9999,0
1653574041436,CSE 293,036,094940,Su; Hao,9999,0,9999,0
1653574041436,CSE 293,037,094941,Swanson; Steven James,9999,0,9999,0
1653574041436,CSE 293,038,094942,Tullsen; Dean Michael,9999,0,9999,0
1653574041436,CSE 293,039,094943,Voelker; Geoffrey M.,9999,0,9999,0
1653574041436,CSE 293,040,094944,Zhao; Jishen,9999,0,9999,0
1653574041436,CSE 293,041,094945,Zhou; Yuan-Yuan,9999,0,9999,0
1653574041436,CSE 293,042,094946,Gao; Sicun,9998,0,9999,1
1653574041436,CSE 293,043,094947,Weibel; Nadir,9999,0,9999,0
1653574041436,CSE 293,044,094948,Gupta; Rajesh K.,9999,0,9999,0
1653574041964,CSE 294,A00,090143,Porter; George M,8,0,10,2
1653574042488,DSE 200,A00,091799,Staff,50,0,50,0
1653574043024,DSE 203,A00,091800,Gupta; Amarnath,30,0,30,0
1653574043549,DSE 250,A00,091801,Deutsch; Alin Bernard,30,0,30,0
1653574044073,DSE 290,A00,091802,Altintas De Callaf; Ilkay,50,0,50,0
1653574044621,ECE 200,001,091003,Antipa; Nicholas A,9999,0,9999,0
1653574044621,ECE 200,002,091004,Atanasov; Nikolay A.,9999,0,9999,0
1653574044621,ECE 200,003,091005,Bharadia; Dinesh,9999,0,9999,0
1653574044621,ECE 200,004,091006,Cheng; Chung Kuan,9999,0,9999,0
1653574044621,ECE 200,005,091007,Cosman; Pamela C.,9999,0,9999,0
1653574044621,ECE 200,006,091008,Staff,9999,0,9999,0
1653574044621,ECE 200,007,091009,Dayeh; Shadi Ahmad,9999,0,9999,0
1653574044621,ECE 200,008,091010,Fainman; Yeshaiahu,9999,0,9999,0
1653574044621,ECE 200,009,091011,Ford; Joseph Earl,9999,0,9999,0
1653574044621,ECE 200,010,091012,Franceschetti; Massimo,9999,0,9999,0
1653574044621,ECE 200,011,091013,Fullerton; Eric E,9999,0,9999,0
1653574044621,ECE 200,012,091014,Galton; Ian A,9999,0,9999,0
1653574044621,ECE 200,013,091015,Gilja; Vikash,9999,0,9999,0
1653574044621,ECE 200,014,091016,Hall; Drew A.,9999,0,9999,0
1653574044621,ECE 200,015,091017,Hsueh; Tzu-Chien,9999,0,9999,0
1653574044621,ECE 200,016,091018,Javidi; Tara,9999,0,9999,0
1653574044621,ECE 200,017,091019,Kahng; Andrew Byun,9999,0,9999,0
1653574044621,ECE 200,018,091020,Kim; Young-Han,9999,0,9999,0
1653574044621,ECE 200,019,091021,Koushanfar; Farinaz,9999,0,9999,0
1653574044621,ECE 200,020,091022,Kuzum; Duygu,9999,0,9999,0
1653574044621,ECE 200,021,091023,Le; Hanh-Phuc,9999,0,9999,0
1653574044621,ECE 200,022,091024,Lin; Bill,9999,0,9999,0
1653574044621,ECE 200,023,091025,Liu; Zhaowei,9999,0,9999,0
1653574044621,ECE 200,024,091026,Lo; Yu-Hwa,9999,0,9999,0
1653574044621,ECE 200,025,091027,Lomakin; Vitaliy,9999,0,9999,0
1653574044621,ECE 200,026,091028,Mercier; Patrick Philip,9999,0,9999,0
1653574044621,ECE 200,027,091029,Meyer; Florian,9999,0,9999,0
1653574044621,ECE 200,028,091030,Milstein; Laurence B.,9999,0,9999,0
1653574044621,ECE 200,029,091031,Mir Arabbaygi; Siavash,9999,0,9999,0
1653574044621,ECE 200,030,091032,Mookherjea; Shayan,9999,0,9999,0
1653574044621,ECE 200,031,091033,Morris; Karcher William,9999,0,9999,0
1653574044621,ECE 200,032,091034,Ng; Tse Nga,9999,0,9999,0
1653574044621,ECE 200,033,091035,Nguyen; Truong Quang,9999,0,9999,0
1653574044621,ECE 200,034,091036,Nomura; Kenji,9999,0,9999,0
1653574044621,ECE 200,035,091037,Orlitsky; Alon,9999,0,9999,0
1653574044621,ECE 200,036,091038,Pal; Piya,9999,0,9999,0
1653574044621,ECE 200,037,091039,Papen; George C.,9999,0,9999,0
1653574044621,ECE 200,038,091040,Radic; Stojan,9999,0,9999,0
1653574044621,ECE 200,039,091041,Rao; Bhaskar D.,9999,0,9999,0
1653574044621,ECE 200,040,091042,Rao; Ramesh R,9999,0,9999,0
1653574044621,ECE 200,041,091043,Rebeiz; Gabriel,9999,0,9999,0
1653574044621,ECE 200,042,091044,Sanford; John R,9999,0,9999,0
1653574044621,ECE 200,043,091045,Siegel; Paul H.,9999,0,9999,0
1653574044621,ECE 200,044,091046,Sievenpiper; Daniel F.,9999,0,9999,0
1653574044621,ECE 200,045,091047,Sworder; David D.,9999,0,9999,0
1653574044621,ECE 200,046,091048,Taur; Yuan,9999,0,9999,0
1653574044621,ECE 200,047,091049,Touri; Behrouz,9999,0,9999,0
1653574044621,ECE 200,048,091050,Trivedi; Mohan M.,9999,0,9999,0
1653574044621,ECE 200,049,091051,Vardy; Alexander,9999,0,9999,0
1653574044621,ECE 200,050,091052,Vasconcelos; Nuno,9999,0,9999,0
1653574044621,ECE 200,051,091053,Wang; Xiaolong,9999,0,9999,0
1653574044621,ECE 200,052,091054,Xie; Pengtao,9999,0,9999,0
1653574044621,ECE 200,053,091055,Yip; Michael,9999,0,9999,0
1653574044621,ECE 200,054,091056,Zeger; Kenneth A.,9999,0,9999,0
1653574044621,ECE 200,055,091057,Zhang; Xinyu,9999,0,9999,0
1653574044621,ECE 200,056,091058,Turakhia; Yatish Girish,9999,0,9999,0
1653574044621,ECE 200,057,091059,Kang; Mingu,9999,0,9999,0
1653574044621,ECE 200,058,091060,Shi; Yuanyuan,9999,0,9999,0
1653574044621,ECE 200,059,091061,Wang; Edward Jay,9999,0,9999,0
1653574044621,ECE 200,060,091062,Zheng; Yang,9999,0,9999,0
1653574045144,ECE 201,A00,095526,Lo; Yu-Hwa,0,0,0,0
1653574045672,ECE 203,A00,091065,Mercier; Patrick Philip,0,0,0,0
1653574046196,ECE 207A,A00,091605,Liu; Thomas Tao-Ming,0,0,0,0
1653574046721,ECE 212AN,A00,091068,Nomura; Kenji,0,0,0,0
1653574047242,ECE 222A,A00,091069,Rebeiz; Gabriel,0,0,0,0
1653574047765,ECE 225A,A00,091070,Orlitsky; Alon,0,0,0,0
1653574048288,ECE 230A,A00,091071,Nomura; Kenji,0,0,0,0
1653574048812,ECE 236A,A00,091072,Dayeh; Shadi Ahmad,0,0,0,0
1653574049337,ECE 238A,A00,091073,Luo; Jian,0,0,0,0
1653574049337,ECE 238A,B00,091074,Luo; Jian,0,0,0,0
1653574049864,ECE 240A,A00,091075,Radic; Stojan,0,0,0,0
1653574050386,ECE 247A,A00,091592,Shi; Lingyan,0,0,0,0
1653574050909,ECE 250,A00,091076,Touri; Behrouz,0,0,0,0
1653574051433,ECE 251C,A00,091078,Nguyen; Truong Quang,0,0,0,0
1653574051974,ECE 253,A00,091079,Cosman; Pamela C.,0,0,0,0
1653574052497,ECE 255A,A00,091080,Orlitsky; Alon,0,0,0,0
1653574053019,ECE 257A,A00,091081,Zhang; Xinyu,0,0,0,0
1653574053544,ECE 260A,A01,091084,Eldon; John,0,0,0,0
1653574054071,ECE 264C,A00,091085,Galton; Ian A,0,0,0,0
1653574054595,ECE 265C,A00,094889,Presti; Calogero Davide,0,0,0,9
1653574055125,ECE 266,A01,091087,Hall; Drew A.,0,0,0,0
1653574056173,ECE 271A,A00,091090,Vasconcelos; Nuno,0,0,0,0
1653574056699,ECE 272B,A00,091091,Sworder; David D.,0,0,0,0
1653574057222,ECE 275A,A00,091092,Meyer; Florian,0,0,0,0
1653574057747,ECE 277,A00,091093,An; Cheolhong,0,0,0,0
1653574058368,ECE 283,A00,091094,Le; Hanh-Phuc,0,0,0,0
1653574058891,ECE 284,A00,091095,Kang; Mingu,0,0,0,0
1653574058891,ECE 284,B00,091096,Wang; Edward Jay,0,0,0,0
1653574059418,ECE 285,A00,094334,Touri; Behrouz,0,0,0,0
1653574059945,ECE 289,A00,091097,Whelan; David Arthur,0,0,0,0
1653574060470,MATH 200A,A00,087414,Salehi Golsefidy; Alireza,7,0,8,1
1653574060993,MATH 202A,A00,087415,Gill; Philip E.,2,0,8,6
1653574061517,MATH 203A,A00,087416,Oprea; Dragos N.,6,0,8,2
1653574062038,MATH 204A,A00,087417,Kedlaya; Kiran S.,6,0,8,2
1653574062561,MATH 205,A00,087418,Sorensen; Claus M,6,0,8,2
1653574063086,MATH 206A,A00,087419,Izadi; Elham,7,0,8,1
1653574063609,MATH 207A,A00,087420,Mohammadi; Amir,5,0,8,3
1653574064137,MATH 208,A00,087421,Staff,9,0,10,1
1653574064660,MATH 209,A00,087422,Staff,10,0,10,0
1653574065183,MATH 218,A00,087423,Staff,10,0,10,0
1653574065714,MATH 220A,A00,087424,Novak; Jonathan I,6,0,8,2
1653574066237,MATH 231A,A00,087425,Bejenaru; Ioan,3,0,8,5
1653574066761,MATH 240A,A00,087426,Ebenfelt; Peter F,5,0,8,3
1653574067288,MATH 243,A00,087427,Staff,9,0,10,1
1653574067811,MATH 248,A00,087429,Staff,10,0,10,0
1653574068340,MATH 250A,A00,087430,Spolaor; Luca,4,0,8,4
1653574068863,MATH 257A,A00,087431,Spolaor; Luca,7,0,8,1
1653574069387,MATH 258,A00,087432,Staff,9,0,10,1
1653574069912,MATH 264A,A00,087433,Warnke; Lutz Peter,5,0,8,3
1653574070435,MATH 268,A00,087434,Staff,15,0,15,0
1653574070961,MATH 269,A00,087435,Staff,14,0,15,1
1653574071488,MATH 270A,A00,087436,Nie; Jiawang,0,0,8,8
1653574072020,MATH 272A,A00,087437,Tian; Xiaochuan,1,0,8,7
1653574072560,MATH 274,A01,087439,Cheng; Li-Tien,9,0,10,1
1653574072560,MATH 274,A02,087440,Cheng; Li-Tien,10,0,10,0
1653574073083,MATH 278A,A00,087441,Staff,8,0,10,2
1653574073607,MATH 278B,A00,087442,Staff,8,0,10,2
1653574074143,MATH 278C,A00,087443,Staff,8,0,10,2
1653574074671,MATH 280A,A00,087444,Zheng; Tianyi,0,0,8,8
1653574075198,MATH 281A,A00,087445,Bradic; Jelena,0,0,8,8
1653574075729,MATH 282A,A00,087446,Zhang; Danna,0,0,8,8
1653574076252,MATH 283,A00,087447,Tesler; Glenn,0,0,0,15
1653574076780,MATH 286,A00,087448,Kemp; Todd Aahron,5,0,8,3
1653574077306,MATH 287D,A00,087449,Bradic; Jelena,0,0,0,1
1653574077831,MATH 288,A00,087450,Staff,14,0,15,1
1653574077831,MATH 288,B00,087451,Staff,15,0,15,0
1653574077831,MATH 288,C00,087452,Staff,15,0,15,0
1653574078353,MATH 290A,A00,087453,Xu; Zhouli,6,0,8,2
1653574078879,MATH 291A,A00,087454,Xu; Zhouli,7,0,8,1
1653574079404,MATH 292,A00,087455,Staff,10,0,10,0
1653574079929,MATH 295,A00,087456,Staff,50,0,50,0
1653574080453,MATH 297,001,087457,Staff,998,0,999,1
1653574640910,COGS 200,A01,087991,Staff,47,0,50,3
1653574641432,COGS 201,A01,094504,Rangel; Lara M,17,0,25,8
1653574641956,COGS 203,A00,087992,Coulson; Seana M,18,0,20,2
1653574642481,COGS 210A,001,087993,Greene; Deanna Jacquelyn,9998,0,9999,1
1653574642481,COGS 210A,002,087994,Saygin; Ayse P,9999,0,9999,0
1653574642481,COGS 210A,003,087995,Xia; Haijun,9999,0,9999,0
1653574642481,COGS 210A,004,087996,Nitz; Douglas A.,9999,0,9999,0
1653574642481,COGS 210A,005,087997,Hollan; James D.,9999,0,9999,0
1653574642481,COGS 210A,006,087998,Deak; Gedeon O.,9998,0,9999,1
1653574642481,COGS 210A,007,087999,Rossano; Federico,9999,0,9999,0
1653574643004,COGS 211A,A00,088000,Coulson; Seana M,9997,0,9999,2
1653574643528,COGS 229,A00,088002,Staff,22,0,25,3
1653574644053,COGS 260,B00,094231,Staff,17,0,20,3
1653574644053,COGS 260,A00,088004,Nitz; Douglas A.,9998,0,9999,1
1653574644583,CSE 202,A00,090110,Paturi; Ramamohan,0,0,0,0
1653574644583,CSE 202,B00,090111,Paturi; Ramamohan,0,0,0,0
1653574645114,CSE 207B,A00,090112,Heninger; Nadia A,0,0,0,0
1653574645640,CSE 208,A00,094858,Micciancio; Daniele,0,0,0,0
1653574646236,CSE 210,A00,090113,Powell; Thomas Allan,0,0,0,0
1653574646759,CSE 219,A00,090898,Staff,0,0,0,0
1653574647282,CSE 221,A00,090114,Zhou; Yuan-Yuan,0,0,0,0
1653574647807,CSE 229A,A00,090115,Porter; George M,0,0,0,0
1653574648338,CSE 229C,A00,090116,Savage; Stefan,0,0,0,0
1653574648863,CSE 230,A00,090117,Jhala; Ranjit,0,0,0,0
1653574649388,CSE 232,A00,090118,Papakonstantinou; Yannis,0,0,0,0
1653574649914,CSE 239A,A00,090121,Kumar; Arun Kumar,0,0,0,0
1653574650441,CSE 239B,A00,090122,Jhala; Ranjit,0,0,0,0
1653574650968,CSE 240A,A00,090123,Zhao; Jishen,1,0,189,188
1653574651491,CSE 243A,A00,090124,Orailoglu; Alex,0,0,15,15
1653574652017,CSE 249B,A00,090125,Kahng; Andrew Byun,13,0,20,7
1653574652540,CSE 250A,A00,090126,Berg-Kirkpatrick; Taylor D,0,0,0,0
1653574653074,CSE 252A,A00,090127,Ochoa; Benjamin Lawrence,0,0,0,0
1653574653596,CSE 258,A01,090129,McAuley; Julian John,0,0,0,0
1653574654119,CSE 258R,A01,090131,McAuley; Julian John,0,0,0,0
1653574654644,CSE 274,A00,090132,Ramamoorthi; Ravi,0,0,0,0
1653574655167,CSE 276A,A00,090133,Christensen; Henrik I,0,0,0,0
1653574655691,CSE 276C,A00,090134,Christensen; Henrik I,0,0,0,0
1653574656217,CSE 290,A00,090135,Bafna; Vineet,0,0,0,0
1653574656217,CSE 290,B00,090136,Ramamoorthi; Ravi,0,0,0,0
1653574656217,CSE 290,C00,090137,Li; Tzumao,8,0,10,2
1653574656217,CSE 290,D00,090138,Zhou; Yuan-Yuan,9,0,10,1
1653574656217,CSE 290,E00,090139,Christensen; Henrik I,8,0,10,2
1653574656217,CSE 290,F00,094053,Shalev; Aaron D,0,0,0,0
1653574656742,CSE 291,A00,090140,Munyaka; Imani N. S.,0,0,0,0
1653574656742,CSE 291,B00,094880,Yu; Qi,0,0,0,0
1653574656742,CSE 291,C00,090142,Pannuto; Patrick William,0,0,0,0
1653574656742,CSE 291,D00,094881,Zhang; Yiying,0,0,0,0
1653574656742,CSE 291,E00,095118,Su; Hao,0,0,0,0
1653574657269,CSE 293,001,094905,Bafna; Vineet,9999,0,9999,0
1653574657269,CSE 293,002,094906,Bellare; Mihir,9999,0,9999,0
1653574657269,CSE 293,003,094907,Berg-Kirkpatrick; Taylor D,9999,0,9999,0
1653574657269,CSE 293,004,094908,Christensen; Henrik I,9999,0,9999,0
1653574657269,CSE 293,005,094909,Cottrell; Garrison W,9999,0,9999,0
1653574657269,CSE 293,006,094910,Deutsch; Alin Bernard,9999,0,9999,0
1653574657269,CSE 293,007,094911,Esmaeilzadeh; Hadi,9999,0,9999,0
1653574657269,CSE 293,008,094912,Freund; Yoav,9999,0,9999,0
1653574657269,CSE 293,009,094913,Griswold; William G.,9999,0,9999,0
1653574657269,CSE 293,010,094914,Gymrek; Melissa Ann,9999,0,9999,0
1653574657269,CSE 293,011,094915,Heninger; Nadia A,9999,0,9999,0
1653574657269,CSE 293,012,094916,Impagliazzo; Russell,9999,0,9999,0
1653574657269,CSE 293,013,094917,Jhala; Ranjit,9999,0,9999,0
1653574657269,CSE 293,014,094918,Kahng; Andrew Byun,9999,0,9999,0
1653574657269,CSE 293,015,094919,Kane; Daniel Mertz,9999,0,9999,0
1653574657269,CSE 293,016,094920,Kriegman; David J,9999,0,9999,0
1653574657269,CSE 293,017,094921,Kumar; Arun Kumar,9999,0,9999,0
1653574657269,CSE 293,018,094922,Lerner; Sorin,9999,0,9999,0
1653574657269,CSE 293,019,094923,Lovett; Shachar,9999,0,9999,0
1653574657269,CSE 293,020,094924,McAuley; Julian John,9999,0,9999,0
1653574657269,CSE 293,021,094925,Micciancio; Daniele,9999,0,9999,0
1653574657269,CSE 293,022,094926,Orailoglu; Alex,9999,0,9999,0
1653574657269,CSE 293,023,094927,Paturi; Ramamohan,9999,0,9999,0
1653574657269,CSE 293,024,094928,Polikarpova; Nadezhda,9999,0,9999,0
1653574657269,CSE 293,025,094929,Politz; Joseph Gibbs,9999,0,9999,0
1653574657269,CSE 293,026,094930,Porter; George M,9999,0,9999,0
1653574657269,CSE 293,027,094931,Porter; Leonard Emerson,9999,0,9999,0
1653574657269,CSE 293,028,094932,Ramamoorthi; Ravi,9999,0,9999,0
1653574657269,CSE 293,029,094933,Sahoo; Debashis,9999,0,9999,0
1653574657269,CSE 293,030,094934,Saul; Lawrence,9999,0,9999,0
1653574657269,CSE 293,031,094935,Savage; Stefan,9999,0,9999,0
1653574657269,CSE 293,032,094936,Schulze; Jurgen P.,9999,0,9999,0
1653574657269,CSE 293,033,094937,Snoeren; Alex C.,9999,0,9999,0
1653574657269,CSE 293,034,094938,Shang; Jingbo,9999,0,9999,0
1653574657269,CSE 293,035,094939,Stefan; Deian,9999,0,9999,0
1653574657269,CSE 293,036,094940,Su; Hao,9999,0,9999,0
1653574657269,CSE 293,037,094941,Swanson; Steven James,9999,0,9999,0
1653574657269,CSE 293,038,094942,Tullsen; Dean Michael,9999,0,9999,0
1653574657269,CSE 293,039,094943,Voelker; Geoffrey M.,9999,0,9999,0
1653574657269,CSE 293,040,094944,Zhao; Jishen,9999,0,9999,0
1653574657269,CSE 293,041,094945,Zhou; Yuan-Yuan,9999,0,9999,0
1653574657269,CSE 293,042,094946,Gao; Sicun,9998,0,9999,1
1653574657269,CSE 293,043,094947,Weibel; Nadir,9999,0,9999,0
1653574657269,CSE 293,044,094948,Gupta; Rajesh K.,9999,0,9999,0
1653574657801,CSE 294,A00,090143,Porter; George M,8,0,10,2
1653574658323,DSE 200,A00,091799,Staff,50,0,50,0
1653574658846,DSE 203,A00,091800,Gupta; Amarnath,30,0,30,0
1653574659370,DSE 250,A00,091801,Deutsch; Alin Bernard,30,0,30,0
1653574659894,DSE 290,A00,091802,Altintas De Callaf; Ilkay,50,0,50,0
1653574660431,ECE 200,001,091003,Antipa; Nicholas A,9999,0,9999,0
1653574660431,ECE 200,002,091004,Atanasov; Nikolay A.,9999,0,9999,0
1653574660431,ECE 200,003,091005,Bharadia; Dinesh,9999,0,9999,0
1653574660431,ECE 200,004,091006,Cheng; Chung Kuan,9999,0,9999,0
1653574660431,ECE 200,005,091007,Cosman; Pamela C.,9999,0,9999,0
1653574660431,ECE 200,006,091008,Staff,9999,0,9999,0
1653574660431,ECE 200,007,091009,Dayeh; Shadi Ahmad,9999,0,9999,0
1653574660431,ECE 200,008,091010,Fainman; Yeshaiahu,9999,0,9999,0
1653574660431,ECE 200,009,091011,Ford; Joseph Earl,9999,0,9999,0
1653574660431,ECE 200,010,091012,Franceschetti; Massimo,9999,0,9999,0
1653574660431,ECE 200,011,091013,Fullerton; Eric E,9999,0,9999,0
1653574660431,ECE 200,012,091014,Galton; Ian A,9999,0,9999,0
1653574660431,ECE 200,013,091015,Gilja; Vikash,9999,0,9999,0
1653574660431,ECE 200,014,091016,Hall; Drew A.,9999,0,9999,0
1653574660431,ECE 200,015,091017,Hsueh; Tzu-Chien,9999,0,9999,0
1653574660431,ECE 200,016,091018,Javidi; Tara,9999,0,9999,0
1653574660431,ECE 200,017,091019,Kahng; Andrew Byun,9999,0,9999,0
1653574660431,ECE 200,018,091020,Kim; Young-Han,9999,0,9999,0
1653574660431,ECE 200,019,091021,Koushanfar; Farinaz,9999,0,9999,0
1653574660431,ECE 200,020,091022,Kuzum; Duygu,9999,0,9999,0
1653574660431,ECE 200,021,091023,Le; Hanh-Phuc,9999,0,9999,0
1653574660431,ECE 200,022,091024,Lin; Bill,9999,0,9999,0
1653574660431,ECE 200,023,091025,Liu; Zhaowei,9999,0,9999,0
1653574660431,ECE 200,024,091026,Lo; Yu-Hwa,9999,0,9999,0
1653574660431,ECE 200,025,091027,Lomakin; Vitaliy,9999,0,9999,0
1653574660431,ECE 200,026,091028,Mercier; Patrick Philip,9999,0,9999,0
1653574660431,ECE 200,027,091029,Meyer; Florian,9999,0,9999,0
1653574660431,ECE 200,028,091030,Milstein; Laurence B.,9999,0,9999,0
1653574660431,ECE 200,029,091031,Mir Arabbaygi; Siavash,9999,0,9999,0
1653574660431,ECE 200,030,091032,Mookherjea; Shayan,9999,0,9999,0
1653574660431,ECE 200,031,091033,Morris; Karcher William,9999,0,9999,0
1653574660431,ECE 200,032,091034,Ng; Tse Nga,9999,0,9999,0
1653574660431,ECE 200,033,091035,Nguyen; Truong Quang,9999,0,9999,0
1653574660431,ECE 200,034,091036,Nomura; Kenji,9999,0,9999,0
1653574660431,ECE 200,035,091037,Orlitsky; Alon,9999,0,9999,0
1653574660431,ECE 200,036,091038,Pal; Piya,9999,0,9999,0
1653574660431,ECE 200,037,091039,Papen; George C.,9999,0,9999,0
1653574660431,ECE 200,038,091040,Radic; Stojan,9999,0,9999,0
1653574660431,ECE 200,039,091041,Rao; Bhaskar D.,9999,0,9999,0
1653574660431,ECE 200,040,091042,Rao; Ramesh R,9999,0,9999,0
1653574660431,ECE 200,041,091043,Rebeiz; Gabriel,9999,0,9999,0
1653574660431,ECE 200,042,091044,Sanford; John R,9999,0,9999,0
1653574660431,ECE 200,043,091045,Siegel; Paul H.,9999,0,9999,0
1653574660431,ECE 200,044,091046,Sievenpiper; Daniel F.,9999,0,9999,0
1653574660431,ECE 200,045,091047,Sworder; David D.,9999,0,9999,0
1653574660431,ECE 200,046,091048,Taur; Yuan,9999,0,9999,0
1653574660431,ECE 200,047,091049,Touri; Behrouz,9999,0,9999,0
1653574660431,ECE 200,048,091050,Trivedi; Mohan M.,9999,0,9999,0
1653574660431,ECE 200,049,091051,Vardy; Alexander,9999,0,9999,0
1653574660431,ECE 200,050,091052,Vasconcelos; Nuno,9999,0,9999,0
1653574660431,ECE 200,051,091053,Wang; Xiaolong,9999,0,9999,0
1653574660431,ECE 200,052,091054,Xie; Pengtao,9999,0,9999,0
1653574660431,ECE 200,053,091055,Yip; Michael,9999,0,9999,0
1653574660431,ECE 200,054,091056,Zeger; Kenneth A.,9999,0,9999,0
1653574660431,ECE 200,055,091057,Zhang; Xinyu,9999,0,9999,0
1653574660431,ECE 200,056,091058,Turakhia; Yatish Girish,9999,0,9999,0
1653574660431,ECE 200,057,091059,Kang; Mingu,9999,0,9999,0
1653574660431,ECE 200,058,091060,Shi; Yuanyuan,9999,0,9999,0
1653574660431,ECE 200,059,091061,Wang; Edward Jay,9999,0,9999,0
1653574660431,ECE 200,060,091062,Zheng; Yang,9999,0,9999,0
1653574660957,ECE 201,A00,095526,Lo; Yu-Hwa,0,0,0,0
1653574661483,ECE 203,A00,091065,Mercier; Patrick Philip,0,0,0,0
1653574662011,ECE 207A,A00,091605,Liu; Thomas Tao-Ming,0,0,0,0
1653574662537,ECE 212AN,A00,091068,Nomura; Kenji,0,0,0,0
1653574663058,ECE 222A,A00,091069,Rebeiz; Gabriel,0,0,0,0
1653574663588,ECE 225A,A00,091070,Orlitsky; Alon,0,0,0,0
1653574664110,ECE 230A,A00,091071,Nomura; Kenji,0,0,0,0
1653574664636,ECE 236A,A00,091072,Dayeh; Shadi Ahmad,0,0,0,0
1653574665158,ECE 238A,A00,091073,Luo; Jian,0,0,0,0
1653574665158,ECE 238A,B00,091074,Luo; Jian,0,0,0,0
1653574665682,ECE 240A,A00,091075,Radic; Stojan,0,0,0,0
1653574666206,ECE 247A,A00,091592,Shi; Lingyan,0,0,0,0
1653574666733,ECE 250,A00,091076,Touri; Behrouz,0,0,0,0
1653574667257,ECE 251C,A00,091078,Nguyen; Truong Quang,0,0,0,0
1653574667783,ECE 253,A00,091079,Cosman; Pamela C.,0,0,0,0
1653574668318,ECE 255A,A00,091080,Orlitsky; Alon,0,0,0,0
1653574668842,ECE 257A,A00,091081,Zhang; Xinyu,0,0,0,0
1653574669367,ECE 260A,A01,091084,Eldon; John,0,0,0,0
1653574669893,ECE 264C,A00,091085,Galton; Ian A,0,0,0,0
1653574670417,ECE 265C,A00,094889,Presti; Calogero Davide,0,0,0,9
1653574670943,ECE 266,A01,091087,Hall; Drew A.,0,0,0,0
1653574671989,ECE 271A,A00,091090,Vasconcelos; Nuno,0,0,0,0
1653574672522,ECE 272B,A00,091091,Sworder; David D.,0,0,0,0
1653574673058,ECE 275A,A00,091092,Meyer; Florian,0,0,0,0
1653574673586,ECE 277,A00,091093,An; Cheolhong,0,0,0,0
1653574674112,ECE 283,A00,091094,Le; Hanh-Phuc,0,0,0,0
1653574674643,ECE 284,A00,091095,Kang; Mingu,0,0,0,0
1653574674643,ECE 284,B00,091096,Wang; Edward Jay,0,0,0,0
1653574675168,ECE 285,A00,094334,Touri; Behrouz,0,0,0,0
1653574675694,ECE 289,A00,091097,Whelan; David Arthur,0,0,0,0
1653574676217,MATH 200A,A00,087414,Salehi Golsefidy; Alireza,7,0,8,1
1653574676739,MATH 202A,A00,087415,Gill; Philip E.,2,0,8,6
1653574677281,MATH 203A,A00,087416,Oprea; Dragos N.,6,0,8,2
1653574677804,MATH 204A,A00,087417,Kedlaya; Kiran S.,6,0,8,2
1653574678330,MATH 205,A00,087418,Sorensen; Claus M,6,0,8,2
1653574678862,MATH 206A,A00,087419,Izadi; Elham,7,0,8,1
1653574679388,MATH 207A,A00,087420,Mohammadi; Amir,5,0,8,3
1653574679910,MATH 208,A00,087421,Staff,9,0,10,1
1653574680436,MATH 209,A00,087422,Staff,10,0,10,0
1653574680961,MATH 218,A00,087423,Staff,10,0,10,0
1653574681484,MATH 220A,A00,087424,Novak; Jonathan I,6,0,8,2
1653574682007,MATH 231A,A00,087425,Bejenaru; Ioan,3,0,8,5
1653574682529,MATH 240A,A00,087426,Ebenfelt; Peter F,5,0,8,3
1653574683058,MATH 243,A00,087427,Staff,9,0,10,1
1653574683594,MATH 248,A00,087429,Staff,10,0,10,0
1653574684119,MATH 250A,A00,087430,Spolaor; Luca,4,0,8,4
1653574684642,MATH 257A,A00,087431,Spolaor; Luca,7,0,8,1
1653574685167,MATH 258,A00,087432,Staff,9,0,10,1
1653574685693,MATH 264A,A00,087433,Warnke; Lutz Peter,5,0,8,3
1653574686217,MATH 268,A00,087434,Staff,15,0,15,0
1653574686741,MATH 269,A00,087435,Staff,14,0,15,1
1653574687266,MATH 270A,A00,087436,Nie; Jiawang,0,0,8,8
1653574687792,MATH 272A,A00,087437,Tian; Xiaochuan,1,0,8,7
1653574688314,MATH 274,A01,087439,Cheng; Li-Tien,9,0,10,1
1653574688314,MATH 274,A02,087440,Cheng; Li-Tien,10,0,10,0
1653574688841,MATH 278A,A00,087441,Staff,8,0,10,2
1653574689363,MATH 278B,A00,087442,Staff,8,0,10,2
1653574689887,MATH 278C,A00,087443,Staff,8,0,10,2
1653574690410,MATH 280A,A00,087444,Zheng; Tianyi,0,0,8,8
1653574690933,MATH 281A,A00,087445,Bradic; Jelena,0,0,8,8
1653574691459,MATH 282A,A00,087446,Zhang; Danna,0,0,8,8
1653574691982,MATH 283,A00,087447,Tesler; Glenn,0,0,0,15
1653574692519,MATH 286,A00,087448,Kemp; Todd Aahron,5,0,8,3
1653574693048,MATH 287D,A00,087449,Bradic; Jelena,0,0,0,1
1653574693572,MATH 288,A00,087450,Staff,14,0,15,1
1653574693572,MATH 288,B00,087451,Staff,15,0,15,0
1653574693572,MATH 288,C00,087452,Staff,15,0,15,0
1653574694100,MATH 290A,A00,087453,Xu; Zhouli,6,0,8,2
1653574694625,MATH 291A,A00,087454,Xu; Zhouli,7,0,8,1
1653574695147,MATH 292,A00,087455,Staff,10,0,10,0
1653574695669,MATH 295,A00,087456,Staff,50,0,50,0
1653574696191,MATH 297,001,087457,Staff,998,0,999,1
1653575256387,COGS 200,A01,087991,Staff,47,0,50,3
1653575256915,COGS 201,A01,094504,Rangel; Lara M,17,0,25,8
1653575257438,COGS 203,A00,087992,Coulson; Seana M,18,0,20,2
1653575257961,COGS 210A,001,087993,Greene; Deanna Jacquelyn,9998,0,9999,1
1653575257961,COGS 210A,002,087994,Saygin; Ayse P,9999,0,9999,0
1653575257961,COGS 210A,003,087995,Xia; Haijun,9999,0,9999,0
1653575257961,COGS 210A,004,087996,Nitz; Douglas A.,9999,0,9999,0
1653575257961,COGS 210A,005,087997,Hollan; James D.,9999,0,9999,0
1653575257961,COGS 210A,006,087998,Deak; Gedeon O.,9998,0,9999,1
1653575257961,COGS 210A,007,087999,Rossano; Federico,9999,0,9999,0
1653575258483,COGS 211A,A00,088000,Coulson; Seana M,9997,0,9999,2
1653575259011,COGS 229,A00,088002,Staff,22,0,25,3
1653575259536,COGS 260,B00,094231,Staff,17,0,20,3
1653575259536,COGS 260,A00,088004,Nitz; Douglas A.,9998,0,9999,1
1653575260064,CSE 202,A00,090110,Paturi; Ramamohan,0,0,0,0
1653575260064,CSE 202,B00,090111,Paturi; Ramamohan,0,0,0,0
1653575260595,CSE 207B,A00,090112,Heninger; Nadia A,0,0,0,0
1653575261121,CSE 208,A00,094858,Micciancio; Daniele,0,0,0,0
1653575261644,CSE 210,A00,090113,Powell; Thomas Allan,0,0,0,0
1653575262168,CSE 219,A00,090898,Staff,0,0,0,0
1653575262700,CSE 221,A00,090114,Zhou; Yuan-Yuan,0,0,0,0
1653575263222,CSE 229A,A00,090115,Porter; George M,0,0,0,0
1653575263746,CSE 229C,A00,090116,Savage; Stefan,0,0,0,0
1653575264273,CSE 230,A00,090117,Jhala; Ranjit,0,0,0,0
1653575264796,CSE 232,A00,090118,Papakonstantinou; Yannis,0,0,0,0
1653575265319,CSE 239A,A00,090121,Kumar; Arun Kumar,0,0,0,0
1653575265841,CSE 239B,A00,090122,Jhala; Ranjit,0,0,0,0
1653575266364,CSE 240A,A00,090123,Zhao; Jishen,1,0,189,188
1653575266888,CSE 243A,A00,090124,Orailoglu; Alex,0,0,15,15
1653575267411,CSE 249B,A00,090125,Kahng; Andrew Byun,13,0,20,7
1653575267934,CSE 250A,A00,090126,Berg-Kirkpatrick; Taylor D,0,0,0,0
1653575268461,CSE 252A,A00,090127,Ochoa; Benjamin Lawrence,0,0,0,0
1653575268983,CSE 258,A01,090129,McAuley; Julian John,0,0,0,0
1653575269510,CSE 258R,A01,090131,McAuley; Julian John,0,0,0,0
1653575270043,CSE 274,A00,090132,Ramamoorthi; Ravi,0,0,0,0
1653575270567,CSE 276A,A00,090133,Christensen; Henrik I,0,0,0,0
1653575271090,CSE 276C,A00,090134,Christensen; Henrik I,0,0,0,0
1653575271613,CSE 290,A00,090135,Bafna; Vineet,0,0,0,0
1653575271613,CSE 290,B00,090136,Ramamoorthi; Ravi,0,0,0,0
1653575271613,CSE 290,C00,090137,Li; Tzumao,8,0,10,2
1653575271613,CSE 290,D00,090138,Zhou; Yuan-Yuan,9,0,10,1
1653575271613,CSE 290,E00,090139,Christensen; Henrik I,8,0,10,2
1653575271613,CSE 290,F00,094053,Shalev; Aaron D,0,0,0,0
1653575272136,CSE 291,A00,090140,Munyaka; Imani N. S.,0,0,0,0
1653575272136,CSE 291,B00,094880,Yu; Qi,0,0,0,0
1653575272136,CSE 291,C00,090142,Pannuto; Patrick William,0,0,0,0
1653575272136,CSE 291,D00,094881,Zhang; Yiying,0,0,0,0
1653575272136,CSE 291,E00,095118,Su; Hao,0,0,0,0
1653575272669,CSE 293,001,094905,Bafna; Vineet,9999,0,9999,0
1653575272669,CSE 293,002,094906,Bellare; Mihir,9999,0,9999,0
1653575272669,CSE 293,003,094907,Berg-Kirkpatrick; Taylor D,9999,0,9999,0
1653575272669,CSE 293,004,094908,Christensen; Henrik I,9999,0,9999,0
1653575272669,CSE 293,005,094909,Cottrell; Garrison W,9999,0,9999,0
1653575272669,CSE 293,006,094910,Deutsch; Alin Bernard,9999,0,9999,0
1653575272669,CSE 293,007,094911,Esmaeilzadeh; Hadi,9999,0,9999,0
1653575272669,CSE 293,008,094912,Freund; Yoav,9999,0,9999,0
1653575272669,CSE 293,009,094913,Griswold; William G.,9999,0,9999,0
1653575272669,CSE 293,010,094914,Gymrek; Melissa Ann,9999,0,9999,0
1653575272669,CSE 293,011,094915,Heninger; Nadia A,9999,0,9999,0
1653575272669,CSE 293,012,094916,Impagliazzo; Russell,9999,0,9999,0
1653575272669,CSE 293,013,094917,Jhala; Ranjit,9999,0,9999,0
1653575272669,CSE 293,014,094918,Kahng; Andrew Byun,9999,0,9999,0
1653575272669,CSE 293,015,094919,Kane; Daniel Mertz,9999,0,9999,0
1653575272669,CSE 293,016,094920,Kriegman; David J,9999,0,9999,0
1653575272669,CSE 293,017,094921,Kumar; Arun Kumar,9999,0,9999,0
1653575272669,CSE 293,018,094922,Lerner; Sorin,9999,0,9999,0
1653575272669,CSE 293,019,094923,Lovett; Shachar,9999,0,9999,0
1653575272669,CSE 293,020,094924,McAuley; Julian John,9999,0,9999,0
1653575272669,CSE 293,021,094925,Micciancio; Daniele,9999,0,9999,0
1653575272669,CSE 293,022,094926,Orailoglu; Alex,9999,0,9999,0
1653575272669,CSE 293,023,094927,Paturi; Ramamohan,9999,0,9999,0
1653575272669,CSE 293,024,094928,Polikarpova; Nadezhda,9999,0,9999,0
1653575272669,CSE 293,025,094929,Politz; Joseph Gibbs,9999,0,9999,0
1653575272669,CSE 293,026,094930,Porter; George M,9999,0,9999,0
1653575272669,CSE 293,027,094931,Porter; Leonard Emerson,9999,0,9999,0
1653575272669,CSE 293,028,094932,Ramamoorthi; Ravi,9999,0,9999,0
1653575272669,CSE 293,029,094933,Sahoo; Debashis,9999,0,9999,0
1653575272669,CSE 293,030,094934,Saul; Lawrence,9999,0,9999,0
1653575272669,CSE 293,031,094935,Savage; Stefan,9999,0,9999,0
1653575272669,CSE 293,032,094936,Schulze; Jurgen P.,9999,0,9999,0
1653575272669,CSE 293,033,094937,Snoeren; Alex C.,9999,0,9999,0
1653575272669,CSE 293,034,094938,Shang; Jingbo,9999,0,9999,0
1653575272669,CSE 293,035,094939,Stefan; Deian,9999,0,9999,0
1653575272669,CSE 293,036,094940,Su; Hao,9999,0,9999,0
1653575272669,CSE 293,037,094941,Swanson; Steven James,9999,0,9999,0
1653575272669,CSE 293,038,094942,Tullsen; Dean Michael,9999,0,9999,0
1653575272669,CSE 293,039,094943,Voelker; Geoffrey M.,9999,0,9999,0
1653575272669,CSE 293,040,094944,Zhao; Jishen,9999,0,9999,0
1653575272669,CSE 293,041,094945,Zhou; Yuan-Yuan,9999,0,9999,0
1653575272669,CSE 293,042,094946,Gao; Sicun,9998,0,9999,1
1653575272669,CSE 293,043,094947,Weibel; Nadir,9999,0,9999,0
1653575272669,CSE 293,044,094948,Gupta; Rajesh K.,9999,0,9999,0
1653575273199,CSE 294,A00,090143,Porter; George M,8,0,10,2
1653575273721,DSE 200,A00,091799,Staff,50,0,50,0
1653575274247,DSE 203,A00,091800,Gupta; Amarnath,30,0,30,0
1653575274769,DSE 250,A00,091801,Deutsch; Alin Bernard,30,0,30,0
1653575275291,DSE 290,A00,091802,Altintas De Callaf; Ilkay,50,0,50,0
1653575275818,ECE 200,001,091003,Antipa; Nicholas A,9999,0,9999,0
1653575275818,ECE 200,002,091004,Atanasov; Nikolay A.,9999,0,9999,0
1653575275818,ECE 200,003,091005,Bharadia; Dinesh,9999,0,9999,0
1653575275818,ECE 200,004,091006,Cheng; Chung Kuan,9999,0,9999,0
1653575275818,ECE 200,005,091007,Cosman; Pamela C.,9999,0,9999,0
1653575275818,ECE 200,006,091008,Staff,9999,0,9999,0
1653575275818,ECE 200,007,091009,Dayeh; Shadi Ahmad,9999,0,9999,0
1653575275818,ECE 200,008,091010,Fainman; Yeshaiahu,9999,0,9999,0
1653575275818,ECE 200,009,091011,Ford; Joseph Earl,9999,0,9999,0
1653575275818,ECE 200,010,091012,Franceschetti; Massimo,9999,0,9999,0
1653575275818,ECE 200,011,091013,Fullerton; Eric E,9999,0,9999,0
1653575275818,ECE 200,012,091014,Galton; Ian A,9999,0,9999,0
1653575275818,ECE 200,013,091015,Gilja; Vikash,9999,0,9999,0
1653575275818,ECE 200,014,091016,Hall; Drew A.,9999,0,9999,0
1653575275818,ECE 200,015,091017,Hsueh; Tzu-Chien,9999,0,9999,0
1653575275818,ECE 200,016,091018,Javidi; Tara,9999,0,9999,0
1653575275818,ECE 200,017,091019,Kahng; Andrew Byun,9999,0,9999,0
1653575275818,ECE 200,018,091020,Kim; Young-Han,9999,0,9999,0
1653575275818,ECE 200,019,091021,Koushanfar; Farinaz,9999,0,9999,0
1653575275818,ECE 200,020,091022,Kuzum; Duygu,9999,0,9999,0
1653575275818,ECE 200,021,091023,Le; Hanh-Phuc,9999,0,9999,0
1653575275818,ECE 200,022,091024,Lin; Bill,9999,0,9999,0
1653575275818,ECE 200,023,091025,Liu; Zhaowei,9999,0,9999,0
1653575275818,ECE 200,024,091026,Lo; Yu-Hwa,9999,0,9999,0
1653575275818,ECE 200,025,091027,Lomakin; Vitaliy,9999,0,9999,0
1653575275818,ECE 200,026,091028,Mercier; Patrick Philip,9999,0,9999,0
1653575275818,ECE 200,027,091029,Meyer; Florian,9999,0,9999,0
1653575275818,ECE 200,028,091030,Milstein; Laurence B.,9999,0,9999,0
1653575275818,ECE 200,029,091031,Mir Arabbaygi; Siavash,9999,0,9999,0
1653575275818,ECE 200,030,091032,Mookherjea; Shayan,9999,0,9999,0
1653575275818,ECE 200,031,091033,Morris; Karcher William,9999,0,9999,0
1653575275818,ECE 200,032,091034,Ng; Tse Nga,9999,0,9999,0
1653575275818,ECE 200,033,091035,Nguyen; Truong Quang,9999,0,9999,0
1653575275818,ECE 200,034,091036,Nomura; Kenji,9999,0,9999,0
1653575275818,ECE 200,035,091037,Orlitsky; Alon,9999,0,9999,0
1653575275818,ECE 200,036,091038,Pal; Piya,9999,0,9999,0
1653575275818,ECE 200,037,091039,Papen; George C.,9999,0,9999,0
1653575275818,ECE 200,038,091040,Radic; Stojan,9999,0,9999,0
1653575275818,ECE 200,039,091041,Rao; Bhaskar D.,9999,0,9999,0
1653575275818,ECE 200,040,091042,Rao; Ramesh R,9999,0,9999,0
1653575275818,ECE 200,041,091043,Rebeiz; Gabriel,9999,0,9999,0
1653575275818,ECE 200,042,091044,Sanford; John R,9999,0,9999,0
1653575275818,ECE 200,043,091045,Siegel; Paul H.,9999,0,9999,0
1653575275818,ECE 200,044,091046,Sievenpiper; Daniel F.,9999,0,9999,0
1653575275818,ECE 200,045,091047,Sworder; David D.,9999,0,9999,0
1653575275818,ECE 200,046,091048,Taur; Yuan,9999,0,9999,0
1653575275818,ECE 200,047,091049,Touri; Behrouz,9999,0,9999,0
1653575275818,ECE 200,048,091050,Trivedi; Mohan M.,9999,0,9999,0
1653575275818,ECE 200,049,091051,Vardy; Alexander,9999,0,9999,0
1653575275818,ECE 200,050,091052,Vasconcelos; Nuno,9999,0,9999,0
1653575275818,ECE 200,051,091053,Wang; Xiaolong,9999,0,9999,0
1653575275818,ECE 200,052,091054,Xie; Pengtao,9999,0,9999,0
1653575275818,ECE 200,053,091055,Yip; Michael,9999,0,9999,0
1653575275818,ECE 200,054,091056,Zeger; Kenneth A.,9999,0,9999,0
1653575275818,ECE 200,055,091057,Zhang; Xinyu,9999,0,9999,0
1653575275818,ECE 200,056,091058,Turakhia; Yatish Girish,9999,0,9999,0
1653575275818,ECE 200,057,091059,Kang; Mingu,9999,0,9999,0
1653575275818,ECE 200,058,091060,Shi; Yuanyuan,9999,0,9999,0
1653575275818,ECE 200,059,091061,Wang; Edward Jay,9999,0,9999,0
1653575275818,ECE 200,060,091062,Zheng; Yang,9999,0,9999,0
1653575276345,ECE 201,A00,095526,Lo; Yu-Hwa,0,0,0,0
1653575276872,ECE 203,A00,091065,Mercier; Patrick Philip,0,0,0,0
1653575277393,ECE 207A,A00,091605,Liu; Thomas Tao-Ming,0,0,0,0
1653575277917,ECE 212AN,A00,091068,Nomura; Kenji,0,0,0,0
1653575278441,ECE 222A,A00,091069,Rebeiz; Gabriel,0,0,0,0
1653575278970,ECE 225A,A00,091070,Orlitsky; Alon,0,0,0,0
1653575279492,ECE 230A,A00,091071,Nomura; Kenji,0,0,0,0
1653575280018,ECE 236A,A00,091072,Dayeh; Shadi Ahmad,0,0,0,0
1653575280549,ECE 238A,A00,091073,Luo; Jian,0,0,0,0
1653575280549,ECE 238A,B00,091074,Luo; Jian,0,0,0,0
1653575281072,ECE 240A,A00,091075,Radic; Stojan,0,0,0,0
1653575281603,ECE 247A,A00,091592,Shi; Lingyan,0,0,0,0
1653575282133,ECE 250,A00,091076,Touri; Behrouz,0,0,0,0
1653575282659,ECE 251C,A00,091078,Nguyen; Truong Quang,0,0,0,0
1653575283183,ECE 253,A00,091079,Cosman; Pamela C.,0,0,0,0
1653575283705,ECE 255A,A00,091080,Orlitsky; Alon,0,0,0,0
1653575284228,ECE 257A,A00,091081,Zhang; Xinyu,0,0,0,0
1653575284751,ECE 260A,A01,091084,Eldon; John,0,0,0,0
1653575285283,ECE 264C,A00,091085,Galton; Ian A,0,0,0,0
1653575285807,ECE 265C,A00,094889,Presti; Calogero Davide,0,0,0,9
1653575286329,ECE 266,A01,091087,Hall; Drew A.,0,0,0,0
1653575287477,ECE 271A,A00,091090,Vasconcelos; Nuno,0,0,0,0
1653575288003,ECE 272B,A00,091091,Sworder; David D.,0,0,0,0
1653575288536,ECE 275A,A00,091092,Meyer; Florian,0,0,0,0
1653575289058,ECE 277,A00,091093,An; Cheolhong,0,0,0,0
1653575289596,ECE 283,A00,091094,Le; Hanh-Phuc,0,0,0,0
1653575290125,ECE 284,A00,091095,Kang; Mingu,0,0,0,0
1653575290125,ECE 284,B00,091096,Wang; Edward Jay,0,0,0,0
1653575290654,ECE 285,A00,094334,Touri; Behrouz,0,0,0,0
1653575291186,ECE 289,A00,091097,Whelan; David Arthur,0,0,0,0
1653575291712,MATH 200A,A00,087414,Salehi Golsefidy; Alireza,7,0,8,1
1653575292234,MATH 202A,A00,087415,Gill; Philip E.,2,0,8,6
1653575292756,MATH 203A,A00,087416,Oprea; Dragos N.,6,0,8,2
1653575293289,MATH 204A,A00,087417,Kedlaya; Kiran S.,6,0,8,2
1653575293812,MATH 205,A00,087418,Sorensen; Claus M,6,0,8,2
1653575294335,MATH 206A,A00,087419,Izadi; Elham,7,0,8,1
1653575294861,MATH 207A,A00,087420,Mohammadi; Amir,5,0,8,3
1653575295386,MATH 208,A00,087421,Staff,9,0,10,1
1653575295907,MATH 209,A00,087422,Staff,10,0,10,0
1653575296430,MATH 218,A00,087423,Staff,10,0,10,0
1653575296962,MATH 220A,A00,087424,Novak; Jonathan I,6,0,8,2
1653575297489,MATH 231A,A00,087425,Bejenaru; Ioan,3,0,8,5
1653575298015,MATH 240A,A00,087426,Ebenfelt; Peter F,5,0,8,3
1653575298541,MATH 243,A00,087427,Staff,9,0,10,1
1653575299066,MATH 248,A00,087429,Staff,10,0,10,0
1653575299593,MATH 250A,A00,087430,Spolaor; Luca,4,0,8,4
1653575300119,MATH 257A,A00,087431,Spolaor; Luca,7,0,8,1
1653575300644,MATH 258,A00,087432,Staff,9,0,10,1
1653575301171,MATH 264A,A00,087433,Warnke; Lutz Peter,5,0,8,3
1653575301694,MATH 268,A00,087434,Staff,15,0,15,0
1653575302217,MATH 269,A00,087435,Staff,14,0,15,1
1653575302748,MATH 270A,A00,087436,Nie; Jiawang,0,0,8,8
1653575303271,MATH 272A,A00,087437,Tian; Xiaochuan,1,0,8,7
1653575303802,MATH 274,A01,087439,Cheng; Li-Tien,9,0,10,1
1653575303802,MATH 274,A02,087440,Cheng; Li-Tien,10,0,10,0
1653575304326,MATH 278A,A00,087441,Staff,8,0,10,2
1653575304849,MATH 278B,A00,087442,Staff,8,0,10,2
1653575305376,MATH 278C,A00,087443,Staff,8,0,10,2
1653575305901,MATH 280A,A00,087444,Zheng; Tianyi,0,0,8,8
1653575306434,MATH 281A,A00,087445,Bradic; Jelena,0,0,8,8
1653575306965,MATH 282A,A00,087446,Zhang; Danna,0,0,8,8
1653575307488,MATH 283,A00,087447,Tesler; Glenn,0,0,0,15
1653575308011,MATH 286,A00,087448,Kemp; Todd Aahron,5,0,8,3
1653575308534,MATH 287D,A00,087449,Bradic; Jelena,0,0,0,1
1653575309060,MATH 288,A00,087450,Staff,14,0,15,1
1653575309060,MATH 288,B00,087451,Staff,15,0,15,0
1653575309060,MATH 288,C00,087452,Staff,15,0,15,0
1653575309583,MATH 290A,A00,087453,Xu; Zhouli,6,0,8,2
1653575310107,MATH 291A,A00,087454,Xu; Zhouli,7,0,8,1
1653575310630,MATH 292,A00,087455,Staff,10,0,10,0
1653575311153,MATH 295,A00,087456,Staff,50,0,50,0
1653575311677,MATH 297,001,087457,Staff,998,0,999,1
1653575871946,COGS 200,A01,087991,Staff,47,0,50,3
1653575872470,COGS 201,A01,094504,Rangel; Lara M,17,0,25,8
1653575872992,COGS 203,A00,087992,Coulson; Seana M,18,0,20,2
1653575873519,COGS 210A,001,087993,Greene; Deanna Jacquelyn,9998,0,9999,1
1653575873519,COGS 210A,002,087994,Saygin; Ayse P,9999,0,9999,0
1653575873519,COGS 210A,003,087995,Xia; Haijun,9999,0,9999,0
1653575873519,COGS 210A,004,087996,Nitz; Douglas A.,9999,0,9999,0
1653575873519,COGS 210A,005,087997,Hollan; James D.,9999,0,9999,0
1653575873519,COGS 210A,006,087998,Deak; Gedeon O.,9998,0,9999,1
1653575873519,COGS 210A,007,087999,Rossano; Federico,9999,0,9999,0
1653575874041,COGS 211A,A00,088000,Coulson; Seana M,9997,0,9999,2
1653575874640,COGS 229,A00,088002,Staff,22,0,25,3
1653575875169,COGS 260,B00,094231,Staff,17,0,20,3
1653575875169,COGS 260,A00,088004,Nitz; Douglas A.,9998,0,9999,1
1653575875697,CSE 202,A00,090110,Paturi; Ramamohan,0,0,0,0
1653575875697,CSE 202,B00,090111,Paturi; Ramamohan,0,0,0,0
1653575876220,CSE 207B,A00,090112,Heninger; Nadia A,0,0,0,0
1653575876742,CSE 208,A00,094858,Micciancio; Daniele,0,0,0,0
1653575877272,CSE 210,A00,090113,Powell; Thomas Allan,0,0,0,0
1653575877797,CSE 219,A00,090898,Staff,0,0,0,0
1653575878321,CSE 221,A00,090114,Zhou; Yuan-Yuan,0,0,0,0
1653575878843,CSE 229A,A00,090115,Porter; George M,0,0,0,0
1653575879370,CSE 229C,A00,090116,Savage; Stefan,0,0,0,0
1653575879892,CSE 230,A00,090117,Jhala; Ranjit,0,0,0,0
1653575880416,CSE 232,A00,090118,Papakonstantinou; Yannis,0,0,0,0
1653575880939,CSE 239A,A00,090121,Kumar; Arun Kumar,0,0,0,0
1653575881467,CSE 239B,A00,090122,Jhala; Ranjit,0,0,0,0
1653575881989,CSE 240A,A00,090123,Zhao; Jishen,1,0,189,188
1653575882519,CSE 243A,A00,090124,Orailoglu; Alex,0,0,15,15
1653575883052,CSE 249B,A00,090125,Kahng; Andrew Byun,13,0,20,7
1653575883575,CSE 250A,A00,090126,Berg-Kirkpatrick; Taylor D,0,0,0,0
1653575884099,CSE 252A,A00,090127,Ochoa; Benjamin Lawrence,0,0,0,0
1653575884624,CSE 258,A01,090129,McAuley; Julian John,0,0,0,0
1653575885148,CSE 258R,A01,090131,McAuley; Julian John,0,0,0,0
1653575885671,CSE 274,A00,090132,Ramamoorthi; Ravi,0,0,0,0
1653575886193,CSE 276A,A00,090133,Christensen; Henrik I,0,0,0,0
1653575886717,CSE 276C,A00,090134,Christensen; Henrik I,0,0,0,0
1653575887255,CSE 290,A00,090135,Bafna; Vineet,0,0,0,0
1653575887255,CSE 290,B00,090136,Ramamoorthi; Ravi,0,0,0,0
1653575887255,CSE 290,C00,090137,Li; Tzumao,8,0,10,2
1653575887255,CSE 290,D00,090138,Zhou; Yuan-Yuan,9,0,10,1
1653575887255,CSE 290,E00,090139,Christensen; Henrik I,8,0,10,2
1653575887255,CSE 290,F00,094053,Shalev; Aaron D,0,0,0,0
1653575887783,CSE 291,A00,090140,Munyaka; Imani N. S.,0,0,0,0
1653575887783,CSE 291,B00,094880,Yu; Qi,0,0,0,0
1653575887783,CSE 291,C00,090142,Pannuto; Patrick William,0,0,0,0
1653575887783,CSE 291,D00,094881,Zhang; Yiying,0,0,0,0
1653575887783,CSE 291,E00,095118,Su; Hao,0,0,0,0
1653575888309,CSE 293,001,094905,Bafna; Vineet,9999,0,9999,0
1653575888309,CSE 293,002,094906,Bellare; Mihir,9999,0,9999,0
1653575888309,CSE 293,003,094907,Berg-Kirkpatrick; Taylor D,9999,0,9999,0
1653575888309,CSE 293,004,094908,Christensen; Henrik I,9999,0,9999,0
1653575888309,CSE 293,005,094909,Cottrell; Garrison W,9999,0,9999,0
1653575888309,CSE 293,006,094910,Deutsch; Alin Bernard,9999,0,9999,0
1653575888309,CSE 293,007,094911,Esmaeilzadeh; Hadi,9999,0,9999,0
1653575888309,CSE 293,008,094912,Freund; Yoav,9999,0,9999,0
1653575888309,CSE 293,009,094913,Griswold; William G.,9999,0,9999,0
1653575888309,CSE 293,010,094914,Gymrek; Melissa Ann,9999,0,9999,0
1653575888309,CSE 293,011,094915,Heninger; Nadia A,9999,0,9999,0
1653575888309,CSE 293,012,094916,Impagliazzo; Russell,9999,0,9999,0
1653575888309,CSE 293,013,094917,Jhala; Ranjit,9999,0,9999,0
1653575888309,CSE 293,014,094918,Kahng; Andrew Byun,9999,0,9999,0
1653575888309,CSE 293,015,094919,Kane; Daniel Mertz,9999,0,9999,0
1653575888309,CSE 293,016,094920,Kriegman; David J,9999,0,9999,0
1653575888309,CSE 293,017,094921,Kumar; Arun Kumar,9999,0,9999,0
1653575888309,CSE 293,018,094922,Lerner; Sorin,9999,0,9999,0
1653575888309,CSE 293,019,094923,Lovett; Shachar,9999,0,9999,0
1653575888309,CSE 293,020,094924,McAuley; Julian John,9999,0,9999,0
1653575888309,CSE 293,021,094925,Micciancio; Daniele,9999,0,9999,0
1653575888309,CSE 293,022,094926,Orailoglu; Alex,9999,0,9999,0
1653575888309,CSE 293,023,094927,Paturi; Ramamohan,9999,0,9999,0
1653575888309,CSE 293,024,094928,Polikarpova; Nadezhda,9999,0,9999,0
1653575888309,CSE 293,025,094929,Politz; Joseph Gibbs,9999,0,9999,0
1653575888309,CSE 293,026,094930,Porter; George M,9999,0,9999,0
1653575888309,CSE 293,027,094931,Porter; Leonard Emerson,9999,0,9999,0
1653575888309,CSE 293,028,094932,Ramamoorthi; Ravi,9999,0,9999,0
1653575888309,CSE 293,029,094933,Sahoo; Debashis,9999,0,9999,0
1653575888309,CSE 293,030,094934,Saul; Lawrence,9999,0,9999,0
1653575888309,CSE 293,031,094935,Savage; Stefan,9999,0,9999,0
1653575888309,CSE 293,032,094936,Schulze; Jurgen P.,9999,0,9999,0
1653575888309,CSE 293,033,094937,Snoeren; Alex C.,9999,0,9999,0
1653575888309,CSE 293,034,094938,Shang; Jingbo,9999,0,9999,0
1653575888309,CSE 293,035,094939,Stefan; Deian,9999,0,9999,0
1653575888309,CSE 293,036,094940,Su; Hao,9999,0,9999,0
1653575888309,CSE 293,037,094941,Swanson; Steven James,9999,0,9999,0
1653575888309,CSE 293,038,094942,Tullsen; Dean Michael,9999,0,9999,0
1653575888309,CSE 293,039,094943,Voelker; Geoffrey M.,9999,0,9999,0
1653575888309,CSE 293,040,094944,Zhao; Jishen,9999,0,9999,0
1653575888309,CSE 293,041,094945,Zhou; Yuan-Yuan,9999,0,9999,0
1653575888309,CSE 293,042,094946,Gao; Sicun,9998,0,9999,1
1653575888309,CSE 293,043,094947,Weibel; Nadir,9999,0,9999,0
1653575888309,CSE 293,044,094948,Gupta; Rajesh K.,9999,0,9999,0
1653575888832,CSE 294,A00,090143,Porter; George M,8,0,10,2
1653575889355,DSE 200,A00,091799,Staff,50,0,50,0
1653575889878,DSE 203,A00,091800,Gupta; Amarnath,30,0,30,0
1653575890403,DSE 250,A00,091801,Deutsch; Alin Bernard,30,0,30,0
1653575890926,DSE 290,A00,091802,Altintas De Callaf; Ilkay,50,0,50,0
1653575891469,ECE 200,001,091003,Antipa; Nicholas A,9999,0,9999,0
1653575891469,ECE 200,002,091004,Atanasov; Nikolay A.,9999,0,9999,0
1653575891469,ECE 200,003,091005,Bharadia; Dinesh,9999,0,9999,0
1653575891469,ECE 200,004,091006,Cheng; Chung Kuan,9999,0,9999,0
1653575891469,ECE 200,005,091007,Cosman; Pamela C.,9999,0,9999,0
1653575891469,ECE 200,006,091008,Staff,9999,0,9999,0
1653575891469,ECE 200,007,091009,Dayeh; Shadi Ahmad,9999,0,9999,0
1653575891469,ECE 200,008,091010,Fainman; Yeshaiahu,9999,0,9999,0
1653575891469,ECE 200,009,091011,Ford; Joseph Earl,9999,0,9999,0
1653575891469,ECE 200,010,091012,Franceschetti; Massimo,9999,0,9999,0
1653575891469,ECE 200,011,091013,Fullerton; Eric E,9999,0,9999,0
1653575891469,ECE 200,012,091014,Galton; Ian A,9999,0,9999,0
1653575891469,ECE 200,013,091015,Gilja; Vikash,9999,0,9999,0
1653575891469,ECE 200,014,091016,Hall; Drew A.,9999,0,9999,0
1653575891469,ECE 200,015,091017,Hsueh; Tzu-Chien,9999,0,9999,0
1653575891469,ECE 200,016,091018,Javidi; Tara,9999,0,9999,0
1653575891469,ECE 200,017,091019,Kahng; Andrew Byun,9999,0,9999,0
1653575891469,ECE 200,018,091020,Kim; Young-Han,9999,0,9999,0
1653575891469,ECE 200,019,091021,Koushanfar; Farinaz,9999,0,9999,0
1653575891469,ECE 200,020,091022,Kuzum; Duygu,9999,0,9999,0
1653575891469,ECE 200,021,091023,Le; Hanh-Phuc,9999,0,9999,0
1653575891469,ECE 200,022,091024,Lin; Bill,9999,0,9999,0
1653575891469,ECE 200,023,091025,Liu; Zhaowei,9999,0,9999,0
1653575891469,ECE 200,024,091026,Lo; Yu-Hwa,9999,0,9999,0
1653575891469,ECE 200,025,091027,Lomakin; Vitaliy,9999,0,9999,0
1653575891469,ECE 200,026,091028,Mercier; Patrick Philip,9999,0,9999,0
1653575891469,ECE 200,027,091029,Meyer; Florian,9999,0,9999,0
1653575891469,ECE 200,028,091030,Milstein; Laurence B.,9999,0,9999,0
1653575891469,ECE 200,029,091031,Mir Arabbaygi; Siavash,9999,0,9999,0
1653575891469,ECE 200,030,091032,Mookherjea; Shayan,9999,0,9999,0
1653575891469,ECE 200,031,091033,Morris; Karcher William,9999,0,9999,0
1653575891469,ECE 200,032,091034,Ng; Tse Nga,9999,0,9999,0
1653575891469,ECE 200,033,091035,Nguyen; Truong Quang,9999,0,9999,0
1653575891469,ECE 200,034,091036,Nomura; Kenji,9999,0,9999,0
1653575891469,ECE 200,035,091037,Orlitsky; Alon,9999,0,9999,0
1653575891469,ECE 200,036,091038,Pal; Piya,9999,0,9999,0
1653575891469,ECE 200,037,091039,Papen; George C.,9999,0,9999,0
1653575891469,ECE 200,038,091040,Radic; Stojan,9999,0,9999,0
1653575891469,ECE 200,039,091041,Rao; Bhaskar D.,9999,0,9999,0
1653575891469,ECE 200,040,091042,Rao; Ramesh R,9999,0,9999,0
1653575891469,ECE 200,041,091043,Rebeiz; Gabriel,9999,0,9999,0
1653575891469,ECE 200,042,091044,Sanford; John R,9999,0,9999,0
1653575891469,ECE 200,043,091045,Siegel; Paul H.,9999,0,9999,0
1653575891469,ECE 200,044,091046,Sievenpiper; Daniel F.,9999,0,9999,0
1653575891469,ECE 200,045,091047,Sworder; David D.,9999,0,9999,0
1653575891469,ECE 200,046,091048,Taur; Yuan,9999,0,9999,0
1653575891469,ECE 200,047,091049,Touri; Behrouz,9999,0,9999,0
1653575891469,ECE 200,048,091050,Trivedi; Mohan M.,9999,0,9999,0
1653575891469,ECE 200,049,091051,Vardy; Alexander,9999,0,9999,0
1653575891469,ECE 200,050,091052,Vasconcelos; Nuno,9999,0,9999,0
1653575891469,ECE 200,051,091053,Wang; Xiaolong,9999,0,9999,0
1653575891469,ECE 200,052,091054,Xie; Pengtao,9999,0,9999,0
1653575891469,ECE 200,053,091055,Yip; Michael,9999,0,9999,0
1653575891469,ECE 200,054,091056,Zeger; Kenneth A.,9999,0,9999,0
1653575891469,ECE 200,055,091057,Zhang; Xinyu,9999,0,9999,0
1653575891469,ECE 200,056,091058,Turakhia; Yatish Girish,9999,0,9999,0
1653575891469,ECE 200,057,091059,Kang; Mingu,9999,0,9999,0
1653575891469,ECE 200,058,091060,Shi; Yuanyuan,9999,0,9999,0
1653575891469,ECE 200,059,091061,Wang; Edward Jay,9999,0,9999,0
1653575891469,ECE 200,060,091062,Zheng; Yang,9999,0,9999,0
1653575891992,ECE 201,A00,095526,Lo; Yu-Hwa,0,0,0,0
1653575892516,ECE 203,A00,091065,Mercier; Patrick Philip,0,0,0,0
1653575893042,ECE 207A,A00,091605,Liu; Thomas Tao-Ming,0,0,0,0
1653575893568,ECE 212AN,A00,091068,Nomura; Kenji,0,0,0,0
1653575894097,ECE 222A,A00,091069,Rebeiz; Gabriel,0,0,0,0
1653575894620,ECE 225A,A00,091070,Orlitsky; Alon,0,0,0,0
1653575895143,ECE 230A,A00,091071,Nomura; Kenji,0,0,0,0
1653575895669,ECE 236A,A00,091072,Dayeh; Shadi Ahmad,0,0,0,0
1653575896198,ECE 238A,A00,091073,Luo; Jian,0,0,0,0
1653575896198,ECE 238A,B00,091074,Luo; Jian,0,0,0,0
1653575896723,ECE 240A,A00,091075,Radic; Stojan,0,0,0,0
1653575897254,ECE 247A,A00,091592,Shi; Lingyan,0,0,0,0
1653575897777,ECE 250,A00,091076,Touri; Behrouz,0,0,0,0
1653575898307,ECE 251C,A00,091078,Nguyen; Truong Quang,0,0,0,0
1653575898831,ECE 253,A00,091079,Cosman; Pamela C.,0,0,0,0
1653575899357,ECE 255A,A00,091080,Orlitsky; Alon,0,0,0,0
1653575899882,ECE 257A,A00,091081,Zhang; Xinyu,0,0,0,0
1653575900408,ECE 260A,A01,091084,Eldon; John,0,0,0,0
1653575900932,ECE 264C,A00,091085,Galton; Ian A,0,0,0,0
1653575901456,ECE 265C,A00,094889,Presti; Calogero Davide,0,0,0,9
1653575901978,ECE 266,A01,091087,Hall; Drew A.,0,0,0,0
1653575903040,ECE 271A,A00,091090,Vasconcelos; Nuno,0,0,0,0
1653575903563,ECE 272B,A00,091091,Sworder; David D.,0,0,0,0
1653575904086,ECE 275A,A00,091092,Meyer; Florian,0,0,0,0
1653575904609,ECE 277,A00,091093,An; Cheolhong,0,0,0,0
1653575905133,ECE 283,A00,091094,Le; Hanh-Phuc,0,0,0,0
1653575905661,ECE 284,A00,091095,Kang; Mingu,0,0,0,0
1653575905661,ECE 284,B00,091096,Wang; Edward Jay,0,0,0,0
1653575906184,ECE 285,A00,094334,Touri; Behrouz,0,0,0,0
1653575906708,ECE 289,A00,091097,Whelan; David Arthur,0,0,0,0
1653575907256,MATH 200A,A00,087414,Salehi Golsefidy; Alireza,7,0,8,1
1653575907793,MATH 202A,A00,087415,Gill; Philip E.,2,0,8,6
1653575908318,MATH 203A,A00,087416,Oprea; Dragos N.,6,0,8,2
1653575908846,MATH 204A,A00,087417,Kedlaya; Kiran S.,6,0,8,2
1653575909375,MATH 205,A00,087418,Sorensen; Claus M,6,0,8,2
1653575909899,MATH 206A,A00,087419,Izadi; Elham,7,0,8,1
1653575910421,MATH 207A,A00,087420,Mohammadi; Amir,5,0,8,3
1653575910945,MATH 208,A00,087421,Staff,9,0,10,1
1653575911468,MATH 209,A00,087422,Staff,10,0,10,0
1653575911993,MATH 218,A00,087423,Staff,10,0,10,0
1653575912526,MATH 220A,A00,087424,Novak; Jonathan I,6,0,8,2
1653575913053,MATH 231A,A00,087425,Bejenaru; Ioan,3,0,8,5
1653575913577,MATH 240A,A00,087426,Ebenfelt; Peter F,5,0,8,3
1653575914100,MATH 243,A00,087427,Staff,9,0,10,1
1653575914625,MATH 248,A00,087429,Staff,10,0,10,0
1653575915147,MATH 250A,A00,087430,Spolaor; Luca,4,0,8,4
1653575915673,MATH 257A,A00,087431,Spolaor; Luca,7,0,8,1
1653575916195,MATH 258,A00,087432,Staff,9,0,10,1
1653575916722,MATH 264A,A00,087433,Warnke; Lutz Peter,5,0,8,3
1653575917254,MATH 268,A00,087434,Staff,15,0,15,0
1653575917777,MATH 269,A00,087435,Staff,14,0,15,1
1653575918300,MATH 270A,A00,087436,Nie; Jiawang,0,0,8,8
1653575918832,MATH 272A,A00,087437,Tian; Xiaochuan,1,0,8,7
1653575919359,MATH 274,A01,087439,Cheng; Li-Tien,9,0,10,1
1653575919359,MATH 274,A02,087440,Cheng; Li-Tien,10,0,10,0
1653575919894,MATH 278A,A00,087441,Staff,8,0,10,2
1653575920423,MATH 278B,A00,087442,Staff,8,0,10,2
1653575920945,MATH 278C,A00,087443,Staff,8,0,10,2
1653575921469,MATH 280A,A00,087444,Zheng; Tianyi,0,0,8,8
1653575921995,MATH 281A,A00,087445,Bradic; Jelena,0,0,8,8
1653575922522,MATH 282A,A00,087446,Zhang; Danna,0,0,8,8
1653575923049,MATH 283,A00,087447,Tesler; Glenn,0,0,0,15
1653575923572,MATH 286,A00,087448,Kemp; Todd Aahron,5,0,8,3
1653575924100,MATH 287D,A00,087449,Bradic; Jelena,0,0,0,1
1653575924626,MATH 288,A00,087450,Staff,14,0,15,1
1653575924626,MATH 288,B00,087451,Staff,15,0,15,0
1653575924626,MATH 288,C00,087452,Staff,15,0,15,0
1653575925153,MATH 290A,A00,087453,Xu; Zhouli,6,0,8,2
1653575925679,MATH 291A,A00,087454,Xu; Zhouli,7,0,8,1
1653575926214,MATH 292,A00,087455,Staff,10,0,10,0
1653575926750,MATH 295,A00,087456,Staff,50,0,50,0
1653575927283,MATH 297,001,087457,Staff,998,0,999,1
1653576487251,COGS 200,A01,087991,Staff,47,0,50,3
1653576487777,COGS 201,A01,094504,Rangel; Lara M,17,0,25,8
1653576488301,COGS 203,A00,087992,Coulson; Seana M,18,0,20,2
1653576488827,COGS 210A,001,087993,Greene; Deanna Jacquelyn,9998,0,9999,1
1653576488827,COGS 210A,002,087994,Saygin; Ayse P,9999,0,9999,0
1653576488827,COGS 210A,003,087995,Xia; Haijun,9999,0,9999,0
1653576488827,COGS 210A,004,087996,Nitz; Douglas A.,9999,0,9999,0
1653576488827,COGS 210A,005,087997,Hollan; James D.,9999,0,9999,0
1653576488827,COGS 210A,006,087998,Deak; Gedeon O.,9998,0,9999,1
1653576488827,COGS 210A,007,087999,Rossano; Federico,9999,0,9999,0
1653576489349,COGS 211A,A00,088000,Coulson; Seana M,9997,0,9999,2
1653576489871,COGS 229,A00,088002,Staff,22,0,25,3
1653576490395,COGS 260,B00,094231,Staff,17,0,20,3
1653576490395,COGS 260,A00,088004,Nitz; Douglas A.,9998,0,9999,1
1653576490937,CSE 202,A00,090110,Paturi; Ramamohan,0,0,0,0
1653576490937,CSE 202,B00,090111,Paturi; Ramamohan,0,0,0,0
1653576491463,CSE 207B,A00,090112,Heninger; Nadia A,0,0,0,0
1653576491988,CSE 208,A00,094858,Micciancio; Daniele,0,0,0,0
1653576492513,CSE 210,A00,090113,Powell; Thomas Allan,0,0,0,0
1653576493038,CSE 219,A00,090898,Staff,0,0,0,0
1653576493563,CSE 221,A00,090114,Zhou; Yuan-Yuan,0,0,0,0
1653576494089,CSE 229A,A00,090115,Porter; George M,0,0,0,0
1653576494615,CSE 229C,A00,090116,Savage; Stefan,0,0,0,0
1653576495140,CSE 230,A00,090117,Jhala; Ranjit,0,0,0,0
1653576495662,CSE 232,A00,090118,Papakonstantinou; Yannis,0,0,0,0
1653576496187,CSE 239A,A00,090121,Kumar; Arun Kumar,0,0,0,0
1653576496707,CSE 239B,A00,090122,Jhala; Ranjit,0,0,0,0
1653576497233,CSE 240A,A00,090123,Zhao; Jishen,1,0,189,188
1653576497757,CSE 243A,A00,090124,Orailoglu; Alex,0,0,15,15
1653576498289,CSE 249B,A00,090125,Kahng; Andrew Byun,13,0,20,7
1653576498815,CSE 250A,A00,090126,Berg-Kirkpatrick; Taylor D,0,0,0,0
1653576499344,CSE 252A,A00,090127,Ochoa; Benjamin Lawrence,0,0,0,0
1653576499868,CSE 258,A01,090129,McAuley; Julian John,0,0,0,0
1653576500402,CSE 258R,A01,090131,McAuley; Julian John,0,0,0,0
1653576500926,CSE 274,A00,090132,Ramamoorthi; Ravi,0,0,0,0
1653576501448,CSE 276A,A00,090133,Christensen; Henrik I,0,0,0,0
1653576501971,CSE 276C,A00,090134,Christensen; Henrik I,0,0,0,0
1653576502494,CSE 290,A00,090135,Bafna; Vineet,0,0,0,0
1653576502494,CSE 290,B00,090136,Ramamoorthi; Ravi,0,0,0,0
1653576502494,CSE 290,C00,090137,Li; Tzumao,8,0,10,2
1653576502494,CSE 290,D00,090138,Zhou; Yuan-Yuan,9,0,10,1
1653576502494,CSE 290,E00,090139,Christensen; Henrik I,8,0,10,2
1653576502494,CSE 290,F00,094053,Shalev; Aaron D,0,0,0,0
1653576503021,CSE 291,A00,090140,Munyaka; Imani N. S.,0,0,0,0
1653576503021,CSE 291,B00,094880,Yu; Qi,0,0,0,0
1653576503021,CSE 291,C00,090142,Pannuto; Patrick William,0,0,0,0
1653576503021,CSE 291,D00,094881,Zhang; Yiying,0,0,0,0
1653576503021,CSE 291,E00,095118,Su; Hao,0,0,0,0
1653576503546,CSE 293,001,094905,Bafna; Vineet,9999,0,9999,0
1653576503546,CSE 293,002,094906,Bellare; Mihir,9999,0,9999,0
1653576503546,CSE 293,003,094907,Berg-Kirkpatrick; Taylor D,9999,0,9999,0
1653576503546,CSE 293,004,094908,Christensen; Henrik I,9999,0,9999,0
1653576503546,CSE 293,005,094909,Cottrell; Garrison W,9999,0,9999,0
1653576503546,CSE 293,006,094910,Deutsch; Alin Bernard,9999,0,9999,0
1653576503546,CSE 293,007,094911,Esmaeilzadeh; Hadi,9999,0,9999,0
1653576503546,CSE 293,008,094912,Freund; Yoav,9999,0,9999,0
1653576503546,CSE 293,009,094913,Griswold; William G.,9999,0,9999,0
1653576503546,CSE 293,010,094914,Gymrek; Melissa Ann,9999,0,9999,0
1653576503546,CSE 293,011,094915,Heninger; Nadia A,9999,0,9999,0
1653576503546,CSE 293,012,094916,Impagliazzo; Russell,9999,0,9999,0
1653576503546,CSE 293,013,094917,Jhala; Ranjit,9999,0,9999,0
1653576503546,CSE 293,014,094918,Kahng; Andrew Byun,9999,0,9999,0
1653576503546,CSE 293,015,094919,Kane; Daniel Mertz,9999,0,9999,0
1653576503546,CSE 293,016,094920,Kriegman; David J,9999,0,9999,0
1653576503546,CSE 293,017,094921,Kumar; Arun Kumar,9999,0,9999,0
1653576503546,CSE 293,018,094922,Lerner; Sorin,9999,0,9999,0
1653576503546,CSE 293,019,094923,Lovett; Shachar,9999,0,9999,0
1653576503546,CSE 293,020,094924,McAuley; Julian John,9999,0,9999,0
1653576503546,CSE 293,021,094925,Micciancio; Daniele,9999,0,9999,0
1653576503546,CSE 293,022,094926,Orailoglu; Alex,9999,0,9999,0
1653576503546,CSE 293,023,094927,Paturi; Ramamohan,9999,0,9999,0
1653576503546,CSE 293,024,094928,Polikarpova; Nadezhda,9999,0,9999,0
1653576503546,CSE 293,025,094929,Politz; Joseph Gibbs,9999,0,9999,0
1653576503546,CSE 293,026,094930,Porter; George M,9999,0,9999,0
1653576503546,CSE 293,027,094931,Porter; Leonard Emerson,9999,0,9999,0
1653576503546,CSE 293,028,094932,Ramamoorthi; Ravi,9999,0,9999,0
1653576503546,CSE 293,029,094933,Sahoo; Debashis,9999,0,9999,0
1653576503546,CSE 293,030,094934,Saul; Lawrence,9999,0,9999,0
1653576503546,CSE 293,031,094935,Savage; Stefan,9999,0,9999,0
1653576503546,CSE 293,032,094936,Schulze; Jurgen P.,9999,0,9999,0
1653576503546,CSE 293,033,094937,Snoeren; Alex C.,9999,0,9999,0
1653576503546,CSE 293,034,094938,Shang; Jingbo,9999,0,9999,0
1653576503546,CSE 293,035,094939,Stefan; Deian,9999,0,9999,0
1653576503546,CSE 293,036,094940,Su; Hao,9999,0,9999,0
1653576503546,CSE 293,037,094941,Swanson; Steven James,9999,0,9999,0
1653576503546,CSE 293,038,094942,Tullsen; Dean Michael,9999,0,9999,0
1653576503546,CSE 293,039,094943,Voelker; Geoffrey M.,9999,0,9999,0
1653576503546,CSE 293,040,094944,Zhao; Jishen,9999,0,9999,0
1653576503546,CSE 293,041,094945,Zhou; Yuan-Yuan,9999,0,9999,0
1653576503546,CSE 293,042,094946,Gao; Sicun,9998,0,9999,1
1653576503546,CSE 293,043,094947,Weibel; Nadir,9999,0,9999,0
1653576503546,CSE 293,044,094948,Gupta; Rajesh K.,9999,0,9999,0
1653576504072,CSE 294,A00,090143,Porter; George M,8,0,10,2
1653576504596,DSE 200,A00,091799,Staff,50,0,50,0
1653576505119,DSE 203,A00,091800,Gupta; Amarnath,30,0,30,0
1653576505641,DSE 250,A00,091801,Deutsch; Alin Bernard,30,0,30,0
1653576506167,DSE 290,A00,091802,Altintas De Callaf; Ilkay,50,0,50,0
1653576506693,ECE 200,001,091003,Antipa; Nicholas A,9999,0,9999,0
1653576506693,ECE 200,002,091004,Atanasov; Nikolay A.,9999,0,9999,0
1653576506693,ECE 200,003,091005,Bharadia; Dinesh,9999,0,9999,0
1653576506693,ECE 200,004,091006,Cheng; Chung Kuan,9999,0,9999,0
1653576506693,ECE 200,005,091007,Cosman; Pamela C.,9999,0,9999,0
1653576506693,ECE 200,006,091008,Staff,9999,0,9999,0
1653576506693,ECE 200,007,091009,Dayeh; Shadi Ahmad,9999,0,9999,0
1653576506693,ECE 200,008,091010,Fainman; Yeshaiahu,9999,0,9999,0
1653576506693,ECE 200,009,091011,Ford; Joseph Earl,9999,0,9999,0
1653576506693,ECE 200,010,091012,Franceschetti; Massimo,9999,0,9999,0
1653576506693,ECE 200,011,091013,Fullerton; Eric E,9999,0,9999,0
1653576506693,ECE 200,012,091014,Galton; Ian A,9999,0,9999,0
1653576506693,ECE 200,013,091015,Gilja; Vikash,9999,0,9999,0
1653576506693,ECE 200,014,091016,Hall; Drew A.,9999,0,9999,0
1653576506693,ECE 200,015,091017,Hsueh; Tzu-Chien,9999,0,9999,0
1653576506693,ECE 200,016,091018,Javidi; Tara,9999,0,9999,0
1653576506693,ECE 200,017,091019,Kahng; Andrew Byun,9999,0,9999,0
1653576506693,ECE 200,018,091020,Kim; Young-Han,9999,0,9999,0
1653576506693,ECE 200,019,091021,Koushanfar; Farinaz,9999,0,9999,0
1653576506693,ECE 200,020,091022,Kuzum; Duygu,9999,0,9999,0
1653576506693,ECE 200,021,091023,Le; Hanh-Phuc,9999,0,9999,0
1653576506693,ECE 200,022,091024,Lin; Bill,9999,0,9999,0
1653576506693,ECE 200,023,091025,Liu; Zhaowei,9999,0,9999,0
1653576506693,ECE 200,024,091026,Lo; Yu-Hwa,9999,0,9999,0
1653576506693,ECE 200,025,091027,Lomakin; Vitaliy,9999,0,9999,0
1653576506693,ECE 200,026,091028,Mercier; Patrick Philip,9999,0,9999,0
1653576506693,ECE 200,027,091029,Meyer; Florian,9999,0,9999,0
1653576506693,ECE 200,028,091030,Milstein; Laurence B.,9999,0,9999,0
1653576506693,ECE 200,029,091031,Mir Arabbaygi; Siavash,9999,0,9999,0
1653576506693,ECE 200,030,091032,Mookherjea; Shayan,9999,0,9999,0
1653576506693,ECE 200,031,091033,Morris; Karcher William,9999,0,9999,0
1653576506693,ECE 200,032,091034,Ng; Tse Nga,9999,0,9999,0
1653576506693,ECE 200,033,091035,Nguyen; Truong Quang,9999,0,9999,0
1653576506693,ECE 200,034,091036,Nomura; Kenji,9999,0,9999,0
1653576506693,ECE 200,035,091037,Orlitsky; Alon,9999,0,9999,0
1653576506693,ECE 200,036,091038,Pal; Piya,9999,0,9999,0
1653576506693,ECE 200,037,091039,Papen; George C.,9999,0,9999,0
1653576506693,ECE 200,038,091040,Radic; Stojan,9999,0,9999,0
1653576506693,ECE 200,039,091041,Rao; Bhaskar D.,9999,0,9999,0
1653576506693,ECE 200,040,091042,Rao; Ramesh R,9999,0,9999,0
1653576506693,ECE 200,041,091043,Rebeiz; Gabriel,9999,0,9999,0
1653576506693,ECE 200,042,091044,Sanford; John R,9999,0,9999,0
1653576506693,ECE 200,043,091045,Siegel; Paul H.,9999,0,9999,0
1653576506693,ECE 200,044,091046,Sievenpiper; Daniel F.,9999,0,9999,0
1653576506693,ECE 200,045,091047,Sworder; David D.,9999,0,9999,0
1653576506693,ECE 200,046,091048,Taur; Yuan,9999,0,9999,0
1653576506693,ECE 200,047,091049,Touri; Behrouz,9999,0,9999,0
1653576506693,ECE 200,048,091050,Trivedi; Mohan M.,9999,0,9999,0
1653576506693,ECE 200,049,091051,Vardy; Alexander,9999,0,9999,0
1653576506693,ECE 200,050,091052,Vasconcelos; Nuno,9999,0,9999,0
1653576506693,ECE 200,051,091053,Wang; Xiaolong,9999,0,9999,0
1653576506693,ECE 200,052,091054,Xie; Pengtao,9999,0,9999,0
1653576506693,ECE 200,053,091055,Yip; Michael,9999,0,9999,0
1653576506693,ECE 200,054,091056,Zeger; Kenneth A.,9999,0,9999,0
1653576506693,ECE 200,055,091057,Zhang; Xinyu,9999,0,9999,0
1653576506693,ECE 200,056,091058,Turakhia; Yatish Girish,9999,0,9999,0
1653576506693,ECE 200,057,091059,Kang; Mingu,9999,0,9999,0
1653576506693,ECE 200,058,091060,Shi; Yuanyuan,9999,0,9999,0
1653576506693,ECE 200,059,091061,Wang; Edward Jay,9999,0,9999,0
1653576506693,ECE 200,060,091062,Zheng; Yang,9999,0,9999,0
1653576507219,ECE 201,A00,095526,Lo; Yu-Hwa,0,0,0,0
1653576507745,ECE 203,A00,091065,Mercier; Patrick Philip,0,0,0,0
1653576508270,ECE 207A,A00,091605,Liu; Thomas Tao-Ming,0,0,0,0
1653576508792,ECE 212AN,A00,091068,Nomura; Kenji,0,0,0,0
1653576509317,ECE 222A,A00,091069,Rebeiz; Gabriel,0,0,0,0
1653576509839,ECE 225A,A00,091070,Orlitsky; Alon,0,0,0,0
1653576510360,ECE 230A,A00,091071,Nomura; Kenji,0,0,0,0
1653576510887,ECE 236A,A00,091072,Dayeh; Shadi Ahmad,0,0,0,0
1653576511410,ECE 238A,A00,091073,Luo; Jian,0,0,0,0
1653576511410,ECE 238A,B00,091074,Luo; Jian,0,0,0,0
1653576511933,ECE 240A,A00,091075,Radic; Stojan,0,0,0,0
1653576512463,ECE 247A,A00,091592,Shi; Lingyan,0,0,0,0
1653576512988,ECE 250,A00,091076,Touri; Behrouz,0,0,0,0
1653576513512,ECE 251C,A00,091078,Nguyen; Truong Quang,0,0,0,0
1653576514034,ECE 253,A00,091079,Cosman; Pamela C.,0,0,0,0
1653576514560,ECE 255A,A00,091080,Orlitsky; Alon,0,0,0,0
1653576515159,ECE 257A,A00,091081,Zhang; Xinyu,0,0,0,0
1653576515682,ECE 260A,A01,091084,Eldon; John,0,0,0,0
1653576516207,ECE 264C,A00,091085,Galton; Ian A,0,0,0,0
1653576516732,ECE 265C,A00,094889,Presti; Calogero Davide,0,0,0,9
1653576517255,ECE 266,A01,091087,Hall; Drew A.,0,0,0,0
1653576518300,ECE 271A,A00,091090,Vasconcelos; Nuno,0,0,0,0
1653576518822,ECE 272B,A00,091091,Sworder; David D.,0,0,0,0
1653576519346,ECE 275A,A00,091092,Meyer; Florian,0,0,0,0
1653576519869,ECE 277,A00,091093,An; Cheolhong,0,0,0,0
1653576520398,ECE 283,A00,091094,Le; Hanh-Phuc,0,0,0,0
1653576520935,ECE 284,A00,091095,Kang; Mingu,0,0,0,0
1653576520935,ECE 284,B00,091096,Wang; Edward Jay,0,0,0,0
1653576521459,ECE 285,A00,094334,Touri; Behrouz,0,0,0,0
1653576521985,ECE 289,A00,091097,Whelan; David Arthur,0,0,0,0
1653576522509,MATH 200A,A00,087414,Salehi Golsefidy; Alireza,7,0,8,1
1653576523032,MATH 202A,A00,087415,Gill; Philip E.,2,0,8,6
1653576523555,MATH 203A,A00,087416,Oprea; Dragos N.,6,0,8,2
1653576524080,MATH 204A,A00,087417,Kedlaya; Kiran S.,6,0,8,2
1653576524602,MATH 205,A00,087418,Sorensen; Claus M,6,0,8,2
1653576525129,MATH 206A,A00,087419,Izadi; Elham,7,0,8,1
1653576525656,MATH 207A,A00,087420,Mohammadi; Amir,5,0,8,3
1653576526182,MATH 208,A00,087421,Staff,9,0,10,1
1653576526705,MATH 209,A00,087422,Staff,10,0,10,0
1653576527231,MATH 218,A00,087423,Staff,10,0,10,0
1653576527756,MATH 220A,A00,087424,Novak; Jonathan I,6,0,8,2
1653576528279,MATH 231A,A00,087425,Bejenaru; Ioan,3,0,8,5
1653576528801,MATH 240A,A00,087426,Ebenfelt; Peter F,5,0,8,3
1653576529324,MATH 243,A00,087427,Staff,9,0,10,1
1653576529847,MATH 248,A00,087429,Staff,10,0,10,0
1653576530379,MATH 250A,A00,087430,Spolaor; Luca,4,0,8,4
1653576530901,MATH 257A,A00,087431,Spolaor; Luca,7,0,8,1
1653576531424,MATH 258,A00,087432,Staff,9,0,10,1
1653576531956,MATH 264A,A00,087433,Warnke; Lutz Peter,5,0,8,3
1653576532486,MATH 268,A00,087434,Staff,15,0,15,0
1653576533009,MATH 269,A00,087435,Staff,14,0,15,1
1653576533538,MATH 270A,A00,087436,Nie; Jiawang,0,0,8,8
1653576534060,MATH 272A,A00,087437,Tian; Xiaochuan,1,0,8,7
1653576534596,MATH 274,A01,087439,Cheng; Li-Tien,9,0,10,1
1653576534596,MATH 274,A02,087440,Cheng; Li-Tien,10,0,10,0
1653576535125,MATH 278A,A00,087441,Staff,8,0,10,2
1653576535651,MATH 278B,A00,087442,Staff,8,0,10,2
1653576536174,MATH 278C,A00,087443,Staff,8,0,10,2
1653576536710,MATH 280A,A00,087444,Zheng; Tianyi,0,0,8,8
1653576537235,MATH 281A,A00,087445,Bradic; Jelena,0,0,8,8
1653576537758,MATH 282A,A00,087446,Zhang; Danna,0,0,8,8
1653576538280,MATH 283,A00,087447,Tesler; Glenn,0,0,0,15
1653576538804,MATH 286,A00,087448,Kemp; Todd Aahron,5,0,8,3
1653576539329,MATH 287D,A00,087449,Bradic; Jelena,0,0,0,1
1653576539853,MATH 288,A00,087450,Staff,14,0,15,1
1653576539853,MATH 288,B00,087451,Staff,15,0,15,0
1653576539853,MATH 288,C00,087452,Staff,15,0,15,0
1653576540375,MATH 290A,A00,087453,Xu; Zhouli,6,0,8,2
1653576540898,MATH 291A,A00,087454,Xu; Zhouli,7,0,8,1
1653576541419,MATH 292,A00,087455,Staff,10,0,10,0
1653576541946,MATH 295,A00,087456,Staff,50,0,50,0
1653576542469,MATH 297,001,087457,Staff,998,0,999,1
1653577101663,COGS 200,A01,087991,Staff,47,0,50,3
1653577102188,COGS 201,A01,094504,Rangel; Lara M,17,0,25,8
1653577102713,COGS 203,A00,087992,Coulson; Seana M,18,0,20,2
1653577103235,COGS 210A,001,087993,Greene; Deanna Jacquelyn,9998,0,9999,1
1653577103235,COGS 210A,002,087994,Saygin; Ayse P,9999,0,9999,0
1653577103235,COGS 210A,003,087995,Xia; Haijun,9999,0,9999,0
1653577103235,COGS 210A,004,087996,Nitz; Douglas A.,9999,0,9999,0
1653577103235,COGS 210A,005,087997,Hollan; James D.,9999,0,9999,0
1653577103235,COGS 210A,006,087998,Deak; Gedeon O.,9998,0,9999,1
1653577103235,COGS 210A,007,087999,Rossano; Federico,9999,0,9999,0
1653577103762,COGS 211A,A00,088000,Coulson; Seana M,9997,0,9999,2
1653577104284,COGS 229,A00,088002,Staff,22,0,25,3
1653577104807,COGS 260,B00,094231,Staff,17,0,20,3
1653577104807,COGS 260,A00,088004,Nitz; Douglas A.,9998,0,9999,1
1653577105334,CSE 202,A00,090110,Paturi; Ramamohan,0,0,0,0
1653577105334,CSE 202,B00,090111,Paturi; Ramamohan,0,0,0,0
1653577105861,CSE 207B,A00,090112,Heninger; Nadia A,0,0,0,0
1653577106382,CSE 208,A00,094858,Micciancio; Daniele,0,0,0,0
1653577106911,CSE 210,A00,090113,Powell; Thomas Allan,0,0,0,0
1653577107434,CSE 219,A00,090898,Staff,0,0,0,0
1653577107960,CSE 221,A00,090114,Zhou; Yuan-Yuan,0,0,0,0
1653577108490,CSE 229A,A00,090115,Porter; George M,0,0,0,0
1653577109020,CSE 229C,A00,090116,Savage; Stefan,0,0,0,0
1653577109546,CSE 230,A00,090117,Jhala; Ranjit,0,0,0,0
1653577110068,CSE 232,A00,090118,Papakonstantinou; Yannis,0,0,0,0
1653577110589,CSE 239A,A00,090121,Kumar; Arun Kumar,0,0,0,0
1653577111114,CSE 239B,A00,090122,Jhala; Ranjit,0,0,0,0
1653577111641,CSE 240A,A00,090123,Zhao; Jishen,1,0,189,188
1653577112170,CSE 243A,A00,090124,Orailoglu; Alex,0,0,15,15
1653577112696,CSE 249B,A00,090125,Kahng; Andrew Byun,13,0,20,7
1653577113217,CSE 250A,A00,090126,Berg-Kirkpatrick; Taylor D,0,0,0,0
1653577113744,CSE 252A,A00,090127,Ochoa; Benjamin Lawrence,0,0,0,0
1653577114266,CSE 258,A01,090129,McAuley; Julian John,0,0,0,0
1653577114788,CSE 258R,A01,090131,McAuley; Julian John,0,0,0,0
1653577115310,CSE 274,A00,090132,Ramamoorthi; Ravi,0,0,0,0
1653577115833,CSE 276A,A00,090133,Christensen; Henrik I,0,0,0,0
1653577116366,CSE 276C,A00,090134,Christensen; Henrik I,0,0,0,0
1653577116889,CSE 290,A00,090135,Bafna; Vineet,0,0,0,0
1653577116889,CSE 290,B00,090136,Ramamoorthi; Ravi,0,0,0,0
1653577116889,CSE 290,C00,090137,Li; Tzumao,8,0,10,2
1653577116889,CSE 290,D00,090138,Zhou; Yuan-Yuan,9,0,10,1
1653577116889,CSE 290,E00,090139,Christensen; Henrik I,8,0,10,2
1653577116889,CSE 290,F00,094053,Shalev; Aaron D,0,0,0,0
1653577117411,CSE 291,A00,090140,Munyaka; Imani N. S.,0,0,0,0
1653577117411,CSE 291,B00,094880,Yu; Qi,0,0,0,0
1653577117411,CSE 291,C00,090142,Pannuto; Patrick William,0,0,0,0
1653577117411,CSE 291,D00,094881,Zhang; Yiying,0,0,0,0
1653577117411,CSE 291,E00,095118,Su; Hao,0,0,0,0
1653577117959,CSE 293,001,094905,Bafna; Vineet,9999,0,9999,0
1653577117959,CSE 293,002,094906,Bellare; Mihir,9999,0,9999,0
1653577117959,CSE 293,003,094907,Berg-Kirkpatrick; Taylor D,9999,0,9999,0
1653577117959,CSE 293,004,094908,Christensen; Henrik I,9999,0,9999,0
1653577117959,CSE 293,005,094909,Cottrell; Garrison W,9999,0,9999,0
1653577117959,CSE 293,006,094910,Deutsch; Alin Bernard,9999,0,9999,0
1653577117959,CSE 293,007,094911,Esmaeilzadeh; Hadi,9999,0,9999,0
1653577117959,CSE 293,008,094912,Freund; Yoav,9999,0,9999,0
1653577117959,CSE 293,009,094913,Griswold; William G.,9999,0,9999,0
1653577117959,CSE 293,010,094914,Gymrek; Melissa Ann,9999,0,9999,0
1653577117959,CSE 293,011,094915,Heninger; Nadia A,9999,0,9999,0
1653577117959,CSE 293,012,094916,Impagliazzo; Russell,9999,0,9999,0
1653577117959,CSE 293,013,094917,Jhala; Ranjit,9999,0,9999,0
1653577117959,CSE 293,014,094918,Kahng; Andrew Byun,9999,0,9999,0
1653577117959,CSE 293,015,094919,Kane; Daniel Mertz,9999,0,9999,0
1653577117959,CSE 293,016,094920,Kriegman; David J,9999,0,9999,0
1653577117959,CSE 293,017,094921,Kumar; Arun Kumar,9999,0,9999,0
1653577117959,CSE 293,018,094922,Lerner; Sorin,9999,0,9999,0
1653577117959,CSE 293,019,094923,Lovett; Shachar,9999,0,9999,0
1653577117959,CSE 293,020,094924,McAuley; Julian John,9999,0,9999,0
1653577117959,CSE 293,021,094925,Micciancio; Daniele,9999,0,9999,0
1653577117959,CSE 293,022,094926,Orailoglu; Alex,9999,0,9999,0
1653577117959,CSE 293,023,094927,Paturi; Ramamohan,9999,0,9999,0
1653577117959,CSE 293,024,094928,Polikarpova; Nadezhda,9999,0,9999,0
1653577117959,CSE 293,025,094929,Politz; Joseph Gibbs,9999,0,9999,0
1653577117959,CSE 293,026,094930,Porter; George M,9999,0,9999,0
1653577117959,CSE 293,027,094931,Porter; Leonard Emerson,9999,0,9999,0
1653577117959,CSE 293,028,094932,Ramamoorthi; Ravi,9999,0,9999,0
1653577117959,CSE 293,029,094933,Sahoo; Debashis,9999,0,9999,0
1653577117959,CSE 293,030,094934,Saul; Lawrence,9999,0,9999,0
1653577117959,CSE 293,031,094935,Savage; Stefan,9999,0,9999,0
1653577117959,CSE 293,032,094936,Schulze; Jurgen P.,9999,0,9999,0
1653577117959,CSE 293,033,094937,Snoeren; Alex C.,9999,0,9999,0
1653577117959,CSE 293,034,094938,Shang; Jingbo,9999,0,9999,0
1653577117959,CSE 293,035,094939,Stefan; Deian,9999,0,9999,0
1653577117959,CSE 293,036,094940,Su; Hao,9999,0,9999,0
1653577117959,CSE 293,037,094941,Swanson; Steven James,9999,0,9999,0
1653577117959,CSE 293,038,094942,Tullsen; Dean Michael,9999,0,9999,0
1653577117959,CSE 293,039,094943,Voelker; Geoffrey M.,9999,0,9999,0
1653577117959,CSE 293,040,094944,Zhao; Jishen,9999,0,9999,0
1653577117959,CSE 293,041,094945,Zhou; Yuan-Yuan,9999,0,9999,0
1653577117959,CSE 293,042,094946,Gao; Sicun,9998,0,9999,1
1653577117959,CSE 293,043,094947,Weibel; Nadir,9999,0,9999,0
1653577117959,CSE 293,044,094948,Gupta; Rajesh K.,9999,0,9999,0
1653577118486,CSE 294,A00,090143,Porter; George M,8,0,10,2
1653577119010,DSE 200,A00,091799,Staff,50,0,50,0
1653577119533,DSE 203,A00,091800,Gupta; Amarnath,30,0,30,0
1653577120056,DSE 250,A00,091801,Deutsch; Alin Bernard,30,0,30,0
1653577120582,DSE 290,A00,091802,Altintas De Callaf; Ilkay,50,0,50,0
1653577121125,ECE 200,001,091003,Antipa; Nicholas A,9999,0,9999,0
1653577121125,ECE 200,002,091004,Atanasov; Nikolay A.,9999,0,9999,0
1653577121125,ECE 200,003,091005,Bharadia; Dinesh,9999,0,9999,0
1653577121125,ECE 200,004,091006,Cheng; Chung Kuan,9999,0,9999,0
1653577121125,ECE 200,005,091007,Cosman; Pamela C.,9999,0,9999,0
1653577121125,ECE 200,006,091008,Staff,9999,0,9999,0
1653577121125,ECE 200,007,091009,Dayeh; Shadi Ahmad,9999,0,9999,0
1653577121125,ECE 200,008,091010,Fainman; Yeshaiahu,9999,0,9999,0
1653577121125,ECE 200,009,091011,Ford; Joseph Earl,9999,0,9999,0
1653577121125,ECE 200,010,091012,Franceschetti; Massimo,9999,0,9999,0
1653577121125,ECE 200,011,091013,Fullerton; Eric E,9999,0,9999,0
1653577121125,ECE 200,012,091014,Galton; Ian A,9999,0,9999,0
1653577121125,ECE 200,013,091015,Gilja; Vikash,9999,0,9999,0
1653577121125,ECE 200,014,091016,Hall; Drew A.,9999,0,9999,0
1653577121125,ECE 200,015,091017,Hsueh; Tzu-Chien,9999,0,9999,0
1653577121125,ECE 200,016,091018,Javidi; Tara,9999,0,9999,0
1653577121125,ECE 200,017,091019,Kahng; Andrew Byun,9999,0,9999,0
1653577121125,ECE 200,018,091020,Kim; Young-Han,9999,0,9999,0
1653577121125,ECE 200,019,091021,Koushanfar; Farinaz,9999,0,9999,0
1653577121125,ECE 200,020,091022,Kuzum; Duygu,9999,0,9999,0
1653577121125,ECE 200,021,091023,Le; Hanh-Phuc,9999,0,9999,0
1653577121125,ECE 200,022,091024,Lin; Bill,9999,0,9999,0
1653577121125,ECE 200,023,091025,Liu; Zhaowei,9999,0,9999,0
1653577121125,ECE 200,024,091026,Lo; Yu-Hwa,9999,0,9999,0
1653577121125,ECE 200,025,091027,Lomakin; Vitaliy,9999,0,9999,0
1653577121125,ECE 200,026,091028,Mercier; Patrick Philip,9999,0,9999,0
1653577121125,ECE 200,027,091029,Meyer; Florian,9999,0,9999,0
1653577121125,ECE 200,028,091030,Milstein; Laurence B.,9999,0,9999,0
1653577121125,ECE 200,029,091031,Mir Arabbaygi; Siavash,9999,0,9999,0
1653577121125,ECE 200,030,091032,Mookherjea; Shayan,9999,0,9999,0
1653577121125,ECE 200,031,091033,Morris; Karcher William,9999,0,9999,0
1653577121125,ECE 200,032,091034,Ng; Tse Nga,9999,0,9999,0
1653577121125,ECE 200,033,091035,Nguyen; Truong Quang,9999,0,9999,0
1653577121125,ECE 200,034,091036,Nomura; Kenji,9999,0,9999,0
1653577121125,ECE 200,035,091037,Orlitsky; Alon,9999,0,9999,0
1653577121125,ECE 200,036,091038,Pal; Piya,9999,0,9999,0
1653577121125,ECE 200,037,091039,Papen; George C.,9999,0,9999,0
1653577121125,ECE 200,038,091040,Radic; Stojan,9999,0,9999,0
1653577121125,ECE 200,039,091041,Rao; Bhaskar D.,9999,0,9999,0
1653577121125,ECE 200,040,091042,Rao; Ramesh R,9999,0,9999,0
1653577121125,ECE 200,041,091043,Rebeiz; Gabriel,9999,0,9999,0
1653577121125,ECE 200,042,091044,Sanford; John R,9999,0,9999,0
1653577121125,ECE 200,043,091045,Siegel; Paul H.,9999,0,9999,0
1653577121125,ECE 200,044,091046,Sievenpiper; Daniel F.,9999,0,9999,0
1653577121125,ECE 200,045,091047,Sworder; David D.,9999,0,9999,0
1653577121125,ECE 200,046,091048,Taur; Yuan,9999,0,9999,0
1653577121125,ECE 200,047,091049,Touri; Behrouz,9999,0,9999,0
1653577121125,ECE 200,048,091050,Trivedi; Mohan M.,9999,0,9999,0
1653577121125,ECE 200,049,091051,Vardy; Alexander,9999,0,9999,0
1653577121125,ECE 200,050,091052,Vasconcelos; Nuno,9999,0,9999,0
1653577121125,ECE 200,051,091053,Wang; Xiaolong,9999,0,9999,0
1653577121125,ECE 200,052,091054,Xie; Pengtao,9999,0,9999,0
1653577121125,ECE 200,053,091055,Yip; Michael,9999,0,9999,0
1653577121125,ECE 200,054,091056,Zeger; Kenneth A.,9999,0,9999,0
1653577121125,ECE 200,055,091057,Zhang; Xinyu,9999,0,9999,0
1653577121125,ECE 200,056,091058,Turakhia; Yatish Girish,9999,0,9999,0
1653577121125,ECE 200,057,091059,Kang; Mingu,9999,0,9999,0
1653577121125,ECE 200,058,091060,Shi; Yuanyuan,9999,0,9999,0
1653577121125,ECE 200,059,091061,Wang; Edward Jay,9999,0,9999,0
1653577121125,ECE 200,060,091062,Zheng; Yang,9999,0,9999,0
1653577121649,ECE 201,A00,095526,Lo; Yu-Hwa,0,0,0,0
1653577122171,ECE 203,A00,091065,Mercier; Patrick Philip,0,0,0,0
1653577122697,ECE 207A,A00,091605,Liu; Thomas Tao-Ming,0,0,0,0
1653577123223,ECE 212AN,A00,091068,Nomura; Kenji,0,0,0,0
1653577123746,ECE 222A,A00,091069,Rebeiz; Gabriel,0,0,0,0
1653577124276,ECE 225A,A00,091070,Orlitsky; Alon,0,0,0,0
1653577124804,ECE 230A,A00,091071,Nomura; Kenji,0,0,0,0
1653577125326,ECE 236A,A00,091072,Dayeh; Shadi Ahmad,0,0,0,0
1653577125857,ECE 238A,A00,091073,Luo; Jian,0,0,0,0
1653577125857,ECE 238A,B00,091074,Luo; Jian,0,0,0,0
1653577126380,ECE 240A,A00,091075,Radic; Stojan,0,0,0,0
1653577126911,ECE 247A,A00,091592,Shi; Lingyan,0,0,0,0
1653577127434,ECE 250,A00,091076,Touri; Behrouz,0,0,0,0
1653577127956,ECE 251C,A00,091078,Nguyen; Truong Quang,0,0,0,0
1653577128482,ECE 253,A00,091079,Cosman; Pamela C.,0,0,0,0
1653577129018,ECE 255A,A00,091080,Orlitsky; Alon,0,0,0,0
1653577129542,ECE 257A,A00,091081,Zhang; Xinyu,0,0,0,0
1653577130067,ECE 260A,A01,091084,Eldon; John,0,0,0,0
1653577130589,ECE 264C,A00,091085,Galton; Ian A,0,0,0,0
1653577131112,ECE 265C,A00,094889,Presti; Calogero Davide,0,0,0,9
1653577131642,ECE 266,A01,091087,Hall; Drew A.,0,0,0,0
1653577132689,ECE 271A,A00,091090,Vasconcelos; Nuno,0,0,0,0
1653577133211,ECE 272B,A00,091091,Sworder; David D.,0,0,0,0
1653577133733,ECE 275A,A00,091092,Meyer; Florian,0,0,0,0
1653577134257,ECE 277,A00,091093,An; Cheolhong,0,0,0,0
1653577134783,ECE 283,A00,091094,Le; Hanh-Phuc,0,0,0,0
1653577135310,ECE 284,A00,091095,Kang; Mingu,0,0,0,0
1653577135310,ECE 284,B00,091096,Wang; Edward Jay,0,0,0,0
1653577135834,ECE 285,A00,094334,Touri; Behrouz,0,0,0,0
1653577136356,ECE 289,A00,091097,Whelan; David Arthur,0,0,0,0
1653577136886,MATH 200A,A00,087414,Salehi Golsefidy; Alireza,7,0,8,1
1653577137409,MATH 202A,A00,087415,Gill; Philip E.,2,0,8,6
1653577137932,MATH 203A,A00,087416,Oprea; Dragos N.,6,0,8,2
1653577138454,MATH 204A,A00,087417,Kedlaya; Kiran S.,6,0,8,2
1653577138976,MATH 205,A00,087418,Sorensen; Claus M,6,0,8,2
1653577139511,MATH 206A,A00,087419,Izadi; Elham,7,0,8,1
1653577140047,MATH 207A,A00,087420,Mohammadi; Amir,5,0,8,3
1653577140569,MATH 208,A00,087421,Staff,9,0,10,1
1653577141092,MATH 209,A00,087422,Staff,10,0,10,0
1653577141614,MATH 218,A00,087423,Staff,10,0,10,0
1653577142136,MATH 220A,A00,087424,Novak; Jonathan I,6,0,8,2
1653577142674,MATH 231A,A00,087425,Bejenaru; Ioan,3,0,8,5
1653577143200,MATH 240A,A00,087426,Ebenfelt; Peter F,5,0,8,3
1653577143729,MATH 243,A00,087427,Staff,9,0,10,1
1653577144250,MATH 248,A00,087429,Staff,10,0,10,0
1653577144772,MATH 250A,A00,087430,Spolaor; Luca,4,0,8,4
1653577145298,MATH 257A,A00,087431,Spolaor; Luca,7,0,8,1
1653577145820,MATH 258,A00,087432,Staff,9,0,10,1
1653577146352,MATH 264A,A00,087433,Warnke; Lutz Peter,5,0,8,3
1653577146876,MATH 268,A00,087434,Staff,15,0,15,0
1653577147400,MATH 269,A00,087435,Staff,14,0,15,1
1653577147924,MATH 270A,A00,087436,Nie; Jiawang,0,0,8,8
1653577148445,MATH 272A,A00,087437,Tian; Xiaochuan,1,0,8,7
1653577148976,MATH 274,A01,087439,Cheng; Li-Tien,9,0,10,1
1653577148976,MATH 274,A02,087440,Cheng; Li-Tien,10,0,10,0
1653577149500,MATH 278A,A00,087441,Staff,8,0,10,2
1653577150024,MATH 278B,A00,087442,Staff,8,0,10,2
1653577150549,MATH 278C,A00,087443,Staff,8,0,10,2
1653577151071,MATH 280A,A00,087444,Zheng; Tianyi,0,0,8,8
1653577151594,MATH 281A,A00,087445,Bradic; Jelena,0,0,8,8
1653577152120,MATH 282A,A00,087446,Zhang; Danna,0,0,8,8
1653577152646,MATH 283,A00,087447,Tesler; Glenn,0,0,0,16
1653577153169,MATH 286,A00,087448,Kemp; Todd Aahron,5,0,8,3
1653577153692,MATH 287D,A00,087449,Bradic; Jelena,0,0,0,2
1653577154220,MATH 288,A00,087450,Staff,14,0,15,1
1653577154220,MATH 288,B00,087451,Staff,15,0,15,0
1653577154220,MATH 288,C00,087452,Staff,15,0,15,0
1653577154817,MATH 290A,A00,087453,Xu; Zhouli,6,0,8,2
1653577155341,MATH 291A,A00,087454,Xu; Zhouli,7,0,8,1
1653577155864,MATH 292,A00,087455,Staff,10,0,10,0
1653577156386,MATH 295,A00,087456,Staff,50,0,50,0
1653577156912,MATH 297,001,087457,Staff,998,0,999,1
1653577716776,COGS 200,A01,087991,Staff,47,0,50,3
1653577717299,COGS 201,A01,094504,Rangel; Lara M,17,0,25,8
1653577717822,COGS 203,A00,087992,Coulson; Seana M,18,0,20,2
1653577718349,COGS 210A,001,087993,Greene; Deanna Jacquelyn,9998,0,9999,1
1653577718349,COGS 210A,002,087994,Saygin; Ayse P,9999,0,9999,0
1653577718349,COGS 210A,003,087995,Xia; Haijun,9999,0,9999,0
1653577718349,COGS 210A,004,087996,Nitz; Douglas A.,9999,0,9999,0
1653577718349,COGS 210A,005,087997,Hollan; James D.,9999,0,9999,0
1653577718349,COGS 210A,006,087998,Deak; Gedeon O.,9998,0,9999,1
1653577718349,COGS 210A,007,087999,Rossano; Federico,9999,0,9999,0
1653577718883,COGS 211A,A00,088000,Coulson; Seana M,9997,0,9999,2
1653577719410,COGS 229,A00,088002,Staff,22,0,25,3
1653577719932,COGS 260,B00,094231,Staff,17,0,20,3
1653577719932,COGS 260,A00,088004,Nitz; Douglas A.,9998,0,9999,1
1653577720465,CSE 202,A00,090110,Paturi; Ramamohan,0,0,0,0
1653577720465,CSE 202,B00,090111,Paturi; Ramamohan,0,0,0,0
1653577720993,CSE 207B,A00,090112,Heninger; Nadia A,0,0,0,0
1653577721516,CSE 208,A00,094858,Micciancio; Daniele,0,0,0,0
1653577722043,CSE 210,A00,090113,Powell; Thomas Allan,0,0,0,0
1653577722567,CSE 219,A00,090898,Staff,0,0,0,0
1653577723092,CSE 221,A00,090114,Zhou; Yuan-Yuan,0,0,0,0
1653577723614,CSE 229A,A00,090115,Porter; George M,0,0,0,0
1653577724138,CSE 229C,A00,090116,Savage; Stefan,0,0,0,0
1653577724659,CSE 230,A00,090117,Jhala; Ranjit,0,0,0,0
1653577725185,CSE 232,A00,090118,Papakonstantinou; Yannis,0,0,0,0
1653577725709,CSE 239A,A00,090121,Kumar; Arun Kumar,0,0,0,0
1653577726245,CSE 239B,A00,090122,Jhala; Ranjit,0,0,0,0
1653577726769,CSE 240A,A00,090123,Zhao; Jishen,1,0,189,188
1653577727296,CSE 243A,A00,090124,Orailoglu; Alex,0,0,15,15
1653577727820,CSE 249B,A00,090125,Kahng; Andrew Byun,13,0,20,7
1653577728347,CSE 250A,A00,090126,Berg-Kirkpatrick; Taylor D,0,0,0,0
1653577728869,CSE 252A,A00,090127,Ochoa; Benjamin Lawrence,0,0,0,0
1653577729394,CSE 258,A01,090129,McAuley; Julian John,0,0,0,0
1653577729921,CSE 258R,A01,090131,McAuley; Julian John,0,0,0,0
1653577730444,CSE 274,A00,090132,Ramamoorthi; Ravi,0,0,0,0
1653577730972,CSE 276A,A00,090133,Christensen; Henrik I,0,0,0,0
1653577731494,CSE 276C,A00,090134,Christensen; Henrik I,0,0,0,0
1653577732022,CSE 290,A00,090135,Bafna; Vineet,0,0,0,0
1653577732022,CSE 290,B00,090136,Ramamoorthi; Ravi,0,0,0,0
1653577732022,CSE 290,C00,090137,Li; Tzumao,8,0,10,2
1653577732022,CSE 290,D00,090138,Zhou; Yuan-Yuan,9,0,10,1
1653577732022,CSE 290,E00,090139,Christensen; Henrik I,8,0,10,2
1653577732022,CSE 290,F00,094053,Shalev; Aaron D,0,0,0,0
1653577732551,CSE 291,A00,090140,Munyaka; Imani N. S.,0,0,0,0
1653577732551,CSE 291,B00,094880,Yu; Qi,0,0,0,0
1653577732551,CSE 291,C00,090142,Pannuto; Patrick William,0,0,0,0
1653577732551,CSE 291,D00,094881,Zhang; Yiying,0,0,0,0
1653577732551,CSE 291,E00,095118,Su; Hao,0,0,0,0
1653577733086,CSE 293,001,094905,Bafna; Vineet,9999,0,9999,0
1653577733086,CSE 293,002,094906,Bellare; Mihir,9999,0,9999,0
1653577733086,CSE 293,003,094907,Berg-Kirkpatrick; Taylor D,9999,0,9999,0
1653577733086,CSE 293,004,094908,Christensen; Henrik I,9999,0,9999,0
1653577733086,CSE 293,005,094909,Cottrell; Garrison W,9999,0,9999,0
1653577733086,CSE 293,006,094910,Deutsch; Alin Bernard,9999,0,9999,0
1653577733086,CSE 293,007,094911,Esmaeilzadeh; Hadi,9999,0,9999,0
1653577733086,CSE 293,008,094912,Freund; Yoav,9999,0,9999,0
1653577733086,CSE 293,009,094913,Griswold; William G.,9999,0,9999,0
1653577733086,CSE 293,010,094914,Gymrek; Melissa Ann,9999,0,9999,0
1653577733086,CSE 293,011,094915,Heninger; Nadia A,9999,0,9999,0
1653577733086,CSE 293,012,094916,Impagliazzo; Russell,9999,0,9999,0
1653577733086,CSE 293,013,094917,Jhala; Ranjit,9999,0,9999,0
1653577733086,CSE 293,014,094918,Kahng; Andrew Byun,9999,0,9999,0
1653577733086,CSE 293,015,094919,Kane; Daniel Mertz,9999,0,9999,0
1653577733086,CSE 293,016,094920,Kriegman; David J,9999,0,9999,0
1653577733086,CSE 293,017,094921,Kumar; Arun Kumar,9999,0,9999,0
1653577733086,CSE 293,018,094922,Lerner; Sorin,9999,0,9999,0
1653577733086,CSE 293,019,094923,Lovett; Shachar,9999,0,9999,0
1653577733086,CSE 293,020,094924,McAuley; Julian John,9999,0,9999,0
1653577733086,CSE 293,021,094925,Micciancio; Daniele,9999,0,9999,0
1653577733086,CSE 293,022,094926,Orailoglu; Alex,9999,0,9999,0
1653577733086,CSE 293,023,094927,Paturi; Ramamohan,9999,0,9999,0
1653577733086,CSE 293,024,094928,Polikarpova; Nadezhda,9999,0,9999,0
1653577733086,CSE 293,025,094929,Politz; Joseph Gibbs,9999,0,9999,0
1653577733086,CSE 293,026,094930,Porter; George M,9999,0,9999,0
1653577733086,CSE 293,027,094931,Porter; Leonard Emerson,9999,0,9999,0
1653577733086,CSE 293,028,094932,Ramamoorthi; Ravi,9999,0,9999,0
1653577733086,CSE 293,029,094933,Sahoo; Debashis,9999,0,9999,0
1653577733086,CSE 293,030,094934,Saul; Lawrence,9999,0,9999,0
1653577733086,CSE 293,031,094935,Savage; Stefan,9999,0,9999,0
1653577733086,CSE 293,032,094936,Schulze; Jurgen P.,9999,0,9999,0
1653577733086,CSE 293,033,094937,Snoeren; Alex C.,9999,0,9999,0
1653577733086,CSE 293,034,094938,Shang; Jingbo,9999,0,9999,0
1653577733086,CSE 293,035,094939,Stefan; Deian,9999,0,9999,0
1653577733086,CSE 293,036,094940,Su; Hao,9999,0,9999,0
1653577733086,CSE 293,037,094941,Swanson; Steven James,9999,0,9999,0
1653577733086,CSE 293,038,094942,Tullsen; Dean Michael,9999,0,9999,0
1653577733086,CSE 293,039,094943,Voelker; Geoffrey M.,9999,0,9999,0
1653577733086,CSE 293,040,094944,Zhao; Jishen,9999,0,9999,0
1653577733086,CSE 293,041,094945,Zhou; Yuan-Yuan,9999,0,9999,0
1653577733086,CSE 293,042,094946,Gao; Sicun,9998,0,9999,1
1653577733086,CSE 293,043,094947,Weibel; Nadir,9999,0,9999,0
1653577733086,CSE 293,044,094948,Gupta; Rajesh K.,9999,0,9999,0
1653577733609,CSE 294,A00,090143,Porter; George M,8,0,10,2
1653577734131,DSE 200,A00,091799,Staff,50,0,50,0
1653577734658,DSE 203,A00,091800,Gupta; Amarnath,30,0,30,0
1653577735180,DSE 250,A00,091801,Deutsch; Alin Bernard,30,0,30,0
1653577735701,DSE 290,A00,091802,Altintas De Callaf; Ilkay,50,0,50,0
1653577736237,ECE 200,001,091003,Antipa; Nicholas A,9999,0,9999,0
1653577736237,ECE 200,002,091004,Atanasov; Nikolay A.,9999,0,9999,0
1653577736237,ECE 200,003,091005,Bharadia; Dinesh,9999,0,9999,0
1653577736237,ECE 200,004,091006,Cheng; Chung Kuan,9999,0,9999,0
1653577736237,ECE 200,005,091007,Cosman; Pamela C.,9999,0,9999,0
1653577736237,ECE 200,006,091008,Staff,9999,0,9999,0
1653577736237,ECE 200,007,091009,Dayeh; Shadi Ahmad,9999,0,9999,0
1653577736237,ECE 200,008,091010,Fainman; Yeshaiahu,9999,0,9999,0
1653577736237,ECE 200,009,091011,Ford; Joseph Earl,9999,0,9999,0
1653577736237,ECE 200,010,091012,Franceschetti; Massimo,9999,0,9999,0
1653577736237,ECE 200,011,091013,Fullerton; Eric E,9999,0,9999,0
1653577736237,ECE 200,012,091014,Galton; Ian A,9999,0,9999,0
1653577736237,ECE 200,013,091015,Gilja; Vikash,9999,0,9999,0
1653577736237,ECE 200,014,091016,Hall; Drew A.,9999,0,9999,0
1653577736237,ECE 200,015,091017,Hsueh; Tzu-Chien,9999,0,9999,0
1653577736237,ECE 200,016,091018,Javidi; Tara,9999,0,9999,0
1653577736237,ECE 200,017,091019,Kahng; Andrew Byun,9999,0,9999,0
1653577736237,ECE 200,018,091020,Kim; Young-Han,9999,0,9999,0
1653577736237,ECE 200,019,091021,Koushanfar; Farinaz,9999,0,9999,0
1653577736237,ECE 200,020,091022,Kuzum; Duygu,9999,0,9999,0
1653577736237,ECE 200,021,091023,Le; Hanh-Phuc,9999,0,9999,0
1653577736237,ECE 200,022,091024,Lin; Bill,9999,0,9999,0
1653577736237,ECE 200,023,091025,Liu; Zhaowei,9999,0,9999,0
1653577736237,ECE 200,024,091026,Lo; Yu-Hwa,9999,0,9999,0
1653577736237,ECE 200,025,091027,Lomakin; Vitaliy,9999,0,9999,0
1653577736237,ECE 200,026,091028,Mercier; Patrick Philip,9999,0,9999,0
1653577736237,ECE 200,027,091029,Meyer; Florian,9999,0,9999,0
1653577736237,ECE 200,028,091030,Milstein; Laurence B.,9999,0,9999,0
1653577736237,ECE 200,029,091031,Mir Arabbaygi; Siavash,9999,0,9999,0
1653577736237,ECE 200,030,091032,Mookherjea; Shayan,9999,0,9999,0
1653577736237,ECE 200,031,091033,Morris; Karcher William,9999,0,9999,0
1653577736237,ECE 200,032,091034,Ng; Tse Nga,9999,0,9999,0
1653577736237,ECE 200,033,091035,Nguyen; Truong Quang,9999,0,9999,0
1653577736237,ECE 200,034,091036,Nomura; Kenji,9999,0,9999,0
1653577736237,ECE 200,035,091037,Orlitsky; Alon,9999,0,9999,0
1653577736237,ECE 200,036,091038,Pal; Piya,9999,0,9999,0
1653577736237,ECE 200,037,091039,Papen; George C.,9999,0,9999,0
1653577736237,ECE 200,038,091040,Radic; Stojan,9999,0,9999,0
1653577736237,ECE 200,039,091041,Rao; Bhaskar D.,9999,0,9999,0
1653577736237,ECE 200,040,091042,Rao; Ramesh R,9999,0,9999,0
1653577736237,ECE 200,041,091043,Rebeiz; Gabriel,9999,0,9999,0
1653577736237,ECE 200,042,091044,Sanford; John R,9999,0,9999,0
1653577736237,ECE 200,043,091045,Siegel; Paul H.,9999,0,9999,0
1653577736237,ECE 200,044,091046,Sievenpiper; Daniel F.,9999,0,9999,0
1653577736237,ECE 200,045,091047,Sworder; David D.,9999,0,9999,0
1653577736237,ECE 200,046,091048,Taur; Yuan,9999,0,9999,0
1653577736237,ECE 200,047,091049,Touri; Behrouz,9999,0,9999,0
1653577736237,ECE 200,048,091050,Trivedi; Mohan M.,9999,0,9999,0
1653577736237,ECE 200,049,091051,Vardy; Alexander,9999,0,9999,0
1653577736237,ECE 200,050,091052,Vasconcelos; Nuno,9999,0,9999,0
1653577736237,ECE 200,051,091053,Wang; Xiaolong,9999,0,9999,0
1653577736237,ECE 200,052,091054,Xie; Pengtao,9999,0,9999,0
1653577736237,ECE 200,053,091055,Yip; Michael,9999,0,9999,0
1653577736237,ECE 200,054,091056,Zeger; Kenneth A.,9999,0,9999,0
1653577736237,ECE 200,055,091057,Zhang; Xinyu,9999,0,9999,0
1653577736237,ECE 200,056,091058,Turakhia; Yatish Girish,9999,0,9999,0
1653577736237,ECE 200,057,091059,Kang; Mingu,9999,0,9999,0
1653577736237,ECE 200,058,091060,Shi; Yuanyuan,9999,0,9999,0
1653577736237,ECE 200,059,091061,Wang; Edward Jay,9999,0,9999,0
1653577736237,ECE 200,060,091062,Zheng; Yang,9999,0,9999,0
1653577736763,ECE 201,A00,095526,Lo; Yu-Hwa,0,0,0,0
1653577737287,ECE 203,A00,091065,Mercier; Patrick Philip,0,0,0,0
1653577737816,ECE 207A,A00,091605,Liu; Thomas Tao-Ming,0,0,0,0
1653577738344,ECE 212AN,A00,091068,Nomura; Kenji,0,0,0,0
1653577738867,ECE 222A,A00,091069,Rebeiz; Gabriel,0,0,0,0
1653577739390,ECE 225A,A00,091070,Orlitsky; Alon,0,0,0,0
1653577739916,ECE 230A,A00,091071,Nomura; Kenji,0,0,0,0
1653577740442,ECE 236A,A00,091072,Dayeh; Shadi Ahmad,0,0,0,0
1653577740967,ECE 238A,A00,091073,Luo; Jian,0,0,0,0
1653577740967,ECE 238A,B00,091074,Luo; Jian,0,0,0,0
1653577741489,ECE 240A,A00,091075,Radic; Stojan,0,0,0,0
1653577742094,ECE 247A,A00,091592,Shi; Lingyan,0,0,0,0
1653577742621,ECE 250,A00,091076,Touri; Behrouz,0,0,0,0
1653577743143,ECE 251C,A00,091078,Nguyen; Truong Quang,0,0,0,0
1653577743671,ECE 253,A00,091079,Cosman; Pamela C.,0,0,0,0
1653577744198,ECE 255A,A00,091080,Orlitsky; Alon,0,0,0,0
1653577744720,ECE 257A,A00,091081,Zhang; Xinyu,0,0,0,0
1653577745254,ECE 260A,A01,091084,Eldon; John,0,0,0,0
1653577745777,ECE 264C,A00,091085,Galton; Ian A,0,0,0,0
1653577746301,ECE 265C,A00,094889,Presti; Calogero Davide,0,0,0,9
1653577746826,ECE 266,A01,091087,Hall; Drew A.,0,0,0,0
1653577747878,ECE 271A,A00,091090,Vasconcelos; Nuno,0,0,0,0
1653577748401,ECE 272B,A00,091091,Sworder; David D.,0,0,0,0
1653577748927,ECE 275A,A00,091092,Meyer; Florian,0,0,0,0
1653577749453,ECE 277,A00,091093,An; Cheolhong,0,0,0,0
1653577749983,ECE 283,A00,091094,Le; Hanh-Phuc,0,0,0,0
1653577750507,ECE 284,A00,091095,Kang; Mingu,0,0,0,0
1653577750507,ECE 284,B00,091096,Wang; Edward Jay,0,0,0,0
1653577751036,ECE 285,A00,094334,Touri; Behrouz,0,0,0,0
1653577751564,ECE 289,A00,091097,Whelan; David Arthur,0,0,0,0
1653577752096,MATH 200A,A00,087414,Salehi Golsefidy; Alireza,7,0,8,1
1653577752618,MATH 202A,A00,087415,Gill; Philip E.,2,0,8,6
1653577753141,MATH 203A,A00,087416,Oprea; Dragos N.,6,0,8,2
1653577753663,MATH 204A,A00,087417,Kedlaya; Kiran S.,6,0,8,2
1653577754186,MATH 205,A00,087418,Sorensen; Claus M,6,0,8,2
1653577754709,MATH 206A,A00,087419,Izadi; Elham,7,0,8,1
1653577755233,MATH 207A,A00,087420,Mohammadi; Amir,5,0,8,3
1653577755763,MATH 208,A00,087421,Staff,9,0,10,1
1653577756288,MATH 209,A00,087422,Staff,10,0,10,0
1653577756814,MATH 218,A00,087423,Staff,10,0,10,0
1653577757340,MATH 220A,A00,087424,Novak; Jonathan I,6,0,8,2
1653577757870,MATH 231A,A00,087425,Bejenaru; Ioan,3,0,8,5
1653577758395,MATH 240A,A00,087426,Ebenfelt; Peter F,5,0,8,3
1653577758917,MATH 243,A00,087427,Staff,9,0,10,1
1653577759439,MATH 248,A00,087429,Staff,10,0,10,0
1653577759963,MATH 250A,A00,087430,Spolaor; Luca,4,0,8,4
1653577760489,MATH 257A,A00,087431,Spolaor; Luca,7,0,8,1
1653577761015,MATH 258,A00,087432,Staff,9,0,10,1
1653577761540,MATH 264A,A00,087433,Warnke; Lutz Peter,5,0,8,3
1653577762065,MATH 268,A00,087434,Staff,15,0,15,0
1653577762596,MATH 269,A00,087435,Staff,14,0,15,1
1653577763118,MATH 270A,A00,087436,Nie; Jiawang,0,0,8,8
1653577763642,MATH 272A,A00,087437,Tian; Xiaochuan,1,0,8,7
1653577764165,MATH 274,A01,087439,Cheng; Li-Tien,9,0,10,1
1653577764165,MATH 274,A02,087440,Cheng; Li-Tien,10,0,10,0
1653577764690,MATH 278A,A00,087441,Staff,8,0,10,2
1653577765215,MATH 278B,A00,087442,Staff,8,0,10,2
1653577765738,MATH 278C,A00,087443,Staff,8,0,10,2
1653577766261,MATH 280A,A00,087444,Zheng; Tianyi,0,0,8,8
1653577766784,MATH 281A,A00,087445,Bradic; Jelena,0,0,8,8
1653577767306,MATH 282A,A00,087446,Zhang; Danna,0,0,8,8
1653577767829,MATH 283,A00,087447,Tesler; Glenn,0,0,0,16
1653577768354,MATH 286,A00,087448,Kemp; Todd Aahron,5,0,8,3
1653577768877,MATH 287D,A00,087449,Bradic; Jelena,0,0,0,2
1653577769416,MATH 288,A00,087450,Staff,14,0,15,1
1653577769416,MATH 288,B00,087451,Staff,15,0,15,0
1653577769416,MATH 288,C00,087452,Staff,15,0,15,0
1653577769943,MATH 290A,A00,087453,Xu; Zhouli,6,0,8,2
1653577770467,MATH 291A,A00,087454,Xu; Zhouli,7,0,8,1
1653577770990,MATH 292,A00,087455,Staff,10,0,10,0
1653577771514,MATH 295,A00,087456,Staff,50,0,50,0
1653577772036,MATH 297,001,087457,Staff,998,0,999,1
1653578331576,COGS 200,A01,087991,Staff,47,0,50,3
1653578332100,COGS 201,A01,094504,Rangel; Lara M,17,0,25,8
1653578332622,COGS 203,A00,087992,Coulson; Seana M,18,0,20,2
1653578333174,COGS 210A,001,087993,Greene; Deanna Jacquelyn,9998,0,9999,1
1653578333174,COGS 210A,002,087994,Saygin; Ayse P,9999,0,9999,0
1653578333174,COGS 210A,003,087995,Xia; Haijun,9999,0,9999,0
1653578333174,COGS 210A,004,087996,Nitz; Douglas A.,9999,0,9999,0
1653578333174,COGS 210A,005,087997,Hollan; James D.,9999,0,9999,0
1653578333174,COGS 210A,006,087998,Deak; Gedeon O.,9998,0,9999,1
1653578333174,COGS 210A,007,087999,Rossano; Federico,9999,0,9999,0
1653578333697,COGS 211A,A00,088000,Coulson; Seana M,9997,0,9999,2
1653578334219,COGS 229,A00,088002,Staff,22,0,25,3
1653578334744,COGS 260,B00,094231,Staff,17,0,20,3
1653578334744,COGS 260,A00,088004,Nitz; Douglas A.,9998,0,9999,1
1653578335267,CSE 202,A00,090110,Paturi; Ramamohan,0,0,0,0
1653578335267,CSE 202,B00,090111,Paturi; Ramamohan,0,0,0,0
1653578335792,CSE 207B,A00,090112,Heninger; Nadia A,0,0,0,0
1653578336315,CSE 208,A00,094858,Micciancio; Daniele,0,0,0,0
1653578336837,CSE 210,A00,090113,Powell; Thomas Allan,0,0,0,0
1653578337359,CSE 219,A00,090898,Staff,0,0,0,0
1653578337884,CSE 221,A00,090114,Zhou; Yuan-Yuan,0,0,0,0
1653578338416,CSE 229A,A00,090115,Porter; George M,0,0,0,0
1653578338942,CSE 229C,A00,090116,Savage; Stefan,0,0,0,0
1653578339465,CSE 230,A00,090117,Jhala; Ranjit,0,0,0,0
1653578339996,CSE 232,A00,090118,Papakonstantinou; Yannis,0,0,0,0
1653578340519,CSE 239A,A00,090121,Kumar; Arun Kumar,0,0,0,0
1653578341053,CSE 239B,A00,090122,Jhala; Ranjit,0,0,0,0
1653578341586,CSE 240A,A00,090123,Zhao; Jishen,1,0,189,188
1653578342116,CSE 243A,A00,090124,Orailoglu; Alex,0,0,15,15
1653578342652,CSE 249B,A00,090125,Kahng; Andrew Byun,13,0,20,7
1653578343180,CSE 250A,A00,090126,Berg-Kirkpatrick; Taylor D,0,0,0,0
1653578343706,CSE 252A,A00,090127,Ochoa; Benjamin Lawrence,0,0,0,0
1653578344230,CSE 258,A01,090129,McAuley; Julian John,0,0,0,0
1653578344756,CSE 258R,A01,090131,McAuley; Julian John,0,0,0,0
1653578345287,CSE 274,A00,090132,Ramamoorthi; Ravi,0,0,0,0
1653578345813,CSE 276A,A00,090133,Christensen; Henrik I,0,0,0,0
1653578346337,CSE 276C,A00,090134,Christensen; Henrik I,0,0,0,0
1653578346863,CSE 290,A00,090135,Bafna; Vineet,0,0,0,0
1653578346863,CSE 290,B00,090136,Ramamoorthi; Ravi,0,0,0,0
1653578346863,CSE 290,C00,090137,Li; Tzumao,8,0,10,2
1653578346863,CSE 290,D00,090138,Zhou; Yuan-Yuan,9,0,10,1
1653578346863,CSE 290,E00,090139,Christensen; Henrik I,8,0,10,2
1653578346863,CSE 290,F00,094053,Shalev; Aaron D,0,0,0,0
1653578347391,CSE 291,A00,090140,Munyaka; Imani N. S.,0,0,0,0
1653578347391,CSE 291,B00,094880,Yu; Qi,0,0,0,0
1653578347391,CSE 291,C00,090142,Pannuto; Patrick William,0,0,0,0
1653578347391,CSE 291,D00,094881,Zhang; Yiying,0,0,0,0
1653578347391,CSE 291,E00,095118,Su; Hao,0,0,0,0
1653578347937,CSE 293,001,094905,Bafna; Vineet,9999,0,9999,0
1653578347937,CSE 293,002,094906,Bellare; Mihir,9999,0,9999,0
1653578347937,CSE 293,003,094907,Berg-Kirkpatrick; Taylor D,9999,0,9999,0
1653578347937,CSE 293,004,094908,Christensen; Henrik I,9999,0,9999,0
1653578347937,CSE 293,005,094909,Cottrell; Garrison W,9999,0,9999,0
1653578347937,CSE 293,006,094910,Deutsch; Alin Bernard,9999,0,9999,0
1653578347937,CSE 293,007,094911,Esmaeilzadeh; Hadi,9999,0,9999,0
1653578347937,CSE 293,008,094912,Freund; Yoav,9999,0,9999,0
1653578347937,CSE 293,009,094913,Griswold; William G.,9999,0,9999,0
1653578347937,CSE 293,010,094914,Gymrek; Melissa Ann,9999,0,9999,0
1653578347937,CSE 293,011,094915,Heninger; Nadia A,9999,0,9999,0
1653578347937,CSE 293,012,094916,Impagliazzo; Russell,9999,0,9999,0
1653578347937,CSE 293,013,094917,Jhala; Ranjit,9999,0,9999,0
1653578347937,CSE 293,014,094918,Kahng; Andrew Byun,9999,0,9999,0
1653578347937,CSE 293,015,094919,Kane; Daniel Mertz,9999,0,9999,0
1653578347937,CSE 293,016,094920,Kriegman; David J,9999,0,9999,0
1653578347937,CSE 293,017,094921,Kumar; Arun Kumar,9999,0,9999,0
1653578347937,CSE 293,018,094922,Lerner; Sorin,9999,0,9999,0
1653578347937,CSE 293,019,094923,Lovett; Shachar,9999,0,9999,0
1653578347937,CSE 293,020,094924,McAuley; Julian John,9999,0,9999,0
1653578347937,CSE 293,021,094925,Micciancio; Daniele,9999,0,9999,0
1653578347937,CSE 293,022,094926,Orailoglu; Alex,9999,0,9999,0
1653578347937,CSE 293,023,094927,Paturi; Ramamohan,9999,0,9999,0
1653578347937,CSE 293,024,094928,Polikarpova; Nadezhda,9999,0,9999,0
1653578347937,CSE 293,025,094929,Politz; Joseph Gibbs,9999,0,9999,0
1653578347937,CSE 293,026,094930,Porter; George M,9999,0,9999,0
1653578347937,CSE 293,027,094931,Porter; Leonard Emerson,9999,0,9999,0
1653578347937,CSE 293,028,094932,Ramamoorthi; Ravi,9999,0,9999,0
1653578347937,CSE 293,029,094933,Sahoo; Debashis,9999,0,9999,0
1653578347937,CSE 293,030,094934,Saul; Lawrence,9999,0,9999,0
1653578347937,CSE 293,031,094935,Savage; Stefan,9999,0,9999,0
1653578347937,CSE 293,032,094936,Schulze; Jurgen P.,9999,0,9999,0
1653578347937,CSE 293,033,094937,Snoeren; Alex C.,9999,0,9999,0
1653578347937,CSE 293,034,094938,Shang; Jingbo,9999,0,9999,0
1653578347937,CSE 293,035,094939,Stefan; Deian,9999,0,9999,0
1653578347937,CSE 293,036,094940,Su; Hao,9999,0,9999,0
1653578347937,CSE 293,037,094941,Swanson; Steven James,9999,0,9999,0
1653578347937,CSE 293,038,094942,Tullsen; Dean Michael,9999,0,9999,0
1653578347937,CSE 293,039,094943,Voelker; Geoffrey M.,9999,0,9999,0
1653578347937,CSE 293,040,094944,Zhao; Jishen,9999,0,9999,0
1653578347937,CSE 293,041,094945,Zhou; Yuan-Yuan,9999,0,9999,0
1653578347937,CSE 293,042,094946,Gao; Sicun,9998,0,9999,1
1653578347937,CSE 293,043,094947,Weibel; Nadir,9999,0,9999,0
1653578347937,CSE 293,044,094948,Gupta; Rajesh K.,9999,0,9999,0
1653578348461,CSE 294,A00,090143,Porter; George M,8,0,10,2
1653578348986,DSE 200,A00,091799,Staff,50,0,50,0
1653578349508,DSE 203,A00,091800,Gupta; Amarnath,30,0,30,0
1653578350035,DSE 250,A00,091801,Deutsch; Alin Bernard,30,0,30,0
1653578350560,DSE 290,A00,091802,Altintas De Callaf; Ilkay,50,0,50,0
1653578351087,ECE 200,001,091003,Antipa; Nicholas A,9999,0,9999,0
1653578351087,ECE 200,002,091004,Atanasov; Nikolay A.,9999,0,9999,0
1653578351087,ECE 200,003,091005,Bharadia; Dinesh,9999,0,9999,0
1653578351087,ECE 200,004,091006,Cheng; Chung Kuan,9999,0,9999,0
1653578351087,ECE 200,005,091007,Cosman; Pamela C.,9999,0,9999,0
1653578351087,ECE 200,006,091008,Staff,9999,0,9999,0
1653578351087,ECE 200,007,091009,Dayeh; Shadi Ahmad,9999,0,9999,0
1653578351087,ECE 200,008,091010,Fainman; Yeshaiahu,9999,0,9999,0
1653578351087,ECE 200,009,091011,Ford; Joseph Earl,9999,0,9999,0
1653578351087,ECE 200,010,091012,Franceschetti; Massimo,9999,0,9999,0
1653578351087,ECE 200,011,091013,Fullerton; Eric E,9999,0,9999,0
1653578351087,ECE 200,012,091014,Galton; Ian A,9999,0,9999,0
1653578351087,ECE 200,013,091015,Gilja; Vikash,9999,0,9999,0
1653578351087,ECE 200,014,091016,Hall; Drew A.,9999,0,9999,0
1653578351087,ECE 200,015,091017,Hsueh; Tzu-Chien,9999,0,9999,0
1653578351087,ECE 200,016,091018,Javidi; Tara,9999,0,9999,0
1653578351087,ECE 200,017,091019,Kahng; Andrew Byun,9999,0,9999,0
1653578351087,ECE 200,018,091020,Kim; Young-Han,9999,0,9999,0
1653578351087,ECE 200,019,091021,Koushanfar; Farinaz,9999,0,9999,0
1653578351087,ECE 200,020,091022,Kuzum; Duygu,9999,0,9999,0
1653578351087,ECE 200,021,091023,Le; Hanh-Phuc,9999,0,9999,0
1653578351087,ECE 200,022,091024,Lin; Bill,9999,0,9999,0
1653578351087,ECE 200,023,091025,Liu; Zhaowei,9999,0,9999,0
1653578351087,ECE 200,024,091026,Lo; Yu-Hwa,9999,0,9999,0
1653578351087,ECE 200,025,091027,Lomakin; Vitaliy,9999,0,9999,0
1653578351087,ECE 200,026,091028,Mercier; Patrick Philip,9999,0,9999,0
1653578351087,ECE 200,027,091029,Meyer; Florian,9999,0,9999,0
1653578351087,ECE 200,028,091030,Milstein; Laurence B.,9999,0,9999,0
1653578351087,ECE 200,029,091031,Mir Arabbaygi; Siavash,9999,0,9999,0
1653578351087,ECE 200,030,091032,Mookherjea; Shayan,9999,0,9999,0
1653578351087,ECE 200,031,091033,Morris; Karcher William,9999,0,9999,0
1653578351087,ECE 200,032,091034,Ng; Tse Nga,9999,0,9999,0
1653578351087,ECE 200,033,091035,Nguyen; Truong Quang,9999,0,9999,0
1653578351087,ECE 200,034,091036,Nomura; Kenji,9999,0,9999,0
1653578351087,ECE 200,035,091037,Orlitsky; Alon,9999,0,9999,0
1653578351087,ECE 200,036,091038,Pal; Piya,9999,0,9999,0
1653578351087,ECE 200,037,091039,Papen; George C.,9999,0,9999,0
1653578351087,ECE 200,038,091040,Radic; Stojan,9999,0,9999,0
1653578351087,ECE 200,039,091041,Rao; Bhaskar D.,9999,0,9999,0
1653578351087,ECE 200,040,091042,Rao; Ramesh R,9999,0,9999,0
1653578351087,ECE 200,041,091043,Rebeiz; Gabriel,9999,0,9999,0
1653578351087,ECE 200,042,091044,Sanford; John R,9999,0,9999,0
1653578351087,ECE 200,043,091045,Siegel; Paul H.,9999,0,9999,0
1653578351087,ECE 200,044,091046,Sievenpiper; Daniel F.,9999,0,9999,0
1653578351087,ECE 200,045,091047,Sworder; David D.,9999,0,9999,0
1653578351087,ECE 200,046,091048,Taur; Yuan,9999,0,9999,0
1653578351087,ECE 200,047,091049,Touri; Behrouz,9999,0,9999,0
1653578351087,ECE 200,048,091050,Trivedi; Mohan M.,9999,0,9999,0
1653578351087,ECE 200,049,091051,Vardy; Alexander,9999,0,9999,0
1653578351087,ECE 200,050,091052,Vasconcelos; Nuno,9999,0,9999,0
1653578351087,ECE 200,051,091053,Wang; Xiaolong,9999,0,9999,0
1653578351087,ECE 200,052,091054,Xie; Pengtao,9999,0,9999,0
1653578351087,ECE 200,053,091055,Yip; Michael,9999,0,9999,0
1653578351087,ECE 200,054,091056,Zeger; Kenneth A.,9999,0,9999,0
1653578351087,ECE 200,055,091057,Zhang; Xinyu,9999,0,9999,0
1653578351087,ECE 200,056,091058,Turakhia; Yatish Girish,9999,0,9999,0
1653578351087,ECE 200,057,091059,Kang; Mingu,9999,0,9999,0
1653578351087,ECE 200,058,091060,Shi; Yuanyuan,9999,0,9999,0
1653578351087,ECE 200,059,091061,Wang; Edward Jay,9999,0,9999,0
1653578351087,ECE 200,060,091062,Zheng; Yang,9999,0,9999,0
1653578351609,ECE 201,A00,095526,Lo; Yu-Hwa,0,0,0,0
1653578352145,ECE 203,A00,091065,Mercier; Patrick Philip,0,0,0,0
1653578352678,ECE 207A,A00,091605,Liu; Thomas Tao-Ming,0,0,0,0
1653578353200,ECE 212AN,A00,091068,Nomura; Kenji,0,0,0,0
1653578353723,ECE 222A,A00,091069,Rebeiz; Gabriel,0,0,0,0
1653578354246,ECE 225A,A00,091070,Orlitsky; Alon,0,0,0,0
1653578354771,ECE 230A,A00,091071,Nomura; Kenji,0,0,0,0
1653578355293,ECE 236A,A00,091072,Dayeh; Shadi Ahmad,0,0,0,0
1653578355826,ECE 238A,A00,091073,Luo; Jian,0,0,0,0
1653578355826,ECE 238A,B00,091074,Luo; Jian,0,0,0,0
1653578356357,ECE 240A,A00,091075,Radic; Stojan,0,0,0,0
1653578356879,ECE 247A,A00,091592,Shi; Lingyan,0,0,0,0
1653578357402,ECE 250,A00,091076,Touri; Behrouz,0,0,0,0
1653578357931,ECE 251C,A00,091078,Nguyen; Truong Quang,0,0,0,0
1653578358462,ECE 253,A00,091079,Cosman; Pamela C.,0,0,0,0
1653578358986,ECE 255A,A00,091080,Orlitsky; Alon,0,0,0,0
1653578359520,ECE 257A,A00,091081,Zhang; Xinyu,0,0,0,0
1653578360050,ECE 260A,A01,091084,Eldon; John,0,0,0,0
1653578360579,ECE 264C,A00,091085,Galton; Ian A,0,0,0,0
1653578361104,ECE 265C,A00,094889,Presti; Calogero Davide,0,0,0,9
1653578361633,ECE 266,A01,091087,Hall; Drew A.,0,0,0,0
1653578362686,ECE 271A,A00,091090,Vasconcelos; Nuno,0,0,0,0
1653578363220,ECE 272B,A00,091091,Sworder; David D.,0,0,0,0
1653578363744,ECE 275A,A00,091092,Meyer; Florian,0,0,0,0
1653578364273,ECE 277,A00,091093,An; Cheolhong,0,0,0,0
1653578364796,ECE 283,A00,091094,Le; Hanh-Phuc,0,0,0,0
1653578365321,ECE 284,A00,091095,Kang; Mingu,0,0,0,0
1653578365321,ECE 284,B00,091096,Wang; Edward Jay,0,0,0,0
1653578365850,ECE 285,A00,094334,Touri; Behrouz,0,0,0,0
1653578366372,ECE 289,A00,091097,Whelan; David Arthur,0,0,0,0
1653578366897,MATH 200A,A00,087414,Salehi Golsefidy; Alireza,7,0,8,1
1653578367429,MATH 202A,A00,087415,Gill; Philip E.,2,0,8,6
1653578367952,MATH 203A,A00,087416,Oprea; Dragos N.,6,0,8,2
1653578368477,MATH 204A,A00,087417,Kedlaya; Kiran S.,6,0,8,2
1653578369003,MATH 205,A00,087418,Sorensen; Claus M,6,0,8,2
1653578369532,MATH 206A,A00,087419,Izadi; Elham,7,0,8,1
1653578370057,MATH 207A,A00,087420,Mohammadi; Amir,5,0,8,3
1653578370591,MATH 208,A00,087421,Staff,9,0,10,1
1653578371117,MATH 209,A00,087422,Staff,10,0,10,0
1653578371638,MATH 218,A00,087423,Staff,10,0,10,0
1653578372165,MATH 220A,A00,087424,Novak; Jonathan I,6,0,8,2
1653578372688,MATH 231A,A00,087425,Bejenaru; Ioan,3,0,8,5
1653578373220,MATH 240A,A00,087426,Ebenfelt; Peter F,5,0,8,3
1653578373754,MATH 243,A00,087427,Staff,9,0,10,1
1653578374276,MATH 248,A00,087429,Staff,10,0,10,0
1653578374813,MATH 250A,A00,087430,Spolaor; Luca,4,0,8,4
1653578375344,MATH 257A,A00,087431,Spolaor; Luca,7,0,8,1
1653578375867,MATH 258,A00,087432,Staff,9,0,10,1
1653578376392,MATH 264A,A00,087433,Warnke; Lutz Peter,5,0,8,3
1653578376917,MATH 268,A00,087434,Staff,15,0,15,0
1653578377441,MATH 269,A00,087435,Staff,14,0,15,1
1653578377964,MATH 270A,A00,087436,Nie; Jiawang,0,0,8,8
1653578378487,MATH 272A,A00,087437,Tian; Xiaochuan,1,0,8,7
1653578379010,MATH 274,A01,087439,Cheng; Li-Tien,9,0,10,1
1653578379010,MATH 274,A02,087440,Cheng; Li-Tien,10,0,10,0
1653578379534,MATH 278A,A00,087441,Staff,8,0,10,2
1653578380059,MATH 278B,A00,087442,Staff,8,0,10,2
1653578380585,MATH 278C,A00,087443,Staff,8,0,10,2
1653578381111,MATH 280A,A00,087444,Zheng; Tianyi,0,0,8,8
1653578381636,MATH 281A,A00,087445,Bradic; Jelena,0,0,8,8
1653578382229,MATH 282A,A00,087446,Zhang; Danna,0,0,8,8
1653578382753,MATH 283,A00,087447,Tesler; Glenn,0,0,0,16
1653578383275,MATH 286,B00,095535,Kemp; Todd Aahron,8,0,8,0
1653578383801,MATH 287D,A00,087449,Bradic; Jelena,0,0,0,2
1653578384335,MATH 288,A00,087450,Staff,14,0,15,1
1653578384335,MATH 288,B00,087451,Staff,15,0,15,0
1653578384335,MATH 288,C00,087452,Staff,15,0,15,0
1653578384857,MATH 290A,A00,087453,Xu; Zhouli,6,0,8,2
1653578385379,MATH 291A,A00,087454,Xu; Zhouli,7,0,8,1
1653578385901,MATH 292,A00,087455,Staff,10,0,10,0
1653578386433,MATH 295,A00,087456,Staff,50,0,50,0
1653578386955,MATH 297,001,087457,Staff,998,0,999,1
1653578946941,COGS 200,A01,087991,Staff,47,0,50,3
1653578947462,COGS 201,A01,094504,Rangel; Lara M,17,0,25,8
1653578947993,COGS 203,A00,087992,Coulson; Seana M,18,0,20,2
1653578948519,COGS 210A,001,087993,Greene; Deanna Jacquelyn,9998,0,9999,1
1653578948519,COGS 210A,002,087994,Saygin; Ayse P,9999,0,9999,0
1653578948519,COGS 210A,003,087995,Xia; Haijun,9999,0,9999,0
1653578948519,COGS 210A,004,087996,Nitz; Douglas A.,9999,0,9999,0
1653578948519,COGS 210A,005,087997,Hollan; James D.,9999,0,9999,0
1653578948519,COGS 210A,006,087998,Deak; Gedeon O.,9998,0,9999,1
1653578948519,COGS 210A,007,087999,Rossano; Federico,9999,0,9999,0
1653578949047,COGS 211A,A00,088000,Coulson; Seana M,9997,0,9999,2
1653578949571,COGS 229,A00,088002,Staff,22,0,25,3
1653578950097,COGS 260,B00,094231,Staff,17,0,20,3
1653578950097,COGS 260,A00,088004,Nitz; Douglas A.,9998,0,9999,1
1653578950619,CSE 202,A00,090110,Paturi; Ramamohan,0,0,0,0
1653578950619,CSE 202,B00,090111,Paturi; Ramamohan,0,0,0,0
1653578951142,CSE 207B,A00,090112,Heninger; Nadia A,0,0,0,0
1653578951667,CSE 208,A00,094858,Micciancio; Daniele,0,0,0,0
1653578952188,CSE 210,A00,090113,Powell; Thomas Allan,0,0,0,0
1653578952710,CSE 219,A00,090898,Staff,0,0,0,0
1653578953246,CSE 221,A00,090114,Zhou; Yuan-Yuan,0,0,0,0
1653578953768,CSE 229A,A00,090115,Porter; George M,0,0,0,0
1653578954290,CSE 229C,A00,090116,Savage; Stefan,0,0,0,0
1653578954814,CSE 230,A00,090117,Jhala; Ranjit,0,0,0,0
1653578955337,CSE 232,A00,090118,Papakonstantinou; Yannis,0,0,0,0
1653578955859,CSE 239A,A00,090121,Kumar; Arun Kumar,0,0,0,0
1653578956385,CSE 239B,A00,090122,Jhala; Ranjit,0,0,0,0
1653578956908,CSE 240A,A00,090123,Zhao; Jishen,1,0,189,188
1653578957431,CSE 243A,A00,090124,Orailoglu; Alex,0,0,15,15
1653578957954,CSE 249B,A00,090125,Kahng; Andrew Byun,13,0,20,7
1653578958478,CSE 250A,A00,090126,Berg-Kirkpatrick; Taylor D,0,0,0,0
1653578959000,CSE 252A,A00,090127,Ochoa; Benjamin Lawrence,0,0,0,0
1653578959526,CSE 258,A01,090129,McAuley; Julian John,0,0,0,0
1653578960048,CSE 258R,A01,090131,McAuley; Julian John,0,0,0,0
1653578960574,CSE 274,A00,090132,Ramamoorthi; Ravi,0,0,0,0
1653578961097,CSE 276A,A00,090133,Christensen; Henrik I,0,0,0,0
1653578961622,CSE 276C,A00,090134,Christensen; Henrik I,0,0,0,0
1653578962145,CSE 290,A00,090135,Bafna; Vineet,0,0,0,0
1653578962145,CSE 290,B00,090136,Ramamoorthi; Ravi,0,0,0,0
1653578962145,CSE 290,C00,090137,Li; Tzumao,8,0,10,2
1653578962145,CSE 290,D00,090138,Zhou; Yuan-Yuan,9,0,10,1
1653578962145,CSE 290,E00,090139,Christensen; Henrik I,8,0,10,2
1653578962145,CSE 290,F00,094053,Shalev; Aaron D,0,0,0,0
1653578962674,CSE 291,A00,090140,Munyaka; Imani N. S.,0,0,0,0
1653578962674,CSE 291,B00,094880,Yu; Qi,0,0,0,0
1653578962674,CSE 291,C00,090142,Pannuto; Patrick William,0,0,0,0
1653578962674,CSE 291,D00,094881,Zhang; Yiying,0,0,0,0
1653578962674,CSE 291,E00,095118,Su; Hao,0,0,0,0
1653578963204,CSE 293,001,094905,Bafna; Vineet,9999,0,9999,0
1653578963204,CSE 293,002,094906,Bellare; Mihir,9999,0,9999,0
1653578963204,CSE 293,003,094907,Berg-Kirkpatrick; Taylor D,9999,0,9999,0
1653578963204,CSE 293,004,094908,Christensen; Henrik I,9999,0,9999,0
1653578963204,CSE 293,005,094909,Cottrell; Garrison W,9999,0,9999,0
1653578963204,CSE 293,006,094910,Deutsch; Alin Bernard,9999,0,9999,0
1653578963204,CSE 293,007,094911,Esmaeilzadeh; Hadi,9999,0,9999,0
1653578963204,CSE 293,008,094912,Freund; Yoav,9999,0,9999,0
1653578963204,CSE 293,009,094913,Griswold; William G.,9999,0,9999,0
1653578963204,CSE 293,010,094914,Gymrek; Melissa Ann,9999,0,9999,0
1653578963204,CSE 293,011,094915,Heninger; Nadia A,9999,0,9999,0
1653578963204,CSE 293,012,094916,Impagliazzo; Russell,9999,0,9999,0
1653578963204,CSE 293,013,094917,Jhala; Ranjit,9999,0,9999,0
1653578963204,CSE 293,014,094918,Kahng; Andrew Byun,9999,0,9999,0
1653578963204,CSE 293,015,094919,Kane; Daniel Mertz,9999,0,9999,0
1653578963204,CSE 293,016,094920,Kriegman; David J,9999,0,9999,0
1653578963204,CSE 293,017,094921,Kumar; Arun Kumar,9999,0,9999,0
1653578963204,CSE 293,018,094922,Lerner; Sorin,9999,0,9999,0
1653578963204,CSE 293,019,094923,Lovett; Shachar,9999,0,9999,0
1653578963204,CSE 293,020,094924,McAuley; Julian John,9999,0,9999,0
1653578963204,CSE 293,021,094925,Micciancio; Daniele,9999,0,9999,0
1653578963204,CSE 293,022,094926,Orailoglu; Alex,9999,0,9999,0
1653578963204,CSE 293,023,094927,Paturi; Ramamohan,9999,0,9999,0
1653578963204,CSE 293,024,094928,Polikarpova; Nadezhda,9999,0,9999,0
1653578963204,CSE 293,025,094929,Politz; Joseph Gibbs,9999,0,9999,0
1653578963204,CSE 293,026,094930,Porter; George M,9999,0,9999,0
1653578963204,CSE 293,027,094931,Porter; Leonard Emerson,9999,0,9999,0
1653578963204,CSE 293,028,094932,Ramamoorthi; Ravi,9999,0,9999,0
1653578963204,CSE 293,029,094933,Sahoo; Debashis,9999,0,9999,0
1653578963204,CSE 293,030,094934,Saul; Lawrence,9999,0,9999,0
1653578963204,CSE 293,031,094935,Savage; Stefan,9999,0,9999,0
1653578963204,CSE 293,032,094936,Schulze; Jurgen P.,9999,0,9999,0
1653578963204,CSE 293,033,094937,Snoeren; Alex C.,9999,0,9999,0
1653578963204,CSE 293,034,094938,Shang; Jingbo,9999,0,9999,0
1653578963204,CSE 293,035,094939,Stefan; Deian,9999,0,9999,0
1653578963204,CSE 293,036,094940,Su; Hao,9999,0,9999,0
1653578963204,CSE 293,037,094941,Swanson; Steven James,9999,0,9999,0
1653578963204,CSE 293,038,094942,Tullsen; Dean Michael,9999,0,9999,0
1653578963204,CSE 293,039,094943,Voelker; Geoffrey M.,9999,0,9999,0
1653578963204,CSE 293,040,094944,Zhao; Jishen,9999,0,9999,0
1653578963204,CSE 293,041,094945,Zhou; Yuan-Yuan,9999,0,9999,0
1653578963204,CSE 293,042,094946,Gao; Sicun,9998,0,9999,1
1653578963204,CSE 293,043,094947,Weibel; Nadir,9999,0,9999,0
1653578963204,CSE 293,044,094948,Gupta; Rajesh K.,9999,0,9999,0
1653578963726,CSE 294,A00,090143,Porter; George M,8,0,10,2
1653578964252,DSE 200,A00,091799,Staff,50,0,50,0
1653578964776,DSE 203,A00,091800,Gupta; Amarnath,30,0,30,0
1653578965303,DSE 250,A00,091801,Deutsch; Alin Bernard,30,0,30,0
1653578965826,DSE 290,A00,091802,Altintas De Callaf; Ilkay,50,0,50,0
1653578966369,ECE 200,001,091003,Antipa; Nicholas A,9999,0,9999,0
1653578966369,ECE 200,002,091004,Atanasov; Nikolay A.,9999,0,9999,0
1653578966369,ECE 200,003,091005,Bharadia; Dinesh,9999,0,9999,0
1653578966369,ECE 200,004,091006,Cheng; Chung Kuan,9999,0,9999,0
1653578966369,ECE 200,005,091007,Cosman; Pamela C.,9999,0,9999,0
1653578966369,ECE 200,006,091008,Staff,9999,0,9999,0
1653578966369,ECE 200,007,091009,Dayeh; Shadi Ahmad,9999,0,9999,0
1653578966369,ECE 200,008,091010,Fainman; Yeshaiahu,9999,0,9999,0
1653578966369,ECE 200,009,091011,Ford; Joseph Earl,9999,0,9999,0
1653578966369,ECE 200,010,091012,Franceschetti; Massimo,9999,0,9999,0
1653578966369,ECE 200,011,091013,Fullerton; Eric E,9999,0,9999,0
1653578966369,ECE 200,012,091014,Galton; Ian A,9999,0,9999,0
1653578966369,ECE 200,013,091015,Gilja; Vikash,9999,0,9999,0
1653578966369,ECE 200,014,091016,Hall; Drew A.,9999,0,9999,0
1653578966369,ECE 200,015,091017,Hsueh; Tzu-Chien,9999,0,9999,0
1653578966369,ECE 200,016,091018,Javidi; Tara,9999,0,9999,0
1653578966369,ECE 200,017,091019,Kahng; Andrew Byun,9999,0,9999,0
1653578966369,ECE 200,018,091020,Kim; Young-Han,9999,0,9999,0
1653578966369,ECE 200,019,091021,Koushanfar; Farinaz,9999,0,9999,0
1653578966369,ECE 200,020,091022,Kuzum; Duygu,9999,0,9999,0
1653578966369,ECE 200,021,091023,Le; Hanh-Phuc,9999,0,9999,0
1653578966369,ECE 200,022,091024,Lin; Bill,9999,0,9999,0
1653578966369,ECE 200,023,091025,Liu; Zhaowei,9999,0,9999,0
1653578966369,ECE 200,024,091026,Lo; Yu-Hwa,9999,0,9999,0
1653578966369,ECE 200,025,091027,Lomakin; Vitaliy,9999,0,9999,0
1653578966369,ECE 200,026,091028,Mercier; Patrick Philip,9999,0,9999,0
1653578966369,ECE 200,027,091029,Meyer; Florian,9999,0,9999,0
1653578966369,ECE 200,028,091030,Milstein; Laurence B.,9999,0,9999,0
1653578966369,ECE 200,029,091031,Mir Arabbaygi; Siavash,9999,0,9999,0
1653578966369,ECE 200,030,091032,Mookherjea; Shayan,9999,0,9999,0
1653578966369,ECE 200,031,091033,Morris; Karcher William,9999,0,9999,0
1653578966369,ECE 200,032,091034,Ng; Tse Nga,9999,0,9999,0
1653578966369,ECE 200,033,091035,Nguyen; Truong Quang,9999,0,9999,0
1653578966369,ECE 200,034,091036,Nomura; Kenji,9999,0,9999,0
1653578966369,ECE 200,035,091037,Orlitsky; Alon,9999,0,9999,0
1653578966369,ECE 200,036,091038,Pal; Piya,9999,0,9999,0
1653578966369,ECE 200,037,091039,Papen; George C.,9999,0,9999,0
1653578966369,ECE 200,038,091040,Radic; Stojan,9999,0,9999,0
1653578966369,ECE 200,039,091041,Rao; Bhaskar D.,9999,0,9999,0
1653578966369,ECE 200,040,091042,Rao; Ramesh R,9999,0,9999,0
1653578966369,ECE 200,041,091043,Rebeiz; Gabriel,9999,0,9999,0
1653578966369,ECE 200,042,091044,Sanford; John R,9999,0,9999,0
1653578966369,ECE 200,043,091045,Siegel; Paul H.,9999,0,9999,0
1653578966369,ECE 200,044,091046,Sievenpiper; Daniel F.,9999,0,9999,0
1653578966369,ECE 200,045,091047,Sworder; David D.,9999,0,9999,0
1653578966369,ECE 200,046,091048,Taur; Yuan,9999,0,9999,0
1653578966369,ECE 200,047,091049,Touri; Behrouz,9999,0,9999,0
1653578966369,ECE 200,048,091050,Trivedi; Mohan M.,9999,0,9999,0
1653578966369,ECE 200,049,091051,Vardy; Alexander,9999,0,9999,0
1653578966369,ECE 200,050,091052,Vasconcelos; Nuno,9999,0,9999,0
1653578966369,ECE 200,051,091053,Wang; Xiaolong,9999,0,9999,0
1653578966369,ECE 200,052,091054,Xie; Pengtao,9999,0,9999,0
1653578966369,ECE 200,053,091055,Yip; Michael,9999,0,9999,0
1653578966369,ECE 200,054,091056,Zeger; Kenneth A.,9999,0,9999,0
1653578966369,ECE 200,055,091057,Zhang; Xinyu,9999,0,9999,0
1653578966369,ECE 200,056,091058,Turakhia; Yatish Girish,9999,0,9999,0
1653578966369,ECE 200,057,091059,Kang; Mingu,9999,0,9999,0
1653578966369,ECE 200,058,091060,Shi; Yuanyuan,9999,0,9999,0
1653578966369,ECE 200,059,091061,Wang; Edward Jay,9999,0,9999,0
1653578966369,ECE 200,060,091062,Zheng; Yang,9999,0,9999,0
1653578966892,ECE 201,A00,095526,Lo; Yu-Hwa,0,0,0,0
1653578967413,ECE 203,A00,091065,Mercier; Patrick Philip,0,0,0,0
1653578967937,ECE 207A,A00,091605,Liu; Thomas Tao-Ming,0,0,0,0
1653578968460,ECE 212AN,A00,091068,Nomura; Kenji,0,0,0,0
1653578968984,ECE 222A,A00,091069,Rebeiz; Gabriel,0,0,0,0
1653578969600,ECE 225A,A00,091070,Orlitsky; Alon,0,0,0,0
1653578970124,ECE 230A,A00,091071,Nomura; Kenji,0,0,0,0
1653578970646,ECE 236A,A00,091072,Dayeh; Shadi Ahmad,0,0,0,0
1653578971174,ECE 238A,A00,091073,Luo; Jian,0,0,0,0
1653578971174,ECE 238A,B00,091074,Luo; Jian,0,0,0,0
1653578971699,ECE 240A,A00,091075,Radic; Stojan,0,0,0,0
1653578972226,ECE 247A,A00,091592,Shi; Lingyan,0,0,0,0
1653578972753,ECE 250,A00,091076,Touri; Behrouz,0,0,0,0
1653578973280,ECE 251C,A00,091078,Nguyen; Truong Quang,0,0,0,0
1653578973806,ECE 253,A00,091079,Cosman; Pamela C.,0,0,0,0
1653578974332,ECE 255A,A00,091080,Orlitsky; Alon,0,0,0,0
1653578974853,ECE 257A,A00,091081,Zhang; Xinyu,0,0,0,0
1653578975380,ECE 260A,A01,091084,Eldon; John,0,0,0,0
1653578975901,ECE 264C,A00,091085,Galton; Ian A,0,0,0,0
1653578976432,ECE 265C,A00,094889,Presti; Calogero Davide,0,0,0,9
1653578976955,ECE 266,A01,091087,Hall; Drew A.,0,0,0,0
1653578978012,ECE 271A,A00,091090,Vasconcelos; Nuno,0,0,0,0
1653578978540,ECE 272B,A00,091091,Sworder; David D.,0,0,0,0
1653578979061,ECE 275A,A00,091092,Meyer; Florian,0,0,0,0
1653578979588,ECE 277,A00,091093,An; Cheolhong,0,0,0,0
1653578980109,ECE 283,A00,091094,Le; Hanh-Phuc,0,0,0,0
1653578980633,ECE 284,A00,091095,Kang; Mingu,0,0,0,0
1653578980633,ECE 284,B00,091096,Wang; Edward Jay,0,0,0,0
1653578981155,ECE 285,A00,094334,Touri; Behrouz,0,0,0,0
1653578981687,ECE 289,A00,091097,Whelan; David Arthur,0,0,0,0
1653578982215,MATH 200A,A00,087414,Salehi Golsefidy; Alireza,7,0,8,1
1653578982744,MATH 202A,A00,087415,Gill; Philip E.,2,0,8,6
1653578983279,MATH 203A,A00,087416,Oprea; Dragos N.,6,0,8,2
1653578983801,MATH 204A,A00,087417,Kedlaya; Kiran S.,6,0,8,2
1653578993521,MATH 205,A00,087418,Sorensen; Claus M,6,0,8,2
1653578994050,MATH 206A,A00,087419,Izadi; Elham,7,0,8,1
1653578994577,MATH 207A,A00,087420,Mohammadi; Amir,5,0,8,3
1653578995101,MATH 208,A00,087421,Staff,9,0,10,1
1653578995624,MATH 209,A00,087422,Staff,10,0,10,0
1653578996153,MATH 218,A00,087423,Staff,10,0,10,0
1653578996675,MATH 220A,A00,087424,Novak; Jonathan I,6,0,8,2
1653578997197,MATH 231A,A00,087425,Bejenaru; Ioan,3,0,8,5
1653578997727,MATH 240A,A00,087426,Ebenfelt; Peter F,5,0,8,3
1653578998252,MATH 243,A00,087427,Staff,9,0,10,1
1653578998776,MATH 248,A00,087429,Staff,10,0,10,0
1653578999308,MATH 250A,A00,087430,Spolaor; Luca,4,0,8,4
1653578999835,MATH 257A,A00,087431,Spolaor; Luca,7,0,8,1
1653579000379,MATH 258,A00,087432,Staff,9,0,10,1
1653579000906,MATH 264A,A00,087433,Warnke; Lutz Peter,5,0,8,3
1653579001434,MATH 268,A00,087434,Staff,15,0,15,0
1653579001960,MATH 269,A00,087435,Staff,14,0,15,1
1653579002487,MATH 270A,A00,087436,Nie; Jiawang,0,0,8,8
1653579003014,MATH 272A,A00,087437,Tian; Xiaochuan,1,0,8,7
1653579003549,MATH 274,A01,087439,Cheng; Li-Tien,9,0,10,1
1653579003549,MATH 274,A02,087440,Cheng; Li-Tien,10,0,10,0
1653579004074,MATH 278A,A00,087441,Staff,8,0,10,2
1653579004597,MATH 278B,A00,087442,Staff,8,0,10,2
1653579005119,MATH 278C,A00,087443,Staff,8,0,10,2
1653579005645,MATH 280A,A00,087444,Zheng; Tianyi,0,0,8,8
1653579006170,MATH 281A,A00,087445,Bradic; Jelena,0,0,8,8
1653579006701,MATH 282A,A00,087446,Zhang; Danna,0,0,8,8
1653579007225,MATH 283,A00,087447,Tesler; Glenn,0,0,0,16
1653579007752,MATH 286,B00,095535,Kemp; Todd Aahron,8,0,8,0
1653579008277,MATH 287D,A00,087449,Bradic; Jelena,0,0,0,2
1653579008803,MATH 288,A00,087450,Staff,14,0,15,1
1653579008803,MATH 288,B00,087451,Staff,15,0,15,0
1653579008803,MATH 288,C00,087452,Staff,15,0,15,0
1653579009331,MATH 290A,A00,087453,Xu; Zhouli,6,0,8,2
1653579009857,MATH 291A,A00,087454,Xu; Zhouli,7,0,8,1
1653579010385,MATH 292,A00,087455,Staff,10,0,10,0
1653579010907,MATH 295,A00,087456,Staff,50,0,50,0
1653579011431,MATH 297,001,087457,Staff,998,0,999,1
1653579572071,COGS 200,A01,087991,Staff,47,0,50,3
1653579572600,COGS 201,A01,094504,Rangel; Lara M,17,0,25,8
1653579573130,COGS 203,A00,087992,Coulson; Seana M,18,0,20,2
1653579573657,COGS 210A,001,087993,Greene; Deanna Jacquelyn,9998,0,9999,1
1653579573657,COGS 210A,002,087994,Saygin; Ayse P,9999,0,9999,0
1653579573657,COGS 210A,003,087995,Xia; Haijun,9999,0,9999,0
1653579573657,COGS 210A,004,087996,Nitz; Douglas A.,9999,0,9999,0
1653579573657,COGS 210A,005,087997,Hollan; James D.,9999,0,9999,0
1653579573657,COGS 210A,006,087998,Deak; Gedeon O.,9998,0,9999,1
1653579573657,COGS 210A,007,087999,Rossano; Federico,9999,0,9999,0
1653579574181,COGS 211A,A00,088000,Coulson; Seana M,9997,0,9999,2
1653579574706,COGS 229,A00,088002,Staff,22,0,25,3
1653579575228,COGS 260,B00,094231,Staff,17,0,20,3
1653579575228,COGS 260,A00,088004,Nitz; Douglas A.,9998,0,9999,1
1653579575757,CSE 202,A00,090110,Paturi; Ramamohan,0,0,0,0
1653579575757,CSE 202,B00,090111,Paturi; Ramamohan,0,0,0,0
1653579576278,CSE 207B,A00,090112,Heninger; Nadia A,0,0,0,0
1653579576808,CSE 208,A00,094858,Micciancio; Daniele,0,0,0,0
1653579577331,CSE 210,A00,090113,Powell; Thomas Allan,0,0,0,0
1653579577862,CSE 219,A00,090898,Staff,0,0,0,0
1653579578387,CSE 221,A00,090114,Zhou; Yuan-Yuan,0,0,0,0
1653579578908,CSE 229A,A00,090115,Porter; George M,0,0,0,0
1653579579434,CSE 229C,A00,090116,Savage; Stefan,0,0,0,0
1653579579957,CSE 230,A00,090117,Jhala; Ranjit,0,0,0,0
1653579580481,CSE 232,A00,090118,Papakonstantinou; Yannis,0,0,0,0
1653579581007,CSE 239A,A00,090121,Kumar; Arun Kumar,0,0,0,0
1653579581549,CSE 239B,A00,090122,Jhala; Ranjit,0,0,0,0
1653579582075,CSE 240A,A00,090123,Zhao; Jishen,1,0,189,188
1653579582604,CSE 243A,A00,090124,Orailoglu; Alex,0,0,15,15
1653579583133,CSE 249B,A00,090125,Kahng; Andrew Byun,13,0,20,7
1653579583665,CSE 250A,A00,090126,Berg-Kirkpatrick; Taylor D,0,0,0,0
1653579584186,CSE 252A,A00,090127,Ochoa; Benjamin Lawrence,0,0,0,0
1653579584710,CSE 258,A01,090129,McAuley; Julian John,0,0,0,0
1653579585237,CSE 258R,A01,090131,McAuley; Julian John,0,0,0,0
1653579585763,CSE 274,A00,090132,Ramamoorthi; Ravi,0,0,0,0
1653579586289,CSE 276A,A00,090133,Christensen; Henrik I,0,0,0,0
1653579586812,CSE 276C,A00,090134,Christensen; Henrik I,0,0,0,0
1653579587334,CSE 290,A00,090135,Bafna; Vineet,0,0,0,0
1653579587334,CSE 290,B00,090136,Ramamoorthi; Ravi,0,0,0,0
1653579587334,CSE 290,C00,090137,Li; Tzumao,8,0,10,2
1653579587334,CSE 290,D00,090138,Zhou; Yuan-Yuan,9,0,10,1
1653579587334,CSE 290,E00,090139,Christensen; Henrik I,8,0,10,2
1653579587334,CSE 290,F00,094053,Shalev; Aaron D,0,0,0,0
1653579587862,CSE 291,A00,090140,Munyaka; Imani N. S.,0,0,0,0
1653579587862,CSE 291,B00,094880,Yu; Qi,0,0,0,0
1653579587862,CSE 291,C00,090142,Pannuto; Patrick William,0,0,0,0
1653579587862,CSE 291,D00,094881,Zhang; Yiying,0,0,0,0
1653579587862,CSE 291,E00,095118,Su; Hao,0,0,0,0
1653579588389,CSE 293,001,094905,Bafna; Vineet,9999,0,9999,0
1653579588389,CSE 293,002,094906,Bellare; Mihir,9999,0,9999,0
1653579588389,CSE 293,003,094907,Berg-Kirkpatrick; Taylor D,9999,0,9999,0
1653579588389,CSE 293,004,094908,Christensen; Henrik I,9999,0,9999,0
1653579588389,CSE 293,005,094909,Cottrell; Garrison W,9999,0,9999,0
1653579588389,CSE 293,006,094910,Deutsch; Alin Bernard,9999,0,9999,0
1653579588389,CSE 293,007,094911,Esmaeilzadeh; Hadi,9999,0,9999,0
1653579588389,CSE 293,008,094912,Freund; Yoav,9999,0,9999,0
1653579588389,CSE 293,009,094913,Griswold; William G.,9999,0,9999,0
1653579588389,CSE 293,010,094914,Gymrek; Melissa Ann,9999,0,9999,0
1653579588389,CSE 293,011,094915,Heninger; Nadia A,9999,0,9999,0
1653579588389,CSE 293,012,094916,Impagliazzo; Russell,9999,0,9999,0
1653579588389,CSE 293,013,094917,Jhala; Ranjit,9999,0,9999,0
1653579588389,CSE 293,014,094918,Kahng; Andrew Byun,9999,0,9999,0
1653579588389,CSE 293,015,094919,Kane; Daniel Mertz,9999,0,9999,0
1653579588389,CSE 293,016,094920,Kriegman; David J,9999,0,9999,0
1653579588389,CSE 293,017,094921,Kumar; Arun Kumar,9999,0,9999,0
1653579588389,CSE 293,018,094922,Lerner; Sorin,9999,0,9999,0
1653579588389,CSE 293,019,094923,Lovett; Shachar,9999,0,9999,0
1653579588389,CSE 293,020,094924,McAuley; Julian John,9999,0,9999,0
1653579588389,CSE 293,021,094925,Micciancio; Daniele,9999,0,9999,0
1653579588389,CSE 293,022,094926,Orailoglu; Alex,9999,0,9999,0
1653579588389,CSE 293,023,094927,Paturi; Ramamohan,9999,0,9999,0
1653579588389,CSE 293,024,094928,Polikarpova; Nadezhda,9999,0,9999,0
1653579588389,CSE 293,025,094929,Politz; Joseph Gibbs,9999,0,9999,0
1653579588389,CSE 293,026,094930,Porter; George M,9999,0,9999,0
1653579588389,CSE 293,027,094931,Porter; Leonard Emerson,9999,0,9999,0
1653579588389,CSE 293,028,094932,Ramamoorthi; Ravi,9999,0,9999,0
1653579588389,CSE 293,029,094933,Sahoo; Debashis,9999,0,9999,0
1653579588389,CSE 293,030,094934,Saul; Lawrence,9999,0,9999,0
1653579588389,CSE 293,031,094935,Savage; Stefan,9999,0,9999,0
1653579588389,CSE 293,032,094936,Schulze; Jurgen P.,9999,0,9999,0
1653579588389,CSE 293,033,094937,Snoeren; Alex C.,9999,0,9999,0
1653579588389,CSE 293,034,094938,Shang; Jingbo,9999,0,9999,0
1653579588389,CSE 293,035,094939,Stefan; Deian,9999,0,9999,0
1653579588389,CSE 293,036,094940,Su; Hao,9999,0,9999,0
1653579588389,CSE 293,037,094941,Swanson; Steven James,9999,0,9999,0
1653579588389,CSE 293,038,094942,Tullsen; Dean Michael,9999,0,9999,0
1653579588389,CSE 293,039,094943,Voelker; Geoffrey M.,9999,0,9999,0
1653579588389,CSE 293,040,094944,Zhao; Jishen,9999,0,9999,0
1653579588389,CSE 293,041,094945,Zhou; Yuan-Yuan,9999,0,9999,0
1653579588389,CSE 293,042,094946,Gao; Sicun,9998,0,9999,1
1653579588389,CSE 293,043,094947,Weibel; Nadir,9999,0,9999,0
1653579588389,CSE 293,044,094948,Gupta; Rajesh K.,9999,0,9999,0
1653579588916,CSE 294,A00,090143,Porter; George M,8,0,10,2
1653579589440,DSE 200,A00,091799,Staff,50,0,50,0
1653579589969,DSE 203,A00,091800,Gupta; Amarnath,30,0,30,0
1653579590495,DSE 250,A00,091801,Deutsch; Alin Bernard,30,0,30,0
1653579591022,DSE 290,A00,091802,Altintas De Callaf; Ilkay,50,0,50,0
1653579591611,ECE 200,001,091003,Antipa; Nicholas A,9999,0,9999,0
1653579591611,ECE 200,002,091004,Atanasov; Nikolay A.,9999,0,9999,0
1653579591611,ECE 200,003,091005,Bharadia; Dinesh,9999,0,9999,0
1653579591611,ECE 200,004,091006,Cheng; Chung Kuan,9999,0,9999,0
1653579591611,ECE 200,005,091007,Cosman; Pamela C.,9999,0,9999,0
1653579591611,ECE 200,006,091008,Staff,9999,0,9999,0
1653579591611,ECE 200,007,091009,Dayeh; Shadi Ahmad,9999,0,9999,0
1653579591611,ECE 200,008,091010,Fainman; Yeshaiahu,9999,0,9999,0
1653579591611,ECE 200,009,091011,Ford; Joseph Earl,9999,0,9999,0
1653579591611,ECE 200,010,091012,Franceschetti; Massimo,9999,0,9999,0
1653579591611,ECE 200,011,091013,Fullerton; Eric E,9999,0,9999,0
1653579591611,ECE 200,012,091014,Galton; Ian A,9999,0,9999,0
1653579591611,ECE 200,013,091015,Gilja; Vikash,9999,0,9999,0
1653579591611,ECE 200,014,091016,Hall; Drew A.,9999,0,9999,0
1653579591611,ECE 200,015,091017,Hsueh; Tzu-Chien,9999,0,9999,0
1653579591611,ECE 200,016,091018,Javidi; Tara,9999,0,9999,0
1653579591611,ECE 200,017,091019,Kahng; Andrew Byun,9999,0,9999,0
1653579591611,ECE 200,018,091020,Kim; Young-Han,9999,0,9999,0
1653579591611,ECE 200,019,091021,Koushanfar; Farinaz,9999,0,9999,0
1653579591611,ECE 200,020,091022,Kuzum; Duygu,9999,0,9999,0
1653579591611,ECE 200,021,091023,Le; Hanh-Phuc,9999,0,9999,0
1653579591611,ECE 200,022,091024,Lin; Bill,9999,0,9999,0
1653579591611,ECE 200,023,091025,Liu; Zhaowei,9999,0,9999,0
1653579591611,ECE 200,024,091026,Lo; Yu-Hwa,9999,0,9999,0
1653579591611,ECE 200,025,091027,Lomakin; Vitaliy,9999,0,9999,0
1653579591611,ECE 200,026,091028,Mercier; Patrick Philip,9999,0,9999,0
1653579591611,ECE 200,027,091029,Meyer; Florian,9999,0,9999,0
1653579591611,ECE 200,028,091030,Milstein; Laurence B.,9999,0,9999,0
1653579591611,ECE 200,029,091031,Mir Arabbaygi; Siavash,9999,0,9999,0
1653579591611,ECE 200,030,091032,Mookherjea; Shayan,9999,0,9999,0
1653579591611,ECE 200,031,091033,Morris; Karcher William,9999,0,9999,0
1653579591611,ECE 200,032,091034,Ng; Tse Nga,9999,0,9999,0
1653579591611,ECE 200,033,091035,Nguyen; Truong Quang,9999,0,9999,0
1653579591611,ECE 200,034,091036,Nomura; Kenji,9999,0,9999,0
1653579591611,ECE 200,035,091037,Orlitsky; Alon,9999,0,9999,0
1653579591611,ECE 200,036,091038,Pal; Piya,9999,0,9999,0
1653579591611,ECE 200,037,091039,Papen; George C.,9999,0,9999,0
1653579591611,ECE 200,038,091040,Radic; Stojan,9999,0,9999,0
1653579591611,ECE 200,039,091041,Rao; Bhaskar D.,9999,0,9999,0
1653579591611,ECE 200,040,091042,Rao; Ramesh R,9999,0,9999,0
1653579591611,ECE 200,041,091043,Rebeiz; Gabriel,9999,0,9999,0
1653579591611,ECE 200,042,091044,Sanford; John R,9999,0,9999,0
1653579591611,ECE 200,043,091045,Siegel; Paul H.,9999,0,9999,0
1653579591611,ECE 200,044,091046,Sievenpiper; Daniel F.,9999,0,9999,0
1653579591611,ECE 200,045,091047,Sworder; David D.,9999,0,9999,0
1653579591611,ECE 200,046,091048,Taur; Yuan,9999,0,9999,0
1653579591611,ECE 200,047,091049,Touri; Behrouz,9999,0,9999,0
1653579591611,ECE 200,048,091050,Trivedi; Mohan M.,9999,0,9999,0
1653579591611,ECE 200,049,091051,Vardy; Alexander,9999,0,9999,0
1653579591611,ECE 200,050,091052,Vasconcelos; Nuno,9999,0,9999,0
1653579591611,ECE 200,051,091053,Wang; Xiaolong,9999,0,9999,0
1653579591611,ECE 200,052,091054,Xie; Pengtao,9999,0,9999,0
1653579591611,ECE 200,053,091055,Yip; Michael,9999,0,9999,0
1653579591611,ECE 200,054,091056,Zeger; Kenneth A.,9999,0,9999,0
1653579591611,ECE 200,055,091057,Zhang; Xinyu,9999,0,9999,0
1653579591611,ECE 200,056,091058,Turakhia; Yatish Girish,9999,0,9999,0
1653579591611,ECE 200,057,091059,Kang; Mingu,9999,0,9999,0
1653579591611,ECE 200,058,091060,Shi; Yuanyuan,9999,0,9999,0
1653579591611,ECE 200,059,091061,Wang; Edward Jay,9999,0,9999,0
1653579591611,ECE 200,060,091062,Zheng; Yang,9999,0,9999,0
1653579592135,ECE 201,A00,095526,Lo; Yu-Hwa,0,0,0,0
1653579592659,ECE 203,A00,091065,Mercier; Patrick Philip,0,0,0,0
1653579593183,ECE 207A,A00,091605,Liu; Thomas Tao-Ming,0,0,0,0
1653579593707,ECE 212AN,A00,091068,Nomura; Kenji,0,0,0,0
1653579594228,ECE 222A,A00,091069,Rebeiz; Gabriel,0,0,0,0
1653579594763,ECE 225A,A00,091070,Orlitsky; Alon,0,0,0,0
1653579595288,ECE 230A,A00,091071,Nomura; Kenji,0,0,0,0
1653579595811,ECE 236A,A00,091072,Dayeh; Shadi Ahmad,0,0,0,0
1653579596335,ECE 238A,A00,091073,Luo; Jian,0,0,0,0
1653579596335,ECE 238A,B00,091074,Luo; Jian,0,0,0,0
1653579596857,ECE 240A,A00,091075,Radic; Stojan,0,0,0,0
1653579597387,ECE 247A,A00,091592,Shi; Lingyan,0,0,0,0
1653579597910,ECE 250,A00,091076,Touri; Behrouz,0,0,0,0
1653579598434,ECE 251C,A00,091078,Nguyen; Truong Quang,0,0,0,0
1653579598960,ECE 253,A00,091079,Cosman; Pamela C.,0,0,0,0
1653579599485,ECE 255A,A00,091080,Orlitsky; Alon,0,0,0,0
1653579600009,ECE 257A,A00,091081,Zhang; Xinyu,0,0,0,0
1653579600535,ECE 260A,A01,091084,Eldon; John,0,0,0,0
1653579601064,ECE 264C,A00,091085,Galton; Ian A,0,0,0,0
1653579601588,ECE 265C,A00,094889,Presti; Calogero Davide,0,0,0,9
1653579602114,ECE 266,A01,091087,Hall; Drew A.,0,0,0,0
1653579603167,ECE 271A,A00,091090,Vasconcelos; Nuno,0,0,0,0
1653579603691,ECE 272B,A00,091091,Sworder; David D.,0,0,0,0
1653579604230,ECE 275A,A00,091092,Meyer; Florian,0,0,0,0
1653579604754,ECE 277,A00,091093,An; Cheolhong,0,0,0,0
1653579605283,ECE 283,A00,091094,Le; Hanh-Phuc,0,0,0,0
1653579605819,ECE 284,A00,091095,Kang; Mingu,0,0,0,0
1653579605819,ECE 284,B00,091096,Wang; Edward Jay,0,0,0,0
1653579606344,ECE 285,A00,094334,Touri; Behrouz,0,0,0,0
1653579606871,ECE 289,A00,091097,Whelan; David Arthur,0,0,0,0
1653579607395,MATH 200A,A00,087414,Salehi Golsefidy; Alireza,7,0,8,1
1653579607923,MATH 202A,A00,087415,Gill; Philip E.,2,0,8,6
1653579608448,MATH 203A,A00,087416,Oprea; Dragos N.,6,0,8,2
1653579608976,MATH 204A,A00,087417,Kedlaya; Kiran S.,6,0,8,2
1653579609511,MATH 205,A00,087418,Sorensen; Claus M,6,0,8,2
1653579610039,MATH 206A,A00,087419,Izadi; Elham,7,0,8,1
1653579610564,MATH 207A,A00,087420,Mohammadi; Amir,5,0,8,3
1653579611090,MATH 208,A00,087421,Staff,9,0,10,1
1653579611612,MATH 209,A00,087422,Staff,10,0,10,0
1653579612136,MATH 218,A00,087423,Staff,10,0,10,0
1653579612673,MATH 220A,A00,087424,Novak; Jonathan I,6,0,8,2
1653579613196,MATH 231A,A00,087425,Bejenaru; Ioan,3,0,8,5
1653579613719,MATH 240A,A00,087426,Ebenfelt; Peter F,5,0,8,3
1653579614248,MATH 243,A00,087427,Staff,9,0,10,1
1653579614772,MATH 248,A00,087429,Staff,10,0,10,0
1653579615302,MATH 250A,A00,087430,Spolaor; Luca,4,0,8,4
1653579615833,MATH 257A,A00,087431,Spolaor; Luca,7,0,8,1
1653579616355,MATH 258,A00,087432,Staff,9,0,10,1
1653579616879,MATH 264A,A00,087433,Warnke; Lutz Peter,5,0,8,3
1653579617415,MATH 268,A00,087434,Staff,15,0,15,0
1653579617942,MATH 269,A00,087435,Staff,14,0,15,1
1653579618465,MATH 270A,A00,087436,Nie; Jiawang,0,0,8,8
1653579618991,MATH 272A,A00,087437,Tian; Xiaochuan,1,0,8,7
1653579619518,MATH 274,A01,087439,Cheng; Li-Tien,9,0,10,1
1653579619518,MATH 274,A02,087440,Cheng; Li-Tien,10,0,10,0
1653579620119,MATH 278A,A00,087441,Staff,8,0,10,2
1653579620662,MATH 278B,A00,087442,Staff,8,0,10,2
1653579621187,MATH 278C,A00,087443,Staff,8,0,10,2
1653579621712,MATH 280A,A00,087444,Zheng; Tianyi,0,0,8,8
1653579622234,MATH 281A,A00,087445,Bradic; Jelena,0,0,8,8
1653579622757,MATH 282A,A00,087446,Zhang; Danna,0,0,8,8
1653579623280,MATH 283,A00,087447,Tesler; Glenn,0,0,0,16
1653579623803,MATH 286,B00,095535,Kemp; Todd Aahron,8,0,8,0
1653579624328,MATH 287D,A00,087449,Bradic; Jelena,0,0,0,2
1653579624858,MATH 288,A00,087450,Staff,14,0,15,1
1653579624858,MATH 288,B00,087451,Staff,15,0,15,0
1653579624858,MATH 288,C00,087452,Staff,15,0,15,0
1653579625381,MATH 290A,A00,087453,Xu; Zhouli,6,0,8,2
1653579625908,MATH 291A,A00,087454,Xu; Zhouli,7,0,8,1
1653579626430,MATH 292,A00,087455,Staff,10,0,10,0
1653579627006,MATH 295,A00,087456,Staff,50,0,50,0
1653579627552,MATH 297,001,087457,Staff,998,0,999,1
1653580188806,COGS 200,A01,087991,Staff,47,0,50,3
1653580189333,COGS 201,A01,094504,Rangel; Lara M,17,0,25,8
1653580189858,COGS 203,A00,087992,Coulson; Seana M,18,0,20,2
1653580190381,COGS 210A,001,087993,Greene; Deanna Jacquelyn,9998,0,9999,1
1653580190381,COGS 210A,002,087994,Saygin; Ayse P,9999,0,9999,0
1653580190381,COGS 210A,003,087995,Xia; Haijun,9999,0,9999,0
1653580190381,COGS 210A,004,087996,Nitz; Douglas A.,9999,0,9999,0
1653580190381,COGS 210A,005,087997,Hollan; James D.,9999,0,9999,0
1653580190381,COGS 210A,006,087998,Deak; Gedeon O.,9998,0,9999,1
1653580190381,COGS 210A,007,087999,Rossano; Federico,9999,0,9999,0
1653580190907,COGS 211A,A00,088000,Coulson; Seana M,9997,0,9999,2
1653580191437,COGS 229,A00,088002,Staff,22,0,25,3
1653580191960,COGS 260,B00,094231,Staff,17,0,20,3
1653580191960,COGS 260,A00,088004,Nitz; Douglas A.,9998,0,9999,1
1653580192482,CSE 202,A00,090110,Paturi; Ramamohan,0,0,0,0
1653580192482,CSE 202,B00,090111,Paturi; Ramamohan,0,0,0,0
1653580193008,CSE 207B,A00,090112,Heninger; Nadia A,0,0,0,0
1653580193534,CSE 208,A00,094858,Micciancio; Daniele,0,0,0,0
1653580194059,CSE 210,A00,090113,Powell; Thomas Allan,0,0,0,0
1653580194583,CSE 219,A00,090898,Staff,0,0,0,0
1653580195106,CSE 221,A00,090114,Zhou; Yuan-Yuan,0,0,0,0
1653580195629,CSE 229A,A00,090115,Porter; George M,0,0,0,0
1653580196152,CSE 229C,A00,090116,Savage; Stefan,0,0,0,0
1653580196679,CSE 230,A00,090117,Jhala; Ranjit,0,0,0,0
1653580197204,CSE 232,A00,090118,Papakonstantinou; Yannis,0,0,0,0
1653580197726,CSE 239A,A00,090121,Kumar; Arun Kumar,0,0,0,0
1653580198249,CSE 239B,A00,090122,Jhala; Ranjit,0,0,0,0
1653580198777,CSE 240A,A00,090123,Zhao; Jishen,1,0,189,188
1653580199299,CSE 243A,A00,090124,Orailoglu; Alex,0,0,15,15
1653580199824,CSE 249B,A00,090125,Kahng; Andrew Byun,13,0,20,7
1653580200349,CSE 250A,A00,090126,Berg-Kirkpatrick; Taylor D,0,0,0,0
1653580200872,CSE 252A,A00,090127,Ochoa; Benjamin Lawrence,0,0,0,0
1653580201394,CSE 258,A01,090129,McAuley; Julian John,0,0,0,0
1653580201919,CSE 258R,A01,090131,McAuley; Julian John,0,0,0,0
1653580202449,CSE 274,A00,090132,Ramamoorthi; Ravi,0,0,0,0
1653580202975,CSE 276A,A00,090133,Christensen; Henrik I,0,0,0,0
1653580203505,CSE 276C,A00,090134,Christensen; Henrik I,0,0,0,0
1653580204040,CSE 290,A00,090135,Bafna; Vineet,0,0,0,0
1653580204040,CSE 290,B00,090136,Ramamoorthi; Ravi,0,0,0,0
1653580204040,CSE 290,C00,090137,Li; Tzumao,8,0,10,2
1653580204040,CSE 290,D00,090138,Zhou; Yuan-Yuan,9,0,10,1
1653580204040,CSE 290,E00,090139,Christensen; Henrik I,8,0,10,2
1653580204040,CSE 290,F00,094053,Shalev; Aaron D,0,0,0,0
1653580204570,CSE 291,A00,090140,Munyaka; Imani N. S.,0,0,0,0
1653580204570,CSE 291,B00,094880,Yu; Qi,0,0,0,0
1653580204570,CSE 291,C00,090142,Pannuto; Patrick William,0,0,0,0
1653580204570,CSE 291,D00,094881,Zhang; Yiying,0,0,0,0
1653580204570,CSE 291,E00,095118,Su; Hao,0,0,0,0
1653580205103,CSE 293,001,094905,Bafna; Vineet,9999,0,9999,0
1653580205103,CSE 293,002,094906,Bellare; Mihir,9999,0,9999,0
1653580205103,CSE 293,003,094907,Berg-Kirkpatrick; Taylor D,9999,0,9999,0
1653580205103,CSE 293,004,094908,Christensen; Henrik I,9999,0,9999,0
1653580205103,CSE 293,005,094909,Cottrell; Garrison W,9999,0,9999,0
1653580205103,CSE 293,006,094910,Deutsch; Alin Bernard,9999,0,9999,0
1653580205103,CSE 293,007,094911,Esmaeilzadeh; Hadi,9999,0,9999,0
1653580205103,CSE 293,008,094912,Freund; Yoav,9999,0,9999,0
1653580205103,CSE 293,009,094913,Griswold; William G.,9999,0,9999,0
1653580205103,CSE 293,010,094914,Gymrek; Melissa Ann,9999,0,9999,0
1653580205103,CSE 293,011,094915,Heninger; Nadia A,9999,0,9999,0
1653580205103,CSE 293,012,094916,Impagliazzo; Russell,9999,0,9999,0
1653580205103,CSE 293,013,094917,Jhala; Ranjit,9999,0,9999,0
1653580205103,CSE 293,014,094918,Kahng; Andrew Byun,9999,0,9999,0
1653580205103,CSE 293,015,094919,Kane; Daniel Mertz,9999,0,9999,0
1653580205103,CSE 293,016,094920,Kriegman; David J,9999,0,9999,0
1653580205103,CSE 293,017,094921,Kumar; Arun Kumar,9999,0,9999,0
1653580205103,CSE 293,018,094922,Lerner; Sorin,9999,0,9999,0
1653580205103,CSE 293,019,094923,Lovett; Shachar,9999,0,9999,0
1653580205103,CSE 293,020,094924,McAuley; Julian John,9999,0,9999,0
1653580205103,CSE 293,021,094925,Micciancio; Daniele,9999,0,9999,0
1653580205103,CSE 293,022,094926,Orailoglu; Alex,9999,0,9999,0
1653580205103,CSE 293,023,094927,Paturi; Ramamohan,9999,0,9999,0
1653580205103,CSE 293,024,094928,Polikarpova; Nadezhda,9999,0,9999,0
1653580205103,CSE 293,025,094929,Politz; Joseph Gibbs,9999,0,9999,0
1653580205103,CSE 293,026,094930,Porter; George M,9999,0,9999,0
1653580205103,CSE 293,027,094931,Porter; Leonard Emerson,9999,0,9999,0
1653580205103,CSE 293,028,094932,Ramamoorthi; Ravi,9999,0,9999,0
1653580205103,CSE 293,029,094933,Sahoo; Debashis,9999,0,9999,0
1653580205103,CSE 293,030,094934,Saul; Lawrence,9999,0,9999,0
1653580205103,CSE 293,031,094935,Savage; Stefan,9999,0,9999,0
1653580205103,CSE 293,032,094936,Schulze; Jurgen P.,9999,0,9999,0
1653580205103,CSE 293,033,094937,Snoeren; Alex C.,9999,0,9999,0
1653580205103,CSE 293,034,094938,Shang; Jingbo,9999,0,9999,0
1653580205103,CSE 293,035,094939,Stefan; Deian,9999,0,9999,0
1653580205103,CSE 293,036,094940,Su; Hao,9999,0,9999,0
1653580205103,CSE 293,037,094941,Swanson; Steven James,9999,0,9999,0
1653580205103,CSE 293,038,094942,Tullsen; Dean Michael,9999,0,9999,0
1653580205103,CSE 293,039,094943,Voelker; Geoffrey M.,9999,0,9999,0
1653580205103,CSE 293,040,094944,Zhao; Jishen,9999,0,9999,0
1653580205103,CSE 293,041,094945,Zhou; Yuan-Yuan,9999,0,9999,0
1653580205103,CSE 293,042,094946,Gao; Sicun,9998,0,9999,1
1653580205103,CSE 293,043,094947,Weibel; Nadir,9999,0,9999,0
1653580205103,CSE 293,044,094948,Gupta; Rajesh K.,9999,0,9999,0
1653580205634,CSE 294,A00,090143,Porter; George M,8,0,10,2
1653580206159,DSE 200,A00,091799,Staff,50,0,50,0
1653580206687,DSE 203,A00,091800,Gupta; Amarnath,30,0,30,0
1653580207213,DSE 250,A00,091801,Deutsch; Alin Bernard,30,0,30,0
1653580207738,DSE 290,A00,091802,Altintas De Callaf; Ilkay,50,0,50,0
1653580208273,ECE 200,001,091003,Antipa; Nicholas A,9999,0,9999,0
1653580208273,ECE 200,002,091004,Atanasov; Nikolay A.,9999,0,9999,0
1653580208273,ECE 200,003,091005,Bharadia; Dinesh,9999,0,9999,0
1653580208273,ECE 200,004,091006,Cheng; Chung Kuan,9999,0,9999,0
1653580208273,ECE 200,005,091007,Cosman; Pamela C.,9999,0,9999,0
1653580208273,ECE 200,006,091008,Staff,9999,0,9999,0
1653580208273,ECE 200,007,091009,Dayeh; Shadi Ahmad,9999,0,9999,0
1653580208273,ECE 200,008,091010,Fainman; Yeshaiahu,9999,0,9999,0
1653580208273,ECE 200,009,091011,Ford; Joseph Earl,9999,0,9999,0
1653580208273,ECE 200,010,091012,Franceschetti; Massimo,9999,0,9999,0
1653580208273,ECE 200,011,091013,Fullerton; Eric E,9999,0,9999,0
1653580208273,ECE 200,012,091014,Galton; Ian A,9999,0,9999,0
1653580208273,ECE 200,013,091015,Gilja; Vikash,9999,0,9999,0
1653580208273,ECE 200,014,091016,Hall; Drew A.,9999,0,9999,0
1653580208273,ECE 200,015,091017,Hsueh; Tzu-Chien,9999,0,9999,0
1653580208273,ECE 200,016,091018,Javidi; Tara,9999,0,9999,0
1653580208273,ECE 200,017,091019,Kahng; Andrew Byun,9999,0,9999,0
1653580208273,ECE 200,018,091020,Kim; Young-Han,9999,0,9999,0
1653580208273,ECE 200,019,091021,Koushanfar; Farinaz,9999,0,9999,0
1653580208273,ECE 200,020,091022,Kuzum; Duygu,9999,0,9999,0
1653580208273,ECE 200,021,091023,Le; Hanh-Phuc,9999,0,9999,0
1653580208273,ECE 200,022,091024,Lin; Bill,9999,0,9999,0
1653580208273,ECE 200,023,091025,Liu; Zhaowei,9999,0,9999,0
1653580208273,ECE 200,024,091026,Lo; Yu-Hwa,9999,0,9999,0
1653580208273,ECE 200,025,091027,Lomakin; Vitaliy,9999,0,9999,0
1653580208273,ECE 200,026,091028,Mercier; Patrick Philip,9999,0,9999,0
1653580208273,ECE 200,027,091029,Meyer; Florian,9999,0,9999,0
1653580208273,ECE 200,028,091030,Milstein; Laurence B.,9999,0,9999,0
1653580208273,ECE 200,029,091031,Mir Arabbaygi; Siavash,9999,0,9999,0
1653580208273,ECE 200,030,091032,Mookherjea; Shayan,9999,0,9999,0
1653580208273,ECE 200,031,091033,Morris; Karcher William,9999,0,9999,0
1653580208273,ECE 200,032,091034,Ng; Tse Nga,9999,0,9999,0
1653580208273,ECE 200,033,091035,Nguyen; Truong Quang,9999,0,9999,0
1653580208273,ECE 200,034,091036,Nomura; Kenji,9999,0,9999,0
1653580208273,ECE 200,035,091037,Orlitsky; Alon,9999,0,9999,0
1653580208273,ECE 200,036,091038,Pal; Piya,9999,0,9999,0
1653580208273,ECE 200,037,091039,Papen; George C.,9999,0,9999,0
1653580208273,ECE 200,038,091040,Radic; Stojan,9999,0,9999,0
1653580208273,ECE 200,039,091041,Rao; Bhaskar D.,9999,0,9999,0
1653580208273,ECE 200,040,091042,Rao; Ramesh R,9999,0,9999,0
1653580208273,ECE 200,041,091043,Rebeiz; Gabriel,9999,0,9999,0
1653580208273,ECE 200,042,091044,Sanford; John R,9999,0,9999,0
1653580208273,ECE 200,043,091045,Siegel; Paul H.,9999,0,9999,0
1653580208273,ECE 200,044,091046,Sievenpiper; Daniel F.,9999,0,9999,0
1653580208273,ECE 200,045,091047,Sworder; David D.,9999,0,9999,0
1653580208273,ECE 200,046,091048,Taur; Yuan,9999,0,9999,0
1653580208273,ECE 200,047,091049,Touri; Behrouz,9999,0,9999,0
1653580208273,ECE 200,048,091050,Trivedi; Mohan M.,9999,0,9999,0
1653580208273,ECE 200,049,091051,Vardy; Alexander,9999,0,9999,0
1653580208273,ECE 200,050,091052,Vasconcelos; Nuno,9999,0,9999,0
1653580208273,ECE 200,051,091053,Wang; Xiaolong,9999,0,9999,0
1653580208273,ECE 200,052,091054,Xie; Pengtao,9999,0,9999,0
1653580208273,ECE 200,053,091055,Yip; Michael,9999,0,9999,0
1653580208273,ECE 200,054,091056,Zeger; Kenneth A.,9999,0,9999,0
1653580208273,ECE 200,055,091057,Zhang; Xinyu,9999,0,9999,0
1653580208273,ECE 200,056,091058,Turakhia; Yatish Girish,9999,0,9999,0
1653580208273,ECE 200,057,091059,Kang; Mingu,9999,0,9999,0
1653580208273,ECE 200,058,091060,Shi; Yuanyuan,9999,0,9999,0
1653580208273,ECE 200,059,091061,Wang; Edward Jay,9999,0,9999,0
1653580208273,ECE 200,060,091062,Zheng; Yang,9999,0,9999,0
1653580208873,ECE 201,A00,095526,Lo; Yu-Hwa,0,0,0,0
1653580209408,ECE 203,A00,091065,Mercier; Patrick Philip,0,0,0,0
1653580209932,ECE 207A,A00,091605,Liu; Thomas Tao-Ming,0,0,0,0
1653580210457,ECE 212AN,A00,091068,Nomura; Kenji,0,0,0,0
1653580210990,ECE 222A,A00,091069,Rebeiz; Gabriel,0,0,0,0
1653580211520,ECE 225A,A00,091070,Orlitsky; Alon,0,0,0,0
1653580212044,ECE 230A,A00,091071,Nomura; Kenji,0,0,0,0
1653580212575,ECE 236A,A00,091072,Dayeh; Shadi Ahmad,0,0,0,0
1653580213098,ECE 238A,A00,091073,Luo; Jian,0,0,0,0
1653580213098,ECE 238A,B00,091074,Luo; Jian,0,0,0,0
1653580213621,ECE 240A,A00,091075,Radic; Stojan,0,0,0,0
1653580214147,ECE 247A,A00,091592,Shi; Lingyan,0,0,0,0
1653580214671,ECE 250,A00,091076,Touri; Behrouz,0,0,0,0
1653580215197,ECE 251C,A00,091078,Nguyen; Truong Quang,0,0,0,0
1653580215731,ECE 253,A00,091079,Cosman; Pamela C.,0,0,0,0
1653580216255,ECE 255A,A00,091080,Orlitsky; Alon,0,0,0,0
1653580216781,ECE 257A,A00,091081,Zhang; Xinyu,0,0,0,0
1653580217306,ECE 260A,A01,091084,Eldon; John,0,0,0,0
1653580217829,ECE 264C,A00,091085,Galton; Ian A,0,0,0,0
1653580218366,ECE 265C,A00,094889,Presti; Calogero Davide,0,0,0,9
1653580218889,ECE 266,A01,091087,Hall; Drew A.,0,0,0,0
1653580219934,ECE 271A,A00,091090,Vasconcelos; Nuno,0,0,0,0
1653580220461,ECE 272B,A00,091091,Sworder; David D.,0,0,0,0
1653580220990,ECE 275A,A00,091092,Meyer; Florian,0,0,0,0
1653580221527,ECE 277,A00,091093,An; Cheolhong,0,0,0,0
1653580222054,ECE 283,A00,091094,Le; Hanh-Phuc,0,0,0,0
1653580222576,ECE 284,A00,091095,Kang; Mingu,0,0,0,0
1653580222576,ECE 284,B00,091096,Wang; Edward Jay,0,0,0,0
1653580223113,ECE 285,A00,094334,Touri; Behrouz,0,0,0,0
1653580223638,ECE 289,A00,091097,Whelan; David Arthur,0,0,0,0
1653580224166,MATH 200A,A00,087414,Salehi Golsefidy; Alireza,7,0,8,1
1653580224688,MATH 202A,A00,087415,Gill; Philip E.,2,0,8,6
1653580225214,MATH 203A,A00,087416,Oprea; Dragos N.,6,0,8,2
1653580225736,MATH 204A,A00,087417,Kedlaya; Kiran S.,6,0,8,2
1653580226262,MATH 205,A00,087418,Sorensen; Claus M,6,0,8,2
1653580226787,MATH 206A,A00,087419,Izadi; Elham,7,0,8,1
1653580227317,MATH 207A,A00,087420,Mohammadi; Amir,5,0,8,3
1653580227841,MATH 208,A00,087421,Staff,9,0,10,1
1653580228364,MATH 209,A00,087422,Staff,10,0,10,0
1653580228891,MATH 218,A00,087423,Staff,10,0,10,0
1653580229420,MATH 220A,A00,087424,Novak; Jonathan I,6,0,8,2
1653580229941,MATH 231A,A00,087425,Bejenaru; Ioan,3,0,8,5
1653580230465,MATH 240A,A00,087426,Ebenfelt; Peter F,5,0,8,3
1653580230988,MATH 243,A00,087427,Staff,9,0,10,1
1653580231513,MATH 248,A00,087429,Staff,10,0,10,0
1653580232036,MATH 250A,A00,087430,Spolaor; Luca,4,0,8,4
1653580232564,MATH 257A,A00,087431,Spolaor; Luca,7,0,8,1
1653580233086,MATH 258,A00,087432,Staff,9,0,10,1
1653580233607,MATH 264A,A00,087433,Warnke; Lutz Peter,5,0,8,3
1653580234130,MATH 268,A00,087434,Staff,15,0,15,0
1653580234655,MATH 269,A00,087435,Staff,14,0,15,1
1653580235178,MATH 270A,A00,087436,Nie; Jiawang,0,0,8,8
1653580235704,MATH 272A,A00,087437,Tian; Xiaochuan,1,0,8,7
1653580236227,MATH 274,A01,087439,Cheng; Li-Tien,9,0,10,1
1653580236227,MATH 274,A02,087440,Cheng; Li-Tien,10,0,10,0
1653580236749,MATH 278A,A00,087441,Staff,8,0,10,2
1653580237274,MATH 278B,A00,087442,Staff,8,0,10,2
1653580237796,MATH 278C,A00,087443,Staff,8,0,10,2
1653580238322,MATH 280A,A00,087444,Zheng; Tianyi,0,0,8,8
1653580238850,MATH 281A,A00,087445,Bradic; Jelena,0,0,8,8
1653580239372,MATH 282A,A00,087446,Zhang; Danna,0,0,8,8
1653580239895,MATH 283,A00,087447,Tesler; Glenn,0,0,0,16
1653580240417,MATH 286,B00,095535,Kemp; Todd Aahron,8,0,8,0
1653580240939,MATH 287D,A00,087449,Bradic; Jelena,0,0,0,2
1653580241463,MATH 288,A00,087450,Staff,14,0,15,1
1653580241463,MATH 288,B00,087451,Staff,15,0,15,0
1653580241463,MATH 288,C00,087452,Staff,15,0,15,0
1653580241986,MATH 290A,A00,087453,Xu; Zhouli,6,0,8,2
1653580242512,MATH 291A,A00,087454,Xu; Zhouli,7,0,8,1
1653580243053,MATH 292,A00,087455,Staff,10,0,10,0
1653580243578,MATH 295,A00,087456,Staff,50,0,50,0
1653580244100,MATH 297,001,087457,Staff,998,0,999,1
1653580804442,COGS 200,A01,087991,Staff,47,0,50,3
1653580804970,COGS 201,A01,094504,Rangel; Lara M,17,0,25,8
1653580805494,COGS 203,A00,087992,Coulson; Seana M,18,0,20,2
1653580806024,COGS 210A,001,087993,Greene; Deanna Jacquelyn,9998,0,9999,1
1653580806024,COGS 210A,002,087994,Saygin; Ayse P,9999,0,9999,0
1653580806024,COGS 210A,003,087995,Xia; Haijun,9999,0,9999,0
1653580806024,COGS 210A,004,087996,Nitz; Douglas A.,9999,0,9999,0
1653580806024,COGS 210A,005,087997,Hollan; James D.,9999,0,9999,0
1653580806024,COGS 210A,006,087998,Deak; Gedeon O.,9998,0,9999,1
1653580806024,COGS 210A,007,087999,Rossano; Federico,9999,0,9999,0
1653580806550,COGS 211A,A00,088000,Coulson; Seana M,9997,0,9999,2
1653580807086,COGS 229,A00,088002,Staff,22,0,25,3
1653580807613,COGS 260,B00,094231,Staff,17,0,20,3
1653580807613,COGS 260,A00,088004,Nitz; Douglas A.,9998,0,9999,1
1653580808140,CSE 202,A00,090110,Paturi; Ramamohan,0,0,0,0
1653580808140,CSE 202,B00,090111,Paturi; Ramamohan,0,0,0,0
1653580808663,CSE 207B,A00,090112,Heninger; Nadia A,0,0,0,0
1653580809188,CSE 208,A00,094858,Micciancio; Daniele,0,0,0,0
1653580809719,CSE 210,A00,090113,Powell; Thomas Allan,0,0,0,0
1653580810251,CSE 219,A00,090898,Staff,0,0,0,0
1653580810777,CSE 221,A00,090114,Zhou; Yuan-Yuan,0,0,0,0
1653580811307,CSE 229A,A00,090115,Porter; George M,0,0,0,0
1653580811832,CSE 229C,A00,090116,Savage; Stefan,0,0,0,0
1653580812358,CSE 230,A00,090117,Jhala; Ranjit,0,0,0,0
1653580812882,CSE 232,A00,090118,Papakonstantinou; Yannis,0,0,0,0
1653580813415,CSE 239A,A00,090121,Kumar; Arun Kumar,0,0,0,0
1653580813941,CSE 239B,A00,090122,Jhala; Ranjit,0,0,0,0
1653580814466,CSE 240A,A00,090123,Zhao; Jishen,1,0,189,188
1653580814991,CSE 243A,A00,090124,Orailoglu; Alex,0,0,15,15
1653580815521,CSE 249B,A00,090125,Kahng; Andrew Byun,13,0,20,7
1653580816044,CSE 250A,A00,090126,Berg-Kirkpatrick; Taylor D,0,0,0,0
1653580816571,CSE 252A,A00,090127,Ochoa; Benjamin Lawrence,0,0,0,0
1653580817096,CSE 258,A01,090129,McAuley; Julian John,0,0,0,0
1653580817621,CSE 258R,A01,090131,McAuley; Julian John,0,0,0,0
1653580818150,CSE 274,A00,090132,Ramamoorthi; Ravi,0,0,0,0
1653580818680,CSE 276A,A00,090133,Christensen; Henrik I,0,0,0,0
1653580819205,CSE 276C,A00,090134,Christensen; Henrik I,0,0,0,0
1653580819736,CSE 290,A00,090135,Bafna; Vineet,0,0,0,0
1653580819736,CSE 290,B00,090136,Ramamoorthi; Ravi,0,0,0,0
1653580819736,CSE 290,C00,090137,Li; Tzumao,8,0,10,2
1653580819736,CSE 290,D00,090138,Zhou; Yuan-Yuan,9,0,10,1
1653580819736,CSE 290,E00,090139,Christensen; Henrik I,8,0,10,2
1653580819736,CSE 290,F00,094053,Shalev; Aaron D,0,0,0,0
1653580820267,CSE 291,A00,090140,Munyaka; Imani N. S.,0,0,0,0
1653580820267,CSE 291,B00,094880,Yu; Qi,0,0,0,0
1653580820267,CSE 291,C00,090142,Pannuto; Patrick William,0,0,0,0
1653580820267,CSE 291,D00,094881,Zhang; Yiying,0,0,0,0
1653580820267,CSE 291,E00,095118,Su; Hao,0,0,0,0
1653580820792,CSE 293,001,094905,Bafna; Vineet,9999,0,9999,0
1653580820792,CSE 293,002,094906,Bellare; Mihir,9999,0,9999,0
1653580820792,CSE 293,003,094907,Berg-Kirkpatrick; Taylor D,9999,0,9999,0
1653580820792,CSE 293,004,094908,Christensen; Henrik I,9999,0,9999,0
1653580820792,CSE 293,005,094909,Cottrell; Garrison W,9999,0,9999,0
1653580820792,CSE 293,006,094910,Deutsch; Alin Bernard,9999,0,9999,0
1653580820792,CSE 293,007,094911,Esmaeilzadeh; Hadi,9999,0,9999,0
1653580820792,CSE 293,008,094912,Freund; Yoav,9999,0,9999,0
1653580820792,CSE 293,009,094913,Griswold; William G.,9999,0,9999,0
1653580820792,CSE 293,010,094914,Gymrek; Melissa Ann,9999,0,9999,0
1653580820792,CSE 293,011,094915,Heninger; Nadia A,9999,0,9999,0
1653580820792,CSE 293,012,094916,Impagliazzo; Russell,9999,0,9999,0
1653580820792,CSE 293,013,094917,Jhala; Ranjit,9999,0,9999,0
1653580820792,CSE 293,014,094918,Kahng; Andrew Byun,9999,0,9999,0
1653580820792,CSE 293,015,094919,Kane; Daniel Mertz,9999,0,9999,0
1653580820792,CSE 293,016,094920,Kriegman; David J,9999,0,9999,0
1653580820792,CSE 293,017,094921,Kumar; Arun Kumar,9999,0,9999,0
1653580820792,CSE 293,018,094922,Lerner; Sorin,9999,0,9999,0
1653580820792,CSE 293,019,094923,Lovett; Shachar,9999,0,9999,0
1653580820792,CSE 293,020,094924,McAuley; Julian John,9999,0,9999,0
1653580820792,CSE 293,021,094925,Micciancio; Daniele,9999,0,9999,0
1653580820792,CSE 293,022,094926,Orailoglu; Alex,9999,0,9999,0
1653580820792,CSE 293,023,094927,Paturi; Ramamohan,9999,0,9999,0
1653580820792,CSE 293,024,094928,Polikarpova; Nadezhda,9999,0,9999,0
1653580820792,CSE 293,025,094929,Politz; Joseph Gibbs,9999,0,9999,0
1653580820792,CSE 293,026,094930,Porter; George M,9999,0,9999,0
1653580820792,CSE 293,027,094931,Porter; Leonard Emerson,9999,0,9999,0
1653580820792,CSE 293,028,094932,Ramamoorthi; Ravi,9999,0,9999,0
1653580820792,CSE 293,029,094933,Sahoo; Debashis,9999,0,9999,0
1653580820792,CSE 293,030,094934,Saul; Lawrence,9999,0,9999,0
1653580820792,CSE 293,031,094935,Savage; Stefan,9999,0,9999,0
1653580820792,CSE 293,032,094936,Schulze; Jurgen P.,9999,0,9999,0
1653580820792,CSE 293,033,094937,Snoeren; Alex C.,9999,0,9999,0
1653580820792,CSE 293,034,094938,Shang; Jingbo,9999,0,9999,0
1653580820792,CSE 293,035,094939,Stefan; Deian,9999,0,9999,0
1653580820792,CSE 293,036,094940,Su; Hao,9999,0,9999,0
1653580820792,CSE 293,037,094941,Swanson; Steven James,9999,0,9999,0
1653580820792,CSE 293,038,094942,Tullsen; Dean Michael,9999,0,9999,0
1653580820792,CSE 293,039,094943,Voelker; Geoffrey M.,9999,0,9999,0
1653580820792,CSE 293,040,094944,Zhao; Jishen,9999,0,9999,0
1653580820792,CSE 293,041,094945,Zhou; Yuan-Yuan,9999,0,9999,0
1653580820792,CSE 293,042,094946,Gao; Sicun,9998,0,9999,1
1653580820792,CSE 293,043,094947,Weibel; Nadir,9999,0,9999,0
1653580820792,CSE 293,044,094948,Gupta; Rajesh K.,9999,0,9999,0
1653580821314,CSE 294,A00,090143,Porter; George M,8,0,10,2
1653580821844,DSE 200,A00,091799,Staff,50,0,50,0
1653580822367,DSE 203,A00,091800,Gupta; Amarnath,30,0,30,0
1653580822893,DSE 250,A00,091801,Deutsch; Alin Bernard,30,0,30,0
1653580823417,DSE 290,A00,091802,Altintas De Callaf; Ilkay,50,0,50,0
1653580823963,ECE 200,001,091003,Antipa; Nicholas A,9999,0,9999,0
1653580823963,ECE 200,002,091004,Atanasov; Nikolay A.,9999,0,9999,0
1653580823963,ECE 200,003,091005,Bharadia; Dinesh,9999,0,9999,0
1653580823963,ECE 200,004,091006,Cheng; Chung Kuan,9999,0,9999,0
1653580823963,ECE 200,005,091007,Cosman; Pamela C.,9999,0,9999,0
1653580823963,ECE 200,006,091008,Staff,9999,0,9999,0
1653580823963,ECE 200,007,091009,Dayeh; Shadi Ahmad,9999,0,9999,0
1653580823963,ECE 200,008,091010,Fainman; Yeshaiahu,9999,0,9999,0
1653580823963,ECE 200,009,091011,Ford; Joseph Earl,9999,0,9999,0
1653580823963,ECE 200,010,091012,Franceschetti; Massimo,9999,0,9999,0
1653580823963,ECE 200,011,091013,Fullerton; Eric E,9999,0,9999,0
1653580823963,ECE 200,012,091014,Galton; Ian A,9999,0,9999,0
1653580823963,ECE 200,013,091015,Gilja; Vikash,9999,0,9999,0
1653580823963,ECE 200,014,091016,Hall; Drew A.,9999,0,9999,0
1653580823963,ECE 200,015,091017,Hsueh; Tzu-Chien,9999,0,9999,0
1653580823963,ECE 200,016,091018,Javidi; Tara,9999,0,9999,0
1653580823963,ECE 200,017,091019,Kahng; Andrew Byun,9999,0,9999,0
1653580823963,ECE 200,018,091020,Kim; Young-Han,9999,0,9999,0
1653580823963,ECE 200,019,091021,Koushanfar; Farinaz,9999,0,9999,0
1653580823963,ECE 200,020,091022,Kuzum; Duygu,9999,0,9999,0
1653580823963,ECE 200,021,091023,Le; Hanh-Phuc,9999,0,9999,0
1653580823963,ECE 200,022,091024,Lin; Bill,9999,0,9999,0
1653580823963,ECE 200,023,091025,Liu; Zhaowei,9999,0,9999,0
1653580823963,ECE 200,024,091026,Lo; Yu-Hwa,9999,0,9999,0
1653580823963,ECE 200,025,091027,Lomakin; Vitaliy,9999,0,9999,0
1653580823963,ECE 200,026,091028,Mercier; Patrick Philip,9999,0,9999,0
1653580823963,ECE 200,027,091029,Meyer; Florian,9999,0,9999,0
1653580823963,ECE 200,028,091030,Milstein; Laurence B.,9999,0,9999,0
1653580823963,ECE 200,029,091031,Mir Arabbaygi; Siavash,9999,0,9999,0
1653580823963,ECE 200,030,091032,Mookherjea; Shayan,9999,0,9999,0
1653580823963,ECE 200,031,091033,Morris; Karcher William,9999,0,9999,0
1653580823963,ECE 200,032,091034,Ng; Tse Nga,9999,0,9999,0
1653580823963,ECE 200,033,091035,Nguyen; Truong Quang,9999,0,9999,0
1653580823963,ECE 200,034,091036,Nomura; Kenji,9999,0,9999,0
1653580823963,ECE 200,035,091037,Orlitsky; Alon,9999,0,9999,0
1653580823963,ECE 200,036,091038,Pal; Piya,9999,0,9999,0
1653580823963,ECE 200,037,091039,Papen; George C.,9999,0,9999,0
1653580823963,ECE 200,038,091040,Radic; Stojan,9999,0,9999,0
1653580823963,ECE 200,039,091041,Rao; Bhaskar D.,9999,0,9999,0
1653580823963,ECE 200,040,091042,Rao; Ramesh R,9999,0,9999,0
1653580823963,ECE 200,041,091043,Rebeiz; Gabriel,9999,0,9999,0
1653580823963,ECE 200,042,091044,Sanford; John R,9999,0,9999,0
1653580823963,ECE 200,043,091045,Siegel; Paul H.,9999,0,9999,0
1653580823963,ECE 200,044,091046,Sievenpiper; Daniel F.,9999,0,9999,0
1653580823963,ECE 200,045,091047,Sworder; David D.,9999,0,9999,0
1653580823963,ECE 200,046,091048,Taur; Yuan,9999,0,9999,0
1653580823963,ECE 200,047,091049,Touri; Behrouz,9999,0,9999,0
1653580823963,ECE 200,048,091050,Trivedi; Mohan M.,9999,0,9999,0
1653580823963,ECE 200,049,091051,Vardy; Alexander,9999,0,9999,0
1653580823963,ECE 200,050,091052,Vasconcelos; Nuno,9999,0,9999,0
1653580823963,ECE 200,051,091053,Wang; Xiaolong,9999,0,9999,0
1653580823963,ECE 200,052,091054,Xie; Pengtao,9999,0,9999,0
1653580823963,ECE 200,053,091055,Yip; Michael,9999,0,9999,0
1653580823963,ECE 200,054,091056,Zeger; Kenneth A.,9999,0,9999,0
1653580823963,ECE 200,055,091057,Zhang; Xinyu,9999,0,9999,0
1653580823963,ECE 200,056,091058,Turakhia; Yatish Girish,9999,0,9999,0
1653580823963,ECE 200,057,091059,Kang; Mingu,9999,0,9999,0
1653580823963,ECE 200,058,091060,Shi; Yuanyuan,9999,0,9999,0
1653580823963,ECE 200,059,091061,Wang; Edward Jay,9999,0,9999,0
1653580823963,ECE 200,060,091062,Zheng; Yang,9999,0,9999,0
1653580824491,ECE 201,A00,095526,Lo; Yu-Hwa,0,0,0,0
1653580825013,ECE 203,A00,091065,Mercier; Patrick Philip,0,0,0,0
1653580825536,ECE 207A,A00,091605,Liu; Thomas Tao-Ming,0,0,0,0
1653580826072,ECE 212AN,A00,091068,Nomura; Kenji,0,0,0,0
1653580826595,ECE 222A,A00,091069,Rebeiz; Gabriel,0,0,0,0
1653580827118,ECE 225A,A00,091070,Orlitsky; Alon,0,0,0,0
1653580827640,ECE 230A,A00,091071,Nomura; Kenji,0,0,0,0
1653580828165,ECE 236A,A00,091072,Dayeh; Shadi Ahmad,0,0,0,0
1653580828694,ECE 238A,A00,091073,Luo; Jian,0,0,0,0
1653580828694,ECE 238A,B00,091074,Luo; Jian,0,0,0,0
1653580829215,ECE 240A,A00,091075,Radic; Stojan,0,0,0,0
1653580829740,ECE 247A,A00,091592,Shi; Lingyan,0,0,0,0
1653580830264,ECE 250,A00,091076,Touri; Behrouz,0,0,0,0
1653580830797,ECE 251C,A00,091078,Nguyen; Truong Quang,0,0,0,0
1653580831324,ECE 253,A00,091079,Cosman; Pamela C.,0,0,0,0
1653580831860,ECE 255A,A00,091080,Orlitsky; Alon,0,0,0,0
1653580832383,ECE 257A,A00,091081,Zhang; Xinyu,0,0,0,0
1653580832909,ECE 260A,A01,091084,Eldon; John,0,0,0,0
1653580833439,ECE 264C,A00,091085,Galton; Ian A,0,0,0,0
1653580833965,ECE 265C,A00,094889,Presti; Calogero Davide,0,0,0,9
1653580834488,ECE 266,A01,091087,Hall; Drew A.,0,0,0,0
1653580835535,ECE 271A,A00,091090,Vasconcelos; Nuno,0,0,0,0
1653580836062,ECE 272B,A00,091091,Sworder; David D.,0,0,0,0
1653580836595,ECE 275A,A00,091092,Meyer; Florian,0,0,0,0
1653580837117,ECE 277,A00,091093,An; Cheolhong,0,0,0,0
1653580837640,ECE 283,A00,091094,Le; Hanh-Phuc,0,0,0,0
1653580838173,ECE 284,A00,091095,Kang; Mingu,0,0,0,0
1653580838173,ECE 284,B00,091096,Wang; Edward Jay,0,0,0,0
1653580838696,ECE 285,A00,094334,Touri; Behrouz,0,0,0,0
1653580839220,ECE 289,A00,091097,Whelan; David Arthur,0,0,0,0
1653580839747,MATH 200A,A00,087414,Salehi Golsefidy; Alireza,7,0,8,1
1653580840272,MATH 202A,A00,087415,Gill; Philip E.,2,0,8,6
1653580840799,MATH 203A,A00,087416,Oprea; Dragos N.,6,0,8,2
1653580841330,MATH 204A,A00,087417,Kedlaya; Kiran S.,6,0,8,2
1653580841856,MATH 205,A00,087418,Sorensen; Claus M,6,0,8,2
1653580842381,MATH 206A,A00,087419,Izadi; Elham,7,0,8,1
1653580842920,MATH 207A,A00,087420,Mohammadi; Amir,5,0,8,3
1653580843448,MATH 208,A00,087421,Staff,9,0,10,1
1653580843970,MATH 209,A00,087422,Staff,10,0,10,0
1653580844495,MATH 218,A00,087423,Staff,10,0,10,0
1653580845022,MATH 220A,A00,087424,Novak; Jonathan I,6,0,8,2
1653580845551,MATH 231A,A00,087425,Bejenaru; Ioan,3,0,8,5
1653580846076,MATH 240A,A00,087426,Ebenfelt; Peter F,5,0,8,3
1653580846601,MATH 243,A00,087427,Staff,9,0,10,1
1653580847122,MATH 248,A00,087429,Staff,10,0,10,0
1653580847649,MATH 250A,A00,087430,Spolaor; Luca,4,0,8,4
1653580848173,MATH 257A,A00,087431,Spolaor; Luca,7,0,8,1
1653580848696,MATH 258,A00,087432,Staff,9,0,10,1
1653580849221,MATH 264A,A00,087433,Warnke; Lutz Peter,5,0,8,3
1653580849840,MATH 268,A00,087434,Staff,15,0,15,0
1653580850365,MATH 269,A00,087435,Staff,14,0,15,1
1653580850890,MATH 270A,A00,087436,Nie; Jiawang,0,0,8,8
1653580851417,MATH 272A,A00,087437,Tian; Xiaochuan,1,0,8,7
1653580851939,MATH 274,A01,087439,Cheng; Li-Tien,9,0,10,1
1653580851939,MATH 274,A02,087440,Cheng; Li-Tien,10,0,10,0
1653580852462,MATH 278A,A00,087441,Staff,8,0,10,2
1653580852987,MATH 278B,A00,087442,Staff,8,0,10,2
1653580853510,MATH 278C,A00,087443,Staff,8,0,10,2
1653580854044,MATH 280A,A00,087444,Zheng; Tianyi,0,0,8,8
1653580854574,MATH 281A,A00,087445,Bradic; Jelena,0,0,8,8
1653580855107,MATH 282A,A00,087446,Zhang; Danna,0,0,8,8
1653580855633,MATH 283,A00,087447,Tesler; Glenn,0,0,0,16
1653580856156,MATH 286,B00,095535,Kemp; Todd Aahron,8,0,8,0
1653580856698,MATH 287D,A00,087449,Bradic; Jelena,0,0,0,2
1653580857223,MATH 288,A00,087450,Staff,14,0,15,1
1653580857223,MATH 288,B00,087451,Staff,15,0,15,0
1653580857223,MATH 288,C00,087452,Staff,15,0,15,0
1653580857752,MATH 290A,A00,087453,Xu; Zhouli,6,0,8,2
1653580858276,MATH 291A,A00,087454,Xu; Zhouli,7,0,8,1
1653580858802,MATH 292,A00,087455,Staff,10,0,10,0
1653580859341,MATH 295,A00,087456,Staff,50,0,50,0
1653580859863,MATH 297,001,087457,Staff,998,0,999,1
1653581420618,COGS 200,A01,087991,Staff,47,0,50,3
1653581421144,COGS 201,A01,094504,Rangel; Lara M,17,0,25,8
1653581421667,COGS 203,A00,087992,Coulson; Seana M,18,0,20,2
1653581422193,COGS 210A,001,087993,Greene; Deanna Jacquelyn,9998,0,9999,1
1653581422193,COGS 210A,002,087994,Saygin; Ayse P,9999,0,9999,0
1653581422193,COGS 210A,003,087995,Xia; Haijun,9999,0,9999,0
1653581422193,COGS 210A,004,087996,Nitz; Douglas A.,9999,0,9999,0
1653581422193,COGS 210A,005,087997,Hollan; James D.,9999,0,9999,0
1653581422193,COGS 210A,006,087998,Deak; Gedeon O.,9998,0,9999,1
1653581422193,COGS 210A,007,087999,Rossano; Federico,9999,0,9999,0
1653581422715,COGS 211A,A00,088000,Coulson; Seana M,9997,0,9999,2
1653581423242,COGS 229,A00,088002,Staff,22,0,25,3
1653581423779,COGS 260,B00,094231,Staff,17,0,20,3
1653581423779,COGS 260,A00,088004,Nitz; Douglas A.,9998,0,9999,1
1653581424305,CSE 202,A00,090110,Paturi; Ramamohan,0,0,0,0
1653581424305,CSE 202,B00,090111,Paturi; Ramamohan,0,0,0,0
1653581424836,CSE 207B,A00,090112,Heninger; Nadia A,0,0,0,0
1653581425360,CSE 208,A00,094858,Micciancio; Daniele,0,0,0,0
1653581425884,CSE 210,A00,090113,Powell; Thomas Allan,0,0,0,0
1653581426413,CSE 219,A00,090898,Staff,0,0,0,0
1653581426939,CSE 221,A00,090114,Zhou; Yuan-Yuan,0,0,0,0
1653581427466,CSE 229A,A00,090115,Porter; George M,0,0,0,0
1653581427988,CSE 229C,A00,090116,Savage; Stefan,0,0,0,0
1653581428522,CSE 230,A00,090117,Jhala; Ranjit,0,0,0,0
1653581429060,CSE 232,A00,090118,Papakonstantinou; Yannis,0,0,0,0
1653581429583,CSE 239A,A00,090121,Kumar; Arun Kumar,0,0,0,0
1653581430108,CSE 239B,A00,090122,Jhala; Ranjit,0,0,0,0
1653581430633,CSE 240A,A00,090123,Zhao; Jishen,1,0,189,188
1653581431156,CSE 243A,A00,090124,Orailoglu; Alex,0,0,15,15
1653581431680,CSE 249B,A00,090125,Kahng; Andrew Byun,13,0,20,7
1653581432213,CSE 250A,A00,090126,Berg-Kirkpatrick; Taylor D,0,0,0,0
1653581432745,CSE 252A,A00,090127,Ochoa; Benjamin Lawrence,0,0,0,0
1653581433289,CSE 258,A01,090129,McAuley; Julian John,0,0,0,0
1653581433812,CSE 258R,A01,090131,McAuley; Julian John,0,0,0,0
1653581434336,CSE 274,A00,090132,Ramamoorthi; Ravi,0,0,0,0
1653581434862,CSE 276A,A00,090133,Christensen; Henrik I,0,0,0,0
1653581435392,CSE 276C,A00,090134,Christensen; Henrik I,0,0,0,0
1653581435915,CSE 290,A00,090135,Bafna; Vineet,0,0,0,0
1653581435915,CSE 290,B00,090136,Ramamoorthi; Ravi,0,0,0,0
1653581435915,CSE 290,C00,090137,Li; Tzumao,8,0,10,2
1653581435915,CSE 290,D00,090138,Zhou; Yuan-Yuan,9,0,10,1
1653581435915,CSE 290,E00,090139,Christensen; Henrik I,8,0,10,2
1653581435915,CSE 290,F00,094053,Shalev; Aaron D,0,0,0,0
1653581436445,CSE 291,A00,090140,Munyaka; Imani N. S.,0,0,0,0
1653581436445,CSE 291,B00,094880,Yu; Qi,0,0,0,0
1653581436445,CSE 291,C00,090142,Pannuto; Patrick William,0,0,0,0
1653581436445,CSE 291,D00,094881,Zhang; Yiying,0,0,0,0
1653581436445,CSE 291,E00,095118,Su; Hao,0,0,0,0
1653581437001,CSE 293,001,094905,Bafna; Vineet,9999,0,9999,0
1653581437001,CSE 293,002,094906,Bellare; Mihir,9999,0,9999,0
1653581437001,CSE 293,003,094907,Berg-Kirkpatrick; Taylor D,9999,0,9999,0
1653581437001,CSE 293,004,094908,Christensen; Henrik I,9999,0,9999,0
1653581437001,CSE 293,005,094909,Cottrell; Garrison W,9999,0,9999,0
1653581437001,CSE 293,006,094910,Deutsch; Alin Bernard,9999,0,9999,0
1653581437001,CSE 293,007,094911,Esmaeilzadeh; Hadi,9999,0,9999,0
1653581437001,CSE 293,008,094912,Freund; Yoav,9999,0,9999,0
1653581437001,CSE 293,009,094913,Griswold; William G.,9999,0,9999,0
1653581437001,CSE 293,010,094914,Gymrek; Melissa Ann,9999,0,9999,0
1653581437001,CSE 293,011,094915,Heninger; Nadia A,9999,0,9999,0
1653581437001,CSE 293,012,094916,Impagliazzo; Russell,9999,0,9999,0
1653581437001,CSE 293,013,094917,Jhala; Ranjit,9999,0,9999,0
1653581437001,CSE 293,014,094918,Kahng; Andrew Byun,9999,0,9999,0
1653581437001,CSE 293,015,094919,Kane; Daniel Mertz,9999,0,9999,0
1653581437001,CSE 293,016,094920,Kriegman; David J,9999,0,9999,0
1653581437001,CSE 293,017,094921,Kumar; Arun Kumar,9999,0,9999,0
1653581437001,CSE 293,018,094922,Lerner; Sorin,9999,0,9999,0
1653581437001,CSE 293,019,094923,Lovett; Shachar,9999,0,9999,0
1653581437001,CSE 293,020,094924,McAuley; Julian John,9999,0,9999,0
1653581437001,CSE 293,021,094925,Micciancio; Daniele,9999,0,9999,0
1653581437001,CSE 293,022,094926,Orailoglu; Alex,9999,0,9999,0
1653581437001,CSE 293,023,094927,Paturi; Ramamohan,9999,0,9999,0
1653581437001,CSE 293,024,094928,Polikarpova; Nadezhda,9999,0,9999,0
1653581437001,CSE 293,025,094929,Politz; Joseph Gibbs,9999,0,9999,0
1653581437001,CSE 293,026,094930,Porter; George M,9999,0,9999,0
1653581437001,CSE 293,027,094931,Porter; Leonard Emerson,9999,0,9999,0
1653581437001,CSE 293,028,094932,Ramamoorthi; Ravi,9999,0,9999,0
1653581437001,CSE 293,029,094933,Sahoo; Debashis,9999,0,9999,0
1653581437001,CSE 293,030,094934,Saul; Lawrence,9999,0,9999,0
1653581437001,CSE 293,031,094935,Savage; Stefan,9999,0,9999,0
1653581437001,CSE 293,032,094936,Schulze; Jurgen P.,9999,0,9999,0
1653581437001,CSE 293,033,094937,Snoeren; Alex C.,9999,0,9999,0
1653581437001,CSE 293,034,094938,Shang; Jingbo,9999,0,9999,0
1653581437001,CSE 293,035,094939,Stefan; Deian,9999,0,9999,0
1653581437001,CSE 293,036,094940,Su; Hao,9999,0,9999,0
1653581437001,CSE 293,037,094941,Swanson; Steven James,9999,0,9999,0
1653581437001,CSE 293,038,094942,Tullsen; Dean Michael,9999,0,9999,0
1653581437001,CSE 293,039,094943,Voelker; Geoffrey M.,9999,0,9999,0
1653581437001,CSE 293,040,094944,Zhao; Jishen,9999,0,9999,0
1653581437001,CSE 293,041,094945,Zhou; Yuan-Yuan,9999,0,9999,0
1653581437001,CSE 293,042,094946,Gao; Sicun,9998,0,9999,1
1653581437001,CSE 293,043,094947,Weibel; Nadir,9999,0,9999,0
1653581437001,CSE 293,044,094948,Gupta; Rajesh K.,9999,0,9999,0
1653581437533,CSE 294,A00,090143,Porter; George M,8,0,10,2
1653581438128,DSE 200,A00,091799,Staff,50,0,50,0
1653581438649,DSE 203,A00,091800,Gupta; Amarnath,30,0,30,0
1653581439195,DSE 250,A00,091801,Deutsch; Alin Bernard,30,0,30,0
1653581439718,DSE 290,A00,091802,Altintas De Callaf; Ilkay,50,0,50,0
1653581440262,ECE 200,001,091003,Antipa; Nicholas A,9999,0,9999,0
1653581440262,ECE 200,002,091004,Atanasov; Nikolay A.,9999,0,9999,0
1653581440262,ECE 200,003,091005,Bharadia; Dinesh,9999,0,9999,0
1653581440262,ECE 200,004,091006,Cheng; Chung Kuan,9999,0,9999,0
1653581440262,ECE 200,005,091007,Cosman; Pamela C.,9999,0,9999,0
1653581440262,ECE 200,006,091008,Staff,9999,0,9999,0
1653581440262,ECE 200,007,091009,Dayeh; Shadi Ahmad,9999,0,9999,0
1653581440262,ECE 200,008,091010,Fainman; Yeshaiahu,9999,0,9999,0
1653581440262,ECE 200,009,091011,Ford; Joseph Earl,9999,0,9999,0
1653581440262,ECE 200,010,091012,Franceschetti; Massimo,9999,0,9999,0
1653581440262,ECE 200,011,091013,Fullerton; Eric E,9999,0,9999,0
1653581440262,ECE 200,012,091014,Galton; Ian A,9999,0,9999,0
1653581440262,ECE 200,013,091015,Gilja; Vikash,9999,0,9999,0
1653581440262,ECE 200,014,091016,Hall; Drew A.,9999,0,9999,0
1653581440262,ECE 200,015,091017,Hsueh; Tzu-Chien,9999,0,9999,0
1653581440262,ECE 200,016,091018,Javidi; Tara,9999,0,9999,0
1653581440262,ECE 200,017,091019,Kahng; Andrew Byun,9999,0,9999,0
1653581440262,ECE 200,018,091020,Kim; Young-Han,9999,0,9999,0
1653581440262,ECE 200,019,091021,Koushanfar; Farinaz,9999,0,9999,0
1653581440262,ECE 200,020,091022,Kuzum; Duygu,9999,0,9999,0
1653581440262,ECE 200,021,091023,Le; Hanh-Phuc,9999,0,9999,0
1653581440262,ECE 200,022,091024,Lin; Bill,9999,0,9999,0
1653581440262,ECE 200,023,091025,Liu; Zhaowei,9999,0,9999,0
1653581440262,ECE 200,024,091026,Lo; Yu-Hwa,9999,0,9999,0
1653581440262,ECE 200,025,091027,Lomakin; Vitaliy,9999,0,9999,0
1653581440262,ECE 200,026,091028,Mercier; Patrick Philip,9999,0,9999,0
1653581440262,ECE 200,027,091029,Meyer; Florian,9999,0,9999,0
1653581440262,ECE 200,028,091030,Milstein; Laurence B.,9999,0,9999,0
1653581440262,ECE 200,029,091031,Mir Arabbaygi; Siavash,9999,0,9999,0
1653581440262,ECE 200,030,091032,Mookherjea; Shayan,9999,0,9999,0
1653581440262,ECE 200,031,091033,Morris; Karcher William,9999,0,9999,0
1653581440262,ECE 200,032,091034,Ng; Tse Nga,9999,0,9999,0
1653581440262,ECE 200,033,091035,Nguyen; Truong Quang,9999,0,9999,0
1653581440262,ECE 200,034,091036,Nomura; Kenji,9999,0,9999,0
1653581440262,ECE 200,035,091037,Orlitsky; Alon,9999,0,9999,0
1653581440262,ECE 200,036,091038,Pal; Piya,9999,0,9999,0
1653581440262,ECE 200,037,091039,Papen; George C.,9999,0,9999,0
1653581440262,ECE 200,038,091040,Radic; Stojan,9999,0,9999,0
1653581440262,ECE 200,039,091041,Rao; Bhaskar D.,9999,0,9999,0
1653581440262,ECE 200,040,091042,Rao; Ramesh R,9999,0,9999,0
1653581440262,ECE 200,041,091043,Rebeiz; Gabriel,9999,0,9999,0
1653581440262,ECE 200,042,091044,Sanford; John R,9999,0,9999,0
1653581440262,ECE 200,043,091045,Siegel; Paul H.,9999,0,9999,0
1653581440262,ECE 200,044,091046,Sievenpiper; Daniel F.,9999,0,9999,0
1653581440262,ECE 200,045,091047,Sworder; David D.,9999,0,9999,0
1653581440262,ECE 200,046,091048,Taur; Yuan,9999,0,9999,0
1653581440262,ECE 200,047,091049,Touri; Behrouz,9999,0,9999,0
1653581440262,ECE 200,048,091050,Trivedi; Mohan M.,9999,0,9999,0
1653581440262,ECE 200,049,091051,Vardy; Alexander,9999,0,9999,0
1653581440262,ECE 200,050,091052,Vasconcelos; Nuno,9999,0,9999,0
1653581440262,ECE 200,051,091053,Wang; Xiaolong,9999,0,9999,0
1653581440262,ECE 200,052,091054,Xie; Pengtao,9999,0,9999,0
1653581440262,ECE 200,053,091055,Yip; Michael,9999,0,9999,0
1653581440262,ECE 200,054,091056,Zeger; Kenneth A.,9999,0,9999,0
1653581440262,ECE 200,055,091057,Zhang; Xinyu,9999,0,9999,0
1653581440262,ECE 200,056,091058,Turakhia; Yatish Girish,9999,0,9999,0
1653581440262,ECE 200,057,091059,Kang; Mingu,9999,0,9999,0
1653581440262,ECE 200,058,091060,Shi; Yuanyuan,9999,0,9999,0
1653581440262,ECE 200,059,091061,Wang; Edward Jay,9999,0,9999,0
1653581440262,ECE 200,060,091062,Zheng; Yang,9999,0,9999,0
1653581440785,ECE 201,A00,095526,Lo; Yu-Hwa,0,0,0,0
1653581441308,ECE 203,A00,091065,Mercier; Patrick Philip,0,0,0,0
1653581441830,ECE 207A,A00,091605,Liu; Thomas Tao-Ming,0,0,0,0
1653581442352,ECE 212AN,A00,091068,Nomura; Kenji,0,0,0,0
1653581442881,ECE 222A,A00,091069,Rebeiz; Gabriel,0,0,0,0
1653581443404,ECE 225A,A00,091070,Orlitsky; Alon,0,0,0,0
1653581443934,ECE 230A,A00,091071,Nomura; Kenji,0,0,0,0
1653581444470,ECE 236A,A00,091072,Dayeh; Shadi Ahmad,0,0,0,0
1653581444993,ECE 238A,A00,091073,Luo; Jian,0,0,0,0
1653581444993,ECE 238A,B00,091074,Luo; Jian,0,0,0,0
1653581445516,ECE 240A,A00,091075,Radic; Stojan,0,0,0,0
1653581446039,ECE 247A,A00,091592,Shi; Lingyan,0,0,0,0
1653581446564,ECE 250,A00,091076,Touri; Behrouz,0,0,0,0
1653581447094,ECE 251C,A00,091078,Nguyen; Truong Quang,0,0,0,0
1653581447621,ECE 253,A00,091079,Cosman; Pamela C.,0,0,0,0
1653581448151,ECE 255A,A00,091080,Orlitsky; Alon,0,0,0,0
1653581448682,ECE 257A,A00,091081,Zhang; Xinyu,0,0,0,0
1653581449232,ECE 260A,A01,091084,Eldon; John,0,0,0,0
1653581449763,ECE 264C,A00,091085,Galton; Ian A,0,0,0,0
1653581450289,ECE 265C,A00,094889,Presti; Calogero Davide,0,0,0,9
1653581450812,ECE 266,A01,091087,Hall; Drew A.,0,0,0,0
1653581451855,ECE 271A,A00,091090,Vasconcelos; Nuno,0,0,0,0
1653581452388,ECE 272B,A00,091091,Sworder; David D.,0,0,0,0
1653581452917,ECE 275A,A00,091092,Meyer; Florian,0,0,0,0
1653581453441,ECE 277,A00,091093,An; Cheolhong,0,0,0,0
1653581453967,ECE 283,A00,091094,Le; Hanh-Phuc,0,0,0,0
1653581454489,ECE 284,A00,091095,Kang; Mingu,0,0,0,0
1653581454489,ECE 284,B00,091096,Wang; Edward Jay,0,0,0,0
1653581455012,ECE 285,A00,094334,Touri; Behrouz,0,0,0,0
1653581455537,ECE 289,A00,091097,Whelan; David Arthur,0,0,0,0
1653581456059,MATH 200A,A00,087414,Salehi Golsefidy; Alireza,7,0,8,1
1653581456585,MATH 202A,A00,087415,Gill; Philip E.,2,0,8,6
1653581457107,MATH 203A,A00,087416,Oprea; Dragos N.,6,0,8,2
1653581457635,MATH 204A,A00,087417,Kedlaya; Kiran S.,6,0,8,2
1653581458158,MATH 205,A00,087418,Sorensen; Claus M,6,0,8,2
1653581458686,MATH 206A,A00,087419,Izadi; Elham,7,0,8,1
1653581459209,MATH 207A,A00,087420,Mohammadi; Amir,5,0,8,3
1653581459735,MATH 208,A00,087421,Staff,9,0,10,1
1653581460259,MATH 209,A00,087422,Staff,10,0,10,0
1653581460796,MATH 218,A00,087423,Staff,10,0,10,0
1653581461330,MATH 220A,A00,087424,Novak; Jonathan I,6,0,8,2
1653581461854,MATH 231A,A00,087425,Bejenaru; Ioan,3,0,8,5
1653581462377,MATH 240A,A00,087426,Ebenfelt; Peter F,5,0,8,3
1653581462900,MATH 243,A00,087427,Staff,9,0,10,1
1653581463423,MATH 248,A00,087429,Staff,10,0,10,0
1653581463945,MATH 250A,A00,087430,Spolaor; Luca,4,0,8,4
1653581464481,MATH 257A,A00,087431,Spolaor; Luca,7,0,8,1
1653581465003,MATH 258,A00,087432,Staff,9,0,10,1
1653581465537,MATH 264A,A00,087433,Warnke; Lutz Peter,5,0,8,3
1653581466073,MATH 268,A00,087434,Staff,15,0,15,0
1653581466595,MATH 269,A00,087435,Staff,14,0,15,1
1653581467118,MATH 270A,A00,087436,Nie; Jiawang,0,0,8,8
1653581467650,MATH 272A,A00,087437,Tian; Xiaochuan,1,0,8,7
1653581468173,MATH 274,A01,087439,Cheng; Li-Tien,9,0,10,1
1653581468173,MATH 274,A02,087440,Cheng; Li-Tien,10,0,10,0
1653581468701,MATH 278A,A00,087441,Staff,8,0,10,2
1653581469222,MATH 278B,A00,087442,Staff,8,0,10,2
1653581469745,MATH 278C,A00,087443,Staff,8,0,10,2
1653581470271,MATH 280A,A00,087444,Zheng; Tianyi,0,0,8,8
1653581470797,MATH 281A,A00,087445,Bradic; Jelena,0,0,8,8
1653581471322,MATH 282A,A00,087446,Zhang; Danna,0,0,8,8
1653581471854,MATH 283,A00,087447,Tesler; Glenn,0,0,0,16
1653581472382,MATH 286,B00,095535,Kemp; Todd Aahron,8,0,8,0
1653581472909,MATH 287D,A00,087449,Bradic; Jelena,0,0,0,2
1653581473434,MATH 288,A00,087450,Staff,14,0,15,1
1653581473434,MATH 288,B00,087451,Staff,15,0,15,0
1653581473434,MATH 288,C00,087452,Staff,15,0,15,0
1653581473957,MATH 290A,A00,087453,Xu; Zhouli,6,0,8,2
1653581474480,MATH 291A,A00,087454,Xu; Zhouli,7,0,8,1
1653581475019,MATH 292,A00,087455,Staff,10,0,10,0
1653581475541,MATH 295,A00,087456,Staff,50,0,50,0
1653581476075,MATH 297,001,087457,Staff,998,0,999,1
1653582035785,COGS 200,A01,087991,Staff,47,0,50,3
1653582036310,COGS 201,A01,094504,Rangel; Lara M,17,0,25,8
1653582036833,COGS 203,A00,087992,Coulson; Seana M,18,0,20,2
1653582037359,COGS 210A,001,087993,Greene; Deanna Jacquelyn,9998,0,9999,1
1653582037359,COGS 210A,002,087994,Saygin; Ayse P,9999,0,9999,0
1653582037359,COGS 210A,003,087995,Xia; Haijun,9999,0,9999,0
1653582037359,COGS 210A,004,087996,Nitz; Douglas A.,9999,0,9999,0
1653582037359,COGS 210A,005,087997,Hollan; James D.,9999,0,9999,0
1653582037359,COGS 210A,006,087998,Deak; Gedeon O.,9998,0,9999,1
1653582037359,COGS 210A,007,087999,Rossano; Federico,9999,0,9999,0
1653582037884,COGS 211A,A00,088000,Coulson; Seana M,9997,0,9999,2
1653582038407,COGS 229,A00,088002,Staff,22,0,25,3
1653582038933,COGS 260,B00,094231,Staff,17,0,20,3
1653582038933,COGS 260,A00,088004,Nitz; Douglas A.,9998,0,9999,1
1653582039455,CSE 202,A00,090110,Paturi; Ramamohan,0,0,0,0
1653582039455,CSE 202,B00,090111,Paturi; Ramamohan,0,0,0,0
1653582039979,CSE 207B,A00,090112,Heninger; Nadia A,0,0,0,0
1653582040501,CSE 208,A00,094858,Micciancio; Daniele,0,0,0,0
1653582041033,CSE 210,A00,090113,Powell; Thomas Allan,0,0,0,0
1653582041565,CSE 219,A00,090898,Staff,0,0,0,0
1653582042089,CSE 221,A00,090114,Zhou; Yuan-Yuan,0,0,0,0
1653582042627,CSE 229A,A00,090115,Porter; George M,0,0,0,0
1653582043155,CSE 229C,A00,090116,Savage; Stefan,0,0,0,0
1653582043676,CSE 230,A00,090117,Jhala; Ranjit,0,0,0,0
1653582044199,CSE 232,A00,090118,Papakonstantinou; Yannis,0,0,0,0
1653582044720,CSE 239A,A00,090121,Kumar; Arun Kumar,0,0,0,0
1653582045245,CSE 239B,A00,090122,Jhala; Ranjit,0,0,0,0
1653582045767,CSE 240A,A00,090123,Zhao; Jishen,1,0,189,188
1653582046298,CSE 243A,A00,090124,Orailoglu; Alex,0,0,15,15
1653582046819,CSE 249B,A00,090125,Kahng; Andrew Byun,13,0,20,7
1653582047344,CSE 250A,A00,090126,Berg-Kirkpatrick; Taylor D,0,0,0,0
1653582047869,CSE 252A,A00,090127,Ochoa; Benjamin Lawrence,0,0,0,0
1653582048393,CSE 258,A01,090129,McAuley; Julian John,0,0,0,0
1653582048917,CSE 258R,A01,090131,McAuley; Julian John,0,0,0,0
1653582049439,CSE 274,A00,090132,Ramamoorthi; Ravi,0,0,0,0
1653582049963,CSE 276A,A00,090133,Christensen; Henrik I,0,0,0,0
1653582050485,CSE 276C,A00,090134,Christensen; Henrik I,0,0,0,0
1653582051009,CSE 290,A00,090135,Bafna; Vineet,0,0,0,0
1653582051009,CSE 290,B00,090136,Ramamoorthi; Ravi,0,0,0,0
1653582051009,CSE 290,C00,090137,Li; Tzumao,8,0,10,2
1653582051009,CSE 290,D00,090138,Zhou; Yuan-Yuan,9,0,10,1
1653582051009,CSE 290,E00,090139,Christensen; Henrik I,8,0,10,2
1653582051009,CSE 290,F00,094053,Shalev; Aaron D,0,0,0,0
1653582051535,CSE 291,A00,090140,Munyaka; Imani N. S.,0,0,0,0
1653582051535,CSE 291,B00,094880,Yu; Qi,0,0,0,0
1653582051535,CSE 291,C00,090142,Pannuto; Patrick William,0,0,0,0
1653582051535,CSE 291,D00,094881,Zhang; Yiying,0,0,0,0
1653582051535,CSE 291,E00,095118,Su; Hao,0,0,0,0
1653582052091,CSE 293,001,094905,Bafna; Vineet,9999,0,9999,0
1653582052091,CSE 293,002,094906,Bellare; Mihir,9999,0,9999,0
1653582052091,CSE 293,003,094907,Berg-Kirkpatrick; Taylor D,9999,0,9999,0
1653582052091,CSE 293,004,094908,Christensen; Henrik I,9999,0,9999,0
1653582052091,CSE 293,005,094909,Cottrell; Garrison W,9999,0,9999,0
1653582052091,CSE 293,006,094910,Deutsch; Alin Bernard,9999,0,9999,0
1653582052091,CSE 293,007,094911,Esmaeilzadeh; Hadi,9999,0,9999,0
1653582052091,CSE 293,008,094912,Freund; Yoav,9999,0,9999,0
1653582052091,CSE 293,009,094913,Griswold; William G.,9999,0,9999,0
1653582052091,CSE 293,010,094914,Gymrek; Melissa Ann,9999,0,9999,0
1653582052091,CSE 293,011,094915,Heninger; Nadia A,9999,0,9999,0
1653582052091,CSE 293,012,094916,Impagliazzo; Russell,9999,0,9999,0
1653582052091,CSE 293,013,094917,Jhala; Ranjit,9999,0,9999,0
1653582052091,CSE 293,014,094918,Kahng; Andrew Byun,9999,0,9999,0
1653582052091,CSE 293,015,094919,Kane; Daniel Mertz,9999,0,9999,0
1653582052091,CSE 293,016,094920,Kriegman; David J,9999,0,9999,0
1653582052091,CSE 293,017,094921,Kumar; Arun Kumar,9999,0,9999,0
1653582052091,CSE 293,018,094922,Lerner; Sorin,9999,0,9999,0
1653582052091,CSE 293,019,094923,Lovett; Shachar,9999,0,9999,0
1653582052091,CSE 293,020,094924,McAuley; Julian John,9999,0,9999,0
1653582052091,CSE 293,021,094925,Micciancio; Daniele,9999,0,9999,0
1653582052091,CSE 293,022,094926,Orailoglu; Alex,9999,0,9999,0
1653582052091,CSE 293,023,094927,Paturi; Ramamohan,9999,0,9999,0
1653582052091,CSE 293,024,094928,Polikarpova; Nadezhda,9999,0,9999,0
1653582052091,CSE 293,025,094929,Politz; Joseph Gibbs,9999,0,9999,0
1653582052091,CSE 293,026,094930,Porter; George M,9999,0,9999,0
1653582052091,CSE 293,027,094931,Porter; Leonard Emerson,9999,0,9999,0
1653582052091,CSE 293,028,094932,Ramamoorthi; Ravi,9999,0,9999,0
1653582052091,CSE 293,029,094933,Sahoo; Debashis,9999,0,9999,0
1653582052091,CSE 293,030,094934,Saul; Lawrence,9999,0,9999,0
1653582052091,CSE 293,031,094935,Savage; Stefan,9999,0,9999,0
1653582052091,CSE 293,032,094936,Schulze; Jurgen P.,9999,0,9999,0
1653582052091,CSE 293,033,094937,Snoeren; Alex C.,9999,0,9999,0
1653582052091,CSE 293,034,094938,Shang; Jingbo,9999,0,9999,0
1653582052091,CSE 293,035,094939,Stefan; Deian,9999,0,9999,0
1653582052091,CSE 293,036,094940,Su; Hao,9999,0,9999,0
1653582052091,CSE 293,037,094941,Swanson; Steven James,9999,0,9999,0
1653582052091,CSE 293,038,094942,Tullsen; Dean Michael,9999,0,9999,0
1653582052091,CSE 293,039,094943,Voelker; Geoffrey M.,9999,0,9999,0
1653582052091,CSE 293,040,094944,Zhao; Jishen,9999,0,9999,0
1653582052091,CSE 293,041,094945,Zhou; Yuan-Yuan,9999,0,9999,0
1653582052091,CSE 293,042,094946,Gao; Sicun,9998,0,9999,1
1653582052091,CSE 293,043,094947,Weibel; Nadir,9999,0,9999,0
1653582052091,CSE 293,044,094948,Gupta; Rajesh K.,9999,0,9999,0
1653582052616,CSE 294,A00,090143,Porter; George M,8,0,10,2
1653582053141,DSE 200,A00,091799,Staff,50,0,50,0
1653582053667,DSE 203,A00,091800,Gupta; Amarnath,30,0,30,0
1653582054189,DSE 250,A00,091801,Deutsch; Alin Bernard,30,0,30,0
1653582054713,DSE 290,A00,091802,Altintas De Callaf; Ilkay,50,0,50,0
1653582055249,ECE 200,001,091003,Antipa; Nicholas A,9999,0,9999,0
1653582055249,ECE 200,002,091004,Atanasov; Nikolay A.,9999,0,9999,0
1653582055249,ECE 200,003,091005,Bharadia; Dinesh,9999,0,9999,0
1653582055249,ECE 200,004,091006,Cheng; Chung Kuan,9999,0,9999,0
1653582055249,ECE 200,005,091007,Cosman; Pamela C.,9999,0,9999,0
1653582055249,ECE 200,006,091008,Staff,9999,0,9999,0
1653582055249,ECE 200,007,091009,Dayeh; Shadi Ahmad,9999,0,9999,0
1653582055249,ECE 200,008,091010,Fainman; Yeshaiahu,9999,0,9999,0
1653582055249,ECE 200,009,091011,Ford; Joseph Earl,9999,0,9999,0
1653582055249,ECE 200,010,091012,Franceschetti; Massimo,9999,0,9999,0
1653582055249,ECE 200,011,091013,Fullerton; Eric E,9999,0,9999,0
1653582055249,ECE 200,012,091014,Galton; Ian A,9999,0,9999,0
1653582055249,ECE 200,013,091015,Gilja; Vikash,9999,0,9999,0
1653582055249,ECE 200,014,091016,Hall; Drew A.,9999,0,9999,0
1653582055249,ECE 200,015,091017,Hsueh; Tzu-Chien,9999,0,9999,0
1653582055249,ECE 200,016,091018,Javidi; Tara,9999,0,9999,0
1653582055249,ECE 200,017,091019,Kahng; Andrew Byun,9999,0,9999,0
1653582055249,ECE 200,018,091020,Kim; Young-Han,9999,0,9999,0
1653582055249,ECE 200,019,091021,Koushanfar; Farinaz,9999,0,9999,0
1653582055249,ECE 200,020,091022,Kuzum; Duygu,9999,0,9999,0
1653582055249,ECE 200,021,091023,Le; Hanh-Phuc,9999,0,9999,0
1653582055249,ECE 200,022,091024,Lin; Bill,9999,0,9999,0
1653582055249,ECE 200,023,091025,Liu; Zhaowei,9999,0,9999,0
1653582055249,ECE 200,024,091026,Lo; Yu-Hwa,9999,0,9999,0
1653582055249,ECE 200,025,091027,Lomakin; Vitaliy,9999,0,9999,0
1653582055249,ECE 200,026,091028,Mercier; Patrick Philip,9999,0,9999,0
1653582055249,ECE 200,027,091029,Meyer; Florian,9999,0,9999,0
1653582055249,ECE 200,028,091030,Milstein; Laurence B.,9999,0,9999,0
1653582055249,ECE 200,029,091031,Mir Arabbaygi; Siavash,9999,0,9999,0
1653582055249,ECE 200,030,091032,Mookherjea; Shayan,9999,0,9999,0
1653582055249,ECE 200,031,091033,Morris; Karcher William,9999,0,9999,0
1653582055249,ECE 200,032,091034,Ng; Tse Nga,9999,0,9999,0
1653582055249,ECE 200,033,091035,Nguyen; Truong Quang,9999,0,9999,0
1653582055249,ECE 200,034,091036,Nomura; Kenji,9999,0,9999,0
1653582055249,ECE 200,035,091037,Orlitsky; Alon,9999,0,9999,0
1653582055249,ECE 200,036,091038,Pal; Piya,9999,0,9999,0
1653582055249,ECE 200,037,091039,Papen; George C.,9999,0,9999,0
1653582055249,ECE 200,038,091040,Radic; Stojan,9999,0,9999,0
1653582055249,ECE 200,039,091041,Rao; Bhaskar D.,9999,0,9999,0
1653582055249,ECE 200,040,091042,Rao; Ramesh R,9999,0,9999,0
1653582055249,ECE 200,041,091043,Rebeiz; Gabriel,9999,0,9999,0
1653582055249,ECE 200,042,091044,Sanford; John R,9999,0,9999,0
1653582055249,ECE 200,043,091045,Siegel; Paul H.,9999,0,9999,0
1653582055249,ECE 200,044,091046,Sievenpiper; Daniel F.,9999,0,9999,0
1653582055249,ECE 200,045,091047,Sworder; David D.,9999,0,9999,0
1653582055249,ECE 200,046,091048,Taur; Yuan,9999,0,9999,0
1653582055249,ECE 200,047,091049,Touri; Behrouz,9999,0,9999,0
1653582055249,ECE 200,048,091050,Trivedi; Mohan M.,9999,0,9999,0
1653582055249,ECE 200,049,091051,Vardy; Alexander,9999,0,9999,0
1653582055249,ECE 200,050,091052,Vasconcelos; Nuno,9999,0,9999,0
1653582055249,ECE 200,051,091053,Wang; Xiaolong,9999,0,9999,0
1653582055249,ECE 200,052,091054,Xie; Pengtao,9999,0,9999,0
1653582055249,ECE 200,053,091055,Yip; Michael,9999,0,9999,0
1653582055249,ECE 200,054,091056,Zeger; Kenneth A.,9999,0,9999,0
1653582055249,ECE 200,055,091057,Zhang; Xinyu,9999,0,9999,0
1653582055249,ECE 200,056,091058,Turakhia; Yatish Girish,9999,0,9999,0
1653582055249,ECE 200,057,091059,Kang; Mingu,9999,0,9999,0
1653582055249,ECE 200,058,091060,Shi; Yuanyuan,9999,0,9999,0
1653582055249,ECE 200,059,091061,Wang; Edward Jay,9999,0,9999,0
1653582055249,ECE 200,060,091062,Zheng; Yang,9999,0,9999,0
1653582055772,ECE 201,A00,095526,Lo; Yu-Hwa,0,0,0,0
1653582056297,ECE 203,A00,091065,Mercier; Patrick Philip,0,0,0,0
1653582056823,ECE 207A,A00,091605,Liu; Thomas Tao-Ming,0,0,0,0
1653582057349,ECE 212AN,A00,091068,Nomura; Kenji,0,0,0,0
1653582057871,ECE 222A,A00,091069,Rebeiz; Gabriel,0,0,0,0
1653582058411,ECE 225A,A00,091070,Orlitsky; Alon,0,0,0,0
1653582058938,ECE 230A,A00,091071,Nomura; Kenji,0,0,0,0
1653582059459,ECE 236A,A00,091072,Dayeh; Shadi Ahmad,0,0,0,0
1653582059985,ECE 238A,A00,091073,Luo; Jian,0,0,0,0
1653582059985,ECE 238A,B00,091074,Luo; Jian,0,0,0,0
1653582060510,ECE 240A,A00,091075,Radic; Stojan,0,0,0,0
1653582061036,ECE 247A,A00,091592,Shi; Lingyan,0,0,0,0
1653582061563,ECE 250,A00,091076,Touri; Behrouz,0,0,0,0
1653582062085,ECE 251C,A00,091078,Nguyen; Truong Quang,0,0,0,0
1653582062615,ECE 253,A00,091079,Cosman; Pamela C.,0,0,0,0
1653582063141,ECE 255A,A00,091080,Orlitsky; Alon,0,0,0,0
1653582063669,ECE 257A,A00,091081,Zhang; Xinyu,0,0,0,0
1653582064193,ECE 260A,A01,091084,Eldon; John,0,0,0,0
1653582064720,ECE 264C,A00,091085,Galton; Ian A,0,0,0,0
1653582065242,ECE 265C,A00,094889,Presti; Calogero Davide,0,0,0,9
1653582065769,ECE 266,A01,091087,Hall; Drew A.,0,0,0,0
1653582066820,ECE 271A,A00,091090,Vasconcelos; Nuno,0,0,0,0
1653582067351,ECE 272B,A00,091091,Sworder; David D.,0,0,0,0
1653582067874,ECE 275A,A00,091092,Meyer; Florian,0,0,0,0
1653582068405,ECE 277,A00,091093,An; Cheolhong,0,0,0,0
1653582068928,ECE 283,A00,091094,Le; Hanh-Phuc,0,0,0,0
1653582069452,ECE 284,A00,091095,Kang; Mingu,0,0,0,0
1653582069452,ECE 284,B00,091096,Wang; Edward Jay,0,0,0,0
1653582069975,ECE 285,A00,094334,Touri; Behrouz,0,0,0,0
1653582070499,ECE 289,A00,091097,Whelan; David Arthur,0,0,0,0
1653582071023,MATH 200A,A00,087414,Salehi Golsefidy; Alireza,7,0,8,1
1653582071547,MATH 202A,A00,087415,Gill; Philip E.,2,0,8,6
1653582072076,MATH 203A,A00,087416,Oprea; Dragos N.,6,0,8,2
1653582072604,MATH 204A,A00,087417,Kedlaya; Kiran S.,6,0,8,2
1653582073139,MATH 205,A00,087418,Sorensen; Claus M,6,0,8,2
1653582073662,MATH 206A,A00,087419,Izadi; Elham,7,0,8,1
1653582074184,MATH 207A,A00,087420,Mohammadi; Amir,5,0,8,3
1653582074706,MATH 208,A00,087421,Staff,9,0,10,1
1653582075235,MATH 209,A00,087422,Staff,10,0,10,0
1653582075757,MATH 218,A00,087423,Staff,10,0,10,0
1653582076288,MATH 220A,A00,087424,Novak; Jonathan I,6,0,8,2
1653582076819,MATH 231A,A00,087425,Bejenaru; Ioan,3,0,8,5
1653582077340,MATH 240A,A00,087426,Ebenfelt; Peter F,5,0,8,3
1653582077862,MATH 243,A00,087427,Staff,9,0,10,1
1653582078480,MATH 248,A00,087429,Staff,10,0,10,0
1653582079002,MATH 250A,A00,087430,Spolaor; Luca,4,0,8,4
1653582079528,MATH 257A,A00,087431,Spolaor; Luca,7,0,8,1
1653582080053,MATH 258,A00,087432,Staff,9,0,10,1
1653582080575,MATH 264A,A00,087433,Warnke; Lutz Peter,5,0,8,3
1653582081100,MATH 268,A00,087434,Staff,15,0,15,0
1653582081623,MATH 269,A00,087435,Staff,14,0,15,1
1653582082146,MATH 270A,A00,087436,Nie; Jiawang,0,0,8,8
1653582082684,MATH 272A,A00,087437,Tian; Xiaochuan,1,0,8,7
1653582083207,MATH 274,A01,087439,Cheng; Li-Tien,9,0,10,1
1653582083207,MATH 274,A02,087440,Cheng; Li-Tien,10,0,10,0
1653582083732,MATH 278A,A00,087441,Staff,8,0,10,2
1653582084253,MATH 278B,A00,087442,Staff,8,0,10,2
1653582084776,MATH 278C,A00,087443,Staff,8,0,10,2
1653582085298,MATH 280A,A00,087444,Zheng; Tianyi,0,0,8,8
1653582085830,MATH 281A,A00,087445,Bradic; Jelena,0,0,8,8
1653582086354,MATH 282A,A00,087446,Zhang; Danna,0,0,8,8
1653582086880,MATH 283,A00,087447,Tesler; Glenn,0,0,0,16
1653582087403,MATH 286,B00,095535,Kemp; Todd Aahron,8,0,8,0
1653582087925,MATH 287D,A00,087449,Bradic; Jelena,0,0,0,2
1653582088451,MATH 288,A00,087450,Staff,14,0,15,1
1653582088451,MATH 288,B00,087451,Staff,15,0,15,0
1653582088451,MATH 288,C00,087452,Staff,15,0,15,0
1653582088976,MATH 290A,A00,087453,Xu; Zhouli,6,0,8,2
1653582089501,MATH 291A,A00,087454,Xu; Zhouli,7,0,8,1
1653582090026,MATH 292,A00,087455,Staff,10,0,10,0
1653582090549,MATH 295,A00,087456,Staff,50,0,50,0
1653582091075,MATH 297,001,087457,Staff,998,0,999,1
1653582651220,COGS 200,A01,087991,Staff,47,0,50,3
1653582651745,COGS 201,A01,094504,Rangel; Lara M,17,0,25,8
1653582652270,COGS 203,A00,087992,Coulson; Seana M,18,0,20,2
1653582652793,COGS 210A,001,087993,Greene; Deanna Jacquelyn,9998,0,9999,1
1653582652793,COGS 210A,002,087994,Saygin; Ayse P,9999,0,9999,0
1653582652793,COGS 210A,003,087995,Xia; Haijun,9999,0,9999,0
1653582652793,COGS 210A,004,087996,Nitz; Douglas A.,9999,0,9999,0
1653582652793,COGS 210A,005,087997,Hollan; James D.,9999,0,9999,0
1653582652793,COGS 210A,006,087998,Deak; Gedeon O.,9998,0,9999,1
1653582652793,COGS 210A,007,087999,Rossano; Federico,9999,0,9999,0
1653582653315,COGS 211A,A00,088000,Coulson; Seana M,9997,0,9999,2
1653582653838,COGS 229,A00,088002,Staff,22,0,25,3
1653582654360,COGS 260,B00,094231,Staff,17,0,20,3
1653582654360,COGS 260,A00,088004,Nitz; Douglas A.,9998,0,9999,1
1653582654893,CSE 202,A00,090110,Paturi; Ramamohan,0,0,0,0
1653582654893,CSE 202,B00,090111,Paturi; Ramamohan,0,0,0,0
1653582655421,CSE 207B,A00,090112,Heninger; Nadia A,0,0,0,0
1653582655945,CSE 208,A00,094858,Micciancio; Daniele,0,0,0,0
1653582656468,CSE 210,A00,090113,Powell; Thomas Allan,0,0,0,0
1653582657000,CSE 219,A00,090898,Staff,0,0,0,0
1653582657528,CSE 221,A00,090114,Zhou; Yuan-Yuan,0,0,0,0
1653582658051,CSE 229A,A00,090115,Porter; George M,0,0,0,0
1653582658576,CSE 229C,A00,090116,Savage; Stefan,0,0,0,0
1653582659099,CSE 230,A00,090117,Jhala; Ranjit,0,0,0,0
1653582659625,CSE 232,A00,090118,Papakonstantinou; Yannis,0,0,0,0
1653582660146,CSE 239A,A00,090121,Kumar; Arun Kumar,0,0,0,0
1653582660681,CSE 239B,A00,090122,Jhala; Ranjit,0,0,0,0
1653582661205,CSE 240A,A00,090123,Zhao; Jishen,1,0,189,188
1653582661734,CSE 243A,A00,090124,Orailoglu; Alex,0,0,15,15
1653582662268,CSE 249B,A00,090125,Kahng; Andrew Byun,13,0,20,7
1653582662800,CSE 250A,A00,090126,Berg-Kirkpatrick; Taylor D,0,0,0,0
1653582663331,CSE 252A,A00,090127,Ochoa; Benjamin Lawrence,0,0,0,0
1653582663860,CSE 258,A01,090129,McAuley; Julian John,0,0,0,0
1653582664382,CSE 258R,A01,090131,McAuley; Julian John,0,0,0,0
1653582664909,CSE 274,A00,090132,Ramamoorthi; Ravi,0,0,0,0
1653582665442,CSE 276A,A00,090133,Christensen; Henrik I,0,0,0,0
1653582666055,CSE 276C,A00,090134,Christensen; Henrik I,0,0,0,0
1653582666578,CSE 290,A00,090135,Bafna; Vineet,0,0,0,0
1653582666578,CSE 290,B00,090136,Ramamoorthi; Ravi,0,0,0,0
1653582666578,CSE 290,C00,090137,Li; Tzumao,8,0,10,2
1653582666578,CSE 290,D00,090138,Zhou; Yuan-Yuan,9,0,10,1
1653582666578,CSE 290,E00,090139,Christensen; Henrik I,8,0,10,2
1653582666578,CSE 290,F00,094053,Shalev; Aaron D,0,0,0,0
1653582667102,CSE 291,A00,090140,Munyaka; Imani N. S.,0,0,0,0
1653582667102,CSE 291,B00,094880,Yu; Qi,0,0,0,0
1653582667102,CSE 291,C00,090142,Pannuto; Patrick William,0,0,0,0
1653582667102,CSE 291,D00,094881,Zhang; Yiying,0,0,0,0
1653582667102,CSE 291,E00,095118,Su; Hao,0,0,0,0
1653582667628,CSE 293,001,094905,Bafna; Vineet,9999,0,9999,0
1653582667628,CSE 293,002,094906,Bellare; Mihir,9999,0,9999,0
1653582667628,CSE 293,003,094907,Berg-Kirkpatrick; Taylor D,9999,0,9999,0
1653582667628,CSE 293,004,094908,Christensen; Henrik I,9999,0,9999,0
1653582667628,CSE 293,005,094909,Cottrell; Garrison W,9999,0,9999,0
1653582667628,CSE 293,006,094910,Deutsch; Alin Bernard,9999,0,9999,0
1653582667628,CSE 293,007,094911,Esmaeilzadeh; Hadi,9999,0,9999,0
1653582667628,CSE 293,008,094912,Freund; Yoav,9999,0,9999,0
1653582667628,CSE 293,009,094913,Griswold; William G.,9999,0,9999,0
1653582667628,CSE 293,010,094914,Gymrek; Melissa Ann,9999,0,9999,0
1653582667628,CSE 293,011,094915,Heninger; Nadia A,9999,0,9999,0
1653582667628,CSE 293,012,094916,Impagliazzo; Russell,9999,0,9999,0
1653582667628,CSE 293,013,094917,Jhala; Ranjit,9999,0,9999,0
1653582667628,CSE 293,014,094918,Kahng; Andrew Byun,9999,0,9999,0
1653582667628,CSE 293,015,094919,Kane; Daniel Mertz,9999,0,9999,0
1653582667628,CSE 293,016,094920,Kriegman; David J,9999,0,9999,0
1653582667628,CSE 293,017,094921,Kumar; Arun Kumar,9999,0,9999,0
1653582667628,CSE 293,018,094922,Lerner; Sorin,9999,0,9999,0
1653582667628,CSE 293,019,094923,Lovett; Shachar,9999,0,9999,0
1653582667628,CSE 293,020,094924,McAuley; Julian John,9999,0,9999,0
1653582667628,CSE 293,021,094925,Micciancio; Daniele,9999,0,9999,0
1653582667628,CSE 293,022,094926,Orailoglu; Alex,9999,0,9999,0
1653582667628,CSE 293,023,094927,Paturi; Ramamohan,9999,0,9999,0
1653582667628,CSE 293,024,094928,Polikarpova; Nadezhda,9999,0,9999,0
1653582667628,CSE 293,025,094929,Politz; Joseph Gibbs,9999,0,9999,0
1653582667628,CSE 293,026,094930,Porter; George M,9999,0,9999,0
1653582667628,CSE 293,027,094931,Porter; Leonard Emerson,9999,0,9999,0
1653582667628,CSE 293,028,094932,Ramamoorthi; Ravi,9999,0,9999,0
1653582667628,CSE 293,029,094933,Sahoo; Debashis,9999,0,9999,0
1653582667628,CSE 293,030,094934,Saul; Lawrence,9999,0,9999,0
1653582667628,CSE 293,031,094935,Savage; Stefan,9999,0,9999,0
1653582667628,CSE 293,032,094936,Schulze; Jurgen P.,9999,0,9999,0
1653582667628,CSE 293,033,094937,Snoeren; Alex C.,9999,0,9999,0
1653582667628,CSE 293,034,094938,Shang; Jingbo,9999,0,9999,0
1653582667628,CSE 293,035,094939,Stefan; Deian,9999,0,9999,0
1653582667628,CSE 293,036,094940,Su; Hao,9999,0,9999,0
1653582667628,CSE 293,037,094941,Swanson; Steven James,9999,0,9999,0
1653582667628,CSE 293,038,094942,Tullsen; Dean Michael,9999,0,9999,0
1653582667628,CSE 293,039,094943,Voelker; Geoffrey M.,9999,0,9999,0
1653582667628,CSE 293,040,094944,Zhao; Jishen,9999,0,9999,0
1653582667628,CSE 293,041,094945,Zhou; Yuan-Yuan,9999,0,9999,0
1653582667628,CSE 293,042,094946,Gao; Sicun,9998,0,9999,1
1653582667628,CSE 293,043,094947,Weibel; Nadir,9999,0,9999,0
1653582667628,CSE 293,044,094948,Gupta; Rajesh K.,9999,0,9999,0
1653582668154,CSE 294,A00,090143,Porter; George M,8,0,10,2
1653582668677,DSE 200,A00,091799,Staff,50,0,50,0
1653582669201,DSE 203,A00,091800,Gupta; Amarnath,30,0,30,0
1653582669726,DSE 250,A00,091801,Deutsch; Alin Bernard,30,0,30,0
1653582670256,DSE 290,A00,091802,Altintas De Callaf; Ilkay,50,0,50,0
1653582670783,ECE 200,001,091003,Antipa; Nicholas A,9999,0,9999,0
1653582670783,ECE 200,002,091004,Atanasov; Nikolay A.,9999,0,9999,0
1653582670783,ECE 200,003,091005,Bharadia; Dinesh,9999,0,9999,0
1653582670783,ECE 200,004,091006,Cheng; Chung Kuan,9999,0,9999,0
1653582670783,ECE 200,005,091007,Cosman; Pamela C.,9999,0,9999,0
1653582670783,ECE 200,006,091008,Staff,9999,0,9999,0
1653582670783,ECE 200,007,091009,Dayeh; Shadi Ahmad,9999,0,9999,0
1653582670783,ECE 200,008,091010,Fainman; Yeshaiahu,9999,0,9999,0
1653582670783,ECE 200,009,091011,Ford; Joseph Earl,9999,0,9999,0
1653582670783,ECE 200,010,091012,Franceschetti; Massimo,9999,0,9999,0
1653582670783,ECE 200,011,091013,Fullerton; Eric E,9999,0,9999,0
1653582670783,ECE 200,012,091014,Galton; Ian A,9999,0,9999,0
1653582670783,ECE 200,013,091015,Gilja; Vikash,9999,0,9999,0
1653582670783,ECE 200,014,091016,Hall; Drew A.,9999,0,9999,0
1653582670783,ECE 200,015,091017,Hsueh; Tzu-Chien,9999,0,9999,0
1653582670783,ECE 200,016,091018,Javidi; Tara,9999,0,9999,0
1653582670783,ECE 200,017,091019,Kahng; Andrew Byun,9999,0,9999,0
1653582670783,ECE 200,018,091020,Kim; Young-Han,9999,0,9999,0
1653582670783,ECE 200,019,091021,Koushanfar; Farinaz,9999,0,9999,0
1653582670783,ECE 200,020,091022,Kuzum; Duygu,9999,0,9999,0
1653582670783,ECE 200,021,091023,Le; Hanh-Phuc,9999,0,9999,0
1653582670783,ECE 200,022,091024,Lin; Bill,9999,0,9999,0
1653582670783,ECE 200,023,091025,Liu; Zhaowei,9999,0,9999,0
1653582670783,ECE 200,024,091026,Lo; Yu-Hwa,9999,0,9999,0
1653582670783,ECE 200,025,091027,Lomakin; Vitaliy,9999,0,9999,0
1653582670783,ECE 200,026,091028,Mercier; Patrick Philip,9999,0,9999,0
1653582670783,ECE 200,027,091029,Meyer; Florian,9999,0,9999,0
1653582670783,ECE 200,028,091030,Milstein; Laurence B.,9999,0,9999,0
1653582670783,ECE 200,029,091031,Mir Arabbaygi; Siavash,9999,0,9999,0
1653582670783,ECE 200,030,091032,Mookherjea; Shayan,9999,0,9999,0
1653582670783,ECE 200,031,091033,Morris; Karcher William,9999,0,9999,0
1653582670783,ECE 200,032,091034,Ng; Tse Nga,9999,0,9999,0
1653582670783,ECE 200,033,091035,Nguyen; Truong Quang,9999,0,9999,0
1653582670783,ECE 200,034,091036,Nomura; Kenji,9999,0,9999,0
1653582670783,ECE 200,035,091037,Orlitsky; Alon,9999,0,9999,0
1653582670783,ECE 200,036,091038,Pal; Piya,9999,0,9999,0
1653582670783,ECE 200,037,091039,Papen; George C.,9999,0,9999,0
1653582670783,ECE 200,038,091040,Radic; Stojan,9999,0,9999,0
1653582670783,ECE 200,039,091041,Rao; Bhaskar D.,9999,0,9999,0
1653582670783,ECE 200,040,091042,Rao; Ramesh R,9999,0,9999,0
1653582670783,ECE 200,041,091043,Rebeiz; Gabriel,9999,0,9999,0
1653582670783,ECE 200,042,091044,Sanford; John R,9999,0,9999,0
1653582670783,ECE 200,043,091045,Siegel; Paul H.,9999,0,9999,0
1653582670783,ECE 200,044,091046,Sievenpiper; Daniel F.,9999,0,9999,0
1653582670783,ECE 200,045,091047,Sworder; David D.,9999,0,9999,0
1653582670783,ECE 200,046,091048,Taur; Yuan,9999,0,9999,0
1653582670783,ECE 200,047,091049,Touri; Behrouz,9999,0,9999,0
1653582670783,ECE 200,048,091050,Trivedi; Mohan M.,9999,0,9999,0
1653582670783,ECE 200,049,091051,Vardy; Alexander,9999,0,9999,0
1653582670783,ECE 200,050,091052,Vasconcelos; Nuno,9999,0,9999,0
1653582670783,ECE 200,051,091053,Wang; Xiaolong,9999,0,9999,0
1653582670783,ECE 200,052,091054,Xie; Pengtao,9999,0,9999,0
1653582670783,ECE 200,053,091055,Yip; Michael,9999,0,9999,0
1653582670783,ECE 200,054,091056,Zeger; Kenneth A.,9999,0,9999,0
1653582670783,ECE 200,055,091057,Zhang; Xinyu,9999,0,9999,0
1653582670783,ECE 200,056,091058,Turakhia; Yatish Girish,9999,0,9999,0
1653582670783,ECE 200,057,091059,Kang; Mingu,9999,0,9999,0
1653582670783,ECE 200,058,091060,Shi; Yuanyuan,9999,0,9999,0
1653582670783,ECE 200,059,091061,Wang; Edward Jay,9999,0,9999,0
1653582670783,ECE 200,060,091062,Zheng; Yang,9999,0,9999,0
1653582671309,ECE 201,A00,095526,Lo; Yu-Hwa,0,0,0,0
1653582671842,ECE 203,A00,091065,Mercier; Patrick Philip,0,0,0,0
1653582672365,ECE 207A,A00,091605,Liu; Thomas Tao-Ming,0,0,0,0
1653582672888,ECE 212AN,A00,091068,Nomura; Kenji,0,0,0,0
1653582673410,ECE 222A,A00,091069,Rebeiz; Gabriel,0,0,0,0
1653582673938,ECE 225A,A00,091070,Orlitsky; Alon,0,0,0,0
1653582674464,ECE 230A,A00,091071,Nomura; Kenji,0,0,0,0
1653582674993,ECE 236A,A00,091072,Dayeh; Shadi Ahmad,0,0,0,0
1653582675519,ECE 238A,A00,091073,Luo; Jian,0,0,0,0
1653582675519,ECE 238A,B00,091074,Luo; Jian,0,0,0,0
1653582676043,ECE 240A,A00,091075,Radic; Stojan,0,0,0,0
1653582676566,ECE 247A,A00,091592,Shi; Lingyan,0,0,0,0
1653582677092,ECE 250,A00,091076,Touri; Behrouz,0,0,0,0
1653582677616,ECE 251C,A00,091078,Nguyen; Truong Quang,0,0,0,0
1653582678146,ECE 253,A00,091079,Cosman; Pamela C.,0,0,0,0
1653582678671,ECE 255A,A00,091080,Orlitsky; Alon,0,0,0,0
1653582679194,ECE 257A,A00,091081,Zhang; Xinyu,0,0,0,0
1653582679722,ECE 260A,A01,091084,Eldon; John,0,0,0,0
1653582680250,ECE 264C,A00,091085,Galton; Ian A,0,0,0,0
1653582680773,ECE 265C,A00,094889,Presti; Calogero Davide,0,0,0,9
1653582681297,ECE 266,A01,091087,Hall; Drew A.,0,0,0,0
1653582682353,ECE 271A,A00,091090,Vasconcelos; Nuno,0,0,0,0
1653582682884,ECE 272B,A00,091091,Sworder; David D.,0,0,0,0
1653582683414,ECE 275A,A00,091092,Meyer; Florian,0,0,0,0
1653582683940,ECE 277,A00,091093,An; Cheolhong,0,0,0,0
1653582684466,ECE 283,A00,091094,Le; Hanh-Phuc,0,0,0,0
1653582684987,ECE 284,A00,091095,Kang; Mingu,0,0,0,0
1653582684987,ECE 284,B00,091096,Wang; Edward Jay,0,0,0,0
1653582685511,ECE 285,A00,094334,Touri; Behrouz,0,0,0,0
1653582686034,ECE 289,A00,091097,Whelan; David Arthur,0,0,0,0
1653582686556,MATH 200A,A00,087414,Salehi Golsefidy; Alireza,7,0,8,1
1653582687087,MATH 202A,A00,087415,Gill; Philip E.,2,0,8,6
1653582687612,MATH 203A,A00,087416,Oprea; Dragos N.,6,0,8,2
1653582688141,MATH 204A,A00,087417,Kedlaya; Kiran S.,6,0,8,2
1653582688667,MATH 205,A00,087418,Sorensen; Claus M,6,0,8,2
1653582689190,MATH 206A,A00,087419,Izadi; Elham,7,0,8,1
1653582689716,MATH 207A,A00,087420,Mohammadi; Amir,5,0,8,3
1653582690241,MATH 208,A00,087421,Staff,9,0,10,1
1653582690770,MATH 209,A00,087422,Staff,10,0,10,0
1653582691304,MATH 218,A00,087423,Staff,10,0,10,0
1653582691833,MATH 220A,A00,087424,Novak; Jonathan I,6,0,8,2
1653582692355,MATH 231A,A00,087425,Bejenaru; Ioan,3,0,8,5
1653582692882,MATH 240A,A00,087426,Ebenfelt; Peter F,5,0,8,3
1653582693407,MATH 243,A00,087427,Staff,9,0,10,1
1653582693936,MATH 248,A00,087429,Staff,10,0,10,0
1653582694462,MATH 250A,A00,087430,Spolaor; Luca,4,0,8,4
1653582694991,MATH 257A,A00,087431,Spolaor; Luca,7,0,8,1
1653582695514,MATH 258,A00,087432,Staff,9,0,10,1
1653582696039,MATH 264A,A00,087433,Warnke; Lutz Peter,5,0,8,3
1653582696562,MATH 268,A00,087434,Staff,15,0,15,0
1653582697095,MATH 269,A00,087435,Staff,14,0,15,1
1653582697620,MATH 270A,A00,087436,Nie; Jiawang,0,0,8,8
1653582698142,MATH 272A,A00,087437,Tian; Xiaochuan,1,0,8,7
1653582698667,MATH 274,A01,087439,Cheng; Li-Tien,9,0,10,1
1653582698667,MATH 274,A02,087440,Cheng; Li-Tien,10,0,10,0
1653582699191,MATH 278A,A00,087441,Staff,8,0,10,2
1653582699713,MATH 278B,A00,087442,Staff,8,0,10,2
1653582700236,MATH 278C,A00,087443,Staff,8,0,10,2
1653582700758,MATH 280A,A00,087444,Zheng; Tianyi,0,0,8,8
1653582701284,MATH 281A,A00,087445,Bradic; Jelena,0,0,8,8
1653582701816,MATH 282A,A00,087446,Zhang; Danna,0,0,8,8
1653582702339,MATH 283,A00,087447,Tesler; Glenn,0,0,0,16
1653582702866,MATH 286,B00,095535,Kemp; Todd Aahron,8,0,8,0
1653582703391,MATH 287D,A00,087449,Bradic; Jelena,0,0,0,2
1653582703914,MATH 288,A00,087450,Staff,14,0,15,1
1653582703914,MATH 288,B00,087451,Staff,15,0,15,0
1653582703914,MATH 288,C00,087452,Staff,15,0,15,0
1653582704436,MATH 290A,A00,087453,Xu; Zhouli,6,0,8,2
1653582704961,MATH 291A,A00,087454,Xu; Zhouli,7,0,8,1
1653582705491,MATH 292,A00,087455,Staff,10,0,10,0
1653582706019,MATH 295,A00,087456,Staff,50,0,50,0
1653582706542,MATH 297,001,087457,Staff,998,0,999,1
1653583267783,COGS 200,A01,087991,Staff,47,0,50,3
1653583268317,COGS 201,A01,094504,Rangel; Lara M,16,0,25,9
1653583268862,COGS 203,A00,087992,Coulson; Seana M,18,0,20,2
1653583269409,COGS 210A,001,087993,Greene; Deanna Jacquelyn,9998,0,9999,1
1653583269409,COGS 210A,002,087994,Saygin; Ayse P,9999,0,9999,0
1653583269409,COGS 210A,003,087995,Xia; Haijun,9999,0,9999,0
1653583269409,COGS 210A,004,087996,Nitz; Douglas A.,9999,0,9999,0
1653583269409,COGS 210A,005,087997,Hollan; James D.,9999,0,9999,0
1653583269409,COGS 210A,006,087998,Deak; Gedeon O.,9998,0,9999,1
1653583269409,COGS 210A,007,087999,Rossano; Federico,9999,0,9999,0
1653583269943,COGS 211A,A00,088000,Coulson; Seana M,9997,0,9999,2
1653583270496,COGS 229,A00,088002,Staff,22,0,25,3
1653583271031,COGS 260,B00,094231,Staff,17,0,20,3
1653583271031,COGS 260,A00,088004,Nitz; Douglas A.,9998,0,9999,1
1653583271568,CSE 202,A00,090110,Paturi; Ramamohan,0,0,0,0
1653583271568,CSE 202,B00,090111,Paturi; Ramamohan,0,0,0,0
1653583272105,CSE 207B,A00,090112,Heninger; Nadia A,0,0,0,0
1653583272630,CSE 208,A00,094858,Micciancio; Daniele,0,0,0,0
1653583273153,CSE 210,A00,090113,Powell; Thomas Allan,0,0,0,0
1653583273687,CSE 219,A00,090898,Staff,0,0,0,0
1653583274210,CSE 221,A00,090114,Zhou; Yuan-Yuan,0,0,0,0
1653583274749,CSE 229A,A00,090115,Porter; George M,0,0,0,0
1653583275276,CSE 229C,A00,090116,Savage; Stefan,0,0,0,0
1653583275800,CSE 230,A00,090117,Jhala; Ranjit,0,0,0,0
1653583276326,CSE 232,A00,090118,Papakonstantinou; Yannis,0,0,0,0
1653583276847,CSE 239A,A00,090121,Kumar; Arun Kumar,0,0,0,0
1653583277370,CSE 239B,A00,090122,Jhala; Ranjit,0,0,0,0
1653583277895,CSE 240A,A00,090123,Zhao; Jishen,1,0,189,188
1653583278418,CSE 243A,A00,090124,Orailoglu; Alex,0,0,15,15
1653583278946,CSE 249B,A00,090125,Kahng; Andrew Byun,13,0,20,7
1653583279475,CSE 250A,A00,090126,Berg-Kirkpatrick; Taylor D,0,0,0,0
1653583279997,CSE 252A,A00,090127,Ochoa; Benjamin Lawrence,0,0,0,0
1653583280523,CSE 258,A01,090129,McAuley; Julian John,0,0,0,0
1653583281045,CSE 258R,A01,090131,McAuley; Julian John,0,0,0,0
1653583281569,CSE 274,A00,090132,Ramamoorthi; Ravi,0,0,0,0
1653583282094,CSE 276A,A00,090133,Christensen; Henrik I,0,0,0,0
1653583282627,CSE 276C,A00,090134,Christensen; Henrik I,0,0,0,0
1653583283153,CSE 290,A00,090135,Bafna; Vineet,0,0,0,0
1653583283153,CSE 290,B00,090136,Ramamoorthi; Ravi,0,0,0,0
1653583283153,CSE 290,C00,090137,Li; Tzumao,8,0,10,2
1653583283153,CSE 290,D00,090138,Zhou; Yuan-Yuan,9,0,10,1
1653583283153,CSE 290,E00,090139,Christensen; Henrik I,8,0,10,2
1653583283153,CSE 290,F00,094053,Shalev; Aaron D,0,0,0,0
1653583283678,CSE 291,A00,090140,Munyaka; Imani N. S.,0,0,0,0
1653583283678,CSE 291,B00,094880,Yu; Qi,0,0,0,0
1653583283678,CSE 291,C00,090142,Pannuto; Patrick William,0,0,0,0
1653583283678,CSE 291,D00,094881,Zhang; Yiying,0,0,0,0
1653583283678,CSE 291,E00,095118,Su; Hao,0,0,0,0
1653583284213,CSE 293,001,094905,Bafna; Vineet,9999,0,9999,0
1653583284213,CSE 293,002,094906,Bellare; Mihir,9999,0,9999,0
1653583284213,CSE 293,003,094907,Berg-Kirkpatrick; Taylor D,9999,0,9999,0
1653583284213,CSE 293,004,094908,Christensen; Henrik I,9999,0,9999,0
1653583284213,CSE 293,005,094909,Cottrell; Garrison W,9999,0,9999,0
1653583284213,CSE 293,006,094910,Deutsch; Alin Bernard,9999,0,9999,0
1653583284213,CSE 293,007,094911,Esmaeilzadeh; Hadi,9999,0,9999,0
1653583284213,CSE 293,008,094912,Freund; Yoav,9999,0,9999,0
1653583284213,CSE 293,009,094913,Griswold; William G.,9999,0,9999,0
1653583284213,CSE 293,010,094914,Gymrek; Melissa Ann,9999,0,9999,0
1653583284213,CSE 293,011,094915,Heninger; Nadia A,9999,0,9999,0
1653583284213,CSE 293,012,094916,Impagliazzo; Russell,9999,0,9999,0
1653583284213,CSE 293,013,094917,Jhala; Ranjit,9999,0,9999,0
1653583284213,CSE 293,014,094918,Kahng; Andrew Byun,9999,0,9999,0
1653583284213,CSE 293,015,094919,Kane; Daniel Mertz,9999,0,9999,0
1653583284213,CSE 293,016,094920,Kriegman; David J,9999,0,9999,0
1653583284213,CSE 293,017,094921,Kumar; Arun Kumar,9999,0,9999,0
1653583284213,CSE 293,018,094922,Lerner; Sorin,9999,0,9999,0
1653583284213,CSE 293,019,094923,Lovett; Shachar,9999,0,9999,0
1653583284213,CSE 293,020,094924,McAuley; Julian John,9999,0,9999,0
1653583284213,CSE 293,021,094925,Micciancio; Daniele,9999,0,9999,0
1653583284213,CSE 293,022,094926,Orailoglu; Alex,9999,0,9999,0
1653583284213,CSE 293,023,094927,Paturi; Ramamohan,9999,0,9999,0
1653583284213,CSE 293,024,094928,Polikarpova; Nadezhda,9999,0,9999,0
1653583284213,CSE 293,025,094929,Politz; Joseph Gibbs,9999,0,9999,0
1653583284213,CSE 293,026,094930,Porter; George M,9999,0,9999,0
1653583284213,CSE 293,027,094931,Porter; Leonard Emerson,9999,0,9999,0
1653583284213,CSE 293,028,094932,Ramamoorthi; Ravi,9999,0,9999,0
1653583284213,CSE 293,029,094933,Sahoo; Debashis,9999,0,9999,0
1653583284213,CSE 293,030,094934,Saul; Lawrence,9999,0,9999,0
1653583284213,CSE 293,031,094935,Savage; Stefan,9999,0,9999,0
1653583284213,CSE 293,032,094936,Schulze; Jurgen P.,9999,0,9999,0
1653583284213,CSE 293,033,094937,Snoeren; Alex C.,9999,0,9999,0
1653583284213,CSE 293,034,094938,Shang; Jingbo,9999,0,9999,0
1653583284213,CSE 293,035,094939,Stefan; Deian,9999,0,9999,0
1653583284213,CSE 293,036,094940,Su; Hao,9999,0,9999,0
1653583284213,CSE 293,037,094941,Swanson; Steven James,9999,0,9999,0
1653583284213,CSE 293,038,094942,Tullsen; Dean Michael,9999,0,9999,0
1653583284213,CSE 293,039,094943,Voelker; Geoffrey M.,9999,0,9999,0
1653583284213,CSE 293,040,094944,Zhao; Jishen,9999,0,9999,0
1653583284213,CSE 293,041,094945,Zhou; Yuan-Yuan,9999,0,9999,0
1653583284213,CSE 293,042,094946,Gao; Sicun,9998,0,9999,1
1653583284213,CSE 293,043,094947,Weibel; Nadir,9999,0,9999,0
1653583284213,CSE 293,044,094948,Gupta; Rajesh K.,9999,0,9999,0
1653583284737,CSE 294,A00,090143,Porter; George M,8,0,10,2
1653583285261,DSE 200,A00,091799,Staff,50,0,50,0
1653583285790,DSE 203,A00,091800,Gupta; Amarnath,30,0,30,0
1653583286317,DSE 250,A00,091801,Deutsch; Alin Bernard,30,0,30,0
1653583286848,DSE 290,A00,091802,Altintas De Callaf; Ilkay,50,0,50,0
1653583287414,ECE 200,001,091003,Antipa; Nicholas A,9999,0,9999,0
1653583287414,ECE 200,002,091004,Atanasov; Nikolay A.,9999,0,9999,0
1653583287414,ECE 200,003,091005,Bharadia; Dinesh,9999,0,9999,0
1653583287414,ECE 200,004,091006,Cheng; Chung Kuan,9999,0,9999,0
1653583287414,ECE 200,005,091007,Cosman; Pamela C.,9999,0,9999,0
1653583287414,ECE 200,006,091008,Staff,9999,0,9999,0
1653583287414,ECE 200,007,091009,Dayeh; Shadi Ahmad,9999,0,9999,0
1653583287414,ECE 200,008,091010,Fainman; Yeshaiahu,9999,0,9999,0
1653583287414,ECE 200,009,091011,Ford; Joseph Earl,9999,0,9999,0
1653583287414,ECE 200,010,091012,Franceschetti; Massimo,9999,0,9999,0
1653583287414,ECE 200,011,091013,Fullerton; Eric E,9999,0,9999,0
1653583287414,ECE 200,012,091014,Galton; Ian A,9999,0,9999,0
1653583287414,ECE 200,013,091015,Gilja; Vikash,9999,0,9999,0
1653583287414,ECE 200,014,091016,Hall; Drew A.,9999,0,9999,0
1653583287414,ECE 200,015,091017,Hsueh; Tzu-Chien,9999,0,9999,0
1653583287414,ECE 200,016,091018,Javidi; Tara,9999,0,9999,0
1653583287414,ECE 200,017,091019,Kahng; Andrew Byun,9999,0,9999,0
1653583287414,ECE 200,018,091020,Kim; Young-Han,9999,0,9999,0
1653583287414,ECE 200,019,091021,Koushanfar; Farinaz,9999,0,9999,0
1653583287414,ECE 200,020,091022,Kuzum; Duygu,9999,0,9999,0
1653583287414,ECE 200,021,091023,Le; Hanh-Phuc,9999,0,9999,0
1653583287414,ECE 200,022,091024,Lin; Bill,9999,0,9999,0
1653583287414,ECE 200,023,091025,Liu; Zhaowei,9999,0,9999,0
1653583287414,ECE 200,024,091026,Lo; Yu-Hwa,9999,0,9999,0
1653583287414,ECE 200,025,091027,Lomakin; Vitaliy,9999,0,9999,0
1653583287414,ECE 200,026,091028,Mercier; Patrick Philip,9999,0,9999,0
1653583287414,ECE 200,027,091029,Meyer; Florian,9999,0,9999,0
1653583287414,ECE 200,028,091030,Milstein; Laurence B.,9999,0,9999,0
1653583287414,ECE 200,029,091031,Mir Arabbaygi; Siavash,9999,0,9999,0
1653583287414,ECE 200,030,091032,Mookherjea; Shayan,9999,0,9999,0
1653583287414,ECE 200,031,091033,Morris; Karcher William,9999,0,9999,0
1653583287414,ECE 200,032,091034,Ng; Tse Nga,9999,0,9999,0
1653583287414,ECE 200,033,091035,Nguyen; Truong Quang,9999,0,9999,0
1653583287414,ECE 200,034,091036,Nomura; Kenji,9999,0,9999,0
1653583287414,ECE 200,035,091037,Orlitsky; Alon,9999,0,9999,0
1653583287414,ECE 200,036,091038,Pal; Piya,9999,0,9999,0
1653583287414,ECE 200,037,091039,Papen; George C.,9999,0,9999,0
1653583287414,ECE 200,038,091040,Radic; Stojan,9999,0,9999,0
1653583287414,ECE 200,039,091041,Rao; Bhaskar D.,9999,0,9999,0
1653583287414,ECE 200,040,091042,Rao; Ramesh R,9999,0,9999,0
1653583287414,ECE 200,041,091043,Rebeiz; Gabriel,9999,0,9999,0
1653583287414,ECE 200,042,091044,Sanford; John R,9999,0,9999,0
1653583287414,ECE 200,043,091045,Siegel; Paul H.,9999,0,9999,0
1653583287414,ECE 200,044,091046,Sievenpiper; Daniel F.,9999,0,9999,0
1653583287414,ECE 200,045,091047,Sworder; David D.,9999,0,9999,0
1653583287414,ECE 200,046,091048,Taur; Yuan,9999,0,9999,0
1653583287414,ECE 200,047,091049,Touri; Behrouz,9999,0,9999,0
1653583287414,ECE 200,048,091050,Trivedi; Mohan M.,9999,0,9999,0
1653583287414,ECE 200,049,091051,Vardy; Alexander,9999,0,9999,0
1653583287414,ECE 200,050,091052,Vasconcelos; Nuno,9999,0,9999,0
1653583287414,ECE 200,051,091053,Wang; Xiaolong,9999,0,9999,0
1653583287414,ECE 200,052,091054,Xie; Pengtao,9999,0,9999,0
1653583287414,ECE 200,053,091055,Yip; Michael,9999,0,9999,0
1653583287414,ECE 200,054,091056,Zeger; Kenneth A.,9999,0,9999,0
1653583287414,ECE 200,055,091057,Zhang; Xinyu,9999,0,9999,0
1653583287414,ECE 200,056,091058,Turakhia; Yatish Girish,9999,0,9999,0
1653583287414,ECE 200,057,091059,Kang; Mingu,9999,0,9999,0
1653583287414,ECE 200,058,091060,Shi; Yuanyuan,9999,0,9999,0
1653583287414,ECE 200,059,091061,Wang; Edward Jay,9999,0,9999,0
1653583287414,ECE 200,060,091062,Zheng; Yang,9999,0,9999,0
1653583287942,ECE 201,A00,095526,Lo; Yu-Hwa,0,0,0,0
1653583288469,ECE 203,A00,091065,Mercier; Patrick Philip,0,0,0,0
1653583289058,ECE 207A,A00,091605,Liu; Thomas Tao-Ming,0,0,0,0
1653583289586,ECE 212AN,A00,091068,Nomura; Kenji,0,0,0,0
1653583290110,ECE 222A,A00,091069,Rebeiz; Gabriel,0,0,0,0
1653583290638,ECE 225A,A00,091070,Orlitsky; Alon,0,0,0,0
1653583291164,ECE 230A,A00,091071,Nomura; Kenji,0,0,0,0
1653583291697,ECE 236A,A00,091072,Dayeh; Shadi Ahmad,0,0,0,0
1653583292226,ECE 238A,A00,091073,Luo; Jian,0,0,0,0
1653583292226,ECE 238A,B00,091074,Luo; Jian,0,0,0,0
1653583292750,ECE 240A,A00,091075,Radic; Stojan,0,0,0,0
1653583293278,ECE 247A,A00,091592,Shi; Lingyan,0,0,0,0
1653583293807,ECE 250,A00,091076,Touri; Behrouz,0,0,0,0
1653583294338,ECE 251C,A00,091078,Nguyen; Truong Quang,0,0,0,0
1653583294861,ECE 253,A00,091079,Cosman; Pamela C.,0,0,0,0
1653583295386,ECE 255A,A00,091080,Orlitsky; Alon,0,0,0,0
1653583295911,ECE 257A,A00,091081,Zhang; Xinyu,0,0,0,0
1653583296434,ECE 260A,A01,091084,Eldon; John,0,0,0,0
1653583296967,ECE 264C,A00,091085,Galton; Ian A,0,0,0,0
1653583297490,ECE 265C,A00,094889,Presti; Calogero Davide,0,0,0,9
1653583298019,ECE 266,A01,091087,Hall; Drew A.,0,0,0,0
1653583299070,ECE 271A,A00,091090,Vasconcelos; Nuno,0,0,0,0
1653583299594,ECE 272B,A00,091091,Sworder; David D.,0,0,0,0
1653583300121,ECE 275A,A00,091092,Meyer; Florian,0,0,0,0
1653583300643,ECE 277,A00,091093,An; Cheolhong,0,0,0,0
1653583301165,ECE 283,A00,091094,Le; Hanh-Phuc,0,0,0,0
1653583301694,ECE 284,A00,091095,Kang; Mingu,0,0,0,0
1653583301694,ECE 284,B00,091096,Wang; Edward Jay,0,0,0,0
1653583302215,ECE 285,A00,094334,Touri; Behrouz,0,0,0,0
1653583302743,ECE 289,A00,091097,Whelan; David Arthur,0,0,0,0
1653583303274,MATH 200A,A00,087414,Salehi Golsefidy; Alireza,7,0,8,1
1653583303797,MATH 202A,A00,087415,Gill; Philip E.,2,0,8,6
1653583304319,MATH 203A,A00,087416,Oprea; Dragos N.,6,0,8,2
1653583304842,MATH 204A,A00,087417,Kedlaya; Kiran S.,6,0,8,2
1653583305367,MATH 205,A00,087418,Sorensen; Claus M,6,0,8,2
1653583305893,MATH 206A,A00,087419,Izadi; Elham,7,0,8,1
1653583306416,MATH 207A,A00,087420,Mohammadi; Amir,5,0,8,3
1653583306938,MATH 208,A00,087421,Staff,9,0,10,1
1653583307461,MATH 209,A00,087422,Staff,10,0,10,0
1653583308058,MATH 218,A00,087423,Staff,10,0,10,0
1653583308588,MATH 220A,A00,087424,Novak; Jonathan I,6,0,8,2
1653583309110,MATH 231A,A00,087425,Bejenaru; Ioan,3,0,8,5
1653583309648,MATH 240A,A00,087426,Ebenfelt; Peter F,5,0,8,3
1653583310172,MATH 243,A00,087427,Staff,9,0,10,1
1653583310703,MATH 248,A00,087429,Staff,10,0,10,0
1653583311233,MATH 250A,A00,087430,Spolaor; Luca,4,0,8,4
1653583311754,MATH 257A,A00,087431,Spolaor; Luca,7,0,8,1
1653583312278,MATH 258,A00,087432,Staff,9,0,10,1
1653583312804,MATH 264A,A00,087433,Warnke; Lutz Peter,5,0,8,3
1653583313333,MATH 268,A00,087434,Staff,15,0,15,0
1653583313857,MATH 269,A00,087435,Staff,14,0,15,1
1653583314383,MATH 270A,A00,087436,Nie; Jiawang,0,0,8,8
1653583314909,MATH 272A,A00,087437,Tian; Xiaochuan,1,0,8,7
1653583315432,MATH 274,A01,087439,Cheng; Li-Tien,9,0,10,1
1653583315432,MATH 274,A02,087440,Cheng; Li-Tien,10,0,10,0
1653583315954,MATH 278A,A00,087441,Staff,8,0,10,2
1653583316477,MATH 278B,A00,087442,Staff,8,0,10,2
1653583316998,MATH 278C,A00,087443,Staff,8,0,10,2
1653583317532,MATH 280A,A00,087444,Zheng; Tianyi,0,0,8,8
1653583318062,MATH 281A,A00,087445,Bradic; Jelena,0,0,8,8
1653583318583,MATH 282A,A00,087446,Zhang; Danna,0,0,8,8
1653583319110,MATH 283,A00,087447,Tesler; Glenn,0,0,0,16
1653583319633,MATH 286,B00,095535,Kemp; Todd Aahron,0,0,0,0
1653583320157,MATH 287D,A00,087449,Bradic; Jelena,0,0,0,1
1653583320687,MATH 288,A00,087450,Staff,14,0,15,1
1653583320687,MATH 288,B00,087451,Staff,15,0,15,0
1653583320687,MATH 288,C00,087452,Staff,15,0,15,0
1653583321218,MATH 290A,A00,087453,Xu; Zhouli,6,0,8,2
1653583321745,MATH 291A,A00,087454,Xu; Zhouli,7,0,8,1
1653583322273,MATH 292,A00,087455,Staff,10,0,10,0
1653583322795,MATH 295,A00,087456,Staff,50,0,50,0
1653583323319,MATH 297,001,087457,Staff,998,0,999,1
1653583884307,COGS 200,A01,087991,Staff,47,0,50,3
1653583884830,COGS 201,A01,094504,Rangel; Lara M,16,0,25,9
1653583885367,COGS 203,A00,087992,Coulson; Seana M,18,0,20,2
1653583885897,COGS 210A,001,087993,Greene; Deanna Jacquelyn,9998,0,9999,1
1653583885897,COGS 210A,002,087994,Saygin; Ayse P,9999,0,9999,0
1653583885897,COGS 210A,003,087995,Xia; Haijun,9999,0,9999,0
1653583885897,COGS 210A,004,087996,Nitz; Douglas A.,9999,0,9999,0
1653583885897,COGS 210A,005,087997,Hollan; James D.,9999,0,9999,0
1653583885897,COGS 210A,006,087998,Deak; Gedeon O.,9998,0,9999,1
1653583885897,COGS 210A,007,087999,Rossano; Federico,9999,0,9999,0
1653583886418,COGS 211A,A00,088000,Coulson; Seana M,9997,0,9999,2
1653583886942,COGS 229,A00,088002,Staff,22,0,25,3
1653583887467,COGS 260,B00,094231,Staff,17,0,20,3
1653583887467,COGS 260,A00,088004,Nitz; Douglas A.,9998,0,9999,1
1653583887991,CSE 202,A00,090110,Paturi; Ramamohan,0,0,0,0
1653583887991,CSE 202,B00,090111,Paturi; Ramamohan,0,0,0,0
1653583888513,CSE 207B,A00,090112,Heninger; Nadia A,0,0,0,0
1653583889036,CSE 208,A00,094858,Micciancio; Daniele,0,0,0,0
1653583889560,CSE 210,A00,090113,Powell; Thomas Allan,0,0,0,0
1653583890083,CSE 219,A00,090898,Staff,0,0,0,0
1653583890609,CSE 221,A00,090114,Zhou; Yuan-Yuan,0,0,0,0
1653583891132,CSE 229A,A00,090115,Porter; George M,0,0,0,0
1653583891665,CSE 229C,A00,090116,Savage; Stefan,0,0,0,0
1653583892191,CSE 230,A00,090117,Jhala; Ranjit,0,0,0,0
1653583892717,CSE 232,A00,090118,Papakonstantinou; Yannis,0,0,0,0
1653583893240,CSE 239A,A00,090121,Kumar; Arun Kumar,0,0,0,0
1653583893762,CSE 239B,A00,090122,Jhala; Ranjit,0,0,0,0
1653583894288,CSE 240A,A00,090123,Zhao; Jishen,1,0,189,188
1653583894817,CSE 243A,A00,090124,Orailoglu; Alex,0,0,15,15
1653583895341,CSE 249B,A00,090125,Kahng; Andrew Byun,13,0,20,7
1653583895868,CSE 250A,A00,090126,Berg-Kirkpatrick; Taylor D,0,0,0,0
1653583896488,CSE 252A,A00,090127,Ochoa; Benjamin Lawrence,0,0,0,0
1653583897035,CSE 258,A01,090129,McAuley; Julian John,0,0,0,0
1653583897560,CSE 258R,A01,090131,McAuley; Julian John,0,0,0,0
1653583898107,CSE 274,A00,090132,Ramamoorthi; Ravi,0,0,0,0
1653583898636,CSE 276A,A00,090133,Christensen; Henrik I,0,0,0,0
1653583899160,CSE 276C,A00,090134,Christensen; Henrik I,0,0,0,0
1653583899698,CSE 290,A00,090135,Bafna; Vineet,0,0,0,0
1653583899698,CSE 290,B00,090136,Ramamoorthi; Ravi,0,0,0,0
1653583899698,CSE 290,C00,090137,Li; Tzumao,8,0,10,2
1653583899698,CSE 290,D00,090138,Zhou; Yuan-Yuan,9,0,10,1
1653583899698,CSE 290,E00,090139,Christensen; Henrik I,8,0,10,2
1653583899698,CSE 290,F00,094053,Shalev; Aaron D,0,0,0,0
1653583900226,CSE 291,A00,090140,Munyaka; Imani N. S.,0,0,0,0
1653583900226,CSE 291,B00,094880,Yu; Qi,0,0,0,0
1653583900226,CSE 291,C00,090142,Pannuto; Patrick William,0,0,0,0
1653583900226,CSE 291,D00,094881,Zhang; Yiying,0,0,0,0
1653583900226,CSE 291,E00,095118,Su; Hao,0,0,0,0
1653583900756,CSE 293,001,094905,Bafna; Vineet,9999,0,9999,0
1653583900756,CSE 293,002,094906,Bellare; Mihir,9999,0,9999,0
1653583900756,CSE 293,003,094907,Berg-Kirkpatrick; Taylor D,9999,0,9999,0
1653583900756,CSE 293,004,094908,Christensen; Henrik I,9999,0,9999,0
1653583900756,CSE 293,005,094909,Cottrell; Garrison W,9999,0,9999,0
1653583900756,CSE 293,006,094910,Deutsch; Alin Bernard,9999,0,9999,0
1653583900756,CSE 293,007,094911,Esmaeilzadeh; Hadi,9999,0,9999,0
1653583900756,CSE 293,008,094912,Freund; Yoav,9999,0,9999,0
1653583900756,CSE 293,009,094913,Griswold; William G.,9999,0,9999,0
1653583900756,CSE 293,010,094914,Gymrek; Melissa Ann,9999,0,9999,0
1653583900756,CSE 293,011,094915,Heninger; Nadia A,9999,0,9999,0
1653583900756,CSE 293,012,094916,Impagliazzo; Russell,9999,0,9999,0
1653583900756,CSE 293,013,094917,Jhala; Ranjit,9999,0,9999,0
1653583900756,CSE 293,014,094918,Kahng; Andrew Byun,9999,0,9999,0
1653583900756,CSE 293,015,094919,Kane; Daniel Mertz,9999,0,9999,0
1653583900756,CSE 293,016,094920,Kriegman; David J,9999,0,9999,0
1653583900756,CSE 293,017,094921,Kumar; Arun Kumar,9999,0,9999,0
1653583900756,CSE 293,018,094922,Lerner; Sorin,9999,0,9999,0
1653583900756,CSE 293,019,094923,Lovett; Shachar,9999,0,9999,0
1653583900756,CSE 293,020,094924,McAuley; Julian John,9999,0,9999,0
1653583900756,CSE 293,021,094925,Micciancio; Daniele,9999,0,9999,0
1653583900756,CSE 293,022,094926,Orailoglu; Alex,9999,0,9999,0
1653583900756,CSE 293,023,094927,Paturi; Ramamohan,9999,0,9999,0
1653583900756,CSE 293,024,094928,Polikarpova; Nadezhda,9999,0,9999,0
1653583900756,CSE 293,025,094929,Politz; Joseph Gibbs,9999,0,9999,0
1653583900756,CSE 293,026,094930,Porter; George M,9999,0,9999,0
1653583900756,CSE 293,027,094931,Porter; Leonard Emerson,9999,0,9999,0
1653583900756,CSE 293,028,094932,Ramamoorthi; Ravi,9999,0,9999,0
1653583900756,CSE 293,029,094933,Sahoo; Debashis,9999,0,9999,0
1653583900756,CSE 293,030,094934,Saul; Lawrence,9999,0,9999,0
1653583900756,CSE 293,031,094935,Savage; Stefan,9999,0,9999,0
1653583900756,CSE 293,032,094936,Schulze; Jurgen P.,9999,0,9999,0
1653583900756,CSE 293,033,094937,Snoeren; Alex C.,9999,0,9999,0
1653583900756,CSE 293,034,094938,Shang; Jingbo,9999,0,9999,0
1653583900756,CSE 293,035,094939,Stefan; Deian,9999,0,9999,0
1653583900756,CSE 293,036,094940,Su; Hao,9999,0,9999,0
1653583900756,CSE 293,037,094941,Swanson; Steven James,9999,0,9999,0
1653583900756,CSE 293,038,094942,Tullsen; Dean Michael,9999,0,9999,0
1653583900756,CSE 293,039,094943,Voelker; Geoffrey M.,9999,0,9999,0
1653583900756,CSE 293,040,094944,Zhao; Jishen,9999,0,9999,0
1653583900756,CSE 293,041,094945,Zhou; Yuan-Yuan,9999,0,9999,0
1653583900756,CSE 293,042,094946,Gao; Sicun,9998,0,9999,1
1653583900756,CSE 293,043,094947,Weibel; Nadir,9999,0,9999,0
1653583900756,CSE 293,044,094948,Gupta; Rajesh K.,9999,0,9999,0
1653583901280,CSE 294,A00,090143,Porter; George M,8,0,10,2
1653583901806,DSE 200,A00,091799,Staff,50,0,50,0
1653583902334,DSE 203,A00,091800,Gupta; Amarnath,30,0,30,0
1653583902859,DSE 250,A00,091801,Deutsch; Alin Bernard,30,0,30,0
1653583903382,DSE 290,A00,091802,Altintas De Callaf; Ilkay,50,0,50,0
1653583903930,ECE 200,001,091003,Antipa; Nicholas A,9999,0,9999,0
1653583903930,ECE 200,002,091004,Atanasov; Nikolay A.,9999,0,9999,0
1653583903930,ECE 200,003,091005,Bharadia; Dinesh,9999,0,9999,0
1653583903930,ECE 200,004,091006,Cheng; Chung Kuan,9999,0,9999,0
1653583903930,ECE 200,005,091007,Cosman; Pamela C.,9999,0,9999,0
1653583903930,ECE 200,006,091008,Staff,9999,0,9999,0
1653583903930,ECE 200,007,091009,Dayeh; Shadi Ahmad,9999,0,9999,0
1653583903930,ECE 200,008,091010,Fainman; Yeshaiahu,9999,0,9999,0
1653583903930,ECE 200,009,091011,Ford; Joseph Earl,9999,0,9999,0
1653583903930,ECE 200,010,091012,Franceschetti; Massimo,9999,0,9999,0
1653583903930,ECE 200,011,091013,Fullerton; Eric E,9999,0,9999,0
1653583903930,ECE 200,012,091014,Galton; Ian A,9999,0,9999,0
1653583903930,ECE 200,013,091015,Gilja; Vikash,9999,0,9999,0
1653583903930,ECE 200,014,091016,Hall; Drew A.,9999,0,9999,0
1653583903930,ECE 200,015,091017,Hsueh; Tzu-Chien,9999,0,9999,0
1653583903930,ECE 200,016,091018,Javidi; Tara,9999,0,9999,0
1653583903930,ECE 200,017,091019,Kahng; Andrew Byun,9999,0,9999,0
1653583903930,ECE 200,018,091020,Kim; Young-Han,9999,0,9999,0
1653583903930,ECE 200,019,091021,Koushanfar; Farinaz,9999,0,9999,0
1653583903930,ECE 200,020,091022,Kuzum; Duygu,9999,0,9999,0
1653583903930,ECE 200,021,091023,Le; Hanh-Phuc,9999,0,9999,0
1653583903930,ECE 200,022,091024,Lin; Bill,9999,0,9999,0
1653583903930,ECE 200,023,091025,Liu; Zhaowei,9999,0,9999,0
1653583903930,ECE 200,024,091026,Lo; Yu-Hwa,9999,0,9999,0
1653583903930,ECE 200,025,091027,Lomakin; Vitaliy,9999,0,9999,0
1653583903930,ECE 200,026,091028,Mercier; Patrick Philip,9999,0,9999,0
1653583903930,ECE 200,027,091029,Meyer; Florian,9999,0,9999,0
1653583903930,ECE 200,028,091030,Milstein; Laurence B.,9999,0,9999,0
1653583903930,ECE 200,029,091031,Mir Arabbaygi; Siavash,9999,0,9999,0
1653583903930,ECE 200,030,091032,Mookherjea; Shayan,9999,0,9999,0
1653583903930,ECE 200,031,091033,Morris; Karcher William,9999,0,9999,0
1653583903930,ECE 200,032,091034,Ng; Tse Nga,9999,0,9999,0
1653583903930,ECE 200,033,091035,Nguyen; Truong Quang,9999,0,9999,0
1653583903930,ECE 200,034,091036,Nomura; Kenji,9999,0,9999,0
1653583903930,ECE 200,035,091037,Orlitsky; Alon,9999,0,9999,0
1653583903930,ECE 200,036,091038,Pal; Piya,9999,0,9999,0
1653583903930,ECE 200,037,091039,Papen; George C.,9999,0,9999,0
1653583903930,ECE 200,038,091040,Radic; Stojan,9999,0,9999,0
1653583903930,ECE 200,039,091041,Rao; Bhaskar D.,9999,0,9999,0
1653583903930,ECE 200,040,091042,Rao; Ramesh R,9999,0,9999,0
1653583903930,ECE 200,041,091043,Rebeiz; Gabriel,9999,0,9999,0
1653583903930,ECE 200,042,091044,Sanford; John R,9999,0,9999,0
1653583903930,ECE 200,043,091045,Siegel; Paul H.,9999,0,9999,0
1653583903930,ECE 200,044,091046,Sievenpiper; Daniel F.,9999,0,9999,0
1653583903930,ECE 200,045,091047,Sworder; David D.,9999,0,9999,0
1653583903930,ECE 200,046,091048,Taur; Yuan,9999,0,9999,0
1653583903930,ECE 200,047,091049,Touri; Behrouz,9999,0,9999,0
1653583903930,ECE 200,048,091050,Trivedi; Mohan M.,9999,0,9999,0
1653583903930,ECE 200,049,091051,Vardy; Alexander,9999,0,9999,0
1653583903930,ECE 200,050,091052,Vasconcelos; Nuno,9999,0,9999,0
1653583903930,ECE 200,051,091053,Wang; Xiaolong,9999,0,9999,0
1653583903930,ECE 200,052,091054,Xie; Pengtao,9999,0,9999,0
1653583903930,ECE 200,053,091055,Yip; Michael,9999,0,9999,0
1653583903930,ECE 200,054,091056,Zeger; Kenneth A.,9999,0,9999,0
1653583903930,ECE 200,055,091057,Zhang; Xinyu,9999,0,9999,0
1653583903930,ECE 200,056,091058,Turakhia; Yatish Girish,9999,0,9999,0
1653583903930,ECE 200,057,091059,Kang; Mingu,9999,0,9999,0
1653583903930,ECE 200,058,091060,Shi; Yuanyuan,9999,0,9999,0
1653583903930,ECE 200,059,091061,Wang; Edward Jay,9999,0,9999,0
1653583903930,ECE 200,060,091062,Zheng; Yang,9999,0,9999,0
1653583904459,ECE 201,A00,095526,Lo; Yu-Hwa,0,0,0,0
1653583904982,ECE 203,A00,091065,Mercier; Patrick Philip,0,0,0,0
1653583905504,ECE 207A,A00,091605,Liu; Thomas Tao-Ming,0,0,0,0
1653583906031,ECE 212AN,A00,091068,Nomura; Kenji,0,0,0,0
1653583906553,ECE 222A,A00,091069,Rebeiz; Gabriel,0,0,0,0
1653583907081,ECE 225A,A00,091070,Orlitsky; Alon,0,0,0,0
1653583907615,ECE 230A,A00,091071,Nomura; Kenji,0,0,0,0
1653583908136,ECE 236A,A00,091072,Dayeh; Shadi Ahmad,0,0,0,0
1653583908671,ECE 238A,A00,091073,Luo; Jian,0,0,0,0
1653583908671,ECE 238A,B00,091074,Luo; Jian,0,0,0,0
1653583909203,ECE 240A,A00,091075,Radic; Stojan,0,0,0,0
1653583909734,ECE 247A,A00,091592,Shi; Lingyan,0,0,0,0
1653583910265,ECE 250,A00,091076,Touri; Behrouz,0,0,0,0
1653583910794,ECE 251C,A00,091078,Nguyen; Truong Quang,0,0,0,0
1653583911321,ECE 253,A00,091079,Cosman; Pamela C.,0,0,0,0
1653583911850,ECE 255A,A00,091080,Orlitsky; Alon,0,0,0,0
1653583912377,ECE 257A,A00,091081,Zhang; Xinyu,0,0,0,0
1653583912898,ECE 260A,A01,091084,Eldon; John,0,0,0,0
1653583913431,ECE 264C,A00,091085,Galton; Ian A,0,0,0,0
1653583913957,ECE 265C,A00,094889,Presti; Calogero Davide,0,0,0,9
1653583914481,ECE 266,A01,091087,Hall; Drew A.,0,0,0,0
1653583915532,ECE 271A,A00,091090,Vasconcelos; Nuno,0,0,0,0
1653583916066,ECE 272B,A00,091091,Sworder; David D.,0,0,0,0
1653583916593,ECE 275A,A00,091092,Meyer; Florian,0,0,0,0
1653583917118,ECE 277,A00,091093,An; Cheolhong,0,0,0,0
1653583917645,ECE 283,A00,091094,Le; Hanh-Phuc,0,0,0,0
1653583918180,ECE 284,A00,091095,Kang; Mingu,0,0,0,0
1653583918180,ECE 284,B00,091096,Wang; Edward Jay,0,0,0,0
1653583918715,ECE 285,A00,094334,Touri; Behrouz,0,0,0,0
1653583919243,ECE 289,A00,091097,Whelan; David Arthur,0,0,0,0
1653583919765,MATH 200A,A00,087414,Salehi Golsefidy; Alireza,7,0,8,1
1653583920288,MATH 202A,A00,087415,Gill; Philip E.,2,0,8,6
1653583920813,MATH 203A,A00,087416,Oprea; Dragos N.,6,0,8,2
1653583921338,MATH 204A,A00,087417,Kedlaya; Kiran S.,6,0,8,2
1653583921879,MATH 205,A00,087418,Sorensen; Claus M,6,0,8,2
1653583922403,MATH 206A,A00,087419,Izadi; Elham,7,0,8,1
1653583922926,MATH 207A,A00,087420,Mohammadi; Amir,5,0,8,3
1653583923459,MATH 208,A00,087421,Staff,9,0,10,1
1653583923984,MATH 209,A00,087422,Staff,10,0,10,0
1653583924506,MATH 218,A00,087423,Staff,10,0,10,0
1653583925029,MATH 220A,A00,087424,Novak; Jonathan I,6,0,8,2
1653583925554,MATH 231A,A00,087425,Bejenaru; Ioan,3,0,8,5
1653583926079,MATH 240A,A00,087426,Ebenfelt; Peter F,5,0,8,3
1653583926605,MATH 243,A00,087427,Staff,9,0,10,1
1653583927134,MATH 248,A00,087429,Staff,10,0,10,0
1653583927669,MATH 250A,A00,087430,Spolaor; Luca,4,0,8,4
1653583928192,MATH 257A,A00,087431,Spolaor; Luca,7,0,8,1
1653583928715,MATH 258,A00,087432,Staff,9,0,10,1
1653583929239,MATH 264A,A00,087433,Warnke; Lutz Peter,5,0,8,3
1653583929764,MATH 268,A00,087434,Staff,15,0,15,0
1653583930287,MATH 269,A00,087435,Staff,14,0,15,1
1653583930811,MATH 270A,A00,087436,Nie; Jiawang,0,0,8,8
1653583931341,MATH 272A,A00,087437,Tian; Xiaochuan,1,0,8,7
1653583931872,MATH 274,A01,087439,Cheng; Li-Tien,9,0,10,1
1653583931872,MATH 274,A02,087440,Cheng; Li-Tien,10,0,10,0
1653583932398,MATH 278A,A00,087441,Staff,8,0,10,2
1653583932923,MATH 278B,A00,087442,Staff,8,0,10,2
1653583933449,MATH 278C,A00,087443,Staff,8,0,10,2
1653583933975,MATH 280A,A00,087444,Zheng; Tianyi,0,0,8,8
1653583934510,MATH 281A,A00,087445,Bradic; Jelena,0,0,8,8
1653583935033,MATH 282A,A00,087446,Zhang; Danna,0,0,8,8
1653583935565,MATH 283,A00,087447,Tesler; Glenn,0,0,0,16
1653583936092,MATH 286,B00,095535,Kemp; Todd Aahron,0,0,0,0
1653583936621,MATH 287D,B00,095536,Bradic; Jelena,8,0,8,0
1653583937142,MATH 288,A00,087450,Staff,14,0,15,1
1653583937142,MATH 288,B00,087451,Staff,15,0,15,0
1653583937142,MATH 288,C00,087452,Staff,15,0,15,0
1653583937668,MATH 290A,A00,087453,Xu; Zhouli,6,0,8,2
1653583938199,MATH 291A,A00,087454,Xu; Zhouli,7,0,8,1
1653583938724,MATH 292,A00,087455,Staff,10,0,10,0
1653583939249,MATH 295,A00,087456,Staff,50,0,50,0
1653583939774,MATH 297,001,087457,Staff,998,0,999,1
1653584500526,COGS 200,A01,087991,Staff,47,0,50,3
1653584501052,COGS 201,A01,094504,Rangel; Lara M,16,0,25,9
1653584501576,COGS 203,A00,087992,Coulson; Seana M,18,0,20,2
1653584502100,COGS 210A,001,087993,Greene; Deanna Jacquelyn,9998,0,9999,1
1653584502100,COGS 210A,002,087994,Saygin; Ayse P,9999,0,9999,0
1653584502100,COGS 210A,003,087995,Xia; Haijun,9999,0,9999,0
1653584502100,COGS 210A,004,087996,Nitz; Douglas A.,9999,0,9999,0
1653584502100,COGS 210A,005,087997,Hollan; James D.,9999,0,9999,0
1653584502100,COGS 210A,006,087998,Deak; Gedeon O.,9998,0,9999,1
1653584502100,COGS 210A,007,087999,Rossano; Federico,9999,0,9999,0
1653584502622,COGS 211A,A00,088000,Coulson; Seana M,9997,0,9999,2
1653584503144,COGS 229,A00,088002,Staff,22,0,25,3
1653584503670,COGS 260,B00,094231,Staff,17,0,20,3
1653584503670,COGS 260,A00,088004,Nitz; Douglas A.,9998,0,9999,1
1653584504198,CSE 202,A00,090110,Paturi; Ramamohan,0,0,0,0
1653584504198,CSE 202,B00,090111,Paturi; Ramamohan,0,0,0,0
1653584504720,CSE 207B,A00,090112,Heninger; Nadia A,0,0,0,0
1653584505250,CSE 208,A00,094858,Micciancio; Daniele,0,0,0,0
1653584505772,CSE 210,A00,090113,Powell; Thomas Allan,0,0,0,0
1653584506307,CSE 219,A00,090898,Staff,0,0,0,0
1653584506830,CSE 221,A00,090114,Zhou; Yuan-Yuan,0,0,0,0
1653584507355,CSE 229A,A00,090115,Porter; George M,0,0,0,0
1653584507893,CSE 229C,A00,090116,Savage; Stefan,0,0,0,0
1653584508419,CSE 230,A00,090117,Jhala; Ranjit,0,0,0,0
1653584508943,CSE 232,A00,090118,Papakonstantinou; Yannis,0,0,0,0
1653584509465,CSE 239A,A00,090121,Kumar; Arun Kumar,0,0,0,0
1653584509989,CSE 239B,A00,090122,Jhala; Ranjit,0,0,0,0
1653584510542,CSE 240A,A00,090123,Zhao; Jishen,1,0,189,188
1653584511065,CSE 243A,A00,090124,Orailoglu; Alex,0,0,15,15
1653584511592,CSE 249B,A00,090125,Kahng; Andrew Byun,13,0,20,7
1653584512114,CSE 250A,A00,090126,Berg-Kirkpatrick; Taylor D,0,0,0,0
1653584512640,CSE 252A,A00,090127,Ochoa; Benjamin Lawrence,0,0,0,0
1653584513167,CSE 258,A01,090129,McAuley; Julian John,0,0,0,0
1653584513690,CSE 258R,A01,090131,McAuley; Julian John,0,0,0,0
1653584514226,CSE 274,A00,090132,Ramamoorthi; Ravi,0,0,0,0
1653584514749,CSE 276A,A00,090133,Christensen; Henrik I,0,0,0,0
1653584515280,CSE 276C,A00,090134,Christensen; Henrik I,0,0,0,0
1653584515802,CSE 290,A00,090135,Bafna; Vineet,0,0,0,0
1653584515802,CSE 290,B00,090136,Ramamoorthi; Ravi,0,0,0,0
1653584515802,CSE 290,C00,090137,Li; Tzumao,8,0,10,2
1653584515802,CSE 290,D00,090138,Zhou; Yuan-Yuan,9,0,10,1
1653584515802,CSE 290,E00,090139,Christensen; Henrik I,8,0,10,2
1653584515802,CSE 290,F00,094053,Shalev; Aaron D,0,0,0,0
1653584516335,CSE 291,A00,090140,Munyaka; Imani N. S.,0,0,0,0
1653584516335,CSE 291,B00,094880,Yu; Qi,0,0,0,0
1653584516335,CSE 291,C00,090142,Pannuto; Patrick William,0,0,0,0
1653584516335,CSE 291,D00,094881,Zhang; Yiying,0,0,0,0
1653584516335,CSE 291,E00,095118,Su; Hao,0,0,0,0
1653584516872,CSE 293,001,094905,Bafna; Vineet,9999,0,9999,0
1653584516872,CSE 293,002,094906,Bellare; Mihir,9999,0,9999,0
1653584516872,CSE 293,003,094907,Berg-Kirkpatrick; Taylor D,9999,0,9999,0
1653584516872,CSE 293,004,094908,Christensen; Henrik I,9999,0,9999,0
1653584516872,CSE 293,005,094909,Cottrell; Garrison W,9999,0,9999,0
1653584516872,CSE 293,006,094910,Deutsch; Alin Bernard,9999,0,9999,0
1653584516872,CSE 293,007,094911,Esmaeilzadeh; Hadi,9999,0,9999,0
1653584516872,CSE 293,008,094912,Freund; Yoav,9999,0,9999,0
1653584516872,CSE 293,009,094913,Griswold; William G.,9999,0,9999,0
1653584516872,CSE 293,010,094914,Gymrek; Melissa Ann,9999,0,9999,0
1653584516872,CSE 293,011,094915,Heninger; Nadia A,9999,0,9999,0
1653584516872,CSE 293,012,094916,Impagliazzo; Russell,9999,0,9999,0
1653584516872,CSE 293,013,094917,Jhala; Ranjit,9999,0,9999,0
1653584516872,CSE 293,014,094918,Kahng; Andrew Byun,9999,0,9999,0
1653584516872,CSE 293,015,094919,Kane; Daniel Mertz,9999,0,9999,0
1653584516872,CSE 293,016,094920,Kriegman; David J,9999,0,9999,0
1653584516872,CSE 293,017,094921,Kumar; Arun Kumar,9999,0,9999,0
1653584516872,CSE 293,018,094922,Lerner; Sorin,9999,0,9999,0
1653584516872,CSE 293,019,094923,Lovett; Shachar,9999,0,9999,0
1653584516872,CSE 293,020,094924,McAuley; Julian John,9999,0,9999,0
1653584516872,CSE 293,021,094925,Micciancio; Daniele,9999,0,9999,0
1653584516872,CSE 293,022,094926,Orailoglu; Alex,9999,0,9999,0
1653584516872,CSE 293,023,094927,Paturi; Ramamohan,9999,0,9999,0
1653584516872,CSE 293,024,094928,Polikarpova; Nadezhda,9999,0,9999,0
1653584516872,CSE 293,025,094929,Politz; Joseph Gibbs,9999,0,9999,0
1653584516872,CSE 293,026,094930,Porter; George M,9999,0,9999,0
1653584516872,CSE 293,027,094931,Porter; Leonard Emerson,9999,0,9999,0
1653584516872,CSE 293,028,094932,Ramamoorthi; Ravi,9999,0,9999,0
1653584516872,CSE 293,029,094933,Sahoo; Debashis,9999,0,9999,0
1653584516872,CSE 293,030,094934,Saul; Lawrence,9999,0,9999,0
1653584516872,CSE 293,031,094935,Savage; Stefan,9999,0,9999,0
1653584516872,CSE 293,032,094936,Schulze; Jurgen P.,9999,0,9999,0
1653584516872,CSE 293,033,094937,Snoeren; Alex C.,9999,0,9999,0
1653584516872,CSE 293,034,094938,Shang; Jingbo,9999,0,9999,0
1653584516872,CSE 293,035,094939,Stefan; Deian,9999,0,9999,0
1653584516872,CSE 293,036,094940,Su; Hao,9999,0,9999,0
1653584516872,CSE 293,037,094941,Swanson; Steven James,9999,0,9999,0
1653584516872,CSE 293,038,094942,Tullsen; Dean Michael,9999,0,9999,0
1653584516872,CSE 293,039,094943,Voelker; Geoffrey M.,9999,0,9999,0
1653584516872,CSE 293,040,094944,Zhao; Jishen,9999,0,9999,0
1653584516872,CSE 293,041,094945,Zhou; Yuan-Yuan,9999,0,9999,0
1653584516872,CSE 293,042,094946,Gao; Sicun,9998,0,9999,1
1653584516872,CSE 293,043,094947,Weibel; Nadir,9999,0,9999,0
1653584516872,CSE 293,044,094948,Gupta; Rajesh K.,9999,0,9999,0
1653584517398,CSE 294,A00,090143,Porter; George M,8,0,10,2
1653584517923,DSE 200,A00,091799,Staff,50,0,50,0
1653584518448,DSE 203,A00,091800,Gupta; Amarnath,30,0,30,0
1653584518974,DSE 250,A00,091801,Deutsch; Alin Bernard,30,0,30,0
1653584519499,DSE 290,A00,091802,Altintas De Callaf; Ilkay,50,0,50,0
1653584520028,ECE 200,001,091003,Antipa; Nicholas A,9999,0,9999,0
1653584520028,ECE 200,002,091004,Atanasov; Nikolay A.,9999,0,9999,0
1653584520028,ECE 200,003,091005,Bharadia; Dinesh,9999,0,9999,0
1653584520028,ECE 200,004,091006,Cheng; Chung Kuan,9999,0,9999,0
1653584520028,ECE 200,005,091007,Cosman; Pamela C.,9999,0,9999,0
1653584520028,ECE 200,006,091008,Staff,9999,0,9999,0
1653584520028,ECE 200,007,091009,Dayeh; Shadi Ahmad,9999,0,9999,0
1653584520028,ECE 200,008,091010,Fainman; Yeshaiahu,9999,0,9999,0
1653584520028,ECE 200,009,091011,Ford; Joseph Earl,9999,0,9999,0
1653584520028,ECE 200,010,091012,Franceschetti; Massimo,9999,0,9999,0
1653584520028,ECE 200,011,091013,Fullerton; Eric E,9999,0,9999,0
1653584520028,ECE 200,012,091014,Galton; Ian A,9999,0,9999,0
1653584520028,ECE 200,013,091015,Gilja; Vikash,9999,0,9999,0
1653584520028,ECE 200,014,091016,Hall; Drew A.,9999,0,9999,0
1653584520028,ECE 200,015,091017,Hsueh; Tzu-Chien,9999,0,9999,0
1653584520028,ECE 200,016,091018,Javidi; Tara,9999,0,9999,0
1653584520028,ECE 200,017,091019,Kahng; Andrew Byun,9999,0,9999,0
1653584520028,ECE 200,018,091020,Kim; Young-Han,9999,0,9999,0
1653584520028,ECE 200,019,091021,Koushanfar; Farinaz,9999,0,9999,0
1653584520028,ECE 200,020,091022,Kuzum; Duygu,9999,0,9999,0
1653584520028,ECE 200,021,091023,Le; Hanh-Phuc,9999,0,9999,0
1653584520028,ECE 200,022,091024,Lin; Bill,9999,0,9999,0
1653584520028,ECE 200,023,091025,Liu; Zhaowei,9999,0,9999,0
1653584520028,ECE 200,024,091026,Lo; Yu-Hwa,9999,0,9999,0
1653584520028,ECE 200,025,091027,Lomakin; Vitaliy,9999,0,9999,0
1653584520028,ECE 200,026,091028,Mercier; Patrick Philip,9999,0,9999,0
1653584520028,ECE 200,027,091029,Meyer; Florian,9999,0,9999,0
1653584520028,ECE 200,028,091030,Milstein; Laurence B.,9999,0,9999,0
1653584520028,ECE 200,029,091031,Mir Arabbaygi; Siavash,9999,0,9999,0
1653584520028,ECE 200,030,091032,Mookherjea; Shayan,9999,0,9999,0
1653584520028,ECE 200,031,091033,Morris; Karcher William,9999,0,9999,0
1653584520028,ECE 200,032,091034,Ng; Tse Nga,9999,0,9999,0
1653584520028,ECE 200,033,091035,Nguyen; Truong Quang,9999,0,9999,0
1653584520028,ECE 200,034,091036,Nomura; Kenji,9999,0,9999,0
1653584520028,ECE 200,035,091037,Orlitsky; Alon,9999,0,9999,0
1653584520028,ECE 200,036,091038,Pal; Piya,9999,0,9999,0
1653584520028,ECE 200,037,091039,Papen; George C.,9999,0,9999,0
1653584520028,ECE 200,038,091040,Radic; Stojan,9999,0,9999,0
1653584520028,ECE 200,039,091041,Rao; Bhaskar D.,9999,0,9999,0
1653584520028,ECE 200,040,091042,Rao; Ramesh R,9999,0,9999,0
1653584520028,ECE 200,041,091043,Rebeiz; Gabriel,9999,0,9999,0
1653584520028,ECE 200,042,091044,Sanford; John R,9999,0,9999,0
1653584520028,ECE 200,043,091045,Siegel; Paul H.,9999,0,9999,0
1653584520028,ECE 200,044,091046,Sievenpiper; Daniel F.,9999,0,9999,0
1653584520028,ECE 200,045,091047,Sworder; David D.,9999,0,9999,0
1653584520028,ECE 200,046,091048,Taur; Yuan,9999,0,9999,0
1653584520028,ECE 200,047,091049,Touri; Behrouz,9999,0,9999,0
1653584520028,ECE 200,048,091050,Trivedi; Mohan M.,9999,0,9999,0
1653584520028,ECE 200,049,091051,Vardy; Alexander,9999,0,9999,0
1653584520028,ECE 200,050,091052,Vasconcelos; Nuno,9999,0,9999,0
1653584520028,ECE 200,051,091053,Wang; Xiaolong,9999,0,9999,0
1653584520028,ECE 200,052,091054,Xie; Pengtao,9999,0,9999,0
1653584520028,ECE 200,053,091055,Yip; Michael,9999,0,9999,0
1653584520028,ECE 200,054,091056,Zeger; Kenneth A.,9999,0,9999,0
1653584520028,ECE 200,055,091057,Zhang; Xinyu,9999,0,9999,0
1653584520028,ECE 200,056,091058,Turakhia; Yatish Girish,9999,0,9999,0
1653584520028,ECE 200,057,091059,Kang; Mingu,9999,0,9999,0
1653584520028,ECE 200,058,091060,Shi; Yuanyuan,9999,0,9999,0
1653584520028,ECE 200,059,091061,Wang; Edward Jay,9999,0,9999,0
1653584520028,ECE 200,060,091062,Zheng; Yang,9999,0,9999,0
1653584520566,ECE 201,A00,095526,Lo; Yu-Hwa,0,0,0,0
1653584521097,ECE 203,A00,091065,Mercier; Patrick Philip,0,0,0,0
1653584521623,ECE 207A,A00,091605,Liu; Thomas Tao-Ming,0,0,0,0
1653584522148,ECE 212AN,A00,091068,Nomura; Kenji,0,0,0,0
1653584522674,ECE 222A,A00,091069,Rebeiz; Gabriel,0,0,0,0
1653584523207,ECE 225A,A00,091070,Orlitsky; Alon,0,0,0,0
1653584523730,ECE 230A,A00,091071,Nomura; Kenji,0,0,0,0
1653584524254,ECE 236A,A00,091072,Dayeh; Shadi Ahmad,0,0,0,0
1653584524808,ECE 238A,A00,091073,Luo; Jian,0,0,0,0
1653584524808,ECE 238A,B00,091074,Luo; Jian,0,0,0,0
1653584525344,ECE 240A,A00,091075,Radic; Stojan,0,0,0,0
1653584525874,ECE 247A,A00,091592,Shi; Lingyan,0,0,0,0
1653584526434,ECE 250,A00,091076,Touri; Behrouz,0,0,0,0
1653584526956,ECE 251C,A00,091078,Nguyen; Truong Quang,0,0,0,0
1653584527480,ECE 253,A00,091079,Cosman; Pamela C.,0,0,0,0
1653584528095,ECE 255A,A00,091080,Orlitsky; Alon,0,0,0,0
1653584528626,ECE 257A,A00,091081,Zhang; Xinyu,0,0,0,0
1653584529174,ECE 260A,A01,091084,Eldon; John,0,0,0,0
1653584529700,ECE 264C,A00,091085,Galton; Ian A,0,0,0,0
1653584530235,ECE 265C,A00,094889,Presti; Calogero Davide,0,0,0,9
1653584530775,ECE 266,A01,091087,Hall; Drew A.,0,0,0,0
1653584531840,ECE 271A,A00,091090,Vasconcelos; Nuno,0,0,0,0
1653584532375,ECE 272B,A00,091091,Sworder; David D.,0,0,0,0
1653584532907,ECE 275A,A00,091092,Meyer; Florian,0,0,0,0
1653584533434,ECE 277,A00,091093,An; Cheolhong,0,0,0,0
1653584533958,ECE 283,A00,091094,Le; Hanh-Phuc,0,0,0,0
1653584534486,ECE 284,A00,091095,Kang; Mingu,0,0,0,0
1653584534486,ECE 284,B00,091096,Wang; Edward Jay,0,0,0,0
1653584535010,ECE 285,A00,094334,Touri; Behrouz,0,0,0,0
1653584535534,ECE 289,A00,091097,Whelan; David Arthur,0,0,0,0
1653584536056,MATH 200A,A00,087414,Salehi Golsefidy; Alireza,7,0,8,1
1653584536583,MATH 202A,A00,087415,Gill; Philip E.,2,0,8,6
1653584537106,MATH 203A,A00,087416,Oprea; Dragos N.,6,0,8,2
1653584537638,MATH 204A,A00,087417,Kedlaya; Kiran S.,6,0,8,2
1653584538232,MATH 205,A00,087418,Sorensen; Claus M,6,0,8,2
1653584538759,MATH 206A,A00,087419,Izadi; Elham,7,0,8,1
1653584539283,MATH 207A,A00,087420,Mohammadi; Amir,5,0,8,3
1653584539807,MATH 208,A00,087421,Staff,9,0,10,1
1653584540333,MATH 209,A00,087422,Staff,10,0,10,0
1653584540861,MATH 218,A00,087423,Staff,10,0,10,0
1653584541399,MATH 220A,A00,087424,Novak; Jonathan I,6,0,8,2
1653584541927,MATH 231A,A00,087425,Bejenaru; Ioan,3,0,8,5
1653584542453,MATH 240A,A00,087426,Ebenfelt; Peter F,5,0,8,3
1653584542974,MATH 243,A00,087427,Staff,9,0,10,1
1653584543500,MATH 248,A00,087429,Staff,10,0,10,0
1653584544031,MATH 250A,A00,087430,Spolaor; Luca,4,0,8,4
1653584544558,MATH 257A,A00,087431,Spolaor; Luca,7,0,8,1
1653584545083,MATH 258,A00,087432,Staff,9,0,10,1
1653584545611,MATH 264A,A00,087433,Warnke; Lutz Peter,5,0,8,3
1653584546145,MATH 268,A00,087434,Staff,15,0,15,0
1653584546668,MATH 269,A00,087435,Staff,14,0,15,1
1653584547196,MATH 270A,A00,087436,Nie; Jiawang,0,0,8,8
1653584547726,MATH 272A,A00,087437,Tian; Xiaochuan,1,0,8,7
1653584548249,MATH 274,A01,087439,Cheng; Li-Tien,9,0,10,1
1653584548249,MATH 274,A02,087440,Cheng; Li-Tien,10,0,10,0
1653584548778,MATH 278A,A00,087441,Staff,8,0,10,2
1653584549302,MATH 278B,A00,087442,Staff,8,0,10,2
1653584549830,MATH 278C,A00,087443,Staff,8,0,10,2
1653584550352,MATH 280A,A00,087444,Zheng; Tianyi,0,0,8,8
1653584550875,MATH 281A,A00,087445,Bradic; Jelena,0,0,8,8
1653584551417,MATH 282A,A00,087446,Zhang; Danna,0,0,8,8
1653584551947,MATH 283,A00,087447,Tesler; Glenn,0,0,0,16
1653584552470,MATH 286,B00,095535,Kemp; Todd Aahron,0,0,0,0
1653584553017,MATH 287D,B00,095536,Bradic; Jelena,8,0,8,0
1653584553542,MATH 288,A00,087450,Staff,14,0,15,1
1653584553542,MATH 288,B00,087451,Staff,15,0,15,0
1653584553542,MATH 288,C00,087452,Staff,15,0,15,0
1653584554075,MATH 290A,A00,087453,Xu; Zhouli,6,0,8,2
1653584554603,MATH 291A,A00,087454,Xu; Zhouli,7,0,8,1
1653584555126,MATH 292,A00,087455,Staff,10,0,10,0
1653584555651,MATH 295,A00,087456,Staff,50,0,50,0
1653584556172,MATH 297,001,087457,Staff,998,0,999,1
1653585118799,COGS 200,A01,087991,Staff,47,0,50,3
1653585119321,COGS 201,A01,094504,Rangel; Lara M,16,0,25,9
1653585119855,COGS 203,A00,087992,Coulson; Seana M,18,0,20,2
1653585120385,COGS 210A,001,087993,Greene; Deanna Jacquelyn,9998,0,9999,1
1653585120385,COGS 210A,002,087994,Saygin; Ayse P,9999,0,9999,0
1653585120385,COGS 210A,003,087995,Xia; Haijun,9999,0,9999,0
1653585120385,COGS 210A,004,087996,Nitz; Douglas A.,9999,0,9999,0
1653585120385,COGS 210A,005,087997,Hollan; James D.,9999,0,9999,0
1653585120385,COGS 210A,006,087998,Deak; Gedeon O.,9998,0,9999,1
1653585120385,COGS 210A,007,087999,Rossano; Federico,9999,0,9999,0
1653585120919,COGS 211A,A00,088000,Coulson; Seana M,9997,0,9999,2
1653585121440,COGS 229,A00,088002,Staff,22,0,25,3
1653585121975,COGS 260,B00,094231,Staff,17,0,20,3
1653585121975,COGS 260,A00,088004,Nitz; Douglas A.,9998,0,9999,1
1653585122500,CSE 202,A00,090110,Paturi; Ramamohan,0,0,0,0
1653585122500,CSE 202,B00,090111,Paturi; Ramamohan,0,0,0,0
1653585123026,CSE 207B,A00,090112,Heninger; Nadia A,0,0,0,0
1653585123549,CSE 208,A00,094858,Micciancio; Daniele,0,0,0,0
1653585124080,CSE 210,A00,090113,Powell; Thomas Allan,0,0,0,0
1653585124609,CSE 219,A00,090898,Staff,0,0,0,0
1653585125131,CSE 221,A00,090114,Zhou; Yuan-Yuan,0,0,0,0
1653585125665,CSE 229A,A00,090115,Porter; George M,0,0,0,0
1653585126193,CSE 229C,A00,090116,Savage; Stefan,0,0,0,0
1653585126717,CSE 230,A00,090117,Jhala; Ranjit,0,0,0,0
1653585127241,CSE 232,A00,090118,Papakonstantinou; Yannis,0,0,0,0
1653585127764,CSE 239A,A00,090121,Kumar; Arun Kumar,0,0,0,0
1653585128365,CSE 239B,A00,090122,Jhala; Ranjit,0,0,0,0
1653585128888,CSE 240A,A00,090123,Zhao; Jishen,1,0,189,188
1653585129419,CSE 243A,A00,090124,Orailoglu; Alex,0,0,15,15
1653585129948,CSE 249B,A00,090125,Kahng; Andrew Byun,13,0,20,7
1653585130472,CSE 250A,A00,090126,Berg-Kirkpatrick; Taylor D,0,0,0,0
1653585131005,CSE 252A,A00,090127,Ochoa; Benjamin Lawrence,0,0,0,0
1653585131528,CSE 258,A01,090129,McAuley; Julian John,0,0,0,0
1653585132052,CSE 258R,A01,090131,McAuley; Julian John,0,0,0,0
1653585132581,CSE 274,A00,090132,Ramamoorthi; Ravi,0,0,0,0
1653585133112,CSE 276A,A00,090133,Christensen; Henrik I,0,0,0,0
1653585133635,CSE 276C,A00,090134,Christensen; Henrik I,0,0,0,0
1653585134161,CSE 290,A00,090135,Bafna; Vineet,0,0,0,0
1653585134161,CSE 290,B00,090136,Ramamoorthi; Ravi,0,0,0,0
1653585134161,CSE 290,C00,090137,Li; Tzumao,8,0,10,2
1653585134161,CSE 290,D00,090138,Zhou; Yuan-Yuan,9,0,10,1
1653585134161,CSE 290,E00,090139,Christensen; Henrik I,8,0,10,2
1653585134161,CSE 290,F00,094053,Shalev; Aaron D,0,0,0,0
1653585134688,CSE 291,A00,090140,Munyaka; Imani N. S.,0,0,0,0
1653585134688,CSE 291,B00,094880,Yu; Qi,0,0,0,0
1653585134688,CSE 291,C00,090142,Pannuto; Patrick William,0,0,0,0
1653585134688,CSE 291,D00,094881,Zhang; Yiying,0,0,0,0
1653585134688,CSE 291,E00,095118,Su; Hao,0,0,0,0
1653585135231,CSE 293,001,094905,Bafna; Vineet,9999,0,9999,0
1653585135231,CSE 293,002,094906,Bellare; Mihir,9999,0,9999,0
1653585135231,CSE 293,003,094907,Berg-Kirkpatrick; Taylor D,9999,0,9999,0
1653585135231,CSE 293,004,094908,Christensen; Henrik I,9999,0,9999,0
1653585135231,CSE 293,005,094909,Cottrell; Garrison W,9999,0,9999,0
1653585135231,CSE 293,006,094910,Deutsch; Alin Bernard,9999,0,9999,0
1653585135231,CSE 293,007,094911,Esmaeilzadeh; Hadi,9999,0,9999,0
1653585135231,CSE 293,008,094912,Freund; Yoav,9999,0,9999,0
1653585135231,CSE 293,009,094913,Griswold; William G.,9999,0,9999,0
1653585135231,CSE 293,010,094914,Gymrek; Melissa Ann,9999,0,9999,0
1653585135231,CSE 293,011,094915,Heninger; Nadia A,9999,0,9999,0
1653585135231,CSE 293,012,094916,Impagliazzo; Russell,9999,0,9999,0
1653585135231,CSE 293,013,094917,Jhala; Ranjit,9999,0,9999,0
1653585135231,CSE 293,014,094918,Kahng; Andrew Byun,9999,0,9999,0
1653585135231,CSE 293,015,094919,Kane; Daniel Mertz,9999,0,9999,0
1653585135231,CSE 293,016,094920,Kriegman; David J,9999,0,9999,0
1653585135231,CSE 293,017,094921,Kumar; Arun Kumar,9999,0,9999,0
1653585135231,CSE 293,018,094922,Lerner; Sorin,9999,0,9999,0
1653585135231,CSE 293,019,094923,Lovett; Shachar,9999,0,9999,0
1653585135231,CSE 293,020,094924,McAuley; Julian John,9999,0,9999,0
1653585135231,CSE 293,021,094925,Micciancio; Daniele,9999,0,9999,0
1653585135231,CSE 293,022,094926,Orailoglu; Alex,9999,0,9999,0
1653585135231,CSE 293,023,094927,Paturi; Ramamohan,9999,0,9999,0
1653585135231,CSE 293,024,094928,Polikarpova; Nadezhda,9999,0,9999,0
1653585135231,CSE 293,025,094929,Politz; Joseph Gibbs,9999,0,9999,0
1653585135231,CSE 293,026,094930,Porter; George M,9999,0,9999,0
1653585135231,CSE 293,027,094931,Porter; Leonard Emerson,9999,0,9999,0
1653585135231,CSE 293,028,094932,Ramamoorthi; Ravi,9999,0,9999,0
1653585135231,CSE 293,029,094933,Sahoo; Debashis,9999,0,9999,0
1653585135231,CSE 293,030,094934,Saul; Lawrence,9999,0,9999,0
1653585135231,CSE 293,031,094935,Savage; Stefan,9999,0,9999,0
1653585135231,CSE 293,032,094936,Schulze; Jurgen P.,9999,0,9999,0
1653585135231,CSE 293,033,094937,Snoeren; Alex C.,9999,0,9999,0
1653585135231,CSE 293,034,094938,Shang; Jingbo,9999,0,9999,0
1653585135231,CSE 293,035,094939,Stefan; Deian,9999,0,9999,0
1653585135231,CSE 293,036,094940,Su; Hao,9999,0,9999,0
1653585135231,CSE 293,037,094941,Swanson; Steven James,9999,0,9999,0
1653585135231,CSE 293,038,094942,Tullsen; Dean Michael,9999,0,9999,0
1653585135231,CSE 293,039,094943,Voelker; Geoffrey M.,9999,0,9999,0
1653585135231,CSE 293,040,094944,Zhao; Jishen,9999,0,9999,0
1653585135231,CSE 293,041,094945,Zhou; Yuan-Yuan,9999,0,9999,0
1653585135231,CSE 293,042,094946,Gao; Sicun,9998,0,9999,1
1653585135231,CSE 293,043,094947,Weibel; Nadir,9999,0,9999,0
1653585135231,CSE 293,044,094948,Gupta; Rajesh K.,9999,0,9999,0
1653585135757,CSE 294,A00,090143,Porter; George M,8,0,10,2
1653585136282,DSE 200,A00,091799,Staff,50,0,50,0
1653585136807,DSE 203,A00,091800,Gupta; Amarnath,30,0,30,0
1653585137335,DSE 250,A00,091801,Deutsch; Alin Bernard,30,0,30,0
1653585137862,DSE 290,A00,091802,Altintas De Callaf; Ilkay,50,0,50,0
1653585138400,ECE 200,001,091003,Antipa; Nicholas A,9999,0,9999,0
1653585138400,ECE 200,002,091004,Atanasov; Nikolay A.,9999,0,9999,0
1653585138400,ECE 200,003,091005,Bharadia; Dinesh,9999,0,9999,0
1653585138400,ECE 200,004,091006,Cheng; Chung Kuan,9999,0,9999,0
1653585138400,ECE 200,005,091007,Cosman; Pamela C.,9999,0,9999,0
1653585138400,ECE 200,006,091008,Staff,9999,0,9999,0
1653585138400,ECE 200,007,091009,Dayeh; Shadi Ahmad,9999,0,9999,0
1653585138400,ECE 200,008,091010,Fainman; Yeshaiahu,9999,0,9999,0
1653585138400,ECE 200,009,091011,Ford; Joseph Earl,9999,0,9999,0
1653585138400,ECE 200,010,091012,Franceschetti; Massimo,9999,0,9999,0
1653585138400,ECE 200,011,091013,Fullerton; Eric E,9999,0,9999,0
1653585138400,ECE 200,012,091014,Galton; Ian A,9999,0,9999,0
1653585138400,ECE 200,013,091015,Gilja; Vikash,9999,0,9999,0
1653585138400,ECE 200,014,091016,Hall; Drew A.,9999,0,9999,0
1653585138400,ECE 200,015,091017,Hsueh; Tzu-Chien,9999,0,9999,0
1653585138400,ECE 200,016,091018,Javidi; Tara,9999,0,9999,0
1653585138400,ECE 200,017,091019,Kahng; Andrew Byun,9999,0,9999,0
1653585138400,ECE 200,018,091020,Kim; Young-Han,9999,0,9999,0
1653585138400,ECE 200,019,091021,Koushanfar; Farinaz,9999,0,9999,0
1653585138400,ECE 200,020,091022,Kuzum; Duygu,9999,0,9999,0
1653585138400,ECE 200,021,091023,Le; Hanh-Phuc,9999,0,9999,0
1653585138400,ECE 200,022,091024,Lin; Bill,9999,0,9999,0
1653585138400,ECE 200,023,091025,Liu; Zhaowei,9999,0,9999,0
1653585138400,ECE 200,024,091026,Lo; Yu-Hwa,9999,0,9999,0
1653585138400,ECE 200,025,091027,Lomakin; Vitaliy,9999,0,9999,0
1653585138400,ECE 200,026,091028,Mercier; Patrick Philip,9999,0,9999,0
1653585138400,ECE 200,027,091029,Meyer; Florian,9999,0,9999,0
1653585138400,ECE 200,028,091030,Milstein; Laurence B.,9999,0,9999,0
1653585138400,ECE 200,029,091031,Mir Arabbaygi; Siavash,9999,0,9999,0
1653585138400,ECE 200,030,091032,Mookherjea; Shayan,9999,0,9999,0
1653585138400,ECE 200,031,091033,Morris; Karcher William,9999,0,9999,0
1653585138400,ECE 200,032,091034,Ng; Tse Nga,9999,0,9999,0
1653585138400,ECE 200,033,091035,Nguyen; Truong Quang,9999,0,9999,0
1653585138400,ECE 200,034,091036,Nomura; Kenji,9999,0,9999,0
1653585138400,ECE 200,035,091037,Orlitsky; Alon,9999,0,9999,0
1653585138400,ECE 200,036,091038,Pal; Piya,9999,0,9999,0
1653585138400,ECE 200,037,091039,Papen; George C.,9999,0,9999,0
1653585138400,ECE 200,038,091040,Radic; Stojan,9999,0,9999,0
1653585138400,ECE 200,039,091041,Rao; Bhaskar D.,9999,0,9999,0
1653585138400,ECE 200,040,091042,Rao; Ramesh R,9999,0,9999,0
1653585138400,ECE 200,041,091043,Rebeiz; Gabriel,9999,0,9999,0
1653585138400,ECE 200,042,091044,Sanford; John R,9999,0,9999,0
1653585138400,ECE 200,043,091045,Siegel; Paul H.,9999,0,9999,0
1653585138400,ECE 200,044,091046,Sievenpiper; Daniel F.,9999,0,9999,0
1653585138400,ECE 200,045,091047,Sworder; David D.,9999,0,9999,0
1653585138400,ECE 200,046,091048,Taur; Yuan,9999,0,9999,0
1653585138400,ECE 200,047,091049,Touri; Behrouz,9999,0,9999,0
1653585138400,ECE 200,048,091050,Trivedi; Mohan M.,9999,0,9999,0
1653585138400,ECE 200,049,091051,Vardy; Alexander,9999,0,9999,0
1653585138400,ECE 200,050,091052,Vasconcelos; Nuno,9999,0,9999,0
1653585138400,ECE 200,051,091053,Wang; Xiaolong,9999,0,9999,0
1653585138400,ECE 200,052,091054,Xie; Pengtao,9999,0,9999,0
1653585138400,ECE 200,053,091055,Yip; Michael,9999,0,9999,0
1653585138400,ECE 200,054,091056,Zeger; Kenneth A.,9999,0,9999,0
1653585138400,ECE 200,055,091057,Zhang; Xinyu,9999,0,9999,0
1653585138400,ECE 200,056,091058,Turakhia; Yatish Girish,9999,0,9999,0
1653585138400,ECE 200,057,091059,Kang; Mingu,9999,0,9999,0
1653585138400,ECE 200,058,091060,Shi; Yuanyuan,9999,0,9999,0
1653585138400,ECE 200,059,091061,Wang; Edward Jay,9999,0,9999,0
1653585138400,ECE 200,060,091062,Zheng; Yang,9999,0,9999,0
1653585138923,ECE 201,A00,095526,Lo; Yu-Hwa,0,0,0,0
1653585139449,ECE 203,A00,091065,Mercier; Patrick Philip,0,0,0,0
1653585139976,ECE 207A,A00,091605,Liu; Thomas Tao-Ming,0,0,0,0
1653585140498,ECE 212AN,A00,091068,Nomura; Kenji,0,0,0,0
1653585141025,ECE 222A,A00,091069,Rebeiz; Gabriel,0,0,0,0
1653585141558,ECE 225A,A00,091070,Orlitsky; Alon,0,0,0,0
1653585142084,ECE 230A,A00,091071,Nomura; Kenji,0,0,0,0
1653585142608,ECE 236A,A00,091072,Dayeh; Shadi Ahmad,0,0,0,0
1653585143134,ECE 238A,A00,091073,Luo; Jian,0,0,0,0
1653585143134,ECE 238A,B00,091074,Luo; Jian,0,0,0,0
1653585143658,ECE 240A,A00,091075,Radic; Stojan,0,0,0,0
1653585144183,ECE 247A,A00,091592,Shi; Lingyan,0,0,0,0
1653585144708,ECE 250,A00,091076,Touri; Behrouz,0,0,0,0
1653585145232,ECE 251C,A00,091078,Nguyen; Truong Quang,0,0,0,0
1653585145755,ECE 253,A00,091079,Cosman; Pamela C.,0,0,0,0
1653585146276,ECE 255A,A00,091080,Orlitsky; Alon,0,0,0,0
1653585146797,ECE 257A,A00,091081,Zhang; Xinyu,0,0,0,0
1653585147334,ECE 260A,A01,091084,Eldon; John,0,0,0,0
1653585147856,ECE 264C,A00,091085,Galton; Ian A,0,0,0,0
1653585148378,ECE 265C,A00,094889,Presti; Calogero Davide,0,0,0,9
1653585148900,ECE 266,A01,091087,Hall; Drew A.,0,0,0,0
1653585149946,ECE 271A,A00,091090,Vasconcelos; Nuno,0,0,0,0
1653585150469,ECE 272B,A00,091091,Sworder; David D.,0,0,0,0
1653585150999,ECE 275A,A00,091092,Meyer; Florian,0,0,0,0
1653585151522,ECE 277,A00,091093,An; Cheolhong,0,0,0,0
1653585152045,ECE 283,A00,091094,Le; Hanh-Phuc,0,0,0,0
1653585152573,ECE 284,A00,091095,Kang; Mingu,0,0,0,0
1653585152573,ECE 284,B00,091096,Wang; Edward Jay,0,0,0,0
1653585153106,ECE 285,A00,094334,Touri; Behrouz,0,0,0,0
1653585153632,ECE 289,A00,091097,Whelan; David Arthur,0,0,0,0
1653585154158,MATH 200A,A00,087414,Salehi Golsefidy; Alireza,7,0,8,1
1653585154681,MATH 202A,A00,087415,Gill; Philip E.,2,0,8,6
1653585155204,MATH 203A,A00,087416,Oprea; Dragos N.,6,0,8,2
1653585155726,MATH 204A,A00,087417,Kedlaya; Kiran S.,6,0,8,2
1653585156248,MATH 205,A00,087418,Sorensen; Claus M,6,0,8,2
1653585156772,MATH 206A,A00,087419,Izadi; Elham,7,0,8,1
1653585157299,MATH 207A,A00,087420,Mohammadi; Amir,5,0,8,3
1653585157826,MATH 208,A00,087421,Staff,9,0,10,1
1653585158348,MATH 209,A00,087422,Staff,10,0,10,0
1653585158872,MATH 218,A00,087423,Staff,10,0,10,0
1653585159395,MATH 220A,A00,087424,Novak; Jonathan I,6,0,8,2
1653585159927,MATH 231A,A00,087425,Bejenaru; Ioan,3,0,8,5
1653585160452,MATH 240A,A00,087426,Ebenfelt; Peter F,5,0,8,3
1653585160982,MATH 243,A00,087427,Staff,9,0,10,1
1653585161506,MATH 248,A00,087429,Staff,10,0,10,0
1653585162032,MATH 250A,A00,087430,Spolaor; Luca,4,0,8,4
1653585162559,MATH 257A,A00,087431,Spolaor; Luca,7,0,8,1
1653585163093,MATH 258,A00,087432,Staff,9,0,10,1
1653585163627,MATH 264A,A00,087433,Warnke; Lutz Peter,5,0,8,3
1653585164150,MATH 268,A00,087434,Staff,15,0,15,0
1653585164687,MATH 269,A00,087435,Staff,14,0,15,1
1653585165211,MATH 270A,A00,087436,Nie; Jiawang,0,0,8,8
1653585165734,MATH 272A,A00,087437,Tian; Xiaochuan,1,0,8,7
1653585166261,MATH 274,A01,087439,Cheng; Li-Tien,9,0,10,1
1653585166261,MATH 274,A02,087440,Cheng; Li-Tien,10,0,10,0
1653585166791,MATH 278A,A00,087441,Staff,8,0,10,2
1653585167315,MATH 278B,A00,087442,Staff,8,0,10,2
1653585167841,MATH 278C,A00,087443,Staff,8,0,10,2
1653585168369,MATH 280A,A00,087444,Zheng; Tianyi,0,0,8,8
1653585168893,MATH 281A,A00,087445,Bradic; Jelena,0,0,8,8
1653585169424,MATH 282A,A00,087446,Zhang; Danna,0,0,8,8
1653585169950,MATH 283,A00,087447,Tesler; Glenn,0,0,0,16
1653585170475,MATH 286,B00,095535,Kemp; Todd Aahron,0,0,0,0
1653585170999,MATH 287D,B00,095536,Bradic; Jelena,8,0,8,0
1653585171525,MATH 288,A00,087450,Staff,14,0,15,1
1653585171525,MATH 288,B00,087451,Staff,15,0,15,0
1653585171525,MATH 288,C00,087452,Staff,15,0,15,0
1653585172049,MATH 290A,A00,087453,Xu; Zhouli,6,0,8,2
1653585172578,MATH 291A,A00,087454,Xu; Zhouli,7,0,8,1
1653585173101,MATH 292,A00,087455,Staff,10,0,10,0
1653585173626,MATH 295,A00,087456,Staff,50,0,50,0
1653585174161,MATH 297,001,087457,Staff,998,0,999,1
1653585746461,COGS 200,A01,087991,Staff,47,0,50,3
1653585746983,COGS 201,A01,094504,Rangel; Lara M,16,0,25,9
1653585747508,COGS 203,A00,087992,Coulson; Seana M,18,0,20,2
1653585748036,COGS 210A,001,087993,Greene; Deanna Jacquelyn,9998,0,9999,1
1653585748036,COGS 210A,002,087994,Saygin; Ayse P,9999,0,9999,0
1653585748036,COGS 210A,003,087995,Xia; Haijun,9999,0,9999,0
1653585748036,COGS 210A,004,087996,Nitz; Douglas A.,9999,0,9999,0
1653585748036,COGS 210A,005,087997,Hollan; James D.,9999,0,9999,0
1653585748036,COGS 210A,006,087998,Deak; Gedeon O.,9998,0,9999,1
1653585748036,COGS 210A,007,087999,Rossano; Federico,9999,0,9999,0
1653585748561,COGS 211A,A00,088000,Coulson; Seana M,9997,0,9999,2
1653585749086,COGS 229,A00,088002,Staff,22,0,25,3
1653585749615,COGS 260,B00,094231,Staff,17,0,20,3
1653585749615,COGS 260,A00,088004,Nitz; Douglas A.,9998,0,9999,1
1653585750142,CSE 202,A00,090110,Paturi; Ramamohan,0,0,0,0
1653585750142,CSE 202,B00,090111,Paturi; Ramamohan,0,0,0,0
1653585750663,CSE 207B,A00,090112,Heninger; Nadia A,0,0,0,0
1653585751189,CSE 208,A00,094858,Micciancio; Daniele,0,0,0,0
1653585751715,CSE 210,A00,090113,Powell; Thomas Allan,0,0,0,0
1653585752243,CSE 219,A00,090898,Staff,0,0,0,0
1653585752767,CSE 221,A00,090114,Zhou; Yuan-Yuan,0,0,0,0
1653585753291,CSE 229A,A00,090115,Porter; George M,0,0,0,0
1653585753813,CSE 229C,A00,090116,Savage; Stefan,0,0,0,0
1653585754336,CSE 230,A00,090117,Jhala; Ranjit,0,0,0,0
1653585754857,CSE 232,A00,090118,Papakonstantinou; Yannis,0,0,0,0
1653585755384,CSE 239A,A00,090121,Kumar; Arun Kumar,0,0,0,0
1653585755911,CSE 239B,A00,090122,Jhala; Ranjit,0,0,0,0
1653585756438,CSE 240A,A00,090123,Zhao; Jishen,1,0,189,188
1653585756965,CSE 243A,A00,090124,Orailoglu; Alex,0,0,15,15
1653585757492,CSE 249B,A00,090125,Kahng; Andrew Byun,13,0,20,7
1653585758018,CSE 250A,A00,090126,Berg-Kirkpatrick; Taylor D,0,0,0,0
1653585758540,CSE 252A,A00,090127,Ochoa; Benjamin Lawrence,0,0,0,0
1653585759067,CSE 258,A01,090129,McAuley; Julian John,0,0,0,0
1653585759590,CSE 258R,A01,090131,McAuley; Julian John,0,0,0,0
1653585760131,CSE 274,A00,090132,Ramamoorthi; Ravi,0,0,0,0
1653585760659,CSE 276A,A00,090133,Christensen; Henrik I,0,0,0,0
1653585761186,CSE 276C,A00,090134,Christensen; Henrik I,0,0,0,0
1653585761712,CSE 290,A00,090135,Bafna; Vineet,0,0,0,0
1653585761712,CSE 290,B00,090136,Ramamoorthi; Ravi,0,0,0,0
1653585761712,CSE 290,C00,090137,Li; Tzumao,8,0,10,2
1653585761712,CSE 290,D00,090138,Zhou; Yuan-Yuan,9,0,10,1
1653585761712,CSE 290,E00,090139,Christensen; Henrik I,8,0,10,2
1653585761712,CSE 290,F00,094053,Shalev; Aaron D,0,0,0,0
1653585762235,CSE 291,A00,090140,Munyaka; Imani N. S.,0,0,0,0
1653585762235,CSE 291,B00,094880,Yu; Qi,0,0,0,0
1653585762235,CSE 291,C00,090142,Pannuto; Patrick William,0,0,0,0
1653585762235,CSE 291,D00,094881,Zhang; Yiying,0,0,0,0
1653585762235,CSE 291,E00,095118,Su; Hao,0,0,0,0
1653585762778,CSE 293,001,094905,Bafna; Vineet,9999,0,9999,0
1653585762778,CSE 293,002,094906,Bellare; Mihir,9999,0,9999,0
1653585762778,CSE 293,003,094907,Berg-Kirkpatrick; Taylor D,9999,0,9999,0
1653585762778,CSE 293,004,094908,Christensen; Henrik I,9999,0,9999,0
1653585762778,CSE 293,005,094909,Cottrell; Garrison W,9999,0,9999,0
1653585762778,CSE 293,006,094910,Deutsch; Alin Bernard,9999,0,9999,0
1653585762778,CSE 293,007,094911,Esmaeilzadeh; Hadi,9999,0,9999,0
1653585762778,CSE 293,008,094912,Freund; Yoav,9999,0,9999,0
1653585762778,CSE 293,009,094913,Griswold; William G.,9999,0,9999,0
1653585762778,CSE 293,010,094914,Gymrek; Melissa Ann,9999,0,9999,0
1653585762778,CSE 293,011,094915,Heninger; Nadia A,9999,0,9999,0
1653585762778,CSE 293,012,094916,Impagliazzo; Russell,9999,0,9999,0
1653585762778,CSE 293,013,094917,Jhala; Ranjit,9999,0,9999,0
1653585762778,CSE 293,014,094918,Kahng; Andrew Byun,9999,0,9999,0
1653585762778,CSE 293,015,094919,Kane; Daniel Mertz,9999,0,9999,0
1653585762778,CSE 293,016,094920,Kriegman; David J,9999,0,9999,0
1653585762778,CSE 293,017,094921,Kumar; Arun Kumar,9999,0,9999,0
1653585762778,CSE 293,018,094922,Lerner; Sorin,9999,0,9999,0
1653585762778,CSE 293,019,094923,Lovett; Shachar,9999,0,9999,0
1653585762778,CSE 293,020,094924,McAuley; Julian John,9999,0,9999,0
1653585762778,CSE 293,021,094925,Micciancio; Daniele,9999,0,9999,0
1653585762778,CSE 293,022,094926,Orailoglu; Alex,9999,0,9999,0
1653585762778,CSE 293,023,094927,Paturi; Ramamohan,9999,0,9999,0
1653585762778,CSE 293,024,094928,Polikarpova; Nadezhda,9999,0,9999,0
1653585762778,CSE 293,025,094929,Politz; Joseph Gibbs,9999,0,9999,0
1653585762778,CSE 293,026,094930,Porter; George M,9999,0,9999,0
1653585762778,CSE 293,027,094931,Porter; Leonard Emerson,9999,0,9999,0
1653585762778,CSE 293,028,094932,Ramamoorthi; Ravi,9999,0,9999,0
1653585762778,CSE 293,029,094933,Sahoo; Debashis,9999,0,9999,0
1653585762778,CSE 293,030,094934,Saul; Lawrence,9999,0,9999,0
1653585762778,CSE 293,031,094935,Savage; Stefan,9999,0,9999,0
1653585762778,CSE 293,032,094936,Schulze; Jurgen P.,9999,0,9999,0
1653585762778,CSE 293,033,094937,Snoeren; Alex C.,9999,0,9999,0
1653585762778,CSE 293,034,094938,Shang; Jingbo,9999,0,9999,0
1653585762778,CSE 293,035,094939,Stefan; Deian,9999,0,9999,0
1653585762778,CSE 293,036,094940,Su; Hao,9999,0,9999,0
1653585762778,CSE 293,037,094941,Swanson; Steven James,9999,0,9999,0
1653585762778,CSE 293,038,094942,Tullsen; Dean Michael,9999,0,9999,0
1653585762778,CSE 293,039,094943,Voelker; Geoffrey M.,9999,0,9999,0
1653585762778,CSE 293,040,094944,Zhao; Jishen,9999,0,9999,0
1653585762778,CSE 293,041,094945,Zhou; Yuan-Yuan,9999,0,9999,0
1653585762778,CSE 293,042,094946,Gao; Sicun,9998,0,9999,1
1653585762778,CSE 293,043,094947,Weibel; Nadir,9999,0,9999,0
1653585762778,CSE 293,044,094948,Gupta; Rajesh K.,9999,0,9999,0
1653585763304,CSE 294,A00,090143,Porter; George M,8,0,10,2
1653585763827,DSE 200,A00,091799,Staff,50,0,50,0
1653585764350,DSE 203,A00,091800,Gupta; Amarnath,30,0,30,0
1653585764885,DSE 250,A00,091801,Deutsch; Alin Bernard,30,0,30,0
1653585765416,DSE 290,A00,091802,Altintas De Callaf; Ilkay,50,0,50,0
1653585765959,ECE 200,001,091003,Antipa; Nicholas A,9999,0,9999,0
1653585765959,ECE 200,002,091004,Atanasov; Nikolay A.,9999,0,9999,0
1653585765959,ECE 200,003,091005,Bharadia; Dinesh,9999,0,9999,0
1653585765959,ECE 200,004,091006,Cheng; Chung Kuan,9999,0,9999,0
1653585765959,ECE 200,005,091007,Cosman; Pamela C.,9999,0,9999,0
1653585765959,ECE 200,006,091008,Staff,9999,0,9999,0
1653585765959,ECE 200,007,091009,Dayeh; Shadi Ahmad,9999,0,9999,0
1653585765959,ECE 200,008,091010,Fainman; Yeshaiahu,9999,0,9999,0
1653585765959,ECE 200,009,091011,Ford; Joseph Earl,9999,0,9999,0
1653585765959,ECE 200,010,091012,Franceschetti; Massimo,9999,0,9999,0
1653585765959,ECE 200,011,091013,Fullerton; Eric E,9999,0,9999,0
1653585765959,ECE 200,012,091014,Galton; Ian A,9999,0,9999,0
1653585765959,ECE 200,013,091015,Gilja; Vikash,9999,0,9999,0
1653585765959,ECE 200,014,091016,Hall; Drew A.,9999,0,9999,0
1653585765959,ECE 200,015,091017,Hsueh; Tzu-Chien,9999,0,9999,0
1653585765959,ECE 200,016,091018,Javidi; Tara,9999,0,9999,0
1653585765959,ECE 200,017,091019,Kahng; Andrew Byun,9999,0,9999,0
1653585765959,ECE 200,018,091020,Kim; Young-Han,9999,0,9999,0
1653585765959,ECE 200,019,091021,Koushanfar; Farinaz,9999,0,9999,0
1653585765959,ECE 200,020,091022,Kuzum; Duygu,9999,0,9999,0
1653585765959,ECE 200,021,091023,Le; Hanh-Phuc,9999,0,9999,0
1653585765959,ECE 200,022,091024,Lin; Bill,9999,0,9999,0
1653585765959,ECE 200,023,091025,Liu; Zhaowei,9999,0,9999,0
1653585765959,ECE 200,024,091026,Lo; Yu-Hwa,9999,0,9999,0
1653585765959,ECE 200,025,091027,Lomakin; Vitaliy,9999,0,9999,0
1653585765959,ECE 200,026,091028,Mercier; Patrick Philip,9999,0,9999,0
1653585765959,ECE 200,027,091029,Meyer; Florian,9999,0,9999,0
1653585765959,ECE 200,028,091030,Milstein; Laurence B.,9999,0,9999,0
1653585765959,ECE 200,029,091031,Mir Arabbaygi; Siavash,9999,0,9999,0
1653585765959,ECE 200,030,091032,Mookherjea; Shayan,9999,0,9999,0
1653585765959,ECE 200,031,091033,Morris; Karcher William,9999,0,9999,0
1653585765959,ECE 200,032,091034,Ng; Tse Nga,9999,0,9999,0
1653585765959,ECE 200,033,091035,Nguyen; Truong Quang,9999,0,9999,0
1653585765959,ECE 200,034,091036,Nomura; Kenji,9999,0,9999,0
1653585765959,ECE 200,035,091037,Orlitsky; Alon,9999,0,9999,0
1653585765959,ECE 200,036,091038,Pal; Piya,9999,0,9999,0
1653585765959,ECE 200,037,091039,Papen; George C.,9999,0,9999,0
1653585765959,ECE 200,038,091040,Radic; Stojan,9999,0,9999,0
1653585765959,ECE 200,039,091041,Rao; Bhaskar D.,9999,0,9999,0
1653585765959,ECE 200,040,091042,Rao; Ramesh R,9999,0,9999,0
1653585765959,ECE 200,041,091043,Rebeiz; Gabriel,9999,0,9999,0
1653585765959,ECE 200,042,091044,Sanford; John R,9999,0,9999,0
1653585765959,ECE 200,043,091045,Siegel; Paul H.,9999,0,9999,0
1653585765959,ECE 200,044,091046,Sievenpiper; Daniel F.,9999,0,9999,0
1653585765959,ECE 200,045,091047,Sworder; David D.,9999,0,9999,0
1653585765959,ECE 200,046,091048,Taur; Yuan,9999,0,9999,0
1653585765959,ECE 200,047,091049,Touri; Behrouz,9999,0,9999,0
1653585765959,ECE 200,048,091050,Trivedi; Mohan M.,9999,0,9999,0
1653585765959,ECE 200,049,091051,Vardy; Alexander,9999,0,9999,0
1653585765959,ECE 200,050,091052,Vasconcelos; Nuno,9999,0,9999,0
1653585765959,ECE 200,051,091053,Wang; Xiaolong,9999,0,9999,0
1653585765959,ECE 200,052,091054,Xie; Pengtao,9999,0,9999,0
1653585765959,ECE 200,053,091055,Yip; Michael,9999,0,9999,0
1653585765959,ECE 200,054,091056,Zeger; Kenneth A.,9999,0,9999,0
1653585765959,ECE 200,055,091057,Zhang; Xinyu,9999,0,9999,0
1653585765959,ECE 200,056,091058,Turakhia; Yatish Girish,9999,0,9999,0
1653585765959,ECE 200,057,091059,Kang; Mingu,9999,0,9999,0
1653585765959,ECE 200,058,091060,Shi; Yuanyuan,9999,0,9999,0
1653585765959,ECE 200,059,091061,Wang; Edward Jay,9999,0,9999,0
1653585765959,ECE 200,060,091062,Zheng; Yang,9999,0,9999,0
1653585766485,ECE 201,A00,095526,Lo; Yu-Hwa,0,0,0,0
1653585767015,ECE 203,A00,091065,Mercier; Patrick Philip,0,0,0,0
1653585767538,ECE 207A,A00,091605,Liu; Thomas Tao-Ming,0,0,0,0
1653585768059,ECE 212AN,A00,091068,Nomura; Kenji,0,0,0,0
1653585768582,ECE 222A,A00,091069,Rebeiz; Gabriel,0,0,0,0
1653585769106,ECE 225A,A00,091070,Orlitsky; Alon,0,0,0,0
1653585769633,ECE 230A,A00,091071,Nomura; Kenji,0,0,0,0
1653585770163,ECE 236A,A00,091072,Dayeh; Shadi Ahmad,0,0,0,0
1653585770690,ECE 238A,A00,091073,Luo; Jian,0,0,0,0
1653585770690,ECE 238A,B00,091074,Luo; Jian,0,0,0,0
1653585771219,ECE 240A,A00,091075,Radic; Stojan,0,0,0,0
1653585771744,ECE 247A,A00,091592,Shi; Lingyan,0,0,0,0
1653585772269,ECE 250,A00,091076,Touri; Behrouz,0,0,0,0
1653585772792,ECE 251C,A00,091078,Nguyen; Truong Quang,0,0,0,0
1653585773324,ECE 253,A00,091079,Cosman; Pamela C.,0,0,0,0
1653585773850,ECE 255A,A00,091080,Orlitsky; Alon,0,0,0,0
1653585774372,ECE 257A,A00,091081,Zhang; Xinyu,0,0,0,0
1653585774902,ECE 260A,A01,091084,Eldon; John,0,0,0,0
1653585775427,ECE 264C,A00,091085,Galton; Ian A,0,0,0,0
1653585775951,ECE 265C,A00,094889,Presti; Calogero Davide,0,0,0,9
1653585776479,ECE 266,A01,091087,Hall; Drew A.,0,0,0,0
1653585777534,ECE 271A,A00,091090,Vasconcelos; Nuno,0,0,0,0
1653585778057,ECE 272B,A00,091091,Sworder; David D.,0,0,0,0
1653585778589,ECE 275A,A00,091092,Meyer; Florian,0,0,0,0
1653585779119,ECE 277,A00,091093,An; Cheolhong,0,0,0,0
1653585779646,ECE 283,A00,091094,Le; Hanh-Phuc,0,0,0,0
1653585780187,ECE 284,A00,091095,Kang; Mingu,0,0,0,0
1653585780187,ECE 284,B00,091096,Wang; Edward Jay,0,0,0,0
1653585780709,ECE 285,A00,094334,Touri; Behrouz,0,0,0,0
1653585781308,ECE 289,A00,091097,Whelan; David Arthur,0,0,0,0
1653585781830,MATH 200A,A00,087414,Salehi Golsefidy; Alireza,7,0,8,1
1653585782360,MATH 202A,A00,087415,Gill; Philip E.,2,0,8,6
1653585782884,MATH 203A,A00,087416,Oprea; Dragos N.,6,0,8,2
1653585783415,MATH 204A,A00,087417,Kedlaya; Kiran S.,6,0,8,2
1653585783946,MATH 205,A00,087418,Sorensen; Claus M,6,0,8,2
1653585784473,MATH 206A,A00,087419,Izadi; Elham,7,0,8,1
1653585785005,MATH 207A,A00,087420,Mohammadi; Amir,5,0,8,3
1653585785531,MATH 208,A00,087421,Staff,9,0,10,1
1653585786068,MATH 209,A00,087422,Staff,10,0,10,0
1653585786591,MATH 218,A00,087423,Staff,10,0,10,0
1653585787119,MATH 220A,A00,087424,Novak; Jonathan I,6,0,8,2
1653585787649,MATH 231A,A00,087425,Bejenaru; Ioan,3,0,8,5
1653585788171,MATH 240A,A00,087426,Ebenfelt; Peter F,5,0,8,3
1653585788702,MATH 243,A00,087427,Staff,9,0,10,1
1653585789224,MATH 248,A00,087429,Staff,10,0,10,0
1653585789747,MATH 250A,A00,087430,Spolaor; Luca,4,0,8,4
1653585790283,MATH 257A,A00,087431,Spolaor; Luca,7,0,8,1
1653585790808,MATH 258,A00,087432,Staff,9,0,10,1
1653585791331,MATH 264A,A00,087433,Warnke; Lutz Peter,5,0,8,3
1653585791859,MATH 268,A00,087434,Staff,15,0,15,0
1653585792383,MATH 269,A00,087435,Staff,14,0,15,1
1653585792907,MATH 270A,A00,087436,Nie; Jiawang,0,0,8,8
1653585793438,MATH 272A,A00,087437,Tian; Xiaochuan,1,0,8,7
1653585793969,MATH 274,A01,087439,Cheng; Li-Tien,9,0,10,1
1653585793969,MATH 274,A02,087440,Cheng; Li-Tien,10,0,10,0
1653585794500,MATH 278A,A00,087441,Staff,8,0,10,2
1653585795028,MATH 278B,A00,087442,Staff,8,0,10,2
1653585795553,MATH 278C,A00,087443,Staff,8,0,10,2
1653585796076,MATH 280A,A00,087444,Zheng; Tianyi,0,0,8,8
1653585796599,MATH 281A,A00,087445,Bradic; Jelena,0,0,8,8
1653585797123,MATH 282A,A00,087446,Zhang; Danna,0,0,8,8
1653585797655,MATH 283,A00,087447,Tesler; Glenn,0,0,0,16
1653585798178,MATH 286,B00,095535,Kemp; Todd Aahron,0,0,0,0
1653585798710,MATH 287D,B00,095536,Bradic; Jelena,8,0,8,0
1653585799234,MATH 288,A00,087450,Staff,14,0,15,1
1653585799234,MATH 288,B00,087451,Staff,15,0,15,0
1653585799234,MATH 288,C00,087452,Staff,15,0,15,0
1653585799757,MATH 290A,A00,087453,Xu; Zhouli,6,0,8,2
1653585800281,MATH 291A,A00,087454,Xu; Zhouli,7,0,8,1
1653585800813,MATH 292,A00,087455,Staff,10,0,10,0
1653585801338,MATH 295,A00,087456,Staff,50,0,50,0
1653585801861,MATH 297,001,087457,Staff,998,0,999,1
1653586363032,COGS 200,A01,087991,Staff,47,0,50,3
1653586363566,COGS 201,A01,094504,Rangel; Lara M,16,0,25,9
1653586364088,COGS 203,A00,087992,Coulson; Seana M,18,0,20,2
1653586364622,COGS 210A,001,087993,Greene; Deanna Jacquelyn,9998,0,9999,1
1653586364622,COGS 210A,002,087994,Saygin; Ayse P,9999,0,9999,0
1653586364622,COGS 210A,003,087995,Xia; Haijun,9999,0,9999,0
1653586364622,COGS 210A,004,087996,Nitz; Douglas A.,9999,0,9999,0
1653586364622,COGS 210A,005,087997,Hollan; James D.,9999,0,9999,0
1653586364622,COGS 210A,006,087998,Deak; Gedeon O.,9998,0,9999,1
1653586364622,COGS 210A,007,087999,Rossano; Federico,9999,0,9999,0
1653586365144,COGS 211A,A00,088000,Coulson; Seana M,9997,0,9999,2
1653586365666,COGS 229,A00,088002,Staff,22,0,25,3
1653586366199,COGS 260,B00,094231,Staff,17,0,20,3
1653586366199,COGS 260,A00,088004,Nitz; Douglas A.,9998,0,9999,1
1653586366721,CSE 202,A00,090110,Paturi; Ramamohan,0,0,0,0
1653586366721,CSE 202,B00,090111,Paturi; Ramamohan,0,0,0,0
1653586367245,CSE 207B,A00,090112,Heninger; Nadia A,0,0,0,0
1653586367768,CSE 208,A00,094858,Micciancio; Daniele,0,0,0,0
1653586368296,CSE 210,A00,090113,Powell; Thomas Allan,0,0,0,0
1653586368821,CSE 219,A00,090898,Staff,0,0,0,0
1653586369344,CSE 221,A00,090114,Zhou; Yuan-Yuan,0,0,0,0
1653586369946,CSE 229A,A00,090115,Porter; George M,0,0,0,0
1653586370468,CSE 229C,A00,090116,Savage; Stefan,0,0,0,0
1653586370992,CSE 230,A00,090117,Jhala; Ranjit,0,0,0,0
1653586371514,CSE 232,A00,090118,Papakonstantinou; Yannis,0,0,0,0
1653586372036,CSE 239A,A00,090121,Kumar; Arun Kumar,0,0,0,0
1653586372569,CSE 239B,A00,090122,Jhala; Ranjit,0,0,0,0
1653586373113,CSE 240A,A00,090123,Zhao; Jishen,1,0,189,188
1653586373638,CSE 243A,A00,090124,Orailoglu; Alex,0,0,15,15
1653586374163,CSE 249B,A00,090125,Kahng; Andrew Byun,13,0,20,7
1653586374686,CSE 250A,A00,090126,Berg-Kirkpatrick; Taylor D,0,0,0,0
1653586375220,CSE 252A,A00,090127,Ochoa; Benjamin Lawrence,0,0,0,0
1653586375748,CSE 258,A01,090129,McAuley; Julian John,0,0,0,0
1653586376270,CSE 258R,A01,090131,McAuley; Julian John,0,0,0,0
1653586376793,CSE 274,A00,090132,Ramamoorthi; Ravi,0,0,0,0
1653586377318,CSE 276A,A00,090133,Christensen; Henrik I,0,0,0,0
1653586377841,CSE 276C,A00,090134,Christensen; Henrik I,0,0,0,0
1653586378366,CSE 290,A00,090135,Bafna; Vineet,0,0,0,0
1653586378366,CSE 290,B00,090136,Ramamoorthi; Ravi,0,0,0,0
1653586378366,CSE 290,C00,090137,Li; Tzumao,8,0,10,2
1653586378366,CSE 290,D00,090138,Zhou; Yuan-Yuan,9,0,10,1
1653586378366,CSE 290,E00,090139,Christensen; Henrik I,8,0,10,2
1653586378366,CSE 290,F00,094053,Shalev; Aaron D,0,0,0,0
1653586378893,CSE 291,A00,090140,Munyaka; Imani N. S.,0,0,0,0
1653586378893,CSE 291,B00,094880,Yu; Qi,0,0,0,0
1653586378893,CSE 291,C00,090142,Pannuto; Patrick William,0,0,0,0
1653586378893,CSE 291,D00,094881,Zhang; Yiying,0,0,0,0
1653586378893,CSE 291,E00,095118,Su; Hao,0,0,0,0
1653586379429,CSE 293,001,094905,Bafna; Vineet,9999,0,9999,0
1653586379429,CSE 293,002,094906,Bellare; Mihir,9999,0,9999,0
1653586379429,CSE 293,003,094907,Berg-Kirkpatrick; Taylor D,9999,0,9999,0
1653586379429,CSE 293,004,094908,Christensen; Henrik I,9999,0,9999,0
1653586379429,CSE 293,005,094909,Cottrell; Garrison W,9999,0,9999,0
1653586379429,CSE 293,006,094910,Deutsch; Alin Bernard,9999,0,9999,0
1653586379429,CSE 293,007,094911,Esmaeilzadeh; Hadi,9999,0,9999,0
1653586379429,CSE 293,008,094912,Freund; Yoav,9999,0,9999,0
1653586379429,CSE 293,009,094913,Griswold; William G.,9999,0,9999,0
1653586379429,CSE 293,010,094914,Gymrek; Melissa Ann,9999,0,9999,0
1653586379429,CSE 293,011,094915,Heninger; Nadia A,9999,0,9999,0
1653586379429,CSE 293,012,094916,Impagliazzo; Russell,9999,0,9999,0
1653586379429,CSE 293,013,094917,Jhala; Ranjit,9999,0,9999,0
1653586379429,CSE 293,014,094918,Kahng; Andrew Byun,9999,0,9999,0
1653586379429,CSE 293,015,094919,Kane; Daniel Mertz,9999,0,9999,0
1653586379429,CSE 293,016,094920,Kriegman; David J,9999,0,9999,0
1653586379429,CSE 293,017,094921,Kumar; Arun Kumar,9999,0,9999,0
1653586379429,CSE 293,018,094922,Lerner; Sorin,9999,0,9999,0
1653586379429,CSE 293,019,094923,Lovett; Shachar,9999,0,9999,0
1653586379429,CSE 293,020,094924,McAuley; Julian John,9999,0,9999,0
1653586379429,CSE 293,021,094925,Micciancio; Daniele,9999,0,9999,0
1653586379429,CSE 293,022,094926,Orailoglu; Alex,9999,0,9999,0
1653586379429,CSE 293,023,094927,Paturi; Ramamohan,9999,0,9999,0
1653586379429,CSE 293,024,094928,Polikarpova; Nadezhda,9999,0,9999,0
1653586379429,CSE 293,025,094929,Politz; Joseph Gibbs,9999,0,9999,0
1653586379429,CSE 293,026,094930,Porter; George M,9999,0,9999,0
1653586379429,CSE 293,027,094931,Porter; Leonard Emerson,9999,0,9999,0
1653586379429,CSE 293,028,094932,Ramamoorthi; Ravi,9999,0,9999,0
1653586379429,CSE 293,029,094933,Sahoo; Debashis,9999,0,9999,0
1653586379429,CSE 293,030,094934,Saul; Lawrence,9999,0,9999,0
1653586379429,CSE 293,031,094935,Savage; Stefan,9999,0,9999,0
1653586379429,CSE 293,032,094936,Schulze; Jurgen P.,9999,0,9999,0
1653586379429,CSE 293,033,094937,Snoeren; Alex C.,9999,0,9999,0
1653586379429,CSE 293,034,094938,Shang; Jingbo,9999,0,9999,0
1653586379429,CSE 293,035,094939,Stefan; Deian,9999,0,9999,0
1653586379429,CSE 293,036,094940,Su; Hao,9999,0,9999,0
1653586379429,CSE 293,037,094941,Swanson; Steven James,9999,0,9999,0
1653586379429,CSE 293,038,094942,Tullsen; Dean Michael,9999,0,9999,0
1653586379429,CSE 293,039,094943,Voelker; Geoffrey M.,9999,0,9999,0
1653586379429,CSE 293,040,094944,Zhao; Jishen,9999,0,9999,0
1653586379429,CSE 293,041,094945,Zhou; Yuan-Yuan,9999,0,9999,0
1653586379429,CSE 293,042,094946,Gao; Sicun,9998,0,9999,1
1653586379429,CSE 293,043,094947,Weibel; Nadir,9999,0,9999,0
1653586379429,CSE 293,044,094948,Gupta; Rajesh K.,9999,0,9999,0
1653586379950,CSE 294,A00,090143,Porter; George M,8,0,10,2
1653586380486,DSE 200,A00,091799,Staff,50,0,50,0
1653586381011,DSE 203,A00,091800,Gupta; Amarnath,30,0,30,0
1653586381536,DSE 250,A00,091801,Deutsch; Alin Bernard,30,0,30,0
1653586382060,DSE 290,A00,091802,Altintas De Callaf; Ilkay,50,0,50,0
1653586382589,ECE 200,001,091003,Antipa; Nicholas A,9999,0,9999,0
1653586382589,ECE 200,002,091004,Atanasov; Nikolay A.,9999,0,9999,0
1653586382589,ECE 200,003,091005,Bharadia; Dinesh,9999,0,9999,0
1653586382589,ECE 200,004,091006,Cheng; Chung Kuan,9999,0,9999,0
1653586382589,ECE 200,005,091007,Cosman; Pamela C.,9999,0,9999,0
1653586382589,ECE 200,006,091008,Staff,9999,0,9999,0
1653586382589,ECE 200,007,091009,Dayeh; Shadi Ahmad,9999,0,9999,0
1653586382589,ECE 200,008,091010,Fainman; Yeshaiahu,9999,0,9999,0
1653586382589,ECE 200,009,091011,Ford; Joseph Earl,9999,0,9999,0
1653586382589,ECE 200,010,091012,Franceschetti; Massimo,9999,0,9999,0
1653586382589,ECE 200,011,091013,Fullerton; Eric E,9999,0,9999,0
1653586382589,ECE 200,012,091014,Galton; Ian A,9999,0,9999,0
1653586382589,ECE 200,013,091015,Gilja; Vikash,9999,0,9999,0
1653586382589,ECE 200,014,091016,Hall; Drew A.,9999,0,9999,0
1653586382589,ECE 200,015,091017,Hsueh; Tzu-Chien,9999,0,9999,0
1653586382589,ECE 200,016,091018,Javidi; Tara,9999,0,9999,0
1653586382589,ECE 200,017,091019,Kahng; Andrew Byun,9999,0,9999,0
1653586382589,ECE 200,018,091020,Kim; Young-Han,9999,0,9999,0
1653586382589,ECE 200,019,091021,Koushanfar; Farinaz,9999,0,9999,0
1653586382589,ECE 200,020,091022,Kuzum; Duygu,9999,0,9999,0
1653586382589,ECE 200,021,091023,Le; Hanh-Phuc,9999,0,9999,0
1653586382589,ECE 200,022,091024,Lin; Bill,9999,0,9999,0
1653586382589,ECE 200,023,091025,Liu; Zhaowei,9999,0,9999,0
1653586382589,ECE 200,024,091026,Lo; Yu-Hwa,9999,0,9999,0
1653586382589,ECE 200,025,091027,Lomakin; Vitaliy,9999,0,9999,0
1653586382589,ECE 200,026,091028,Mercier; Patrick Philip,9999,0,9999,0
1653586382589,ECE 200,027,091029,Meyer; Florian,9999,0,9999,0
1653586382589,ECE 200,028,091030,Milstein; Laurence B.,9999,0,9999,0
1653586382589,ECE 200,029,091031,Mir Arabbaygi; Siavash,9999,0,9999,0
1653586382589,ECE 200,030,091032,Mookherjea; Shayan,9999,0,9999,0
1653586382589,ECE 200,031,091033,Morris; Karcher William,9999,0,9999,0
1653586382589,ECE 200,032,091034,Ng; Tse Nga,9999,0,9999,0
1653586382589,ECE 200,033,091035,Nguyen; Truong Quang,9999,0,9999,0
1653586382589,ECE 200,034,091036,Nomura; Kenji,9999,0,9999,0
1653586382589,ECE 200,035,091037,Orlitsky; Alon,9999,0,9999,0
1653586382589,ECE 200,036,091038,Pal; Piya,9999,0,9999,0
1653586382589,ECE 200,037,091039,Papen; George C.,9999,0,9999,0
1653586382589,ECE 200,038,091040,Radic; Stojan,9999,0,9999,0
1653586382589,ECE 200,039,091041,Rao; Bhaskar D.,9999,0,9999,0
1653586382589,ECE 200,040,091042,Rao; Ramesh R,9999,0,9999,0
1653586382589,ECE 200,041,091043,Rebeiz; Gabriel,9999,0,9999,0
1653586382589,ECE 200,042,091044,Sanford; John R,9999,0,9999,0
1653586382589,ECE 200,043,091045,Siegel; Paul H.,9999,0,9999,0
1653586382589,ECE 200,044,091046,Sievenpiper; Daniel F.,9999,0,9999,0
1653586382589,ECE 200,045,091047,Sworder; David D.,9999,0,9999,0
1653586382589,ECE 200,046,091048,Taur; Yuan,9999,0,9999,0
1653586382589,ECE 200,047,091049,Touri; Behrouz,9999,0,9999,0
1653586382589,ECE 200,048,091050,Trivedi; Mohan M.,9999,0,9999,0
1653586382589,ECE 200,049,091051,Vardy; Alexander,9999,0,9999,0
1653586382589,ECE 200,050,091052,Vasconcelos; Nuno,9999,0,9999,0
1653586382589,ECE 200,051,091053,Wang; Xiaolong,9999,0,9999,0
1653586382589,ECE 200,052,091054,Xie; Pengtao,9999,0,9999,0
1653586382589,ECE 200,053,091055,Yip; Michael,9999,0,9999,0
1653586382589,ECE 200,054,091056,Zeger; Kenneth A.,9999,0,9999,0
1653586382589,ECE 200,055,091057,Zhang; Xinyu,9999,0,9999,0
1653586382589,ECE 200,056,091058,Turakhia; Yatish Girish,9999,0,9999,0
1653586382589,ECE 200,057,091059,Kang; Mingu,9999,0,9999,0
1653586382589,ECE 200,058,091060,Shi; Yuanyuan,9999,0,9999,0
1653586382589,ECE 200,059,091061,Wang; Edward Jay,9999,0,9999,0
1653586382589,ECE 200,060,091062,Zheng; Yang,9999,0,9999,0
1653586383118,ECE 201,A00,095526,Lo; Yu-Hwa,0,0,0,0
1653586383651,ECE 203,A00,091065,Mercier; Patrick Philip,0,0,0,0
1653586384175,ECE 207A,A00,091605,Liu; Thomas Tao-Ming,0,0,0,0
1653586384699,ECE 212AN,A00,091068,Nomura; Kenji,0,0,0,0
1653586385227,ECE 222A,A00,091069,Rebeiz; Gabriel,0,0,0,0
1653586385750,ECE 225A,A00,091070,Orlitsky; Alon,0,0,0,0
1653586386273,ECE 230A,A00,091071,Nomura; Kenji,0,0,0,0
1653586386795,ECE 236A,A00,091072,Dayeh; Shadi Ahmad,0,0,0,0
1653586387331,ECE 238A,A00,091073,Luo; Jian,0,0,0,0
1653586387331,ECE 238A,B00,091074,Luo; Jian,0,0,0,0
1653586387854,ECE 240A,A00,091075,Radic; Stojan,0,0,0,0
1653586388388,ECE 247A,A00,091592,Shi; Lingyan,0,0,0,0
1653586388917,ECE 250,A00,091076,Touri; Behrouz,0,0,0,0
1653586389439,ECE 251C,A00,091078,Nguyen; Truong Quang,0,0,0,0
1653586389962,ECE 253,A00,091079,Cosman; Pamela C.,0,0,0,0
1653586390485,ECE 255A,A00,091080,Orlitsky; Alon,0,0,0,0
1653586391008,ECE 257A,A00,091081,Zhang; Xinyu,0,0,0,0
1653586391539,ECE 260A,A01,091084,Eldon; John,0,0,0,0
1653586392064,ECE 264C,A00,091085,Galton; Ian A,0,0,0,0
1653586392594,ECE 265C,A00,094889,Presti; Calogero Davide,0,0,0,9
1653586393116,ECE 266,A01,091087,Hall; Drew A.,0,0,0,0
1653586394166,ECE 271A,A00,091090,Vasconcelos; Nuno,0,0,0,0
1653586394692,ECE 272B,A00,091091,Sworder; David D.,0,0,0,0
1653586395215,ECE 275A,A00,091092,Meyer; Florian,0,0,0,0
1653586395741,ECE 277,A00,091093,An; Cheolhong,0,0,0,0
1653586396268,ECE 283,A00,091094,Le; Hanh-Phuc,0,0,0,0
1653586396794,ECE 284,A00,091095,Kang; Mingu,0,0,0,0
1653586396794,ECE 284,B00,091096,Wang; Edward Jay,0,0,0,0
1653586397317,ECE 285,A00,094334,Touri; Behrouz,0,0,0,0
1653586397840,ECE 289,A00,091097,Whelan; David Arthur,0,0,0,0
1653586398363,MATH 200A,A00,087414,Salehi Golsefidy; Alireza,7,0,8,1
1653586398897,MATH 202A,A00,087415,Gill; Philip E.,2,0,8,6
1653586399428,MATH 203A,A00,087416,Oprea; Dragos N.,6,0,8,2
1653586399962,MATH 204A,A00,087417,Kedlaya; Kiran S.,6,0,8,2
1653586400487,MATH 205,A00,087418,Sorensen; Claus M,6,0,8,2
1653586401009,MATH 206A,A00,087419,Izadi; Elham,7,0,8,1
1653586401533,MATH 207A,A00,087420,Mohammadi; Amir,5,0,8,3
1653586402070,MATH 208,A00,087421,Staff,9,0,10,1
1653586402595,MATH 209,A00,087422,Staff,10,0,10,0
1653586403120,MATH 218,A00,087423,Staff,10,0,10,0
1653586403644,MATH 220A,A00,087424,Novak; Jonathan I,6,0,8,2
1653586404171,MATH 231A,A00,087425,Bejenaru; Ioan,3,0,8,5
1653586404700,MATH 240A,A00,087426,Ebenfelt; Peter F,5,0,8,3
1653586405222,MATH 243,A00,087427,Staff,9,0,10,1
1653586405747,MATH 248,A00,087429,Staff,10,0,10,0
1653586406278,MATH 250A,A00,087430,Spolaor; Luca,4,0,8,4
1653586406804,MATH 257A,A00,087431,Spolaor; Luca,7,0,8,1
1653586407327,MATH 258,A00,087432,Staff,9,0,10,1
1653586407858,MATH 264A,A00,087433,Warnke; Lutz Peter,5,0,8,3
1653586408386,MATH 268,A00,087434,Staff,15,0,15,0
1653586408914,MATH 269,A00,087435,Staff,14,0,15,1
1653586409440,MATH 270A,A00,087436,Nie; Jiawang,0,0,8,8
1653586409980,MATH 272A,A00,087437,Tian; Xiaochuan,1,0,8,7
1653586410508,MATH 274,A01,087439,Cheng; Li-Tien,9,0,10,1
1653586410508,MATH 274,A02,087440,Cheng; Li-Tien,10,0,10,0
1653586411033,MATH 278A,A00,087441,Staff,8,0,10,2
1653586411557,MATH 278B,A00,087442,Staff,8,0,10,2
1653586412079,MATH 278C,A00,087443,Staff,8,0,10,2
1653586412611,MATH 280A,A00,087444,Zheng; Tianyi,0,0,8,8
1653586413135,MATH 281A,A00,087445,Bradic; Jelena,0,0,8,8
1653586413666,MATH 282A,A00,087446,Zhang; Danna,0,0,8,8
1653586414191,MATH 283,A00,087447,Tesler; Glenn,0,0,0,16
1653586414717,MATH 286,B00,095535,Kemp; Todd Aahron,0,0,0,0
1653586415240,MATH 287D,B00,095536,Bradic; Jelena,8,0,8,0
1653586415766,MATH 288,A00,087450,Staff,14,0,15,1
1653586415766,MATH 288,B00,087451,Staff,15,0,15,0
1653586415766,MATH 288,C00,087452,Staff,15,0,15,0
1653586416302,MATH 290A,A00,087453,Xu; Zhouli,6,0,8,2
1653586416824,MATH 291A,A00,087454,Xu; Zhouli,7,0,8,1
1653586417346,MATH 292,A00,087455,Staff,10,0,10,0
1653586417870,MATH 295,A00,087456,Staff,50,0,50,0
1653586418392,MATH 297,001,087457,Staff,998,0,999,1
1653586979546,COGS 200,A01,087991,Staff,47,0,50,3
1653586980077,COGS 201,A01,094504,Rangel; Lara M,16,0,25,9
1653586980605,COGS 203,A00,087992,Coulson; Seana M,18,0,20,2
1653586981135,COGS 210A,001,087993,Greene; Deanna Jacquelyn,9998,0,9999,1
1653586981135,COGS 210A,002,087994,Saygin; Ayse P,9999,0,9999,0
1653586981135,COGS 210A,003,087995,Xia; Haijun,9999,0,9999,0
1653586981135,COGS 210A,004,087996,Nitz; Douglas A.,9999,0,9999,0
1653586981135,COGS 210A,005,087997,Hollan; James D.,9999,0,9999,0
1653586981135,COGS 210A,006,087998,Deak; Gedeon O.,9998,0,9999,1
1653586981135,COGS 210A,007,087999,Rossano; Federico,9999,0,9999,0
1653586981658,COGS 211A,A00,088000,Coulson; Seana M,9997,0,9999,2
1653586982190,COGS 229,A00,088002,Staff,22,0,25,3
1653586982720,COGS 260,B00,094231,Staff,17,0,20,3
1653586982720,COGS 260,A00,088004,Nitz; Douglas A.,9998,0,9999,1
1653586983248,CSE 202,A00,090110,Paturi; Ramamohan,0,0,0,0
1653586983248,CSE 202,B00,090111,Paturi; Ramamohan,0,0,0,0
1653586983776,CSE 207B,A00,090112,Heninger; Nadia A,0,0,0,0
1653586984298,CSE 208,A00,094858,Micciancio; Daniele,0,0,0,0
1653586984829,CSE 210,A00,090113,Powell; Thomas Allan,0,0,0,0
1653586985353,CSE 219,A00,090898,Staff,0,0,0,0
1653586985880,CSE 221,A00,090114,Zhou; Yuan-Yuan,0,0,0,0
1653586986407,CSE 229A,A00,090115,Porter; George M,0,0,0,0
1653586986937,CSE 229C,A00,090116,Savage; Stefan,0,0,0,0
1653586987459,CSE 230,A00,090117,Jhala; Ranjit,0,0,0,0
1653586987992,CSE 232,A00,090118,Papakonstantinou; Yannis,0,0,0,0
1653586988514,CSE 239A,A00,090121,Kumar; Arun Kumar,0,0,0,0
1653586989040,CSE 239B,A00,090122,Jhala; Ranjit,0,0,0,0
1653586989564,CSE 240A,A00,090123,Zhao; Jishen,1,0,189,188
1653586990091,CSE 243A,A00,090124,Orailoglu; Alex,0,0,15,15
1653586990613,CSE 249B,A00,090125,Kahng; Andrew Byun,13,0,20,7
1653586991135,CSE 250A,A00,090126,Berg-Kirkpatrick; Taylor D,0,0,0,0
1653586991662,CSE 252A,A00,090127,Ochoa; Benjamin Lawrence,0,0,0,0
1653586992184,CSE 258,A01,090129,McAuley; Julian John,0,0,0,0
1653586992710,CSE 258R,A01,090131,McAuley; Julian John,0,0,0,0
1653586993232,CSE 274,A00,090132,Ramamoorthi; Ravi,0,0,0,0
1653586993758,CSE 276A,A00,090133,Christensen; Henrik I,0,0,0,0
1653586994280,CSE 276C,A00,090134,Christensen; Henrik I,0,0,0,0
1653586994816,CSE 290,A00,090135,Bafna; Vineet,0,0,0,0
1653586994816,CSE 290,B00,090136,Ramamoorthi; Ravi,0,0,0,0
1653586994816,CSE 290,C00,090137,Li; Tzumao,8,0,10,2
1653586994816,CSE 290,D00,090138,Zhou; Yuan-Yuan,9,0,10,1
1653586994816,CSE 290,E00,090139,Christensen; Henrik I,8,0,10,2
1653586994816,CSE 290,F00,094053,Shalev; Aaron D,0,0,0,0
1653586995345,CSE 291,A00,090140,Munyaka; Imani N. S.,0,0,0,0
1653586995345,CSE 291,B00,094880,Yu; Qi,0,0,0,0
1653586995345,CSE 291,C00,090142,Pannuto; Patrick William,0,0,0,0
1653586995345,CSE 291,D00,094881,Zhang; Yiying,0,0,0,0
1653586995345,CSE 291,E00,095118,Su; Hao,0,0,0,0
1653586995878,CSE 293,001,094905,Bafna; Vineet,9999,0,9999,0
1653586995878,CSE 293,002,094906,Bellare; Mihir,9999,0,9999,0
1653586995878,CSE 293,003,094907,Berg-Kirkpatrick; Taylor D,9999,0,9999,0
1653586995878,CSE 293,004,094908,Christensen; Henrik I,9999,0,9999,0
1653586995878,CSE 293,005,094909,Cottrell; Garrison W,9999,0,9999,0
1653586995878,CSE 293,006,094910,Deutsch; Alin Bernard,9999,0,9999,0
1653586995878,CSE 293,007,094911,Esmaeilzadeh; Hadi,9999,0,9999,0
1653586995878,CSE 293,008,094912,Freund; Yoav,9999,0,9999,0
1653586995878,CSE 293,009,094913,Griswold; William G.,9999,0,9999,0
1653586995878,CSE 293,010,094914,Gymrek; Melissa Ann,9999,0,9999,0
1653586995878,CSE 293,011,094915,Heninger; Nadia A,9999,0,9999,0
1653586995878,CSE 293,012,094916,Impagliazzo; Russell,9999,0,9999,0
1653586995878,CSE 293,013,094917,Jhala; Ranjit,9999,0,9999,0
1653586995878,CSE 293,014,094918,Kahng; Andrew Byun,9999,0,9999,0
1653586995878,CSE 293,015,094919,Kane; Daniel Mertz,9999,0,9999,0
1653586995878,CSE 293,016,094920,Kriegman; David J,9999,0,9999,0
1653586995878,CSE 293,017,094921,Kumar; Arun Kumar,9999,0,9999,0
1653586995878,CSE 293,018,094922,Lerner; Sorin,9999,0,9999,0
1653586995878,CSE 293,019,094923,Lovett; Shachar,9999,0,9999,0
1653586995878,CSE 293,020,094924,McAuley; Julian John,9999,0,9999,0
1653586995878,CSE 293,021,094925,Micciancio; Daniele,9999,0,9999,0
1653586995878,CSE 293,022,094926,Orailoglu; Alex,9999,0,9999,0
1653586995878,CSE 293,023,094927,Paturi; Ramamohan,9999,0,9999,0
1653586995878,CSE 293,024,094928,Polikarpova; Nadezhda,9999,0,9999,0
1653586995878,CSE 293,025,094929,Politz; Joseph Gibbs,9999,0,9999,0
1653586995878,CSE 293,026,094930,Porter; George M,9999,0,9999,0
1653586995878,CSE 293,027,094931,Porter; Leonard Emerson,9999,0,9999,0
1653586995878,CSE 293,028,094932,Ramamoorthi; Ravi,9999,0,9999,0
1653586995878,CSE 293,029,094933,Sahoo; Debashis,9999,0,9999,0
1653586995878,CSE 293,030,094934,Saul; Lawrence,9999,0,9999,0
1653586995878,CSE 293,031,094935,Savage; Stefan,9999,0,9999,0
1653586995878,CSE 293,032,094936,Schulze; Jurgen P.,9999,0,9999,0
1653586995878,CSE 293,033,094937,Snoeren; Alex C.,9999,0,9999,0
1653586995878,CSE 293,034,094938,Shang; Jingbo,9999,0,9999,0
1653586995878,CSE 293,035,094939,Stefan; Deian,9999,0,9999,0
1653586995878,CSE 293,036,094940,Su; Hao,9999,0,9999,0
1653586995878,CSE 293,037,094941,Swanson; Steven James,9999,0,9999,0
1653586995878,CSE 293,038,094942,Tullsen; Dean Michael,9999,0,9999,0
1653586995878,CSE 293,039,094943,Voelker; Geoffrey M.,9999,0,9999,0
1653586995878,CSE 293,040,094944,Zhao; Jishen,9999,0,9999,0
1653586995878,CSE 293,041,094945,Zhou; Yuan-Yuan,9999,0,9999,0
1653586995878,CSE 293,042,094946,Gao; Sicun,9998,0,9999,1
1653586995878,CSE 293,043,094947,Weibel; Nadir,9999,0,9999,0
1653586995878,CSE 293,044,094948,Gupta; Rajesh K.,9999,0,9999,0
1653586996406,CSE 294,A00,090143,Porter; George M,8,0,10,2
1653586996928,DSE 200,A00,091799,Staff,50,0,50,0
1653586997460,DSE 203,A00,091800,Gupta; Amarnath,30,0,30,0
1653586997984,DSE 250,A00,091801,Deutsch; Alin Bernard,30,0,30,0
1653586998507,DSE 290,A00,091802,Altintas De Callaf; Ilkay,50,0,50,0
1653586999042,ECE 200,001,091003,Antipa; Nicholas A,9999,0,9999,0
1653586999042,ECE 200,002,091004,Atanasov; Nikolay A.,9999,0,9999,0
1653586999042,ECE 200,003,091005,Bharadia; Dinesh,9999,0,9999,0
1653586999042,ECE 200,004,091006,Cheng; Chung Kuan,9999,0,9999,0
1653586999042,ECE 200,005,091007,Cosman; Pamela C.,9999,0,9999,0
1653586999042,ECE 200,006,091008,Staff,9999,0,9999,0
1653586999042,ECE 200,007,091009,Dayeh; Shadi Ahmad,9999,0,9999,0
1653586999042,ECE 200,008,091010,Fainman; Yeshaiahu,9999,0,9999,0
1653586999042,ECE 200,009,091011,Ford; Joseph Earl,9999,0,9999,0
1653586999042,ECE 200,010,091012,Franceschetti; Massimo,9999,0,9999,0
1653586999042,ECE 200,011,091013,Fullerton; Eric E,9999,0,9999,0
1653586999042,ECE 200,012,091014,Galton; Ian A,9999,0,9999,0
1653586999042,ECE 200,013,091015,Gilja; Vikash,9999,0,9999,0
1653586999042,ECE 200,014,091016,Hall; Drew A.,9999,0,9999,0
1653586999042,ECE 200,015,091017,Hsueh; Tzu-Chien,9999,0,9999,0
1653586999042,ECE 200,016,091018,Javidi; Tara,9999,0,9999,0
1653586999042,ECE 200,017,091019,Kahng; Andrew Byun,9999,0,9999,0
1653586999042,ECE 200,018,091020,Kim; Young-Han,9999,0,9999,0
1653586999042,ECE 200,019,091021,Koushanfar; Farinaz,9999,0,9999,0
1653586999042,ECE 200,020,091022,Kuzum; Duygu,9999,0,9999,0
1653586999042,ECE 200,021,091023,Le; Hanh-Phuc,9999,0,9999,0
1653586999042,ECE 200,022,091024,Lin; Bill,9999,0,9999,0
1653586999042,ECE 200,023,091025,Liu; Zhaowei,9999,0,9999,0
1653586999042,ECE 200,024,091026,Lo; Yu-Hwa,9999,0,9999,0
1653586999042,ECE 200,025,091027,Lomakin; Vitaliy,9999,0,9999,0
1653586999042,ECE 200,026,091028,Mercier; Patrick Philip,9999,0,9999,0
1653586999042,ECE 200,027,091029,Meyer; Florian,9999,0,9999,0
1653586999042,ECE 200,028,091030,Milstein; Laurence B.,9999,0,9999,0
1653586999042,ECE 200,029,091031,Mir Arabbaygi; Siavash,9999,0,9999,0
1653586999042,ECE 200,030,091032,Mookherjea; Shayan,9999,0,9999,0
1653586999042,ECE 200,031,091033,Morris; Karcher William,9999,0,9999,0
1653586999042,ECE 200,032,091034,Ng; Tse Nga,9999,0,9999,0
1653586999042,ECE 200,033,091035,Nguyen; Truong Quang,9999,0,9999,0
1653586999042,ECE 200,034,091036,Nomura; Kenji,9999,0,9999,0
1653586999042,ECE 200,035,091037,Orlitsky; Alon,9999,0,9999,0
1653586999042,ECE 200,036,091038,Pal; Piya,9999,0,9999,0
1653586999042,ECE 200,037,091039,Papen; George C.,9999,0,9999,0
1653586999042,ECE 200,038,091040,Radic; Stojan,9999,0,9999,0
1653586999042,ECE 200,039,091041,Rao; Bhaskar D.,9999,0,9999,0
1653586999042,ECE 200,040,091042,Rao; Ramesh R,9999,0,9999,0
1653586999042,ECE 200,041,091043,Rebeiz; Gabriel,9999,0,9999,0
1653586999042,ECE 200,042,091044,Sanford; John R,9999,0,9999,0
1653586999042,ECE 200,043,091045,Siegel; Paul H.,9999,0,9999,0
1653586999042,ECE 200,044,091046,Sievenpiper; Daniel F.,9999,0,9999,0
1653586999042,ECE 200,045,091047,Sworder; David D.,9999,0,9999,0
1653586999042,ECE 200,046,091048,Taur; Yuan,9999,0,9999,0
1653586999042,ECE 200,047,091049,Touri; Behrouz,9999,0,9999,0
1653586999042,ECE 200,048,091050,Trivedi; Mohan M.,9999,0,9999,0
1653586999042,ECE 200,049,091051,Vardy; Alexander,9999,0,9999,0
1653586999042,ECE 200,050,091052,Vasconcelos; Nuno,9999,0,9999,0
1653586999042,ECE 200,051,091053,Wang; Xiaolong,9999,0,9999,0
1653586999042,ECE 200,052,091054,Xie; Pengtao,9999,0,9999,0
1653586999042,ECE 200,053,091055,Yip; Michael,9999,0,9999,0
1653586999042,ECE 200,054,091056,Zeger; Kenneth A.,9999,0,9999,0
1653586999042,ECE 200,055,091057,Zhang; Xinyu,9999,0,9999,0
1653586999042,ECE 200,056,091058,Turakhia; Yatish Girish,9999,0,9999,0
1653586999042,ECE 200,057,091059,Kang; Mingu,9999,0,9999,0
1653586999042,ECE 200,058,091060,Shi; Yuanyuan,9999,0,9999,0
1653586999042,ECE 200,059,091061,Wang; Edward Jay,9999,0,9999,0
1653586999042,ECE 200,060,091062,Zheng; Yang,9999,0,9999,0
1653586999564,ECE 201,A00,095526,Lo; Yu-Hwa,0,0,0,0
1653587000089,ECE 203,A00,091065,Mercier; Patrick Philip,0,0,0,0
1653587000613,ECE 207A,A00,091605,Liu; Thomas Tao-Ming,0,0,0,0
1653587001137,ECE 212AN,A00,091068,Nomura; Kenji,0,0,0,0
1653587001659,ECE 222A,A00,091069,Rebeiz; Gabriel,0,0,0,0
1653587002189,ECE 225A,A00,091070,Orlitsky; Alon,0,0,0,0
1653587002712,ECE 230A,A00,091071,Nomura; Kenji,0,0,0,0
1653587003240,ECE 236A,A00,091072,Dayeh; Shadi Ahmad,0,0,0,0
1653587003764,ECE 238A,A00,091073,Luo; Jian,0,0,0,0
1653587003764,ECE 238A,B00,091074,Luo; Jian,0,0,0,0
1653587004290,ECE 240A,A00,091075,Radic; Stojan,0,0,0,0
1653587004812,ECE 247A,A00,091592,Shi; Lingyan,0,0,0,0
1653587005335,ECE 250,A00,091076,Touri; Behrouz,0,0,0,0
1653587005861,ECE 251C,A00,091078,Nguyen; Truong Quang,0,0,0,0
1653587006384,ECE 253,A00,091079,Cosman; Pamela C.,0,0,0,0
1653587006911,ECE 255A,A00,091080,Orlitsky; Alon,0,0,0,0
1653587007433,ECE 257A,A00,091081,Zhang; Xinyu,0,0,0,0
1653587007958,ECE 260A,A01,091084,Eldon; John,0,0,0,0
1653587008480,ECE 264C,A00,091085,Galton; Ian A,0,0,0,0
1653587009011,ECE 265C,A00,094889,Presti; Calogero Davide,0,0,0,9
1653587009536,ECE 266,A01,091087,Hall; Drew A.,0,0,0,0
1653587010583,ECE 271A,A00,091090,Vasconcelos; Nuno,0,0,0,0
1653587011109,ECE 272B,A00,091091,Sworder; David D.,0,0,0,0
1653587011711,ECE 275A,A00,091092,Meyer; Florian,0,0,0,0
1653587012234,ECE 277,A00,091093,An; Cheolhong,0,0,0,0
1653587012761,ECE 283,A00,091094,Le; Hanh-Phuc,0,0,0,0
1653587013286,ECE 284,A00,091095,Kang; Mingu,0,0,0,0
1653587013286,ECE 284,B00,091096,Wang; Edward Jay,0,0,0,0
1653587013814,ECE 285,A00,094334,Touri; Behrouz,0,0,0,0
1653587014340,ECE 289,A00,091097,Whelan; David Arthur,0,0,0,0
1653587014866,MATH 200A,A00,087414,Salehi Golsefidy; Alireza,7,0,8,1
1653587015398,MATH 202A,A00,087415,Gill; Philip E.,2,0,8,6
1653587015929,MATH 203A,A00,087416,Oprea; Dragos N.,6,0,8,2
1653587016459,MATH 204A,A00,087417,Kedlaya; Kiran S.,6,0,8,2
1653587016981,MATH 205,A00,087418,Sorensen; Claus M,6,0,8,2
1653587017507,MATH 206A,A00,087419,Izadi; Elham,7,0,8,1
1653587018030,MATH 207A,A00,087420,Mohammadi; Amir,5,0,8,3
1653587018563,MATH 208,A00,087421,Staff,9,0,10,1
1653587019092,MATH 209,A00,087422,Staff,10,0,10,0
1653587019617,MATH 218,A00,087423,Staff,10,0,10,0
1653587020145,MATH 220A,A00,087424,Novak; Jonathan I,6,0,8,2
1653587020672,MATH 231A,A00,087425,Bejenaru; Ioan,3,0,8,5
1653587021194,MATH 240A,A00,087426,Ebenfelt; Peter F,5,0,8,3
1653587021724,MATH 243,A00,087427,Staff,9,0,10,1
1653587022246,MATH 248,A00,087429,Staff,10,0,10,0
1653587022770,MATH 250A,A00,087430,Spolaor; Luca,4,0,8,4
1653587023301,MATH 257A,A00,087431,Spolaor; Luca,7,0,8,1
1653587023826,MATH 258,A00,087432,Staff,9,0,10,1
1653587024356,MATH 264A,A00,087433,Warnke; Lutz Peter,5,0,8,3
1653587024878,MATH 268,A00,087434,Staff,15,0,15,0
1653587025406,MATH 269,A00,087435,Staff,14,0,15,1
1653587025938,MATH 270A,A00,087436,Nie; Jiawang,0,0,8,8
1653587026470,MATH 272A,A00,087437,Tian; Xiaochuan,1,0,8,7
1653587026997,MATH 274,A01,087439,Cheng; Li-Tien,9,0,10,1
1653587026997,MATH 274,A02,087440,Cheng; Li-Tien,10,0,10,0
1653587027519,MATH 278A,A00,087441,Staff,8,0,10,2
1653587028049,MATH 278B,A00,087442,Staff,8,0,10,2
1653587028574,MATH 278C,A00,087443,Staff,8,0,10,2
1653587029098,MATH 280A,A00,087444,Zheng; Tianyi,0,0,8,8
1653587029625,MATH 281A,A00,087445,Bradic; Jelena,0,0,8,8
1653587030148,MATH 282A,A00,087446,Zhang; Danna,0,0,8,8
1653587030671,MATH 283,A00,087447,Tesler; Glenn,0,0,0,16
1653587031209,MATH 286,B00,095535,Kemp; Todd Aahron,0,0,0,0
1653587031735,MATH 287D,B00,095536,Bradic; Jelena,7,0,8,1
1653587032261,MATH 288,A00,087450,Staff,14,0,15,1
1653587032261,MATH 288,B00,087451,Staff,15,0,15,0
1653587032261,MATH 288,C00,087452,Staff,15,0,15,0
1653587032784,MATH 290A,A00,087453,Xu; Zhouli,6,0,8,2
1653587033320,MATH 291A,A00,087454,Xu; Zhouli,7,0,8,1
1653587033845,MATH 292,A00,087455,Staff,10,0,10,0
1653587034371,MATH 295,A00,087456,Staff,50,0,50,0
1653587034896,MATH 297,001,087457,Staff,998,0,999,1
1653587596006,COGS 200,A01,087991,Staff,47,0,50,3
1653587596530,COGS 201,A01,094504,Rangel; Lara M,16,0,25,9
1653587597064,COGS 203,A00,087992,Coulson; Seana M,18,0,20,2
1653587597587,COGS 210A,001,087993,Greene; Deanna Jacquelyn,9998,0,9999,1
1653587597587,COGS 210A,002,087994,Saygin; Ayse P,9999,0,9999,0
1653587597587,COGS 210A,003,087995,Xia; Haijun,9999,0,9999,0
1653587597587,COGS 210A,004,087996,Nitz; Douglas A.,9999,0,9999,0
1653587597587,COGS 210A,005,087997,Hollan; James D.,9999,0,9999,0
1653587597587,COGS 210A,006,087998,Deak; Gedeon O.,9998,0,9999,1
1653587597587,COGS 210A,007,087999,Rossano; Federico,9999,0,9999,0
1653587598130,COGS 211A,A00,088000,Coulson; Seana M,9997,0,9999,2
1653587598655,COGS 229,A00,088002,Staff,22,0,25,3
1653587599180,COGS 260,B00,094231,Staff,17,0,20,3
1653587599180,COGS 260,A00,088004,Nitz; Douglas A.,9998,0,9999,1
1653587599710,CSE 202,A00,090110,Paturi; Ramamohan,0,0,0,0
1653587599710,CSE 202,B00,090111,Paturi; Ramamohan,0,0,0,0
1653587600338,CSE 207B,A00,090112,Heninger; Nadia A,0,0,0,0
1653587600872,CSE 208,A00,094858,Micciancio; Daniele,0,0,0,0
1653587601403,CSE 210,A00,090113,Powell; Thomas Allan,0,0,0,0
1653587601941,CSE 219,A00,090898,Staff,0,0,0,0
1653587602463,CSE 221,A00,090114,Zhou; Yuan-Yuan,0,0,0,0
1653587603001,CSE 229A,A00,090115,Porter; George M,0,0,0,0
1653587603526,CSE 229C,A00,090116,Savage; Stefan,0,0,0,0
1653587604052,CSE 230,A00,090117,Jhala; Ranjit,0,0,0,0
1653587604579,CSE 232,A00,090118,Papakonstantinou; Yannis,0,0,0,0
1653587605102,CSE 239A,A00,090121,Kumar; Arun Kumar,0,0,0,0
1653587605625,CSE 239B,A00,090122,Jhala; Ranjit,0,0,0,0
1653587606150,CSE 240A,A00,090123,Zhao; Jishen,1,0,189,188
1653587606683,CSE 243A,A00,090124,Orailoglu; Alex,0,0,15,15
1653587607204,CSE 249B,A00,090125,Kahng; Andrew Byun,13,0,20,7
1653587607725,CSE 250A,A00,090126,Berg-Kirkpatrick; Taylor D,0,0,0,0
1653587608252,CSE 252A,A00,090127,Ochoa; Benjamin Lawrence,0,0,0,0
1653587608778,CSE 258,A01,090129,McAuley; Julian John,0,0,0,0
1653587609304,CSE 258R,A01,090131,McAuley; Julian John,0,0,0,0
1653587609840,CSE 274,A00,090132,Ramamoorthi; Ravi,0,0,0,0
1653587610364,CSE 276A,A00,090133,Christensen; Henrik I,0,0,0,0
1653587610891,CSE 276C,A00,090134,Christensen; Henrik I,0,0,0,0
1653587611419,CSE 290,A00,090135,Bafna; Vineet,0,0,0,0
1653587611419,CSE 290,B00,090136,Ramamoorthi; Ravi,0,0,0,0
1653587611419,CSE 290,C00,090137,Li; Tzumao,8,0,10,2
1653587611419,CSE 290,D00,090138,Zhou; Yuan-Yuan,9,0,10,1
1653587611419,CSE 290,E00,090139,Christensen; Henrik I,8,0,10,2
1653587611419,CSE 290,F00,094053,Shalev; Aaron D,0,0,0,0
1653587611951,CSE 291,A00,090140,Munyaka; Imani N. S.,0,0,0,0
1653587611951,CSE 291,B00,094880,Yu; Qi,0,0,0,0
1653587611951,CSE 291,C00,090142,Pannuto; Patrick William,0,0,0,0
1653587611951,CSE 291,D00,094881,Zhang; Yiying,0,0,0,0
1653587611951,CSE 291,E00,095118,Su; Hao,0,0,0,0
1653587612512,CSE 293,001,094905,Bafna; Vineet,9999,0,9999,0
1653587612512,CSE 293,002,094906,Bellare; Mihir,9999,0,9999,0
1653587612512,CSE 293,003,094907,Berg-Kirkpatrick; Taylor D,9999,0,9999,0
1653587612512,CSE 293,004,094908,Christensen; Henrik I,9999,0,9999,0
1653587612512,CSE 293,005,094909,Cottrell; Garrison W,9999,0,9999,0
1653587612512,CSE 293,006,094910,Deutsch; Alin Bernard,9999,0,9999,0
1653587612512,CSE 293,007,094911,Esmaeilzadeh; Hadi,9999,0,9999,0
1653587612512,CSE 293,008,094912,Freund; Yoav,9999,0,9999,0
1653587612512,CSE 293,009,094913,Griswold; William G.,9999,0,9999,0
1653587612512,CSE 293,010,094914,Gymrek; Melissa Ann,9999,0,9999,0
1653587612512,CSE 293,011,094915,Heninger; Nadia A,9999,0,9999,0
1653587612512,CSE 293,012,094916,Impagliazzo; Russell,9999,0,9999,0
1653587612512,CSE 293,013,094917,Jhala; Ranjit,9999,0,9999,0
1653587612512,CSE 293,014,094918,Kahng; Andrew Byun,9999,0,9999,0
1653587612512,CSE 293,015,094919,Kane; Daniel Mertz,9999,0,9999,0
1653587612512,CSE 293,016,094920,Kriegman; David J,9999,0,9999,0
1653587612512,CSE 293,017,094921,Kumar; Arun Kumar,9999,0,9999,0
1653587612512,CSE 293,018,094922,Lerner; Sorin,9999,0,9999,0
1653587612512,CSE 293,019,094923,Lovett; Shachar,9999,0,9999,0
1653587612512,CSE 293,020,094924,McAuley; Julian John,9999,0,9999,0
1653587612512,CSE 293,021,094925,Micciancio; Daniele,9999,0,9999,0
1653587612512,CSE 293,022,094926,Orailoglu; Alex,9999,0,9999,0
1653587612512,CSE 293,023,094927,Paturi; Ramamohan,9999,0,9999,0
1653587612512,CSE 293,024,094928,Polikarpova; Nadezhda,9999,0,9999,0
1653587612512,CSE 293,025,094929,Politz; Joseph Gibbs,9999,0,9999,0
1653587612512,CSE 293,026,094930,Porter; George M,9999,0,9999,0
1653587612512,CSE 293,027,094931,Porter; Leonard Emerson,9999,0,9999,0
1653587612512,CSE 293,028,094932,Ramamoorthi; Ravi,9999,0,9999,0
1653587612512,CSE 293,029,094933,Sahoo; Debashis,9999,0,9999,0
1653587612512,CSE 293,030,094934,Saul; Lawrence,9999,0,9999,0
1653587612512,CSE 293,031,094935,Savage; Stefan,9999,0,9999,0
1653587612512,CSE 293,032,094936,Schulze; Jurgen P.,9999,0,9999,0
1653587612512,CSE 293,033,094937,Snoeren; Alex C.,9999,0,9999,0
1653587612512,CSE 293,034,094938,Shang; Jingbo,9999,0,9999,0
1653587612512,CSE 293,035,094939,Stefan; Deian,9999,0,9999,0
1653587612512,CSE 293,036,094940,Su; Hao,9999,0,9999,0
1653587612512,CSE 293,037,094941,Swanson; Steven James,9999,0,9999,0
1653587612512,CSE 293,038,094942,Tullsen; Dean Michael,9999,0,9999,0
1653587612512,CSE 293,039,094943,Voelker; Geoffrey M.,9999,0,9999,0
1653587612512,CSE 293,040,094944,Zhao; Jishen,9999,0,9999,0
1653587612512,CSE 293,041,094945,Zhou; Yuan-Yuan,9999,0,9999,0
1653587612512,CSE 293,042,094946,Gao; Sicun,9998,0,9999,1
1653587612512,CSE 293,043,094947,Weibel; Nadir,9999,0,9999,0
1653587612512,CSE 293,044,094948,Gupta; Rajesh K.,9999,0,9999,0
1653587613041,CSE 294,A00,090143,Porter; George M,8,0,10,2
1653587613567,DSE 200,A00,091799,Staff,50,0,50,0
1653587614098,DSE 203,A00,091800,Gupta; Amarnath,30,0,30,0
1653587614626,DSE 250,A00,091801,Deutsch; Alin Bernard,30,0,30,0
1653587615150,DSE 290,A00,091802,Altintas De Callaf; Ilkay,50,0,50,0
1653587615683,ECE 200,001,091003,Antipa; Nicholas A,9999,0,9999,0
1653587615683,ECE 200,002,091004,Atanasov; Nikolay A.,9999,0,9999,0
1653587615683,ECE 200,003,091005,Bharadia; Dinesh,9999,0,9999,0
1653587615683,ECE 200,004,091006,Cheng; Chung Kuan,9999,0,9999,0
1653587615683,ECE 200,005,091007,Cosman; Pamela C.,9999,0,9999,0
1653587615683,ECE 200,006,091008,Staff,9999,0,9999,0
1653587615683,ECE 200,007,091009,Dayeh; Shadi Ahmad,9999,0,9999,0
1653587615683,ECE 200,008,091010,Fainman; Yeshaiahu,9999,0,9999,0
1653587615683,ECE 200,009,091011,Ford; Joseph Earl,9999,0,9999,0
1653587615683,ECE 200,010,091012,Franceschetti; Massimo,9999,0,9999,0
1653587615683,ECE 200,011,091013,Fullerton; Eric E,9999,0,9999,0
1653587615683,ECE 200,012,091014,Galton; Ian A,9999,0,9999,0
1653587615683,ECE 200,013,091015,Gilja; Vikash,9999,0,9999,0
1653587615683,ECE 200,014,091016,Hall; Drew A.,9999,0,9999,0
1653587615683,ECE 200,015,091017,Hsueh; Tzu-Chien,9999,0,9999,0
1653587615683,ECE 200,016,091018,Javidi; Tara,9999,0,9999,0
1653587615683,ECE 200,017,091019,Kahng; Andrew Byun,9999,0,9999,0
1653587615683,ECE 200,018,091020,Kim; Young-Han,9999,0,9999,0
1653587615683,ECE 200,019,091021,Koushanfar; Farinaz,9999,0,9999,0
1653587615683,ECE 200,020,091022,Kuzum; Duygu,9999,0,9999,0
1653587615683,ECE 200,021,091023,Le; Hanh-Phuc,9999,0,9999,0
1653587615683,ECE 200,022,091024,Lin; Bill,9999,0,9999,0
1653587615683,ECE 200,023,091025,Liu; Zhaowei,9999,0,9999,0
1653587615683,ECE 200,024,091026,Lo; Yu-Hwa,9999,0,9999,0
1653587615683,ECE 200,025,091027,Lomakin; Vitaliy,9999,0,9999,0
1653587615683,ECE 200,026,091028,Mercier; Patrick Philip,9999,0,9999,0
1653587615683,ECE 200,027,091029,Meyer; Florian,9999,0,9999,0
1653587615683,ECE 200,028,091030,Milstein; Laurence B.,9999,0,9999,0
1653587615683,ECE 200,029,091031,Mir Arabbaygi; Siavash,9999,0,9999,0
1653587615683,ECE 200,030,091032,Mookherjea; Shayan,9999,0,9999,0
1653587615683,ECE 200,031,091033,Morris; Karcher William,9999,0,9999,0
1653587615683,ECE 200,032,091034,Ng; Tse Nga,9999,0,9999,0
1653587615683,ECE 200,033,091035,Nguyen; Truong Quang,9999,0,9999,0
1653587615683,ECE 200,034,091036,Nomura; Kenji,9999,0,9999,0
1653587615683,ECE 200,035,091037,Orlitsky; Alon,9999,0,9999,0
1653587615683,ECE 200,036,091038,Pal; Piya,9999,0,9999,0
1653587615683,ECE 200,037,091039,Papen; George C.,9999,0,9999,0
1653587615683,ECE 200,038,091040,Radic; Stojan,9999,0,9999,0
1653587615683,ECE 200,039,091041,Rao; Bhaskar D.,9999,0,9999,0
1653587615683,ECE 200,040,091042,Rao; Ramesh R,9999,0,9999,0
1653587615683,ECE 200,041,091043,Rebeiz; Gabriel,9999,0,9999,0
1653587615683,ECE 200,042,091044,Sanford; John R,9999,0,9999,0
1653587615683,ECE 200,043,091045,Siegel; Paul H.,9999,0,9999,0
1653587615683,ECE 200,044,091046,Sievenpiper; Daniel F.,9999,0,9999,0
1653587615683,ECE 200,045,091047,Sworder; David D.,9999,0,9999,0
1653587615683,ECE 200,046,091048,Taur; Yuan,9999,0,9999,0
1653587615683,ECE 200,047,091049,Touri; Behrouz,9999,0,9999,0
1653587615683,ECE 200,048,091050,Trivedi; Mohan M.,9999,0,9999,0
1653587615683,ECE 200,049,091051,Vardy; Alexander,9999,0,9999,0
1653587615683,ECE 200,050,091052,Vasconcelos; Nuno,9999,0,9999,0
1653587615683,ECE 200,051,091053,Wang; Xiaolong,9999,0,9999,0
1653587615683,ECE 200,052,091054,Xie; Pengtao,9999,0,9999,0
1653587615683,ECE 200,053,091055,Yip; Michael,9999,0,9999,0
1653587615683,ECE 200,054,091056,Zeger; Kenneth A.,9999,0,9999,0
1653587615683,ECE 200,055,091057,Zhang; Xinyu,9999,0,9999,0
1653587615683,ECE 200,056,091058,Turakhia; Yatish Girish,9999,0,9999,0
1653587615683,ECE 200,057,091059,Kang; Mingu,9999,0,9999,0
1653587615683,ECE 200,058,091060,Shi; Yuanyuan,9999,0,9999,0
1653587615683,ECE 200,059,091061,Wang; Edward Jay,9999,0,9999,0
1653587615683,ECE 200,060,091062,Zheng; Yang,9999,0,9999,0
1653587616209,ECE 201,A00,095526,Lo; Yu-Hwa,0,0,0,0
1653587616735,ECE 203,A00,091065,Mercier; Patrick Philip,0,0,0,0
1653587617258,ECE 207A,A00,091605,Liu; Thomas Tao-Ming,0,0,0,0
1653587617782,ECE 212AN,A00,091068,Nomura; Kenji,0,0,0,0
1653587618310,ECE 222A,A00,091069,Rebeiz; Gabriel,0,0,0,0
1653587618834,ECE 225A,A00,091070,Orlitsky; Alon,0,0,0,0
1653587619363,ECE 230A,A00,091071,Nomura; Kenji,0,0,0,0
1653587619886,ECE 236A,A00,091072,Dayeh; Shadi Ahmad,0,0,0,0
1653587620416,ECE 238A,A00,091073,Luo; Jian,0,0,0,0
1653587620416,ECE 238A,B00,091074,Luo; Jian,0,0,0,0
1653587620941,ECE 240A,A00,091075,Radic; Stojan,0,0,0,0
1653587621463,ECE 247A,A00,091592,Shi; Lingyan,0,0,0,0
1653587621986,ECE 250,A00,091076,Touri; Behrouz,0,0,0,0
1653587622511,ECE 251C,A00,091078,Nguyen; Truong Quang,0,0,0,0
1653587623034,ECE 253,A00,091079,Cosman; Pamela C.,0,0,0,0
1653587623568,ECE 255A,A00,091080,Orlitsky; Alon,0,0,0,0
1653587624092,ECE 257A,A00,091081,Zhang; Xinyu,0,0,0,0
1653587624625,ECE 260A,A01,091084,Eldon; John,0,0,0,0
1653587625149,ECE 264C,A00,091085,Galton; Ian A,0,0,0,0
1653587625684,ECE 265C,A00,094889,Presti; Calogero Davide,0,0,0,9
1653587626214,ECE 266,A01,091087,Hall; Drew A.,0,0,0,0
1653587627271,ECE 271A,A00,091090,Vasconcelos; Nuno,0,0,0,0
1653587627801,ECE 272B,A00,091091,Sworder; David D.,0,0,0,0
1653587628325,ECE 275A,A00,091092,Meyer; Florian,0,0,0,0
1653587628847,ECE 277,A00,091093,An; Cheolhong,0,0,0,0
1653587629385,ECE 283,A00,091094,Le; Hanh-Phuc,0,0,0,0
1653587629910,ECE 284,A00,091095,Kang; Mingu,0,0,0,0
1653587629910,ECE 284,B00,091096,Wang; Edward Jay,0,0,0,0
1653587630432,ECE 285,A00,094334,Touri; Behrouz,0,0,0,0
1653587630957,ECE 289,A00,091097,Whelan; David Arthur,0,0,0,0
1653587631480,MATH 200A,A00,087414,Salehi Golsefidy; Alireza,7,0,8,1
1653587632002,MATH 202A,A00,087415,Gill; Philip E.,2,0,8,6
1653587632523,MATH 203A,A00,087416,Oprea; Dragos N.,6,0,8,2
1653587633047,MATH 204A,A00,087417,Kedlaya; Kiran S.,6,0,8,2
1653587633573,MATH 205,A00,087418,Sorensen; Claus M,6,0,8,2
1653587634099,MATH 206A,A00,087419,Izadi; Elham,7,0,8,1
1653587634627,MATH 207A,A00,087420,Mohammadi; Amir,5,0,8,3
1653587635150,MATH 208,A00,087421,Staff,9,0,10,1
1653587635686,MATH 209,A00,087422,Staff,10,0,10,0
1653587636216,MATH 218,A00,087423,Staff,10,0,10,0
1653587636741,MATH 220A,A00,087424,Novak; Jonathan I,6,0,8,2
1653587637273,MATH 231A,A00,087425,Bejenaru; Ioan,3,0,8,5
1653587637796,MATH 240A,A00,087426,Ebenfelt; Peter F,5,0,8,3
1653587638318,MATH 243,A00,087427,Staff,9,0,10,1
1653587638849,MATH 248,A00,087429,Staff,10,0,10,0
1653587639373,MATH 250A,A00,087430,Spolaor; Luca,4,0,8,4
1653587639896,MATH 257A,A00,087431,Spolaor; Luca,7,0,8,1
1653587640417,MATH 258,A00,087432,Staff,9,0,10,1
1653587640942,MATH 264A,A00,087433,Warnke; Lutz Peter,5,0,8,3
1653587641464,MATH 268,A00,087434,Staff,15,0,15,0
1653587641987,MATH 269,A00,087435,Staff,14,0,15,1
1653587642509,MATH 270A,A00,087436,Nie; Jiawang,0,0,8,8
1653587643032,MATH 272A,A00,087437,Tian; Xiaochuan,1,0,8,7
1653587643569,MATH 274,A01,087439,Cheng; Li-Tien,9,0,10,1
1653587643569,MATH 274,A02,087440,Cheng; Li-Tien,10,0,10,0
1653587644092,MATH 278A,A00,087441,Staff,8,0,10,2
1653587644630,MATH 278B,A00,087442,Staff,8,0,10,2
1653587645155,MATH 278C,A00,087443,Staff,8,0,10,2
1653587645684,MATH 280A,A00,087444,Zheng; Tianyi,0,0,8,8
1653587646205,MATH 281A,A00,087445,Bradic; Jelena,0,0,8,8
1653587646737,MATH 282A,A00,087446,Zhang; Danna,0,0,8,8
1653587647263,MATH 283,A00,087447,Tesler; Glenn,0,0,0,16
1653587647787,MATH 286,B00,095535,Kemp; Todd Aahron,0,0,0,0
1653587648309,MATH 287D,B00,095536,Bradic; Jelena,7,0,8,1
1653587648831,MATH 288,A00,087450,Staff,14,0,15,1
1653587648831,MATH 288,B00,087451,Staff,15,0,15,0
1653587648831,MATH 288,C00,087452,Staff,15,0,15,0
1653587649352,MATH 290A,A00,087453,Xu; Zhouli,6,0,8,2
1653587649877,MATH 291A,A00,087454,Xu; Zhouli,7,0,8,1
1653587650406,MATH 292,A00,087455,Staff,10,0,10,0
1653587650929,MATH 295,A00,087456,Staff,50,0,50,0
1653587651474,MATH 297,001,087457,Staff,998,0,999,1
1653588215076,COGS 200,A01,087991,Staff,47,0,50,3
1653588215600,COGS 201,A01,094504,Rangel; Lara M,16,0,25,9
1653588216131,COGS 203,A00,087992,Coulson; Seana M,18,0,20,2
1653588216658,COGS 210A,001,087993,Greene; Deanna Jacquelyn,9998,0,9999,1
1653588216658,COGS 210A,002,087994,Saygin; Ayse P,9999,0,9999,0
1653588216658,COGS 210A,003,087995,Xia; Haijun,9999,0,9999,0
1653588216658,COGS 210A,004,087996,Nitz; Douglas A.,9999,0,9999,0
1653588216658,COGS 210A,005,087997,Hollan; James D.,9999,0,9999,0
1653588216658,COGS 210A,006,087998,Deak; Gedeon O.,9998,0,9999,1
1653588216658,COGS 210A,007,087999,Rossano; Federico,9999,0,9999,0
1653588217190,COGS 211A,A00,088000,Coulson; Seana M,9997,0,9999,2
1653588217721,COGS 229,A00,088002,Staff,22,0,25,3
1653588218244,COGS 260,B00,094231,Staff,17,0,20,3
1653588218244,COGS 260,A00,088004,Nitz; Douglas A.,9998,0,9999,1
1653588218767,CSE 202,A00,090110,Paturi; Ramamohan,0,0,0,0
1653588218767,CSE 202,B00,090111,Paturi; Ramamohan,0,0,0,0
1653588219287,CSE 207B,A00,090112,Heninger; Nadia A,0,0,0,0
1653588219813,CSE 208,A00,094858,Micciancio; Daniele,0,0,0,0
1653588220339,CSE 210,A00,090113,Powell; Thomas Allan,0,0,0,0
1653588220866,CSE 219,A00,090898,Staff,0,0,0,0
1653588221396,CSE 221,A00,090114,Zhou; Yuan-Yuan,0,0,0,0
1653588221918,CSE 229A,A00,090115,Porter; George M,0,0,0,0
1653588222450,CSE 229C,A00,090116,Savage; Stefan,0,0,0,0
1653588222975,CSE 230,A00,090117,Jhala; Ranjit,0,0,0,0
1653588223518,CSE 232,A00,090118,Papakonstantinou; Yannis,0,0,0,0
1653588224054,CSE 239A,A00,090121,Kumar; Arun Kumar,0,0,0,0
1653588224576,CSE 239B,A00,090122,Jhala; Ranjit,0,0,0,0
1653588225111,CSE 240A,A00,090123,Zhao; Jishen,0,0,189,189
1653588225634,CSE 243A,A00,090124,Orailoglu; Alex,0,0,15,15
1653588226160,CSE 249B,A00,090125,Kahng; Andrew Byun,13,0,20,7
1653588226682,CSE 250A,A00,090126,Berg-Kirkpatrick; Taylor D,0,0,0,0
1653588227204,CSE 252A,A00,090127,Ochoa; Benjamin Lawrence,0,0,0,0
1653588227728,CSE 258,A01,090129,McAuley; Julian John,0,0,0,0
1653588228250,CSE 258R,A01,090131,McAuley; Julian John,0,0,0,0
1653588228777,CSE 274,A00,090132,Ramamoorthi; Ravi,0,0,0,0
1653588229299,CSE 276A,A00,090133,Christensen; Henrik I,0,0,0,0
1653588229823,CSE 276C,A00,090134,Christensen; Henrik I,0,0,0,0
1653588230356,CSE 290,A00,090135,Bafna; Vineet,0,0,0,0
1653588230356,CSE 290,B00,090136,Ramamoorthi; Ravi,0,0,0,0
1653588230356,CSE 290,C00,090137,Li; Tzumao,7,0,10,3
1653588230356,CSE 290,D00,090138,Zhou; Yuan-Yuan,9,0,10,1
1653588230356,CSE 290,E00,090139,Christensen; Henrik I,8,0,10,2
1653588230356,CSE 290,F00,094053,Shalev; Aaron D,0,0,0,0
1653588230880,CSE 291,A00,090140,Munyaka; Imani N. S.,0,0,0,0
1653588230880,CSE 291,B00,094880,Yu; Qi,0,0,0,0
1653588230880,CSE 291,C00,090142,Pannuto; Patrick William,0,0,0,0
1653588230880,CSE 291,D00,094881,Zhang; Yiying,0,0,0,0
1653588230880,CSE 291,E00,095118,Su; Hao,0,0,0,0
1653588231414,CSE 293,001,094905,Bafna; Vineet,9999,0,9999,0
1653588231414,CSE 293,002,094906,Bellare; Mihir,9999,0,9999,0
1653588231414,CSE 293,003,094907,Berg-Kirkpatrick; Taylor D,9999,0,9999,0
1653588231414,CSE 293,004,094908,Christensen; Henrik I,9999,0,9999,0
1653588231414,CSE 293,005,094909,Cottrell; Garrison W,9999,0,9999,0
1653588231414,CSE 293,006,094910,Deutsch; Alin Bernard,9999,0,9999,0
1653588231414,CSE 293,007,094911,Esmaeilzadeh; Hadi,9999,0,9999,0
1653588231414,CSE 293,008,094912,Freund; Yoav,9999,0,9999,0
1653588231414,CSE 293,009,094913,Griswold; William G.,9999,0,9999,0
1653588231414,CSE 293,010,094914,Gymrek; Melissa Ann,9999,0,9999,0
1653588231414,CSE 293,011,094915,Heninger; Nadia A,9999,0,9999,0
1653588231414,CSE 293,012,094916,Impagliazzo; Russell,9999,0,9999,0
1653588231414,CSE 293,013,094917,Jhala; Ranjit,9999,0,9999,0
1653588231414,CSE 293,014,094918,Kahng; Andrew Byun,9999,0,9999,0
1653588231414,CSE 293,015,094919,Kane; Daniel Mertz,9999,0,9999,0
1653588231414,CSE 293,016,094920,Kriegman; David J,9999,0,9999,0
1653588231414,CSE 293,017,094921,Kumar; Arun Kumar,9999,0,9999,0
1653588231414,CSE 293,018,094922,Lerner; Sorin,9999,0,9999,0
1653588231414,CSE 293,019,094923,Lovett; Shachar,9999,0,9999,0
1653588231414,CSE 293,020,094924,McAuley; Julian John,9999,0,9999,0
1653588231414,CSE 293,021,094925,Micciancio; Daniele,9999,0,9999,0
1653588231414,CSE 293,022,094926,Orailoglu; Alex,9999,0,9999,0
1653588231414,CSE 293,023,094927,Paturi; Ramamohan,9999,0,9999,0
1653588231414,CSE 293,024,094928,Polikarpova; Nadezhda,9999,0,9999,0
1653588231414,CSE 293,025,094929,Politz; Joseph Gibbs,9999,0,9999,0
1653588231414,CSE 293,026,094930,Porter; George M,9999,0,9999,0
1653588231414,CSE 293,027,094931,Porter; Leonard Emerson,9999,0,9999,0
1653588231414,CSE 293,028,094932,Ramamoorthi; Ravi,9999,0,9999,0
1653588231414,CSE 293,029,094933,Sahoo; Debashis,9999,0,9999,0
1653588231414,CSE 293,030,094934,Saul; Lawrence,9999,0,9999,0
1653588231414,CSE 293,031,094935,Savage; Stefan,9999,0,9999,0
1653588231414,CSE 293,032,094936,Schulze; Jurgen P.,9999,0,9999,0
1653588231414,CSE 293,033,094937,Snoeren; Alex C.,9999,0,9999,0
1653588231414,CSE 293,034,094938,Shang; Jingbo,9999,0,9999,0
1653588231414,CSE 293,035,094939,Stefan; Deian,9999,0,9999,0
1653588231414,CSE 293,036,094940,Su; Hao,9999,0,9999,0
1653588231414,CSE 293,037,094941,Swanson; Steven James,9999,0,9999,0
1653588231414,CSE 293,038,094942,Tullsen; Dean Michael,9999,0,9999,0
1653588231414,CSE 293,039,094943,Voelker; Geoffrey M.,9999,0,9999,0
1653588231414,CSE 293,040,094944,Zhao; Jishen,9999,0,9999,0
1653588231414,CSE 293,041,094945,Zhou; Yuan-Yuan,9999,0,9999,0
1653588231414,CSE 293,042,094946,Gao; Sicun,9998,0,9999,1
1653588231414,CSE 293,043,094947,Weibel; Nadir,9999,0,9999,0
1653588231414,CSE 293,044,094948,Gupta; Rajesh K.,9999,0,9999,0
1653588231940,CSE 294,A00,090143,Porter; George M,8,0,10,2
1653588232465,DSE 200,A00,091799,Staff,50,0,50,0
1653588232996,DSE 203,A00,091800,Gupta; Amarnath,30,0,30,0
1653588233530,DSE 250,A00,091801,Deutsch; Alin Bernard,30,0,30,0
1653588234062,DSE 290,A00,091802,Altintas De Callaf; Ilkay,50,0,50,0
1653588234588,ECE 200,001,091003,Antipa; Nicholas A,9999,0,9999,0
1653588234588,ECE 200,002,091004,Atanasov; Nikolay A.,9999,0,9999,0
1653588234588,ECE 200,003,091005,Bharadia; Dinesh,9999,0,9999,0
1653588234588,ECE 200,004,091006,Cheng; Chung Kuan,9999,0,9999,0
1653588234588,ECE 200,005,091007,Cosman; Pamela C.,9999,0,9999,0
1653588234588,ECE 200,006,091008,Staff,9999,0,9999,0
1653588234588,ECE 200,007,091009,Dayeh; Shadi Ahmad,9999,0,9999,0
1653588234588,ECE 200,008,091010,Fainman; Yeshaiahu,9999,0,9999,0
1653588234588,ECE 200,009,091011,Ford; Joseph Earl,9999,0,9999,0
1653588234588,ECE 200,010,091012,Franceschetti; Massimo,9999,0,9999,0
1653588234588,ECE 200,011,091013,Fullerton; Eric E,9999,0,9999,0
1653588234588,ECE 200,012,091014,Galton; Ian A,9999,0,9999,0
1653588234588,ECE 200,013,091015,Gilja; Vikash,9999,0,9999,0
1653588234588,ECE 200,014,091016,Hall; Drew A.,9999,0,9999,0
1653588234588,ECE 200,015,091017,Hsueh; Tzu-Chien,9999,0,9999,0
1653588234588,ECE 200,016,091018,Javidi; Tara,9999,0,9999,0
1653588234588,ECE 200,017,091019,Kahng; Andrew Byun,9999,0,9999,0
1653588234588,ECE 200,018,091020,Kim; Young-Han,9999,0,9999,0
1653588234588,ECE 200,019,091021,Koushanfar; Farinaz,9999,0,9999,0
1653588234588,ECE 200,020,091022,Kuzum; Duygu,9999,0,9999,0
1653588234588,ECE 200,021,091023,Le; Hanh-Phuc,9999,0,9999,0
1653588234588,ECE 200,022,091024,Lin; Bill,9999,0,9999,0
1653588234588,ECE 200,023,091025,Liu; Zhaowei,9999,0,9999,0
1653588234588,ECE 200,024,091026,Lo; Yu-Hwa,9999,0,9999,0
1653588234588,ECE 200,025,091027,Lomakin; Vitaliy,9999,0,9999,0
1653588234588,ECE 200,026,091028,Mercier; Patrick Philip,9999,0,9999,0
1653588234588,ECE 200,027,091029,Meyer; Florian,9999,0,9999,0
1653588234588,ECE 200,028,091030,Milstein; Laurence B.,9999,0,9999,0
1653588234588,ECE 200,029,091031,Mir Arabbaygi; Siavash,9999,0,9999,0
1653588234588,ECE 200,030,091032,Mookherjea; Shayan,9999,0,9999,0
1653588234588,ECE 200,031,091033,Morris; Karcher William,9999,0,9999,0
1653588234588,ECE 200,032,091034,Ng; Tse Nga,9999,0,9999,0
1653588234588,ECE 200,033,091035,Nguyen; Truong Quang,9999,0,9999,0
1653588234588,ECE 200,034,091036,Nomura; Kenji,9999,0,9999,0
1653588234588,ECE 200,035,091037,Orlitsky; Alon,9999,0,9999,0
1653588234588,ECE 200,036,091038,Pal; Piya,9999,0,9999,0
1653588234588,ECE 200,037,091039,Papen; George C.,9999,0,9999,0
1653588234588,ECE 200,038,091040,Radic; Stojan,9999,0,9999,0
1653588234588,ECE 200,039,091041,Rao; Bhaskar D.,9999,0,9999,0
1653588234588,ECE 200,040,091042,Rao; Ramesh R,9999,0,9999,0
1653588234588,ECE 200,041,091043,Rebeiz; Gabriel,9999,0,9999,0
1653588234588,ECE 200,042,091044,Sanford; John R,9999,0,9999,0
1653588234588,ECE 200,043,091045,Siegel; Paul H.,9999,0,9999,0
1653588234588,ECE 200,044,091046,Sievenpiper; Daniel F.,9999,0,9999,0
1653588234588,ECE 200,045,091047,Sworder; David D.,9999,0,9999,0
1653588234588,ECE 200,046,091048,Taur; Yuan,9999,0,9999,0
1653588234588,ECE 200,047,091049,Touri; Behrouz,9999,0,9999,0
1653588234588,ECE 200,048,091050,Trivedi; Mohan M.,9999,0,9999,0
1653588234588,ECE 200,049,091051,Vardy; Alexander,9999,0,9999,0
1653588234588,ECE 200,050,091052,Vasconcelos; Nuno,9999,0,9999,0
1653588234588,ECE 200,051,091053,Wang; Xiaolong,9999,0,9999,0
1653588234588,ECE 200,052,091054,Xie; Pengtao,9999,0,9999,0
1653588234588,ECE 200,053,091055,Yip; Michael,9999,0,9999,0
1653588234588,ECE 200,054,091056,Zeger; Kenneth A.,9999,0,9999,0
1653588234588,ECE 200,055,091057,Zhang; Xinyu,9999,0,9999,0
1653588234588,ECE 200,056,091058,Turakhia; Yatish Girish,9999,0,9999,0
1653588234588,ECE 200,057,091059,Kang; Mingu,9999,0,9999,0
1653588234588,ECE 200,058,091060,Shi; Yuanyuan,9999,0,9999,0
1653588234588,ECE 200,059,091061,Wang; Edward Jay,9999,0,9999,0
1653588234588,ECE 200,060,091062,Zheng; Yang,9999,0,9999,0
1653588235126,ECE 201,A00,095526,Lo; Yu-Hwa,0,0,0,0
1653588235653,ECE 203,A00,091065,Mercier; Patrick Philip,0,0,0,0
1653588236392,ECE 207A,A00,091605,Liu; Thomas Tao-Ming,0,0,0,0
1653588236924,ECE 212AN,A00,091068,Nomura; Kenji,0,0,0,0
1653588237447,ECE 222A,A00,091069,Rebeiz; Gabriel,0,0,0,0
1653588237970,ECE 225A,A00,091070,Orlitsky; Alon,0,0,0,0
1653588238505,ECE 230A,A00,091071,Nomura; Kenji,0,0,0,0
1653588239028,ECE 236A,A00,091072,Dayeh; Shadi Ahmad,0,0,0,0
1653588239551,ECE 238A,A00,091073,Luo; Jian,0,0,0,0
1653588239551,ECE 238A,B00,091074,Luo; Jian,0,0,0,0
1653588240073,ECE 240A,A00,091075,Radic; Stojan,0,0,0,0
1653588240604,ECE 247A,A00,091592,Shi; Lingyan,0,0,0,0
1653588241133,ECE 250,A00,091076,Touri; Behrouz,0,0,0,0
1653588241662,ECE 251C,A00,091078,Nguyen; Truong Quang,0,0,0,0
1653588242183,ECE 253,A00,091079,Cosman; Pamela C.,0,0,0,0
1653588242725,ECE 255A,A00,091080,Orlitsky; Alon,0,0,0,0
1653588243254,ECE 257A,A00,091081,Zhang; Xinyu,0,0,0,0
1653588243783,ECE 260A,A01,091084,Eldon; John,0,0,0,0
1653588244319,ECE 264C,A00,091085,Galton; Ian A,0,0,0,0
1653588244914,ECE 265C,A00,094889,Presti; Calogero Davide,0,0,0,9
1653588245441,ECE 266,A01,091087,Hall; Drew A.,0,0,0,0
1653588246489,ECE 271A,A00,091090,Vasconcelos; Nuno,0,0,0,0
1653588247016,ECE 272B,A00,091091,Sworder; David D.,0,0,0,0
1653588247538,ECE 275A,A00,091092,Meyer; Florian,0,0,0,0
1653588248062,ECE 277,A00,091093,An; Cheolhong,0,0,0,0
1653588248598,ECE 283,A00,091094,Le; Hanh-Phuc,0,0,0,0
1653588249132,ECE 284,A00,091095,Kang; Mingu,0,0,0,0
1653588249132,ECE 284,B00,091096,Wang; Edward Jay,0,0,0,0
1653588249658,ECE 285,A00,094334,Touri; Behrouz,0,0,0,0
1653588250187,ECE 289,A00,091097,Whelan; David Arthur,0,0,0,0
1653588250710,MATH 200A,A00,087414,Salehi Golsefidy; Alireza,7,0,8,1
1653588251239,MATH 202A,A00,087415,Gill; Philip E.,2,0,8,6
1653588251762,MATH 203A,A00,087416,Oprea; Dragos N.,6,0,8,2
1653588252286,MATH 204A,A00,087417,Kedlaya; Kiran S.,6,0,8,2
1653588252825,MATH 205,A00,087418,Sorensen; Claus M,6,0,8,2
1653588253352,MATH 206A,A00,087419,Izadi; Elham,7,0,8,1
1653588253875,MATH 207A,A00,087420,Mohammadi; Amir,5,0,8,3
1653588254399,MATH 208,A00,087421,Staff,9,0,10,1
1653588254922,MATH 209,A00,087422,Staff,10,0,10,0
1653588255444,MATH 218,A00,087423,Staff,10,0,10,0
1653588255973,MATH 220A,A00,087424,Novak; Jonathan I,6,0,8,2
1653588256513,MATH 231A,A00,087425,Bejenaru; Ioan,3,0,8,5
1653588257036,MATH 240A,A00,087426,Ebenfelt; Peter F,5,0,8,3
1653588257562,MATH 243,A00,087427,Staff,9,0,10,1
1653588258096,MATH 248,A00,087429,Staff,10,0,10,0
1653588258621,MATH 250A,A00,087430,Spolaor; Luca,4,0,8,4
1653588259146,MATH 257A,A00,087431,Spolaor; Luca,7,0,8,1
1653588259681,MATH 258,A00,087432,Staff,9,0,10,1
1653588260204,MATH 264A,A00,087433,Warnke; Lutz Peter,5,0,8,3
1653588260730,MATH 268,A00,087434,Staff,15,0,15,0
1653588261256,MATH 269,A00,087435,Staff,14,0,15,1
1653588261788,MATH 270A,A00,087436,Nie; Jiawang,0,0,8,8
1653588262313,MATH 272A,A00,087437,Tian; Xiaochuan,0,0,8,8
1653588262836,MATH 274,A01,087439,Cheng; Li-Tien,9,0,10,1
1653588262836,MATH 274,A02,087440,Cheng; Li-Tien,10,0,10,0
1653588263368,MATH 278A,A00,087441,Staff,8,0,10,2
1653588263891,MATH 278B,A00,087442,Staff,8,0,10,2
1653588264416,MATH 278C,A00,087443,Staff,8,0,10,2
1653588264938,MATH 280A,A00,087444,Zheng; Tianyi,0,0,8,8
1653588265466,MATH 281A,A00,087445,Bradic; Jelena,0,0,8,8
1653588265987,MATH 282A,A00,087446,Zhang; Danna,0,0,8,8
1653588266510,MATH 283,A00,087447,Tesler; Glenn,0,0,0,16
1653588267035,MATH 286,B00,095535,Kemp; Todd Aahron,0,0,0,0
1653588267557,MATH 287D,B00,095536,Bradic; Jelena,6,0,8,2
1653588268082,MATH 288,A00,087450,Staff,14,0,15,1
1653588268082,MATH 288,B00,087451,Staff,15,0,15,0
1653588268082,MATH 288,C00,087452,Staff,15,0,15,0
1653588268618,MATH 290A,A00,087453,Xu; Zhouli,6,0,8,2
1653588269144,MATH 291A,A00,087454,Xu; Zhouli,7,0,8,1
1653588269667,MATH 292,A00,087455,Staff,10,0,10,0
1653588270192,MATH 295,A00,087456,Staff,50,0,50,0
1653588270715,MATH 297,001,087457,Staff,997,0,999,2
1653588832166,COGS 200,A01,087991,Staff,47,0,50,3
1653588832694,COGS 201,A01,094504,Rangel; Lara M,16,0,25,9
1653588833219,COGS 203,A00,087992,Coulson; Seana M,18,0,20,2
1653588833826,COGS 210A,001,087993,Greene; Deanna Jacquelyn,9998,0,9999,1
1653588833826,COGS 210A,002,087994,Saygin; Ayse P,9999,0,9999,0
1653588833826,COGS 210A,003,087995,Xia; Haijun,9999,0,9999,0
1653588833826,COGS 210A,004,087996,Nitz; Douglas A.,9999,0,9999,0
1653588833826,COGS 210A,005,087997,Hollan; James D.,9999,0,9999,0
1653588833826,COGS 210A,006,087998,Deak; Gedeon O.,9998,0,9999,1
1653588833826,COGS 210A,007,087999,Rossano; Federico,9999,0,9999,0
1653588834370,COGS 211A,A00,088000,Coulson; Seana M,9997,0,9999,2
1653588834901,COGS 229,A00,088002,Staff,22,0,25,3
1653588835423,COGS 260,B00,094231,Staff,17,0,20,3
1653588835423,COGS 260,A00,088004,Nitz; Douglas A.,9998,0,9999,1
1653588835965,CSE 202,A00,090110,Paturi; Ramamohan,0,0,0,0
1653588835965,CSE 202,B00,090111,Paturi; Ramamohan,0,0,0,0
1653588836489,CSE 207B,A00,090112,Heninger; Nadia A,0,0,0,0
1653588837021,CSE 208,A00,094858,Micciancio; Daniele,0,0,0,0
1653588837550,CSE 210,A00,090113,Powell; Thomas Allan,0,0,0,0
1653588838078,CSE 219,A00,090898,Staff,0,0,0,0
1653588838634,CSE 221,A00,090114,Zhou; Yuan-Yuan,0,0,0,0
1653588839160,CSE 229A,A00,090115,Porter; George M,0,0,0,0
1653588839682,CSE 229C,A00,090116,Savage; Stefan,0,0,0,0
1653588840210,CSE 230,A00,090117,Jhala; Ranjit,0,0,0,0
1653588840739,CSE 232,A00,090118,Papakonstantinou; Yannis,0,0,0,0
1653588841264,CSE 239A,A00,090121,Kumar; Arun Kumar,0,0,0,0
1653588841787,CSE 239B,A00,090122,Jhala; Ranjit,0,0,0,0
1653588842313,CSE 240A,A00,090123,Zhao; Jishen,0,0,189,189
1653588842841,CSE 243A,A00,090124,Orailoglu; Alex,0,0,15,15
1653588843366,CSE 249B,A00,090125,Kahng; Andrew Byun,13,0,20,7
1653588843898,CSE 250A,A00,090126,Berg-Kirkpatrick; Taylor D,0,0,0,0
1653588844423,CSE 252A,A00,090127,Ochoa; Benjamin Lawrence,0,0,0,0
1653588844955,CSE 258,A01,090129,McAuley; Julian John,0,0,0,0
1653588845478,CSE 258R,A01,090131,McAuley; Julian John,0,0,0,0
1653588846005,CSE 274,A00,090132,Ramamoorthi; Ravi,0,0,0,0
1653588846540,CSE 276A,A00,090133,Christensen; Henrik I,0,0,0,0
1653588847072,CSE 276C,A00,090134,Christensen; Henrik I,0,0,0,0
1653588847598,CSE 290,A00,090135,Bafna; Vineet,0,0,0,0
1653588847598,CSE 290,B00,090136,Ramamoorthi; Ravi,0,0,0,0
1653588847598,CSE 290,C00,090137,Li; Tzumao,7,0,10,3
1653588847598,CSE 290,D00,090138,Zhou; Yuan-Yuan,9,0,10,1
1653588847598,CSE 290,E00,090139,Christensen; Henrik I,8,0,10,2
1653588847598,CSE 290,F00,094053,Shalev; Aaron D,0,0,0,0
1653588848122,CSE 291,A00,090140,Munyaka; Imani N. S.,0,0,0,0
1653588848122,CSE 291,B00,094880,Yu; Qi,0,0,0,0
1653588848122,CSE 291,C00,090142,Pannuto; Patrick William,0,0,0,0
1653588848122,CSE 291,D00,094881,Zhang; Yiying,0,0,0,0
1653588848122,CSE 291,E00,095118,Su; Hao,0,0,0,0
1653588848691,CSE 293,001,094905,Bafna; Vineet,9999,0,9999,0
1653588848691,CSE 293,002,094906,Bellare; Mihir,9999,0,9999,0
1653588848691,CSE 293,003,094907,Berg-Kirkpatrick; Taylor D,9999,0,9999,0
1653588848691,CSE 293,004,094908,Christensen; Henrik I,9999,0,9999,0
1653588848691,CSE 293,005,094909,Cottrell; Garrison W,9999,0,9999,0
1653588848691,CSE 293,006,094910,Deutsch; Alin Bernard,9999,0,9999,0
1653588848691,CSE 293,007,094911,Esmaeilzadeh; Hadi,9999,0,9999,0
1653588848691,CSE 293,008,094912,Freund; Yoav,9999,0,9999,0
1653588848691,CSE 293,009,094913,Griswold; William G.,9999,0,9999,0
1653588848691,CSE 293,010,094914,Gymrek; Melissa Ann,9999,0,9999,0
1653588848691,CSE 293,011,094915,Heninger; Nadia A,9999,0,9999,0
1653588848691,CSE 293,012,094916,Impagliazzo; Russell,9999,0,9999,0
1653588848691,CSE 293,013,094917,Jhala; Ranjit,9999,0,9999,0
1653588848691,CSE 293,014,094918,Kahng; Andrew Byun,9999,0,9999,0
1653588848691,CSE 293,015,094919,Kane; Daniel Mertz,9999,0,9999,0
1653588848691,CSE 293,016,094920,Kriegman; David J,9999,0,9999,0
1653588848691,CSE 293,017,094921,Kumar; Arun Kumar,9999,0,9999,0
1653588848691,CSE 293,018,094922,Lerner; Sorin,9999,0,9999,0
1653588848691,CSE 293,019,094923,Lovett; Shachar,9999,0,9999,0
1653588848691,CSE 293,020,094924,McAuley; Julian John,9999,0,9999,0
1653588848691,CSE 293,021,094925,Micciancio; Daniele,9999,0,9999,0
1653588848691,CSE 293,022,094926,Orailoglu; Alex,9999,0,9999,0
1653588848691,CSE 293,023,094927,Paturi; Ramamohan,9999,0,9999,0
1653588848691,CSE 293,024,094928,Polikarpova; Nadezhda,9999,0,9999,0
1653588848691,CSE 293,025,094929,Politz; Joseph Gibbs,9999,0,9999,0
1653588848691,CSE 293,026,094930,Porter; George M,9999,0,9999,0
1653588848691,CSE 293,027,094931,Porter; Leonard Emerson,9999,0,9999,0
1653588848691,CSE 293,028,094932,Ramamoorthi; Ravi,9999,0,9999,0
1653588848691,CSE 293,029,094933,Sahoo; Debashis,9999,0,9999,0
1653588848691,CSE 293,030,094934,Saul; Lawrence,9999,0,9999,0
1653588848691,CSE 293,031,094935,Savage; Stefan,9999,0,9999,0
1653588848691,CSE 293,032,094936,Schulze; Jurgen P.,9999,0,9999,0
1653588848691,CSE 293,033,094937,Snoeren; Alex C.,9999,0,9999,0
1653588848691,CSE 293,034,094938,Shang; Jingbo,9999,0,9999,0
1653588848691,CSE 293,035,094939,Stefan; Deian,9999,0,9999,0
1653588848691,CSE 293,036,094940,Su; Hao,9999,0,9999,0
1653588848691,CSE 293,037,094941,Swanson; Steven James,9999,0,9999,0
1653588848691,CSE 293,038,094942,Tullsen; Dean Michael,9999,0,9999,0
1653588848691,CSE 293,039,094943,Voelker; Geoffrey M.,9999,0,9999,0
1653588848691,CSE 293,040,094944,Zhao; Jishen,9999,0,9999,0
1653588848691,CSE 293,041,094945,Zhou; Yuan-Yuan,9999,0,9999,0
1653588848691,CSE 293,042,094946,Gao; Sicun,9998,0,9999,1
1653588848691,CSE 293,043,094947,Weibel; Nadir,9999,0,9999,0
1653588848691,CSE 293,044,094948,Gupta; Rajesh K.,9999,0,9999,0
1653588849220,CSE 294,A00,090143,Porter; George M,8,0,10,2
1653588849743,DSE 200,A00,091799,Staff,50,0,50,0
1653588850276,DSE 203,A00,091800,Gupta; Amarnath,30,0,30,0
1653588850798,DSE 250,A00,091801,Deutsch; Alin Bernard,30,0,30,0
1653588851322,DSE 290,A00,091802,Altintas De Callaf; Ilkay,50,0,50,0
1653588851863,ECE 200,001,091003,Antipa; Nicholas A,9999,0,9999,0
1653588851863,ECE 200,002,091004,Atanasov; Nikolay A.,9999,0,9999,0
1653588851863,ECE 200,003,091005,Bharadia; Dinesh,9999,0,9999,0
1653588851863,ECE 200,004,091006,Cheng; Chung Kuan,9999,0,9999,0
1653588851863,ECE 200,005,091007,Cosman; Pamela C.,9999,0,9999,0
1653588851863,ECE 200,006,091008,Staff,9999,0,9999,0
1653588851863,ECE 200,007,091009,Dayeh; Shadi Ahmad,9999,0,9999,0
1653588851863,ECE 200,008,091010,Fainman; Yeshaiahu,9999,0,9999,0
1653588851863,ECE 200,009,091011,Ford; Joseph Earl,9999,0,9999,0
1653588851863,ECE 200,010,091012,Franceschetti; Massimo,9999,0,9999,0
1653588851863,ECE 200,011,091013,Fullerton; Eric E,9999,0,9999,0
1653588851863,ECE 200,012,091014,Galton; Ian A,9999,0,9999,0
1653588851863,ECE 200,013,091015,Gilja; Vikash,9999,0,9999,0
1653588851863,ECE 200,014,091016,Hall; Drew A.,9999,0,9999,0
1653588851863,ECE 200,015,091017,Hsueh; Tzu-Chien,9999,0,9999,0
1653588851863,ECE 200,016,091018,Javidi; Tara,9999,0,9999,0
1653588851863,ECE 200,017,091019,Kahng; Andrew Byun,9999,0,9999,0
1653588851863,ECE 200,018,091020,Kim; Young-Han,9999,0,9999,0
1653588851863,ECE 200,019,091021,Koushanfar; Farinaz,9999,0,9999,0
1653588851863,ECE 200,020,091022,Kuzum; Duygu,9999,0,9999,0
1653588851863,ECE 200,021,091023,Le; Hanh-Phuc,9999,0,9999,0
1653588851863,ECE 200,022,091024,Lin; Bill,9999,0,9999,0
1653588851863,ECE 200,023,091025,Liu; Zhaowei,9999,0,9999,0
1653588851863,ECE 200,024,091026,Lo; Yu-Hwa,9999,0,9999,0
1653588851863,ECE 200,025,091027,Lomakin; Vitaliy,9999,0,9999,0
1653588851863,ECE 200,026,091028,Mercier; Patrick Philip,9999,0,9999,0
1653588851863,ECE 200,027,091029,Meyer; Florian,9999,0,9999,0
1653588851863,ECE 200,028,091030,Milstein; Laurence B.,9999,0,9999,0
1653588851863,ECE 200,029,091031,Mir Arabbaygi; Siavash,9999,0,9999,0
1653588851863,ECE 200,030,091032,Mookherjea; Shayan,9999,0,9999,0
1653588851863,ECE 200,031,091033,Morris; Karcher William,9999,0,9999,0
1653588851863,ECE 200,032,091034,Ng; Tse Nga,9999,0,9999,0
1653588851863,ECE 200,033,091035,Nguyen; Truong Quang,9999,0,9999,0
1653588851863,ECE 200,034,091036,Nomura; Kenji,9999,0,9999,0
1653588851863,ECE 200,035,091037,Orlitsky; Alon,9999,0,9999,0
1653588851863,ECE 200,036,091038,Pal; Piya,9999,0,9999,0
1653588851863,ECE 200,037,091039,Papen; George C.,9999,0,9999,0
1653588851863,ECE 200,038,091040,Radic; Stojan,9999,0,9999,0
1653588851863,ECE 200,039,091041,Rao; Bhaskar D.,9999,0,9999,0
1653588851863,ECE 200,040,091042,Rao; Ramesh R,9999,0,9999,0
1653588851863,ECE 200,041,091043,Rebeiz; Gabriel,9999,0,9999,0
1653588851863,ECE 200,042,091044,Sanford; John R,9999,0,9999,0
1653588851863,ECE 200,043,091045,Siegel; Paul H.,9999,0,9999,0
1653588851863,ECE 200,044,091046,Sievenpiper; Daniel F.,9999,0,9999,0
1653588851863,ECE 200,045,091047,Sworder; David D.,9999,0,9999,0
1653588851863,ECE 200,046,091048,Taur; Yuan,9999,0,9999,0
1653588851863,ECE 200,047,091049,Touri; Behrouz,9999,0,9999,0
1653588851863,ECE 200,048,091050,Trivedi; Mohan M.,9999,0,9999,0
1653588851863,ECE 200,049,091051,Vardy; Alexander,9999,0,9999,0
1653588851863,ECE 200,050,091052,Vasconcelos; Nuno,9999,0,9999,0
1653588851863,ECE 200,051,091053,Wang; Xiaolong,9999,0,9999,0
1653588851863,ECE 200,052,091054,Xie; Pengtao,9999,0,9999,0
1653588851863,ECE 200,053,091055,Yip; Michael,9999,0,9999,0
1653588851863,ECE 200,054,091056,Zeger; Kenneth A.,9999,0,9999,0
1653588851863,ECE 200,055,091057,Zhang; Xinyu,9999,0,9999,0
1653588851863,ECE 200,056,091058,Turakhia; Yatish Girish,9999,0,9999,0
1653588851863,ECE 200,057,091059,Kang; Mingu,9999,0,9999,0
1653588851863,ECE 200,058,091060,Shi; Yuanyuan,9999,0,9999,0
1653588851863,ECE 200,059,091061,Wang; Edward Jay,9999,0,9999,0
1653588851863,ECE 200,060,091062,Zheng; Yang,9999,0,9999,0
1653588852402,ECE 201,A00,095526,Lo; Yu-Hwa,0,0,0,0
1653588852930,ECE 203,A00,091065,Mercier; Patrick Philip,0,0,0,0
1653588853468,ECE 207A,A00,091605,Liu; Thomas Tao-Ming,0,0,0,0
1653588853993,ECE 212AN,A00,091068,Nomura; Kenji,0,0,0,0
1653588854520,ECE 222A,A00,091069,Rebeiz; Gabriel,0,0,0,0
1653588855044,ECE 225A,A00,091070,Orlitsky; Alon,0,0,0,0
1653588855569,ECE 230A,A00,091071,Nomura; Kenji,0,0,0,0
1653588856097,ECE 236A,A00,091072,Dayeh; Shadi Ahmad,0,0,0,0
1653588856622,ECE 238A,A00,091073,Luo; Jian,0,0,0,0
1653588856622,ECE 238A,B00,091074,Luo; Jian,0,0,0,0
1653588857156,ECE 240A,A00,091075,Radic; Stojan,0,0,0,0
1653588857679,ECE 247A,A00,091592,Shi; Lingyan,0,0,0,0
1653588858201,ECE 250,A00,091076,Touri; Behrouz,0,0,0,0
1653588858724,ECE 251C,A00,091078,Nguyen; Truong Quang,0,0,0,0
1653588859246,ECE 253,A00,091079,Cosman; Pamela C.,0,0,0,0
1653588859772,ECE 255A,A00,091080,Orlitsky; Alon,0,0,0,0
1653588860295,ECE 257A,A00,091081,Zhang; Xinyu,0,0,0,0
1653588860832,ECE 260A,A01,091084,Eldon; John,0,0,0,0
1653588861396,ECE 264C,A00,091085,Galton; Ian A,0,0,0,0
1653588861933,ECE 265C,A00,094889,Presti; Calogero Davide,0,0,0,9
1653588862467,ECE 266,A01,091087,Hall; Drew A.,0,0,0,0
1653588863518,ECE 271A,A00,091090,Vasconcelos; Nuno,0,0,0,0
1653588864042,ECE 272B,A00,091091,Sworder; David D.,0,0,0,0
1653588864565,ECE 275A,A00,091092,Meyer; Florian,0,0,0,0
1653588865099,ECE 277,A00,091093,An; Cheolhong,0,0,0,0
1653588865627,ECE 283,A00,091094,Le; Hanh-Phuc,0,0,0,0
1653588866156,ECE 284,A00,091095,Kang; Mingu,0,0,0,0
1653588866156,ECE 284,B00,091096,Wang; Edward Jay,0,0,0,0
1653588866678,ECE 285,A00,094334,Touri; Behrouz,0,0,0,0
1653588867201,ECE 289,A00,091097,Whelan; David Arthur,0,0,0,0
1653588867726,MATH 200A,A00,087414,Salehi Golsefidy; Alireza,7,0,8,1
1653588868248,MATH 202A,A00,087415,Gill; Philip E.,2,0,8,6
1653588868772,MATH 203A,A00,087416,Oprea; Dragos N.,6,0,8,2
1653588869295,MATH 204A,A00,087417,Kedlaya; Kiran S.,6,0,8,2
1653588869825,MATH 205,A00,087418,Sorensen; Claus M,6,0,8,2
1653588870359,MATH 206A,A00,087419,Izadi; Elham,7,0,8,1
1653588870887,MATH 207A,A00,087420,Mohammadi; Amir,5,0,8,3
1653588871424,MATH 208,A00,087421,Staff,9,0,10,1
1653588871959,MATH 209,A00,087422,Staff,10,0,10,0
1653588872484,MATH 218,A00,087423,Staff,10,0,10,0
1653588873006,MATH 220A,A00,087424,Novak; Jonathan I,6,0,8,2
1653588873532,MATH 231A,A00,087425,Bejenaru; Ioan,3,0,8,5
1653588874062,MATH 240A,A00,087426,Ebenfelt; Peter F,5,0,8,3
1653588874587,MATH 243,A00,087427,Staff,9,0,10,1
1653588875112,MATH 248,A00,087429,Staff,10,0,10,0
1653588875636,MATH 250A,A00,087430,Spolaor; Luca,4,0,8,4
1653588876164,MATH 257A,A00,087431,Spolaor; Luca,7,0,8,1
1653588876694,MATH 258,A00,087432,Staff,9,0,10,1
1653588877222,MATH 264A,A00,087433,Warnke; Lutz Peter,5,0,8,3
1653588877748,MATH 268,A00,087434,Staff,15,0,15,0
1653588878274,MATH 269,A00,087435,Staff,14,0,15,1
1653588878802,MATH 270A,A00,087436,Nie; Jiawang,0,0,8,8
1653588879326,MATH 272A,A00,087437,Tian; Xiaochuan,0,0,8,8
1653588879850,MATH 274,A01,087439,Cheng; Li-Tien,9,0,10,1
1653588879850,MATH 274,A02,087440,Cheng; Li-Tien,10,0,10,0
1653588880382,MATH 278A,A00,087441,Staff,8,0,10,2
1653588880910,MATH 278B,A00,087442,Staff,8,0,10,2
1653588881433,MATH 278C,A00,087443,Staff,8,0,10,2
1653588881958,MATH 280A,A00,087444,Zheng; Tianyi,0,0,8,8
1653588882488,MATH 281A,A00,087445,Bradic; Jelena,0,0,8,8
1653588883022,MATH 282A,A00,087446,Zhang; Danna,0,0,8,8
1653588883543,MATH 283,A00,087447,Tesler; Glenn,0,0,0,16
1653588884071,MATH 286,B00,095535,Kemp; Todd Aahron,0,0,0,0
1653588884596,MATH 287D,B00,095536,Bradic; Jelena,6,0,8,2
1653588885119,MATH 288,A00,087450,Staff,14,0,15,1
1653588885119,MATH 288,B00,087451,Staff,15,0,15,0
1653588885119,MATH 288,C00,087452,Staff,15,0,15,0
1653588885647,MATH 290A,A00,087453,Xu; Zhouli,6,0,8,2
1653588886180,MATH 291A,A00,087454,Xu; Zhouli,7,0,8,1
1653588886702,MATH 292,A00,087455,Staff,10,0,10,0
1653588887306,MATH 295,A00,087456,Staff,50,0,50,0
1653588887840,MATH 297,001,087457,Staff,997,0,999,2
1653589465625,COGS 200,A01,087991,Staff,47,0,50,3
1653589466153,COGS 201,A01,094504,Rangel; Lara M,16,0,25,9
1653589466681,COGS 203,A00,087992,Coulson; Seana M,18,0,20,2
1653589467218,COGS 210A,001,087993,Greene; Deanna Jacquelyn,9998,0,9999,1
1653589467218,COGS 210A,002,087994,Saygin; Ayse P,9999,0,9999,0
1653589467218,COGS 210A,003,087995,Xia; Haijun,9999,0,9999,0
1653589467218,COGS 210A,004,087996,Nitz; Douglas A.,9999,0,9999,0
1653589467218,COGS 210A,005,087997,Hollan; James D.,9999,0,9999,0
1653589467218,COGS 210A,006,087998,Deak; Gedeon O.,9998,0,9999,1
1653589467218,COGS 210A,007,087999,Rossano; Federico,9999,0,9999,0
1653589467742,COGS 211A,A00,088000,Coulson; Seana M,9997,0,9999,2
1653589468268,COGS 229,A00,088002,Staff,22,0,25,3
1653589468792,COGS 260,B00,094231,Staff,17,0,20,3
1653589468792,COGS 260,A00,088004,Nitz; Douglas A.,9998,0,9999,1
1653589469316,CSE 202,A00,090110,Paturi; Ramamohan,0,0,0,0
1653589469316,CSE 202,B00,090111,Paturi; Ramamohan,0,0,0,0
1653589469856,CSE 207B,A00,090112,Heninger; Nadia A,0,0,0,0
1653589470399,CSE 208,A00,094858,Micciancio; Daniele,0,0,0,0
1653589470947,CSE 210,A00,090113,Powell; Thomas Allan,0,0,0,0
1653589471485,CSE 219,A00,090898,Staff,0,0,0,0
1653589472014,CSE 221,A00,090114,Zhou; Yuan-Yuan,0,0,0,0
1653589472545,CSE 229A,A00,090115,Porter; George M,0,0,0,0
1653589473078,CSE 229C,A00,090116,Savage; Stefan,0,0,0,0
1653589473622,CSE 230,A00,090117,Jhala; Ranjit,0,0,0,0
1653589474152,CSE 232,A00,090118,Papakonstantinou; Yannis,0,0,0,0
1653589474684,CSE 239A,A00,090121,Kumar; Arun Kumar,0,0,0,0
1653589475206,CSE 239B,A00,090122,Jhala; Ranjit,0,0,0,0
1653589475732,CSE 240A,A00,090123,Zhao; Jishen,0,0,189,189
1653589476254,CSE 243A,A00,090124,Orailoglu; Alex,0,0,15,15
1653589476777,CSE 249B,A00,090125,Kahng; Andrew Byun,12,0,20,8
1653589477313,CSE 250A,A00,090126,Berg-Kirkpatrick; Taylor D,0,0,0,0
1653589477857,CSE 252A,A00,090127,Ochoa; Benjamin Lawrence,0,0,0,0
1653589478388,CSE 258,A01,090129,McAuley; Julian John,0,0,0,0
1653589478909,CSE 258R,A01,090131,McAuley; Julian John,0,0,0,0
1653589479432,CSE 274,A00,090132,Ramamoorthi; Ravi,0,0,0,0
1653589479957,CSE 276A,A00,090133,Christensen; Henrik I,0,0,0,0
1653589480488,CSE 276C,A00,090134,Christensen; Henrik I,0,0,0,0
1653589481021,CSE 290,A00,090135,Bafna; Vineet,0,0,0,0
1653589481021,CSE 290,B00,090136,Ramamoorthi; Ravi,0,0,0,0
1653589481021,CSE 290,C00,090137,Li; Tzumao,7,0,10,3
1653589481021,CSE 290,D00,090138,Zhou; Yuan-Yuan,9,0,10,1
1653589481021,CSE 290,E00,090139,Christensen; Henrik I,8,0,10,2
1653589481021,CSE 290,F00,094053,Shalev; Aaron D,0,0,0,0
1653589481559,CSE 291,A00,090140,Munyaka; Imani N. S.,0,0,0,0
1653589481559,CSE 291,B00,094880,Yu; Qi,0,0,0,0
1653589481559,CSE 291,C00,090142,Pannuto; Patrick William,0,0,0,0
1653589481559,CSE 291,D00,094881,Zhang; Yiying,0,0,0,0
1653589481559,CSE 291,E00,095118,Su; Hao,0,0,0,0
1653589482086,CSE 293,001,094905,Bafna; Vineet,9999,0,9999,0
1653589482086,CSE 293,002,094906,Bellare; Mihir,9999,0,9999,0
1653589482086,CSE 293,003,094907,Berg-Kirkpatrick; Taylor D,9999,0,9999,0
1653589482086,CSE 293,004,094908,Christensen; Henrik I,9999,0,9999,0
1653589482086,CSE 293,005,094909,Cottrell; Garrison W,9999,0,9999,0
1653589482086,CSE 293,006,094910,Deutsch; Alin Bernard,9999,0,9999,0
1653589482086,CSE 293,007,094911,Esmaeilzadeh; Hadi,9999,0,9999,0
1653589482086,CSE 293,008,094912,Freund; Yoav,9999,0,9999,0
1653589482086,CSE 293,009,094913,Griswold; William G.,9999,0,9999,0
1653589482086,CSE 293,010,094914,Gymrek; Melissa Ann,9999,0,9999,0
1653589482086,CSE 293,011,094915,Heninger; Nadia A,9999,0,9999,0
1653589482086,CSE 293,012,094916,Impagliazzo; Russell,9999,0,9999,0
1653589482086,CSE 293,013,094917,Jhala; Ranjit,9999,0,9999,0
1653589482086,CSE 293,014,094918,Kahng; Andrew Byun,9999,0,9999,0
1653589482086,CSE 293,015,094919,Kane; Daniel Mertz,9999,0,9999,0
1653589482086,CSE 293,016,094920,Kriegman; David J,9999,0,9999,0
1653589482086,CSE 293,017,094921,Kumar; Arun Kumar,9999,0,9999,0
1653589482086,CSE 293,018,094922,Lerner; Sorin,9999,0,9999,0
1653589482086,CSE 293,019,094923,Lovett; Shachar,9999,0,9999,0
1653589482086,CSE 293,020,094924,McAuley; Julian John,9999,0,9999,0
1653589482086,CSE 293,021,094925,Micciancio; Daniele,9999,0,9999,0
1653589482086,CSE 293,022,094926,Orailoglu; Alex,9999,0,9999,0
1653589482086,CSE 293,023,094927,Paturi; Ramamohan,9999,0,9999,0
1653589482086,CSE 293,024,094928,Polikarpova; Nadezhda,9999,0,9999,0
1653589482086,CSE 293,025,094929,Politz; Joseph Gibbs,9999,0,9999,0
1653589482086,CSE 293,026,094930,Porter; George M,9999,0,9999,0
1653589482086,CSE 293,027,094931,Porter; Leonard Emerson,9999,0,9999,0
1653589482086,CSE 293,028,094932,Ramamoorthi; Ravi,9999,0,9999,0
1653589482086,CSE 293,029,094933,Sahoo; Debashis,9999,0,9999,0
1653589482086,CSE 293,030,094934,Saul; Lawrence,9999,0,9999,0
1653589482086,CSE 293,031,094935,Savage; Stefan,9999,0,9999,0
1653589482086,CSE 293,032,094936,Schulze; Jurgen P.,9999,0,9999,0
1653589482086,CSE 293,033,094937,Snoeren; Alex C.,9999,0,9999,0
1653589482086,CSE 293,034,094938,Shang; Jingbo,9999,0,9999,0
1653589482086,CSE 293,035,094939,Stefan; Deian,9999,0,9999,0
1653589482086,CSE 293,036,094940,Su; Hao,9999,0,9999,0
1653589482086,CSE 293,037,094941,Swanson; Steven James,9999,0,9999,0
1653589482086,CSE 293,038,094942,Tullsen; Dean Michael,9999,0,9999,0
1653589482086,CSE 293,039,094943,Voelker; Geoffrey M.,9999,0,9999,0
1653589482086,CSE 293,040,094944,Zhao; Jishen,9999,0,9999,0
1653589482086,CSE 293,041,094945,Zhou; Yuan-Yuan,9999,0,9999,0
1653589482086,CSE 293,042,094946,Gao; Sicun,9998,0,9999,1
1653589482086,CSE 293,043,094947,Weibel; Nadir,9999,0,9999,0
1653589482086,CSE 293,044,094948,Gupta; Rajesh K.,9999,0,9999,0
1653589482619,CSE 294,A00,090143,Porter; George M,8,0,10,2
1653589483159,DSE 200,A00,091799,Staff,50,0,50,0
1653589483697,DSE 203,A00,091800,Gupta; Amarnath,30,0,30,0
1653589484223,DSE 250,A00,091801,Deutsch; Alin Bernard,30,0,30,0
1653589484745,DSE 290,A00,091802,Altintas De Callaf; Ilkay,50,0,50,0
1653589485299,ECE 200,001,091003,Antipa; Nicholas A,9999,0,9999,0
1653589485299,ECE 200,002,091004,Atanasov; Nikolay A.,9999,0,9999,0
1653589485299,ECE 200,003,091005,Bharadia; Dinesh,9999,0,9999,0
1653589485299,ECE 200,004,091006,Cheng; Chung Kuan,9999,0,9999,0
1653589485299,ECE 200,005,091007,Cosman; Pamela C.,9999,0,9999,0
1653589485299,ECE 200,006,091008,Staff,9999,0,9999,0
1653589485299,ECE 200,007,091009,Dayeh; Shadi Ahmad,9999,0,9999,0
1653589485299,ECE 200,008,091010,Fainman; Yeshaiahu,9999,0,9999,0
1653589485299,ECE 200,009,091011,Ford; Joseph Earl,9999,0,9999,0
1653589485299,ECE 200,010,091012,Franceschetti; Massimo,9999,0,9999,0
1653589485299,ECE 200,011,091013,Fullerton; Eric E,9999,0,9999,0
1653589485299,ECE 200,012,091014,Galton; Ian A,9999,0,9999,0
1653589485299,ECE 200,013,091015,Gilja; Vikash,9999,0,9999,0
1653589485299,ECE 200,014,091016,Hall; Drew A.,9999,0,9999,0
1653589485299,ECE 200,015,091017,Hsueh; Tzu-Chien,9999,0,9999,0
1653589485299,ECE 200,016,091018,Javidi; Tara,9999,0,9999,0
1653589485299,ECE 200,017,091019,Kahng; Andrew Byun,9999,0,9999,0
1653589485299,ECE 200,018,091020,Kim; Young-Han,9999,0,9999,0
1653589485299,ECE 200,019,091021,Koushanfar; Farinaz,9999,0,9999,0
1653589485299,ECE 200,020,091022,Kuzum; Duygu,9999,0,9999,0
1653589485299,ECE 200,021,091023,Le; Hanh-Phuc,9999,0,9999,0
1653589485299,ECE 200,022,091024,Lin; Bill,9999,0,9999,0
1653589485299,ECE 200,023,091025,Liu; Zhaowei,9999,0,9999,0
1653589485299,ECE 200,024,091026,Lo; Yu-Hwa,9999,0,9999,0
1653589485299,ECE 200,025,091027,Lomakin; Vitaliy,9999,0,9999,0
1653589485299,ECE 200,026,091028,Mercier; Patrick Philip,9999,0,9999,0
1653589485299,ECE 200,027,091029,Meyer; Florian,9999,0,9999,0
1653589485299,ECE 200,028,091030,Milstein; Laurence B.,9999,0,9999,0
1653589485299,ECE 200,029,091031,Mir Arabbaygi; Siavash,9999,0,9999,0
1653589485299,ECE 200,030,091032,Mookherjea; Shayan,9999,0,9999,0
1653589485299,ECE 200,031,091033,Morris; Karcher William,9999,0,9999,0
1653589485299,ECE 200,032,091034,Ng; Tse Nga,9999,0,9999,0
1653589485299,ECE 200,033,091035,Nguyen; Truong Quang,9999,0,9999,0
1653589485299,ECE 200,034,091036,Nomura; Kenji,9999,0,9999,0
1653589485299,ECE 200,035,091037,Orlitsky; Alon,9999,0,9999,0
1653589485299,ECE 200,036,091038,Pal; Piya,9999,0,9999,0
1653589485299,ECE 200,037,091039,Papen; George C.,9999,0,9999,0
1653589485299,ECE 200,038,091040,Radic; Stojan,9999,0,9999,0
1653589485299,ECE 200,039,091041,Rao; Bhaskar D.,9999,0,9999,0
1653589485299,ECE 200,040,091042,Rao; Ramesh R,9999,0,9999,0
1653589485299,ECE 200,041,091043,Rebeiz; Gabriel,9999,0,9999,0
1653589485299,ECE 200,042,091044,Sanford; John R,9999,0,9999,0
1653589485299,ECE 200,043,091045,Siegel; Paul H.,9999,0,9999,0
1653589485299,ECE 200,044,091046,Sievenpiper; Daniel F.,9999,0,9999,0
1653589485299,ECE 200,045,091047,Sworder; David D.,9999,0,9999,0
1653589485299,ECE 200,046,091048,Taur; Yuan,9999,0,9999,0
1653589485299,ECE 200,047,091049,Touri; Behrouz,9999,0,9999,0
1653589485299,ECE 200,048,091050,Trivedi; Mohan M.,9999,0,9999,0
1653589485299,ECE 200,049,091051,Vardy; Alexander,9999,0,9999,0
1653589485299,ECE 200,050,091052,Vasconcelos; Nuno,9999,0,9999,0
1653589485299,ECE 200,051,091053,Wang; Xiaolong,9999,0,9999,0
1653589485299,ECE 200,052,091054,Xie; Pengtao,9999,0,9999,0
1653589485299,ECE 200,053,091055,Yip; Michael,9999,0,9999,0
1653589485299,ECE 200,054,091056,Zeger; Kenneth A.,9999,0,9999,0
1653589485299,ECE 200,055,091057,Zhang; Xinyu,9999,0,9999,0
1653589485299,ECE 200,056,091058,Turakhia; Yatish Girish,9999,0,9999,0
1653589485299,ECE 200,057,091059,Kang; Mingu,9999,0,9999,0
1653589485299,ECE 200,058,091060,Shi; Yuanyuan,9999,0,9999,0
1653589485299,ECE 200,059,091061,Wang; Edward Jay,9999,0,9999,0
1653589485299,ECE 200,060,091062,Zheng; Yang,9999,0,9999,0
1653589485846,ECE 201,A00,095526,Lo; Yu-Hwa,0,0,0,0
1653589486370,ECE 203,A00,091065,Mercier; Patrick Philip,0,0,0,0
1653589486899,ECE 207A,A00,091605,Liu; Thomas Tao-Ming,0,0,0,0
1653589487425,ECE 212AN,A00,091068,Nomura; Kenji,0,0,0,0
1653589487955,ECE 222A,A00,091069,Rebeiz; Gabriel,0,0,0,0
1653589488500,ECE 225A,A00,091070,Orlitsky; Alon,0,0,0,0
1653589489046,ECE 230A,A00,091071,Nomura; Kenji,0,0,0,0
1653589489584,ECE 236A,A00,091072,Dayeh; Shadi Ahmad,0,0,0,0
1653589490111,ECE 238A,A00,091073,Luo; Jian,0,0,0,0
1653589490111,ECE 238A,B00,091074,Luo; Jian,0,0,0,0
1653589490652,ECE 240A,A00,091075,Radic; Stojan,0,0,0,0
1653589491180,ECE 247A,A00,091592,Shi; Lingyan,0,0,0,0
1653589491702,ECE 250,A00,091076,Touri; Behrouz,0,0,0,0
1653589492229,ECE 251C,A00,091078,Nguyen; Truong Quang,0,0,0,0
1653589492837,ECE 253,A00,091079,Cosman; Pamela C.,0,0,0,0
1653589493363,ECE 255A,A00,091080,Orlitsky; Alon,0,0,0,0
1653589493914,ECE 257A,A00,091081,Zhang; Xinyu,0,0,0,0
1653589494441,ECE 260A,A01,091084,Eldon; John,0,0,0,0
1653589494978,ECE 264C,A00,091085,Galton; Ian A,0,0,0,0
1653589495522,ECE 265C,A00,094889,Presti; Calogero Davide,0,0,0,9
1653589496074,ECE 266,A01,091087,Hall; Drew A.,0,0,0,0
1653589497120,ECE 271A,A00,091090,Vasconcelos; Nuno,0,0,0,0
1653589497643,ECE 272B,A00,091091,Sworder; David D.,0,0,0,0
1653589498166,ECE 275A,A00,091092,Meyer; Florian,0,0,0,0
1653589498710,ECE 277,A00,091093,An; Cheolhong,0,0,0,0
1653589499237,ECE 283,A00,091094,Le; Hanh-Phuc,0,0,0,0
1653589499783,ECE 284,A00,091095,Kang; Mingu,0,0,0,0
1653589499783,ECE 284,B00,091096,Wang; Edward Jay,0,0,0,0
1653589500310,ECE 285,A00,094334,Touri; Behrouz,0,0,0,0
1653589500841,ECE 289,A00,091097,Whelan; David Arthur,0,0,0,0
1653589501367,MATH 200A,A00,087414,Salehi Golsefidy; Alireza,7,0,8,1
1653589501952,MATH 202A,A00,087415,Gill; Philip E.,2,0,8,6
1653589502475,MATH 203A,A00,087416,Oprea; Dragos N.,6,0,8,2
1653589503011,MATH 204A,A00,087417,Kedlaya; Kiran S.,6,0,8,2
1653589503543,MATH 205,A00,087418,Sorensen; Claus M,6,0,8,2
1653589504067,MATH 206A,A00,087419,Izadi; Elham,7,0,8,1
1653589504596,MATH 207A,A00,087420,Mohammadi; Amir,5,0,8,3
1653589505139,MATH 208,A00,087421,Staff,9,0,10,1
1653589505665,MATH 209,A00,087422,Staff,10,0,10,0
1653589506192,MATH 218,A00,087423,Staff,10,0,10,0
1653589506721,MATH 220A,A00,087424,Novak; Jonathan I,6,0,8,2
1653589507256,MATH 231A,A00,087425,Bejenaru; Ioan,3,0,8,5
1653589507785,MATH 240A,A00,087426,Ebenfelt; Peter F,5,0,8,3
1653589508338,MATH 243,A00,087427,Staff,9,0,10,1
1653589508881,MATH 248,A00,087429,Staff,10,0,10,0
1653589509420,MATH 250A,A00,087430,Spolaor; Luca,4,0,8,4
1653589509958,MATH 257A,A00,087431,Spolaor; Luca,7,0,8,1
1653589510495,MATH 258,A00,087432,Staff,9,0,10,1
1653589511018,MATH 264A,A00,087433,Warnke; Lutz Peter,5,0,8,3
1653589511546,MATH 268,A00,087434,Staff,15,0,15,0
1653589512090,MATH 269,A00,087435,Staff,14,0,15,1
1653589512619,MATH 270A,A00,087436,Nie; Jiawang,0,0,8,8
1653589513163,MATH 272A,A00,087437,Tian; Xiaochuan,0,0,8,8
1653589513701,MATH 274,A01,087439,Cheng; Li-Tien,9,0,10,1
1653589513701,MATH 274,A02,087440,Cheng; Li-Tien,10,0,10,0
1653589514233,MATH 278A,A00,087441,Staff,8,0,10,2
1653589514766,MATH 278B,A00,087442,Staff,8,0,10,2
1653589515308,MATH 278C,A00,087443,Staff,8,0,10,2
1653589515854,MATH 280A,A00,087444,Zheng; Tianyi,0,0,8,8
1653589516384,MATH 281A,A00,087445,Bradic; Jelena,0,0,8,8
1653589516923,MATH 282A,A00,087446,Zhang; Danna,0,0,8,8
1653589517446,MATH 283,A00,087447,Tesler; Glenn,0,0,0,16
1653589517980,MATH 286,B00,095535,Kemp; Todd Aahron,0,0,0,0
1653589518518,MATH 287D,B00,095536,Bradic; Jelena,6,0,8,2
1653589519061,MATH 288,A00,087450,Staff,14,0,15,1
1653589519061,MATH 288,B00,087451,Staff,15,0,15,0
1653589519061,MATH 288,C00,087452,Staff,15,0,15,0
1653589519587,MATH 290A,A00,087453,Xu; Zhouli,6,0,8,2
1653589520122,MATH 291A,A00,087454,Xu; Zhouli,7,0,8,1
1653589520655,MATH 292,A00,087455,Staff,10,0,10,0
1653589521177,MATH 295,A00,087456,Staff,50,0,50,0
1653589521712,MATH 297,001,087457,Staff,997,0,999,2
1653590090342,COGS 200,A01,087991,Staff,47,0,50,3
1653590090867,COGS 201,A01,094504,Rangel; Lara M,16,0,25,9
1653590091404,COGS 203,A00,087992,Coulson; Seana M,18,0,20,2
1653590091929,COGS 210A,001,087993,Greene; Deanna Jacquelyn,9998,0,9999,1
1653590091929,COGS 210A,002,087994,Saygin; Ayse P,9999,0,9999,0
1653590091929,COGS 210A,003,087995,Xia; Haijun,9999,0,9999,0
1653590091929,COGS 210A,004,087996,Nitz; Douglas A.,9999,0,9999,0
1653590091929,COGS 210A,005,087997,Hollan; James D.,9999,0,9999,0
1653590091929,COGS 210A,006,087998,Deak; Gedeon O.,9998,0,9999,1
1653590091929,COGS 210A,007,087999,Rossano; Federico,9999,0,9999,0
1653590092452,COGS 211A,A00,088000,Coulson; Seana M,9997,0,9999,2
1653590093006,COGS 229,A00,088002,Staff,22,0,25,3
1653590093547,COGS 260,B00,094231,Staff,17,0,20,3
1653590093547,COGS 260,A00,088004,Nitz; Douglas A.,9998,0,9999,1
1653590094079,CSE 202,A00,090110,Paturi; Ramamohan,0,0,0,0
1653590094079,CSE 202,B00,090111,Paturi; Ramamohan,0,0,0,0
1653590094603,CSE 207B,A00,090112,Heninger; Nadia A,0,0,0,0
1653590095138,CSE 208,A00,094858,Micciancio; Daniele,0,0,0,0
1653590095670,CSE 210,A00,090113,Powell; Thomas Allan,0,0,0,0
1653590096209,CSE 219,A00,090898,Staff,0,0,0,0
1653590096735,CSE 221,A00,090114,Zhou; Yuan-Yuan,0,0,0,0
1653590097260,CSE 229A,A00,090115,Porter; George M,0,0,0,0
1653590097811,CSE 229C,A00,090116,Savage; Stefan,0,0,0,0
1653590098341,CSE 230,A00,090117,Jhala; Ranjit,0,0,0,0
1653590098893,CSE 232,A00,090118,Papakonstantinou; Yannis,0,0,0,0
1653590099443,CSE 239A,A00,090121,Kumar; Arun Kumar,0,0,0,0
1653590099978,CSE 239B,A00,090122,Jhala; Ranjit,0,0,0,0
1653590100518,CSE 240A,A00,090123,Zhao; Jishen,0,0,189,189
1653590101050,CSE 243A,A00,090124,Orailoglu; Alex,0,0,15,15
1653590101584,CSE 249B,A00,090125,Kahng; Andrew Byun,12,0,20,8
1653590102120,CSE 250A,A00,090126,Berg-Kirkpatrick; Taylor D,0,0,0,0
1653590102658,CSE 252A,A00,090127,Ochoa; Benjamin Lawrence,0,0,0,0
1653590103208,CSE 258,A01,090129,McAuley; Julian John,0,0,0,0
1653590103741,CSE 258R,A01,090131,McAuley; Julian John,0,0,0,0
1653590104267,CSE 274,A00,090132,Ramamoorthi; Ravi,0,0,0,0
1653590104801,CSE 276A,A00,090133,Christensen; Henrik I,0,0,0,0
1653590105322,CSE 276C,A00,090134,Christensen; Henrik I,0,0,0,0
1653590105860,CSE 290,A00,090135,Bafna; Vineet,0,0,0,0
1653590105860,CSE 290,B00,090136,Ramamoorthi; Ravi,0,0,0,0
1653590105860,CSE 290,C00,090137,Li; Tzumao,7,0,10,3
1653590105860,CSE 290,D00,090138,Zhou; Yuan-Yuan,9,0,10,1
1653590105860,CSE 290,E00,090139,Christensen; Henrik I,8,0,10,2
1653590105860,CSE 290,F00,094053,Shalev; Aaron D,0,0,0,0
1653590106396,CSE 291,A00,090140,Munyaka; Imani N. S.,0,0,0,0
1653590106396,CSE 291,B00,094880,Yu; Qi,0,0,0,0
1653590106396,CSE 291,C00,090142,Pannuto; Patrick William,0,0,0,0
1653590106396,CSE 291,D00,094881,Zhang; Yiying,0,0,0,0
1653590106396,CSE 291,E00,095118,Su; Hao,0,0,0,0
1653590106923,CSE 293,001,094905,Bafna; Vineet,9999,0,9999,0
1653590106923,CSE 293,002,094906,Bellare; Mihir,9999,0,9999,0
1653590106923,CSE 293,003,094907,Berg-Kirkpatrick; Taylor D,9999,0,9999,0
1653590106923,CSE 293,004,094908,Christensen; Henrik I,9999,0,9999,0
1653590106923,CSE 293,005,094909,Cottrell; Garrison W,9999,0,9999,0
1653590106923,CSE 293,006,094910,Deutsch; Alin Bernard,9999,0,9999,0
1653590106923,CSE 293,007,094911,Esmaeilzadeh; Hadi,9999,0,9999,0
1653590106923,CSE 293,008,094912,Freund; Yoav,9999,0,9999,0
1653590106923,CSE 293,009,094913,Griswold; William G.,9999,0,9999,0
1653590106923,CSE 293,010,094914,Gymrek; Melissa Ann,9999,0,9999,0
1653590106923,CSE 293,011,094915,Heninger; Nadia A,9999,0,9999,0
1653590106923,CSE 293,012,094916,Impagliazzo; Russell,9999,0,9999,0
1653590106923,CSE 293,013,094917,Jhala; Ranjit,9999,0,9999,0
1653590106923,CSE 293,014,094918,Kahng; Andrew Byun,9999,0,9999,0
1653590106923,CSE 293,015,094919,Kane; Daniel Mertz,9999,0,9999,0
1653590106923,CSE 293,016,094920,Kriegman; David J,9999,0,9999,0
1653590106923,CSE 293,017,094921,Kumar; Arun Kumar,9999,0,9999,0
1653590106923,CSE 293,018,094922,Lerner; Sorin,9999,0,9999,0
1653590106923,CSE 293,019,094923,Lovett; Shachar,9999,0,9999,0
1653590106923,CSE 293,020,094924,McAuley; Julian John,9999,0,9999,0
1653590106923,CSE 293,021,094925,Micciancio; Daniele,9999,0,9999,0
1653590106923,CSE 293,022,094926,Orailoglu; Alex,9999,0,9999,0
1653590106923,CSE 293,023,094927,Paturi; Ramamohan,9999,0,9999,0
1653590106923,CSE 293,024,094928,Polikarpova; Nadezhda,9999,0,9999,0
1653590106923,CSE 293,025,094929,Politz; Joseph Gibbs,9999,0,9999,0
1653590106923,CSE 293,026,094930,Porter; George M,9999,0,9999,0
1653590106923,CSE 293,027,094931,Porter; Leonard Emerson,9999,0,9999,0
1653590106923,CSE 293,028,094932,Ramamoorthi; Ravi,9999,0,9999,0
1653590106923,CSE 293,029,094933,Sahoo; Debashis,9999,0,9999,0
1653590106923,CSE 293,030,094934,Saul; Lawrence,9999,0,9999,0
1653590106923,CSE 293,031,094935,Savage; Stefan,9999,0,9999,0
1653590106923,CSE 293,032,094936,Schulze; Jurgen P.,9999,0,9999,0
1653590106923,CSE 293,033,094937,Snoeren; Alex C.,9999,0,9999,0
1653590106923,CSE 293,034,094938,Shang; Jingbo,9999,0,9999,0
1653590106923,CSE 293,035,094939,Stefan; Deian,9999,0,9999,0
1653590106923,CSE 293,036,094940,Su; Hao,9999,0,9999,0
1653590106923,CSE 293,037,094941,Swanson; Steven James,9999,0,9999,0
1653590106923,CSE 293,038,094942,Tullsen; Dean Michael,9999,0,9999,0
1653590106923,CSE 293,039,094943,Voelker; Geoffrey M.,9999,0,9999,0
1653590106923,CSE 293,040,094944,Zhao; Jishen,9999,0,9999,0
1653590106923,CSE 293,041,094945,Zhou; Yuan-Yuan,9999,0,9999,0
1653590106923,CSE 293,042,094946,Gao; Sicun,9998,0,9999,1
1653590106923,CSE 293,043,094947,Weibel; Nadir,9999,0,9999,0
1653590106923,CSE 293,044,094948,Gupta; Rajesh K.,9999,0,9999,0
1653590107461,CSE 294,A00,090143,Porter; George M,8,0,10,2
1653590108006,DSE 200,A00,091799,Staff,50,0,50,0
1653590108551,DSE 203,A00,091800,Gupta; Amarnath,30,0,30,0
1653590109096,DSE 250,A00,091801,Deutsch; Alin Bernard,30,0,30,0
1653590109619,DSE 290,A00,091802,Altintas De Callaf; Ilkay,50,0,50,0
1653590110146,ECE 200,001,091003,Antipa; Nicholas A,9999,0,9999,0
1653590110146,ECE 200,002,091004,Atanasov; Nikolay A.,9999,0,9999,0
1653590110146,ECE 200,003,091005,Bharadia; Dinesh,9999,0,9999,0
1653590110146,ECE 200,004,091006,Cheng; Chung Kuan,9999,0,9999,0
1653590110146,ECE 200,005,091007,Cosman; Pamela C.,9999,0,9999,0
1653590110146,ECE 200,006,091008,Staff,9999,0,9999,0
1653590110146,ECE 200,007,091009,Dayeh; Shadi Ahmad,9999,0,9999,0
1653590110146,ECE 200,008,091010,Fainman; Yeshaiahu,9999,0,9999,0
1653590110146,ECE 200,009,091011,Ford; Joseph Earl,9999,0,9999,0
1653590110146,ECE 200,010,091012,Franceschetti; Massimo,9999,0,9999,0
1653590110146,ECE 200,011,091013,Fullerton; Eric E,9999,0,9999,0
1653590110146,ECE 200,012,091014,Galton; Ian A,9999,0,9999,0
1653590110146,ECE 200,013,091015,Gilja; Vikash,9999,0,9999,0
1653590110146,ECE 200,014,091016,Hall; Drew A.,9999,0,9999,0
1653590110146,ECE 200,015,091017,Hsueh; Tzu-Chien,9999,0,9999,0
1653590110146,ECE 200,016,091018,Javidi; Tara,9999,0,9999,0
1653590110146,ECE 200,017,091019,Kahng; Andrew Byun,9999,0,9999,0
1653590110146,ECE 200,018,091020,Kim; Young-Han,9999,0,9999,0
1653590110146,ECE 200,019,091021,Koushanfar; Farinaz,9999,0,9999,0
1653590110146,ECE 200,020,091022,Kuzum; Duygu,9999,0,9999,0
1653590110146,ECE 200,021,091023,Le; Hanh-Phuc,9999,0,9999,0
1653590110146,ECE 200,022,091024,Lin; Bill,9999,0,9999,0
1653590110146,ECE 200,023,091025,Liu; Zhaowei,9999,0,9999,0
1653590110146,ECE 200,024,091026,Lo; Yu-Hwa,9999,0,9999,0
1653590110146,ECE 200,025,091027,Lomakin; Vitaliy,9999,0,9999,0
1653590110146,ECE 200,026,091028,Mercier; Patrick Philip,9999,0,9999,0
1653590110146,ECE 200,027,091029,Meyer; Florian,9999,0,9999,0
1653590110146,ECE 200,028,091030,Milstein; Laurence B.,9999,0,9999,0
1653590110146,ECE 200,029,091031,Mir Arabbaygi; Siavash,9999,0,9999,0
1653590110146,ECE 200,030,091032,Mookherjea; Shayan,9999,0,9999,0
1653590110146,ECE 200,031,091033,Morris; Karcher William,9999,0,9999,0
1653590110146,ECE 200,032,091034,Ng; Tse Nga,9999,0,9999,0
1653590110146,ECE 200,033,091035,Nguyen; Truong Quang,9999,0,9999,0
1653590110146,ECE 200,034,091036,Nomura; Kenji,9999,0,9999,0
1653590110146,ECE 200,035,091037,Orlitsky; Alon,9999,0,9999,0
1653590110146,ECE 200,036,091038,Pal; Piya,9999,0,9999,0
1653590110146,ECE 200,037,091039,Papen; George C.,9999,0,9999,0
1653590110146,ECE 200,038,091040,Radic; Stojan,9999,0,9999,0
1653590110146,ECE 200,039,091041,Rao; Bhaskar D.,9999,0,9999,0
1653590110146,ECE 200,040,091042,Rao; Ramesh R,9999,0,9999,0
1653590110146,ECE 200,041,091043,Rebeiz; Gabriel,9999,0,9999,0
1653590110146,ECE 200,042,091044,Sanford; John R,9999,0,9999,0
1653590110146,ECE 200,043,091045,Siegel; Paul H.,9999,0,9999,0
1653590110146,ECE 200,044,091046,Sievenpiper; Daniel F.,9999,0,9999,0
1653590110146,ECE 200,045,091047,Sworder; David D.,9999,0,9999,0
1653590110146,ECE 200,046,091048,Taur; Yuan,9999,0,9999,0
1653590110146,ECE 200,047,091049,Touri; Behrouz,9999,0,9999,0
1653590110146,ECE 200,048,091050,Trivedi; Mohan M.,9999,0,9999,0
1653590110146,ECE 200,049,091051,Vardy; Alexander,9999,0,9999,0
1653590110146,ECE 200,050,091052,Vasconcelos; Nuno,9999,0,9999,0
1653590110146,ECE 200,051,091053,Wang; Xiaolong,9999,0,9999,0
1653590110146,ECE 200,052,091054,Xie; Pengtao,9999,0,9999,0
1653590110146,ECE 200,053,091055,Yip; Michael,9999,0,9999,0
1653590110146,ECE 200,054,091056,Zeger; Kenneth A.,9999,0,9999,0
1653590110146,ECE 200,055,091057,Zhang; Xinyu,9999,0,9999,0
1653590110146,ECE 200,056,091058,Turakhia; Yatish Girish,9999,0,9999,0
1653590110146,ECE 200,057,091059,Kang; Mingu,9999,0,9999,0
1653590110146,ECE 200,058,091060,Shi; Yuanyuan,9999,0,9999,0
1653590110146,ECE 200,059,091061,Wang; Edward Jay,9999,0,9999,0
1653590110146,ECE 200,060,091062,Zheng; Yang,9999,0,9999,0
1653590110667,ECE 201,A00,095526,Lo; Yu-Hwa,0,0,0,0
1653590111191,ECE 203,A00,091065,Mercier; Patrick Philip,0,0,0,0
1653590111740,ECE 207A,A00,091605,Liu; Thomas Tao-Ming,0,0,0,0
1653590112282,ECE 212AN,A00,091068,Nomura; Kenji,0,0,0,0
1653590112830,ECE 222A,A00,091069,Rebeiz; Gabriel,0,0,0,0
1653590113366,ECE 225A,A00,091070,Orlitsky; Alon,0,0,0,0
1653590113902,ECE 230A,A00,091071,Nomura; Kenji,0,0,0,0
1653590114445,ECE 236A,A00,091072,Dayeh; Shadi Ahmad,0,0,0,0
1653590114980,ECE 238A,A00,091073,Luo; Jian,0,0,0,0
1653590114980,ECE 238A,B00,091074,Luo; Jian,0,0,0,0
1653590115512,ECE 240A,A00,091075,Radic; Stojan,0,0,0,0
1653590116049,ECE 247A,A00,091592,Shi; Lingyan,0,0,0,0
1653590116584,ECE 250,A00,091076,Touri; Behrouz,0,0,0,0
1653590117120,ECE 251C,A00,091078,Nguyen; Truong Quang,0,0,0,0
1653590117658,ECE 253,A00,091079,Cosman; Pamela C.,0,0,0,0
1653590118204,ECE 255A,A00,091080,Orlitsky; Alon,0,0,0,0
1653590118730,ECE 257A,A00,091081,Zhang; Xinyu,0,0,0,0
1653590119253,ECE 260A,A01,091084,Eldon; John,0,0,0,0
1653590119787,ECE 264C,A00,091085,Galton; Ian A,0,0,0,0
1653590120312,ECE 265C,A00,094889,Presti; Calogero Davide,0,0,0,9
1653590120852,ECE 266,A01,091087,Hall; Drew A.,0,0,0,0
1653590121923,ECE 271A,A00,091090,Vasconcelos; Nuno,0,0,0,0
1653590122461,ECE 272B,A00,091091,Sworder; David D.,0,0,0,0
1653590122992,ECE 275A,A00,091092,Meyer; Florian,0,0,0,0
1653590123534,ECE 277,A00,091093,An; Cheolhong,0,0,0,0
1653590124060,ECE 283,A00,091094,Le; Hanh-Phuc,0,0,0,0
1653590124609,ECE 284,A00,091095,Kang; Mingu,0,0,0,0
1653590124609,ECE 284,B00,091096,Wang; Edward Jay,0,0,0,0
1653590125144,ECE 285,A00,094334,Touri; Behrouz,0,0,0,0
1653590125678,ECE 289,A00,091097,Whelan; David Arthur,0,0,0,0
1653590126211,MATH 200A,A00,087414,Salehi Golsefidy; Alireza,7,0,8,1
1653590126749,MATH 202A,A00,087415,Gill; Philip E.,2,0,8,6
1653590127276,MATH 203A,A00,087416,Oprea; Dragos N.,6,0,8,2
1653590127800,MATH 204A,A00,087417,Kedlaya; Kiran S.,6,0,8,2
1653590128327,MATH 205,A00,087418,Sorensen; Claus M,6,0,8,2
1653590128854,MATH 206A,A00,087419,Izadi; Elham,7,0,8,1
1653590129391,MATH 207A,A00,087420,Mohammadi; Amir,5,0,8,3
1653590129935,MATH 208,A00,087421,Staff,9,0,10,1
1653590130468,MATH 209,A00,087422,Staff,10,0,10,0
1653590131000,MATH 218,A00,087423,Staff,10,0,10,0
1653590131526,MATH 220A,A00,087424,Novak; Jonathan I,6,0,8,2
1653590132056,MATH 231A,A00,087425,Bejenaru; Ioan,3,0,8,5
1653590132583,MATH 240A,A00,087426,Ebenfelt; Peter F,5,0,8,3
1653590133115,MATH 243,A00,087427,Staff,9,0,10,1
1653590133663,MATH 248,A00,087429,Staff,10,0,10,0
1653590134191,MATH 250A,A00,087430,Spolaor; Luca,4,0,8,4
1653590134718,MATH 257A,A00,087431,Spolaor; Luca,7,0,8,1
1653590135261,MATH 258,A00,087432,Staff,9,0,10,1
1653590135786,MATH 264A,A00,087433,Warnke; Lutz Peter,5,0,8,3
1653590136309,MATH 268,A00,087434,Staff,15,0,15,0
1653590136843,MATH 269,A00,087435,Staff,14,0,15,1
1653590137393,MATH 270A,A00,087436,Nie; Jiawang,0,0,8,8
1653590137927,MATH 272A,A00,087437,Tian; Xiaochuan,0,0,8,8
1653590138455,MATH 274,A01,087439,Cheng; Li-Tien,9,0,10,1
1653590138455,MATH 274,A02,087440,Cheng; Li-Tien,10,0,10,0
1653590138981,MATH 278A,A00,087441,Staff,8,0,10,2
1653590139511,MATH 278B,A00,087442,Staff,8,0,10,2
1653590140033,MATH 278C,A00,087443,Staff,8,0,10,2
1653590140558,MATH 280A,A00,087444,Zheng; Tianyi,0,0,8,8
1653590141088,MATH 281A,A00,087445,Bradic; Jelena,0,0,8,8
1653590141615,MATH 282A,A00,087446,Zhang; Danna,0,0,8,8
1653590142157,MATH 283,A00,087447,Tesler; Glenn,0,0,0,16
1653590142699,MATH 286,B00,095535,Kemp; Todd Aahron,0,0,0,0
1653590143320,MATH 287D,B00,095536,Bradic; Jelena,6,0,8,2
1653590143860,MATH 288,A00,087450,Staff,14,0,15,1
1653590143860,MATH 288,B00,087451,Staff,15,0,15,0
1653590143860,MATH 288,C00,087452,Staff,15,0,15,0
1653590144397,MATH 290A,A00,087453,Xu; Zhouli,6,0,8,2
1653590144936,MATH 291A,A00,087454,Xu; Zhouli,7,0,8,1
1653590145469,MATH 292,A00,087455,Staff,10,0,10,0
1653590146004,MATH 295,A00,087456,Staff,50,0,50,0
1653590146550,MATH 297,001,087457,Staff,997,0,999,2
1653590714969,COGS 200,A01,087991,Staff,47,0,50,3
1653590715499,COGS 201,A01,094504,Rangel; Lara M,16,0,25,9
1653590716037,COGS 203,A00,087992,Coulson; Seana M,18,0,20,2
1653590716566,COGS 210A,001,087993,Greene; Deanna Jacquelyn,9998,0,9999,1
1653590716566,COGS 210A,002,087994,Saygin; Ayse P,9999,0,9999,0
1653590716566,COGS 210A,003,087995,Xia; Haijun,9999,0,9999,0
1653590716566,COGS 210A,004,087996,Nitz; Douglas A.,9999,0,9999,0
1653590716566,COGS 210A,005,087997,Hollan; James D.,9999,0,9999,0
1653590716566,COGS 210A,006,087998,Deak; Gedeon O.,9998,0,9999,1
1653590716566,COGS 210A,007,087999,Rossano; Federico,9999,0,9999,0
1653590717105,COGS 211A,A00,088000,Coulson; Seana M,9997,0,9999,2
1653590717628,COGS 229,A00,088002,Staff,22,0,25,3
1653590718154,COGS 260,B00,094231,Staff,17,0,20,3
1653590718154,COGS 260,A00,088004,Nitz; Douglas A.,9998,0,9999,1
1653590718701,CSE 202,A00,090110,Paturi; Ramamohan,0,0,0,0
1653590718701,CSE 202,B00,090111,Paturi; Ramamohan,0,0,0,0
1653590719226,CSE 207B,A00,090112,Heninger; Nadia A,0,0,0,0
1653590719765,CSE 208,A00,094858,Micciancio; Daniele,0,0,0,0
1653590720291,CSE 210,A00,090113,Powell; Thomas Allan,0,0,0,0
1653590720817,CSE 219,A00,090898,Staff,0,0,0,0
1653590721345,CSE 221,A00,090114,Zhou; Yuan-Yuan,0,0,0,0
1653590721883,CSE 229A,A00,090115,Porter; George M,0,0,0,0
1653590722406,CSE 229C,A00,090116,Savage; Stefan,0,0,0,0
1653590722939,CSE 230,A00,090117,Jhala; Ranjit,0,0,0,0
1653590723484,CSE 232,A00,090118,Papakonstantinou; Yannis,0,0,0,0
1653590724007,CSE 239A,A00,090121,Kumar; Arun Kumar,0,0,0,0
1653590724529,CSE 239B,A00,090122,Jhala; Ranjit,0,0,0,0
1653590725065,CSE 240A,A00,090123,Zhao; Jishen,0,0,189,189
1653590725607,CSE 243A,A00,090124,Orailoglu; Alex,0,0,15,15
1653590726145,CSE 249B,A00,090125,Kahng; Andrew Byun,12,0,20,8
1653590726669,CSE 250A,A00,090126,Berg-Kirkpatrick; Taylor D,0,0,0,0
1653590727203,CSE 252A,A00,090127,Ochoa; Benjamin Lawrence,0,0,0,0
1653590727733,CSE 258,A01,090129,McAuley; Julian John,0,0,0,0
1653590728255,CSE 258R,A01,090131,McAuley; Julian John,0,0,0,0
1653590728796,CSE 274,A00,090132,Ramamoorthi; Ravi,0,0,0,0
1653590729335,CSE 276A,A00,090133,Christensen; Henrik I,0,0,0,0
1653590729883,CSE 276C,A00,090134,Christensen; Henrik I,0,0,0,0
1653590730416,CSE 290,A00,090135,Bafna; Vineet,0,0,0,0
1653590730416,CSE 290,B00,090136,Ramamoorthi; Ravi,0,0,0,0
1653590730416,CSE 290,C00,090137,Li; Tzumao,7,0,10,3
1653590730416,CSE 290,D00,090138,Zhou; Yuan-Yuan,9,0,10,1
1653590730416,CSE 290,E00,090139,Christensen; Henrik I,8,0,10,2
1653590730416,CSE 290,F00,094053,Shalev; Aaron D,0,0,0,0
1653590730943,CSE 291,A00,090140,Munyaka; Imani N. S.,0,0,0,0
1653590730943,CSE 291,B00,094880,Yu; Qi,0,0,0,0
1653590730943,CSE 291,C00,090142,Pannuto; Patrick William,0,0,0,0
1653590730943,CSE 291,D00,094881,Zhang; Yiying,0,0,0,0
1653590730943,CSE 291,E00,095118,Su; Hao,0,0,0,0
1653590731480,CSE 293,001,094905,Bafna; Vineet,9999,0,9999,0
1653590731480,CSE 293,002,094906,Bellare; Mihir,9999,0,9999,0
1653590731480,CSE 293,003,094907,Berg-Kirkpatrick; Taylor D,9999,0,9999,0
1653590731480,CSE 293,004,094908,Christensen; Henrik I,9999,0,9999,0
1653590731480,CSE 293,005,094909,Cottrell; Garrison W,9999,0,9999,0
1653590731480,CSE 293,006,094910,Deutsch; Alin Bernard,9999,0,9999,0
1653590731480,CSE 293,007,094911,Esmaeilzadeh; Hadi,9999,0,9999,0
1653590731480,CSE 293,008,094912,Freund; Yoav,9999,0,9999,0
1653590731480,CSE 293,009,094913,Griswold; William G.,9999,0,9999,0
1653590731480,CSE 293,010,094914,Gymrek; Melissa Ann,9999,0,9999,0
1653590731480,CSE 293,011,094915,Heninger; Nadia A,9999,0,9999,0
1653590731480,CSE 293,012,094916,Impagliazzo; Russell,9999,0,9999,0
1653590731480,CSE 293,013,094917,Jhala; Ranjit,9999,0,9999,0
1653590731480,CSE 293,014,094918,Kahng; Andrew Byun,9999,0,9999,0
1653590731480,CSE 293,015,094919,Kane; Daniel Mertz,9999,0,9999,0
1653590731480,CSE 293,016,094920,Kriegman; David J,9999,0,9999,0
1653590731480,CSE 293,017,094921,Kumar; Arun Kumar,9999,0,9999,0
1653590731480,CSE 293,018,094922,Lerner; Sorin,9999,0,9999,0
1653590731480,CSE 293,019,094923,Lovett; Shachar,9999,0,9999,0
1653590731480,CSE 293,020,094924,McAuley; Julian John,9999,0,9999,0
1653590731480,CSE 293,021,094925,Micciancio; Daniele,9999,0,9999,0
1653590731480,CSE 293,022,094926,Orailoglu; Alex,9999,0,9999,0
1653590731480,CSE 293,023,094927,Paturi; Ramamohan,9999,0,9999,0
1653590731480,CSE 293,024,094928,Polikarpova; Nadezhda,9999,0,9999,0
1653590731480,CSE 293,025,094929,Politz; Joseph Gibbs,9999,0,9999,0
1653590731480,CSE 293,026,094930,Porter; George M,9999,0,9999,0
1653590731480,CSE 293,027,094931,Porter; Leonard Emerson,9999,0,9999,0
1653590731480,CSE 293,028,094932,Ramamoorthi; Ravi,9999,0,9999,0
1653590731480,CSE 293,029,094933,Sahoo; Debashis,9999,0,9999,0
1653590731480,CSE 293,030,094934,Saul; Lawrence,9999,0,9999,0
1653590731480,CSE 293,031,094935,Savage; Stefan,9999,0,9999,0
1653590731480,CSE 293,032,094936,Schulze; Jurgen P.,9999,0,9999,0
1653590731480,CSE 293,033,094937,Snoeren; Alex C.,9999,0,9999,0
1653590731480,CSE 293,034,094938,Shang; Jingbo,9999,0,9999,0
1653590731480,CSE 293,035,094939,Stefan; Deian,9999,0,9999,0
1653590731480,CSE 293,036,094940,Su; Hao,9999,0,9999,0
1653590731480,CSE 293,037,094941,Swanson; Steven James,9999,0,9999,0
1653590731480,CSE 293,038,094942,Tullsen; Dean Michael,9999,0,9999,0
1653590731480,CSE 293,039,094943,Voelker; Geoffrey M.,9999,0,9999,0
1653590731480,CSE 293,040,094944,Zhao; Jishen,9999,0,9999,0
1653590731480,CSE 293,041,094945,Zhou; Yuan-Yuan,9999,0,9999,0
1653590731480,CSE 293,042,094946,Gao; Sicun,9998,0,9999,1
1653590731480,CSE 293,043,094947,Weibel; Nadir,9999,0,9999,0
1653590731480,CSE 293,044,094948,Gupta; Rajesh K.,9999,0,9999,0
1653590732003,CSE 294,A00,090143,Porter; George M,8,0,10,2
1653590732548,DSE 200,A00,091799,Staff,50,0,50,0
1653590733106,DSE 203,A00,091800,Gupta; Amarnath,30,0,30,0
1653590733649,DSE 250,A00,091801,Deutsch; Alin Bernard,30,0,30,0
1653590734184,DSE 290,A00,091802,Altintas De Callaf; Ilkay,50,0,50,0
1653590734727,ECE 200,001,091003,Antipa; Nicholas A,9999,0,9999,0
1653590734727,ECE 200,002,091004,Atanasov; Nikolay A.,9999,0,9999,0
1653590734727,ECE 200,003,091005,Bharadia; Dinesh,9999,0,9999,0
1653590734727,ECE 200,004,091006,Cheng; Chung Kuan,9999,0,9999,0
1653590734727,ECE 200,005,091007,Cosman; Pamela C.,9999,0,9999,0
1653590734727,ECE 200,006,091008,Staff,9999,0,9999,0
1653590734727,ECE 200,007,091009,Dayeh; Shadi Ahmad,9999,0,9999,0
1653590734727,ECE 200,008,091010,Fainman; Yeshaiahu,9999,0,9999,0
1653590734727,ECE 200,009,091011,Ford; Joseph Earl,9999,0,9999,0
1653590734727,ECE 200,010,091012,Franceschetti; Massimo,9999,0,9999,0
1653590734727,ECE 200,011,091013,Fullerton; Eric E,9999,0,9999,0
1653590734727,ECE 200,012,091014,Galton; Ian A,9999,0,9999,0
1653590734727,ECE 200,013,091015,Gilja; Vikash,9999,0,9999,0
1653590734727,ECE 200,014,091016,Hall; Drew A.,9999,0,9999,0
1653590734727,ECE 200,015,091017,Hsueh; Tzu-Chien,9999,0,9999,0
1653590734727,ECE 200,016,091018,Javidi; Tara,9999,0,9999,0
1653590734727,ECE 200,017,091019,Kahng; Andrew Byun,9999,0,9999,0
1653590734727,ECE 200,018,091020,Kim; Young-Han,9999,0,9999,0
1653590734727,ECE 200,019,091021,Koushanfar; Farinaz,9999,0,9999,0
1653590734727,ECE 200,020,091022,Kuzum; Duygu,9999,0,9999,0
1653590734727,ECE 200,021,091023,Le; Hanh-Phuc,9999,0,9999,0
1653590734727,ECE 200,022,091024,Lin; Bill,9999,0,9999,0
1653590734727,ECE 200,023,091025,Liu; Zhaowei,9999,0,9999,0
1653590734727,ECE 200,024,091026,Lo; Yu-Hwa,9999,0,9999,0
1653590734727,ECE 200,025,091027,Lomakin; Vitaliy,9999,0,9999,0
1653590734727,ECE 200,026,091028,Mercier; Patrick Philip,9999,0,9999,0
1653590734727,ECE 200,027,091029,Meyer; Florian,9999,0,9999,0
1653590734727,ECE 200,028,091030,Milstein; Laurence B.,9999,0,9999,0
1653590734727,ECE 200,029,091031,Mir Arabbaygi; Siavash,9999,0,9999,0
1653590734727,ECE 200,030,091032,Mookherjea; Shayan,9999,0,9999,0
1653590734727,ECE 200,031,091033,Morris; Karcher William,9999,0,9999,0
1653590734727,ECE 200,032,091034,Ng; Tse Nga,9999,0,9999,0
1653590734727,ECE 200,033,091035,Nguyen; Truong Quang,9999,0,9999,0
1653590734727,ECE 200,034,091036,Nomura; Kenji,9999,0,9999,0
1653590734727,ECE 200,035,091037,Orlitsky; Alon,9999,0,9999,0
1653590734727,ECE 200,036,091038,Pal; Piya,9999,0,9999,0
1653590734727,ECE 200,037,091039,Papen; George C.,9999,0,9999,0
1653590734727,ECE 200,038,091040,Radic; Stojan,9999,0,9999,0
1653590734727,ECE 200,039,091041,Rao; Bhaskar D.,9999,0,9999,0
1653590734727,ECE 200,040,091042,Rao; Ramesh R,9999,0,9999,0
1653590734727,ECE 200,041,091043,Rebeiz; Gabriel,9999,0,9999,0
1653590734727,ECE 200,042,091044,Sanford; John R,9999,0,9999,0
1653590734727,ECE 200,043,091045,Siegel; Paul H.,9999,0,9999,0
1653590734727,ECE 200,044,091046,Sievenpiper; Daniel F.,9999,0,9999,0
1653590734727,ECE 200,045,091047,Sworder; David D.,9999,0,9999,0
1653590734727,ECE 200,046,091048,Taur; Yuan,9999,0,9999,0
1653590734727,ECE 200,047,091049,Touri; Behrouz,9999,0,9999,0
1653590734727,ECE 200,048,091050,Trivedi; Mohan M.,9999,0,9999,0
1653590734727,ECE 200,049,091051,Vardy; Alexander,9999,0,9999,0
1653590734727,ECE 200,050,091052,Vasconcelos; Nuno,9999,0,9999,0
1653590734727,ECE 200,051,091053,Wang; Xiaolong,9999,0,9999,0
1653590734727,ECE 200,052,091054,Xie; Pengtao,9999,0,9999,0
1653590734727,ECE 200,053,091055,Yip; Michael,9999,0,9999,0
1653590734727,ECE 200,054,091056,Zeger; Kenneth A.,9999,0,9999,0
1653590734727,ECE 200,055,091057,Zhang; Xinyu,9999,0,9999,0
1653590734727,ECE 200,056,091058,Turakhia; Yatish Girish,9999,0,9999,0
1653590734727,ECE 200,057,091059,Kang; Mingu,9999,0,9999,0
1653590734727,ECE 200,058,091060,Shi; Yuanyuan,9999,0,9999,0
1653590734727,ECE 200,059,091061,Wang; Edward Jay,9999,0,9999,0
1653590734727,ECE 200,060,091062,Zheng; Yang,9999,0,9999,0
1653590735250,ECE 201,A00,095526,Lo; Yu-Hwa,0,0,0,0
1653590735780,ECE 203,A00,091065,Mercier; Patrick Philip,0,0,0,0
1653590736321,ECE 207A,A00,091605,Liu; Thomas Tao-Ming,0,0,0,0
1653590736868,ECE 212AN,A00,091068,Nomura; Kenji,0,0,0,0
1653590737392,ECE 222A,A00,091069,Rebeiz; Gabriel,0,0,0,0
1653590737929,ECE 225A,A00,091070,Orlitsky; Alon,0,0,0,0
1653590738454,ECE 230A,A00,091071,Nomura; Kenji,0,0,0,0
1653590738985,ECE 236A,A00,091072,Dayeh; Shadi Ahmad,0,0,0,0
1653590739625,ECE 238A,A00,091073,Luo; Jian,0,0,0,0
1653590739625,ECE 238A,B00,091074,Luo; Jian,0,0,0,0
1653590740159,ECE 240A,A00,091075,Radic; Stojan,0,0,0,0
1653590740693,ECE 247A,A00,091592,Shi; Lingyan,0,0,0,0
1653590741221,ECE 250,A00,091076,Touri; Behrouz,0,0,0,0
1653590741751,ECE 251C,A00,091078,Nguyen; Truong Quang,0,0,0,0
1653590742277,ECE 253,A00,091079,Cosman; Pamela C.,0,0,0,0
1653590742822,ECE 255A,A00,091080,Orlitsky; Alon,0,0,0,0
1653590743369,ECE 257A,A00,091081,Zhang; Xinyu,0,0,0,0
1653590743902,ECE 260A,A01,091084,Eldon; John,0,0,0,0
1653590744432,ECE 264C,A00,091085,Galton; Ian A,0,0,0,0
1653590744972,ECE 265C,A00,094889,Presti; Calogero Davide,0,0,0,9
1653590745520,ECE 266,A01,091087,Hall; Drew A.,0,0,0,0
1653590746579,ECE 271A,A00,091090,Vasconcelos; Nuno,0,0,0,0
1653590747101,ECE 272B,A00,091091,Sworder; David D.,0,0,0,0
1653590747629,ECE 275A,A00,091092,Meyer; Florian,0,0,0,0
1653590748165,ECE 277,A00,091093,An; Cheolhong,0,0,0,0
1653590748700,ECE 283,A00,091094,Le; Hanh-Phuc,0,0,0,0
1653590749255,ECE 284,A00,091095,Kang; Mingu,0,0,0,0
1653590749255,ECE 284,B00,091096,Wang; Edward Jay,0,0,0,0
1653590749778,ECE 285,A00,094334,Touri; Behrouz,0,0,0,0
1653590750304,ECE 289,A00,091097,Whelan; David Arthur,0,0,0,0
1653590750828,MATH 200A,A00,087414,Salehi Golsefidy; Alireza,7,0,8,1
1653590751353,MATH 202A,A00,087415,Gill; Philip E.,2,0,8,6
1653590751913,MATH 203A,A00,087416,Oprea; Dragos N.,6,0,8,2
1653590752459,MATH 204A,A00,087417,Kedlaya; Kiran S.,6,0,8,2
1653590752989,MATH 205,A00,087418,Sorensen; Claus M,6,0,8,2
1653590753533,MATH 206A,A00,087419,Izadi; Elham,7,0,8,1
1653590754094,MATH 207A,A00,087420,Mohammadi; Amir,5,0,8,3
1653590754622,MATH 208,A00,087421,Staff,9,0,10,1
1653590755156,MATH 209,A00,087422,Staff,10,0,10,0
1653590755698,MATH 218,A00,087423,Staff,10,0,10,0
1653590756227,MATH 220A,A00,087424,Novak; Jonathan I,6,0,8,2
1653590756756,MATH 231A,A00,087425,Bejenaru; Ioan,3,0,8,5
1653590757278,MATH 240A,A00,087426,Ebenfelt; Peter F,5,0,8,3
1653590757800,MATH 243,A00,087427,Staff,9,0,10,1
1653590758322,MATH 248,A00,087429,Staff,10,0,10,0
1653590758879,MATH 250A,A00,087430,Spolaor; Luca,4,0,8,4
1653590759419,MATH 257A,A00,087431,Spolaor; Luca,7,0,8,1
1653590759945,MATH 258,A00,087432,Staff,9,0,10,1
1653590760477,MATH 264A,A00,087433,Warnke; Lutz Peter,5,0,8,3
1653590761016,MATH 268,A00,087434,Staff,15,0,15,0
1653590761562,MATH 269,A00,087435,Staff,14,0,15,1
1653590762106,MATH 270A,A00,087436,Nie; Jiawang,0,0,8,8
1653590762642,MATH 272A,A00,087437,Tian; Xiaochuan,0,0,8,8
1653590763191,MATH 274,A01,087439,Cheng; Li-Tien,9,0,10,1
1653590763191,MATH 274,A02,087440,Cheng; Li-Tien,10,0,10,0
1653590763715,MATH 278A,A00,087441,Staff,8,0,10,2
1653590764261,MATH 278B,A00,087442,Staff,8,0,10,2
1653590764813,MATH 278C,A00,087443,Staff,8,0,10,2
1653590765360,MATH 280A,A00,087444,Zheng; Tianyi,0,0,8,8
1653590765900,MATH 281A,A00,087445,Bradic; Jelena,0,0,8,8
1653590766426,MATH 282A,A00,087446,Zhang; Danna,0,0,8,8
1653590766969,MATH 283,A00,087447,Tesler; Glenn,0,0,0,16
1653590767496,MATH 286,B00,095535,Kemp; Todd Aahron,8,0,8,0
1653590768051,MATH 287D,B00,095536,Bradic; Jelena,6,0,8,2
1653590768577,MATH 288,A00,087450,Staff,14,0,15,1
1653590768577,MATH 288,B00,087451,Staff,15,0,15,0
1653590768577,MATH 288,C00,087452,Staff,15,0,15,0
1653590769118,MATH 290A,A00,087453,Xu; Zhouli,6,0,8,2
1653590769656,MATH 291A,A00,087454,Xu; Zhouli,7,0,8,1
1653590770200,MATH 292,A00,087455,Staff,10,0,10,0
1653590770729,MATH 295,A00,087456,Staff,50,0,50,0
1653590771263,MATH 297,001,087457,Staff,997,0,999,2
1653591343726,COGS 200,A01,087991,Staff,47,0,50,3
1653591344263,COGS 201,A01,094504,Rangel; Lara M,16,0,25,9
1653591344812,COGS 203,A00,087992,Coulson; Seana M,18,0,20,2
1653591345353,COGS 210A,001,087993,Greene; Deanna Jacquelyn,9998,0,9999,1
1653591345353,COGS 210A,002,087994,Saygin; Ayse P,9999,0,9999,0
1653591345353,COGS 210A,003,087995,Xia; Haijun,9999,0,9999,0
1653591345353,COGS 210A,004,087996,Nitz; Douglas A.,9999,0,9999,0
1653591345353,COGS 210A,005,087997,Hollan; James D.,9999,0,9999,0
1653591345353,COGS 210A,006,087998,Deak; Gedeon O.,9998,0,9999,1
1653591345353,COGS 210A,007,087999,Rossano; Federico,9999,0,9999,0
1653591345888,COGS 211A,A00,088000,Coulson; Seana M,9997,0,9999,2
1653591346411,COGS 229,A00,088002,Staff,22,0,25,3
1653591346947,COGS 260,B00,094231,Staff,17,0,20,3
1653591346947,COGS 260,A00,088004,Nitz; Douglas A.,9998,0,9999,1
1653591347501,CSE 202,A00,090110,Paturi; Ramamohan,0,0,0,0
1653591347501,CSE 202,B00,090111,Paturi; Ramamohan,0,0,0,0
1653591348039,CSE 207B,A00,090112,Heninger; Nadia A,0,0,0,0
1653591348561,CSE 208,A00,094858,Micciancio; Daniele,0,0,0,0
1653591349088,CSE 210,A00,090113,Powell; Thomas Allan,0,0,0,0
1653591349625,CSE 219,A00,090898,Staff,0,0,0,0
1653591350161,CSE 221,A00,090114,Zhou; Yuan-Yuan,0,0,0,0
1653591350703,CSE 229A,A00,090115,Porter; George M,0,0,0,0
1653591351254,CSE 229C,A00,090116,Savage; Stefan,0,0,0,0
1653591351791,CSE 230,A00,090117,Jhala; Ranjit,0,0,0,0
1653591352324,CSE 232,A00,090118,Papakonstantinou; Yannis,0,0,0,0
1653591352870,CSE 239A,A00,090121,Kumar; Arun Kumar,0,0,0,0
1653591353407,CSE 239B,A00,090122,Jhala; Ranjit,0,0,0,0
1653591353942,CSE 240A,A00,090123,Zhao; Jishen,1,0,189,188
1653591354479,CSE 243A,A00,090124,Orailoglu; Alex,0,0,15,15
1653591355004,CSE 249B,A00,090125,Kahng; Andrew Byun,12,0,20,8
1653591355555,CSE 250A,A00,090126,Berg-Kirkpatrick; Taylor D,0,0,0,0
1653591356098,CSE 252A,A00,090127,Ochoa; Benjamin Lawrence,0,0,0,0
1653591356650,CSE 258,A01,090129,McAuley; Julian John,0,0,0,0
1653591357189,CSE 258R,A01,090131,McAuley; Julian John,0,0,0,0
1653591357739,CSE 274,A00,090132,Ramamoorthi; Ravi,0,0,0,0
1653591358281,CSE 276A,A00,090133,Christensen; Henrik I,0,0,0,0
1653591358804,CSE 276C,A00,090134,Christensen; Henrik I,0,0,0,0
1653591359329,CSE 290,A00,090135,Bafna; Vineet,0,0,0,0
1653591359329,CSE 290,B00,090136,Ramamoorthi; Ravi,0,0,0,0
1653591359329,CSE 290,C00,090137,Li; Tzumao,7,0,10,3
1653591359329,CSE 290,D00,090138,Zhou; Yuan-Yuan,9,0,10,1
1653591359329,CSE 290,E00,090139,Christensen; Henrik I,8,0,10,2
1653591359329,CSE 290,F00,094053,Shalev; Aaron D,0,0,0,0
1653591359874,CSE 291,A00,090140,Munyaka; Imani N. S.,0,0,0,0
1653591359874,CSE 291,B00,094880,Yu; Qi,0,0,0,0
1653591359874,CSE 291,C00,090142,Pannuto; Patrick William,0,0,0,0
1653591359874,CSE 291,D00,094881,Zhang; Yiying,0,0,0,0
1653591359874,CSE 291,E00,095118,Su; Hao,0,0,0,0
1653591360401,CSE 293,001,094905,Bafna; Vineet,9999,0,9999,0
1653591360401,CSE 293,002,094906,Bellare; Mihir,9999,0,9999,0
1653591360401,CSE 293,003,094907,Berg-Kirkpatrick; Taylor D,9999,0,9999,0
1653591360401,CSE 293,004,094908,Christensen; Henrik I,9999,0,9999,0
1653591360401,CSE 293,005,094909,Cottrell; Garrison W,9999,0,9999,0
1653591360401,CSE 293,006,094910,Deutsch; Alin Bernard,9999,0,9999,0
1653591360401,CSE 293,007,094911,Esmaeilzadeh; Hadi,9999,0,9999,0
1653591360401,CSE 293,008,094912,Freund; Yoav,9999,0,9999,0
1653591360401,CSE 293,009,094913,Griswold; William G.,9999,0,9999,0
1653591360401,CSE 293,010,094914,Gymrek; Melissa Ann,9999,0,9999,0
1653591360401,CSE 293,011,094915,Heninger; Nadia A,9999,0,9999,0
1653591360401,CSE 293,012,094916,Impagliazzo; Russell,9999,0,9999,0
1653591360401,CSE 293,013,094917,Jhala; Ranjit,9999,0,9999,0
1653591360401,CSE 293,014,094918,Kahng; Andrew Byun,9999,0,9999,0
1653591360401,CSE 293,015,094919,Kane; Daniel Mertz,9999,0,9999,0
1653591360401,CSE 293,016,094920,Kriegman; David J,9999,0,9999,0
1653591360401,CSE 293,017,094921,Kumar; Arun Kumar,9999,0,9999,0
1653591360401,CSE 293,018,094922,Lerner; Sorin,9999,0,9999,0
1653591360401,CSE 293,019,094923,Lovett; Shachar,9999,0,9999,0
1653591360401,CSE 293,020,094924,McAuley; Julian John,9999,0,9999,0
1653591360401,CSE 293,021,094925,Micciancio; Daniele,9999,0,9999,0
1653591360401,CSE 293,022,094926,Orailoglu; Alex,9999,0,9999,0
1653591360401,CSE 293,023,094927,Paturi; Ramamohan,9999,0,9999,0
1653591360401,CSE 293,024,094928,Polikarpova; Nadezhda,9999,0,9999,0
1653591360401,CSE 293,025,094929,Politz; Joseph Gibbs,9999,0,9999,0
1653591360401,CSE 293,026,094930,Porter; George M,9999,0,9999,0
1653591360401,CSE 293,027,094931,Porter; Leonard Emerson,9999,0,9999,0
1653591360401,CSE 293,028,094932,Ramamoorthi; Ravi,9999,0,9999,0
1653591360401,CSE 293,029,094933,Sahoo; Debashis,9999,0,9999,0
1653591360401,CSE 293,030,094934,Saul; Lawrence,9999,0,9999,0
1653591360401,CSE 293,031,094935,Savage; Stefan,9999,0,9999,0
1653591360401,CSE 293,032,094936,Schulze; Jurgen P.,9999,0,9999,0
1653591360401,CSE 293,033,094937,Snoeren; Alex C.,9999,0,9999,0
1653591360401,CSE 293,034,094938,Shang; Jingbo,9999,0,9999,0
1653591360401,CSE 293,035,094939,Stefan; Deian,9999,0,9999,0
1653591360401,CSE 293,036,094940,Su; Hao,9999,0,9999,0
1653591360401,CSE 293,037,094941,Swanson; Steven James,9999,0,9999,0
1653591360401,CSE 293,038,094942,Tullsen; Dean Michael,9999,0,9999,0
1653591360401,CSE 293,039,094943,Voelker; Geoffrey M.,9999,0,9999,0
1653591360401,CSE 293,040,094944,Zhao; Jishen,9999,0,9999,0
1653591360401,CSE 293,041,094945,Zhou; Yuan-Yuan,9999,0,9999,0
1653591360401,CSE 293,042,094946,Gao; Sicun,9998,0,9999,1
1653591360401,CSE 293,043,094947,Weibel; Nadir,9999,0,9999,0
1653591360401,CSE 293,044,094948,Gupta; Rajesh K.,9999,0,9999,0
1653591360930,CSE 294,A00,090143,Porter; George M,8,0,10,2
1653591361467,DSE 200,A00,091799,Staff,50,0,50,0
1653591362006,DSE 203,A00,091800,Gupta; Amarnath,30,0,30,0
1653591362529,DSE 250,A00,091801,Deutsch; Alin Bernard,30,0,30,0
1653591363065,DSE 290,A00,091802,Altintas De Callaf; Ilkay,50,0,50,0
1653591363659,ECE 200,001,091003,Antipa; Nicholas A,9999,0,9999,0
1653591363659,ECE 200,002,091004,Atanasov; Nikolay A.,9999,0,9999,0
1653591363659,ECE 200,003,091005,Bharadia; Dinesh,9999,0,9999,0
1653591363659,ECE 200,004,091006,Cheng; Chung Kuan,9999,0,9999,0
1653591363659,ECE 200,005,091007,Cosman; Pamela C.,9999,0,9999,0
1653591363659,ECE 200,006,091008,Staff,9999,0,9999,0
1653591363659,ECE 200,007,091009,Dayeh; Shadi Ahmad,9999,0,9999,0
1653591363659,ECE 200,008,091010,Fainman; Yeshaiahu,9999,0,9999,0
1653591363659,ECE 200,009,091011,Ford; Joseph Earl,9999,0,9999,0
1653591363659,ECE 200,010,091012,Franceschetti; Massimo,9999,0,9999,0
1653591363659,ECE 200,011,091013,Fullerton; Eric E,9999,0,9999,0
1653591363659,ECE 200,012,091014,Galton; Ian A,9999,0,9999,0
1653591363659,ECE 200,013,091015,Gilja; Vikash,9999,0,9999,0
1653591363659,ECE 200,014,091016,Hall; Drew A.,9999,0,9999,0
1653591363659,ECE 200,015,091017,Hsueh; Tzu-Chien,9999,0,9999,0
1653591363659,ECE 200,016,091018,Javidi; Tara,9999,0,9999,0
1653591363659,ECE 200,017,091019,Kahng; Andrew Byun,9999,0,9999,0
1653591363659,ECE 200,018,091020,Kim; Young-Han,9999,0,9999,0
1653591363659,ECE 200,019,091021,Koushanfar; Farinaz,9999,0,9999,0
1653591363659,ECE 200,020,091022,Kuzum; Duygu,9999,0,9999,0
1653591363659,ECE 200,021,091023,Le; Hanh-Phuc,9999,0,9999,0
1653591363659,ECE 200,022,091024,Lin; Bill,9999,0,9999,0
1653591363659,ECE 200,023,091025,Liu; Zhaowei,9999,0,9999,0
1653591363659,ECE 200,024,091026,Lo; Yu-Hwa,9999,0,9999,0
1653591363659,ECE 200,025,091027,Lomakin; Vitaliy,9999,0,9999,0
1653591363659,ECE 200,026,091028,Mercier; Patrick Philip,9999,0,9999,0
1653591363659,ECE 200,027,091029,Meyer; Florian,9999,0,9999,0
1653591363659,ECE 200,028,091030,Milstein; Laurence B.,9999,0,9999,0
1653591363659,ECE 200,029,091031,Mir Arabbaygi; Siavash,9999,0,9999,0
1653591363659,ECE 200,030,091032,Mookherjea; Shayan,9999,0,9999,0
1653591363659,ECE 200,031,091033,Morris; Karcher William,9999,0,9999,0
1653591363659,ECE 200,032,091034,Ng; Tse Nga,9999,0,9999,0
1653591363659,ECE 200,033,091035,Nguyen; Truong Quang,9999,0,9999,0
1653591363659,ECE 200,034,091036,Nomura; Kenji,9999,0,9999,0
1653591363659,ECE 200,035,091037,Orlitsky; Alon,9999,0,9999,0
1653591363659,ECE 200,036,091038,Pal; Piya,9999,0,9999,0
1653591363659,ECE 200,037,091039,Papen; George C.,9999,0,9999,0
1653591363659,ECE 200,038,091040,Radic; Stojan,9999,0,9999,0
1653591363659,ECE 200,039,091041,Rao; Bhaskar D.,9999,0,9999,0
1653591363659,ECE 200,040,091042,Rao; Ramesh R,9999,0,9999,0
1653591363659,ECE 200,041,091043,Rebeiz; Gabriel,9999,0,9999,0
1653591363659,ECE 200,042,091044,Sanford; John R,9999,0,9999,0
1653591363659,ECE 200,043,091045,Siegel; Paul H.,9999,0,9999,0
1653591363659,ECE 200,044,091046,Sievenpiper; Daniel F.,9999,0,9999,0
1653591363659,ECE 200,045,091047,Sworder; David D.,9999,0,9999,0
1653591363659,ECE 200,046,091048,Taur; Yuan,9999,0,9999,0
1653591363659,ECE 200,047,091049,Touri; Behrouz,9999,0,9999,0
1653591363659,ECE 200,048,091050,Trivedi; Mohan M.,9999,0,9999,0
1653591363659,ECE 200,049,091051,Vardy; Alexander,9999,0,9999,0
1653591363659,ECE 200,050,091052,Vasconcelos; Nuno,9999,0,9999,0
1653591363659,ECE 200,051,091053,Wang; Xiaolong,9999,0,9999,0
1653591363659,ECE 200,052,091054,Xie; Pengtao,9999,0,9999,0
1653591363659,ECE 200,053,091055,Yip; Michael,9999,0,9999,0
1653591363659,ECE 200,054,091056,Zeger; Kenneth A.,9999,0,9999,0
1653591363659,ECE 200,055,091057,Zhang; Xinyu,9999,0,9999,0
1653591363659,ECE 200,056,091058,Turakhia; Yatish Girish,9999,0,9999,0
1653591363659,ECE 200,057,091059,Kang; Mingu,9999,0,9999,0
1653591363659,ECE 200,058,091060,Shi; Yuanyuan,9999,0,9999,0
1653591363659,ECE 200,059,091061,Wang; Edward Jay,9999,0,9999,0
1653591363659,ECE 200,060,091062,Zheng; Yang,9999,0,9999,0
1653591364198,ECE 201,A00,095526,Lo; Yu-Hwa,0,0,0,0
1653591364737,ECE 203,A00,091065,Mercier; Patrick Philip,0,0,0,0
1653591365272,ECE 207A,A00,091605,Liu; Thomas Tao-Ming,0,0,0,0
1653591365809,ECE 212AN,A00,091068,Nomura; Kenji,0,0,0,0
1653591366355,ECE 222A,A00,091069,Rebeiz; Gabriel,0,0,0,0
1653591366889,ECE 225A,A00,091070,Orlitsky; Alon,0,0,0,0
1653591367426,ECE 230A,A00,091071,Nomura; Kenji,0,0,0,0
1653591367963,ECE 236A,A00,091072,Dayeh; Shadi Ahmad,0,0,0,0
1653591368503,ECE 238A,A00,091073,Luo; Jian,0,0,0,0
1653591368503,ECE 238A,B00,091074,Luo; Jian,0,0,0,0
1653591369043,ECE 240A,A00,091075,Radic; Stojan,0,0,0,0
1653591369578,ECE 247A,A00,091592,Shi; Lingyan,0,0,0,0
1653591370112,ECE 250,A00,091076,Touri; Behrouz,0,0,0,0
1653591370648,ECE 251C,A00,091078,Nguyen; Truong Quang,0,0,0,0
1653591371193,ECE 253,A00,091079,Cosman; Pamela C.,0,0,0,0
1653591371721,ECE 255A,A00,091080,Orlitsky; Alon,0,0,0,0
1653591372259,ECE 257A,A00,091081,Zhang; Xinyu,0,0,0,0
1653591372801,ECE 260A,A01,091084,Eldon; John,0,0,0,0
1653591373335,ECE 264C,A00,091085,Galton; Ian A,0,0,0,0
1653591373874,ECE 265C,A00,094889,Presti; Calogero Davide,0,0,0,9
1653591374412,ECE 266,A01,091087,Hall; Drew A.,0,0,0,0
1653591375483,ECE 271A,A00,091090,Vasconcelos; Nuno,0,0,0,0
1653591376025,ECE 272B,A00,091091,Sworder; David D.,0,0,0,0
1653591376570,ECE 275A,A00,091092,Meyer; Florian,0,0,0,0
1653591377104,ECE 277,A00,091093,An; Cheolhong,0,0,0,0
1653591377636,ECE 283,A00,091094,Le; Hanh-Phuc,0,0,0,0
1653591378188,ECE 284,A00,091095,Kang; Mingu,0,0,0,0
1653591378188,ECE 284,B00,091096,Wang; Edward Jay,0,0,0,0
1653591378737,ECE 285,A00,094334,Touri; Behrouz,0,0,0,0
1653591379271,ECE 289,A00,091097,Whelan; David Arthur,0,0,0,0
1653591379822,MATH 200A,A00,087414,Salehi Golsefidy; Alireza,7,0,8,1
1653591380360,MATH 202A,A00,087415,Gill; Philip E.,2,0,8,6
1653591380887,MATH 203A,A00,087416,Oprea; Dragos N.,6,0,8,2
1653591381438,MATH 204A,A00,087417,Kedlaya; Kiran S.,6,0,8,2
1653591381985,MATH 205,A00,087418,Sorensen; Claus M,6,0,8,2
1653591382514,MATH 206A,A00,087419,Izadi; Elham,7,0,8,1
1653591383050,MATH 207A,A00,087420,Mohammadi; Amir,5,0,8,3
1653591383583,MATH 208,A00,087421,Staff,9,0,10,1
1653591384128,MATH 209,A00,087422,Staff,10,0,10,0
1653591384654,MATH 218,A00,087423,Staff,10,0,10,0
1653591385178,MATH 220A,A00,087424,Novak; Jonathan I,6,0,8,2
1653591385724,MATH 231A,A00,087425,Bejenaru; Ioan,3,0,8,5
1653591386270,MATH 240A,A00,087426,Ebenfelt; Peter F,5,0,8,3
1653591386791,MATH 243,A00,087427,Staff,9,0,10,1
1653591387324,MATH 248,A00,087429,Staff,10,0,10,0
1653591387850,MATH 250A,A00,087430,Spolaor; Luca,4,0,8,4
1653591388379,MATH 257A,A00,087431,Spolaor; Luca,7,0,8,1
1653591388935,MATH 258,A00,087432,Staff,9,0,10,1
1653591389470,MATH 264A,A00,087433,Warnke; Lutz Peter,5,0,8,3
1653591390018,MATH 268,A00,087434,Staff,15,0,15,0
1653591390567,MATH 269,A00,087435,Staff,14,0,15,1
1653591391116,MATH 270A,A00,087436,Nie; Jiawang,0,0,8,8
1653591391657,MATH 272A,A00,087437,Tian; Xiaochuan,0,0,8,8
1653591392190,MATH 274,A01,087439,Cheng; Li-Tien,9,0,10,1
1653591392190,MATH 274,A02,087440,Cheng; Li-Tien,10,0,10,0
1653591392724,MATH 278A,A00,087441,Staff,8,0,10,2
1653591393245,MATH 278B,A00,087442,Staff,8,0,10,2
1653591393768,MATH 278C,A00,087443,Staff,8,0,10,2
1653591394392,MATH 280A,A00,087444,Zheng; Tianyi,0,0,8,8
1653591394933,MATH 281A,A00,087445,Bradic; Jelena,0,0,8,8
1653591395456,MATH 282A,A00,087446,Zhang; Danna,0,0,8,8
1653591395982,MATH 283,A00,087447,Tesler; Glenn,0,0,0,16
1653591396534,MATH 286,B00,095535,Kemp; Todd Aahron,8,0,8,0
1653591397075,MATH 287D,B00,095536,Bradic; Jelena,6,0,8,2
1653591397621,MATH 288,A00,087450,Staff,14,0,15,1
1653591397621,MATH 288,B00,087451,Staff,15,0,15,0
1653591397621,MATH 288,C00,087452,Staff,15,0,15,0
1653591398149,MATH 290A,A00,087453,Xu; Zhouli,6,0,8,2
1653591398686,MATH 291A,A00,087454,Xu; Zhouli,7,0,8,1
1653591399224,MATH 292,A00,087455,Staff,10,0,10,0
1653591399761,MATH 295,A00,087456,Staff,50,0,50,0
1653591400286,MATH 297,001,087457,Staff,997,0,999,2
1653591970449,COGS 200,A01,087991,Staff,47,0,50,3
1653591970977,COGS 201,A01,094504,Rangel; Lara M,16,0,25,9
1653591971507,COGS 203,A00,087992,Coulson; Seana M,18,0,20,2
1653591972050,COGS 210A,001,087993,Greene; Deanna Jacquelyn,9998,0,9999,1
1653591972050,COGS 210A,002,087994,Saygin; Ayse P,9999,0,9999,0
1653591972050,COGS 210A,003,087995,Xia; Haijun,9999,0,9999,0
1653591972050,COGS 210A,004,087996,Nitz; Douglas A.,9999,0,9999,0
1653591972050,COGS 210A,005,087997,Hollan; James D.,9999,0,9999,0
1653591972050,COGS 210A,006,087998,Deak; Gedeon O.,9998,0,9999,1
1653591972050,COGS 210A,007,087999,Rossano; Federico,9999,0,9999,0
1653591972595,COGS 211A,A00,088000,Coulson; Seana M,9997,0,9999,2
1653591973120,COGS 229,A00,088002,Staff,22,0,25,3
1653591973669,COGS 260,B00,094231,Staff,17,0,20,3
1653591973669,COGS 260,A00,088004,Nitz; Douglas A.,9998,0,9999,1
1653591974222,CSE 202,A00,090110,Paturi; Ramamohan,0,0,0,0
1653591974222,CSE 202,B00,090111,Paturi; Ramamohan,0,0,0,0
1653591974745,CSE 207B,A00,090112,Heninger; Nadia A,0,0,0,0
1653591975267,CSE 208,A00,094858,Micciancio; Daniele,0,0,0,0
1653591975794,CSE 210,A00,090113,Powell; Thomas Allan,0,0,0,0
1653591976340,CSE 219,A00,090898,Staff,0,0,0,0
1653591976870,CSE 221,A00,090114,Zhou; Yuan-Yuan,0,0,0,0
1653591977423,CSE 229A,A00,090115,Porter; George M,0,0,0,0
1653591977957,CSE 229C,A00,090116,Savage; Stefan,0,0,0,0
1653591978503,CSE 230,A00,090117,Jhala; Ranjit,0,0,0,0
1653591979029,CSE 232,A00,090118,Papakonstantinou; Yannis,0,0,0,0
1653591979561,CSE 239A,A00,090121,Kumar; Arun Kumar,0,0,0,0
1653591980085,CSE 239B,A00,090122,Jhala; Ranjit,0,0,0,0
1653591980635,CSE 240A,A00,090123,Zhao; Jishen,1,0,189,188
1653591981169,CSE 243A,A00,090124,Orailoglu; Alex,0,0,15,15
1653591981706,CSE 249B,A00,090125,Kahng; Andrew Byun,12,0,20,8
1653591982249,CSE 250A,A00,090126,Berg-Kirkpatrick; Taylor D,0,0,0,0
1653591982780,CSE 252A,A00,090127,Ochoa; Benjamin Lawrence,0,0,0,0
1653591983322,CSE 258,A01,090129,McAuley; Julian John,0,0,0,0
1653591983853,CSE 258R,A01,090131,McAuley; Julian John,0,0,0,0
1653591984383,CSE 274,A00,090132,Ramamoorthi; Ravi,0,0,0,0
1653591984937,CSE 276A,A00,090133,Christensen; Henrik I,0,0,0,0
1653591985495,CSE 276C,A00,090134,Christensen; Henrik I,0,0,0,0
1653591986028,CSE 290,A00,090135,Bafna; Vineet,0,0,0,0
1653591986028,CSE 290,B00,090136,Ramamoorthi; Ravi,0,0,0,0
1653591986028,CSE 290,C00,090137,Li; Tzumao,7,0,10,3
1653591986028,CSE 290,D00,090138,Zhou; Yuan-Yuan,9,0,10,1
1653591986028,CSE 290,E00,090139,Christensen; Henrik I,8,0,10,2
1653591986028,CSE 290,F00,094053,Shalev; Aaron D,0,0,0,0
1653591986550,CSE 291,A00,090140,Munyaka; Imani N. S.,0,0,0,0
1653591986550,CSE 291,B00,094880,Yu; Qi,0,0,0,0
1653591986550,CSE 291,C00,090142,Pannuto; Patrick William,0,0,0,0
1653591986550,CSE 291,D00,094881,Zhang; Yiying,0,0,0,0
1653591986550,CSE 291,E00,095118,Su; Hao,0,0,0,0
1653591987081,CSE 293,001,094905,Bafna; Vineet,9999,0,9999,0
1653591987081,CSE 293,002,094906,Bellare; Mihir,9999,0,9999,0
1653591987081,CSE 293,003,094907,Berg-Kirkpatrick; Taylor D,9999,0,9999,0
1653591987081,CSE 293,004,094908,Christensen; Henrik I,9999,0,9999,0
1653591987081,CSE 293,005,094909,Cottrell; Garrison W,9999,0,9999,0
1653591987081,CSE 293,006,094910,Deutsch; Alin Bernard,9999,0,9999,0
1653591987081,CSE 293,007,094911,Esmaeilzadeh; Hadi,9999,0,9999,0
1653591987081,CSE 293,008,094912,Freund; Yoav,9999,0,9999,0
1653591987081,CSE 293,009,094913,Griswold; William G.,9999,0,9999,0
1653591987081,CSE 293,010,094914,Gymrek; Melissa Ann,9999,0,9999,0
1653591987081,CSE 293,011,094915,Heninger; Nadia A,9999,0,9999,0
1653591987081,CSE 293,012,094916,Impagliazzo; Russell,9999,0,9999,0
1653591987081,CSE 293,013,094917,Jhala; Ranjit,9999,0,9999,0
1653591987081,CSE 293,014,094918,Kahng; Andrew Byun,9999,0,9999,0
1653591987081,CSE 293,015,094919,Kane; Daniel Mertz,9999,0,9999,0
1653591987081,CSE 293,016,094920,Kriegman; David J,9999,0,9999,0
1653591987081,CSE 293,017,094921,Kumar; Arun Kumar,9999,0,9999,0
1653591987081,CSE 293,018,094922,Lerner; Sorin,9999,0,9999,0
1653591987081,CSE 293,019,094923,Lovett; Shachar,9999,0,9999,0
1653591987081,CSE 293,020,094924,McAuley; Julian John,9999,0,9999,0
1653591987081,CSE 293,021,094925,Micciancio; Daniele,9999,0,9999,0
1653591987081,CSE 293,022,094926,Orailoglu; Alex,9999,0,9999,0
1653591987081,CSE 293,023,094927,Paturi; Ramamohan,9999,0,9999,0
1653591987081,CSE 293,024,094928,Polikarpova; Nadezhda,9999,0,9999,0
1653591987081,CSE 293,025,094929,Politz; Joseph Gibbs,9999,0,9999,0
1653591987081,CSE 293,026,094930,Porter; George M,9999,0,9999,0
1653591987081,CSE 293,027,094931,Porter; Leonard Emerson,9999,0,9999,0
1653591987081,CSE 293,028,094932,Ramamoorthi; Ravi,9999,0,9999,0
1653591987081,CSE 293,029,094933,Sahoo; Debashis,9999,0,9999,0
1653591987081,CSE 293,030,094934,Saul; Lawrence,9999,0,9999,0
1653591987081,CSE 293,031,094935,Savage; Stefan,9999,0,9999,0
1653591987081,CSE 293,032,094936,Schulze; Jurgen P.,9999,0,9999,0
1653591987081,CSE 293,033,094937,Snoeren; Alex C.,9999,0,9999,0
1653591987081,CSE 293,034,094938,Shang; Jingbo,9999,0,9999,0
1653591987081,CSE 293,035,094939,Stefan; Deian,9999,0,9999,0
1653591987081,CSE 293,036,094940,Su; Hao,9999,0,9999,0
1653591987081,CSE 293,037,094941,Swanson; Steven James,9999,0,9999,0
1653591987081,CSE 293,038,094942,Tullsen; Dean Michael,9999,0,9999,0
1653591987081,CSE 293,039,094943,Voelker; Geoffrey M.,9999,0,9999,0
1653591987081,CSE 293,040,094944,Zhao; Jishen,9999,0,9999,0
1653591987081,CSE 293,041,094945,Zhou; Yuan-Yuan,9999,0,9999,0
1653591987081,CSE 293,042,094946,Gao; Sicun,9998,0,9999,1
1653591987081,CSE 293,043,094947,Weibel; Nadir,9999,0,9999,0
1653591987081,CSE 293,044,094948,Gupta; Rajesh K.,9999,0,9999,0
1653591987613,CSE 294,A00,090143,Porter; George M,8,0,10,2
1653591988163,DSE 200,A00,091799,Staff,50,0,50,0
1653591988696,DSE 203,A00,091800,Gupta; Amarnath,30,0,30,0
1653591989248,DSE 250,A00,091801,Deutsch; Alin Bernard,30,0,30,0
1653591989770,DSE 290,A00,091802,Altintas De Callaf; Ilkay,50,0,50,0
1653591990358,ECE 200,001,091003,Antipa; Nicholas A,9999,0,9999,0
1653591990358,ECE 200,002,091004,Atanasov; Nikolay A.,9999,0,9999,0
1653591990358,ECE 200,003,091005,Bharadia; Dinesh,9999,0,9999,0
1653591990358,ECE 200,004,091006,Cheng; Chung Kuan,9999,0,9999,0
1653591990358,ECE 200,005,091007,Cosman; Pamela C.,9999,0,9999,0
1653591990358,ECE 200,006,091008,Staff,9999,0,9999,0
1653591990358,ECE 200,007,091009,Dayeh; Shadi Ahmad,9999,0,9999,0
1653591990358,ECE 200,008,091010,Fainman; Yeshaiahu,9999,0,9999,0
1653591990358,ECE 200,009,091011,Ford; Joseph Earl,9999,0,9999,0
1653591990358,ECE 200,010,091012,Franceschetti; Massimo,9999,0,9999,0
1653591990358,ECE 200,011,091013,Fullerton; Eric E,9999,0,9999,0
1653591990358,ECE 200,012,091014,Galton; Ian A,9999,0,9999,0
1653591990358,ECE 200,013,091015,Gilja; Vikash,9999,0,9999,0
1653591990358,ECE 200,014,091016,Hall; Drew A.,9999,0,9999,0
1653591990358,ECE 200,015,091017,Hsueh; Tzu-Chien,9999,0,9999,0
1653591990358,ECE 200,016,091018,Javidi; Tara,9999,0,9999,0
1653591990358,ECE 200,017,091019,Kahng; Andrew Byun,9999,0,9999,0
1653591990358,ECE 200,018,091020,Kim; Young-Han,9999,0,9999,0
1653591990358,ECE 200,019,091021,Koushanfar; Farinaz,9999,0,9999,0
1653591990358,ECE 200,020,091022,Kuzum; Duygu,9999,0,9999,0
1653591990358,ECE 200,021,091023,Le; Hanh-Phuc,9999,0,9999,0
1653591990358,ECE 200,022,091024,Lin; Bill,9999,0,9999,0
1653591990358,ECE 200,023,091025,Liu; Zhaowei,9999,0,9999,0
1653591990358,ECE 200,024,091026,Lo; Yu-Hwa,9999,0,9999,0
1653591990358,ECE 200,025,091027,Lomakin; Vitaliy,9999,0,9999,0
1653591990358,ECE 200,026,091028,Mercier; Patrick Philip,9999,0,9999,0
1653591990358,ECE 200,027,091029,Meyer; Florian,9999,0,9999,0
1653591990358,ECE 200,028,091030,Milstein; Laurence B.,9999,0,9999,0
1653591990358,ECE 200,029,091031,Mir Arabbaygi; Siavash,9999,0,9999,0
1653591990358,ECE 200,030,091032,Mookherjea; Shayan,9999,0,9999,0
1653591990358,ECE 200,031,091033,Morris; Karcher William,9999,0,9999,0
1653591990358,ECE 200,032,091034,Ng; Tse Nga,9999,0,9999,0
1653591990358,ECE 200,033,091035,Nguyen; Truong Quang,9999,0,9999,0
1653591990358,ECE 200,034,091036,Nomura; Kenji,9999,0,9999,0
1653591990358,ECE 200,035,091037,Orlitsky; Alon,9999,0,9999,0
1653591990358,ECE 200,036,091038,Pal; Piya,9999,0,9999,0
1653591990358,ECE 200,037,091039,Papen; George C.,9999,0,9999,0
1653591990358,ECE 200,038,091040,Radic; Stojan,9999,0,9999,0
1653591990358,ECE 200,039,091041,Rao; Bhaskar D.,9999,0,9999,0
1653591990358,ECE 200,040,091042,Rao; Ramesh R,9999,0,9999,0
1653591990358,ECE 200,041,091043,Rebeiz; Gabriel,9999,0,9999,0
1653591990358,ECE 200,042,091044,Sanford; John R,9999,0,9999,0
1653591990358,ECE 200,043,091045,Siegel; Paul H.,9999,0,9999,0
1653591990358,ECE 200,044,091046,Sievenpiper; Daniel F.,9999,0,9999,0
1653591990358,ECE 200,045,091047,Sworder; David D.,9999,0,9999,0
1653591990358,ECE 200,046,091048,Taur; Yuan,9999,0,9999,0
1653591990358,ECE 200,047,091049,Touri; Behrouz,9999,0,9999,0
1653591990358,ECE 200,048,091050,Trivedi; Mohan M.,9999,0,9999,0
1653591990358,ECE 200,049,091051,Vardy; Alexander,9999,0,9999,0
1653591990358,ECE 200,050,091052,Vasconcelos; Nuno,9999,0,9999,0
1653591990358,ECE 200,051,091053,Wang; Xiaolong,9999,0,9999,0
1653591990358,ECE 200,052,091054,Xie; Pengtao,9999,0,9999,0
1653591990358,ECE 200,053,091055,Yip; Michael,9999,0,9999,0
1653591990358,ECE 200,054,091056,Zeger; Kenneth A.,9999,0,9999,0
1653591990358,ECE 200,055,091057,Zhang; Xinyu,9999,0,9999,0
1653591990358,ECE 200,056,091058,Turakhia; Yatish Girish,9999,0,9999,0
1653591990358,ECE 200,057,091059,Kang; Mingu,9999,0,9999,0
1653591990358,ECE 200,058,091060,Shi; Yuanyuan,9999,0,9999,0
1653591990358,ECE 200,059,091061,Wang; Edward Jay,9999,0,9999,0
1653591990358,ECE 200,060,091062,Zheng; Yang,9999,0,9999,0
1653591990895,ECE 201,A00,095526,Lo; Yu-Hwa,0,0,0,0
1653591991429,ECE 203,A00,091065,Mercier; Patrick Philip,0,0,0,0
1653591991954,ECE 207A,A00,091605,Liu; Thomas Tao-Ming,0,0,0,0
1653591992616,ECE 212AN,A00,091068,Nomura; Kenji,0,0,0,0
1653591993162,ECE 222A,A00,091069,Rebeiz; Gabriel,0,0,0,0
1653591993721,ECE 225A,A00,091070,Orlitsky; Alon,0,0,0,0
1653591994247,ECE 230A,A00,091071,Nomura; Kenji,0,0,0,0
1653591994772,ECE 236A,A00,091072,Dayeh; Shadi Ahmad,0,0,0,0
1653591995295,ECE 238A,A00,091073,Luo; Jian,0,0,0,0
1653591995295,ECE 238A,B00,091074,Luo; Jian,0,0,0,0
1653591995835,ECE 240A,A00,091075,Radic; Stojan,0,0,0,0
1653591996376,ECE 247A,A00,091592,Shi; Lingyan,0,0,0,0
1653591996907,ECE 250,A00,091076,Touri; Behrouz,0,0,0,0
1653591997459,ECE 251C,A00,091078,Nguyen; Truong Quang,0,0,0,0
1653591997996,ECE 253,A00,091079,Cosman; Pamela C.,0,0,0,0
1653591998533,ECE 255A,A00,091080,Orlitsky; Alon,0,0,0,0
1653591999068,ECE 257A,A00,091081,Zhang; Xinyu,0,0,0,0
1653591999604,ECE 260A,A01,091084,Eldon; John,0,0,0,0
1653592000128,ECE 264C,A00,091085,Galton; Ian A,0,0,0,0
1653592000667,ECE 265C,A00,094889,Presti; Calogero Davide,0,0,0,9
1653592001191,ECE 266,A01,091087,Hall; Drew A.,0,0,0,0
1653592002269,ECE 271A,A00,091090,Vasconcelos; Nuno,0,0,0,0
1653592002800,ECE 272B,A00,091091,Sworder; David D.,0,0,0,0
1653592003322,ECE 275A,A00,091092,Meyer; Florian,0,0,0,0
1653592003849,ECE 277,A00,091093,An; Cheolhong,0,0,0,0
1653592004387,ECE 283,A00,091094,Le; Hanh-Phuc,0,0,0,0
1653592004931,ECE 284,A00,091095,Kang; Mingu,0,0,0,0
1653592004931,ECE 284,B00,091096,Wang; Edward Jay,0,0,0,0
1653592005474,ECE 285,A00,094334,Touri; Behrouz,0,0,0,0
1653592006017,ECE 289,A00,091097,Whelan; David Arthur,0,0,0,0
1653592006555,MATH 200A,A00,087414,Salehi Golsefidy; Alireza,7,0,8,1
1653592007094,MATH 202A,A00,087415,Gill; Philip E.,2,0,8,6
1653592007627,MATH 203A,A00,087416,Oprea; Dragos N.,6,0,8,2
1653592008159,MATH 204A,A00,087417,Kedlaya; Kiran S.,6,0,8,2
1653592008713,MATH 205,A00,087418,Sorensen; Claus M,6,0,8,2
1653592009238,MATH 206A,A00,087419,Izadi; Elham,7,0,8,1
1653592009764,MATH 207A,A00,087420,Mohammadi; Amir,5,0,8,3
1653592010303,MATH 208,A00,087421,Staff,9,0,10,1
1653592010841,MATH 209,A00,087422,Staff,10,0,10,0
1653592011384,MATH 218,A00,087423,Staff,10,0,10,0
1653592011924,MATH 220A,A00,087424,Novak; Jonathan I,6,0,8,2
1653592012473,MATH 231A,A00,087425,Bejenaru; Ioan,3,0,8,5
1653592012998,MATH 240A,A00,087426,Ebenfelt; Peter F,5,0,8,3
1653592013533,MATH 243,A00,087427,Staff,9,0,10,1
1653592014092,MATH 248,A00,087429,Staff,10,0,10,0
1653592014640,MATH 250A,A00,087430,Spolaor; Luca,4,0,8,4
1653592015165,MATH 257A,A00,087431,Spolaor; Luca,7,0,8,1
1653592015698,MATH 258,A00,087432,Staff,9,0,10,1
1653592016249,MATH 264A,A00,087433,Warnke; Lutz Peter,5,0,8,3
1653592016782,MATH 268,A00,087434,Staff,15,0,15,0
1653592017316,MATH 269,A00,087435,Staff,14,0,15,1
1653592017844,MATH 270A,A00,087436,Nie; Jiawang,0,0,8,8
1653592018367,MATH 272A,A00,087437,Tian; Xiaochuan,0,0,8,8
1653592018911,MATH 274,A01,087439,Cheng; Li-Tien,9,0,10,1
1653592018911,MATH 274,A02,087440,Cheng; Li-Tien,10,0,10,0
1653592019438,MATH 278A,A00,087441,Staff,8,0,10,2
1653592019976,MATH 278B,A00,087442,Staff,8,0,10,2
1653592020512,MATH 278C,A00,087443,Staff,8,0,10,2
1653592021054,MATH 280A,A00,087444,Zheng; Tianyi,0,0,8,8
1653592021588,MATH 281A,A00,087445,Bradic; Jelena,0,0,8,8
1653592022132,MATH 282A,A00,087446,Zhang; Danna,0,0,8,8
1653592022659,MATH 283,A00,087447,Tesler; Glenn,0,0,0,16
1653592023180,MATH 286,B00,095535,Kemp; Todd Aahron,8,0,8,0
1653592023728,MATH 287D,B00,095536,Bradic; Jelena,5,0,8,3
1653592024272,MATH 288,A00,087450,Staff,14,0,15,1
1653592024272,MATH 288,B00,087451,Staff,15,0,15,0
1653592024272,MATH 288,C00,087452,Staff,15,0,15,0
1653592024804,MATH 290A,A00,087453,Xu; Zhouli,6,0,8,2
1653592025348,MATH 291A,A00,087454,Xu; Zhouli,7,0,8,1
1653592025874,MATH 292,A00,087455,Staff,10,0,10,0
1653592026398,MATH 295,A00,087456,Staff,50,0,50,0
1653592026951,MATH 297,001,087457,Staff,997,0,999,2
1653592597670,COGS 200,A01,087991,Staff,47,0,50,3
1653592598218,COGS 201,A01,094504,Rangel; Lara M,16,0,25,9
1653592598744,COGS 203,A00,087992,Coulson; Seana M,18,0,20,2
1653592599283,COGS 210A,001,087993,Greene; Deanna Jacquelyn,9998,0,9999,1
1653592599283,COGS 210A,002,087994,Saygin; Ayse P,9999,0,9999,0
1653592599283,COGS 210A,003,087995,Xia; Haijun,9999,0,9999,0
1653592599283,COGS 210A,004,087996,Nitz; Douglas A.,9999,0,9999,0
1653592599283,COGS 210A,005,087997,Hollan; James D.,9999,0,9999,0
1653592599283,COGS 210A,006,087998,Deak; Gedeon O.,9998,0,9999,1
1653592599283,COGS 210A,007,087999,Rossano; Federico,9999,0,9999,0
1653592599810,COGS 211A,A00,088000,Coulson; Seana M,9997,0,9999,2
1653592600349,COGS 229,A00,088002,Staff,22,0,25,3
1653592600879,COGS 260,B00,094231,Staff,17,0,20,3
1653592600879,COGS 260,A00,088004,Nitz; Douglas A.,9998,0,9999,1
1653592601415,CSE 202,A00,090110,Paturi; Ramamohan,0,0,0,0
1653592601415,CSE 202,B00,090111,Paturi; Ramamohan,0,0,0,0
1653592601947,CSE 207B,A00,090112,Heninger; Nadia A,0,0,0,0
1653592602482,CSE 208,A00,094858,Micciancio; Daniele,0,0,0,0
1653592603017,CSE 210,A00,090113,Powell; Thomas Allan,0,0,0,0
1653592603555,CSE 219,A00,090898,Staff,0,0,0,0
1653592604078,CSE 221,A00,090114,Zhou; Yuan-Yuan,0,0,0,0
1653592604601,CSE 229A,A00,090115,Porter; George M,0,0,0,0
1653592605138,CSE 229C,A00,090116,Savage; Stefan,0,0,0,0
1653592605677,CSE 230,A00,090117,Jhala; Ranjit,0,0,0,0
1653592606225,CSE 232,A00,090118,Papakonstantinou; Yannis,0,0,0,0
1653592606749,CSE 239A,A00,090121,Kumar; Arun Kumar,0,0,0,0
1653592607283,CSE 239B,A00,090122,Jhala; Ranjit,0,0,0,0
1653592607835,CSE 240A,A00,090123,Zhao; Jishen,1,0,189,188
1653592608358,CSE 243A,A00,090124,Orailoglu; Alex,0,0,15,15
1653592608914,CSE 249B,A00,090125,Kahng; Andrew Byun,12,0,20,8
1653592609447,CSE 250A,A00,090126,Berg-Kirkpatrick; Taylor D,0,0,0,0
1653592609998,CSE 252A,A00,090127,Ochoa; Benjamin Lawrence,0,0,0,0
1653592610523,CSE 258,A01,090129,McAuley; Julian John,0,0,0,0
1653592611063,CSE 258R,A01,090131,McAuley; Julian John,0,0,0,0
1653592611601,CSE 274,A00,090132,Ramamoorthi; Ravi,0,0,0,0
1653592612123,CSE 276A,A00,090133,Christensen; Henrik I,0,0,0,0
1653592612646,CSE 276C,A00,090134,Christensen; Henrik I,0,0,0,0
1653592613189,CSE 290,A00,090135,Bafna; Vineet,0,0,0,0
1653592613189,CSE 290,B00,090136,Ramamoorthi; Ravi,0,0,0,0
1653592613189,CSE 290,C00,090137,Li; Tzumao,7,0,10,3
1653592613189,CSE 290,D00,090138,Zhou; Yuan-Yuan,9,0,10,1
1653592613189,CSE 290,E00,090139,Christensen; Henrik I,8,0,10,2
1653592613189,CSE 290,F00,094053,Shalev; Aaron D,0,0,0,0
1653592613719,CSE 291,A00,090140,Munyaka; Imani N. S.,0,0,0,0
1653592613719,CSE 291,B00,094880,Yu; Qi,0,0,0,0
1653592613719,CSE 291,C00,090142,Pannuto; Patrick William,0,0,0,0
1653592613719,CSE 291,D00,094881,Zhang; Yiying,0,0,0,0
1653592613719,CSE 291,E00,095118,Su; Hao,0,0,0,0
1653592614242,CSE 293,001,094905,Bafna; Vineet,9999,0,9999,0
1653592614242,CSE 293,002,094906,Bellare; Mihir,9999,0,9999,0
1653592614242,CSE 293,003,094907,Berg-Kirkpatrick; Taylor D,9999,0,9999,0
1653592614242,CSE 293,004,094908,Christensen; Henrik I,9999,0,9999,0
1653592614242,CSE 293,005,094909,Cottrell; Garrison W,9999,0,9999,0
1653592614242,CSE 293,006,094910,Deutsch; Alin Bernard,9999,0,9999,0
1653592614242,CSE 293,007,094911,Esmaeilzadeh; Hadi,9999,0,9999,0
1653592614242,CSE 293,008,094912,Freund; Yoav,9999,0,9999,0
1653592614242,CSE 293,009,094913,Griswold; William G.,9999,0,9999,0
1653592614242,CSE 293,010,094914,Gymrek; Melissa Ann,9999,0,9999,0
1653592614242,CSE 293,011,094915,Heninger; Nadia A,9999,0,9999,0
1653592614242,CSE 293,012,094916,Impagliazzo; Russell,9999,0,9999,0
1653592614242,CSE 293,013,094917,Jhala; Ranjit,9999,0,9999,0
1653592614242,CSE 293,014,094918,Kahng; Andrew Byun,9999,0,9999,0
1653592614242,CSE 293,015,094919,Kane; Daniel Mertz,9999,0,9999,0
1653592614242,CSE 293,016,094920,Kriegman; David J,9999,0,9999,0
1653592614242,CSE 293,017,094921,Kumar; Arun Kumar,9999,0,9999,0
1653592614242,CSE 293,018,094922,Lerner; Sorin,9999,0,9999,0
1653592614242,CSE 293,019,094923,Lovett; Shachar,9999,0,9999,0
1653592614242,CSE 293,020,094924,McAuley; Julian John,9999,0,9999,0
1653592614242,CSE 293,021,094925,Micciancio; Daniele,9999,0,9999,0
1653592614242,CSE 293,022,094926,Orailoglu; Alex,9999,0,9999,0
1653592614242,CSE 293,023,094927,Paturi; Ramamohan,9999,0,9999,0
1653592614242,CSE 293,024,094928,Polikarpova; Nadezhda,9999,0,9999,0
1653592614242,CSE 293,025,094929,Politz; Joseph Gibbs,9999,0,9999,0
1653592614242,CSE 293,026,094930,Porter; George M,9999,0,9999,0
1653592614242,CSE 293,027,094931,Porter; Leonard Emerson,9999,0,9999,0
1653592614242,CSE 293,028,094932,Ramamoorthi; Ravi,9999,0,9999,0
1653592614242,CSE 293,029,094933,Sahoo; Debashis,9999,0,9999,0
1653592614242,CSE 293,030,094934,Saul; Lawrence,9999,0,9999,0
1653592614242,CSE 293,031,094935,Savage; Stefan,9999,0,9999,0
1653592614242,CSE 293,032,094936,Schulze; Jurgen P.,9999,0,9999,0
1653592614242,CSE 293,033,094937,Snoeren; Alex C.,9999,0,9999,0
1653592614242,CSE 293,034,094938,Shang; Jingbo,9999,0,9999,0
1653592614242,CSE 293,035,094939,Stefan; Deian,9999,0,9999,0
1653592614242,CSE 293,036,094940,Su; Hao,9999,0,9999,0
1653592614242,CSE 293,037,094941,Swanson; Steven James,9999,0,9999,0
1653592614242,CSE 293,038,094942,Tullsen; Dean Michael,9999,0,9999,0
1653592614242,CSE 293,039,094943,Voelker; Geoffrey M.,9999,0,9999,0
1653592614242,CSE 293,040,094944,Zhao; Jishen,9999,0,9999,0
1653592614242,CSE 293,041,094945,Zhou; Yuan-Yuan,9999,0,9999,0
1653592614242,CSE 293,042,094946,Gao; Sicun,9998,0,9999,1
1653592614242,CSE 293,043,094947,Weibel; Nadir,9999,0,9999,0
1653592614242,CSE 293,044,094948,Gupta; Rajesh K.,9999,0,9999,0
1653592614789,CSE 294,A00,090143,Porter; George M,8,0,10,2
1653592615314,DSE 200,A00,091799,Staff,50,0,50,0
1653592615864,DSE 203,A00,091800,Gupta; Amarnath,30,0,30,0
1653592616403,DSE 250,A00,091801,Deutsch; Alin Bernard,30,0,30,0
1653592616947,DSE 290,A00,091802,Altintas De Callaf; Ilkay,50,0,50,0
1653592617505,ECE 200,001,091003,Antipa; Nicholas A,9999,0,9999,0
1653592617505,ECE 200,002,091004,Atanasov; Nikolay A.,9999,0,9999,0
1653592617505,ECE 200,003,091005,Bharadia; Dinesh,9999,0,9999,0
1653592617505,ECE 200,004,091006,Cheng; Chung Kuan,9999,0,9999,0
1653592617505,ECE 200,005,091007,Cosman; Pamela C.,9999,0,9999,0
1653592617505,ECE 200,006,091008,Staff,9999,0,9999,0
1653592617505,ECE 200,007,091009,Dayeh; Shadi Ahmad,9999,0,9999,0
1653592617505,ECE 200,008,091010,Fainman; Yeshaiahu,9999,0,9999,0
1653592617505,ECE 200,009,091011,Ford; Joseph Earl,9999,0,9999,0
1653592617505,ECE 200,010,091012,Franceschetti; Massimo,9999,0,9999,0
1653592617505,ECE 200,011,091013,Fullerton; Eric E,9999,0,9999,0
1653592617505,ECE 200,012,091014,Galton; Ian A,9999,0,9999,0
1653592617505,ECE 200,013,091015,Gilja; Vikash,9999,0,9999,0
1653592617505,ECE 200,014,091016,Hall; Drew A.,9999,0,9999,0
1653592617505,ECE 200,015,091017,Hsueh; Tzu-Chien,9999,0,9999,0
1653592617505,ECE 200,016,091018,Javidi; Tara,9999,0,9999,0
1653592617505,ECE 200,017,091019,Kahng; Andrew Byun,9999,0,9999,0
1653592617505,ECE 200,018,091020,Kim; Young-Han,9999,0,9999,0
1653592617505,ECE 200,019,091021,Koushanfar; Farinaz,9999,0,9999,0
1653592617505,ECE 200,020,091022,Kuzum; Duygu,9999,0,9999,0
1653592617505,ECE 200,021,091023,Le; Hanh-Phuc,9999,0,9999,0
1653592617505,ECE 200,022,091024,Lin; Bill,9999,0,9999,0
1653592617505,ECE 200,023,091025,Liu; Zhaowei,9999,0,9999,0
1653592617505,ECE 200,024,091026,Lo; Yu-Hwa,9999,0,9999,0
1653592617505,ECE 200,025,091027,Lomakin; Vitaliy,9999,0,9999,0
1653592617505,ECE 200,026,091028,Mercier; Patrick Philip,9999,0,9999,0
1653592617505,ECE 200,027,091029,Meyer; Florian,9999,0,9999,0
1653592617505,ECE 200,028,091030,Milstein; Laurence B.,9999,0,9999,0
1653592617505,ECE 200,029,091031,Mir Arabbaygi; Siavash,9999,0,9999,0
1653592617505,ECE 200,030,091032,Mookherjea; Shayan,9999,0,9999,0
1653592617505,ECE 200,031,091033,Morris; Karcher William,9999,0,9999,0
1653592617505,ECE 200,032,091034,Ng; Tse Nga,9999,0,9999,0
1653592617505,ECE 200,033,091035,Nguyen; Truong Quang,9999,0,9999,0
1653592617505,ECE 200,034,091036,Nomura; Kenji,9999,0,9999,0
1653592617505,ECE 200,035,091037,Orlitsky; Alon,9999,0,9999,0
1653592617505,ECE 200,036,091038,Pal; Piya,9999,0,9999,0
1653592617505,ECE 200,037,091039,Papen; George C.,9999,0,9999,0
1653592617505,ECE 200,038,091040,Radic; Stojan,9999,0,9999,0
1653592617505,ECE 200,039,091041,Rao; Bhaskar D.,9999,0,9999,0
1653592617505,ECE 200,040,091042,Rao; Ramesh R,9999,0,9999,0
1653592617505,ECE 200,041,091043,Rebeiz; Gabriel,9999,0,9999,0
1653592617505,ECE 200,042,091044,Sanford; John R,9999,0,9999,0
1653592617505,ECE 200,043,091045,Siegel; Paul H.,9999,0,9999,0
1653592617505,ECE 200,044,091046,Sievenpiper; Daniel F.,9999,0,9999,0
1653592617505,ECE 200,045,091047,Sworder; David D.,9999,0,9999,0
1653592617505,ECE 200,046,091048,Taur; Yuan,9999,0,9999,0
1653592617505,ECE 200,047,091049,Touri; Behrouz,9999,0,9999,0
1653592617505,ECE 200,048,091050,Trivedi; Mohan M.,9999,0,9999,0
1653592617505,ECE 200,049,091051,Vardy; Alexander,9999,0,9999,0
1653592617505,ECE 200,050,091052,Vasconcelos; Nuno,9999,0,9999,0
1653592617505,ECE 200,051,091053,Wang; Xiaolong,9999,0,9999,0
1653592617505,ECE 200,052,091054,Xie; Pengtao,9999,0,9999,0
1653592617505,ECE 200,053,091055,Yip; Michael,9999,0,9999,0
1653592617505,ECE 200,054,091056,Zeger; Kenneth A.,9999,0,9999,0
1653592617505,ECE 200,055,091057,Zhang; Xinyu,9999,0,9999,0
1653592617505,ECE 200,056,091058,Turakhia; Yatish Girish,9999,0,9999,0
1653592617505,ECE 200,057,091059,Kang; Mingu,9999,0,9999,0
1653592617505,ECE 200,058,091060,Shi; Yuanyuan,9999,0,9999,0
1653592617505,ECE 200,059,091061,Wang; Edward Jay,9999,0,9999,0
1653592617505,ECE 200,060,091062,Zheng; Yang,9999,0,9999,0
1653592618055,ECE 201,A00,095526,Lo; Yu-Hwa,0,0,0,0
1653592618590,ECE 203,A00,091065,Mercier; Patrick Philip,0,0,0,0
1653592619137,ECE 207A,A00,091605,Liu; Thomas Tao-Ming,0,0,0,0
1653592619669,ECE 212AN,A00,091068,Nomura; Kenji,0,0,0,0
1653592620195,ECE 222A,A00,091069,Rebeiz; Gabriel,0,0,0,0
1653592620720,ECE 225A,A00,091070,Orlitsky; Alon,0,0,0,0
1653592621258,ECE 230A,A00,091071,Nomura; Kenji,0,0,0,0
1653592621781,ECE 236A,A00,091072,Dayeh; Shadi Ahmad,0,0,0,0
1653592622307,ECE 238A,A00,091073,Luo; Jian,0,0,0,0
1653592622307,ECE 238A,B00,091074,Luo; Jian,0,0,0,0
1653592622843,ECE 240A,A00,091075,Radic; Stojan,0,0,0,0
1653592623368,ECE 247A,A00,091592,Shi; Lingyan,0,0,0,0
1653592623911,ECE 250,A00,091076,Touri; Behrouz,0,0,0,0
1653592624456,ECE 251C,A00,091078,Nguyen; Truong Quang,0,0,0,0
1653592625004,ECE 253,A00,091079,Cosman; Pamela C.,0,0,0,0
1653592625546,ECE 255A,A00,091080,Orlitsky; Alon,0,0,0,0
1653592626104,ECE 257A,A00,091081,Zhang; Xinyu,0,0,0,0
1653592626641,ECE 260A,A01,091084,Eldon; John,0,0,0,0
1653592627165,ECE 264C,A00,091085,Galton; Ian A,0,0,0,0
1653592627698,ECE 265C,A00,094889,Presti; Calogero Davide,0,0,0,9
1653592628220,ECE 266,A01,091087,Hall; Drew A.,0,0,0,0
1653592629275,ECE 271A,A00,091090,Vasconcelos; Nuno,0,0,0,0
1653592629798,ECE 272B,A00,091091,Sworder; David D.,0,0,0,0
1653592630340,ECE 275A,A00,091092,Meyer; Florian,0,0,0,0
1653592630866,ECE 277,A00,091093,An; Cheolhong,0,0,0,0
1653592631415,ECE 283,A00,091094,Le; Hanh-Phuc,0,0,0,0
1653592631958,ECE 284,A00,091095,Kang; Mingu,0,0,0,0
1653592631958,ECE 284,B00,091096,Wang; Edward Jay,0,0,0,0
1653592632482,ECE 285,A00,094334,Touri; Behrouz,0,0,0,0
1653592633034,ECE 289,A00,091097,Whelan; David Arthur,0,0,0,0
1653592633559,MATH 200A,A00,087414,Salehi Golsefidy; Alireza,7,0,8,1
1653592634083,MATH 202A,A00,087415,Gill; Philip E.,2,0,8,6
1653592634619,MATH 203A,A00,087416,Oprea; Dragos N.,6,0,8,2
1653592635170,MATH 204A,A00,087417,Kedlaya; Kiran S.,6,0,8,2
1653592635722,MATH 205,A00,087418,Sorensen; Claus M,6,0,8,2
1653592636276,MATH 206A,A00,087419,Izadi; Elham,7,0,8,1
1653592636799,MATH 207A,A00,087420,Mohammadi; Amir,5,0,8,3
1653592637349,MATH 208,A00,087421,Staff,9,0,10,1
1653592637871,MATH 209,A00,087422,Staff,10,0,10,0
1653592638409,MATH 218,A00,087423,Staff,10,0,10,0
1653592638939,MATH 220A,A00,087424,Novak; Jonathan I,6,0,8,2
1653592639472,MATH 231A,A00,087425,Bejenaru; Ioan,3,0,8,5
1653592640009,MATH 240A,A00,087426,Ebenfelt; Peter F,5,0,8,3
1653592640556,MATH 243,A00,087427,Staff,9,0,10,1
1653592641087,MATH 248,A00,087429,Staff,10,0,10,0
1653592641626,MATH 250A,A00,087430,Spolaor; Luca,4,0,8,4
1653592642152,MATH 257A,A00,087431,Spolaor; Luca,7,0,8,1
1653592642676,MATH 258,A00,087432,Staff,9,0,10,1
1653592643210,MATH 264A,A00,087433,Warnke; Lutz Peter,5,0,8,3
1653592643762,MATH 268,A00,087434,Staff,15,0,15,0
1653592644303,MATH 269,A00,087435,Staff,14,0,15,1
1653592644844,MATH 270A,A00,087436,Nie; Jiawang,0,0,8,8
1653592645513,MATH 272A,A00,087437,Tian; Xiaochuan,0,0,8,8
1653592646037,MATH 274,A01,087439,Cheng; Li-Tien,9,0,10,1
1653592646037,MATH 274,A02,087440,Cheng; Li-Tien,10,0,10,0
1653592646564,MATH 278A,A00,087441,Staff,8,0,10,2
1653592647100,MATH 278B,A00,087442,Staff,8,0,10,2
1653592647647,MATH 278C,A00,087443,Staff,8,0,10,2
1653592648177,MATH 280A,A00,087444,Zheng; Tianyi,0,0,8,8
1653592648729,MATH 281A,A00,087445,Bradic; Jelena,0,0,8,8
1653592649258,MATH 282A,A00,087446,Zhang; Danna,0,0,8,8
1653592649806,MATH 283,A00,087447,Tesler; Glenn,0,0,0,16
1653592650342,MATH 286,B00,095535,Kemp; Todd Aahron,8,0,8,0
1653592650868,MATH 287D,B00,095536,Bradic; Jelena,5,0,8,3
1653592651394,MATH 288,A00,087450,Staff,14,0,15,1
1653592651394,MATH 288,B00,087451,Staff,15,0,15,0
1653592651394,MATH 288,C00,087452,Staff,15,0,15,0
1653592651920,MATH 290A,A00,087453,Xu; Zhouli,6,0,8,2
1653592652470,MATH 291A,A00,087454,Xu; Zhouli,7,0,8,1
1653592653004,MATH 292,A00,087455,Staff,10,0,10,0
1653592653535,MATH 295,A00,087456,Staff,50,0,50,0
1653592654065,MATH 297,001,087457,Staff,997,0,999,2
1653593228417,COGS 200,A01,087991,Staff,47,0,50,3
1653593228952,COGS 201,A01,094504,Rangel; Lara M,16,0,25,9
1653593229475,COGS 203,A00,087992,Coulson; Seana M,18,0,20,2
1653593230010,COGS 210A,001,087993,Greene; Deanna Jacquelyn,9998,0,9999,1
1653593230010,COGS 210A,002,087994,Saygin; Ayse P,9999,0,9999,0
1653593230010,COGS 210A,003,087995,Xia; Haijun,9999,0,9999,0
1653593230010,COGS 210A,004,087996,Nitz; Douglas A.,9999,0,9999,0
1653593230010,COGS 210A,005,087997,Hollan; James D.,9999,0,9999,0
1653593230010,COGS 210A,006,087998,Deak; Gedeon O.,9998,0,9999,1
1653593230010,COGS 210A,007,087999,Rossano; Federico,9999,0,9999,0
1653593230548,COGS 211A,A00,088000,Coulson; Seana M,9997,0,9999,2
1653593231070,COGS 229,A00,088002,Staff,22,0,25,3
1653593231615,COGS 260,B00,094231,Staff,17,0,20,3
1653593231615,COGS 260,A00,088004,Nitz; Douglas A.,9998,0,9999,1
1653593232163,CSE 202,A00,090110,Paturi; Ramamohan,0,0,0,0
1653593232163,CSE 202,B00,090111,Paturi; Ramamohan,0,0,0,0
1653593232694,CSE 207B,A00,090112,Heninger; Nadia A,0,0,0,0
1653593233239,CSE 208,A00,094858,Micciancio; Daniele,0,0,0,0
1653593233763,CSE 210,A00,090113,Powell; Thomas Allan,0,0,0,0
1653593234313,CSE 219,A00,090898,Staff,0,0,0,0
1653593234840,CSE 221,A00,090114,Zhou; Yuan-Yuan,0,0,0,0
1653593235377,CSE 229A,A00,090115,Porter; George M,0,0,0,0
1653593235906,CSE 229C,A00,090116,Savage; Stefan,0,0,0,0
1653593236437,CSE 230,A00,090117,Jhala; Ranjit,0,0,0,0
1653593236980,CSE 232,A00,090118,Papakonstantinou; Yannis,0,0,0,0
1653593237534,CSE 239A,A00,090121,Kumar; Arun Kumar,0,0,0,0
1653593238081,CSE 239B,A00,090122,Jhala; Ranjit,0,0,0,0
1653593238634,CSE 240A,A00,090123,Zhao; Jishen,1,0,189,188
1653593239191,CSE 243A,A00,090124,Orailoglu; Alex,0,0,15,15
1653593239719,CSE 249B,A00,090125,Kahng; Andrew Byun,12,0,20,8
1653593240255,CSE 250A,A00,090126,Berg-Kirkpatrick; Taylor D,0,0,0,0
1653593240797,CSE 252A,A00,090127,Ochoa; Benjamin Lawrence,0,0,0,0
1653593241335,CSE 258,A01,090129,McAuley; Julian John,0,0,0,0
1653593241865,CSE 258R,A01,090131,McAuley; Julian John,0,0,0,0
1653593242389,CSE 274,A00,090132,Ramamoorthi; Ravi,0,0,0,0
1653593242916,CSE 276A,A00,090133,Christensen; Henrik I,0,0,0,0
1653593243462,CSE 276C,A00,090134,Christensen; Henrik I,0,0,0,0
1653593243994,CSE 290,A00,090135,Bafna; Vineet,0,0,0,0
1653593243994,CSE 290,B00,090136,Ramamoorthi; Ravi,0,0,0,0
1653593243994,CSE 290,C00,090137,Li; Tzumao,7,0,10,3
1653593243994,CSE 290,D00,090138,Zhou; Yuan-Yuan,9,0,10,1
1653593243994,CSE 290,E00,090139,Christensen; Henrik I,8,0,10,2
1653593243994,CSE 290,F00,094053,Shalev; Aaron D,0,0,0,0
1653593244542,CSE 291,A00,090140,Munyaka; Imani N. S.,0,0,0,0
1653593244542,CSE 291,B00,094880,Yu; Qi,0,0,0,0
1653593244542,CSE 291,C00,090142,Pannuto; Patrick William,0,0,0,0
1653593244542,CSE 291,D00,094881,Zhang; Yiying,0,0,0,0
1653593244542,CSE 291,E00,095118,Su; Hao,0,0,0,0
1653593245116,CSE 293,001,094905,Bafna; Vineet,9999,0,9999,0
1653593245116,CSE 293,002,094906,Bellare; Mihir,9999,0,9999,0
1653593245116,CSE 293,003,094907,Berg-Kirkpatrick; Taylor D,9999,0,9999,0
1653593245116,CSE 293,004,094908,Christensen; Henrik I,9999,0,9999,0
1653593245116,CSE 293,005,094909,Cottrell; Garrison W,9999,0,9999,0
1653593245116,CSE 293,006,094910,Deutsch; Alin Bernard,9999,0,9999,0
1653593245116,CSE 293,007,094911,Esmaeilzadeh; Hadi,9999,0,9999,0
1653593245116,CSE 293,008,094912,Freund; Yoav,9999,0,9999,0
1653593245116,CSE 293,009,094913,Griswold; William G.,9999,0,9999,0
1653593245116,CSE 293,010,094914,Gymrek; Melissa Ann,9999,0,9999,0
1653593245116,CSE 293,011,094915,Heninger; Nadia A,9999,0,9999,0
1653593245116,CSE 293,012,094916,Impagliazzo; Russell,9999,0,9999,0
1653593245116,CSE 293,013,094917,Jhala; Ranjit,9999,0,9999,0
1653593245116,CSE 293,014,094918,Kahng; Andrew Byun,9999,0,9999,0
1653593245116,CSE 293,015,094919,Kane; Daniel Mertz,9999,0,9999,0
1653593245116,CSE 293,016,094920,Kriegman; David J,9999,0,9999,0
1653593245116,CSE 293,017,094921,Kumar; Arun Kumar,9999,0,9999,0
1653593245116,CSE 293,018,094922,Lerner; Sorin,9999,0,9999,0
1653593245116,CSE 293,019,094923,Lovett; Shachar,9999,0,9999,0
1653593245116,CSE 293,020,094924,McAuley; Julian John,9999,0,9999,0
1653593245116,CSE 293,021,094925,Micciancio; Daniele,9999,0,9999,0
1653593245116,CSE 293,022,094926,Orailoglu; Alex,9999,0,9999,0
1653593245116,CSE 293,023,094927,Paturi; Ramamohan,9999,0,9999,0
1653593245116,CSE 293,024,094928,Polikarpova; Nadezhda,9999,0,9999,0
1653593245116,CSE 293,025,094929,Politz; Joseph Gibbs,9999,0,9999,0
1653593245116,CSE 293,026,094930,Porter; George M,9999,0,9999,0
1653593245116,CSE 293,027,094931,Porter; Leonard Emerson,9999,0,9999,0
1653593245116,CSE 293,028,094932,Ramamoorthi; Ravi,9999,0,9999,0
1653593245116,CSE 293,029,094933,Sahoo; Debashis,9999,0,9999,0
1653593245116,CSE 293,030,094934,Saul; Lawrence,9999,0,9999,0
1653593245116,CSE 293,031,094935,Savage; Stefan,9999,0,9999,0
1653593245116,CSE 293,032,094936,Schulze; Jurgen P.,9999,0,9999,0
1653593245116,CSE 293,033,094937,Snoeren; Alex C.,9999,0,9999,0
1653593245116,CSE 293,034,094938,Shang; Jingbo,9999,0,9999,0
1653593245116,CSE 293,035,094939,Stefan; Deian,9999,0,9999,0
1653593245116,CSE 293,036,094940,Su; Hao,9999,0,9999,0
1653593245116,CSE 293,037,094941,Swanson; Steven James,9999,0,9999,0
1653593245116,CSE 293,038,094942,Tullsen; Dean Michael,9999,0,9999,0
1653593245116,CSE 293,039,094943,Voelker; Geoffrey M.,9999,0,9999,0
1653593245116,CSE 293,040,094944,Zhao; Jishen,9999,0,9999,0
1653593245116,CSE 293,041,094945,Zhou; Yuan-Yuan,9999,0,9999,0
1653593245116,CSE 293,042,094946,Gao; Sicun,9998,0,9999,1
1653593245116,CSE 293,043,094947,Weibel; Nadir,9999,0,9999,0
1653593245116,CSE 293,044,094948,Gupta; Rajesh K.,9999,0,9999,0
1653593245668,CSE 294,A00,090143,Porter; George M,8,0,10,2
1653593246215,DSE 200,A00,091799,Staff,50,0,50,0
1653593246746,DSE 203,A00,091800,Gupta; Amarnath,30,0,30,0
1653593247282,DSE 250,A00,091801,Deutsch; Alin Bernard,30,0,30,0
1653593247924,DSE 290,A00,091802,Altintas De Callaf; Ilkay,50,0,50,0
1653593248495,ECE 200,001,091003,Antipa; Nicholas A,9999,0,9999,0
1653593248495,ECE 200,002,091004,Atanasov; Nikolay A.,9999,0,9999,0
1653593248495,ECE 200,003,091005,Bharadia; Dinesh,9999,0,9999,0
1653593248495,ECE 200,004,091006,Cheng; Chung Kuan,9999,0,9999,0
1653593248495,ECE 200,005,091007,Cosman; Pamela C.,9999,0,9999,0
1653593248495,ECE 200,006,091008,Staff,9999,0,9999,0
1653593248495,ECE 200,007,091009,Dayeh; Shadi Ahmad,9999,0,9999,0
1653593248495,ECE 200,008,091010,Fainman; Yeshaiahu,9999,0,9999,0
1653593248495,ECE 200,009,091011,Ford; Joseph Earl,9999,0,9999,0
1653593248495,ECE 200,010,091012,Franceschetti; Massimo,9999,0,9999,0
1653593248495,ECE 200,011,091013,Fullerton; Eric E,9999,0,9999,0
1653593248495,ECE 200,012,091014,Galton; Ian A,9999,0,9999,0
1653593248495,ECE 200,013,091015,Gilja; Vikash,9999,0,9999,0
1653593248495,ECE 200,014,091016,Hall; Drew A.,9999,0,9999,0
1653593248495,ECE 200,015,091017,Hsueh; Tzu-Chien,9999,0,9999,0
1653593248495,ECE 200,016,091018,Javidi; Tara,9999,0,9999,0
1653593248495,ECE 200,017,091019,Kahng; Andrew Byun,9999,0,9999,0
1653593248495,ECE 200,018,091020,Kim; Young-Han,9999,0,9999,0
1653593248495,ECE 200,019,091021,Koushanfar; Farinaz,9999,0,9999,0
1653593248495,ECE 200,020,091022,Kuzum; Duygu,9999,0,9999,0
1653593248495,ECE 200,021,091023,Le; Hanh-Phuc,9999,0,9999,0
1653593248495,ECE 200,022,091024,Lin; Bill,9999,0,9999,0
1653593248495,ECE 200,023,091025,Liu; Zhaowei,9999,0,9999,0
1653593248495,ECE 200,024,091026,Lo; Yu-Hwa,9999,0,9999,0
1653593248495,ECE 200,025,091027,Lomakin; Vitaliy,9999,0,9999,0
1653593248495,ECE 200,026,091028,Mercier; Patrick Philip,9999,0,9999,0
1653593248495,ECE 200,027,091029,Meyer; Florian,9999,0,9999,0
1653593248495,ECE 200,028,091030,Milstein; Laurence B.,9999,0,9999,0
1653593248495,ECE 200,029,091031,Mir Arabbaygi; Siavash,9999,0,9999,0
1653593248495,ECE 200,030,091032,Mookherjea; Shayan,9999,0,9999,0
1653593248495,ECE 200,031,091033,Morris; Karcher William,9999,0,9999,0
1653593248495,ECE 200,032,091034,Ng; Tse Nga,9999,0,9999,0
1653593248495,ECE 200,033,091035,Nguyen; Truong Quang,9999,0,9999,0
1653593248495,ECE 200,034,091036,Nomura; Kenji,9999,0,9999,0
1653593248495,ECE 200,035,091037,Orlitsky; Alon,9999,0,9999,0
1653593248495,ECE 200,036,091038,Pal; Piya,9999,0,9999,0
1653593248495,ECE 200,037,091039,Papen; George C.,9999,0,9999,0
1653593248495,ECE 200,038,091040,Radic; Stojan,9999,0,9999,0
1653593248495,ECE 200,039,091041,Rao; Bhaskar D.,9999,0,9999,0
1653593248495,ECE 200,040,091042,Rao; Ramesh R,9999,0,9999,0
1653593248495,ECE 200,041,091043,Rebeiz; Gabriel,9999,0,9999,0
1653593248495,ECE 200,042,091044,Sanford; John R,9999,0,9999,0
1653593248495,ECE 200,043,091045,Siegel; Paul H.,9999,0,9999,0
1653593248495,ECE 200,044,091046,Sievenpiper; Daniel F.,9999,0,9999,0
1653593248495,ECE 200,045,091047,Sworder; David D.,9999,0,9999,0
1653593248495,ECE 200,046,091048,Taur; Yuan,9999,0,9999,0
1653593248495,ECE 200,047,091049,Touri; Behrouz,9999,0,9999,0
1653593248495,ECE 200,048,091050,Trivedi; Mohan M.,9999,0,9999,0
1653593248495,ECE 200,049,091051,Vardy; Alexander,9999,0,9999,0
1653593248495,ECE 200,050,091052,Vasconcelos; Nuno,9999,0,9999,0
1653593248495,ECE 200,051,091053,Wang; Xiaolong,9999,0,9999,0
1653593248495,ECE 200,052,091054,Xie; Pengtao,9999,0,9999,0
1653593248495,ECE 200,053,091055,Yip; Michael,9999,0,9999,0
1653593248495,ECE 200,054,091056,Zeger; Kenneth A.,9999,0,9999,0
1653593248495,ECE 200,055,091057,Zhang; Xinyu,9999,0,9999,0
1653593248495,ECE 200,056,091058,Turakhia; Yatish Girish,9999,0,9999,0
1653593248495,ECE 200,057,091059,Kang; Mingu,9999,0,9999,0
1653593248495,ECE 200,058,091060,Shi; Yuanyuan,9999,0,9999,0
1653593248495,ECE 200,059,091061,Wang; Edward Jay,9999,0,9999,0
1653593248495,ECE 200,060,091062,Zheng; Yang,9999,0,9999,0
1653593249034,ECE 201,A00,095526,Lo; Yu-Hwa,0,0,0,0
1653593249564,ECE 203,A00,091065,Mercier; Patrick Philip,0,0,0,0
1653593250120,ECE 207A,A00,091605,Liu; Thomas Tao-Ming,0,0,0,0
1653593250669,ECE 212AN,A00,091068,Nomura; Kenji,0,0,0,0
1653593251216,ECE 222A,A00,091069,Rebeiz; Gabriel,0,0,0,0
1653593251744,ECE 225A,A00,091070,Orlitsky; Alon,0,0,0,0
1653593252283,ECE 230A,A00,091071,Nomura; Kenji,0,0,0,0
1653593252808,ECE 236A,A00,091072,Dayeh; Shadi Ahmad,0,0,0,0
1653593253341,ECE 238A,A00,091073,Luo; Jian,0,0,0,0
1653593253341,ECE 238A,B00,091074,Luo; Jian,0,0,0,0
1653593253876,ECE 240A,A00,091075,Radic; Stojan,0,0,0,0
1653593254411,ECE 247A,A00,091592,Shi; Lingyan,0,0,0,0
1653593254937,ECE 250,A00,091076,Touri; Behrouz,0,0,0,0
1653593255479,ECE 251C,A00,091078,Nguyen; Truong Quang,0,0,0,0
1653593256010,ECE 253,A00,091079,Cosman; Pamela C.,0,0,0,0
1653593256543,ECE 255A,A00,091080,Orlitsky; Alon,0,0,0,0
1653593257071,ECE 257A,A00,091081,Zhang; Xinyu,0,0,0,0
1653593257617,ECE 260A,A01,091084,Eldon; John,0,0,0,0
1653593258157,ECE 264C,A00,091085,Galton; Ian A,0,0,0,0
1653593258705,ECE 265C,A00,094889,Presti; Calogero Davide,0,0,0,9
1653593259225,ECE 266,A01,091087,Hall; Drew A.,0,0,0,0
1653593260292,ECE 271A,A00,091090,Vasconcelos; Nuno,0,0,0,0
1653593260820,ECE 272B,A00,091091,Sworder; David D.,0,0,0,0
1653593261344,ECE 275A,A00,091092,Meyer; Florian,0,0,0,0
1653593261880,ECE 277,A00,091093,An; Cheolhong,0,0,0,0
1653593262417,ECE 283,A00,091094,Le; Hanh-Phuc,0,0,0,0
1653593262953,ECE 284,A00,091095,Kang; Mingu,0,0,0,0
1653593262953,ECE 284,B00,091096,Wang; Edward Jay,0,0,0,0
1653593263496,ECE 285,A00,094334,Touri; Behrouz,0,0,0,0
1653593264033,ECE 289,A00,091097,Whelan; David Arthur,0,0,0,0
1653593264589,MATH 200A,A00,087414,Salehi Golsefidy; Alireza,7,0,8,1
1653593265124,MATH 202A,A00,087415,Gill; Philip E.,2,0,8,6
1653593265664,MATH 203A,A00,087416,Oprea; Dragos N.,6,0,8,2
1653593266196,MATH 204A,A00,087417,Kedlaya; Kiran S.,6,0,8,2
1653593266733,MATH 205,A00,087418,Sorensen; Claus M,6,0,8,2
1653593267266,MATH 206A,A00,087419,Izadi; Elham,7,0,8,1
1653593267799,MATH 207A,A00,087420,Mohammadi; Amir,5,0,8,3
1653593268324,MATH 208,A00,087421,Staff,9,0,10,1
1653593268873,MATH 209,A00,087422,Staff,10,0,10,0
1653593269412,MATH 218,A00,087423,Staff,10,0,10,0
1653593269958,MATH 220A,A00,087424,Novak; Jonathan I,6,0,8,2
1653593270509,MATH 231A,A00,087425,Bejenaru; Ioan,3,0,8,5
1653593271057,MATH 240A,A00,087426,Ebenfelt; Peter F,5,0,8,3
1653593271603,MATH 243,A00,087427,Staff,9,0,10,1
1653593272137,MATH 248,A00,087429,Staff,10,0,10,0
1653593272688,MATH 250A,A00,087430,Spolaor; Luca,4,0,8,4
1653593273228,MATH 257A,A00,087431,Spolaor; Luca,7,0,8,1
1653593273754,MATH 258,A00,087432,Staff,9,0,10,1
1653593274287,MATH 264A,A00,087433,Warnke; Lutz Peter,5,0,8,3
1653593274837,MATH 268,A00,087434,Staff,15,0,15,0
1653593275358,MATH 269,A00,087435,Staff,14,0,15,1
1653593275888,MATH 270A,A00,087436,Nie; Jiawang,0,0,8,8
1653593276436,MATH 272A,A00,087437,Tian; Xiaochuan,0,0,8,8
1653593276970,MATH 274,A01,087439,Cheng; Li-Tien,9,0,10,1
1653593276970,MATH 274,A02,087440,Cheng; Li-Tien,10,0,10,0
1653593277494,MATH 278A,A00,087441,Staff,8,0,10,2
1653593278025,MATH 278B,A00,087442,Staff,8,0,10,2
1653593278547,MATH 278C,A00,087443,Staff,8,0,10,2
1653593279073,MATH 280A,A00,087444,Zheng; Tianyi,0,0,8,8
1653593279600,MATH 281A,A00,087445,Bradic; Jelena,0,0,8,8
1653593280137,MATH 282A,A00,087446,Zhang; Danna,0,0,8,8
1653593280661,MATH 283,A00,087447,Tesler; Glenn,0,0,0,16
1653593281184,MATH 286,B00,095535,Kemp; Todd Aahron,8,0,8,0
1653593281734,MATH 287D,B00,095536,Bradic; Jelena,5,0,8,3
1653593282292,MATH 288,A00,087450,Staff,14,0,15,1
1653593282292,MATH 288,B00,087451,Staff,15,0,15,0
1653593282292,MATH 288,C00,087452,Staff,15,0,15,0
1653593282826,MATH 290A,A00,087453,Xu; Zhouli,6,0,8,2
1653593283380,MATH 291A,A00,087454,Xu; Zhouli,7,0,8,1
1653593283927,MATH 292,A00,087455,Staff,10,0,10,0
1653593284453,MATH 295,A00,087456,Staff,50,0,50,0
1653593284987,MATH 297,001,087457,Staff,997,0,999,2
1653593871654,COGS 200,A01,087991,Staff,47,0,50,3
1653593872186,COGS 201,A01,094504,Rangel; Lara M,16,0,25,9
1653593872723,COGS 203,A00,087992,Coulson; Seana M,18,0,20,2
1653593873252,COGS 210A,001,087993,Greene; Deanna Jacquelyn,9998,0,9999,1
1653593873252,COGS 210A,002,087994,Saygin; Ayse P,9999,0,9999,0
1653593873252,COGS 210A,003,087995,Xia; Haijun,9999,0,9999,0
1653593873252,COGS 210A,004,087996,Nitz; Douglas A.,9999,0,9999,0
1653593873252,COGS 210A,005,087997,Hollan; James D.,9999,0,9999,0
1653593873252,COGS 210A,006,087998,Deak; Gedeon O.,9998,0,9999,1
1653593873252,COGS 210A,007,087999,Rossano; Federico,9999,0,9999,0
1653593873804,COGS 211A,A00,088000,Coulson; Seana M,9997,0,9999,2
1653593874340,COGS 229,A00,088002,Staff,22,0,25,3
1653593874868,COGS 260,B00,094231,Staff,17,0,20,3
1653593874868,COGS 260,A00,088004,Nitz; Douglas A.,9998,0,9999,1
1653593875402,CSE 202,A00,090110,Paturi; Ramamohan,0,0,0,0
1653593875402,CSE 202,B00,090111,Paturi; Ramamohan,0,0,0,0
1653593875949,CSE 207B,A00,090112,Heninger; Nadia A,0,0,0,0
1653593876489,CSE 208,A00,094858,Micciancio; Daniele,0,0,0,0
1653593877033,CSE 210,A00,090113,Powell; Thomas Allan,0,0,0,0
1653593877585,CSE 219,A00,090898,Staff,0,0,0,0
1653593878146,CSE 221,A00,090114,Zhou; Yuan-Yuan,0,0,0,0
1653593878682,CSE 229A,A00,090115,Porter; George M,0,0,0,0
1653593879204,CSE 229C,A00,090116,Savage; Stefan,0,0,0,0
1653593879738,CSE 230,A00,090117,Jhala; Ranjit,0,0,0,0
1653593880264,CSE 232,A00,090118,Papakonstantinou; Yannis,0,0,0,0
1653593880786,CSE 239A,A00,090121,Kumar; Arun Kumar,0,0,0,0
1653593881310,CSE 239B,A00,090122,Jhala; Ranjit,0,0,0,0
1653593881834,CSE 240A,A00,090123,Zhao; Jishen,0,0,189,189
1653593882356,CSE 243A,A00,090124,Orailoglu; Alex,0,0,15,15
1653593882894,CSE 249B,A00,090125,Kahng; Andrew Byun,12,0,20,8
1653593883449,CSE 250A,A00,090126,Berg-Kirkpatrick; Taylor D,0,0,0,0
1653593883970,CSE 252A,A00,090127,Ochoa; Benjamin Lawrence,0,0,0,0
1653593884503,CSE 258,A01,090129,McAuley; Julian John,0,0,0,0
1653593885024,CSE 258R,A01,090131,McAuley; Julian John,0,0,0,0
1653593885559,CSE 274,A00,090132,Ramamoorthi; Ravi,0,0,0,0
1653593886114,CSE 276A,A00,090133,Christensen; Henrik I,0,0,0,0
1653593886659,CSE 276C,A00,090134,Christensen; Henrik I,0,0,0,0
1653593887202,CSE 290,A00,090135,Bafna; Vineet,0,0,0,0
1653593887202,CSE 290,B00,090136,Ramamoorthi; Ravi,0,0,0,0
1653593887202,CSE 290,C00,090137,Li; Tzumao,7,0,10,3
1653593887202,CSE 290,D00,090138,Zhou; Yuan-Yuan,9,0,10,1
1653593887202,CSE 290,E00,090139,Christensen; Henrik I,8,0,10,2
1653593887202,CSE 290,F00,094053,Shalev; Aaron D,0,0,0,0
1653593887732,CSE 291,A00,090140,Munyaka; Imani N. S.,0,0,0,0
1653593887732,CSE 291,B00,094880,Yu; Qi,0,0,0,0
1653593887732,CSE 291,C00,090142,Pannuto; Patrick William,0,0,0,0
1653593887732,CSE 291,D00,094881,Zhang; Yiying,0,0,0,0
1653593887732,CSE 291,E00,095118,Su; Hao,0,0,0,0
1653593888313,CSE 293,001,094905,Bafna; Vineet,9999,0,9999,0
1653593888313,CSE 293,002,094906,Bellare; Mihir,9999,0,9999,0
1653593888313,CSE 293,003,094907,Berg-Kirkpatrick; Taylor D,9999,0,9999,0
1653593888313,CSE 293,004,094908,Christensen; Henrik I,9999,0,9999,0
1653593888313,CSE 293,005,094909,Cottrell; Garrison W,9999,0,9999,0
1653593888313,CSE 293,006,094910,Deutsch; Alin Bernard,9999,0,9999,0
1653593888313,CSE 293,007,094911,Esmaeilzadeh; Hadi,9999,0,9999,0
1653593888313,CSE 293,008,094912,Freund; Yoav,9999,0,9999,0
1653593888313,CSE 293,009,094913,Griswold; William G.,9999,0,9999,0
1653593888313,CSE 293,010,094914,Gymrek; Melissa Ann,9999,0,9999,0
1653593888313,CSE 293,011,094915,Heninger; Nadia A,9999,0,9999,0
1653593888313,CSE 293,012,094916,Impagliazzo; Russell,9999,0,9999,0
1653593888313,CSE 293,013,094917,Jhala; Ranjit,9999,0,9999,0
1653593888313,CSE 293,014,094918,Kahng; Andrew Byun,9999,0,9999,0
1653593888313,CSE 293,015,094919,Kane; Daniel Mertz,9999,0,9999,0
1653593888313,CSE 293,016,094920,Kriegman; David J,9999,0,9999,0
1653593888313,CSE 293,017,094921,Kumar; Arun Kumar,9999,0,9999,0
1653593888313,CSE 293,018,094922,Lerner; Sorin,9999,0,9999,0
1653593888313,CSE 293,019,094923,Lovett; Shachar,9999,0,9999,0
1653593888313,CSE 293,020,094924,McAuley; Julian John,9999,0,9999,0
1653593888313,CSE 293,021,094925,Micciancio; Daniele,9999,0,9999,0
1653593888313,CSE 293,022,094926,Orailoglu; Alex,9999,0,9999,0
1653593888313,CSE 293,023,094927,Paturi; Ramamohan,9999,0,9999,0
1653593888313,CSE 293,024,094928,Polikarpova; Nadezhda,9999,0,9999,0
1653593888313,CSE 293,025,094929,Politz; Joseph Gibbs,9999,0,9999,0
1653593888313,CSE 293,026,094930,Porter; George M,9999,0,9999,0
1653593888313,CSE 293,027,094931,Porter; Leonard Emerson,9999,0,9999,0
1653593888313,CSE 293,028,094932,Ramamoorthi; Ravi,9999,0,9999,0
1653593888313,CSE 293,029,094933,Sahoo; Debashis,9999,0,9999,0
1653593888313,CSE 293,030,094934,Saul; Lawrence,9999,0,9999,0
1653593888313,CSE 293,031,094935,Savage; Stefan,9999,0,9999,0
1653593888313,CSE 293,032,094936,Schulze; Jurgen P.,9999,0,9999,0
1653593888313,CSE 293,033,094937,Snoeren; Alex C.,9999,0,9999,0
1653593888313,CSE 293,034,094938,Shang; Jingbo,9999,0,9999,0
1653593888313,CSE 293,035,094939,Stefan; Deian,9999,0,9999,0
1653593888313,CSE 293,036,094940,Su; Hao,9999,0,9999,0
1653593888313,CSE 293,037,094941,Swanson; Steven James,9999,0,9999,0
1653593888313,CSE 293,038,094942,Tullsen; Dean Michael,9999,0,9999,0
1653593888313,CSE 293,039,094943,Voelker; Geoffrey M.,9999,0,9999,0
1653593888313,CSE 293,040,094944,Zhao; Jishen,9999,0,9999,0
1653593888313,CSE 293,041,094945,Zhou; Yuan-Yuan,9999,0,9999,0
1653593888313,CSE 293,042,094946,Gao; Sicun,9998,0,9999,1
1653593888313,CSE 293,043,094947,Weibel; Nadir,9999,0,9999,0
1653593888313,CSE 293,044,094948,Gupta; Rajesh K.,9999,0,9999,0
1653593888858,CSE 294,A00,090143,Porter; George M,8,0,10,2
1653593889406,DSE 200,A00,091799,Staff,50,0,50,0
1653593889928,DSE 203,A00,091800,Gupta; Amarnath,30,0,30,0
1653593890462,DSE 250,A00,091801,Deutsch; Alin Bernard,30,0,30,0
1653593890987,DSE 290,A00,091802,Altintas De Callaf; Ilkay,50,0,50,0
1653593891549,ECE 200,001,091003,Antipa; Nicholas A,9999,0,9999,0
1653593891549,ECE 200,002,091004,Atanasov; Nikolay A.,9999,0,9999,0
1653593891549,ECE 200,003,091005,Bharadia; Dinesh,9999,0,9999,0
1653593891549,ECE 200,004,091006,Cheng; Chung Kuan,9999,0,9999,0
1653593891549,ECE 200,005,091007,Cosman; Pamela C.,9999,0,9999,0
1653593891549,ECE 200,006,091008,Staff,9999,0,9999,0
1653593891549,ECE 200,007,091009,Dayeh; Shadi Ahmad,9999,0,9999,0
1653593891549,ECE 200,008,091010,Fainman; Yeshaiahu,9999,0,9999,0
1653593891549,ECE 200,009,091011,Ford; Joseph Earl,9999,0,9999,0
1653593891549,ECE 200,010,091012,Franceschetti; Massimo,9999,0,9999,0
1653593891549,ECE 200,011,091013,Fullerton; Eric E,9999,0,9999,0
1653593891549,ECE 200,012,091014,Galton; Ian A,9999,0,9999,0
1653593891549,ECE 200,013,091015,Gilja; Vikash,9999,0,9999,0
1653593891549,ECE 200,014,091016,Hall; Drew A.,9999,0,9999,0
1653593891549,ECE 200,015,091017,Hsueh; Tzu-Chien,9999,0,9999,0
1653593891549,ECE 200,016,091018,Javidi; Tara,9999,0,9999,0
1653593891549,ECE 200,017,091019,Kahng; Andrew Byun,9999,0,9999,0
1653593891549,ECE 200,018,091020,Kim; Young-Han,9999,0,9999,0
1653593891549,ECE 200,019,091021,Koushanfar; Farinaz,9999,0,9999,0
1653593891549,ECE 200,020,091022,Kuzum; Duygu,9999,0,9999,0
1653593891549,ECE 200,021,091023,Le; Hanh-Phuc,9999,0,9999,0
1653593891549,ECE 200,022,091024,Lin; Bill,9999,0,9999,0
1653593891549,ECE 200,023,091025,Liu; Zhaowei,9999,0,9999,0
1653593891549,ECE 200,024,091026,Lo; Yu-Hwa,9999,0,9999,0
1653593891549,ECE 200,025,091027,Lomakin; Vitaliy,9999,0,9999,0
1653593891549,ECE 200,026,091028,Mercier; Patrick Philip,9999,0,9999,0
1653593891549,ECE 200,027,091029,Meyer; Florian,9999,0,9999,0
1653593891549,ECE 200,028,091030,Milstein; Laurence B.,9999,0,9999,0
1653593891549,ECE 200,029,091031,Mir Arabbaygi; Siavash,9999,0,9999,0
1653593891549,ECE 200,030,091032,Mookherjea; Shayan,9999,0,9999,0
1653593891549,ECE 200,031,091033,Morris; Karcher William,9999,0,9999,0
1653593891549,ECE 200,032,091034,Ng; Tse Nga,9999,0,9999,0
1653593891549,ECE 200,033,091035,Nguyen; Truong Quang,9999,0,9999,0
1653593891549,ECE 200,034,091036,Nomura; Kenji,9999,0,9999,0
1653593891549,ECE 200,035,091037,Orlitsky; Alon,9999,0,9999,0
1653593891549,ECE 200,036,091038,Pal; Piya,9999,0,9999,0
1653593891549,ECE 200,037,091039,Papen; George C.,9999,0,9999,0
1653593891549,ECE 200,038,091040,Radic; Stojan,9999,0,9999,0
1653593891549,ECE 200,039,091041,Rao; Bhaskar D.,9999,0,9999,0
1653593891549,ECE 200,040,091042,Rao; Ramesh R,9999,0,9999,0
1653593891549,ECE 200,041,091043,Rebeiz; Gabriel,9999,0,9999,0
1653593891549,ECE 200,042,091044,Sanford; John R,9999,0,9999,0
1653593891549,ECE 200,043,091045,Siegel; Paul H.,9999,0,9999,0
1653593891549,ECE 200,044,091046,Sievenpiper; Daniel F.,9999,0,9999,0
1653593891549,ECE 200,045,091047,Sworder; David D.,9999,0,9999,0
1653593891549,ECE 200,046,091048,Taur; Yuan,9999,0,9999,0
1653593891549,ECE 200,047,091049,Touri; Behrouz,9999,0,9999,0
1653593891549,ECE 200,048,091050,Trivedi; Mohan M.,9999,0,9999,0
1653593891549,ECE 200,049,091051,Vardy; Alexander,9999,0,9999,0
1653593891549,ECE 200,050,091052,Vasconcelos; Nuno,9999,0,9999,0
1653593891549,ECE 200,051,091053,Wang; Xiaolong,9999,0,9999,0
1653593891549,ECE 200,052,091054,Xie; Pengtao,9999,0,9999,0
1653593891549,ECE 200,053,091055,Yip; Michael,9999,0,9999,0
1653593891549,ECE 200,054,091056,Zeger; Kenneth A.,9999,0,9999,0
1653593891549,ECE 200,055,091057,Zhang; Xinyu,9999,0,9999,0
1653593891549,ECE 200,056,091058,Turakhia; Yatish Girish,9999,0,9999,0
1653593891549,ECE 200,057,091059,Kang; Mingu,9999,0,9999,0
1653593891549,ECE 200,058,091060,Shi; Yuanyuan,9999,0,9999,0
1653593891549,ECE 200,059,091061,Wang; Edward Jay,9999,0,9999,0
1653593891549,ECE 200,060,091062,Zheng; Yang,9999,0,9999,0
1653593892084,ECE 201,A00,095526,Lo; Yu-Hwa,0,0,0,0
1653593892615,ECE 203,A00,091065,Mercier; Patrick Philip,0,0,0,0
1653593893145,ECE 207A,A00,091605,Liu; Thomas Tao-Ming,0,0,0,0
1653593893699,ECE 212AN,A00,091068,Nomura; Kenji,0,0,0,0
1653593894253,ECE 222A,A00,091069,Rebeiz; Gabriel,0,0,0,0
1653593894788,ECE 225A,A00,091070,Orlitsky; Alon,0,0,0,0
1653593895326,ECE 230A,A00,091071,Nomura; Kenji,0,0,0,0
1653593895874,ECE 236A,A00,091072,Dayeh; Shadi Ahmad,0,0,0,0
1653593896409,ECE 238A,A00,091073,Luo; Jian,0,0,0,0
1653593896409,ECE 238A,B00,091074,Luo; Jian,0,0,0,0
1653593896950,ECE 240A,A00,091075,Radic; Stojan,0,0,0,0
1653593897506,ECE 247A,A00,091592,Shi; Lingyan,0,0,0,0
1653593898051,ECE 250,A00,091076,Touri; Behrouz,0,0,0,0
1653593898603,ECE 251C,A00,091078,Nguyen; Truong Quang,0,0,0,0
1653593899155,ECE 253,A00,091079,Cosman; Pamela C.,0,0,0,0
1653593899691,ECE 255A,A00,091080,Orlitsky; Alon,0,0,0,0
1653593900227,ECE 257A,A00,091081,Zhang; Xinyu,0,0,0,0
1653593900755,ECE 260A,A01,091084,Eldon; John,0,0,0,0
1653593901312,ECE 264C,A00,091085,Galton; Ian A,0,0,0,0
1653593901834,ECE 265C,A00,094889,Presti; Calogero Davide,0,0,0,9
1653593902370,ECE 266,A01,091087,Hall; Drew A.,0,0,0,0
1653593903446,ECE 271A,A00,091090,Vasconcelos; Nuno,0,0,0,0
1653593903990,ECE 272B,A00,091091,Sworder; David D.,0,0,0,0
1653593904539,ECE 275A,A00,091092,Meyer; Florian,0,0,0,0
1653593905073,ECE 277,A00,091093,An; Cheolhong,0,0,0,0
1653593905609,ECE 283,A00,091094,Le; Hanh-Phuc,0,0,0,0
1653593906156,ECE 284,A00,091095,Kang; Mingu,0,0,0,0
1653593906156,ECE 284,B00,091096,Wang; Edward Jay,0,0,0,0
1653593906699,ECE 285,A00,094334,Touri; Behrouz,0,0,0,0
1653593907240,ECE 289,A00,091097,Whelan; David Arthur,0,0,0,0
1653593907771,MATH 200A,A00,087414,Salehi Golsefidy; Alireza,7,0,8,1
1653593908310,MATH 202A,A00,087415,Gill; Philip E.,2,0,8,6
1653593908859,MATH 203A,A00,087416,Oprea; Dragos N.,6,0,8,2
1653593909410,MATH 204A,A00,087417,Kedlaya; Kiran S.,6,0,8,2
1653593909957,MATH 205,A00,087418,Sorensen; Claus M,6,0,8,2
1653593910493,MATH 206A,A00,087419,Izadi; Elham,7,0,8,1
1653593911036,MATH 207A,A00,087420,Mohammadi; Amir,5,0,8,3
1653593911563,MATH 208,A00,087421,Staff,9,0,10,1
1653593912115,MATH 209,A00,087422,Staff,10,0,10,0
1653593912666,MATH 218,A00,087423,Staff,10,0,10,0
1653593913204,MATH 220A,A00,087424,Novak; Jonathan I,6,0,8,2
1653593913752,MATH 231A,A00,087425,Bejenaru; Ioan,3,0,8,5
1653593914299,MATH 240A,A00,087426,Ebenfelt; Peter F,5,0,8,3
1653593914829,MATH 243,A00,087427,Staff,9,0,10,1
1653593915362,MATH 248,A00,087429,Staff,10,0,10,0
1653593915902,MATH 250A,A00,087430,Spolaor; Luca,4,0,8,4
1653593916446,MATH 257A,A00,087431,Spolaor; Luca,7,0,8,1
1653593917076,MATH 258,A00,087432,Staff,9,0,10,1
1653593917619,MATH 264A,A00,087433,Warnke; Lutz Peter,5,0,8,3
1653593918165,MATH 268,A00,087434,Staff,15,0,15,0
1653593918720,MATH 269,A00,087435,Staff,14,0,15,1
1653593919264,MATH 270A,A00,087436,Nie; Jiawang,0,0,8,8
1653593919803,MATH 272A,A00,087437,Tian; Xiaochuan,0,0,8,8
1653593920351,MATH 274,A01,087439,Cheng; Li-Tien,9,0,10,1
1653593920351,MATH 274,A02,087440,Cheng; Li-Tien,10,0,10,0
1653593920893,MATH 278A,A00,087441,Staff,8,0,10,2
1653593921426,MATH 278B,A00,087442,Staff,8,0,10,2
1653593921963,MATH 278C,A00,087443,Staff,8,0,10,2
1653593922486,MATH 280A,A00,087444,Zheng; Tianyi,0,0,8,8
1653593923048,MATH 281A,A00,087445,Bradic; Jelena,0,0,8,8
1653593923600,MATH 282A,A00,087446,Zhang; Danna,0,0,8,8
1653593924147,MATH 283,A00,087447,Tesler; Glenn,0,0,0,16
1653593924668,MATH 286,B00,095535,Kemp; Todd Aahron,8,0,8,0
1653593925208,MATH 287D,B00,095536,Bradic; Jelena,5,0,8,3
1653593925766,MATH 288,A00,087450,Staff,14,0,15,1
1653593925766,MATH 288,B00,087451,Staff,15,0,15,0
1653593925766,MATH 288,C00,087452,Staff,15,0,15,0
1653593926324,MATH 290A,A00,087453,Xu; Zhouli,6,0,8,2
1653593926864,MATH 291A,A00,087454,Xu; Zhouli,7,0,8,1
1653593927410,MATH 292,A00,087455,Staff,10,0,10,0
1653593927973,MATH 295,A00,087456,Staff,50,0,50,0
1653593928519,MATH 297,001,087457,Staff,997,0,999,2
1653594502634,COGS 200,A01,087991,Staff,47,0,50,3
1653594503164,COGS 201,A01,094504,Rangel; Lara M,16,0,25,9
1653594503701,COGS 203,A00,087992,Coulson; Seana M,18,0,20,2
1653594504245,COGS 210A,001,087993,Greene; Deanna Jacquelyn,9998,0,9999,1
1653594504245,COGS 210A,002,087994,Saygin; Ayse P,9999,0,9999,0
1653594504245,COGS 210A,003,087995,Xia; Haijun,9999,0,9999,0
1653594504245,COGS 210A,004,087996,Nitz; Douglas A.,9999,0,9999,0
1653594504245,COGS 210A,005,087997,Hollan; James D.,9999,0,9999,0
1653594504245,COGS 210A,006,087998,Deak; Gedeon O.,9998,0,9999,1
1653594504245,COGS 210A,007,087999,Rossano; Federico,9999,0,9999,0
1653594504786,COGS 211A,A00,088000,Coulson; Seana M,9997,0,9999,2
1653594505320,COGS 229,A00,088002,Staff,22,0,25,3
1653594505848,COGS 260,B00,094231,Staff,17,0,20,3
1653594505848,COGS 260,A00,088004,Nitz; Douglas A.,9998,0,9999,1
1653594506385,CSE 202,A00,090110,Paturi; Ramamohan,0,0,0,0
1653594506385,CSE 202,B00,090111,Paturi; Ramamohan,0,0,0,0
1653594506937,CSE 207B,A00,090112,Heninger; Nadia A,0,0,0,0
1653594507483,CSE 208,A00,094858,Micciancio; Daniele,0,0,0,0
1653594508040,CSE 210,A00,090113,Powell; Thomas Allan,0,0,0,0
1653594508582,CSE 219,A00,090898,Staff,0,0,0,0
1653594509105,CSE 221,A00,090114,Zhou; Yuan-Yuan,0,0,0,0
1653594509640,CSE 229A,A00,090115,Porter; George M,0,0,0,0
1653594510182,CSE 229C,A00,090116,Savage; Stefan,0,0,0,0
1653594510707,CSE 230,A00,090117,Jhala; Ranjit,0,0,0,0
1653594511239,CSE 232,A00,090118,Papakonstantinou; Yannis,0,0,0,0
1653594511760,CSE 239A,A00,090121,Kumar; Arun Kumar,0,0,0,0
1653594512285,CSE 239B,A00,090122,Jhala; Ranjit,0,0,0,0
1653594512832,CSE 240A,A00,090123,Zhao; Jishen,0,0,189,189
1653594513377,CSE 243A,A00,090124,Orailoglu; Alex,0,0,15,15
1653594513924,CSE 249B,A00,090125,Kahng; Andrew Byun,12,0,20,8
1653594514472,CSE 250A,A00,090126,Berg-Kirkpatrick; Taylor D,0,0,0,0
1653594515002,CSE 252A,A00,090127,Ochoa; Benjamin Lawrence,0,0,0,0
1653594515549,CSE 258,A01,090129,McAuley; Julian John,0,0,0,0
1653594516108,CSE 258R,A01,090131,McAuley; Julian John,0,0,0,0
1653594516653,CSE 274,A00,090132,Ramamoorthi; Ravi,0,0,0,0
1653594517197,CSE 276A,A00,090133,Christensen; Henrik I,0,0,0,0
1653594517739,CSE 276C,A00,090134,Christensen; Henrik I,0,0,0,0
1653594518277,CSE 290,A00,090135,Bafna; Vineet,0,0,0,0
1653594518277,CSE 290,B00,090136,Ramamoorthi; Ravi,0,0,0,0
1653594518277,CSE 290,C00,090137,Li; Tzumao,7,0,10,3
1653594518277,CSE 290,D00,090138,Zhou; Yuan-Yuan,9,0,10,1
1653594518277,CSE 290,E00,090139,Christensen; Henrik I,8,0,10,2
1653594518277,CSE 290,F00,094053,Shalev; Aaron D,0,0,0,0
1653594518813,CSE 291,A00,090140,Munyaka; Imani N. S.,0,0,0,0
1653594518813,CSE 291,B00,094880,Yu; Qi,0,0,0,0
1653594518813,CSE 291,C00,090142,Pannuto; Patrick William,0,0,0,0
1653594518813,CSE 291,D00,094881,Zhang; Yiying,0,0,0,0
1653594518813,CSE 291,E00,095118,Su; Hao,0,0,0,0
1653594519506,CSE 293,001,094905,Bafna; Vineet,9999,0,9999,0
1653594519506,CSE 293,002,094906,Bellare; Mihir,9999,0,9999,0
1653594519506,CSE 293,003,094907,Berg-Kirkpatrick; Taylor D,9999,0,9999,0
1653594519506,CSE 293,004,094908,Christensen; Henrik I,9999,0,9999,0
1653594519506,CSE 293,005,094909,Cottrell; Garrison W,9999,0,9999,0
1653594519506,CSE 293,006,094910,Deutsch; Alin Bernard,9999,0,9999,0
1653594519506,CSE 293,007,094911,Esmaeilzadeh; Hadi,9999,0,9999,0
1653594519506,CSE 293,008,094912,Freund; Yoav,9999,0,9999,0
1653594519506,CSE 293,009,094913,Griswold; William G.,9999,0,9999,0
1653594519506,CSE 293,010,094914,Gymrek; Melissa Ann,9999,0,9999,0
1653594519506,CSE 293,011,094915,Heninger; Nadia A,9999,0,9999,0
1653594519506,CSE 293,012,094916,Impagliazzo; Russell,9999,0,9999,0
1653594519506,CSE 293,013,094917,Jhala; Ranjit,9999,0,9999,0
1653594519506,CSE 293,014,094918,Kahng; Andrew Byun,9999,0,9999,0
1653594519506,CSE 293,015,094919,Kane; Daniel Mertz,9999,0,9999,0
1653594519506,CSE 293,016,094920,Kriegman; David J,9999,0,9999,0
1653594519506,CSE 293,017,094921,Kumar; Arun Kumar,9999,0,9999,0
1653594519506,CSE 293,018,094922,Lerner; Sorin,9999,0,9999,0
1653594519506,CSE 293,019,094923,Lovett; Shachar,9999,0,9999,0
1653594519506,CSE 293,020,094924,McAuley; Julian John,9999,0,9999,0
1653594519506,CSE 293,021,094925,Micciancio; Daniele,9999,0,9999,0
1653594519506,CSE 293,022,094926,Orailoglu; Alex,9999,0,9999,0
1653594519506,CSE 293,023,094927,Paturi; Ramamohan,9999,0,9999,0
1653594519506,CSE 293,024,094928,Polikarpova; Nadezhda,9999,0,9999,0
1653594519506,CSE 293,025,094929,Politz; Joseph Gibbs,9999,0,9999,0
1653594519506,CSE 293,026,094930,Porter; George M,9999,0,9999,0
1653594519506,CSE 293,027,094931,Porter; Leonard Emerson,9999,0,9999,0
1653594519506,CSE 293,028,094932,Ramamoorthi; Ravi,9999,0,9999,0
1653594519506,CSE 293,029,094933,Sahoo; Debashis,9999,0,9999,0
1653594519506,CSE 293,030,094934,Saul; Lawrence,9999,0,9999,0
1653594519506,CSE 293,031,094935,Savage; Stefan,9999,0,9999,0
1653594519506,CSE 293,032,094936,Schulze; Jurgen P.,9999,0,9999,0
1653594519506,CSE 293,033,094937,Snoeren; Alex C.,9999,0,9999,0
1653594519506,CSE 293,034,094938,Shang; Jingbo,9999,0,9999,0
1653594519506,CSE 293,035,094939,Stefan; Deian,9999,0,9999,0
1653594519506,CSE 293,036,094940,Su; Hao,9999,0,9999,0
1653594519506,CSE 293,037,094941,Swanson; Steven James,9999,0,9999,0
1653594519506,CSE 293,038,094942,Tullsen; Dean Michael,9999,0,9999,0
1653594519506,CSE 293,039,094943,Voelker; Geoffrey M.,9999,0,9999,0
1653594519506,CSE 293,040,094944,Zhao; Jishen,9999,0,9999,0
1653594519506,CSE 293,041,094945,Zhou; Yuan-Yuan,9999,0,9999,0
1653594519506,CSE 293,042,094946,Gao; Sicun,9998,0,9999,1
1653594519506,CSE 293,043,094947,Weibel; Nadir,9999,0,9999,0
1653594519506,CSE 293,044,094948,Gupta; Rajesh K.,9999,0,9999,0
1653594520054,CSE 294,A00,090143,Porter; George M,8,0,10,2
1653594520599,DSE 200,A00,091799,Staff,50,0,50,0
1653594521122,DSE 203,A00,091800,Gupta; Amarnath,30,0,30,0
1653594521657,DSE 250,A00,091801,Deutsch; Alin Bernard,30,0,30,0
1653594522209,DSE 290,A00,091802,Altintas De Callaf; Ilkay,50,0,50,0
1653594522777,ECE 200,001,091003,Antipa; Nicholas A,9999,0,9999,0
1653594522777,ECE 200,002,091004,Atanasov; Nikolay A.,9999,0,9999,0
1653594522777,ECE 200,003,091005,Bharadia; Dinesh,9999,0,9999,0
1653594522777,ECE 200,004,091006,Cheng; Chung Kuan,9999,0,9999,0
1653594522777,ECE 200,005,091007,Cosman; Pamela C.,9999,0,9999,0
1653594522777,ECE 200,006,091008,Staff,9999,0,9999,0
1653594522777,ECE 200,007,091009,Dayeh; Shadi Ahmad,9999,0,9999,0
1653594522777,ECE 200,008,091010,Fainman; Yeshaiahu,9999,0,9999,0
1653594522777,ECE 200,009,091011,Ford; Joseph Earl,9999,0,9999,0
1653594522777,ECE 200,010,091012,Franceschetti; Massimo,9999,0,9999,0
1653594522777,ECE 200,011,091013,Fullerton; Eric E,9999,0,9999,0
1653594522777,ECE 200,012,091014,Galton; Ian A,9999,0,9999,0
1653594522777,ECE 200,013,091015,Gilja; Vikash,9999,0,9999,0
1653594522777,ECE 200,014,091016,Hall; Drew A.,9999,0,9999,0
1653594522777,ECE 200,015,091017,Hsueh; Tzu-Chien,9999,0,9999,0
1653594522777,ECE 200,016,091018,Javidi; Tara,9999,0,9999,0
1653594522777,ECE 200,017,091019,Kahng; Andrew Byun,9999,0,9999,0
1653594522777,ECE 200,018,091020,Kim; Young-Han,9999,0,9999,0
1653594522777,ECE 200,019,091021,Koushanfar; Farinaz,9999,0,9999,0
1653594522777,ECE 200,020,091022,Kuzum; Duygu,9999,0,9999,0
1653594522777,ECE 200,021,091023,Le; Hanh-Phuc,9999,0,9999,0
1653594522777,ECE 200,022,091024,Lin; Bill,9999,0,9999,0
1653594522777,ECE 200,023,091025,Liu; Zhaowei,9999,0,9999,0
1653594522777,ECE 200,024,091026,Lo; Yu-Hwa,9999,0,9999,0
1653594522777,ECE 200,025,091027,Lomakin; Vitaliy,9999,0,9999,0
1653594522777,ECE 200,026,091028,Mercier; Patrick Philip,9999,0,9999,0
1653594522777,ECE 200,027,091029,Meyer; Florian,9999,0,9999,0
1653594522777,ECE 200,028,091030,Milstein; Laurence B.,9999,0,9999,0
1653594522777,ECE 200,029,091031,Mir Arabbaygi; Siavash,9999,0,9999,0
1653594522777,ECE 200,030,091032,Mookherjea; Shayan,9999,0,9999,0
1653594522777,ECE 200,031,091033,Morris; Karcher William,9999,0,9999,0
1653594522777,ECE 200,032,091034,Ng; Tse Nga,9999,0,9999,0
1653594522777,ECE 200,033,091035,Nguyen; Truong Quang,9999,0,9999,0
1653594522777,ECE 200,034,091036,Nomura; Kenji,9999,0,9999,0
1653594522777,ECE 200,035,091037,Orlitsky; Alon,9999,0,9999,0
1653594522777,ECE 200,036,091038,Pal; Piya,9999,0,9999,0
1653594522777,ECE 200,037,091039,Papen; George C.,9999,0,9999,0
1653594522777,ECE 200,038,091040,Radic; Stojan,9999,0,9999,0
1653594522777,ECE 200,039,091041,Rao; Bhaskar D.,9999,0,9999,0
1653594522777,ECE 200,040,091042,Rao; Ramesh R,9999,0,9999,0
1653594522777,ECE 200,041,091043,Rebeiz; Gabriel,9999,0,9999,0
1653594522777,ECE 200,042,091044,Sanford; John R,9999,0,9999,0
1653594522777,ECE 200,043,091045,Siegel; Paul H.,9999,0,9999,0
1653594522777,ECE 200,044,091046,Sievenpiper; Daniel F.,9999,0,9999,0
1653594522777,ECE 200,045,091047,Sworder; David D.,9999,0,9999,0
1653594522777,ECE 200,046,091048,Taur; Yuan,9999,0,9999,0
1653594522777,ECE 200,047,091049,Touri; Behrouz,9999,0,9999,0
1653594522777,ECE 200,048,091050,Trivedi; Mohan M.,9999,0,9999,0
1653594522777,ECE 200,049,091051,Vardy; Alexander,9999,0,9999,0
1653594522777,ECE 200,050,091052,Vasconcelos; Nuno,9999,0,9999,0
1653594522777,ECE 200,051,091053,Wang; Xiaolong,9999,0,9999,0
1653594522777,ECE 200,052,091054,Xie; Pengtao,9999,0,9999,0
1653594522777,ECE 200,053,091055,Yip; Michael,9999,0,9999,0
1653594522777,ECE 200,054,091056,Zeger; Kenneth A.,9999,0,9999,0
1653594522777,ECE 200,055,091057,Zhang; Xinyu,9999,0,9999,0
1653594522777,ECE 200,056,091058,Turakhia; Yatish Girish,9999,0,9999,0
1653594522777,ECE 200,057,091059,Kang; Mingu,9999,0,9999,0
1653594522777,ECE 200,058,091060,Shi; Yuanyuan,9999,0,9999,0
1653594522777,ECE 200,059,091061,Wang; Edward Jay,9999,0,9999,0
1653594522777,ECE 200,060,091062,Zheng; Yang,9999,0,9999,0
1653594523315,ECE 201,A00,095526,Lo; Yu-Hwa,0,0,0,0
1653594523846,ECE 203,A00,091065,Mercier; Patrick Philip,0,0,0,0
1653594524379,ECE 207A,A00,091605,Liu; Thomas Tao-Ming,0,0,0,0
1653594524914,ECE 212AN,A00,091068,Nomura; Kenji,0,0,0,0
1653594525453,ECE 222A,A00,091069,Rebeiz; Gabriel,0,0,0,0
1653594525975,ECE 225A,A00,091070,Orlitsky; Alon,0,0,0,0
1653594526516,ECE 230A,A00,091071,Nomura; Kenji,0,0,0,0
1653594527068,ECE 236A,A00,091072,Dayeh; Shadi Ahmad,0,0,0,0
1653594527612,ECE 238A,A00,091073,Luo; Jian,0,0,0,0
1653594527612,ECE 238A,B00,091074,Luo; Jian,0,0,0,0
1653594528154,ECE 240A,A00,091075,Radic; Stojan,0,0,0,0
1653594528679,ECE 247A,A00,091592,Shi; Lingyan,0,0,0,0
1653594529214,ECE 250,A00,091076,Touri; Behrouz,0,0,0,0
1653594529757,ECE 251C,A00,091078,Nguyen; Truong Quang,0,0,0,0
1653594530291,ECE 253,A00,091079,Cosman; Pamela C.,0,0,0,0
1653594530823,ECE 255A,A00,091080,Orlitsky; Alon,0,0,0,0
1653594531355,ECE 257A,A00,091081,Zhang; Xinyu,0,0,0,0
1653594531900,ECE 260A,A01,091084,Eldon; John,0,0,0,0
1653594532422,ECE 264C,A00,091085,Galton; Ian A,0,0,0,0
1653594532955,ECE 265C,A00,094889,Presti; Calogero Davide,0,0,0,9
1653594533490,ECE 266,A01,091087,Hall; Drew A.,0,0,0,0
1653594534579,ECE 271A,A00,091090,Vasconcelos; Nuno,0,0,0,0
1653594535124,ECE 272B,A00,091091,Sworder; David D.,0,0,0,0
1653594535673,ECE 275A,A00,091092,Meyer; Florian,0,0,0,0
1653594536214,ECE 277,A00,091093,An; Cheolhong,0,0,0,0
1653594536741,ECE 283,A00,091094,Le; Hanh-Phuc,0,0,0,0
1653594537267,ECE 284,A00,091095,Kang; Mingu,0,0,0,0
1653594537267,ECE 284,B00,091096,Wang; Edward Jay,0,0,0,0
1653594537800,ECE 285,A00,094334,Touri; Behrouz,0,0,0,0
1653594538330,ECE 289,A00,091097,Whelan; David Arthur,0,0,0,0
1653594538867,MATH 200A,A00,087414,Salehi Golsefidy; Alireza,7,0,8,1
1653594539390,MATH 202A,A00,087415,Gill; Philip E.,2,0,8,6
1653594539916,MATH 203A,A00,087416,Oprea; Dragos N.,6,0,8,2
1653594540445,MATH 204A,A00,087417,Kedlaya; Kiran S.,6,0,8,2
1653594540978,MATH 205,A00,087418,Sorensen; Claus M,6,0,8,2
1653594541512,MATH 206A,A00,087419,Izadi; Elham,7,0,8,1
1653594542035,MATH 207A,A00,087420,Mohammadi; Amir,5,0,8,3
1653594542565,MATH 208,A00,087421,Staff,9,0,10,1
1653594543092,MATH 209,A00,087422,Staff,10,0,10,0
1653594543643,MATH 218,A00,087423,Staff,10,0,10,0
1653594544202,MATH 220A,A00,087424,Novak; Jonathan I,6,0,8,2
1653594544749,MATH 231A,A00,087425,Bejenaru; Ioan,3,0,8,5
1653594545292,MATH 240A,A00,087426,Ebenfelt; Peter F,5,0,8,3
1653594545816,MATH 243,A00,087427,Staff,9,0,10,1
1653594546341,MATH 248,A00,087429,Staff,10,0,10,0
1653594546866,MATH 250A,A00,087430,Spolaor; Luca,4,0,8,4
1653594547415,MATH 257A,A00,087431,Spolaor; Luca,7,0,8,1
1653594547952,MATH 258,A00,087432,Staff,9,0,10,1
1653594548494,MATH 264A,A00,087433,Warnke; Lutz Peter,5,0,8,3
1653594549044,MATH 268,A00,087434,Staff,15,0,15,0
1653594549586,MATH 269,A00,087435,Staff,14,0,15,1
1653594550131,MATH 270A,A00,087436,Nie; Jiawang,0,0,8,8
1653594550653,MATH 272A,A00,087437,Tian; Xiaochuan,0,0,8,8
1653594551186,MATH 274,A01,087439,Cheng; Li-Tien,9,0,10,1
1653594551186,MATH 274,A02,087440,Cheng; Li-Tien,10,0,10,0
1653594551713,MATH 278A,A00,087441,Staff,8,0,10,2
1653594552245,MATH 278B,A00,087442,Staff,8,0,10,2
1653594552774,MATH 278C,A00,087443,Staff,8,0,10,2
1653594553302,MATH 280A,A00,087444,Zheng; Tianyi,0,0,8,8
1653594553840,MATH 281A,A00,087445,Bradic; Jelena,0,0,8,8
1653594554368,MATH 282A,A00,087446,Zhang; Danna,0,0,8,8
1653594554914,MATH 283,A00,087447,Tesler; Glenn,0,0,0,16
1653594555455,MATH 286,B00,095535,Kemp; Todd Aahron,8,0,8,0
1653594556003,MATH 287D,B00,095536,Bradic; Jelena,5,0,8,3
1653594556554,MATH 288,A00,087450,Staff,14,0,15,1
1653594556554,MATH 288,B00,087451,Staff,15,0,15,0
1653594556554,MATH 288,C00,087452,Staff,15,0,15,0
1653594557105,MATH 290A,A00,087453,Xu; Zhouli,6,0,8,2
1653594557644,MATH 291A,A00,087454,Xu; Zhouli,7,0,8,1
1653594558171,MATH 292,A00,087455,Staff,10,0,10,0
1653594558715,MATH 295,A00,087456,Staff,50,0,50,0
1653594559238,MATH 297,001,087457,Staff,997,0,999,2
1653595131173,COGS 200,A01,087991,Staff,47,0,50,3
1653595131708,COGS 201,A01,094504,Rangel; Lara M,16,0,25,9
1653595132241,COGS 203,A00,087992,Coulson; Seana M,18,0,20,2
1653595132764,COGS 210A,001,087993,Greene; Deanna Jacquelyn,9998,0,9999,1
1653595132764,COGS 210A,002,087994,Saygin; Ayse P,9999,0,9999,0
1653595132764,COGS 210A,003,087995,Xia; Haijun,9999,0,9999,0
1653595132764,COGS 210A,004,087996,Nitz; Douglas A.,9999,0,9999,0
1653595132764,COGS 210A,005,087997,Hollan; James D.,9999,0,9999,0
1653595132764,COGS 210A,006,087998,Deak; Gedeon O.,9998,0,9999,1
1653595132764,COGS 210A,007,087999,Rossano; Federico,9999,0,9999,0
1653595133287,COGS 211A,A00,088000,Coulson; Seana M,9997,0,9999,2
1653595133828,COGS 229,A00,088002,Staff,22,0,25,3
1653595134367,COGS 260,B00,094231,Staff,17,0,20,3
1653595134367,COGS 260,A00,088004,Nitz; Douglas A.,9998,0,9999,1
1653595134898,CSE 202,A00,090110,Paturi; Ramamohan,0,0,0,0
1653595134898,CSE 202,B00,090111,Paturi; Ramamohan,0,0,0,0
1653595135435,CSE 207B,A00,090112,Heninger; Nadia A,0,0,0,0
1653595135966,CSE 208,A00,094858,Micciancio; Daniele,0,0,0,0
1653595136491,CSE 210,A00,090113,Powell; Thomas Allan,0,0,0,0
1653595137021,CSE 219,A00,090898,Staff,0,0,0,0
1653595137545,CSE 221,A00,090114,Zhou; Yuan-Yuan,0,0,0,0
1653595138093,CSE 229A,A00,090115,Porter; George M,0,0,0,0
1653595138637,CSE 229C,A00,090116,Savage; Stefan,0,0,0,0
1653595139190,CSE 230,A00,090117,Jhala; Ranjit,0,0,0,0
1653595139739,CSE 232,A00,090118,Papakonstantinou; Yannis,0,0,0,0
1653595140264,CSE 239A,A00,090121,Kumar; Arun Kumar,0,0,0,0
1653595140798,CSE 239B,A00,090122,Jhala; Ranjit,0,0,0,0
1653595141328,CSE 240A,A00,090123,Zhao; Jishen,0,0,189,189
1653595141865,CSE 243A,A00,090124,Orailoglu; Alex,0,0,15,15
1653595142389,CSE 249B,A00,090125,Kahng; Andrew Byun,12,0,20,8
1653595142935,CSE 250A,A00,090126,Berg-Kirkpatrick; Taylor D,0,0,0,0
1653595143479,CSE 252A,A00,090127,Ochoa; Benjamin Lawrence,0,0,0,0
1653595144020,CSE 258,A01,090129,McAuley; Julian John,0,0,0,0
1653595144571,CSE 258R,A01,090131,McAuley; Julian John,0,0,0,0
1653595145118,CSE 274,A00,090132,Ramamoorthi; Ravi,0,0,0,0
1653595145641,CSE 276A,A00,090133,Christensen; Henrik I,0,0,0,0
1653595146164,CSE 276C,A00,090134,Christensen; Henrik I,0,0,0,0
1653595146701,CSE 290,A00,090135,Bafna; Vineet,0,0,0,0
1653595146701,CSE 290,B00,090136,Ramamoorthi; Ravi,0,0,0,0
1653595146701,CSE 290,C00,090137,Li; Tzumao,7,0,10,3
1653595146701,CSE 290,D00,090138,Zhou; Yuan-Yuan,9,0,10,1
1653595146701,CSE 290,E00,090139,Christensen; Henrik I,8,0,10,2
1653595146701,CSE 290,F00,094053,Shalev; Aaron D,0,0,0,0
1653595147232,CSE 291,A00,090140,Munyaka; Imani N. S.,0,0,0,0
1653595147232,CSE 291,B00,094880,Yu; Qi,0,0,0,0
1653595147232,CSE 291,C00,090142,Pannuto; Patrick William,0,0,0,0
1653595147232,CSE 291,D00,094881,Zhang; Yiying,0,0,0,0
1653595147232,CSE 291,E00,095118,Su; Hao,0,0,0,0
1653595147770,CSE 293,001,094905,Bafna; Vineet,9999,0,9999,0
1653595147770,CSE 293,002,094906,Bellare; Mihir,9999,0,9999,0
1653595147770,CSE 293,003,094907,Berg-Kirkpatrick; Taylor D,9999,0,9999,0
1653595147770,CSE 293,004,094908,Christensen; Henrik I,9999,0,9999,0
1653595147770,CSE 293,005,094909,Cottrell; Garrison W,9999,0,9999,0
1653595147770,CSE 293,006,094910,Deutsch; Alin Bernard,9999,0,9999,0
1653595147770,CSE 293,007,094911,Esmaeilzadeh; Hadi,9999,0,9999,0
1653595147770,CSE 293,008,094912,Freund; Yoav,9999,0,9999,0
1653595147770,CSE 293,009,094913,Griswold; William G.,9999,0,9999,0
1653595147770,CSE 293,010,094914,Gymrek; Melissa Ann,9999,0,9999,0
1653595147770,CSE 293,011,094915,Heninger; Nadia A,9999,0,9999,0
1653595147770,CSE 293,012,094916,Impagliazzo; Russell,9999,0,9999,0
1653595147770,CSE 293,013,094917,Jhala; Ranjit,9999,0,9999,0
1653595147770,CSE 293,014,094918,Kahng; Andrew Byun,9999,0,9999,0
1653595147770,CSE 293,015,094919,Kane; Daniel Mertz,9999,0,9999,0
1653595147770,CSE 293,016,094920,Kriegman; David J,9999,0,9999,0
1653595147770,CSE 293,017,094921,Kumar; Arun Kumar,9999,0,9999,0
1653595147770,CSE 293,018,094922,Lerner; Sorin,9999,0,9999,0
1653595147770,CSE 293,019,094923,Lovett; Shachar,9999,0,9999,0
1653595147770,CSE 293,020,094924,McAuley; Julian John,9999,0,9999,0
1653595147770,CSE 293,021,094925,Micciancio; Daniele,9999,0,9999,0
1653595147770,CSE 293,022,094926,Orailoglu; Alex,9999,0,9999,0
1653595147770,CSE 293,023,094927,Paturi; Ramamohan,9999,0,9999,0
1653595147770,CSE 293,024,094928,Polikarpova; Nadezhda,9999,0,9999,0
1653595147770,CSE 293,025,094929,Politz; Joseph Gibbs,9999,0,9999,0
1653595147770,CSE 293,026,094930,Porter; George M,9999,0,9999,0
1653595147770,CSE 293,027,094931,Porter; Leonard Emerson,9999,0,9999,0
1653595147770,CSE 293,028,094932,Ramamoorthi; Ravi,9999,0,9999,0
1653595147770,CSE 293,029,094933,Sahoo; Debashis,9999,0,9999,0
1653595147770,CSE 293,030,094934,Saul; Lawrence,9999,0,9999,0
1653595147770,CSE 293,031,094935,Savage; Stefan,9999,0,9999,0
1653595147770,CSE 293,032,094936,Schulze; Jurgen P.,9999,0,9999,0
1653595147770,CSE 293,033,094937,Snoeren; Alex C.,9999,0,9999,0
1653595147770,CSE 293,034,094938,Shang; Jingbo,9999,0,9999,0
1653595147770,CSE 293,035,094939,Stefan; Deian,9999,0,9999,0
1653595147770,CSE 293,036,094940,Su; Hao,9999,0,9999,0
1653595147770,CSE 293,037,094941,Swanson; Steven James,9999,0,9999,0
1653595147770,CSE 293,038,094942,Tullsen; Dean Michael,9999,0,9999,0
1653595147770,CSE 293,039,094943,Voelker; Geoffrey M.,9999,0,9999,0
1653595147770,CSE 293,040,094944,Zhao; Jishen,9999,0,9999,0
1653595147770,CSE 293,041,094945,Zhou; Yuan-Yuan,9999,0,9999,0
1653595147770,CSE 293,042,094946,Gao; Sicun,9998,0,9999,1
1653595147770,CSE 293,043,094947,Weibel; Nadir,9999,0,9999,0
1653595147770,CSE 293,044,094948,Gupta; Rajesh K.,9999,0,9999,0
1653595148314,CSE 294,A00,090143,Porter; George M,8,0,10,2
1653595148861,DSE 200,A00,091799,Staff,50,0,50,0
1653595149395,DSE 203,A00,091800,Gupta; Amarnath,30,0,30,0
1653595149945,DSE 250,A00,091801,Deutsch; Alin Bernard,30,0,30,0
1653595150467,DSE 290,A00,091802,Altintas De Callaf; Ilkay,50,0,50,0
1653595151042,ECE 200,001,091003,Antipa; Nicholas A,9999,0,9999,0
1653595151042,ECE 200,002,091004,Atanasov; Nikolay A.,9999,0,9999,0
1653595151042,ECE 200,003,091005,Bharadia; Dinesh,9999,0,9999,0
1653595151042,ECE 200,004,091006,Cheng; Chung Kuan,9999,0,9999,0
1653595151042,ECE 200,005,091007,Cosman; Pamela C.,9999,0,9999,0
1653595151042,ECE 200,006,091008,Staff,9999,0,9999,0
1653595151042,ECE 200,007,091009,Dayeh; Shadi Ahmad,9999,0,9999,0
1653595151042,ECE 200,008,091010,Fainman; Yeshaiahu,9999,0,9999,0
1653595151042,ECE 200,009,091011,Ford; Joseph Earl,9999,0,9999,0
1653595151042,ECE 200,010,091012,Franceschetti; Massimo,9999,0,9999,0
1653595151042,ECE 200,011,091013,Fullerton; Eric E,9999,0,9999,0
1653595151042,ECE 200,012,091014,Galton; Ian A,9999,0,9999,0
1653595151042,ECE 200,013,091015,Gilja; Vikash,9999,0,9999,0
1653595151042,ECE 200,014,091016,Hall; Drew A.,9999,0,9999,0
1653595151042,ECE 200,015,091017,Hsueh; Tzu-Chien,9999,0,9999,0
1653595151042,ECE 200,016,091018,Javidi; Tara,9999,0,9999,0
1653595151042,ECE 200,017,091019,Kahng; Andrew Byun,9999,0,9999,0
1653595151042,ECE 200,018,091020,Kim; Young-Han,9999,0,9999,0
1653595151042,ECE 200,019,091021,Koushanfar; Farinaz,9999,0,9999,0
1653595151042,ECE 200,020,091022,Kuzum; Duygu,9999,0,9999,0
1653595151042,ECE 200,021,091023,Le; Hanh-Phuc,9999,0,9999,0
1653595151042,ECE 200,022,091024,Lin; Bill,9999,0,9999,0
1653595151042,ECE 200,023,091025,Liu; Zhaowei,9999,0,9999,0
1653595151042,ECE 200,024,091026,Lo; Yu-Hwa,9999,0,9999,0
1653595151042,ECE 200,025,091027,Lomakin; Vitaliy,9999,0,9999,0
1653595151042,ECE 200,026,091028,Mercier; Patrick Philip,9999,0,9999,0
1653595151042,ECE 200,027,091029,Meyer; Florian,9999,0,9999,0
1653595151042,ECE 200,028,091030,Milstein; Laurence B.,9999,0,9999,0
1653595151042,ECE 200,029,091031,Mir Arabbaygi; Siavash,9999,0,9999,0
1653595151042,ECE 200,030,091032,Mookherjea; Shayan,9999,0,9999,0
1653595151042,ECE 200,031,091033,Morris; Karcher William,9999,0,9999,0
1653595151042,ECE 200,032,091034,Ng; Tse Nga,9999,0,9999,0
1653595151042,ECE 200,033,091035,Nguyen; Truong Quang,9999,0,9999,0
1653595151042,ECE 200,034,091036,Nomura; Kenji,9999,0,9999,0
1653595151042,ECE 200,035,091037,Orlitsky; Alon,9999,0,9999,0
1653595151042,ECE 200,036,091038,Pal; Piya,9999,0,9999,0
1653595151042,ECE 200,037,091039,Papen; George C.,9999,0,9999,0
1653595151042,ECE 200,038,091040,Radic; Stojan,9999,0,9999,0
1653595151042,ECE 200,039,091041,Rao; Bhaskar D.,9999,0,9999,0
1653595151042,ECE 200,040,091042,Rao; Ramesh R,9999,0,9999,0
1653595151042,ECE 200,041,091043,Rebeiz; Gabriel,9999,0,9999,0
1653595151042,ECE 200,042,091044,Sanford; John R,9999,0,9999,0
1653595151042,ECE 200,043,091045,Siegel; Paul H.,9999,0,9999,0
1653595151042,ECE 200,044,091046,Sievenpiper; Daniel F.,9999,0,9999,0
1653595151042,ECE 200,045,091047,Sworder; David D.,9999,0,9999,0
1653595151042,ECE 200,046,091048,Taur; Yuan,9999,0,9999,0
1653595151042,ECE 200,047,091049,Touri; Behrouz,9999,0,9999,0
1653595151042,ECE 200,048,091050,Trivedi; Mohan M.,9999,0,9999,0
1653595151042,ECE 200,049,091051,Vardy; Alexander,9999,0,9999,0
1653595151042,ECE 200,050,091052,Vasconcelos; Nuno,9999,0,9999,0
1653595151042,ECE 200,051,091053,Wang; Xiaolong,9999,0,9999,0
1653595151042,ECE 200,052,091054,Xie; Pengtao,9999,0,9999,0
1653595151042,ECE 200,053,091055,Yip; Michael,9999,0,9999,0
1653595151042,ECE 200,054,091056,Zeger; Kenneth A.,9999,0,9999,0
1653595151042,ECE 200,055,091057,Zhang; Xinyu,9999,0,9999,0
1653595151042,ECE 200,056,091058,Turakhia; Yatish Girish,9999,0,9999,0
1653595151042,ECE 200,057,091059,Kang; Mingu,9999,0,9999,0
1653595151042,ECE 200,058,091060,Shi; Yuanyuan,9999,0,9999,0
1653595151042,ECE 200,059,091061,Wang; Edward Jay,9999,0,9999,0
1653595151042,ECE 200,060,091062,Zheng; Yang,9999,0,9999,0
1653595151565,ECE 201,A00,095526,Lo; Yu-Hwa,0,0,0,0
1653595152102,ECE 203,A00,091065,Mercier; Patrick Philip,0,0,0,0
1653595152627,ECE 207A,A00,091605,Liu; Thomas Tao-Ming,0,0,0,0
1653595153156,ECE 212AN,A00,091068,Nomura; Kenji,0,0,0,0
1653595153680,ECE 222A,A00,091069,Rebeiz; Gabriel,0,0,0,0
1653595154220,ECE 225A,A00,091070,Orlitsky; Alon,0,0,0,0
1653595154744,ECE 230A,A00,091071,Nomura; Kenji,0,0,0,0
1653595155277,ECE 236A,A00,091072,Dayeh; Shadi Ahmad,0,0,0,0
1653595155808,ECE 238A,A00,091073,Luo; Jian,0,0,0,0
1653595155808,ECE 238A,B00,091074,Luo; Jian,0,0,0,0
1653595156335,ECE 240A,A00,091075,Radic; Stojan,0,0,0,0
1653595156860,ECE 247A,A00,091592,Shi; Lingyan,0,0,0,0
1653595157413,ECE 250,A00,091076,Touri; Behrouz,0,0,0,0
1653595157961,ECE 251C,A00,091078,Nguyen; Truong Quang,0,0,0,0
1653595158486,ECE 253,A00,091079,Cosman; Pamela C.,0,0,0,0
1653595159042,ECE 255A,A00,091080,Orlitsky; Alon,0,0,0,0
1653595159574,ECE 257A,A00,091081,Zhang; Xinyu,0,0,0,0
1653595160104,ECE 260A,A01,091084,Eldon; John,0,0,0,0
1653595160636,ECE 264C,A00,091085,Galton; Ian A,0,0,0,0
1653595161171,ECE 265C,A00,094889,Presti; Calogero Davide,0,0,0,9
1653595161707,ECE 266,A01,091087,Hall; Drew A.,0,0,0,0
1653595162759,ECE 271A,A00,091090,Vasconcelos; Nuno,0,0,0,0
1653595163303,ECE 272B,A00,091091,Sworder; David D.,0,0,0,0
1653595163837,ECE 275A,A00,091092,Meyer; Florian,0,0,0,0
1653595164380,ECE 277,A00,091093,An; Cheolhong,0,0,0,0
1653595164905,ECE 283,A00,091094,Le; Hanh-Phuc,0,0,0,0
1653595165431,ECE 284,A00,091095,Kang; Mingu,0,0,0,0
1653595165431,ECE 284,B00,091096,Wang; Edward Jay,0,0,0,0
1653595165958,ECE 285,A00,094334,Touri; Behrouz,0,0,0,0
1653595166493,ECE 289,A00,091097,Whelan; David Arthur,0,0,0,0
1653595167032,MATH 200A,A00,087414,Salehi Golsefidy; Alireza,7,0,8,1
1653595167567,MATH 202A,A00,087415,Gill; Philip E.,2,0,8,6
1653595168101,MATH 203A,A00,087416,Oprea; Dragos N.,6,0,8,2
1653595168634,MATH 204A,A00,087417,Kedlaya; Kiran S.,6,0,8,2
1653595169181,MATH 205,A00,087418,Sorensen; Claus M,6,0,8,2
1653595169725,MATH 206A,A00,087419,Izadi; Elham,7,0,8,1
1653595170254,MATH 207A,A00,087420,Mohammadi; Amir,5,0,8,3
1653595170803,MATH 208,A00,087421,Staff,9,0,10,1
1653595171328,MATH 209,A00,087422,Staff,10,0,10,0
1653595171854,MATH 218,A00,087423,Staff,10,0,10,0
1653595172380,MATH 220A,A00,087424,Novak; Jonathan I,6,0,8,2
1653595172910,MATH 231A,A00,087425,Bejenaru; Ioan,3,0,8,5
1653595173581,MATH 240A,A00,087426,Ebenfelt; Peter F,5,0,8,3
1653595174116,MATH 243,A00,087427,Staff,9,0,10,1
1653595174667,MATH 248,A00,087429,Staff,10,0,10,0
1653595175194,MATH 250A,A00,087430,Spolaor; Luca,4,0,8,4
1653595175727,MATH 257A,A00,087431,Spolaor; Luca,7,0,8,1
1653595176260,MATH 258,A00,087432,Staff,9,0,10,1
1653595176803,MATH 264A,A00,087433,Warnke; Lutz Peter,5,0,8,3
1653595177327,MATH 268,A00,087434,Staff,15,0,15,0
1653595177860,MATH 269,A00,087435,Staff,14,0,15,1
1653595178391,MATH 270A,A00,087436,Nie; Jiawang,0,0,8,8
1653595178931,MATH 272A,A00,087437,Tian; Xiaochuan,0,0,8,8
1653595179476,MATH 274,A01,087439,Cheng; Li-Tien,9,0,10,1
1653595179476,MATH 274,A02,087440,Cheng; Li-Tien,10,0,10,0
1653595179999,MATH 278A,A00,087441,Staff,8,0,10,2
1653595180545,MATH 278B,A00,087442,Staff,8,0,10,2
1653595181094,MATH 278C,A00,087443,Staff,8,0,10,2
1653595181631,MATH 280A,A00,087444,Zheng; Tianyi,0,0,8,8
1653595182165,MATH 281A,A00,087445,Bradic; Jelena,0,0,8,8
1653595182709,MATH 282A,A00,087446,Zhang; Danna,0,0,8,8
1653595183243,MATH 283,A00,087447,Tesler; Glenn,0,0,0,16
1653595183782,MATH 286,B00,095535,Kemp; Todd Aahron,8,0,8,0
1653595184317,MATH 287D,B00,095536,Bradic; Jelena,5,0,8,3
1653595184849,MATH 288,A00,087450,Staff,14,0,15,1
1653595184849,MATH 288,B00,087451,Staff,15,0,15,0
1653595184849,MATH 288,C00,087452,Staff,15,0,15,0
1653595185397,MATH 290A,A00,087453,Xu; Zhouli,6,0,8,2
1653595185930,MATH 291A,A00,087454,Xu; Zhouli,7,0,8,1
1653595186484,MATH 292,A00,087455,Staff,10,0,10,0
1653595187009,MATH 295,A00,087456,Staff,50,0,50,0
1653595187532,MATH 297,001,087457,Staff,997,0,999,2
1653595757433,COGS 200,A01,087991,Staff,47,0,50,3
1653595757973,COGS 201,A01,094504,Rangel; Lara M,16,0,25,9
1653595758520,COGS 203,A00,087992,Coulson; Seana M,18,0,20,2
1653595759061,COGS 210A,001,087993,Greene; Deanna Jacquelyn,9998,0,9999,1
1653595759061,COGS 210A,002,087994,Saygin; Ayse P,9999,0,9999,0
1653595759061,COGS 210A,003,087995,Xia; Haijun,9999,0,9999,0
1653595759061,COGS 210A,004,087996,Nitz; Douglas A.,9999,0,9999,0
1653595759061,COGS 210A,005,087997,Hollan; James D.,9999,0,9999,0
1653595759061,COGS 210A,006,087998,Deak; Gedeon O.,9998,0,9999,1
1653595759061,COGS 210A,007,087999,Rossano; Federico,9999,0,9999,0
1653595759602,COGS 211A,A00,088000,Coulson; Seana M,9997,0,9999,2
1653595760143,COGS 229,A00,088002,Staff,22,0,25,3
1653595760683,COGS 260,B00,094231,Staff,17,0,20,3
1653595760683,COGS 260,A00,088004,Nitz; Douglas A.,9998,0,9999,1
1653595761231,CSE 202,A00,090110,Paturi; Ramamohan,0,0,0,0
1653595761231,CSE 202,B00,090111,Paturi; Ramamohan,0,0,0,0
1653595761768,CSE 207B,A00,090112,Heninger; Nadia A,0,0,0,0
1653595762291,CSE 208,A00,094858,Micciancio; Daniele,0,0,0,0
1653595762814,CSE 210,A00,090113,Powell; Thomas Allan,0,0,0,0
1653595763345,CSE 219,A00,090898,Staff,0,0,0,0
1653595763874,CSE 221,A00,090114,Zhou; Yuan-Yuan,0,0,0,0
1653595764399,CSE 229A,A00,090115,Porter; George M,0,0,0,0
1653595764931,CSE 229C,A00,090116,Savage; Stefan,0,0,0,0
1653595765469,CSE 230,A00,090117,Jhala; Ranjit,0,0,0,0
1653595766013,CSE 232,A00,090118,Papakonstantinou; Yannis,0,0,0,0
1653595766561,CSE 239A,A00,090121,Kumar; Arun Kumar,0,0,0,0
1653595767115,CSE 239B,A00,090122,Jhala; Ranjit,0,0,0,0
1653595767661,CSE 240A,A00,090123,Zhao; Jishen,0,0,189,189
1653595768197,CSE 243A,A00,090124,Orailoglu; Alex,0,0,15,15
1653595768729,CSE 249B,A00,090125,Kahng; Andrew Byun,12,0,20,8
1653595769255,CSE 250A,A00,090126,Berg-Kirkpatrick; Taylor D,0,0,0,0
1653595769779,CSE 252A,A00,090127,Ochoa; Benjamin Lawrence,0,0,0,0
1653595770317,CSE 258,A01,090129,McAuley; Julian John,0,0,0,0
1653595770853,CSE 258R,A01,090131,McAuley; Julian John,0,0,0,0
1653595771479,CSE 274,A00,090132,Ramamoorthi; Ravi,0,0,0,0
1653595772014,CSE 276A,A00,090133,Christensen; Henrik I,0,0,0,0
1653595772553,CSE 276C,A00,090134,Christensen; Henrik I,0,0,0,0
1653595773091,CSE 290,A00,090135,Bafna; Vineet,0,0,0,0
1653595773091,CSE 290,B00,090136,Ramamoorthi; Ravi,0,0,0,0
1653595773091,CSE 290,C00,090137,Li; Tzumao,7,0,10,3
1653595773091,CSE 290,D00,090138,Zhou; Yuan-Yuan,9,0,10,1
1653595773091,CSE 290,E00,090139,Christensen; Henrik I,8,0,10,2
1653595773091,CSE 290,F00,094053,Shalev; Aaron D,0,0,0,0
1653595773639,CSE 291,A00,090140,Munyaka; Imani N. S.,0,0,0,0
1653595773639,CSE 291,B00,094880,Yu; Qi,0,0,0,0
1653595773639,CSE 291,C00,090142,Pannuto; Patrick William,0,0,0,0
1653595773639,CSE 291,D00,094881,Zhang; Yiying,0,0,0,0
1653595773639,CSE 291,E00,095118,Su; Hao,0,0,0,0
1653595774201,CSE 293,001,094905,Bafna; Vineet,9999,0,9999,0
1653595774201,CSE 293,002,094906,Bellare; Mihir,9999,0,9999,0
1653595774201,CSE 293,003,094907,Berg-Kirkpatrick; Taylor D,9999,0,9999,0
1653595774201,CSE 293,004,094908,Christensen; Henrik I,9999,0,9999,0
1653595774201,CSE 293,005,094909,Cottrell; Garrison W,9999,0,9999,0
1653595774201,CSE 293,006,094910,Deutsch; Alin Bernard,9999,0,9999,0
1653595774201,CSE 293,007,094911,Esmaeilzadeh; Hadi,9999,0,9999,0
1653595774201,CSE 293,008,094912,Freund; Yoav,9999,0,9999,0
1653595774201,CSE 293,009,094913,Griswold; William G.,9999,0,9999,0
1653595774201,CSE 293,010,094914,Gymrek; Melissa Ann,9999,0,9999,0
1653595774201,CSE 293,011,094915,Heninger; Nadia A,9999,0,9999,0
1653595774201,CSE 293,012,094916,Impagliazzo; Russell,9999,0,9999,0
1653595774201,CSE 293,013,094917,Jhala; Ranjit,9999,0,9999,0
1653595774201,CSE 293,014,094918,Kahng; Andrew Byun,9999,0,9999,0
1653595774201,CSE 293,015,094919,Kane; Daniel Mertz,9999,0,9999,0
1653595774201,CSE 293,016,094920,Kriegman; David J,9999,0,9999,0
1653595774201,CSE 293,017,094921,Kumar; Arun Kumar,9999,0,9999,0
1653595774201,CSE 293,018,094922,Lerner; Sorin,9999,0,9999,0
1653595774201,CSE 293,019,094923,Lovett; Shachar,9999,0,9999,0
1653595774201,CSE 293,020,094924,McAuley; Julian John,9999,0,9999,0
1653595774201,CSE 293,021,094925,Micciancio; Daniele,9999,0,9999,0
1653595774201,CSE 293,022,094926,Orailoglu; Alex,9999,0,9999,0
1653595774201,CSE 293,023,094927,Paturi; Ramamohan,9999,0,9999,0
1653595774201,CSE 293,024,094928,Polikarpova; Nadezhda,9999,0,9999,0
1653595774201,CSE 293,025,094929,Politz; Joseph Gibbs,9999,0,9999,0
1653595774201,CSE 293,026,094930,Porter; George M,9999,0,9999,0
1653595774201,CSE 293,027,094931,Porter; Leonard Emerson,9999,0,9999,0
1653595774201,CSE 293,028,094932,Ramamoorthi; Ravi,9999,0,9999,0
1653595774201,CSE 293,029,094933,Sahoo; Debashis,9999,0,9999,0
1653595774201,CSE 293,030,094934,Saul; Lawrence,9999,0,9999,0
1653595774201,CSE 293,031,094935,Savage; Stefan,9999,0,9999,0
1653595774201,CSE 293,032,094936,Schulze; Jurgen P.,9999,0,9999,0
1653595774201,CSE 293,033,094937,Snoeren; Alex C.,9999,0,9999,0
1653595774201,CSE 293,034,094938,Shang; Jingbo,9999,0,9999,0
1653595774201,CSE 293,035,094939,Stefan; Deian,9999,0,9999,0
1653595774201,CSE 293,036,094940,Su; Hao,9999,0,9999,0
1653595774201,CSE 293,037,094941,Swanson; Steven James,9999,0,9999,0
1653595774201,CSE 293,038,094942,Tullsen; Dean Michael,9999,0,9999,0
1653595774201,CSE 293,039,094943,Voelker; Geoffrey M.,9999,0,9999,0
1653595774201,CSE 293,040,094944,Zhao; Jishen,9999,0,9999,0
1653595774201,CSE 293,041,094945,Zhou; Yuan-Yuan,9999,0,9999,0
1653595774201,CSE 293,042,094946,Gao; Sicun,9998,0,9999,1
1653595774201,CSE 293,043,094947,Weibel; Nadir,9999,0,9999,0
1653595774201,CSE 293,044,094948,Gupta; Rajesh K.,9999,0,9999,0
1653595774726,CSE 294,A00,090143,Porter; George M,8,0,10,2
1653595775253,DSE 200,A00,091799,Staff,50,0,50,0
1653595775776,DSE 203,A00,091800,Gupta; Amarnath,30,0,30,0
1653595776299,DSE 250,A00,091801,Deutsch; Alin Bernard,30,0,30,0
1653595776824,DSE 290,A00,091802,Altintas De Callaf; Ilkay,50,0,50,0
1653595777372,ECE 200,001,091003,Antipa; Nicholas A,9999,0,9999,0
1653595777372,ECE 200,002,091004,Atanasov; Nikolay A.,9999,0,9999,0
1653595777372,ECE 200,003,091005,Bharadia; Dinesh,9999,0,9999,0
1653595777372,ECE 200,004,091006,Cheng; Chung Kuan,9999,0,9999,0
1653595777372,ECE 200,005,091007,Cosman; Pamela C.,9999,0,9999,0
1653595777372,ECE 200,006,091008,Staff,9999,0,9999,0
1653595777372,ECE 200,007,091009,Dayeh; Shadi Ahmad,9999,0,9999,0
1653595777372,ECE 200,008,091010,Fainman; Yeshaiahu,9999,0,9999,0
1653595777372,ECE 200,009,091011,Ford; Joseph Earl,9999,0,9999,0
1653595777372,ECE 200,010,091012,Franceschetti; Massimo,9999,0,9999,0
1653595777372,ECE 200,011,091013,Fullerton; Eric E,9999,0,9999,0
1653595777372,ECE 200,012,091014,Galton; Ian A,9999,0,9999,0
1653595777372,ECE 200,013,091015,Gilja; Vikash,9999,0,9999,0
1653595777372,ECE 200,014,091016,Hall; Drew A.,9999,0,9999,0
1653595777372,ECE 200,015,091017,Hsueh; Tzu-Chien,9999,0,9999,0
1653595777372,ECE 200,016,091018,Javidi; Tara,9999,0,9999,0
1653595777372,ECE 200,017,091019,Kahng; Andrew Byun,9999,0,9999,0
1653595777372,ECE 200,018,091020,Kim; Young-Han,9999,0,9999,0
1653595777372,ECE 200,019,091021,Koushanfar; Farinaz,9999,0,9999,0
1653595777372,ECE 200,020,091022,Kuzum; Duygu,9999,0,9999,0
1653595777372,ECE 200,021,091023,Le; Hanh-Phuc,9999,0,9999,0
1653595777372,ECE 200,022,091024,Lin; Bill,9999,0,9999,0
1653595777372,ECE 200,023,091025,Liu; Zhaowei,9999,0,9999,0
1653595777372,ECE 200,024,091026,Lo; Yu-Hwa,9999,0,9999,0
1653595777372,ECE 200,025,091027,Lomakin; Vitaliy,9999,0,9999,0
1653595777372,ECE 200,026,091028,Mercier; Patrick Philip,9999,0,9999,0
1653595777372,ECE 200,027,091029,Meyer; Florian,9999,0,9999,0
1653595777372,ECE 200,028,091030,Milstein; Laurence B.,9999,0,9999,0
1653595777372,ECE 200,029,091031,Mir Arabbaygi; Siavash,9999,0,9999,0
1653595777372,ECE 200,030,091032,Mookherjea; Shayan,9999,0,9999,0
1653595777372,ECE 200,031,091033,Morris; Karcher William,9999,0,9999,0
1653595777372,ECE 200,032,091034,Ng; Tse Nga,9999,0,9999,0
1653595777372,ECE 200,033,091035,Nguyen; Truong Quang,9999,0,9999,0
1653595777372,ECE 200,034,091036,Nomura; Kenji,9999,0,9999,0
1653595777372,ECE 200,035,091037,Orlitsky; Alon,9999,0,9999,0
1653595777372,ECE 200,036,091038,Pal; Piya,9999,0,9999,0
1653595777372,ECE 200,037,091039,Papen; George C.,9999,0,9999,0
1653595777372,ECE 200,038,091040,Radic; Stojan,9999,0,9999,0
1653595777372,ECE 200,039,091041,Rao; Bhaskar D.,9999,0,9999,0
1653595777372,ECE 200,040,091042,Rao; Ramesh R,9999,0,9999,0
1653595777372,ECE 200,041,091043,Rebeiz; Gabriel,9999,0,9999,0
1653595777372,ECE 200,042,091044,Sanford; John R,9999,0,9999,0
1653595777372,ECE 200,043,091045,Siegel; Paul H.,9999,0,9999,0
1653595777372,ECE 200,044,091046,Sievenpiper; Daniel F.,9999,0,9999,0
1653595777372,ECE 200,045,091047,Sworder; David D.,9999,0,9999,0
1653595777372,ECE 200,046,091048,Taur; Yuan,9999,0,9999,0
1653595777372,ECE 200,047,091049,Touri; Behrouz,9999,0,9999,0
1653595777372,ECE 200,048,091050,Trivedi; Mohan M.,9999,0,9999,0
1653595777372,ECE 200,049,091051,Vardy; Alexander,9999,0,9999,0
1653595777372,ECE 200,050,091052,Vasconcelos; Nuno,9999,0,9999,0
1653595777372,ECE 200,051,091053,Wang; Xiaolong,9999,0,9999,0
1653595777372,ECE 200,052,091054,Xie; Pengtao,9999,0,9999,0
1653595777372,ECE 200,053,091055,Yip; Michael,9999,0,9999,0
1653595777372,ECE 200,054,091056,Zeger; Kenneth A.,9999,0,9999,0
1653595777372,ECE 200,055,091057,Zhang; Xinyu,9999,0,9999,0
1653595777372,ECE 200,056,091058,Turakhia; Yatish Girish,9999,0,9999,0
1653595777372,ECE 200,057,091059,Kang; Mingu,9999,0,9999,0
1653595777372,ECE 200,058,091060,Shi; Yuanyuan,9999,0,9999,0
1653595777372,ECE 200,059,091061,Wang; Edward Jay,9999,0,9999,0
1653595777372,ECE 200,060,091062,Zheng; Yang,9999,0,9999,0
1653595777896,ECE 201,A00,095526,Lo; Yu-Hwa,0,0,0,0
1653595778429,ECE 203,A00,091065,Mercier; Patrick Philip,0,0,0,0
1653595778970,ECE 207A,A00,091605,Liu; Thomas Tao-Ming,0,0,0,0
1653595779500,ECE 212AN,A00,091068,Nomura; Kenji,0,0,0,0
1653595780042,ECE 222A,A00,091069,Rebeiz; Gabriel,0,0,0,0
1653595780596,ECE 225A,A00,091070,Orlitsky; Alon,0,0,0,0
1653595781136,ECE 230A,A00,091071,Nomura; Kenji,0,0,0,0
1653595781672,ECE 236A,A00,091072,Dayeh; Shadi Ahmad,0,0,0,0
1653595782230,ECE 238A,A00,091073,Luo; Jian,0,0,0,0
1653595782230,ECE 238A,B00,091074,Luo; Jian,0,0,0,0
1653595782756,ECE 240A,A00,091075,Radic; Stojan,0,0,0,0
1653595783282,ECE 247A,A00,091592,Shi; Lingyan,0,0,0,0
1653595783804,ECE 250,A00,091076,Touri; Behrouz,0,0,0,0
1653595784348,ECE 251C,A00,091078,Nguyen; Truong Quang,0,0,0,0
1653595784879,ECE 253,A00,091079,Cosman; Pamela C.,0,0,0,0
1653595785407,ECE 255A,A00,091080,Orlitsky; Alon,0,0,0,0
1653595785962,ECE 257A,A00,091081,Zhang; Xinyu,0,0,0,0
1653595786506,ECE 260A,A01,091084,Eldon; John,0,0,0,0
1653595787069,ECE 264C,A00,091085,Galton; Ian A,0,0,0,0
1653595787622,ECE 265C,A00,094889,Presti; Calogero Davide,0,0,0,9
1653595788181,ECE 266,A01,091087,Hall; Drew A.,0,0,0,0
1653595789236,ECE 271A,A00,091090,Vasconcelos; Nuno,0,0,0,0
1653595789760,ECE 272B,A00,091091,Sworder; David D.,0,0,0,0
1653595790301,ECE 275A,A00,091092,Meyer; Florian,0,0,0,0
1653595790833,ECE 277,A00,091093,An; Cheolhong,0,0,0,0
1653595791365,ECE 283,A00,091094,Le; Hanh-Phuc,0,0,0,0
1653595791894,ECE 284,A00,091095,Kang; Mingu,0,0,0,0
1653595791894,ECE 284,B00,091096,Wang; Edward Jay,0,0,0,0
1653595792424,ECE 285,A00,094334,Touri; Behrouz,0,0,0,0
1653595792960,ECE 289,A00,091097,Whelan; David Arthur,0,0,0,0
1653595793515,MATH 200A,A00,087414,Salehi Golsefidy; Alireza,7,0,8,1
1653595794046,MATH 202A,A00,087415,Gill; Philip E.,2,0,8,6
1653595794590,MATH 203A,A00,087416,Oprea; Dragos N.,6,0,8,2
1653595795140,MATH 204A,A00,087417,Kedlaya; Kiran S.,6,0,8,2
1653595795680,MATH 205,A00,087418,Sorensen; Claus M,6,0,8,2
1653595796201,MATH 206A,A00,087419,Izadi; Elham,7,0,8,1
1653595796738,MATH 207A,A00,087420,Mohammadi; Amir,5,0,8,3
1653595797264,MATH 208,A00,087421,Staff,9,0,10,1
1653595797791,MATH 209,A00,087422,Staff,10,0,10,0
1653595798316,MATH 218,A00,087423,Staff,10,0,10,0
1653595798838,MATH 220A,A00,087424,Novak; Jonathan I,6,0,8,2
1653595799361,MATH 231A,A00,087425,Bejenaru; Ioan,3,0,8,5
1653595799890,MATH 240A,A00,087426,Ebenfelt; Peter F,5,0,8,3
1653595800413,MATH 243,A00,087427,Staff,9,0,10,1
1653595800958,MATH 248,A00,087429,Staff,10,0,10,0
1653595801481,MATH 250A,A00,087430,Spolaor; Luca,4,0,8,4
1653595802034,MATH 257A,A00,087431,Spolaor; Luca,7,0,8,1
1653595802556,MATH 258,A00,087432,Staff,9,0,10,1
1653595803112,MATH 264A,A00,087433,Warnke; Lutz Peter,5,0,8,3
1653595803668,MATH 268,A00,087434,Staff,15,0,15,0
1653595804223,MATH 269,A00,087435,Staff,14,0,15,1
1653595804753,MATH 270A,A00,087436,Nie; Jiawang,0,0,8,8
1653595805277,MATH 272A,A00,087437,Tian; Xiaochuan,0,0,8,8
1653595805801,MATH 274,A01,087439,Cheng; Li-Tien,9,0,10,1
1653595805801,MATH 274,A02,087440,Cheng; Li-Tien,10,0,10,0
1653595806346,MATH 278A,A00,087441,Staff,8,0,10,2
1653595806868,MATH 278B,A00,087442,Staff,8,0,10,2
1653595807398,MATH 278C,A00,087443,Staff,8,0,10,2
1653595807942,MATH 280A,A00,087444,Zheng; Tianyi,0,0,8,8
1653595808476,MATH 281A,A00,087445,Bradic; Jelena,0,0,8,8
1653595809023,MATH 282A,A00,087446,Zhang; Danna,0,0,8,8
1653595809565,MATH 283,A00,087447,Tesler; Glenn,0,0,0,16
1653595810100,MATH 286,B00,095535,Kemp; Todd Aahron,8,0,8,0
1653595810645,MATH 287D,B00,095536,Bradic; Jelena,5,0,8,3
1653595811188,MATH 288,A00,087450,Staff,14,0,15,1
1653595811188,MATH 288,B00,087451,Staff,15,0,15,0
1653595811188,MATH 288,C00,087452,Staff,15,0,15,0
1653595811731,MATH 290A,A00,087453,Xu; Zhouli,6,0,8,2
1653595812268,MATH 291A,A00,087454,Xu; Zhouli,7,0,8,1
1653595812790,MATH 292,A00,087455,Staff,10,0,10,0
1653595813325,MATH 295,A00,087456,Staff,50,0,50,0
1653595813873,MATH 297,001,087457,Staff,997,0,999,2
1653596385367,COGS 200,A01,087991,Staff,47,0,50,3
1653596385901,COGS 201,A01,094504,Rangel; Lara M,16,0,25,9
1653596386462,COGS 203,A00,087992,Coulson; Seana M,18,0,20,2
1653596387003,COGS 210A,001,087993,Greene; Deanna Jacquelyn,9998,0,9999,1
1653596387003,COGS 210A,002,087994,Saygin; Ayse P,9999,0,9999,0
1653596387003,COGS 210A,003,087995,Xia; Haijun,9999,0,9999,0
1653596387003,COGS 210A,004,087996,Nitz; Douglas A.,9999,0,9999,0
1653596387003,COGS 210A,005,087997,Hollan; James D.,9999,0,9999,0
1653596387003,COGS 210A,006,087998,Deak; Gedeon O.,9998,0,9999,1
1653596387003,COGS 210A,007,087999,Rossano; Federico,9999,0,9999,0
1653596387533,COGS 211A,A00,088000,Coulson; Seana M,9997,0,9999,2
1653596388089,COGS 229,A00,088002,Staff,22,0,25,3
1653596388615,COGS 260,B00,094231,Staff,17,0,20,3
1653596388615,COGS 260,A00,088004,Nitz; Douglas A.,9998,0,9999,1
1653596389142,CSE 202,A00,090110,Paturi; Ramamohan,0,0,0,0
1653596389142,CSE 202,B00,090111,Paturi; Ramamohan,0,0,0,0
1653596389666,CSE 207B,A00,090112,Heninger; Nadia A,0,0,0,0
1653596390208,CSE 208,A00,094858,Micciancio; Daniele,0,0,0,0
1653596390739,CSE 210,A00,090113,Powell; Thomas Allan,0,0,0,0
1653596391264,CSE 219,A00,090898,Staff,0,0,0,0
1653596391804,CSE 221,A00,090114,Zhou; Yuan-Yuan,0,0,0,0
1653596392327,CSE 229A,A00,090115,Porter; George M,0,0,0,0
1653596392852,CSE 229C,A00,090116,Savage; Stefan,0,0,0,0
1653596393385,CSE 230,A00,090117,Jhala; Ranjit,0,0,0,0
1653596393931,CSE 232,A00,090118,Papakonstantinou; Yannis,0,0,0,0
1653596394471,CSE 239A,A00,090121,Kumar; Arun Kumar,0,0,0,0
1653596395019,CSE 239B,A00,090122,Jhala; Ranjit,0,0,0,0
1653596395553,CSE 240A,A00,090123,Zhao; Jishen,0,0,189,189
1653596396112,CSE 243A,A00,090124,Orailoglu; Alex,0,0,15,15
1653596396648,CSE 249B,A00,090125,Kahng; Andrew Byun,12,0,20,8
1653596397193,CSE 250A,A00,090126,Berg-Kirkpatrick; Taylor D,0,0,0,0
1653596397746,CSE 252A,A00,090127,Ochoa; Benjamin Lawrence,0,0,0,0
1653596398285,CSE 258,A01,090129,McAuley; Julian John,0,0,0,0
1653596398821,CSE 258R,A01,090131,McAuley; Julian John,0,0,0,0
1653596399342,CSE 274,A00,090132,Ramamoorthi; Ravi,0,0,0,0
1653596399875,CSE 276A,A00,090133,Christensen; Henrik I,0,0,0,0
1653596400415,CSE 276C,A00,090134,Christensen; Henrik I,0,0,0,0
1653596400940,CSE 290,A00,090135,Bafna; Vineet,0,0,0,0
1653596400940,CSE 290,B00,090136,Ramamoorthi; Ravi,0,0,0,0
1653596400940,CSE 290,C00,090137,Li; Tzumao,7,0,10,3
1653596400940,CSE 290,D00,090138,Zhou; Yuan-Yuan,9,0,10,1
1653596400940,CSE 290,E00,090139,Christensen; Henrik I,8,0,10,2
1653596400940,CSE 290,F00,094053,Shalev; Aaron D,0,0,0,0
1653596401465,CSE 291,A00,090140,Munyaka; Imani N. S.,0,0,0,0
1653596401465,CSE 291,B00,094880,Yu; Qi,0,0,0,0
1653596401465,CSE 291,C00,090142,Pannuto; Patrick William,0,0,0,0
1653596401465,CSE 291,D00,094881,Zhang; Yiying,0,0,0,0
1653596401465,CSE 291,E00,095118,Su; Hao,0,0,0,0
1653596401990,CSE 293,001,094905,Bafna; Vineet,9999,0,9999,0
1653596401990,CSE 293,002,094906,Bellare; Mihir,9999,0,9999,0
1653596401990,CSE 293,003,094907,Berg-Kirkpatrick; Taylor D,9999,0,9999,0
1653596401990,CSE 293,004,094908,Christensen; Henrik I,9999,0,9999,0
1653596401990,CSE 293,005,094909,Cottrell; Garrison W,9999,0,9999,0
1653596401990,CSE 293,006,094910,Deutsch; Alin Bernard,9999,0,9999,0
1653596401990,CSE 293,007,094911,Esmaeilzadeh; Hadi,9999,0,9999,0
1653596401990,CSE 293,008,094912,Freund; Yoav,9999,0,9999,0
1653596401990,CSE 293,009,094913,Griswold; William G.,9999,0,9999,0
1653596401990,CSE 293,010,094914,Gymrek; Melissa Ann,9999,0,9999,0
1653596401990,CSE 293,011,094915,Heninger; Nadia A,9999,0,9999,0
1653596401990,CSE 293,012,094916,Impagliazzo; Russell,9999,0,9999,0
1653596401990,CSE 293,013,094917,Jhala; Ranjit,9999,0,9999,0
1653596401990,CSE 293,014,094918,Kahng; Andrew Byun,9999,0,9999,0
1653596401990,CSE 293,015,094919,Kane; Daniel Mertz,9999,0,9999,0
1653596401990,CSE 293,016,094920,Kriegman; David J,9999,0,9999,0
1653596401990,CSE 293,017,094921,Kumar; Arun Kumar,9999,0,9999,0
1653596401990,CSE 293,018,094922,Lerner; Sorin,9999,0,9999,0
1653596401990,CSE 293,019,094923,Lovett; Shachar,9999,0,9999,0
1653596401990,CSE 293,020,094924,McAuley; Julian John,9999,0,9999,0
1653596401990,CSE 293,021,094925,Micciancio; Daniele,9999,0,9999,0
1653596401990,CSE 293,022,094926,Orailoglu; Alex,9999,0,9999,0
1653596401990,CSE 293,023,094927,Paturi; Ramamohan,9999,0,9999,0
1653596401990,CSE 293,024,094928,Polikarpova; Nadezhda,9999,0,9999,0
1653596401990,CSE 293,025,094929,Politz; Joseph Gibbs,9999,0,9999,0
1653596401990,CSE 293,026,094930,Porter; George M,9999,0,9999,0
1653596401990,CSE 293,027,094931,Porter; Leonard Emerson,9999,0,9999,0
1653596401990,CSE 293,028,094932,Ramamoorthi; Ravi,9999,0,9999,0
1653596401990,CSE 293,029,094933,Sahoo; Debashis,9999,0,9999,0
1653596401990,CSE 293,030,094934,Saul; Lawrence,9999,0,9999,0
1653596401990,CSE 293,031,094935,Savage; Stefan,9999,0,9999,0
1653596401990,CSE 293,032,094936,Schulze; Jurgen P.,9999,0,9999,0
1653596401990,CSE 293,033,094937,Snoeren; Alex C.,9999,0,9999,0
1653596401990,CSE 293,034,094938,Shang; Jingbo,9999,0,9999,0
1653596401990,CSE 293,035,094939,Stefan; Deian,9999,0,9999,0
1653596401990,CSE 293,036,094940,Su; Hao,9999,0,9999,0
1653596401990,CSE 293,037,094941,Swanson; Steven James,9999,0,9999,0
1653596401990,CSE 293,038,094942,Tullsen; Dean Michael,9999,0,9999,0
1653596401990,CSE 293,039,094943,Voelker; Geoffrey M.,9999,0,9999,0
1653596401990,CSE 293,040,094944,Zhao; Jishen,9999,0,9999,0
1653596401990,CSE 293,041,094945,Zhou; Yuan-Yuan,9999,0,9999,0
1653596401990,CSE 293,042,094946,Gao; Sicun,9998,0,9999,1
1653596401990,CSE 293,043,094947,Weibel; Nadir,9999,0,9999,0
1653596401990,CSE 293,044,094948,Gupta; Rajesh K.,9999,0,9999,0
1653596402522,CSE 294,A00,090143,Porter; George M,8,0,10,2
1653596403054,DSE 200,A00,091799,Staff,50,0,50,0
1653596403578,DSE 203,A00,091800,Gupta; Amarnath,30,0,30,0
1653596404123,DSE 250,A00,091801,Deutsch; Alin Bernard,30,0,30,0
1653596404673,DSE 290,A00,091802,Altintas De Callaf; Ilkay,50,0,50,0
1653596405254,ECE 200,001,091003,Antipa; Nicholas A,9999,0,9999,0
1653596405254,ECE 200,002,091004,Atanasov; Nikolay A.,9999,0,9999,0
1653596405254,ECE 200,003,091005,Bharadia; Dinesh,9999,0,9999,0
1653596405254,ECE 200,004,091006,Cheng; Chung Kuan,9999,0,9999,0
1653596405254,ECE 200,005,091007,Cosman; Pamela C.,9999,0,9999,0
1653596405254,ECE 200,006,091008,Staff,9999,0,9999,0
1653596405254,ECE 200,007,091009,Dayeh; Shadi Ahmad,9999,0,9999,0
1653596405254,ECE 200,008,091010,Fainman; Yeshaiahu,9999,0,9999,0
1653596405254,ECE 200,009,091011,Ford; Joseph Earl,9999,0,9999,0
1653596405254,ECE 200,010,091012,Franceschetti; Massimo,9999,0,9999,0
1653596405254,ECE 200,011,091013,Fullerton; Eric E,9999,0,9999,0
1653596405254,ECE 200,012,091014,Galton; Ian A,9999,0,9999,0
1653596405254,ECE 200,013,091015,Gilja; Vikash,9999,0,9999,0
1653596405254,ECE 200,014,091016,Hall; Drew A.,9999,0,9999,0
1653596405254,ECE 200,015,091017,Hsueh; Tzu-Chien,9999,0,9999,0
1653596405254,ECE 200,016,091018,Javidi; Tara,9999,0,9999,0
1653596405254,ECE 200,017,091019,Kahng; Andrew Byun,9999,0,9999,0
1653596405254,ECE 200,018,091020,Kim; Young-Han,9999,0,9999,0
1653596405254,ECE 200,019,091021,Koushanfar; Farinaz,9999,0,9999,0
1653596405254,ECE 200,020,091022,Kuzum; Duygu,9999,0,9999,0
1653596405254,ECE 200,021,091023,Le; Hanh-Phuc,9999,0,9999,0
1653596405254,ECE 200,022,091024,Lin; Bill,9999,0,9999,0
1653596405254,ECE 200,023,091025,Liu; Zhaowei,9999,0,9999,0
1653596405254,ECE 200,024,091026,Lo; Yu-Hwa,9999,0,9999,0
1653596405254,ECE 200,025,091027,Lomakin; Vitaliy,9999,0,9999,0
1653596405254,ECE 200,026,091028,Mercier; Patrick Philip,9999,0,9999,0
1653596405254,ECE 200,027,091029,Meyer; Florian,9999,0,9999,0
1653596405254,ECE 200,028,091030,Milstein; Laurence B.,9999,0,9999,0
1653596405254,ECE 200,029,091031,Mir Arabbaygi; Siavash,9999,0,9999,0
1653596405254,ECE 200,030,091032,Mookherjea; Shayan,9999,0,9999,0
1653596405254,ECE 200,031,091033,Morris; Karcher William,9999,0,9999,0
1653596405254,ECE 200,032,091034,Ng; Tse Nga,9999,0,9999,0
1653596405254,ECE 200,033,091035,Nguyen; Truong Quang,9999,0,9999,0
1653596405254,ECE 200,034,091036,Nomura; Kenji,9999,0,9999,0
1653596405254,ECE 200,035,091037,Orlitsky; Alon,9999,0,9999,0
1653596405254,ECE 200,036,091038,Pal; Piya,9999,0,9999,0
1653596405254,ECE 200,037,091039,Papen; George C.,9999,0,9999,0
1653596405254,ECE 200,038,091040,Radic; Stojan,9999,0,9999,0
1653596405254,ECE 200,039,091041,Rao; Bhaskar D.,9999,0,9999,0
1653596405254,ECE 200,040,091042,Rao; Ramesh R,9999,0,9999,0
1653596405254,ECE 200,041,091043,Rebeiz; Gabriel,9999,0,9999,0
1653596405254,ECE 200,042,091044,Sanford; John R,9999,0,9999,0
1653596405254,ECE 200,043,091045,Siegel; Paul H.,9999,0,9999,0
1653596405254,ECE 200,044,091046,Sievenpiper; Daniel F.,9999,0,9999,0
1653596405254,ECE 200,045,091047,Sworder; David D.,9999,0,9999,0
1653596405254,ECE 200,046,091048,Taur; Yuan,9999,0,9999,0
1653596405254,ECE 200,047,091049,Touri; Behrouz,9999,0,9999,0
1653596405254,ECE 200,048,091050,Trivedi; Mohan M.,9999,0,9999,0
1653596405254,ECE 200,049,091051,Vardy; Alexander,9999,0,9999,0
1653596405254,ECE 200,050,091052,Vasconcelos; Nuno,9999,0,9999,0
1653596405254,ECE 200,051,091053,Wang; Xiaolong,9999,0,9999,0
1653596405254,ECE 200,052,091054,Xie; Pengtao,9999,0,9999,0
1653596405254,ECE 200,053,091055,Yip; Michael,9999,0,9999,0
1653596405254,ECE 200,054,091056,Zeger; Kenneth A.,9999,0,9999,0
1653596405254,ECE 200,055,091057,Zhang; Xinyu,9999,0,9999,0
1653596405254,ECE 200,056,091058,Turakhia; Yatish Girish,9999,0,9999,0
1653596405254,ECE 200,057,091059,Kang; Mingu,9999,0,9999,0
1653596405254,ECE 200,058,091060,Shi; Yuanyuan,9999,0,9999,0
1653596405254,ECE 200,059,091061,Wang; Edward Jay,9999,0,9999,0
1653596405254,ECE 200,060,091062,Zheng; Yang,9999,0,9999,0
1653596405791,ECE 201,A00,095526,Lo; Yu-Hwa,0,0,0,0
1653596406345,ECE 203,A00,091065,Mercier; Patrick Philip,0,0,0,0
1653596406891,ECE 207A,A00,091605,Liu; Thomas Tao-Ming,0,0,0,0
1653596407429,ECE 212AN,A00,091068,Nomura; Kenji,0,0,0,0
1653596407994,ECE 222A,A00,091069,Rebeiz; Gabriel,0,0,0,0
1653596408517,ECE 225A,A00,091070,Orlitsky; Alon,0,0,0,0
1653596409044,ECE 230A,A00,091071,Nomura; Kenji,0,0,0,0
1653596409571,ECE 236A,A00,091072,Dayeh; Shadi Ahmad,0,0,0,0
1653596410130,ECE 238A,A00,091073,Luo; Jian,0,0,0,0
1653596410130,ECE 238A,B00,091074,Luo; Jian,0,0,0,0
1653596410677,ECE 240A,A00,091075,Radic; Stojan,0,0,0,0
1653596411217,ECE 247A,A00,091592,Shi; Lingyan,0,0,0,0
1653596411765,ECE 250,A00,091076,Touri; Behrouz,0,0,0,0
1653596412312,ECE 251C,A00,091078,Nguyen; Truong Quang,0,0,0,0
1653596412848,ECE 253,A00,091079,Cosman; Pamela C.,0,0,0,0
1653596413375,ECE 255A,A00,091080,Orlitsky; Alon,0,0,0,0
1653596413928,ECE 257A,A00,091081,Zhang; Xinyu,0,0,0,0
1653596414485,ECE 260A,A01,091084,Eldon; John,0,0,0,0
1653596415012,ECE 264C,A00,091085,Galton; Ian A,0,0,0,0
1653596415536,ECE 265C,A00,094889,Presti; Calogero Davide,0,0,0,9
1653596416062,ECE 266,A01,091087,Hall; Drew A.,0,0,0,0
1653596417123,ECE 271A,A00,091090,Vasconcelos; Nuno,0,0,0,0
1653596417655,ECE 272B,A00,091091,Sworder; David D.,0,0,0,0
1653596418181,ECE 275A,A00,091092,Meyer; Florian,0,0,0,0
1653596418704,ECE 277,A00,091093,An; Cheolhong,0,0,0,0
1653596419227,ECE 283,A00,091094,Le; Hanh-Phuc,0,0,0,0
1653596419750,ECE 284,A00,091095,Kang; Mingu,0,0,0,0
1653596419750,ECE 284,B00,091096,Wang; Edward Jay,0,0,0,0
1653596420291,ECE 285,A00,094334,Touri; Behrouz,0,0,0,0
1653596420848,ECE 289,A00,091097,Whelan; David Arthur,0,0,0,0
1653596421402,MATH 200A,A00,087414,Salehi Golsefidy; Alireza,7,0,8,1
1653596421952,MATH 202A,A00,087415,Gill; Philip E.,2,0,8,6
1653596422498,MATH 203A,A00,087416,Oprea; Dragos N.,6,0,8,2
1653596423022,MATH 204A,A00,087417,Kedlaya; Kiran S.,6,0,8,2
1653596423568,MATH 205,A00,087418,Sorensen; Claus M,6,0,8,2
1653596424130,MATH 206A,A00,087419,Izadi; Elham,7,0,8,1
1653596424666,MATH 207A,A00,087420,Mohammadi; Amir,5,0,8,3
1653596425263,MATH 208,A00,087421,Staff,9,0,10,1
1653596425785,MATH 209,A00,087422,Staff,10,0,10,0
1653596426308,MATH 218,A00,087423,Staff,10,0,10,0
1653596426831,MATH 220A,A00,087424,Novak; Jonathan I,6,0,8,2
1653596427355,MATH 231A,A00,087425,Bejenaru; Ioan,3,0,8,5
1653596427878,MATH 240A,A00,087426,Ebenfelt; Peter F,5,0,8,3
1653596428421,MATH 243,A00,087427,Staff,9,0,10,1
1653596428947,MATH 248,A00,087429,Staff,10,0,10,0
1653596429490,MATH 250A,A00,087430,Spolaor; Luca,4,0,8,4
1653596430028,MATH 257A,A00,087431,Spolaor; Luca,7,0,8,1
1653596430571,MATH 258,A00,087432,Staff,9,0,10,1
1653596431106,MATH 264A,A00,087433,Warnke; Lutz Peter,5,0,8,3
1653596431628,MATH 268,A00,087434,Staff,15,0,15,0
1653596432167,MATH 269,A00,087435,Staff,14,0,15,1
1653596432718,MATH 270A,A00,087436,Nie; Jiawang,0,0,8,8
1653596433250,MATH 272A,A00,087437,Tian; Xiaochuan,0,0,8,8
1653596433803,MATH 274,A01,087439,Cheng; Li-Tien,9,0,10,1
1653596433803,MATH 274,A02,087440,Cheng; Li-Tien,10,0,10,0
1653596434330,MATH 278A,A00,087441,Staff,8,0,10,2
1653596434866,MATH 278B,A00,087442,Staff,8,0,10,2
1653596435393,MATH 278C,A00,087443,Staff,8,0,10,2
1653596435921,MATH 280A,A00,087444,Zheng; Tianyi,0,0,8,8
1653596436451,MATH 281A,A00,087445,Bradic; Jelena,0,0,8,8
1653596436974,MATH 282A,A00,087446,Zhang; Danna,0,0,8,8
1653596437510,MATH 283,A00,087447,Tesler; Glenn,0,0,0,16
1653596438045,MATH 286,B00,095535,Kemp; Todd Aahron,7,0,8,1
1653596438571,MATH 287D,B00,095536,Bradic; Jelena,5,0,8,3
1653596439095,MATH 288,A00,087450,Staff,14,0,15,1
1653596439095,MATH 288,B00,087451,Staff,15,0,15,0
1653596439095,MATH 288,C00,087452,Staff,15,0,15,0
1653596439641,MATH 290A,A00,087453,Xu; Zhouli,6,0,8,2
1653596440194,MATH 291A,A00,087454,Xu; Zhouli,7,0,8,1
1653596440742,MATH 292,A00,087455,Staff,10,0,10,0
1653596441279,MATH 295,A00,087456,Staff,50,0,50,0
1653596441816,MATH 297,001,087457,Staff,997,0,999,2
1653597010444,COGS 200,A01,087991,Staff,47,0,50,3
1653597010973,COGS 201,A01,094504,Rangel; Lara M,16,0,25,9
1653597011510,COGS 203,A00,087992,Coulson; Seana M,18,0,20,2
1653597012042,COGS 210A,001,087993,Greene; Deanna Jacquelyn,9998,0,9999,1
1653597012042,COGS 210A,002,087994,Saygin; Ayse P,9999,0,9999,0
1653597012042,COGS 210A,003,087995,Xia; Haijun,9999,0,9999,0
1653597012042,COGS 210A,004,087996,Nitz; Douglas A.,9999,0,9999,0
1653597012042,COGS 210A,005,087997,Hollan; James D.,9999,0,9999,0
1653597012042,COGS 210A,006,087998,Deak; Gedeon O.,9998,0,9999,1
1653597012042,COGS 210A,007,087999,Rossano; Federico,9999,0,9999,0
1653597012581,COGS 211A,A00,088000,Coulson; Seana M,9997,0,9999,2
1653597013103,COGS 229,A00,088002,Staff,22,0,25,3
1653597013638,COGS 260,B00,094231,Staff,17,0,20,3
1653597013638,COGS 260,A00,088004,Nitz; Douglas A.,9998,0,9999,1
1653597014161,CSE 202,A00,090110,Paturi; Ramamohan,0,0,0,0
1653597014161,CSE 202,B00,090111,Paturi; Ramamohan,0,0,0,0
1653597014707,CSE 207B,A00,090112,Heninger; Nadia A,0,0,0,0
1653597015232,CSE 208,A00,094858,Micciancio; Daniele,0,0,0,0
1653597015767,CSE 210,A00,090113,Powell; Thomas Allan,0,0,0,0
1653597016299,CSE 219,A00,090898,Staff,0,0,0,0
1653597016824,CSE 221,A00,090114,Zhou; Yuan-Yuan,0,0,0,0
1653597017346,CSE 229A,A00,090115,Porter; George M,0,0,0,0
1653597017869,CSE 229C,A00,090116,Savage; Stefan,0,0,0,0
1653597018395,CSE 230,A00,090117,Jhala; Ranjit,0,0,0,0
1653597018933,CSE 232,A00,090118,Papakonstantinou; Yannis,0,0,0,0
1653597019466,CSE 239A,A00,090121,Kumar; Arun Kumar,0,0,0,0
1653597019992,CSE 239B,A00,090122,Jhala; Ranjit,0,0,0,0
1653597020537,CSE 240A,A00,090123,Zhao; Jishen,0,0,189,189
1653597021075,CSE 243A,A00,090124,Orailoglu; Alex,0,0,15,15
1653597021745,CSE 249B,A00,090125,Kahng; Andrew Byun,12,0,20,8
1653597022281,CSE 250A,A00,090126,Berg-Kirkpatrick; Taylor D,0,0,0,0
1653597022829,CSE 252A,A00,090127,Ochoa; Benjamin Lawrence,0,0,0,0
1653597023351,CSE 258,A01,090129,McAuley; Julian John,0,0,0,0
1653597023892,CSE 258R,A01,090131,McAuley; Julian John,0,0,0,0
1653597024428,CSE 274,A00,090132,Ramamoorthi; Ravi,0,0,0,0
1653597024951,CSE 276A,A00,090133,Christensen; Henrik I,0,0,0,0
1653597025477,CSE 276C,A00,090134,Christensen; Henrik I,0,0,0,0
1653597026015,CSE 290,A00,090135,Bafna; Vineet,0,0,0,0
1653597026015,CSE 290,B00,090136,Ramamoorthi; Ravi,0,0,0,0
1653597026015,CSE 290,C00,090137,Li; Tzumao,7,0,10,3
1653597026015,CSE 290,D00,090138,Zhou; Yuan-Yuan,9,0,10,1
1653597026015,CSE 290,E00,090139,Christensen; Henrik I,8,0,10,2
1653597026015,CSE 290,F00,094053,Shalev; Aaron D,0,0,0,0
1653597026553,CSE 291,A00,090140,Munyaka; Imani N. S.,0,0,0,0
1653597026553,CSE 291,B00,094880,Yu; Qi,0,0,0,0
1653597026553,CSE 291,C00,090142,Pannuto; Patrick William,0,0,0,0
1653597026553,CSE 291,D00,094881,Zhang; Yiying,0,0,0,0
1653597026553,CSE 291,E00,095118,Su; Hao,0,0,0,0
1653597027117,CSE 293,001,094905,Bafna; Vineet,9999,0,9999,0
1653597027117,CSE 293,002,094906,Bellare; Mihir,9999,0,9999,0
1653597027117,CSE 293,003,094907,Berg-Kirkpatrick; Taylor D,9999,0,9999,0
1653597027117,CSE 293,004,094908,Christensen; Henrik I,9999,0,9999,0
1653597027117,CSE 293,005,094909,Cottrell; Garrison W,9999,0,9999,0
1653597027117,CSE 293,006,094910,Deutsch; Alin Bernard,9999,0,9999,0
1653597027117,CSE 293,007,094911,Esmaeilzadeh; Hadi,9999,0,9999,0
1653597027117,CSE 293,008,094912,Freund; Yoav,9999,0,9999,0
1653597027117,CSE 293,009,094913,Griswold; William G.,9999,0,9999,0
1653597027117,CSE 293,010,094914,Gymrek; Melissa Ann,9999,0,9999,0
1653597027117,CSE 293,011,094915,Heninger; Nadia A,9999,0,9999,0
1653597027117,CSE 293,012,094916,Impagliazzo; Russell,9999,0,9999,0
1653597027117,CSE 293,013,094917,Jhala; Ranjit,9999,0,9999,0
1653597027117,CSE 293,014,094918,Kahng; Andrew Byun,9999,0,9999,0
1653597027117,CSE 293,015,094919,Kane; Daniel Mertz,9999,0,9999,0
1653597027117,CSE 293,016,094920,Kriegman; David J,9999,0,9999,0
1653597027117,CSE 293,017,094921,Kumar; Arun Kumar,9999,0,9999,0
1653597027117,CSE 293,018,094922,Lerner; Sorin,9999,0,9999,0
1653597027117,CSE 293,019,094923,Lovett; Shachar,9999,0,9999,0
1653597027117,CSE 293,020,094924,McAuley; Julian John,9999,0,9999,0
1653597027117,CSE 293,021,094925,Micciancio; Daniele,9999,0,9999,0
1653597027117,CSE 293,022,094926,Orailoglu; Alex,9999,0,9999,0
1653597027117,CSE 293,023,094927,Paturi; Ramamohan,9999,0,9999,0
1653597027117,CSE 293,024,094928,Polikarpova; Nadezhda,9999,0,9999,0
1653597027117,CSE 293,025,094929,Politz; Joseph Gibbs,9999,0,9999,0
1653597027117,CSE 293,026,094930,Porter; George M,9999,0,9999,0
1653597027117,CSE 293,027,094931,Porter; Leonard Emerson,9999,0,9999,0
1653597027117,CSE 293,028,094932,Ramamoorthi; Ravi,9999,0,9999,0
1653597027117,CSE 293,029,094933,Sahoo; Debashis,9999,0,9999,0
1653597027117,CSE 293,030,094934,Saul; Lawrence,9999,0,9999,0
1653597027117,CSE 293,031,094935,Savage; Stefan,9999,0,9999,0
1653597027117,CSE 293,032,094936,Schulze; Jurgen P.,9999,0,9999,0
1653597027117,CSE 293,033,094937,Snoeren; Alex C.,9999,0,9999,0
1653597027117,CSE 293,034,094938,Shang; Jingbo,9999,0,9999,0
1653597027117,CSE 293,035,094939,Stefan; Deian,9999,0,9999,0
1653597027117,CSE 293,036,094940,Su; Hao,9999,0,9999,0
1653597027117,CSE 293,037,094941,Swanson; Steven James,9999,0,9999,0
1653597027117,CSE 293,038,094942,Tullsen; Dean Michael,9999,0,9999,0
1653597027117,CSE 293,039,094943,Voelker; Geoffrey M.,9999,0,9999,0
1653597027117,CSE 293,040,094944,Zhao; Jishen,9999,0,9999,0
1653597027117,CSE 293,041,094945,Zhou; Yuan-Yuan,9999,0,9999,0
1653597027117,CSE 293,042,094946,Gao; Sicun,9998,0,9999,1
1653597027117,CSE 293,043,094947,Weibel; Nadir,9999,0,9999,0
1653597027117,CSE 293,044,094948,Gupta; Rajesh K.,9999,0,9999,0
1653597027653,CSE 294,A00,090143,Porter; George M,8,0,10,2
1653597028190,DSE 200,A00,091799,Staff,50,0,50,0
1653597028715,DSE 203,A00,091800,Gupta; Amarnath,30,0,30,0
1653597029246,DSE 250,A00,091801,Deutsch; Alin Bernard,30,0,30,0
1653597029773,DSE 290,A00,091802,Altintas De Callaf; Ilkay,50,0,50,0
1653597030308,ECE 200,001,091003,Antipa; Nicholas A,9999,0,9999,0
1653597030308,ECE 200,002,091004,Atanasov; Nikolay A.,9999,0,9999,0
1653597030308,ECE 200,003,091005,Bharadia; Dinesh,9999,0,9999,0
1653597030308,ECE 200,004,091006,Cheng; Chung Kuan,9999,0,9999,0
1653597030308,ECE 200,005,091007,Cosman; Pamela C.,9999,0,9999,0
1653597030308,ECE 200,006,091008,Staff,9999,0,9999,0
1653597030308,ECE 200,007,091009,Dayeh; Shadi Ahmad,9999,0,9999,0
1653597030308,ECE 200,008,091010,Fainman; Yeshaiahu,9999,0,9999,0
1653597030308,ECE 200,009,091011,Ford; Joseph Earl,9999,0,9999,0
1653597030308,ECE 200,010,091012,Franceschetti; Massimo,9999,0,9999,0
1653597030308,ECE 200,011,091013,Fullerton; Eric E,9999,0,9999,0
1653597030308,ECE 200,012,091014,Galton; Ian A,9999,0,9999,0
1653597030308,ECE 200,013,091015,Gilja; Vikash,9999,0,9999,0
1653597030308,ECE 200,014,091016,Hall; Drew A.,9999,0,9999,0
1653597030308,ECE 200,015,091017,Hsueh; Tzu-Chien,9999,0,9999,0
1653597030308,ECE 200,016,091018,Javidi; Tara,9999,0,9999,0
1653597030308,ECE 200,017,091019,Kahng; Andrew Byun,9999,0,9999,0
1653597030308,ECE 200,018,091020,Kim; Young-Han,9999,0,9999,0
1653597030308,ECE 200,019,091021,Koushanfar; Farinaz,9999,0,9999,0
1653597030308,ECE 200,020,091022,Kuzum; Duygu,9999,0,9999,0
1653597030308,ECE 200,021,091023,Le; Hanh-Phuc,9999,0,9999,0
1653597030308,ECE 200,022,091024,Lin; Bill,9999,0,9999,0
1653597030308,ECE 200,023,091025,Liu; Zhaowei,9999,0,9999,0
1653597030308,ECE 200,024,091026,Lo; Yu-Hwa,9999,0,9999,0
1653597030308,ECE 200,025,091027,Lomakin; Vitaliy,9999,0,9999,0
1653597030308,ECE 200,026,091028,Mercier; Patrick Philip,9999,0,9999,0
1653597030308,ECE 200,027,091029,Meyer; Florian,9999,0,9999,0
1653597030308,ECE 200,028,091030,Milstein; Laurence B.,9999,0,9999,0
1653597030308,ECE 200,029,091031,Mir Arabbaygi; Siavash,9999,0,9999,0
1653597030308,ECE 200,030,091032,Mookherjea; Shayan,9999,0,9999,0
1653597030308,ECE 200,031,091033,Morris; Karcher William,9999,0,9999,0
1653597030308,ECE 200,032,091034,Ng; Tse Nga,9999,0,9999,0
1653597030308,ECE 200,033,091035,Nguyen; Truong Quang,9999,0,9999,0
1653597030308,ECE 200,034,091036,Nomura; Kenji,9999,0,9999,0
1653597030308,ECE 200,035,091037,Orlitsky; Alon,9999,0,9999,0
1653597030308,ECE 200,036,091038,Pal; Piya,9999,0,9999,0
1653597030308,ECE 200,037,091039,Papen; George C.,9999,0,9999,0
1653597030308,ECE 200,038,091040,Radic; Stojan,9999,0,9999,0
1653597030308,ECE 200,039,091041,Rao; Bhaskar D.,9999,0,9999,0
1653597030308,ECE 200,040,091042,Rao; Ramesh R,9999,0,9999,0
1653597030308,ECE 200,041,091043,Rebeiz; Gabriel,9999,0,9999,0
1653597030308,ECE 200,042,091044,Sanford; John R,9999,0,9999,0
1653597030308,ECE 200,043,091045,Siegel; Paul H.,9999,0,9999,0
1653597030308,ECE 200,044,091046,Sievenpiper; Daniel F.,9999,0,9999,0
1653597030308,ECE 200,045,091047,Sworder; David D.,9999,0,9999,0
1653597030308,ECE 200,046,091048,Taur; Yuan,9999,0,9999,0
1653597030308,ECE 200,047,091049,Touri; Behrouz,9999,0,9999,0
1653597030308,ECE 200,048,091050,Trivedi; Mohan M.,9999,0,9999,0
1653597030308,ECE 200,049,091051,Vardy; Alexander,9999,0,9999,0
1653597030308,ECE 200,050,091052,Vasconcelos; Nuno,9999,0,9999,0
1653597030308,ECE 200,051,091053,Wang; Xiaolong,9999,0,9999,0
1653597030308,ECE 200,052,091054,Xie; Pengtao,9999,0,9999,0
1653597030308,ECE 200,053,091055,Yip; Michael,9999,0,9999,0
1653597030308,ECE 200,054,091056,Zeger; Kenneth A.,9999,0,9999,0
1653597030308,ECE 200,055,091057,Zhang; Xinyu,9999,0,9999,0
1653597030308,ECE 200,056,091058,Turakhia; Yatish Girish,9999,0,9999,0
1653597030308,ECE 200,057,091059,Kang; Mingu,9999,0,9999,0
1653597030308,ECE 200,058,091060,Shi; Yuanyuan,9999,0,9999,0
1653597030308,ECE 200,059,091061,Wang; Edward Jay,9999,0,9999,0
1653597030308,ECE 200,060,091062,Zheng; Yang,9999,0,9999,0
1653597030834,ECE 201,A00,095526,Lo; Yu-Hwa,0,0,0,0
1653597031382,ECE 203,A00,091065,Mercier; Patrick Philip,0,0,0,0
1653597031915,ECE 207A,A00,091605,Liu; Thomas Tao-Ming,0,0,0,0
1653597032472,ECE 212AN,A00,091068,Nomura; Kenji,0,0,0,0
1653597033009,ECE 222A,A00,091069,Rebeiz; Gabriel,0,0,0,0
1653597033542,ECE 225A,A00,091070,Orlitsky; Alon,0,0,0,0
1653597034074,ECE 230A,A00,091071,Nomura; Kenji,0,0,0,0
1653597034616,ECE 236A,A00,091072,Dayeh; Shadi Ahmad,0,0,0,0
1653597035140,ECE 238A,A00,091073,Luo; Jian,0,0,0,0
1653597035140,ECE 238A,B00,091074,Luo; Jian,0,0,0,0
1653597035687,ECE 240A,A00,091075,Radic; Stojan,0,0,0,0
1653597036220,ECE 247A,A00,091592,Shi; Lingyan,0,0,0,0
1653597036758,ECE 250,A00,091076,Touri; Behrouz,0,0,0,0
1653597037306,ECE 251C,A00,091078,Nguyen; Truong Quang,0,0,0,0
1653597037845,ECE 253,A00,091079,Cosman; Pamela C.,0,0,0,0
1653597038368,ECE 255A,A00,091080,Orlitsky; Alon,0,0,0,0
1653597038897,ECE 257A,A00,091081,Zhang; Xinyu,0,0,0,0
1653597039425,ECE 260A,A01,091084,Eldon; John,0,0,0,0
1653597039951,ECE 264C,A00,091085,Galton; Ian A,0,0,0,0
1653597040514,ECE 265C,A00,094889,Presti; Calogero Davide,0,0,0,9
1653597041038,ECE 266,A01,091087,Hall; Drew A.,0,0,0,0
1653597042133,ECE 271A,A00,091090,Vasconcelos; Nuno,0,0,0,0
1653597042672,ECE 272B,A00,091091,Sworder; David D.,0,0,0,0
1653597043198,ECE 275A,A00,091092,Meyer; Florian,0,0,0,0
1653597043736,ECE 277,A00,091093,An; Cheolhong,0,0,0,0
1653597044273,ECE 283,A00,091094,Le; Hanh-Phuc,0,0,0,0
1653597044815,ECE 284,A00,091095,Kang; Mingu,0,0,0,0
1653597044815,ECE 284,B00,091096,Wang; Edward Jay,0,0,0,0
1653597045370,ECE 285,A00,094334,Touri; Behrouz,0,0,0,0
1653597045897,ECE 289,A00,091097,Whelan; David Arthur,0,0,0,0
1653597046428,MATH 200A,A00,087414,Salehi Golsefidy; Alireza,7,0,8,1
1653597046951,MATH 202A,A00,087415,Gill; Philip E.,2,0,8,6
1653597047482,MATH 203A,A00,087416,Oprea; Dragos N.,6,0,8,2
1653597048017,MATH 204A,A00,087417,Kedlaya; Kiran S.,6,0,8,2
1653597048541,MATH 205,A00,087418,Sorensen; Claus M,6,0,8,2
1653597049066,MATH 206A,A00,087419,Izadi; Elham,7,0,8,1
1653597049592,MATH 207A,A00,087420,Mohammadi; Amir,5,0,8,3
1653597050143,MATH 208,A00,087421,Staff,9,0,10,1
1653597050677,MATH 209,A00,087422,Staff,10,0,10,0
1653597051204,MATH 218,A00,087423,Staff,10,0,10,0
1653597051734,MATH 220A,A00,087424,Novak; Jonathan I,6,0,8,2
1653597052267,MATH 231A,A00,087425,Bejenaru; Ioan,3,0,8,5
1653597052796,MATH 240A,A00,087426,Ebenfelt; Peter F,5,0,8,3
1653597053322,MATH 243,A00,087427,Staff,9,0,10,1
1653597053855,MATH 248,A00,087429,Staff,10,0,10,0
1653597054392,MATH 250A,A00,087430,Spolaor; Luca,4,0,8,4
1653597054936,MATH 257A,A00,087431,Spolaor; Luca,7,0,8,1
1653597055472,MATH 258,A00,087432,Staff,9,0,10,1
1653597055997,MATH 264A,A00,087433,Warnke; Lutz Peter,5,0,8,3
1653597056539,MATH 268,A00,087434,Staff,15,0,15,0
1653597057063,MATH 269,A00,087435,Staff,14,0,15,1
1653597057602,MATH 270A,A00,087436,Nie; Jiawang,0,0,8,8
1653597058133,MATH 272A,A00,087437,Tian; Xiaochuan,0,0,8,8
1653597058671,MATH 274,A01,087439,Cheng; Li-Tien,9,0,10,1
1653597058671,MATH 274,A02,087440,Cheng; Li-Tien,10,0,10,0
1653597059195,MATH 278A,A00,087441,Staff,8,0,10,2
1653597059740,MATH 278B,A00,087442,Staff,8,0,10,2
1653597060275,MATH 278C,A00,087443,Staff,8,0,10,2
1653597060838,MATH 280A,A00,087444,Zheng; Tianyi,0,0,8,8
1653597061373,MATH 281A,A00,087445,Bradic; Jelena,0,0,8,8
1653597061900,MATH 282A,A00,087446,Zhang; Danna,0,0,8,8
1653597062426,MATH 283,A00,087447,Tesler; Glenn,0,0,0,16
1653597062954,MATH 286,B00,095535,Kemp; Todd Aahron,7,0,8,1
1653597063480,MATH 287D,B00,095536,Bradic; Jelena,5,0,8,3
1653597064003,MATH 288,A00,087450,Staff,14,0,15,1
1653597064003,MATH 288,B00,087451,Staff,15,0,15,0
1653597064003,MATH 288,C00,087452,Staff,15,0,15,0
1653597064548,MATH 290A,A00,087453,Xu; Zhouli,6,0,8,2
1653597065103,MATH 291A,A00,087454,Xu; Zhouli,7,0,8,1
1653597065635,MATH 292,A00,087455,Staff,10,0,10,0
1653597066161,MATH 295,A00,087456,Staff,50,0,50,0
1653597066693,MATH 297,001,087457,Staff,997,0,999,2
1653597636649,COGS 200,A01,087991,Staff,47,0,50,3
1653597637195,COGS 201,A01,094504,Rangel; Lara M,16,0,25,9
1653597637733,COGS 203,A00,087992,Coulson; Seana M,18,0,20,2
1653597638286,COGS 210A,001,087993,Greene; Deanna Jacquelyn,9998,0,9999,1
1653597638286,COGS 210A,002,087994,Saygin; Ayse P,9999,0,9999,0
1653597638286,COGS 210A,003,087995,Xia; Haijun,9999,0,9999,0
1653597638286,COGS 210A,004,087996,Nitz; Douglas A.,9999,0,9999,0
1653597638286,COGS 210A,005,087997,Hollan; James D.,9999,0,9999,0
1653597638286,COGS 210A,006,087998,Deak; Gedeon O.,9998,0,9999,1
1653597638286,COGS 210A,007,087999,Rossano; Federico,9999,0,9999,0
1653597638842,COGS 211A,A00,088000,Coulson; Seana M,9997,0,9999,2
1653597639380,COGS 229,A00,088002,Staff,22,0,25,3
1653597639903,COGS 260,B00,094231,Staff,17,0,20,3
1653597639903,COGS 260,A00,088004,Nitz; Douglas A.,9998,0,9999,1
1653597640438,CSE 202,A00,090110,Paturi; Ramamohan,0,0,0,0
1653597640438,CSE 202,B00,090111,Paturi; Ramamohan,0,0,0,0
1653597640962,CSE 207B,A00,090112,Heninger; Nadia A,0,0,0,0
1653597641523,CSE 208,A00,094858,Micciancio; Daniele,0,0,0,0
1653597642063,CSE 210,A00,090113,Powell; Thomas Allan,0,0,0,0
1653597642586,CSE 219,A00,090898,Staff,0,0,0,0
1653597643131,CSE 221,A00,090114,Zhou; Yuan-Yuan,0,0,0,0
1653597643674,CSE 229A,A00,090115,Porter; George M,0,0,0,0
1653597644226,CSE 229C,A00,090116,Savage; Stefan,0,0,0,0
1653597644766,CSE 230,A00,090117,Jhala; Ranjit,0,0,0,0
1653597645303,CSE 232,A00,090118,Papakonstantinou; Yannis,0,0,0,0
1653597645839,CSE 239A,A00,090121,Kumar; Arun Kumar,0,0,0,0
1653597646367,CSE 239B,A00,090122,Jhala; Ranjit,0,0,0,0
1653597646897,CSE 240A,A00,090123,Zhao; Jishen,0,0,189,189
1653597647443,CSE 243A,A00,090124,Orailoglu; Alex,0,0,15,15
1653597647989,CSE 249B,A00,090125,Kahng; Andrew Byun,12,0,20,8
1653597648529,CSE 250A,A00,090126,Berg-Kirkpatrick; Taylor D,0,0,0,0
1653597649073,CSE 252A,A00,090127,Ochoa; Benjamin Lawrence,0,0,0,0
1653597649599,CSE 258,A01,090129,McAuley; Julian John,0,0,0,0
1653597650122,CSE 258R,A01,090131,McAuley; Julian John,0,0,0,0
1653597650645,CSE 274,A00,090132,Ramamoorthi; Ravi,0,0,0,0
1653597651169,CSE 276A,A00,090133,Christensen; Henrik I,0,0,0,0
1653597651709,CSE 276C,A00,090134,Christensen; Henrik I,0,0,0,0
1653597652244,CSE 290,A00,090135,Bafna; Vineet,0,0,0,0
1653597652244,CSE 290,B00,090136,Ramamoorthi; Ravi,0,0,0,0
1653597652244,CSE 290,C00,090137,Li; Tzumao,7,0,10,3
1653597652244,CSE 290,D00,090138,Zhou; Yuan-Yuan,9,0,10,1
1653597652244,CSE 290,E00,090139,Christensen; Henrik I,8,0,10,2
1653597652244,CSE 290,F00,094053,Shalev; Aaron D,0,0,0,0
1653597652768,CSE 291,A00,090140,Munyaka; Imani N. S.,0,0,0,0
1653597652768,CSE 291,B00,094880,Yu; Qi,0,0,0,0
1653597652768,CSE 291,C00,090142,Pannuto; Patrick William,0,0,0,0
1653597652768,CSE 291,D00,094881,Zhang; Yiying,0,0,0,0
1653597652768,CSE 291,E00,095118,Su; Hao,0,0,0,0
1653597653295,CSE 293,001,094905,Bafna; Vineet,9999,0,9999,0
1653597653295,CSE 293,002,094906,Bellare; Mihir,9999,0,9999,0
1653597653295,CSE 293,003,094907,Berg-Kirkpatrick; Taylor D,9999,0,9999,0
1653597653295,CSE 293,004,094908,Christensen; Henrik I,9999,0,9999,0
1653597653295,CSE 293,005,094909,Cottrell; Garrison W,9999,0,9999,0
1653597653295,CSE 293,006,094910,Deutsch; Alin Bernard,9999,0,9999,0
1653597653295,CSE 293,007,094911,Esmaeilzadeh; Hadi,9999,0,9999,0
1653597653295,CSE 293,008,094912,Freund; Yoav,9999,0,9999,0
1653597653295,CSE 293,009,094913,Griswold; William G.,9999,0,9999,0
1653597653295,CSE 293,010,094914,Gymrek; Melissa Ann,9999,0,9999,0
1653597653295,CSE 293,011,094915,Heninger; Nadia A,9999,0,9999,0
1653597653295,CSE 293,012,094916,Impagliazzo; Russell,9999,0,9999,0
1653597653295,CSE 293,013,094917,Jhala; Ranjit,9999,0,9999,0
1653597653295,CSE 293,014,094918,Kahng; Andrew Byun,9999,0,9999,0
1653597653295,CSE 293,015,094919,Kane; Daniel Mertz,9999,0,9999,0
1653597653295,CSE 293,016,094920,Kriegman; David J,9999,0,9999,0
1653597653295,CSE 293,017,094921,Kumar; Arun Kumar,9999,0,9999,0
1653597653295,CSE 293,018,094922,Lerner; Sorin,9999,0,9999,0
1653597653295,CSE 293,019,094923,Lovett; Shachar,9999,0,9999,0
1653597653295,CSE 293,020,094924,McAuley; Julian John,9999,0,9999,0
1653597653295,CSE 293,021,094925,Micciancio; Daniele,9999,0,9999,0
1653597653295,CSE 293,022,094926,Orailoglu; Alex,9999,0,9999,0
1653597653295,CSE 293,023,094927,Paturi; Ramamohan,9999,0,9999,0
1653597653295,CSE 293,024,094928,Polikarpova; Nadezhda,9999,0,9999,0
1653597653295,CSE 293,025,094929,Politz; Joseph Gibbs,9999,0,9999,0
1653597653295,CSE 293,026,094930,Porter; George M,9999,0,9999,0
1653597653295,CSE 293,027,094931,Porter; Leonard Emerson,9999,0,9999,0
1653597653295,CSE 293,028,094932,Ramamoorthi; Ravi,9999,0,9999,0
1653597653295,CSE 293,029,094933,Sahoo; Debashis,9999,0,9999,0
1653597653295,CSE 293,030,094934,Saul; Lawrence,9999,0,9999,0
1653597653295,CSE 293,031,094935,Savage; Stefan,9999,0,9999,0
1653597653295,CSE 293,032,094936,Schulze; Jurgen P.,9999,0,9999,0
1653597653295,CSE 293,033,094937,Snoeren; Alex C.,9999,0,9999,0
1653597653295,CSE 293,034,094938,Shang; Jingbo,9999,0,9999,0
1653597653295,CSE 293,035,094939,Stefan; Deian,9999,0,9999,0
1653597653295,CSE 293,036,094940,Su; Hao,9999,0,9999,0
1653597653295,CSE 293,037,094941,Swanson; Steven James,9999,0,9999,0
1653597653295,CSE 293,038,094942,Tullsen; Dean Michael,9999,0,9999,0
1653597653295,CSE 293,039,094943,Voelker; Geoffrey M.,9999,0,9999,0
1653597653295,CSE 293,040,094944,Zhao; Jishen,9999,0,9999,0
1653597653295,CSE 293,041,094945,Zhou; Yuan-Yuan,9999,0,9999,0
1653597653295,CSE 293,042,094946,Gao; Sicun,9998,0,9999,1
1653597653295,CSE 293,043,094947,Weibel; Nadir,9999,0,9999,0
1653597653295,CSE 293,044,094948,Gupta; Rajesh K.,9999,0,9999,0
1653597653823,CSE 294,A00,090143,Porter; George M,8,0,10,2
1653597654363,DSE 200,A00,091799,Staff,50,0,50,0
1653597654919,DSE 203,A00,091800,Gupta; Amarnath,30,0,30,0
1653597655456,DSE 250,A00,091801,Deutsch; Alin Bernard,30,0,30,0
1653597655984,DSE 290,A00,091802,Altintas De Callaf; Ilkay,50,0,50,0
1653597656537,ECE 200,001,091003,Antipa; Nicholas A,9999,0,9999,0
1653597656537,ECE 200,002,091004,Atanasov; Nikolay A.,9999,0,9999,0
1653597656537,ECE 200,003,091005,Bharadia; Dinesh,9999,0,9999,0
1653597656537,ECE 200,004,091006,Cheng; Chung Kuan,9999,0,9999,0
1653597656537,ECE 200,005,091007,Cosman; Pamela C.,9999,0,9999,0
1653597656537,ECE 200,006,091008,Staff,9999,0,9999,0
1653597656537,ECE 200,007,091009,Dayeh; Shadi Ahmad,9999,0,9999,0
1653597656537,ECE 200,008,091010,Fainman; Yeshaiahu,9999,0,9999,0
1653597656537,ECE 200,009,091011,Ford; Joseph Earl,9999,0,9999,0
1653597656537,ECE 200,010,091012,Franceschetti; Massimo,9999,0,9999,0
1653597656537,ECE 200,011,091013,Fullerton; Eric E,9999,0,9999,0
1653597656537,ECE 200,012,091014,Galton; Ian A,9999,0,9999,0
1653597656537,ECE 200,013,091015,Gilja; Vikash,9999,0,9999,0
1653597656537,ECE 200,014,091016,Hall; Drew A.,9999,0,9999,0
1653597656537,ECE 200,015,091017,Hsueh; Tzu-Chien,9999,0,9999,0
1653597656537,ECE 200,016,091018,Javidi; Tara,9999,0,9999,0
1653597656537,ECE 200,017,091019,Kahng; Andrew Byun,9999,0,9999,0
1653597656537,ECE 200,018,091020,Kim; Young-Han,9999,0,9999,0
1653597656537,ECE 200,019,091021,Koushanfar; Farinaz,9999,0,9999,0
1653597656537,ECE 200,020,091022,Kuzum; Duygu,9999,0,9999,0
1653597656537,ECE 200,021,091023,Le; Hanh-Phuc,9999,0,9999,0
1653597656537,ECE 200,022,091024,Lin; Bill,9999,0,9999,0
1653597656537,ECE 200,023,091025,Liu; Zhaowei,9999,0,9999,0
1653597656537,ECE 200,024,091026,Lo; Yu-Hwa,9999,0,9999,0
1653597656537,ECE 200,025,091027,Lomakin; Vitaliy,9999,0,9999,0
1653597656537,ECE 200,026,091028,Mercier; Patrick Philip,9999,0,9999,0
1653597656537,ECE 200,027,091029,Meyer; Florian,9999,0,9999,0
1653597656537,ECE 200,028,091030,Milstein; Laurence B.,9999,0,9999,0
1653597656537,ECE 200,029,091031,Mir Arabbaygi; Siavash,9999,0,9999,0
1653597656537,ECE 200,030,091032,Mookherjea; Shayan,9999,0,9999,0
1653597656537,ECE 200,031,091033,Morris; Karcher William,9999,0,9999,0
1653597656537,ECE 200,032,091034,Ng; Tse Nga,9999,0,9999,0
1653597656537,ECE 200,033,091035,Nguyen; Truong Quang,9999,0,9999,0
1653597656537,ECE 200,034,091036,Nomura; Kenji,9999,0,9999,0
1653597656537,ECE 200,035,091037,Orlitsky; Alon,9999,0,9999,0
1653597656537,ECE 200,036,091038,Pal; Piya,9999,0,9999,0
1653597656537,ECE 200,037,091039,Papen; George C.,9999,0,9999,0
1653597656537,ECE 200,038,091040,Radic; Stojan,9999,0,9999,0
1653597656537,ECE 200,039,091041,Rao; Bhaskar D.,9999,0,9999,0
1653597656537,ECE 200,040,091042,Rao; Ramesh R,9999,0,9999,0
1653597656537,ECE 200,041,091043,Rebeiz; Gabriel,9999,0,9999,0
1653597656537,ECE 200,042,091044,Sanford; John R,9999,0,9999,0
1653597656537,ECE 200,043,091045,Siegel; Paul H.,9999,0,9999,0
1653597656537,ECE 200,044,091046,Sievenpiper; Daniel F.,9999,0,9999,0
1653597656537,ECE 200,045,091047,Sworder; David D.,9999,0,9999,0
1653597656537,ECE 200,046,091048,Taur; Yuan,9999,0,9999,0
1653597656537,ECE 200,047,091049,Touri; Behrouz,9999,0,9999,0
1653597656537,ECE 200,048,091050,Trivedi; Mohan M.,9999,0,9999,0
1653597656537,ECE 200,049,091051,Vardy; Alexander,9999,0,9999,0
1653597656537,ECE 200,050,091052,Vasconcelos; Nuno,9999,0,9999,0
1653597656537,ECE 200,051,091053,Wang; Xiaolong,9999,0,9999,0
1653597656537,ECE 200,052,091054,Xie; Pengtao,9999,0,9999,0
1653597656537,ECE 200,053,091055,Yip; Michael,9999,0,9999,0
1653597656537,ECE 200,054,091056,Zeger; Kenneth A.,9999,0,9999,0
1653597656537,ECE 200,055,091057,Zhang; Xinyu,9999,0,9999,0
1653597656537,ECE 200,056,091058,Turakhia; Yatish Girish,9999,0,9999,0
1653597656537,ECE 200,057,091059,Kang; Mingu,9999,0,9999,0
1653597656537,ECE 200,058,091060,Shi; Yuanyuan,9999,0,9999,0
1653597656537,ECE 200,059,091061,Wang; Edward Jay,9999,0,9999,0
1653597656537,ECE 200,060,091062,Zheng; Yang,9999,0,9999,0
1653597657069,ECE 201,A00,095526,Lo; Yu-Hwa,0,0,0,0
1653597657599,ECE 203,A00,091065,Mercier; Patrick Philip,0,0,0,0
1653597658156,ECE 207A,A00,091605,Liu; Thomas Tao-Ming,0,0,0,0
1653597658702,ECE 212AN,A00,091068,Nomura; Kenji,0,0,0,0
1653597659265,ECE 222A,A00,091069,Rebeiz; Gabriel,0,0,0,0
1653597659788,ECE 225A,A00,091070,Orlitsky; Alon,0,0,0,0
1653597660331,ECE 230A,A00,091071,Nomura; Kenji,0,0,0,0
1653597660865,ECE 236A,A00,091072,Dayeh; Shadi Ahmad,0,0,0,0
1653597661400,ECE 238A,A00,091073,Luo; Jian,0,0,0,0
1653597661400,ECE 238A,B00,091074,Luo; Jian,0,0,0,0
1653597661946,ECE 240A,A00,091075,Radic; Stojan,0,0,0,0
1653597662472,ECE 247A,A00,091592,Shi; Lingyan,0,0,0,0
1653597663019,ECE 250,A00,091076,Touri; Behrouz,0,0,0,0
1653597663567,ECE 251C,A00,091078,Nguyen; Truong Quang,0,0,0,0
1653597664093,ECE 253,A00,091079,Cosman; Pamela C.,0,0,0,0
1653597664627,ECE 255A,A00,091080,Orlitsky; Alon,0,0,0,0
1653597665159,ECE 257A,A00,091081,Zhang; Xinyu,0,0,0,0
1653597665711,ECE 260A,A01,091084,Eldon; John,0,0,0,0
1653597666251,ECE 264C,A00,091085,Galton; Ian A,0,0,0,0
1653597666777,ECE 265C,A00,094889,Presti; Calogero Davide,0,0,0,9
1653597667299,ECE 266,A01,091087,Hall; Drew A.,0,0,0,0
1653597668378,ECE 271A,A00,091090,Vasconcelos; Nuno,0,0,0,0
1653597668920,ECE 272B,A00,091091,Sworder; David D.,0,0,0,0
1653597669448,ECE 275A,A00,091092,Meyer; Florian,0,0,0,0
1653597669981,ECE 277,A00,091093,An; Cheolhong,0,0,0,0
1653597670522,ECE 283,A00,091094,Le; Hanh-Phuc,0,0,0,0
1653597671055,ECE 284,A00,091095,Kang; Mingu,0,0,0,0
1653597671055,ECE 284,B00,091096,Wang; Edward Jay,0,0,0,0
1653597671600,ECE 285,A00,094334,Touri; Behrouz,0,0,0,0
1653597672160,ECE 289,A00,091097,Whelan; David Arthur,0,0,0,0
1653597672697,MATH 200A,A00,087414,Salehi Golsefidy; Alireza,7,0,8,1
1653597673241,MATH 202A,A00,087415,Gill; Philip E.,2,0,8,6
1653597673862,MATH 203A,A00,087416,Oprea; Dragos N.,6,0,8,2
1653597674408,MATH 204A,A00,087417,Kedlaya; Kiran S.,6,0,8,2
1653597674955,MATH 205,A00,087418,Sorensen; Claus M,6,0,8,2
1653597675494,MATH 206A,A00,087419,Izadi; Elham,7,0,8,1
1653597676037,MATH 207A,A00,087420,Mohammadi; Amir,5,0,8,3
1653597676584,MATH 208,A00,087421,Staff,9,0,10,1
1653597677140,MATH 209,A00,087422,Staff,10,0,10,0
1653597677699,MATH 218,A00,087423,Staff,10,0,10,0
1653597678221,MATH 220A,A00,087424,Novak; Jonathan I,6,0,8,2
1653597678761,MATH 231A,A00,087425,Bejenaru; Ioan,3,0,8,5
1653597679302,MATH 240A,A00,087426,Ebenfelt; Peter F,5,0,8,3
1653597679852,MATH 243,A00,087427,Staff,9,0,10,1
1653597680383,MATH 248,A00,087429,Staff,10,0,10,0
1653597680908,MATH 250A,A00,087430,Spolaor; Luca,4,0,8,4
1653597681449,MATH 257A,A00,087431,Spolaor; Luca,7,0,8,1
1653597681997,MATH 258,A00,087432,Staff,9,0,10,1
1653597682543,MATH 264A,A00,087433,Warnke; Lutz Peter,5,0,8,3
1653597683075,MATH 268,A00,087434,Staff,15,0,15,0
1653597683614,MATH 269,A00,087435,Staff,14,0,15,1
1653597684159,MATH 270A,A00,087436,Nie; Jiawang,0,0,8,8
1653597684686,MATH 272A,A00,087437,Tian; Xiaochuan,0,0,8,8
1653597685213,MATH 274,A01,087439,Cheng; Li-Tien,9,0,10,1
1653597685213,MATH 274,A02,087440,Cheng; Li-Tien,10,0,10,0
1653597685756,MATH 278A,A00,087441,Staff,8,0,10,2
1653597686299,MATH 278B,A00,087442,Staff,8,0,10,2
1653597686830,MATH 278C,A00,087443,Staff,8,0,10,2
1653597687373,MATH 280A,A00,087444,Zheng; Tianyi,0,0,8,8
1653597687897,MATH 281A,A00,087445,Bradic; Jelena,0,0,8,8
1653597688435,MATH 282A,A00,087446,Zhang; Danna,0,0,8,8
1653597688971,MATH 283,A00,087447,Tesler; Glenn,0,0,0,16
1653597689505,MATH 286,B00,095535,Kemp; Todd Aahron,7,0,8,1
1653597690041,MATH 287D,B00,095536,Bradic; Jelena,5,0,8,3
1653597690576,MATH 288,A00,087450,Staff,14,0,15,1
1653597690576,MATH 288,B00,087451,Staff,15,0,15,0
1653597690576,MATH 288,C00,087452,Staff,15,0,15,0
1653597691099,MATH 290A,A00,087453,Xu; Zhouli,6,0,8,2
1653597691649,MATH 291A,A00,087454,Xu; Zhouli,7,0,8,1
1653597692172,MATH 292,A00,087455,Staff,10,0,10,0
1653597692695,MATH 295,A00,087456,Staff,50,0,50,0
1653597693230,MATH 297,001,087457,Staff,997,0,999,2
1653598262401,COGS 200,A01,087991,Staff,47,0,50,3
1653598262943,COGS 201,A01,094504,Rangel; Lara M,16,0,25,9
1653598263499,COGS 203,A00,087992,Coulson; Seana M,18,0,20,2
1653598264034,COGS 210A,001,087993,Greene; Deanna Jacquelyn,9998,0,9999,1
1653598264034,COGS 210A,002,087994,Saygin; Ayse P,9999,0,9999,0
1653598264034,COGS 210A,003,087995,Xia; Haijun,9999,0,9999,0
1653598264034,COGS 210A,004,087996,Nitz; Douglas A.,9999,0,9999,0
1653598264034,COGS 210A,005,087997,Hollan; James D.,9999,0,9999,0
1653598264034,COGS 210A,006,087998,Deak; Gedeon O.,9998,0,9999,1
1653598264034,COGS 210A,007,087999,Rossano; Federico,9999,0,9999,0
1653598264556,COGS 211A,A00,088000,Coulson; Seana M,9997,0,9999,2
1653598265093,COGS 229,A00,088002,Staff,22,0,25,3
1653598265632,COGS 260,B00,094231,Staff,17,0,20,3
1653598265632,COGS 260,A00,088004,Nitz; Douglas A.,9998,0,9999,1
1653598266186,CSE 202,A00,090110,Paturi; Ramamohan,0,0,0,0
1653598266186,CSE 202,B00,090111,Paturi; Ramamohan,0,0,0,0
1653598266736,CSE 207B,A00,090112,Heninger; Nadia A,0,0,0,0
1653598267290,CSE 208,A00,094858,Micciancio; Daniele,0,0,0,0
1653598267814,CSE 210,A00,090113,Powell; Thomas Allan,0,0,0,0
1653598268336,CSE 219,A00,090898,Staff,0,0,0,0
1653598268857,CSE 221,A00,090114,Zhou; Yuan-Yuan,0,0,0,0
1653598269387,CSE 229A,A00,090115,Porter; George M,0,0,0,0
1653598269913,CSE 229C,A00,090116,Savage; Stefan,0,0,0,0
1653598270449,CSE 230,A00,090117,Jhala; Ranjit,0,0,0,0
1653598271105,CSE 232,A00,090118,Papakonstantinou; Yannis,0,0,0,0
1653598271639,CSE 239A,A00,090121,Kumar; Arun Kumar,0,0,0,0
1653598272189,CSE 239B,A00,090122,Jhala; Ranjit,0,0,0,0
1653598272716,CSE 240A,A00,090123,Zhao; Jishen,0,0,189,189
1653598273243,CSE 243A,A00,090124,Orailoglu; Alex,0,0,15,15
1653598273767,CSE 249B,A00,090125,Kahng; Andrew Byun,12,0,20,8
1653598274324,CSE 250A,A00,090126,Berg-Kirkpatrick; Taylor D,0,0,0,0
1653598274856,CSE 252A,A00,090127,Ochoa; Benjamin Lawrence,0,0,0,0
1653598275403,CSE 258,A01,090129,McAuley; Julian John,0,0,0,0
1653598275926,CSE 258R,A01,090131,McAuley; Julian John,0,0,0,0
1653598276449,CSE 274,A00,090132,Ramamoorthi; Ravi,0,0,0,0
1653598276973,CSE 276A,A00,090133,Christensen; Henrik I,0,0,0,0
1653598277495,CSE 276C,A00,090134,Christensen; Henrik I,0,0,0,0
1653598278016,CSE 290,A00,090135,Bafna; Vineet,0,0,0,0
1653598278016,CSE 290,B00,090136,Ramamoorthi; Ravi,0,0,0,0
1653598278016,CSE 290,C00,090137,Li; Tzumao,7,0,10,3
1653598278016,CSE 290,D00,090138,Zhou; Yuan-Yuan,9,0,10,1
1653598278016,CSE 290,E00,090139,Christensen; Henrik I,8,0,10,2
1653598278016,CSE 290,F00,094053,Shalev; Aaron D,0,0,0,0
1653598278545,CSE 291,A00,090140,Munyaka; Imani N. S.,0,0,0,0
1653598278545,CSE 291,B00,094880,Yu; Qi,0,0,0,0
1653598278545,CSE 291,C00,090142,Pannuto; Patrick William,0,0,0,0
1653598278545,CSE 291,D00,094881,Zhang; Yiying,0,0,0,0
1653598278545,CSE 291,E00,095118,Su; Hao,0,0,0,0
1653598279117,CSE 293,001,094905,Bafna; Vineet,9999,0,9999,0
1653598279117,CSE 293,002,094906,Bellare; Mihir,9999,0,9999,0
1653598279117,CSE 293,003,094907,Berg-Kirkpatrick; Taylor D,9999,0,9999,0
1653598279117,CSE 293,004,094908,Christensen; Henrik I,9999,0,9999,0
1653598279117,CSE 293,005,094909,Cottrell; Garrison W,9999,0,9999,0
1653598279117,CSE 293,006,094910,Deutsch; Alin Bernard,9999,0,9999,0
1653598279117,CSE 293,007,094911,Esmaeilzadeh; Hadi,9999,0,9999,0
1653598279117,CSE 293,008,094912,Freund; Yoav,9999,0,9999,0
1653598279117,CSE 293,009,094913,Griswold; William G.,9999,0,9999,0
1653598279117,CSE 293,010,094914,Gymrek; Melissa Ann,9999,0,9999,0
1653598279117,CSE 293,011,094915,Heninger; Nadia A,9999,0,9999,0
1653598279117,CSE 293,012,094916,Impagliazzo; Russell,9999,0,9999,0
1653598279117,CSE 293,013,094917,Jhala; Ranjit,9999,0,9999,0
1653598279117,CSE 293,014,094918,Kahng; Andrew Byun,9999,0,9999,0
1653598279117,CSE 293,015,094919,Kane; Daniel Mertz,9999,0,9999,0
1653598279117,CSE 293,016,094920,Kriegman; David J,9999,0,9999,0
1653598279117,CSE 293,017,094921,Kumar; Arun Kumar,9999,0,9999,0
1653598279117,CSE 293,018,094922,Lerner; Sorin,9999,0,9999,0
1653598279117,CSE 293,019,094923,Lovett; Shachar,9999,0,9999,0
1653598279117,CSE 293,020,094924,McAuley; Julian John,9999,0,9999,0
1653598279117,CSE 293,021,094925,Micciancio; Daniele,9999,0,9999,0
1653598279117,CSE 293,022,094926,Orailoglu; Alex,9999,0,9999,0
1653598279117,CSE 293,023,094927,Paturi; Ramamohan,9999,0,9999,0
1653598279117,CSE 293,024,094928,Polikarpova; Nadezhda,9999,0,9999,0
1653598279117,CSE 293,025,094929,Politz; Joseph Gibbs,9999,0,9999,0
1653598279117,CSE 293,026,094930,Porter; George M,9999,0,9999,0
1653598279117,CSE 293,027,094931,Porter; Leonard Emerson,9999,0,9999,0
1653598279117,CSE 293,028,094932,Ramamoorthi; Ravi,9999,0,9999,0
1653598279117,CSE 293,029,094933,Sahoo; Debashis,9999,0,9999,0
1653598279117,CSE 293,030,094934,Saul; Lawrence,9999,0,9999,0
1653598279117,CSE 293,031,094935,Savage; Stefan,9999,0,9999,0
1653598279117,CSE 293,032,094936,Schulze; Jurgen P.,9999,0,9999,0
1653598279117,CSE 293,033,094937,Snoeren; Alex C.,9999,0,9999,0
1653598279117,CSE 293,034,094938,Shang; Jingbo,9999,0,9999,0
1653598279117,CSE 293,035,094939,Stefan; Deian,9999,0,9999,0
1653598279117,CSE 293,036,094940,Su; Hao,9999,0,9999,0
1653598279117,CSE 293,037,094941,Swanson; Steven James,9999,0,9999,0
1653598279117,CSE 293,038,094942,Tullsen; Dean Michael,9999,0,9999,0
1653598279117,CSE 293,039,094943,Voelker; Geoffrey M.,9999,0,9999,0
1653598279117,CSE 293,040,094944,Zhao; Jishen,9999,0,9999,0
1653598279117,CSE 293,041,094945,Zhou; Yuan-Yuan,9999,0,9999,0
1653598279117,CSE 293,042,094946,Gao; Sicun,9998,0,9999,1
1653598279117,CSE 293,043,094947,Weibel; Nadir,9999,0,9999,0
1653598279117,CSE 293,044,094948,Gupta; Rajesh K.,9999,0,9999,0
1653598279641,CSE 294,A00,090143,Porter; George M,8,0,10,2
1653598280175,DSE 200,A00,091799,Staff,50,0,50,0
1653598280720,DSE 203,A00,091800,Gupta; Amarnath,30,0,30,0
1653598281255,DSE 250,A00,091801,Deutsch; Alin Bernard,30,0,30,0
1653598281790,DSE 290,A00,091802,Altintas De Callaf; Ilkay,50,0,50,0
1653598282381,ECE 200,001,091003,Antipa; Nicholas A,9999,0,9999,0
1653598282381,ECE 200,002,091004,Atanasov; Nikolay A.,9999,0,9999,0
1653598282381,ECE 200,003,091005,Bharadia; Dinesh,9999,0,9999,0
1653598282381,ECE 200,004,091006,Cheng; Chung Kuan,9999,0,9999,0
1653598282381,ECE 200,005,091007,Cosman; Pamela C.,9999,0,9999,0
1653598282381,ECE 200,006,091008,Staff,9999,0,9999,0
1653598282381,ECE 200,007,091009,Dayeh; Shadi Ahmad,9999,0,9999,0
1653598282381,ECE 200,008,091010,Fainman; Yeshaiahu,9999,0,9999,0
1653598282381,ECE 200,009,091011,Ford; Joseph Earl,9999,0,9999,0
1653598282381,ECE 200,010,091012,Franceschetti; Massimo,9999,0,9999,0
1653598282381,ECE 200,011,091013,Fullerton; Eric E,9999,0,9999,0
1653598282381,ECE 200,012,091014,Galton; Ian A,9999,0,9999,0
1653598282381,ECE 200,013,091015,Gilja; Vikash,9999,0,9999,0
1653598282381,ECE 200,014,091016,Hall; Drew A.,9999,0,9999,0
1653598282381,ECE 200,015,091017,Hsueh; Tzu-Chien,9999,0,9999,0
1653598282381,ECE 200,016,091018,Javidi; Tara,9999,0,9999,0
1653598282381,ECE 200,017,091019,Kahng; Andrew Byun,9999,0,9999,0
1653598282381,ECE 200,018,091020,Kim; Young-Han,9999,0,9999,0
1653598282381,ECE 200,019,091021,Koushanfar; Farinaz,9999,0,9999,0
1653598282381,ECE 200,020,091022,Kuzum; Duygu,9999,0,9999,0
1653598282381,ECE 200,021,091023,Le; Hanh-Phuc,9999,0,9999,0
1653598282381,ECE 200,022,091024,Lin; Bill,9999,0,9999,0
1653598282381,ECE 200,023,091025,Liu; Zhaowei,9999,0,9999,0
1653598282381,ECE 200,024,091026,Lo; Yu-Hwa,9999,0,9999,0
1653598282381,ECE 200,025,091027,Lomakin; Vitaliy,9999,0,9999,0
1653598282381,ECE 200,026,091028,Mercier; Patrick Philip,9999,0,9999,0
1653598282381,ECE 200,027,091029,Meyer; Florian,9999,0,9999,0
1653598282381,ECE 200,028,091030,Milstein; Laurence B.,9999,0,9999,0
1653598282381,ECE 200,029,091031,Mir Arabbaygi; Siavash,9999,0,9999,0
1653598282381,ECE 200,030,091032,Mookherjea; Shayan,9999,0,9999,0
1653598282381,ECE 200,031,091033,Morris; Karcher William,9999,0,9999,0
1653598282381,ECE 200,032,091034,Ng; Tse Nga,9999,0,9999,0
1653598282381,ECE 200,033,091035,Nguyen; Truong Quang,9999,0,9999,0
1653598282381,ECE 200,034,091036,Nomura; Kenji,9999,0,9999,0
1653598282381,ECE 200,035,091037,Orlitsky; Alon,9999,0,9999,0
1653598282381,ECE 200,036,091038,Pal; Piya,9999,0,9999,0
1653598282381,ECE 200,037,091039,Papen; George C.,9999,0,9999,0
1653598282381,ECE 200,038,091040,Radic; Stojan,9999,0,9999,0
1653598282381,ECE 200,039,091041,Rao; Bhaskar D.,9999,0,9999,0
1653598282381,ECE 200,040,091042,Rao; Ramesh R,9999,0,9999,0
1653598282381,ECE 200,041,091043,Rebeiz; Gabriel,9999,0,9999,0
1653598282381,ECE 200,042,091044,Sanford; John R,9999,0,9999,0
1653598282381,ECE 200,043,091045,Siegel; Paul H.,9999,0,9999,0
1653598282381,ECE 200,044,091046,Sievenpiper; Daniel F.,9999,0,9999,0
1653598282381,ECE 200,045,091047,Sworder; David D.,9999,0,9999,0
1653598282381,ECE 200,046,091048,Taur; Yuan,9999,0,9999,0
1653598282381,ECE 200,047,091049,Touri; Behrouz,9999,0,9999,0
1653598282381,ECE 200,048,091050,Trivedi; Mohan M.,9999,0,9999,0
1653598282381,ECE 200,049,091051,Vardy; Alexander,9999,0,9999,0
1653598282381,ECE 200,050,091052,Vasconcelos; Nuno,9999,0,9999,0
1653598282381,ECE 200,051,091053,Wang; Xiaolong,9999,0,9999,0
1653598282381,ECE 200,052,091054,Xie; Pengtao,9999,0,9999,0
1653598282381,ECE 200,053,091055,Yip; Michael,9999,0,9999,0
1653598282381,ECE 200,054,091056,Zeger; Kenneth A.,9999,0,9999,0
1653598282381,ECE 200,055,091057,Zhang; Xinyu,9999,0,9999,0
1653598282381,ECE 200,056,091058,Turakhia; Yatish Girish,9999,0,9999,0
1653598282381,ECE 200,057,091059,Kang; Mingu,9999,0,9999,0
1653598282381,ECE 200,058,091060,Shi; Yuanyuan,9999,0,9999,0
1653598282381,ECE 200,059,091061,Wang; Edward Jay,9999,0,9999,0
1653598282381,ECE 200,060,091062,Zheng; Yang,9999,0,9999,0
1653598282918,ECE 201,A00,095526,Lo; Yu-Hwa,0,0,0,0
1653598283468,ECE 203,A00,091065,Mercier; Patrick Philip,0,0,0,0
1653598284013,ECE 207A,A00,091605,Liu; Thomas Tao-Ming,0,0,0,0
1653598284544,ECE 212AN,A00,091068,Nomura; Kenji,0,0,0,0
1653598285087,ECE 222A,A00,091069,Rebeiz; Gabriel,0,0,0,0
1653598285618,ECE 225A,A00,091070,Orlitsky; Alon,0,0,0,0
1653598286147,ECE 230A,A00,091071,Nomura; Kenji,0,0,0,0
1653598286670,ECE 236A,A00,091072,Dayeh; Shadi Ahmad,0,0,0,0
1653598287198,ECE 238A,A00,091073,Luo; Jian,0,0,0,0
1653598287198,ECE 238A,B00,091074,Luo; Jian,0,0,0,0
1653598287756,ECE 240A,A00,091075,Radic; Stojan,0,0,0,0
1653598288305,ECE 247A,A00,091592,Shi; Lingyan,0,0,0,0
1653598288859,ECE 250,A00,091076,Touri; Behrouz,0,0,0,0
1653598289395,ECE 251C,A00,091078,Nguyen; Truong Quang,0,0,0,0
1653598289917,ECE 253,A00,091079,Cosman; Pamela C.,0,0,0,0
1653598290461,ECE 255A,A00,091080,Orlitsky; Alon,0,0,0,0
1653598290988,ECE 257A,A00,091081,Zhang; Xinyu,0,0,0,0
1653598291519,ECE 260A,A01,091084,Eldon; John,0,0,0,0
1653598292068,ECE 264C,A00,091085,Galton; Ian A,0,0,0,0
1653598292624,ECE 265C,A00,094889,Presti; Calogero Davide,0,0,0,9
1653598293154,ECE 266,A01,091087,Hall; Drew A.,0,0,0,0
1653598294202,ECE 271A,A00,091090,Vasconcelos; Nuno,0,0,0,0
1653598294725,ECE 272B,A00,091091,Sworder; David D.,0,0,0,0
1653598295252,ECE 275A,A00,091092,Meyer; Florian,0,0,0,0
1653598295774,ECE 277,A00,091093,An; Cheolhong,0,0,0,0
1653598296312,ECE 283,A00,091094,Le; Hanh-Phuc,0,0,0,0
1653598296837,ECE 284,A00,091095,Kang; Mingu,0,0,0,0
1653598296837,ECE 284,B00,091096,Wang; Edward Jay,0,0,0,0
1653598297360,ECE 285,A00,094334,Touri; Behrouz,0,0,0,0
1653598297902,ECE 289,A00,091097,Whelan; David Arthur,0,0,0,0
1653598298426,MATH 200A,A00,087414,Salehi Golsefidy; Alireza,7,0,8,1
1653598298960,MATH 202A,A00,087415,Gill; Philip E.,2,0,8,6
1653598299482,MATH 203A,A00,087416,Oprea; Dragos N.,6,0,8,2
1653598300015,MATH 204A,A00,087417,Kedlaya; Kiran S.,6,0,8,2
1653598300542,MATH 205,A00,087418,Sorensen; Claus M,6,0,8,2
1653598301075,MATH 206A,A00,087419,Izadi; Elham,7,0,8,1
1653598301597,MATH 207A,A00,087420,Mohammadi; Amir,5,0,8,3
1653598302130,MATH 208,A00,087421,Staff,9,0,10,1
1653598302666,MATH 209,A00,087422,Staff,10,0,10,0
1653598303225,MATH 218,A00,087423,Staff,10,0,10,0
1653598303754,MATH 220A,A00,087424,Novak; Jonathan I,6,0,8,2
1653598304282,MATH 231A,A00,087425,Bejenaru; Ioan,3,0,8,5
1653598304811,MATH 240A,A00,087426,Ebenfelt; Peter F,5,0,8,3
1653598305334,MATH 243,A00,087427,Staff,9,0,10,1
1653598305859,MATH 248,A00,087429,Staff,10,0,10,0
1653598306395,MATH 250A,A00,087430,Spolaor; Luca,4,0,8,4
1653598306937,MATH 257A,A00,087431,Spolaor; Luca,7,0,8,1
1653598307460,MATH 258,A00,087432,Staff,9,0,10,1
1653598307986,MATH 264A,A00,087433,Warnke; Lutz Peter,5,0,8,3
1653598308507,MATH 268,A00,087434,Staff,15,0,15,0
1653598309032,MATH 269,A00,087435,Staff,14,0,15,1
1653598309554,MATH 270A,A00,087436,Nie; Jiawang,0,0,8,8
1653598310085,MATH 272A,A00,087437,Tian; Xiaochuan,0,0,8,8
1653598310611,MATH 274,A01,087439,Cheng; Li-Tien,9,0,10,1
1653598310611,MATH 274,A02,087440,Cheng; Li-Tien,10,0,10,0
1653598311143,MATH 278A,A00,087441,Staff,8,0,10,2
1653598311674,MATH 278B,A00,087442,Staff,8,0,10,2
1653598312208,MATH 278C,A00,087443,Staff,8,0,10,2
1653598312735,MATH 280A,A00,087444,Zheng; Tianyi,0,0,8,8
1653598313288,MATH 281A,A00,087445,Bradic; Jelena,0,0,8,8
1653598313813,MATH 282A,A00,087446,Zhang; Danna,0,0,8,8
1653598314335,MATH 283,A00,087447,Tesler; Glenn,0,0,0,16
1653598314883,MATH 286,B00,095535,Kemp; Todd Aahron,7,0,8,1
1653598315415,MATH 287D,B00,095536,Bradic; Jelena,5,0,8,3
1653598315940,MATH 288,A00,087450,Staff,14,0,15,1
1653598315940,MATH 288,B00,087451,Staff,15,0,15,0
1653598315940,MATH 288,C00,087452,Staff,15,0,15,0
1653598316467,MATH 290A,A00,087453,Xu; Zhouli,6,0,8,2
1653598317015,MATH 291A,A00,087454,Xu; Zhouli,7,0,8,1
1653598317540,MATH 292,A00,087455,Staff,10,0,10,0
1653598318070,MATH 295,A00,087456,Staff,50,0,50,0
1653598318592,MATH 297,001,087457,Staff,997,0,999,2
1653598885338,COGS 200,A01,087991,Staff,47,0,50,3
1653598885885,COGS 201,A01,094504,Rangel; Lara M,16,0,25,9
1653598886418,COGS 203,A00,087992,Coulson; Seana M,18,0,20,2
1653598886942,COGS 210A,001,087993,Greene; Deanna Jacquelyn,9998,0,9999,1
1653598886942,COGS 210A,002,087994,Saygin; Ayse P,9999,0,9999,0
1653598886942,COGS 210A,003,087995,Xia; Haijun,9999,0,9999,0
1653598886942,COGS 210A,004,087996,Nitz; Douglas A.,9999,0,9999,0
1653598886942,COGS 210A,005,087997,Hollan; James D.,9999,0,9999,0
1653598886942,COGS 210A,006,087998,Deak; Gedeon O.,9998,0,9999,1
1653598886942,COGS 210A,007,087999,Rossano; Federico,9999,0,9999,0
1653598887490,COGS 211A,A00,088000,Coulson; Seana M,9997,0,9999,2
1653598888043,COGS 229,A00,088002,Staff,22,0,25,3
1653598888569,COGS 260,B00,094231,Staff,17,0,20,3
1653598888569,COGS 260,A00,088004,Nitz; Douglas A.,9998,0,9999,1
1653598889100,CSE 202,A00,090110,Paturi; Ramamohan,0,0,0,0
1653598889100,CSE 202,B00,090111,Paturi; Ramamohan,0,0,0,0
1653598889634,CSE 207B,A00,090112,Heninger; Nadia A,0,0,0,0
1653598890162,CSE 208,A00,094858,Micciancio; Daniele,0,0,0,0
1653598890688,CSE 210,A00,090113,Powell; Thomas Allan,0,0,0,0
1653598891210,CSE 219,A00,090898,Staff,0,0,0,0
1653598891756,CSE 221,A00,090114,Zhou; Yuan-Yuan,0,0,0,0
1653598892280,CSE 229A,A00,090115,Porter; George M,0,0,0,0
1653598892805,CSE 229C,A00,090116,Savage; Stefan,0,0,0,0
1653598893332,CSE 230,A00,090117,Jhala; Ranjit,0,0,0,0
1653598893858,CSE 232,A00,090118,Papakonstantinou; Yannis,0,0,0,0
1653598894392,CSE 239A,A00,090121,Kumar; Arun Kumar,0,0,0,0
1653598894931,CSE 239B,A00,090122,Jhala; Ranjit,0,0,0,0
1653598895462,CSE 240A,A00,090123,Zhao; Jishen,0,0,189,189
1653598895984,CSE 243A,A00,090124,Orailoglu; Alex,0,0,15,15
1653598896510,CSE 249B,A00,090125,Kahng; Andrew Byun,12,0,20,8
1653598897050,CSE 250A,A00,090126,Berg-Kirkpatrick; Taylor D,0,0,0,0
1653598897577,CSE 252A,A00,090127,Ochoa; Benjamin Lawrence,0,0,0,0
1653598898110,CSE 258,A01,090129,McAuley; Julian John,0,0,0,0
1653598898633,CSE 258R,A01,090131,McAuley; Julian John,0,0,0,0
1653598899156,CSE 274,A00,090132,Ramamoorthi; Ravi,0,0,0,0
1653598899699,CSE 276A,A00,090133,Christensen; Henrik I,0,0,0,0
1653598900231,CSE 276C,A00,090134,Christensen; Henrik I,0,0,0,0
1653598900789,CSE 290,A00,090135,Bafna; Vineet,0,0,0,0
1653598900789,CSE 290,B00,090136,Ramamoorthi; Ravi,0,0,0,0
1653598900789,CSE 290,C00,090137,Li; Tzumao,7,0,10,3
1653598900789,CSE 290,D00,090138,Zhou; Yuan-Yuan,9,0,10,1
1653598900789,CSE 290,E00,090139,Christensen; Henrik I,8,0,10,2
1653598900789,CSE 290,F00,094053,Shalev; Aaron D,0,0,0,0
1653598901329,CSE 291,A00,090140,Munyaka; Imani N. S.,0,0,0,0
1653598901329,CSE 291,B00,094880,Yu; Qi,0,0,0,0
1653598901329,CSE 291,C00,090142,Pannuto; Patrick William,0,0,0,0
1653598901329,CSE 291,D00,094881,Zhang; Yiying,0,0,0,0
1653598901329,CSE 291,E00,095118,Su; Hao,0,0,0,0
1653598901864,CSE 293,001,094905,Bafna; Vineet,9999,0,9999,0
1653598901864,CSE 293,002,094906,Bellare; Mihir,9999,0,9999,0
1653598901864,CSE 293,003,094907,Berg-Kirkpatrick; Taylor D,9999,0,9999,0
1653598901864,CSE 293,004,094908,Christensen; Henrik I,9999,0,9999,0
1653598901864,CSE 293,005,094909,Cottrell; Garrison W,9999,0,9999,0
1653598901864,CSE 293,006,094910,Deutsch; Alin Bernard,9999,0,9999,0
1653598901864,CSE 293,007,094911,Esmaeilzadeh; Hadi,9999,0,9999,0
1653598901864,CSE 293,008,094912,Freund; Yoav,9999,0,9999,0
1653598901864,CSE 293,009,094913,Griswold; William G.,9999,0,9999,0
1653598901864,CSE 293,010,094914,Gymrek; Melissa Ann,9999,0,9999,0
1653598901864,CSE 293,011,094915,Heninger; Nadia A,9999,0,9999,0
1653598901864,CSE 293,012,094916,Impagliazzo; Russell,9999,0,9999,0
1653598901864,CSE 293,013,094917,Jhala; Ranjit,9999,0,9999,0
1653598901864,CSE 293,014,094918,Kahng; Andrew Byun,9999,0,9999,0
1653598901864,CSE 293,015,094919,Kane; Daniel Mertz,9999,0,9999,0
1653598901864,CSE 293,016,094920,Kriegman; David J,9999,0,9999,0
1653598901864,CSE 293,017,094921,Kumar; Arun Kumar,9999,0,9999,0
1653598901864,CSE 293,018,094922,Lerner; Sorin,9999,0,9999,0
1653598901864,CSE 293,019,094923,Lovett; Shachar,9999,0,9999,0
1653598901864,CSE 293,020,094924,McAuley; Julian John,9999,0,9999,0
1653598901864,CSE 293,021,094925,Micciancio; Daniele,9999,0,9999,0
1653598901864,CSE 293,022,094926,Orailoglu; Alex,9999,0,9999,0
1653598901864,CSE 293,023,094927,Paturi; Ramamohan,9999,0,9999,0
1653598901864,CSE 293,024,094928,Polikarpova; Nadezhda,9999,0,9999,0
1653598901864,CSE 293,025,094929,Politz; Joseph Gibbs,9999,0,9999,0
1653598901864,CSE 293,026,094930,Porter; George M,9999,0,9999,0
1653598901864,CSE 293,027,094931,Porter; Leonard Emerson,9999,0,9999,0
1653598901864,CSE 293,028,094932,Ramamoorthi; Ravi,9999,0,9999,0
1653598901864,CSE 293,029,094933,Sahoo; Debashis,9999,0,9999,0
1653598901864,CSE 293,030,094934,Saul; Lawrence,9999,0,9999,0
1653598901864,CSE 293,031,094935,Savage; Stefan,9999,0,9999,0
1653598901864,CSE 293,032,094936,Schulze; Jurgen P.,9999,0,9999,0
1653598901864,CSE 293,033,094937,Snoeren; Alex C.,9999,0,9999,0
1653598901864,CSE 293,034,094938,Shang; Jingbo,9999,0,9999,0
1653598901864,CSE 293,035,094939,Stefan; Deian,9999,0,9999,0
1653598901864,CSE 293,036,094940,Su; Hao,9999,0,9999,0
1653598901864,CSE 293,037,094941,Swanson; Steven James,9999,0,9999,0
1653598901864,CSE 293,038,094942,Tullsen; Dean Michael,9999,0,9999,0
1653598901864,CSE 293,039,094943,Voelker; Geoffrey M.,9999,0,9999,0
1653598901864,CSE 293,040,094944,Zhao; Jishen,9999,0,9999,0
1653598901864,CSE 293,041,094945,Zhou; Yuan-Yuan,9999,0,9999,0
1653598901864,CSE 293,042,094946,Gao; Sicun,9998,0,9999,1
1653598901864,CSE 293,043,094947,Weibel; Nadir,9999,0,9999,0
1653598901864,CSE 293,044,094948,Gupta; Rajesh K.,9999,0,9999,0
1653598902385,CSE 294,A00,090143,Porter; George M,8,0,10,2
1653598902911,DSE 200,A00,091799,Staff,50,0,50,0
1653598903436,DSE 203,A00,091800,Gupta; Amarnath,30,0,30,0
1653598903980,DSE 250,A00,091801,Deutsch; Alin Bernard,30,0,30,0
1653598904503,DSE 290,A00,091802,Altintas De Callaf; Ilkay,50,0,50,0
1653598905039,ECE 200,001,091003,Antipa; Nicholas A,9999,0,9999,0
1653598905039,ECE 200,002,091004,Atanasov; Nikolay A.,9999,0,9999,0
1653598905039,ECE 200,003,091005,Bharadia; Dinesh,9999,0,9999,0
1653598905039,ECE 200,004,091006,Cheng; Chung Kuan,9999,0,9999,0
1653598905039,ECE 200,005,091007,Cosman; Pamela C.,9999,0,9999,0
1653598905039,ECE 200,006,091008,Staff,9999,0,9999,0
1653598905039,ECE 200,007,091009,Dayeh; Shadi Ahmad,9999,0,9999,0
1653598905039,ECE 200,008,091010,Fainman; Yeshaiahu,9999,0,9999,0
1653598905039,ECE 200,009,091011,Ford; Joseph Earl,9999,0,9999,0
1653598905039,ECE 200,010,091012,Franceschetti; Massimo,9999,0,9999,0
1653598905039,ECE 200,011,091013,Fullerton; Eric E,9999,0,9999,0
1653598905039,ECE 200,012,091014,Galton; Ian A,9999,0,9999,0
1653598905039,ECE 200,013,091015,Gilja; Vikash,9999,0,9999,0
1653598905039,ECE 200,014,091016,Hall; Drew A.,9999,0,9999,0
1653598905039,ECE 200,015,091017,Hsueh; Tzu-Chien,9999,0,9999,0
1653598905039,ECE 200,016,091018,Javidi; Tara,9999,0,9999,0
1653598905039,ECE 200,017,091019,Kahng; Andrew Byun,9999,0,9999,0
1653598905039,ECE 200,018,091020,Kim; Young-Han,9999,0,9999,0
1653598905039,ECE 200,019,091021,Koushanfar; Farinaz,9999,0,9999,0
1653598905039,ECE 200,020,091022,Kuzum; Duygu,9999,0,9999,0
1653598905039,ECE 200,021,091023,Le; Hanh-Phuc,9999,0,9999,0
1653598905039,ECE 200,022,091024,Lin; Bill,9999,0,9999,0
1653598905039,ECE 200,023,091025,Liu; Zhaowei,9999,0,9999,0
1653598905039,ECE 200,024,091026,Lo; Yu-Hwa,9999,0,9999,0
1653598905039,ECE 200,025,091027,Lomakin; Vitaliy,9999,0,9999,0
1653598905039,ECE 200,026,091028,Mercier; Patrick Philip,9999,0,9999,0
1653598905039,ECE 200,027,091029,Meyer; Florian,9999,0,9999,0
1653598905039,ECE 200,028,091030,Milstein; Laurence B.,9999,0,9999,0
1653598905039,ECE 200,029,091031,Mir Arabbaygi; Siavash,9999,0,9999,0
1653598905039,ECE 200,030,091032,Mookherjea; Shayan,9999,0,9999,0
1653598905039,ECE 200,031,091033,Morris; Karcher William,9999,0,9999,0
1653598905039,ECE 200,032,091034,Ng; Tse Nga,9999,0,9999,0
1653598905039,ECE 200,033,091035,Nguyen; Truong Quang,9999,0,9999,0
1653598905039,ECE 200,034,091036,Nomura; Kenji,9999,0,9999,0
1653598905039,ECE 200,035,091037,Orlitsky; Alon,9999,0,9999,0
1653598905039,ECE 200,036,091038,Pal; Piya,9999,0,9999,0
1653598905039,ECE 200,037,091039,Papen; George C.,9999,0,9999,0
1653598905039,ECE 200,038,091040,Radic; Stojan,9999,0,9999,0
1653598905039,ECE 200,039,091041,Rao; Bhaskar D.,9999,0,9999,0
1653598905039,ECE 200,040,091042,Rao; Ramesh R,9999,0,9999,0
1653598905039,ECE 200,041,091043,Rebeiz; Gabriel,9999,0,9999,0
1653598905039,ECE 200,042,091044,Sanford; John R,9999,0,9999,0
1653598905039,ECE 200,043,091045,Siegel; Paul H.,9999,0,9999,0
1653598905039,ECE 200,044,091046,Sievenpiper; Daniel F.,9999,0,9999,0
1653598905039,ECE 200,045,091047,Sworder; David D.,9999,0,9999,0
1653598905039,ECE 200,046,091048,Taur; Yuan,9999,0,9999,0
1653598905039,ECE 200,047,091049,Touri; Behrouz,9999,0,9999,0
1653598905039,ECE 200,048,091050,Trivedi; Mohan M.,9999,0,9999,0
1653598905039,ECE 200,049,091051,Vardy; Alexander,9999,0,9999,0
1653598905039,ECE 200,050,091052,Vasconcelos; Nuno,9999,0,9999,0
1653598905039,ECE 200,051,091053,Wang; Xiaolong,9999,0,9999,0
1653598905039,ECE 200,052,091054,Xie; Pengtao,9999,0,9999,0
1653598905039,ECE 200,053,091055,Yip; Michael,9999,0,9999,0
1653598905039,ECE 200,054,091056,Zeger; Kenneth A.,9999,0,9999,0
1653598905039,ECE 200,055,091057,Zhang; Xinyu,9999,0,9999,0
1653598905039,ECE 200,056,091058,Turakhia; Yatish Girish,9999,0,9999,0
1653598905039,ECE 200,057,091059,Kang; Mingu,9999,0,9999,0
1653598905039,ECE 200,058,091060,Shi; Yuanyuan,9999,0,9999,0
1653598905039,ECE 200,059,091061,Wang; Edward Jay,9999,0,9999,0
1653598905039,ECE 200,060,091062,Zheng; Yang,9999,0,9999,0
1653598905562,ECE 201,A00,095526,Lo; Yu-Hwa,0,0,0,0
1653598906107,ECE 203,A00,091065,Mercier; Patrick Philip,0,0,0,0
1653598906637,ECE 207A,A00,091605,Liu; Thomas Tao-Ming,0,0,0,0
1653598907163,ECE 212AN,A00,091068,Nomura; Kenji,0,0,0,0
1653598907692,ECE 222A,A00,091069,Rebeiz; Gabriel,0,0,0,0
1653598908235,ECE 225A,A00,091070,Orlitsky; Alon,0,0,0,0
1653598908769,ECE 230A,A00,091071,Nomura; Kenji,0,0,0,0
1653598909305,ECE 236A,A00,091072,Dayeh; Shadi Ahmad,0,0,0,0
1653598909857,ECE 238A,A00,091073,Luo; Jian,0,0,0,0
1653598909857,ECE 238A,B00,091074,Luo; Jian,0,0,0,0
1653598910385,ECE 240A,A00,091075,Radic; Stojan,0,0,0,0
1653598910934,ECE 247A,A00,091592,Shi; Lingyan,0,0,0,0
1653598911488,ECE 250,A00,091076,Touri; Behrouz,0,0,0,0
1653598912041,ECE 251C,A00,091078,Nguyen; Truong Quang,0,0,0,0
1653598912590,ECE 253,A00,091079,Cosman; Pamela C.,0,0,0,0
1653598913116,ECE 255A,A00,091080,Orlitsky; Alon,0,0,0,0
1653598913640,ECE 257A,A00,091081,Zhang; Xinyu,0,0,0,0
1653598914171,ECE 260A,A01,091084,Eldon; John,0,0,0,0
1653598914694,ECE 264C,A00,091085,Galton; Ian A,0,0,0,0
1653598915217,ECE 265C,A00,094889,Presti; Calogero Davide,0,0,0,9
1653598915742,ECE 266,A01,091087,Hall; Drew A.,0,0,0,0
1653598916813,ECE 271A,A00,091090,Vasconcelos; Nuno,0,0,0,0
1653598917343,ECE 272B,A00,091091,Sworder; David D.,0,0,0,0
1653598917871,ECE 275A,A00,091092,Meyer; Florian,0,0,0,0
1653598918394,ECE 277,A00,091093,An; Cheolhong,0,0,0,0
1653598918920,ECE 283,A00,091094,Le; Hanh-Phuc,0,0,0,0
1653598919529,ECE 284,A00,091095,Kang; Mingu,0,0,0,0
1653598919529,ECE 284,B00,091096,Wang; Edward Jay,0,0,0,0
1653598920050,ECE 285,A00,094334,Touri; Behrouz,0,0,0,0
1653598920577,ECE 289,A00,091097,Whelan; David Arthur,0,0,0,0
1653598921100,MATH 200A,A00,087414,Salehi Golsefidy; Alireza,7,0,8,1
1653598921623,MATH 202A,A00,087415,Gill; Philip E.,2,0,8,6
1653598922169,MATH 203A,A00,087416,Oprea; Dragos N.,6,0,8,2
1653598922715,MATH 204A,A00,087417,Kedlaya; Kiran S.,6,0,8,2
1653598923253,MATH 205,A00,087418,Sorensen; Claus M,6,0,8,2
1653598923807,MATH 206A,A00,087419,Izadi; Elham,7,0,8,1
1653598924340,MATH 207A,A00,087420,Mohammadi; Amir,5,0,8,3
1653598924888,MATH 208,A00,087421,Staff,9,0,10,1
1653598925432,MATH 209,A00,087422,Staff,10,0,10,0
1653598925963,MATH 218,A00,087423,Staff,10,0,10,0
1653598926492,MATH 220A,A00,087424,Novak; Jonathan I,6,0,8,2
1653598927027,MATH 231A,A00,087425,Bejenaru; Ioan,3,0,8,5
1653598927581,MATH 240A,A00,087426,Ebenfelt; Peter F,5,0,8,3
1653598928103,MATH 243,A00,087427,Staff,9,0,10,1
1653598928639,MATH 248,A00,087429,Staff,10,0,10,0
1653598929171,MATH 250A,A00,087430,Spolaor; Luca,4,0,8,4
1653598929694,MATH 257A,A00,087431,Spolaor; Luca,7,0,8,1
1653598930225,MATH 258,A00,087432,Staff,9,0,10,1
1653598930751,MATH 264A,A00,087433,Warnke; Lutz Peter,5,0,8,3
1653598931286,MATH 268,A00,087434,Staff,15,0,15,0
1653598931820,MATH 269,A00,087435,Staff,14,0,15,1
1653598932348,MATH 270A,A00,087436,Nie; Jiawang,0,0,8,8
1653598932880,MATH 272A,A00,087437,Tian; Xiaochuan,0,0,8,8
1653598933414,MATH 274,A01,087439,Cheng; Li-Tien,9,0,10,1
1653598933414,MATH 274,A02,087440,Cheng; Li-Tien,10,0,10,0
1653598933956,MATH 278A,A00,087441,Staff,8,0,10,2
1653598934478,MATH 278B,A00,087442,Staff,8,0,10,2
1653598935000,MATH 278C,A00,087443,Staff,8,0,10,2
1653598935540,MATH 280A,A00,087444,Zheng; Tianyi,0,0,8,8
1653598936088,MATH 281A,A00,087445,Bradic; Jelena,0,0,8,8
1653598936644,MATH 282A,A00,087446,Zhang; Danna,0,0,8,8
1653598937166,MATH 283,A00,087447,Tesler; Glenn,0,0,0,16
1653598937695,MATH 286,B00,095535,Kemp; Todd Aahron,7,0,8,1
1653598938222,MATH 287D,B00,095536,Bradic; Jelena,5,0,8,3
1653598938768,MATH 288,A00,087450,Staff,14,0,15,1
1653598938768,MATH 288,B00,087451,Staff,15,0,15,0
1653598938768,MATH 288,C00,087452,Staff,15,0,15,0
1653598939309,MATH 290A,A00,087453,Xu; Zhouli,6,0,8,2
1653598939842,MATH 291A,A00,087454,Xu; Zhouli,7,0,8,1
1653598940376,MATH 292,A00,087455,Staff,10,0,10,0
1653598940912,MATH 295,A00,087456,Staff,50,0,50,0
1653598941443,MATH 297,001,087457,Staff,997,0,999,2
1653599520291,COGS 200,A01,087991,Staff,47,0,50,3
1653599520817,COGS 201,A01,094504,Rangel; Lara M,16,0,25,9
1653599521342,COGS 203,A00,087992,Coulson; Seana M,18,0,20,2
1653599521874,COGS 210A,001,087993,Greene; Deanna Jacquelyn,9998,0,9999,1
1653599521874,COGS 210A,002,087994,Saygin; Ayse P,9999,0,9999,0
1653599521874,COGS 210A,003,087995,Xia; Haijun,9999,0,9999,0
1653599521874,COGS 210A,004,087996,Nitz; Douglas A.,9999,0,9999,0
1653599521874,COGS 210A,005,087997,Hollan; James D.,9999,0,9999,0
1653599521874,COGS 210A,006,087998,Deak; Gedeon O.,9998,0,9999,1
1653599521874,COGS 210A,007,087999,Rossano; Federico,9999,0,9999,0
1653599522412,COGS 211A,A00,088000,Coulson; Seana M,9997,0,9999,2
1653599522946,COGS 229,A00,088002,Staff,22,0,25,3
1653599523482,COGS 260,B00,094231,Staff,17,0,20,3
1653599523482,COGS 260,A00,088004,Nitz; Douglas A.,9998,0,9999,1
1653599524019,CSE 202,A00,090110,Paturi; Ramamohan,0,0,0,0
1653599524019,CSE 202,B00,090111,Paturi; Ramamohan,0,0,0,0
1653599524542,CSE 207B,A00,090112,Heninger; Nadia A,0,0,0,0
1653599525079,CSE 208,A00,094858,Micciancio; Daniele,0,0,0,0
1653599525615,CSE 210,A00,090113,Powell; Thomas Allan,0,0,0,0
1653599526239,CSE 219,A00,090898,Staff,0,0,0,0
1653599526771,CSE 221,A00,090114,Zhou; Yuan-Yuan,0,0,0,0
1653599527294,CSE 229A,A00,090115,Porter; George M,0,0,0,0
1653599527821,CSE 229C,A00,090116,Savage; Stefan,0,0,0,0
1653599528359,CSE 230,A00,090117,Jhala; Ranjit,0,0,0,0
1653599528889,CSE 232,A00,090118,Papakonstantinou; Yannis,0,0,0,0
1653599529415,CSE 239A,A00,090121,Kumar; Arun Kumar,0,0,0,0
1653599529946,CSE 239B,A00,090122,Jhala; Ranjit,0,0,0,0
1653599530482,CSE 240A,A00,090123,Zhao; Jishen,0,0,189,189
1653599531019,CSE 243A,A00,090124,Orailoglu; Alex,0,0,15,15
1653599531541,CSE 249B,A00,090125,Kahng; Andrew Byun,12,0,20,8
1653599532089,CSE 250A,A00,090126,Berg-Kirkpatrick; Taylor D,0,0,0,0
1653599532617,CSE 252A,A00,090127,Ochoa; Benjamin Lawrence,0,0,0,0
1653599533162,CSE 258,A01,090129,McAuley; Julian John,0,0,0,0
1653599533692,CSE 258R,A01,090131,McAuley; Julian John,0,0,0,0
1653599534233,CSE 274,A00,090132,Ramamoorthi; Ravi,0,0,0,0
1653599534778,CSE 276A,A00,090133,Christensen; Henrik I,0,0,0,0
1653599535304,CSE 276C,A00,090134,Christensen; Henrik I,0,0,0,0
1653599535829,CSE 290,A00,090135,Bafna; Vineet,0,0,0,0
1653599535829,CSE 290,B00,090136,Ramamoorthi; Ravi,0,0,0,0
1653599535829,CSE 290,C00,090137,Li; Tzumao,7,0,10,3
1653599535829,CSE 290,D00,090138,Zhou; Yuan-Yuan,9,0,10,1
1653599535829,CSE 290,E00,090139,Christensen; Henrik I,8,0,10,2
1653599535829,CSE 290,F00,094053,Shalev; Aaron D,0,0,0,0
1653599536365,CSE 291,A00,090140,Munyaka; Imani N. S.,0,0,0,0
1653599536365,CSE 291,B00,094880,Yu; Qi,0,0,0,0
1653599536365,CSE 291,C00,090142,Pannuto; Patrick William,0,0,0,0
1653599536365,CSE 291,D00,094881,Zhang; Yiying,0,0,0,0
1653599536365,CSE 291,E00,095118,Su; Hao,0,0,0,0
1653599536931,CSE 293,001,094905,Bafna; Vineet,9999,0,9999,0
1653599536931,CSE 293,002,094906,Bellare; Mihir,9999,0,9999,0
1653599536931,CSE 293,003,094907,Berg-Kirkpatrick; Taylor D,9999,0,9999,0
1653599536931,CSE 293,004,094908,Christensen; Henrik I,9999,0,9999,0
1653599536931,CSE 293,005,094909,Cottrell; Garrison W,9999,0,9999,0
1653599536931,CSE 293,006,094910,Deutsch; Alin Bernard,9999,0,9999,0
1653599536931,CSE 293,007,094911,Esmaeilzadeh; Hadi,9999,0,9999,0
1653599536931,CSE 293,008,094912,Freund; Yoav,9999,0,9999,0
1653599536931,CSE 293,009,094913,Griswold; William G.,9999,0,9999,0
1653599536931,CSE 293,010,094914,Gymrek; Melissa Ann,9999,0,9999,0
1653599536931,CSE 293,011,094915,Heninger; Nadia A,9999,0,9999,0
1653599536931,CSE 293,012,094916,Impagliazzo; Russell,9999,0,9999,0
1653599536931,CSE 293,013,094917,Jhala; Ranjit,9999,0,9999,0
1653599536931,CSE 293,014,094918,Kahng; Andrew Byun,9999,0,9999,0
1653599536931,CSE 293,015,094919,Kane; Daniel Mertz,9999,0,9999,0
1653599536931,CSE 293,016,094920,Kriegman; David J,9999,0,9999,0
1653599536931,CSE 293,017,094921,Kumar; Arun Kumar,9999,0,9999,0
1653599536931,CSE 293,018,094922,Lerner; Sorin,9999,0,9999,0
1653599536931,CSE 293,019,094923,Lovett; Shachar,9999,0,9999,0
1653599536931,CSE 293,020,094924,McAuley; Julian John,9999,0,9999,0
1653599536931,CSE 293,021,094925,Micciancio; Daniele,9999,0,9999,0
1653599536931,CSE 293,022,094926,Orailoglu; Alex,9999,0,9999,0
1653599536931,CSE 293,023,094927,Paturi; Ramamohan,9999,0,9999,0
1653599536931,CSE 293,024,094928,Polikarpova; Nadezhda,9999,0,9999,0
1653599536931,CSE 293,025,094929,Politz; Joseph Gibbs,9999,0,9999,0
1653599536931,CSE 293,026,094930,Porter; George M,9999,0,9999,0
1653599536931,CSE 293,027,094931,Porter; Leonard Emerson,9999,0,9999,0
1653599536931,CSE 293,028,094932,Ramamoorthi; Ravi,9999,0,9999,0
1653599536931,CSE 293,029,094933,Sahoo; Debashis,9999,0,9999,0
1653599536931,CSE 293,030,094934,Saul; Lawrence,9999,0,9999,0
1653599536931,CSE 293,031,094935,Savage; Stefan,9999,0,9999,0
1653599536931,CSE 293,032,094936,Schulze; Jurgen P.,9999,0,9999,0
1653599536931,CSE 293,033,094937,Snoeren; Alex C.,9999,0,9999,0
1653599536931,CSE 293,034,094938,Shang; Jingbo,9999,0,9999,0
1653599536931,CSE 293,035,094939,Stefan; Deian,9999,0,9999,0
1653599536931,CSE 293,036,094940,Su; Hao,9999,0,9999,0
1653599536931,CSE 293,037,094941,Swanson; Steven James,9999,0,9999,0
1653599536931,CSE 293,038,094942,Tullsen; Dean Michael,9999,0,9999,0
1653599536931,CSE 293,039,094943,Voelker; Geoffrey M.,9999,0,9999,0
1653599536931,CSE 293,040,094944,Zhao; Jishen,9999,0,9999,0
1653599536931,CSE 293,041,094945,Zhou; Yuan-Yuan,9999,0,9999,0
1653599536931,CSE 293,042,094946,Gao; Sicun,9998,0,9999,1
1653599536931,CSE 293,043,094947,Weibel; Nadir,9999,0,9999,0
1653599536931,CSE 293,044,094948,Gupta; Rajesh K.,9999,0,9999,0
1653599537455,CSE 294,A00,090143,Porter; George M,8,0,10,2
1653599537984,DSE 200,A00,091799,Staff,50,0,50,0
1653599538509,DSE 203,A00,091800,Gupta; Amarnath,30,0,30,0
1653599539037,DSE 250,A00,091801,Deutsch; Alin Bernard,30,0,30,0
1653599539574,DSE 290,A00,091802,Altintas De Callaf; Ilkay,50,0,50,0
1653599540102,ECE 200,001,091003,Antipa; Nicholas A,9999,0,9999,0
1653599540102,ECE 200,002,091004,Atanasov; Nikolay A.,9999,0,9999,0
1653599540102,ECE 200,003,091005,Bharadia; Dinesh,9999,0,9999,0
1653599540102,ECE 200,004,091006,Cheng; Chung Kuan,9999,0,9999,0
1653599540102,ECE 200,005,091007,Cosman; Pamela C.,9999,0,9999,0
1653599540102,ECE 200,006,091008,Staff,9999,0,9999,0
1653599540102,ECE 200,007,091009,Dayeh; Shadi Ahmad,9999,0,9999,0
1653599540102,ECE 200,008,091010,Fainman; Yeshaiahu,9999,0,9999,0
1653599540102,ECE 200,009,091011,Ford; Joseph Earl,9999,0,9999,0
1653599540102,ECE 200,010,091012,Franceschetti; Massimo,9999,0,9999,0
1653599540102,ECE 200,011,091013,Fullerton; Eric E,9999,0,9999,0
1653599540102,ECE 200,012,091014,Galton; Ian A,9999,0,9999,0
1653599540102,ECE 200,013,091015,Gilja; Vikash,9999,0,9999,0
1653599540102,ECE 200,014,091016,Hall; Drew A.,9999,0,9999,0
1653599540102,ECE 200,015,091017,Hsueh; Tzu-Chien,9999,0,9999,0
1653599540102,ECE 200,016,091018,Javidi; Tara,9999,0,9999,0
1653599540102,ECE 200,017,091019,Kahng; Andrew Byun,9999,0,9999,0
1653599540102,ECE 200,018,091020,Kim; Young-Han,9999,0,9999,0
1653599540102,ECE 200,019,091021,Koushanfar; Farinaz,9999,0,9999,0
1653599540102,ECE 200,020,091022,Kuzum; Duygu,9999,0,9999,0
1653599540102,ECE 200,021,091023,Le; Hanh-Phuc,9999,0,9999,0
1653599540102,ECE 200,022,091024,Lin; Bill,9999,0,9999,0
1653599540102,ECE 200,023,091025,Liu; Zhaowei,9999,0,9999,0
1653599540102,ECE 200,024,091026,Lo; Yu-Hwa,9999,0,9999,0
1653599540102,ECE 200,025,091027,Lomakin; Vitaliy,9999,0,9999,0
1653599540102,ECE 200,026,091028,Mercier; Patrick Philip,9999,0,9999,0
1653599540102,ECE 200,027,091029,Meyer; Florian,9999,0,9999,0
1653599540102,ECE 200,028,091030,Milstein; Laurence B.,9999,0,9999,0
1653599540102,ECE 200,029,091031,Mir Arabbaygi; Siavash,9999,0,9999,0
1653599540102,ECE 200,030,091032,Mookherjea; Shayan,9999,0,9999,0
1653599540102,ECE 200,031,091033,Morris; Karcher William,9999,0,9999,0
1653599540102,ECE 200,032,091034,Ng; Tse Nga,9999,0,9999,0
1653599540102,ECE 200,033,091035,Nguyen; Truong Quang,9999,0,9999,0
1653599540102,ECE 200,034,091036,Nomura; Kenji,9999,0,9999,0
1653599540102,ECE 200,035,091037,Orlitsky; Alon,9999,0,9999,0
1653599540102,ECE 200,036,091038,Pal; Piya,9999,0,9999,0
1653599540102,ECE 200,037,091039,Papen; George C.,9999,0,9999,0
1653599540102,ECE 200,038,091040,Radic; Stojan,9999,0,9999,0
1653599540102,ECE 200,039,091041,Rao; Bhaskar D.,9999,0,9999,0
1653599540102,ECE 200,040,091042,Rao; Ramesh R,9999,0,9999,0
1653599540102,ECE 200,041,091043,Rebeiz; Gabriel,9999,0,9999,0
1653599540102,ECE 200,042,091044,Sanford; John R,9999,0,9999,0
1653599540102,ECE 200,043,091045,Siegel; Paul H.,9999,0,9999,0
1653599540102,ECE 200,044,091046,Sievenpiper; Daniel F.,9999,0,9999,0
1653599540102,ECE 200,045,091047,Sworder; David D.,9999,0,9999,0
1653599540102,ECE 200,046,091048,Taur; Yuan,9999,0,9999,0
1653599540102,ECE 200,047,091049,Touri; Behrouz,9999,0,9999,0
1653599540102,ECE 200,048,091050,Trivedi; Mohan M.,9999,0,9999,0
1653599540102,ECE 200,049,091051,Vardy; Alexander,9999,0,9999,0
1653599540102,ECE 200,050,091052,Vasconcelos; Nuno,9999,0,9999,0
1653599540102,ECE 200,051,091053,Wang; Xiaolong,9999,0,9999,0
1653599540102,ECE 200,052,091054,Xie; Pengtao,9999,0,9999,0
1653599540102,ECE 200,053,091055,Yip; Michael,9999,0,9999,0
1653599540102,ECE 200,054,091056,Zeger; Kenneth A.,9999,0,9999,0
1653599540102,ECE 200,055,091057,Zhang; Xinyu,9999,0,9999,0
1653599540102,ECE 200,056,091058,Turakhia; Yatish Girish,9999,0,9999,0
1653599540102,ECE 200,057,091059,Kang; Mingu,9999,0,9999,0
1653599540102,ECE 200,058,091060,Shi; Yuanyuan,9999,0,9999,0
1653599540102,ECE 200,059,091061,Wang; Edward Jay,9999,0,9999,0
1653599540102,ECE 200,060,091062,Zheng; Yang,9999,0,9999,0
1653599540634,ECE 201,A00,095526,Lo; Yu-Hwa,0,0,0,0
1653599541168,ECE 203,A00,091065,Mercier; Patrick Philip,0,0,0,0
1653599541713,ECE 207A,A00,091605,Liu; Thomas Tao-Ming,0,0,0,0
1653599542248,ECE 212AN,A00,091068,Nomura; Kenji,0,0,0,0
1653599542770,ECE 222A,A00,091069,Rebeiz; Gabriel,0,0,0,0
1653599543297,ECE 225A,A00,091070,Orlitsky; Alon,0,0,0,0
1653599543844,ECE 230A,A00,091071,Nomura; Kenji,0,0,0,0
1653599544373,ECE 236A,A00,091072,Dayeh; Shadi Ahmad,0,0,0,0
1653599544920,ECE 238A,A00,091073,Luo; Jian,0,0,0,0
1653599544920,ECE 238A,B00,091074,Luo; Jian,0,0,0,0
1653599545455,ECE 240A,A00,091075,Radic; Stojan,0,0,0,0
1653599545979,ECE 247A,A00,091592,Shi; Lingyan,0,0,0,0
1653599546513,ECE 250,A00,091076,Touri; Behrouz,0,0,0,0
1653599547059,ECE 251C,A00,091078,Nguyen; Truong Quang,0,0,0,0
1653599547586,ECE 253,A00,091079,Cosman; Pamela C.,0,0,0,0
1653599548109,ECE 255A,A00,091080,Orlitsky; Alon,0,0,0,0
1653599548639,ECE 257A,A00,091081,Zhang; Xinyu,0,0,0,0
1653599549163,ECE 260A,A01,091084,Eldon; John,0,0,0,0
1653599549686,ECE 264C,A00,091085,Galton; Ian A,0,0,0,0
1653599550212,ECE 265C,A00,094889,Presti; Calogero Davide,0,0,0,9
1653599550771,ECE 266,A01,091087,Hall; Drew A.,0,0,0,0
1653599551830,ECE 271A,A00,091090,Vasconcelos; Nuno,0,0,0,0
1653599552358,ECE 272B,A00,091091,Sworder; David D.,0,0,0,0
1653599552881,ECE 275A,A00,091092,Meyer; Florian,0,0,0,0
1653599553404,ECE 277,A00,091093,An; Cheolhong,0,0,0,0
1653599553945,ECE 283,A00,091094,Le; Hanh-Phuc,0,0,0,0
1653599554468,ECE 284,A00,091095,Kang; Mingu,0,0,0,0
1653599554468,ECE 284,B00,091096,Wang; Edward Jay,0,0,0,0
1653599554990,ECE 285,A00,094334,Touri; Behrouz,0,0,0,0
1653599555520,ECE 289,A00,091097,Whelan; David Arthur,0,0,0,0
1653599556049,MATH 200A,A00,087414,Salehi Golsefidy; Alireza,7,0,8,1
1653599556574,MATH 202A,A00,087415,Gill; Philip E.,2,0,8,6
1653599557103,MATH 203A,A00,087416,Oprea; Dragos N.,6,0,8,2
1653599557626,MATH 204A,A00,087417,Kedlaya; Kiran S.,6,0,8,2
1653599558166,MATH 205,A00,087418,Sorensen; Claus M,6,0,8,2
1653599558699,MATH 206A,A00,087419,Izadi; Elham,7,0,8,1
1653599559227,MATH 207A,A00,087420,Mohammadi; Amir,5,0,8,3
1653599559752,MATH 208,A00,087421,Staff,9,0,10,1
1653599560293,MATH 209,A00,087422,Staff,10,0,10,0
1653599560828,MATH 218,A00,087423,Staff,10,0,10,0
1653599561363,MATH 220A,A00,087424,Novak; Jonathan I,6,0,8,2
1653599561913,MATH 231A,A00,087425,Bejenaru; Ioan,3,0,8,5
1653599562436,MATH 240A,A00,087426,Ebenfelt; Peter F,5,0,8,3
1653599562988,MATH 243,A00,087427,Staff,9,0,10,1
1653599563511,MATH 248,A00,087429,Staff,10,0,10,0
1653599564034,MATH 250A,A00,087430,Spolaor; Luca,4,0,8,4
1653599564567,MATH 257A,A00,087431,Spolaor; Luca,7,0,8,1
1653599565120,MATH 258,A00,087432,Staff,9,0,10,1
1653599565654,MATH 264A,A00,087433,Warnke; Lutz Peter,5,0,8,3
1653599566177,MATH 268,A00,087434,Staff,15,0,15,0
1653599566719,MATH 269,A00,087435,Staff,14,0,15,1
1653599567252,MATH 270A,A00,087436,Nie; Jiawang,0,0,8,8
1653599567778,MATH 272A,A00,087437,Tian; Xiaochuan,0,0,8,8
1653599568324,MATH 274,A01,087439,Cheng; Li-Tien,9,0,10,1
1653599568324,MATH 274,A02,087440,Cheng; Li-Tien,10,0,10,0
1653599568882,MATH 278A,A00,087441,Staff,8,0,10,2
1653599569414,MATH 278B,A00,087442,Staff,8,0,10,2
1653599569939,MATH 278C,A00,087443,Staff,8,0,10,2
1653599570482,MATH 280A,A00,087444,Zheng; Tianyi,0,0,8,8
1653599571005,MATH 281A,A00,087445,Bradic; Jelena,0,0,8,8
1653599571540,MATH 282A,A00,087446,Zhang; Danna,0,0,8,8
1653599572075,MATH 283,A00,087447,Tesler; Glenn,0,0,0,16
1653599572599,MATH 286,B00,095535,Kemp; Todd Aahron,7,0,8,1
1653599573147,MATH 287D,B00,095536,Bradic; Jelena,5,0,8,3
1653599573682,MATH 288,A00,087450,Staff,14,0,15,1
1653599573682,MATH 288,B00,087451,Staff,15,0,15,0
1653599573682,MATH 288,C00,087452,Staff,15,0,15,0
1653599574202,MATH 290A,A00,087453,Xu; Zhouli,6,0,8,2
1653599574730,MATH 291A,A00,087454,Xu; Zhouli,7,0,8,1
1653599575267,MATH 292,A00,087455,Staff,10,0,10,0
1653599575818,MATH 295,A00,087456,Staff,50,0,50,0
1653599576347,MATH 297,001,087457,Staff,997,0,999,2
1653600143352,COGS 200,A01,087991,Staff,47,0,50,3
1653600143875,COGS 201,A01,094504,Rangel; Lara M,16,0,25,9
1653600144404,COGS 203,A00,087992,Coulson; Seana M,18,0,20,2
1653600144931,COGS 210A,001,087993,Greene; Deanna Jacquelyn,9998,0,9999,1
1653600144931,COGS 210A,002,087994,Saygin; Ayse P,9999,0,9999,0
1653600144931,COGS 210A,003,087995,Xia; Haijun,9999,0,9999,0
1653600144931,COGS 210A,004,087996,Nitz; Douglas A.,9999,0,9999,0
1653600144931,COGS 210A,005,087997,Hollan; James D.,9999,0,9999,0
1653600144931,COGS 210A,006,087998,Deak; Gedeon O.,9998,0,9999,1
1653600144931,COGS 210A,007,087999,Rossano; Federico,9999,0,9999,0
1653600145453,COGS 211A,A00,088000,Coulson; Seana M,9997,0,9999,2
1653600145981,COGS 229,A00,088002,Staff,22,0,25,3
1653600146510,COGS 260,B00,094231,Staff,17,0,20,3
1653600146510,COGS 260,A00,088004,Nitz; Douglas A.,9998,0,9999,1
1653600147033,CSE 202,A00,090110,Paturi; Ramamohan,0,0,0,0
1653600147033,CSE 202,B00,090111,Paturi; Ramamohan,0,0,0,0
1653600147556,CSE 207B,A00,090112,Heninger; Nadia A,0,0,0,0
1653600148085,CSE 208,A00,094858,Micciancio; Daniele,0,0,0,0
1653600148612,CSE 210,A00,090113,Powell; Thomas Allan,0,0,0,0
1653600149139,CSE 219,A00,090898,Staff,0,0,0,0
1653600149663,CSE 221,A00,090114,Zhou; Yuan-Yuan,0,0,0,0
1653600150186,CSE 229A,A00,090115,Porter; George M,0,0,0,0
1653600150709,CSE 229C,A00,090116,Savage; Stefan,0,0,0,0
1653600151231,CSE 230,A00,090117,Jhala; Ranjit,0,0,0,0
1653600151760,CSE 232,A00,090118,Papakonstantinou; Yannis,0,0,0,0
1653600152285,CSE 239A,A00,090121,Kumar; Arun Kumar,0,0,0,0
1653600152808,CSE 239B,A00,090122,Jhala; Ranjit,0,0,0,0
1653600153328,CSE 240A,A00,090123,Zhao; Jishen,0,0,189,189
1653600153856,CSE 243A,A00,090124,Orailoglu; Alex,0,0,15,15
1653600154378,CSE 249B,A00,090125,Kahng; Andrew Byun,12,0,20,8
1653600154901,CSE 250A,A00,090126,Berg-Kirkpatrick; Taylor D,0,0,0,0
1653600155432,CSE 252A,A00,090127,Ochoa; Benjamin Lawrence,0,0,0,0
1653600155956,CSE 258,A01,090129,McAuley; Julian John,0,0,0,0
1653600156479,CSE 258R,A01,090131,McAuley; Julian John,0,0,0,0
1653600157001,CSE 274,A00,090132,Ramamoorthi; Ravi,0,0,0,0
1653600157536,CSE 276A,A00,090133,Christensen; Henrik I,0,0,0,0
1653600158060,CSE 276C,A00,090134,Christensen; Henrik I,0,0,0,0
1653600158590,CSE 290,A00,090135,Bafna; Vineet,0,0,0,0
1653600158590,CSE 290,B00,090136,Ramamoorthi; Ravi,0,0,0,0
1653600158590,CSE 290,C00,090137,Li; Tzumao,7,0,10,3
1653600158590,CSE 290,D00,090138,Zhou; Yuan-Yuan,9,0,10,1
1653600158590,CSE 290,E00,090139,Christensen; Henrik I,8,0,10,2
1653600158590,CSE 290,F00,094053,Shalev; Aaron D,0,0,0,0
1653600159123,CSE 291,A00,090140,Munyaka; Imani N. S.,0,0,0,0
1653600159123,CSE 291,B00,094880,Yu; Qi,0,0,0,0
1653600159123,CSE 291,C00,090142,Pannuto; Patrick William,0,0,0,0
1653600159123,CSE 291,D00,094881,Zhang; Yiying,0,0,0,0
1653600159123,CSE 291,E00,095118,Su; Hao,0,0,0,0
1653600159649,CSE 293,001,094905,Bafna; Vineet,9999,0,9999,0
1653600159649,CSE 293,002,094906,Bellare; Mihir,9999,0,9999,0
1653600159649,CSE 293,003,094907,Berg-Kirkpatrick; Taylor D,9999,0,9999,0
1653600159649,CSE 293,004,094908,Christensen; Henrik I,9999,0,9999,0
1653600159649,CSE 293,005,094909,Cottrell; Garrison W,9999,0,9999,0
1653600159649,CSE 293,006,094910,Deutsch; Alin Bernard,9999,0,9999,0
1653600159649,CSE 293,007,094911,Esmaeilzadeh; Hadi,9999,0,9999,0
1653600159649,CSE 293,008,094912,Freund; Yoav,9999,0,9999,0
1653600159649,CSE 293,009,094913,Griswold; William G.,9999,0,9999,0
1653600159649,CSE 293,010,094914,Gymrek; Melissa Ann,9999,0,9999,0
1653600159649,CSE 293,011,094915,Heninger; Nadia A,9999,0,9999,0
1653600159649,CSE 293,012,094916,Impagliazzo; Russell,9999,0,9999,0
1653600159649,CSE 293,013,094917,Jhala; Ranjit,9999,0,9999,0
1653600159649,CSE 293,014,094918,Kahng; Andrew Byun,9999,0,9999,0
1653600159649,CSE 293,015,094919,Kane; Daniel Mertz,9999,0,9999,0
1653600159649,CSE 293,016,094920,Kriegman; David J,9999,0,9999,0
1653600159649,CSE 293,017,094921,Kumar; Arun Kumar,9999,0,9999,0
1653600159649,CSE 293,018,094922,Lerner; Sorin,9999,0,9999,0
1653600159649,CSE 293,019,094923,Lovett; Shachar,9999,0,9999,0
1653600159649,CSE 293,020,094924,McAuley; Julian John,9999,0,9999,0
1653600159649,CSE 293,021,094925,Micciancio; Daniele,9999,0,9999,0
1653600159649,CSE 293,022,094926,Orailoglu; Alex,9999,0,9999,0
1653600159649,CSE 293,023,094927,Paturi; Ramamohan,9999,0,9999,0
1653600159649,CSE 293,024,094928,Polikarpova; Nadezhda,9999,0,9999,0
1653600159649,CSE 293,025,094929,Politz; Joseph Gibbs,9999,0,9999,0
1653600159649,CSE 293,026,094930,Porter; George M,9999,0,9999,0
1653600159649,CSE 293,027,094931,Porter; Leonard Emerson,9999,0,9999,0
1653600159649,CSE 293,028,094932,Ramamoorthi; Ravi,9999,0,9999,0
1653600159649,CSE 293,029,094933,Sahoo; Debashis,9999,0,9999,0
1653600159649,CSE 293,030,094934,Saul; Lawrence,9999,0,9999,0
1653600159649,CSE 293,031,094935,Savage; Stefan,9999,0,9999,0
1653600159649,CSE 293,032,094936,Schulze; Jurgen P.,9999,0,9999,0
1653600159649,CSE 293,033,094937,Snoeren; Alex C.,9999,0,9999,0
1653600159649,CSE 293,034,094938,Shang; Jingbo,9999,0,9999,0
1653600159649,CSE 293,035,094939,Stefan; Deian,9999,0,9999,0
1653600159649,CSE 293,036,094940,Su; Hao,9999,0,9999,0
1653600159649,CSE 293,037,094941,Swanson; Steven James,9999,0,9999,0
1653600159649,CSE 293,038,094942,Tullsen; Dean Michael,9999,0,9999,0
1653600159649,CSE 293,039,094943,Voelker; Geoffrey M.,9999,0,9999,0
1653600159649,CSE 293,040,094944,Zhao; Jishen,9999,0,9999,0
1653600159649,CSE 293,041,094945,Zhou; Yuan-Yuan,9999,0,9999,0
1653600159649,CSE 293,042,094946,Gao; Sicun,9998,0,9999,1
1653600159649,CSE 293,043,094947,Weibel; Nadir,9999,0,9999,0
1653600159649,CSE 293,044,094948,Gupta; Rajesh K.,9999,0,9999,0
1653600160180,CSE 294,A00,090143,Porter; George M,8,0,10,2
1653600160704,DSE 200,A00,091799,Staff,50,0,50,0
1653600161228,DSE 203,A00,091800,Gupta; Amarnath,30,0,30,0
1653600161752,DSE 250,A00,091801,Deutsch; Alin Bernard,30,0,30,0
1653600162285,DSE 290,A00,091802,Altintas De Callaf; Ilkay,50,0,50,0
1653600162840,ECE 200,001,091003,Antipa; Nicholas A,9999,0,9999,0
1653600162840,ECE 200,002,091004,Atanasov; Nikolay A.,9999,0,9999,0
1653600162840,ECE 200,003,091005,Bharadia; Dinesh,9999,0,9999,0
1653600162840,ECE 200,004,091006,Cheng; Chung Kuan,9999,0,9999,0
1653600162840,ECE 200,005,091007,Cosman; Pamela C.,9999,0,9999,0
1653600162840,ECE 200,006,091008,Staff,9999,0,9999,0
1653600162840,ECE 200,007,091009,Dayeh; Shadi Ahmad,9999,0,9999,0
1653600162840,ECE 200,008,091010,Fainman; Yeshaiahu,9999,0,9999,0
1653600162840,ECE 200,009,091011,Ford; Joseph Earl,9999,0,9999,0
1653600162840,ECE 200,010,091012,Franceschetti; Massimo,9999,0,9999,0
1653600162840,ECE 200,011,091013,Fullerton; Eric E,9999,0,9999,0
1653600162840,ECE 200,012,091014,Galton; Ian A,9999,0,9999,0
1653600162840,ECE 200,013,091015,Gilja; Vikash,9999,0,9999,0
1653600162840,ECE 200,014,091016,Hall; Drew A.,9999,0,9999,0
1653600162840,ECE 200,015,091017,Hsueh; Tzu-Chien,9999,0,9999,0
1653600162840,ECE 200,016,091018,Javidi; Tara,9999,0,9999,0
1653600162840,ECE 200,017,091019,Kahng; Andrew Byun,9999,0,9999,0
1653600162840,ECE 200,018,091020,Kim; Young-Han,9999,0,9999,0
1653600162840,ECE 200,019,091021,Koushanfar; Farinaz,9999,0,9999,0
1653600162840,ECE 200,020,091022,Kuzum; Duygu,9999,0,9999,0
1653600162840,ECE 200,021,091023,Le; Hanh-Phuc,9999,0,9999,0
1653600162840,ECE 200,022,091024,Lin; Bill,9999,0,9999,0
1653600162840,ECE 200,023,091025,Liu; Zhaowei,9999,0,9999,0
1653600162840,ECE 200,024,091026,Lo; Yu-Hwa,9999,0,9999,0
1653600162840,ECE 200,025,091027,Lomakin; Vitaliy,9999,0,9999,0
1653600162840,ECE 200,026,091028,Mercier; Patrick Philip,9999,0,9999,0
1653600162840,ECE 200,027,091029,Meyer; Florian,9999,0,9999,0
1653600162840,ECE 200,028,091030,Milstein; Laurence B.,9999,0,9999,0
1653600162840,ECE 200,029,091031,Mir Arabbaygi; Siavash,9999,0,9999,0
1653600162840,ECE 200,030,091032,Mookherjea; Shayan,9999,0,9999,0
1653600162840,ECE 200,031,091033,Morris; Karcher William,9999,0,9999,0
1653600162840,ECE 200,032,091034,Ng; Tse Nga,9999,0,9999,0
1653600162840,ECE 200,033,091035,Nguyen; Truong Quang,9999,0,9999,0
1653600162840,ECE 200,034,091036,Nomura; Kenji,9999,0,9999,0
1653600162840,ECE 200,035,091037,Orlitsky; Alon,9999,0,9999,0
1653600162840,ECE 200,036,091038,Pal; Piya,9999,0,9999,0
1653600162840,ECE 200,037,091039,Papen; George C.,9999,0,9999,0
1653600162840,ECE 200,038,091040,Radic; Stojan,9999,0,9999,0
1653600162840,ECE 200,039,091041,Rao; Bhaskar D.,9999,0,9999,0
1653600162840,ECE 200,040,091042,Rao; Ramesh R,9999,0,9999,0
1653600162840,ECE 200,041,091043,Rebeiz; Gabriel,9999,0,9999,0
1653600162840,ECE 200,042,091044,Sanford; John R,9999,0,9999,0
1653600162840,ECE 200,043,091045,Siegel; Paul H.,9999,0,9999,0
1653600162840,ECE 200,044,091046,Sievenpiper; Daniel F.,9999,0,9999,0
1653600162840,ECE 200,045,091047,Sworder; David D.,9999,0,9999,0
1653600162840,ECE 200,046,091048,Taur; Yuan,9999,0,9999,0
1653600162840,ECE 200,047,091049,Touri; Behrouz,9999,0,9999,0
1653600162840,ECE 200,048,091050,Trivedi; Mohan M.,9999,0,9999,0
1653600162840,ECE 200,049,091051,Vardy; Alexander,9999,0,9999,0
1653600162840,ECE 200,050,091052,Vasconcelos; Nuno,9999,0,9999,0
1653600162840,ECE 200,051,091053,Wang; Xiaolong,9999,0,9999,0
1653600162840,ECE 200,052,091054,Xie; Pengtao,9999,0,9999,0
1653600162840,ECE 200,053,091055,Yip; Michael,9999,0,9999,0
1653600162840,ECE 200,054,091056,Zeger; Kenneth A.,9999,0,9999,0
1653600162840,ECE 200,055,091057,Zhang; Xinyu,9999,0,9999,0
1653600162840,ECE 200,056,091058,Turakhia; Yatish Girish,9999,0,9999,0
1653600162840,ECE 200,057,091059,Kang; Mingu,9999,0,9999,0
1653600162840,ECE 200,058,091060,Shi; Yuanyuan,9999,0,9999,0
1653600162840,ECE 200,059,091061,Wang; Edward Jay,9999,0,9999,0
1653600162840,ECE 200,060,091062,Zheng; Yang,9999,0,9999,0
1653600163368,ECE 201,A00,095526,Lo; Yu-Hwa,0,0,0,0
1653600163890,ECE 203,A00,091065,Mercier; Patrick Philip,0,0,0,0
1653600164421,ECE 207A,A00,091605,Liu; Thomas Tao-Ming,0,0,0,0
1653600164947,ECE 212AN,A00,091068,Nomura; Kenji,0,0,0,0
1653600165470,ECE 222A,A00,091069,Rebeiz; Gabriel,0,0,0,0
1653600165994,ECE 225A,A00,091070,Orlitsky; Alon,0,0,0,0
1653600166517,ECE 230A,A00,091071,Nomura; Kenji,0,0,0,0
1653600167040,ECE 236A,A00,091072,Dayeh; Shadi Ahmad,0,0,0,0
1653600167563,ECE 238A,A00,091073,Luo; Jian,0,0,0,0
1653600167563,ECE 238A,B00,091074,Luo; Jian,0,0,0,0
1653600168091,ECE 240A,A00,091075,Radic; Stojan,0,0,0,0
1653600168619,ECE 247A,A00,091592,Shi; Lingyan,0,0,0,0
1653600169140,ECE 250,A00,091076,Touri; Behrouz,0,0,0,0
1653600169666,ECE 251C,A00,091078,Nguyen; Truong Quang,0,0,0,0
1653600170188,ECE 253,A00,091079,Cosman; Pamela C.,0,0,0,0
1653600170712,ECE 255A,A00,091080,Orlitsky; Alon,0,0,0,0
1653600171234,ECE 257A,A00,091081,Zhang; Xinyu,0,0,0,0
1653600171760,ECE 260A,A01,091084,Eldon; John,0,0,0,0
1653600172286,ECE 264C,A00,091085,Galton; Ian A,0,0,0,0
1653600172812,ECE 265C,A00,094889,Presti; Calogero Davide,0,0,0,9
1653600173340,ECE 266,A01,091087,Hall; Drew A.,0,0,0,0
1653600174479,ECE 271A,A00,091090,Vasconcelos; Nuno,0,0,0,0
1653600175015,ECE 272B,A00,091091,Sworder; David D.,0,0,0,0
1653600175541,ECE 275A,A00,091092,Meyer; Florian,0,0,0,0
1653600176072,ECE 277,A00,091093,An; Cheolhong,0,0,0,0
1653600176598,ECE 283,A00,091094,Le; Hanh-Phuc,0,0,0,0
1653600177123,ECE 284,A00,091095,Kang; Mingu,0,0,0,0
1653600177123,ECE 284,B00,091096,Wang; Edward Jay,0,0,0,0
1653600177645,ECE 285,A00,094334,Touri; Behrouz,0,0,0,0
1653600178169,ECE 289,A00,091097,Whelan; David Arthur,0,0,0,0
1653600178691,MATH 200A,A00,087414,Salehi Golsefidy; Alireza,7,0,8,1
1653600179224,MATH 202A,A00,087415,Gill; Philip E.,2,0,8,6
1653600179761,MATH 203A,A00,087416,Oprea; Dragos N.,6,0,8,2
1653600180295,MATH 204A,A00,087417,Kedlaya; Kiran S.,6,0,8,2
1653600180827,MATH 205,A00,087418,Sorensen; Claus M,6,0,8,2
1653600181349,MATH 206A,A00,087419,Izadi; Elham,7,0,8,1
1653600181873,MATH 207A,A00,087420,Mohammadi; Amir,5,0,8,3
1653600182405,MATH 208,A00,087421,Staff,9,0,10,1
1653600182931,MATH 209,A00,087422,Staff,10,0,10,0
1653600183454,MATH 218,A00,087423,Staff,10,0,10,0
1653600183989,MATH 220A,A00,087424,Novak; Jonathan I,6,0,8,2
1653600184513,MATH 231A,A00,087425,Bejenaru; Ioan,3,0,8,5
1653600185040,MATH 240A,A00,087426,Ebenfelt; Peter F,5,0,8,3
1653600185565,MATH 243,A00,087427,Staff,9,0,10,1
1653600186090,MATH 248,A00,087429,Staff,10,0,10,0
1653600186613,MATH 250A,A00,087430,Spolaor; Luca,4,0,8,4
1653600187145,MATH 257A,A00,087431,Spolaor; Luca,7,0,8,1
1653600187667,MATH 258,A00,087432,Staff,9,0,10,1
1653600188190,MATH 264A,A00,087433,Warnke; Lutz Peter,5,0,8,3
1653600188718,MATH 268,A00,087434,Staff,15,0,15,0
1653600189249,MATH 269,A00,087435,Staff,14,0,15,1
1653600189776,MATH 270A,A00,087436,Nie; Jiawang,0,0,8,8
1653600190302,MATH 272A,A00,087437,Tian; Xiaochuan,0,0,8,8
1653600190824,MATH 274,A01,087439,Cheng; Li-Tien,9,0,10,1
1653600190824,MATH 274,A02,087440,Cheng; Li-Tien,10,0,10,0
1653600191357,MATH 278A,A00,087441,Staff,8,0,10,2
1653600191879,MATH 278B,A00,087442,Staff,8,0,10,2
1653600192404,MATH 278C,A00,087443,Staff,8,0,10,2
1653600192931,MATH 280A,A00,087444,Zheng; Tianyi,0,0,8,8
1653600193461,MATH 281A,A00,087445,Bradic; Jelena,0,0,8,8
1653600193983,MATH 282A,A00,087446,Zhang; Danna,0,0,8,8
1653600194505,MATH 283,A00,087447,Tesler; Glenn,0,0,0,16
1653600195032,MATH 286,B00,095535,Kemp; Todd Aahron,7,0,8,1
1653600195565,MATH 287D,B00,095536,Bradic; Jelena,5,0,8,3
1653600196088,MATH 288,A00,087450,Staff,14,0,15,1
1653600196088,MATH 288,B00,087451,Staff,15,0,15,0
1653600196088,MATH 288,C00,087452,Staff,15,0,15,0
1653600196611,MATH 290A,A00,087453,Xu; Zhouli,6,0,8,2
1653600197137,MATH 291A,A00,087454,Xu; Zhouli,7,0,8,1
1653600197675,MATH 292,A00,087455,Staff,10,0,10,0
1653600198196,MATH 295,A00,087456,Staff,50,0,50,0
1653600198740,MATH 297,001,087457,Staff,997,0,999,2
1653600759365,COGS 200,A01,087991,Staff,47,0,50,3
1653600759892,COGS 201,A01,094504,Rangel; Lara M,16,0,25,9
1653600760421,COGS 203,A00,087992,Coulson; Seana M,18,0,20,2
1653600760948,COGS 210A,001,087993,Greene; Deanna Jacquelyn,9998,0,9999,1
1653600760948,COGS 210A,002,087994,Saygin; Ayse P,9999,0,9999,0
1653600760948,COGS 210A,003,087995,Xia; Haijun,9999,0,9999,0
1653600760948,COGS 210A,004,087996,Nitz; Douglas A.,9999,0,9999,0
1653600760948,COGS 210A,005,087997,Hollan; James D.,9999,0,9999,0
1653600760948,COGS 210A,006,087998,Deak; Gedeon O.,9998,0,9999,1
1653600760948,COGS 210A,007,087999,Rossano; Federico,9999,0,9999,0
1653600761470,COGS 211A,A00,088000,Coulson; Seana M,9997,0,9999,2
1653600761996,COGS 229,A00,088002,Staff,22,0,25,3
1653600762597,COGS 260,B00,094231,Staff,17,0,20,3
1653600762597,COGS 260,A00,088004,Nitz; Douglas A.,9998,0,9999,1
1653600763121,CSE 202,A00,090110,Paturi; Ramamohan,0,0,0,0
1653600763121,CSE 202,B00,090111,Paturi; Ramamohan,0,0,0,0
1653600763646,CSE 207B,A00,090112,Heninger; Nadia A,0,0,0,0
1653600764171,CSE 208,A00,094858,Micciancio; Daniele,0,0,0,0
1653600764711,CSE 210,A00,090113,Powell; Thomas Allan,0,0,0,0
1653600765235,CSE 219,A00,090898,Staff,0,0,0,0
1653600765759,CSE 221,A00,090114,Zhou; Yuan-Yuan,0,0,0,0
1653600766290,CSE 229A,A00,090115,Porter; George M,0,0,0,0
1653600766831,CSE 229C,A00,090116,Savage; Stefan,0,0,0,0
1653600767359,CSE 230,A00,090117,Jhala; Ranjit,0,0,0,0
1653600767885,CSE 232,A00,090118,Papakonstantinou; Yannis,0,0,0,0
1653600768407,CSE 239A,A00,090121,Kumar; Arun Kumar,0,0,0,0
1653600768929,CSE 239B,A00,090122,Jhala; Ranjit,0,0,0,0
1653600769450,CSE 240A,A00,090123,Zhao; Jishen,0,0,189,189
1653600769974,CSE 243A,A00,090124,Orailoglu; Alex,0,0,15,15
1653600770496,CSE 249B,A00,090125,Kahng; Andrew Byun,12,0,20,8
1653600771029,CSE 250A,A00,090126,Berg-Kirkpatrick; Taylor D,0,0,0,0
1653600771555,CSE 252A,A00,090127,Ochoa; Benjamin Lawrence,0,0,0,0
1653600772077,CSE 258,A01,090129,McAuley; Julian John,0,0,0,0
1653600772600,CSE 258R,A01,090131,McAuley; Julian John,0,0,0,0
1653600773126,CSE 274,A00,090132,Ramamoorthi; Ravi,0,0,0,0
1653600773661,CSE 276A,A00,090133,Christensen; Henrik I,0,0,0,0
1653600774183,CSE 276C,A00,090134,Christensen; Henrik I,0,0,0,0
1653600774710,CSE 290,A00,090135,Bafna; Vineet,0,0,0,0
1653600774710,CSE 290,B00,090136,Ramamoorthi; Ravi,0,0,0,0
1653600774710,CSE 290,C00,090137,Li; Tzumao,7,0,10,3
1653600774710,CSE 290,D00,090138,Zhou; Yuan-Yuan,9,0,10,1
1653600774710,CSE 290,E00,090139,Christensen; Henrik I,8,0,10,2
1653600774710,CSE 290,F00,094053,Shalev; Aaron D,0,0,0,0
1653600775239,CSE 291,A00,090140,Munyaka; Imani N. S.,0,0,0,0
1653600775239,CSE 291,B00,094880,Yu; Qi,0,0,0,0
1653600775239,CSE 291,C00,090142,Pannuto; Patrick William,0,0,0,0
1653600775239,CSE 291,D00,094881,Zhang; Yiying,0,0,0,0
1653600775239,CSE 291,E00,095118,Su; Hao,0,0,0,0
1653600775774,CSE 293,001,094905,Bafna; Vineet,9999,0,9999,0
1653600775774,CSE 293,002,094906,Bellare; Mihir,9999,0,9999,0
1653600775774,CSE 293,003,094907,Berg-Kirkpatrick; Taylor D,9999,0,9999,0
1653600775774,CSE 293,004,094908,Christensen; Henrik I,9999,0,9999,0
1653600775774,CSE 293,005,094909,Cottrell; Garrison W,9999,0,9999,0
1653600775774,CSE 293,006,094910,Deutsch; Alin Bernard,9999,0,9999,0
1653600775774,CSE 293,007,094911,Esmaeilzadeh; Hadi,9999,0,9999,0
1653600775774,CSE 293,008,094912,Freund; Yoav,9999,0,9999,0
1653600775774,CSE 293,009,094913,Griswold; William G.,9999,0,9999,0
1653600775774,CSE 293,010,094914,Gymrek; Melissa Ann,9999,0,9999,0
1653600775774,CSE 293,011,094915,Heninger; Nadia A,9999,0,9999,0
1653600775774,CSE 293,012,094916,Impagliazzo; Russell,9999,0,9999,0
1653600775774,CSE 293,013,094917,Jhala; Ranjit,9999,0,9999,0
1653600775774,CSE 293,014,094918,Kahng; Andrew Byun,9999,0,9999,0
1653600775774,CSE 293,015,094919,Kane; Daniel Mertz,9999,0,9999,0
1653600775774,CSE 293,016,094920,Kriegman; David J,9999,0,9999,0
1653600775774,CSE 293,017,094921,Kumar; Arun Kumar,9999,0,9999,0
1653600775774,CSE 293,018,094922,Lerner; Sorin,9999,0,9999,0
1653600775774,CSE 293,019,094923,Lovett; Shachar,9999,0,9999,0
1653600775774,CSE 293,020,094924,McAuley; Julian John,9999,0,9999,0
1653600775774,CSE 293,021,094925,Micciancio; Daniele,9999,0,9999,0
1653600775774,CSE 293,022,094926,Orailoglu; Alex,9999,0,9999,0
1653600775774,CSE 293,023,094927,Paturi; Ramamohan,9999,0,9999,0
1653600775774,CSE 293,024,094928,Polikarpova; Nadezhda,9999,0,9999,0
1653600775774,CSE 293,025,094929,Politz; Joseph Gibbs,9999,0,9999,0
1653600775774,CSE 293,026,094930,Porter; George M,9999,0,9999,0
1653600775774,CSE 293,027,094931,Porter; Leonard Emerson,9999,0,9999,0
1653600775774,CSE 293,028,094932,Ramamoorthi; Ravi,9999,0,9999,0
1653600775774,CSE 293,029,094933,Sahoo; Debashis,9999,0,9999,0
1653600775774,CSE 293,030,094934,Saul; Lawrence,9999,0,9999,0
1653600775774,CSE 293,031,094935,Savage; Stefan,9999,0,9999,0
1653600775774,CSE 293,032,094936,Schulze; Jurgen P.,9999,0,9999,0
1653600775774,CSE 293,033,094937,Snoeren; Alex C.,9999,0,9999,0
1653600775774,CSE 293,034,094938,Shang; Jingbo,9999,0,9999,0
1653600775774,CSE 293,035,094939,Stefan; Deian,9999,0,9999,0
1653600775774,CSE 293,036,094940,Su; Hao,9999,0,9999,0
1653600775774,CSE 293,037,094941,Swanson; Steven James,9999,0,9999,0
1653600775774,CSE 293,038,094942,Tullsen; Dean Michael,9999,0,9999,0
1653600775774,CSE 293,039,094943,Voelker; Geoffrey M.,9999,0,9999,0
1653600775774,CSE 293,040,094944,Zhao; Jishen,9999,0,9999,0
1653600775774,CSE 293,041,094945,Zhou; Yuan-Yuan,9999,0,9999,0
1653600775774,CSE 293,042,094946,Gao; Sicun,9998,0,9999,1
1653600775774,CSE 293,043,094947,Weibel; Nadir,9999,0,9999,0
1653600775774,CSE 293,044,094948,Gupta; Rajesh K.,9999,0,9999,0
1653600776311,CSE 294,A00,090143,Porter; George M,8,0,10,2
1653600776838,DSE 200,A00,091799,Staff,50,0,50,0
1653600777377,DSE 203,A00,091800,Gupta; Amarnath,30,0,30,0
1653600777906,DSE 250,A00,091801,Deutsch; Alin Bernard,30,0,30,0
1653600778439,DSE 290,A00,091802,Altintas De Callaf; Ilkay,50,0,50,0
1653600778973,ECE 200,001,091003,Antipa; Nicholas A,9999,0,9999,0
1653600778973,ECE 200,002,091004,Atanasov; Nikolay A.,9999,0,9999,0
1653600778973,ECE 200,003,091005,Bharadia; Dinesh,9999,0,9999,0
1653600778973,ECE 200,004,091006,Cheng; Chung Kuan,9999,0,9999,0
1653600778973,ECE 200,005,091007,Cosman; Pamela C.,9999,0,9999,0
1653600778973,ECE 200,006,091008,Staff,9999,0,9999,0
1653600778973,ECE 200,007,091009,Dayeh; Shadi Ahmad,9999,0,9999,0
1653600778973,ECE 200,008,091010,Fainman; Yeshaiahu,9999,0,9999,0
1653600778973,ECE 200,009,091011,Ford; Joseph Earl,9999,0,9999,0
1653600778973,ECE 200,010,091012,Franceschetti; Massimo,9999,0,9999,0
1653600778973,ECE 200,011,091013,Fullerton; Eric E,9999,0,9999,0
1653600778973,ECE 200,012,091014,Galton; Ian A,9999,0,9999,0
1653600778973,ECE 200,013,091015,Gilja; Vikash,9999,0,9999,0
1653600778973,ECE 200,014,091016,Hall; Drew A.,9999,0,9999,0
1653600778973,ECE 200,015,091017,Hsueh; Tzu-Chien,9999,0,9999,0
1653600778973,ECE 200,016,091018,Javidi; Tara,9999,0,9999,0
1653600778973,ECE 200,017,091019,Kahng; Andrew Byun,9999,0,9999,0
1653600778973,ECE 200,018,091020,Kim; Young-Han,9999,0,9999,0
1653600778973,ECE 200,019,091021,Koushanfar; Farinaz,9999,0,9999,0
1653600778973,ECE 200,020,091022,Kuzum; Duygu,9999,0,9999,0
1653600778973,ECE 200,021,091023,Le; Hanh-Phuc,9999,0,9999,0
1653600778973,ECE 200,022,091024,Lin; Bill,9999,0,9999,0
1653600778973,ECE 200,023,091025,Liu; Zhaowei,9999,0,9999,0
1653600778973,ECE 200,024,091026,Lo; Yu-Hwa,9999,0,9999,0
1653600778973,ECE 200,025,091027,Lomakin; Vitaliy,9999,0,9999,0
1653600778973,ECE 200,026,091028,Mercier; Patrick Philip,9999,0,9999,0
1653600778973,ECE 200,027,091029,Meyer; Florian,9999,0,9999,0
1653600778973,ECE 200,028,091030,Milstein; Laurence B.,9999,0,9999,0
1653600778973,ECE 200,029,091031,Mir Arabbaygi; Siavash,9999,0,9999,0
1653600778973,ECE 200,030,091032,Mookherjea; Shayan,9999,0,9999,0
1653600778973,ECE 200,031,091033,Morris; Karcher William,9999,0,9999,0
1653600778973,ECE 200,032,091034,Ng; Tse Nga,9999,0,9999,0
1653600778973,ECE 200,033,091035,Nguyen; Truong Quang,9999,0,9999,0
1653600778973,ECE 200,034,091036,Nomura; Kenji,9999,0,9999,0
1653600778973,ECE 200,035,091037,Orlitsky; Alon,9999,0,9999,0
1653600778973,ECE 200,036,091038,Pal; Piya,9999,0,9999,0
1653600778973,ECE 200,037,091039,Papen; George C.,9999,0,9999,0
1653600778973,ECE 200,038,091040,Radic; Stojan,9999,0,9999,0
1653600778973,ECE 200,039,091041,Rao; Bhaskar D.,9999,0,9999,0
1653600778973,ECE 200,040,091042,Rao; Ramesh R,9999,0,9999,0
1653600778973,ECE 200,041,091043,Rebeiz; Gabriel,9999,0,9999,0
1653600778973,ECE 200,042,091044,Sanford; John R,9999,0,9999,0
1653600778973,ECE 200,043,091045,Siegel; Paul H.,9999,0,9999,0
1653600778973,ECE 200,044,091046,Sievenpiper; Daniel F.,9999,0,9999,0
1653600778973,ECE 200,045,091047,Sworder; David D.,9999,0,9999,0
1653600778973,ECE 200,046,091048,Taur; Yuan,9999,0,9999,0
1653600778973,ECE 200,047,091049,Touri; Behrouz,9999,0,9999,0
1653600778973,ECE 200,048,091050,Trivedi; Mohan M.,9999,0,9999,0
1653600778973,ECE 200,049,091051,Vardy; Alexander,9999,0,9999,0
1653600778973,ECE 200,050,091052,Vasconcelos; Nuno,9999,0,9999,0
1653600778973,ECE 200,051,091053,Wang; Xiaolong,9999,0,9999,0
1653600778973,ECE 200,052,091054,Xie; Pengtao,9999,0,9999,0
1653600778973,ECE 200,053,091055,Yip; Michael,9999,0,9999,0
1653600778973,ECE 200,054,091056,Zeger; Kenneth A.,9999,0,9999,0
1653600778973,ECE 200,055,091057,Zhang; Xinyu,9999,0,9999,0
1653600778973,ECE 200,056,091058,Turakhia; Yatish Girish,9999,0,9999,0
1653600778973,ECE 200,057,091059,Kang; Mingu,9999,0,9999,0
1653600778973,ECE 200,058,091060,Shi; Yuanyuan,9999,0,9999,0
1653600778973,ECE 200,059,091061,Wang; Edward Jay,9999,0,9999,0
1653600778973,ECE 200,060,091062,Zheng; Yang,9999,0,9999,0
1653600779496,ECE 201,A00,095526,Lo; Yu-Hwa,0,0,0,0
1653600780020,ECE 203,A00,091065,Mercier; Patrick Philip,0,0,0,0
1653600780546,ECE 207A,A00,091605,Liu; Thomas Tao-Ming,0,0,0,0
1653600781081,ECE 212AN,A00,091068,Nomura; Kenji,0,0,0,0
1653600781611,ECE 222A,A00,091069,Rebeiz; Gabriel,0,0,0,0
1653600782138,ECE 225A,A00,091070,Orlitsky; Alon,0,0,0,0
1653600782663,ECE 230A,A00,091071,Nomura; Kenji,0,0,0,0
1653600783185,ECE 236A,A00,091072,Dayeh; Shadi Ahmad,0,0,0,0
1653600783717,ECE 238A,A00,091073,Luo; Jian,0,0,0,0
1653600783717,ECE 238A,B00,091074,Luo; Jian,0,0,0,0
1653600784246,ECE 240A,A00,091075,Radic; Stojan,0,0,0,0
1653600784771,ECE 247A,A00,091592,Shi; Lingyan,0,0,0,0
1653600785306,ECE 250,A00,091076,Touri; Behrouz,0,0,0,0
1653600785833,ECE 251C,A00,091078,Nguyen; Truong Quang,0,0,0,0
1653600786356,ECE 253,A00,091079,Cosman; Pamela C.,0,0,0,0
1653600786885,ECE 255A,A00,091080,Orlitsky; Alon,0,0,0,0
1653600787407,ECE 257A,A00,091081,Zhang; Xinyu,0,0,0,0
1653600787937,ECE 260A,A01,091084,Eldon; John,0,0,0,0
1653600788462,ECE 264C,A00,091085,Galton; Ian A,0,0,0,0
1653600788986,ECE 265C,A00,094889,Presti; Calogero Davide,0,0,0,9
1653600789514,ECE 266,A01,091087,Hall; Drew A.,0,0,0,0
1653600790564,ECE 271A,A00,091090,Vasconcelos; Nuno,0,0,0,0
1653600791090,ECE 272B,A00,091091,Sworder; David D.,0,0,0,0
1653600791618,ECE 275A,A00,091092,Meyer; Florian,0,0,0,0
1653600792141,ECE 277,A00,091093,An; Cheolhong,0,0,0,0
1653600792667,ECE 283,A00,091094,Le; Hanh-Phuc,0,0,0,0
1653600793194,ECE 284,A00,091095,Kang; Mingu,0,0,0,0
1653600793194,ECE 284,B00,091096,Wang; Edward Jay,0,0,0,0
1653600793717,ECE 285,A00,094334,Touri; Behrouz,0,0,0,0
1653600794246,ECE 289,A00,091097,Whelan; David Arthur,0,0,0,0
1653600794769,MATH 200A,A00,087414,Salehi Golsefidy; Alireza,7,0,8,1
1653600795294,MATH 202A,A00,087415,Gill; Philip E.,2,0,8,6
1653600795822,MATH 203A,A00,087416,Oprea; Dragos N.,6,0,8,2
1653600796359,MATH 204A,A00,087417,Kedlaya; Kiran S.,6,0,8,2
1653600796890,MATH 205,A00,087418,Sorensen; Claus M,6,0,8,2
1653600797416,MATH 206A,A00,087419,Izadi; Elham,7,0,8,1
1653600797946,MATH 207A,A00,087420,Mohammadi; Amir,5,0,8,3
1653600798480,MATH 208,A00,087421,Staff,9,0,10,1
1653600799004,MATH 209,A00,087422,Staff,10,0,10,0
1653600799528,MATH 218,A00,087423,Staff,10,0,10,0
1653600800050,MATH 220A,A00,087424,Novak; Jonathan I,6,0,8,2
1653600800583,MATH 231A,A00,087425,Bejenaru; Ioan,3,0,8,5
1653600801108,MATH 240A,A00,087426,Ebenfelt; Peter F,5,0,8,3
1653600801630,MATH 243,A00,087427,Staff,9,0,10,1
1653600802153,MATH 248,A00,087429,Staff,10,0,10,0
1653600802694,MATH 250A,A00,087430,Spolaor; Luca,4,0,8,4
1653600803217,MATH 257A,A00,087431,Spolaor; Luca,7,0,8,1
1653600803740,MATH 258,A00,087432,Staff,9,0,10,1
1653600804267,MATH 264A,A00,087433,Warnke; Lutz Peter,5,0,8,3
1653600804789,MATH 268,A00,087434,Staff,15,0,15,0
1653600805316,MATH 269,A00,087435,Staff,14,0,15,1
1653600805839,MATH 270A,A00,087436,Nie; Jiawang,0,0,8,8
1653600806363,MATH 272A,A00,087437,Tian; Xiaochuan,0,0,8,8
1653600806892,MATH 274,A01,087439,Cheng; Li-Tien,9,0,10,1
1653600806892,MATH 274,A02,087440,Cheng; Li-Tien,10,0,10,0
1653600807419,MATH 278A,A00,087441,Staff,8,0,10,2
1653600807944,MATH 278B,A00,087442,Staff,8,0,10,2
1653600808483,MATH 278C,A00,087443,Staff,8,0,10,2
1653600809006,MATH 280A,A00,087444,Zheng; Tianyi,0,0,8,8
1653600809533,MATH 281A,A00,087445,Bradic; Jelena,0,0,8,8
1653600810057,MATH 282A,A00,087446,Zhang; Danna,0,0,8,8
1653600810580,MATH 283,A00,087447,Tesler; Glenn,0,0,0,16
1653600811109,MATH 286,B00,095535,Kemp; Todd Aahron,7,0,8,1
1653600811634,MATH 287D,B00,095536,Bradic; Jelena,5,0,8,3
1653600812157,MATH 288,A00,087450,Staff,14,0,15,1
1653600812157,MATH 288,B00,087451,Staff,15,0,15,0
1653600812157,MATH 288,C00,087452,Staff,15,0,15,0
1653600812684,MATH 290A,A00,087453,Xu; Zhouli,6,0,8,2
1653600813209,MATH 291A,A00,087454,Xu; Zhouli,7,0,8,1
1653600813737,MATH 292,A00,087455,Staff,10,0,10,0
1653600814262,MATH 295,A00,087456,Staff,50,0,50,0
1653600814786,MATH 297,001,087457,Staff,997,0,999,2
1653601376010,COGS 200,A01,087991,Staff,47,0,50,3
1653601376536,COGS 201,A01,094504,Rangel; Lara M,16,0,25,9
1653601377059,COGS 203,A00,087992,Coulson; Seana M,18,0,20,2
1653601377582,COGS 210A,001,087993,Greene; Deanna Jacquelyn,9998,0,9999,1
1653601377582,COGS 210A,002,087994,Saygin; Ayse P,9999,0,9999,0
1653601377582,COGS 210A,003,087995,Xia; Haijun,9999,0,9999,0
1653601377582,COGS 210A,004,087996,Nitz; Douglas A.,9999,0,9999,0
1653601377582,COGS 210A,005,087997,Hollan; James D.,9999,0,9999,0
1653601377582,COGS 210A,006,087998,Deak; Gedeon O.,9998,0,9999,1
1653601377582,COGS 210A,007,087999,Rossano; Federico,9999,0,9999,0
1653601378106,COGS 211A,A00,088000,Coulson; Seana M,9997,0,9999,2
1653601378631,COGS 229,A00,088002,Staff,22,0,25,3
1653601379154,COGS 260,B00,094231,Staff,17,0,20,3
1653601379154,COGS 260,A00,088004,Nitz; Douglas A.,9998,0,9999,1
1653601379682,CSE 202,A00,090110,Paturi; Ramamohan,0,0,0,0
1653601379682,CSE 202,B00,090111,Paturi; Ramamohan,0,0,0,0
1653601380207,CSE 207B,A00,090112,Heninger; Nadia A,0,0,0,0
1653601380728,CSE 208,A00,094858,Micciancio; Daniele,0,0,0,0
1653601381251,CSE 210,A00,090113,Powell; Thomas Allan,0,0,0,0
1653601381796,CSE 219,A00,090898,Staff,0,0,0,0
1653601382321,CSE 221,A00,090114,Zhou; Yuan-Yuan,0,0,0,0
1653601382848,CSE 229A,A00,090115,Porter; George M,0,0,0,0
1653601383374,CSE 229C,A00,090116,Savage; Stefan,0,0,0,0
1653601383897,CSE 230,A00,090117,Jhala; Ranjit,0,0,0,0
1653601384429,CSE 232,A00,090118,Papakonstantinou; Yannis,0,0,0,0
1653601384962,CSE 239A,A00,090121,Kumar; Arun Kumar,0,0,0,0
1653601385487,CSE 239B,A00,090122,Jhala; Ranjit,0,0,0,0
1653601386013,CSE 240A,A00,090123,Zhao; Jishen,0,0,189,189
1653601386536,CSE 243A,A00,090124,Orailoglu; Alex,0,0,15,15
1653601387059,CSE 249B,A00,090125,Kahng; Andrew Byun,12,0,20,8
1653601387584,CSE 250A,A00,090126,Berg-Kirkpatrick; Taylor D,0,0,0,0
1653601388113,CSE 252A,A00,090127,Ochoa; Benjamin Lawrence,0,0,0,0
1653601388646,CSE 258,A01,090129,McAuley; Julian John,0,0,0,0
1653601389173,CSE 258R,A01,090131,McAuley; Julian John,0,0,0,0
1653601389698,CSE 274,A00,090132,Ramamoorthi; Ravi,0,0,0,0
1653601390225,CSE 276A,A00,090133,Christensen; Henrik I,0,0,0,0
1653601390748,CSE 276C,A00,090134,Christensen; Henrik I,0,0,0,0
1653601391271,CSE 290,A00,090135,Bafna; Vineet,0,0,0,0
1653601391271,CSE 290,B00,090136,Ramamoorthi; Ravi,0,0,0,0
1653601391271,CSE 290,C00,090137,Li; Tzumao,7,0,10,3
1653601391271,CSE 290,D00,090138,Zhou; Yuan-Yuan,9,0,10,1
1653601391271,CSE 290,E00,090139,Christensen; Henrik I,8,0,10,2
1653601391271,CSE 290,F00,094053,Shalev; Aaron D,0,0,0,0
1653601391794,CSE 291,A00,090140,Munyaka; Imani N. S.,0,0,0,0
1653601391794,CSE 291,B00,094880,Yu; Qi,0,0,0,0
1653601391794,CSE 291,C00,090142,Pannuto; Patrick William,0,0,0,0
1653601391794,CSE 291,D00,094881,Zhang; Yiying,0,0,0,0
1653601391794,CSE 291,E00,095118,Su; Hao,0,0,0,0
1653601392327,CSE 293,001,094905,Bafna; Vineet,9999,0,9999,0
1653601392327,CSE 293,002,094906,Bellare; Mihir,9999,0,9999,0
1653601392327,CSE 293,003,094907,Berg-Kirkpatrick; Taylor D,9999,0,9999,0
1653601392327,CSE 293,004,094908,Christensen; Henrik I,9999,0,9999,0
1653601392327,CSE 293,005,094909,Cottrell; Garrison W,9999,0,9999,0
1653601392327,CSE 293,006,094910,Deutsch; Alin Bernard,9999,0,9999,0
1653601392327,CSE 293,007,094911,Esmaeilzadeh; Hadi,9999,0,9999,0
1653601392327,CSE 293,008,094912,Freund; Yoav,9999,0,9999,0
1653601392327,CSE 293,009,094913,Griswold; William G.,9999,0,9999,0
1653601392327,CSE 293,010,094914,Gymrek; Melissa Ann,9999,0,9999,0
1653601392327,CSE 293,011,094915,Heninger; Nadia A,9999,0,9999,0
1653601392327,CSE 293,012,094916,Impagliazzo; Russell,9999,0,9999,0
1653601392327,CSE 293,013,094917,Jhala; Ranjit,9999,0,9999,0
1653601392327,CSE 293,014,094918,Kahng; Andrew Byun,9999,0,9999,0
1653601392327,CSE 293,015,094919,Kane; Daniel Mertz,9999,0,9999,0
1653601392327,CSE 293,016,094920,Kriegman; David J,9999,0,9999,0
1653601392327,CSE 293,017,094921,Kumar; Arun Kumar,9999,0,9999,0
1653601392327,CSE 293,018,094922,Lerner; Sorin,9999,0,9999,0
1653601392327,CSE 293,019,094923,Lovett; Shachar,9999,0,9999,0
1653601392327,CSE 293,020,094924,McAuley; Julian John,9999,0,9999,0
1653601392327,CSE 293,021,094925,Micciancio; Daniele,9999,0,9999,0
1653601392327,CSE 293,022,094926,Orailoglu; Alex,9999,0,9999,0
1653601392327,CSE 293,023,094927,Paturi; Ramamohan,9999,0,9999,0
1653601392327,CSE 293,024,094928,Polikarpova; Nadezhda,9999,0,9999,0
1653601392327,CSE 293,025,094929,Politz; Joseph Gibbs,9999,0,9999,0
1653601392327,CSE 293,026,094930,Porter; George M,9999,0,9999,0
1653601392327,CSE 293,027,094931,Porter; Leonard Emerson,9999,0,9999,0
1653601392327,CSE 293,028,094932,Ramamoorthi; Ravi,9999,0,9999,0
1653601392327,CSE 293,029,094933,Sahoo; Debashis,9999,0,9999,0
1653601392327,CSE 293,030,094934,Saul; Lawrence,9999,0,9999,0
1653601392327,CSE 293,031,094935,Savage; Stefan,9999,0,9999,0
1653601392327,CSE 293,032,094936,Schulze; Jurgen P.,9999,0,9999,0
1653601392327,CSE 293,033,094937,Snoeren; Alex C.,9999,0,9999,0
1653601392327,CSE 293,034,094938,Shang; Jingbo,9999,0,9999,0
1653601392327,CSE 293,035,094939,Stefan; Deian,9999,0,9999,0
1653601392327,CSE 293,036,094940,Su; Hao,9999,0,9999,0
1653601392327,CSE 293,037,094941,Swanson; Steven James,9999,0,9999,0
1653601392327,CSE 293,038,094942,Tullsen; Dean Michael,9999,0,9999,0
1653601392327,CSE 293,039,094943,Voelker; Geoffrey M.,9999,0,9999,0
1653601392327,CSE 293,040,094944,Zhao; Jishen,9999,0,9999,0
1653601392327,CSE 293,041,094945,Zhou; Yuan-Yuan,9999,0,9999,0
1653601392327,CSE 293,042,094946,Gao; Sicun,9998,0,9999,1
1653601392327,CSE 293,043,094947,Weibel; Nadir,9999,0,9999,0
1653601392327,CSE 293,044,094948,Gupta; Rajesh K.,9999,0,9999,0
1653601392850,CSE 294,A00,090143,Porter; George M,8,0,10,2
1653601393376,DSE 200,A00,091799,Staff,50,0,50,0
1653601393900,DSE 203,A00,091800,Gupta; Amarnath,30,0,30,0
1653601394422,DSE 250,A00,091801,Deutsch; Alin Bernard,30,0,30,0
1653601394947,DSE 290,A00,091802,Altintas De Callaf; Ilkay,50,0,50,0
1653601395527,ECE 200,001,091003,Antipa; Nicholas A,9999,0,9999,0
1653601395527,ECE 200,002,091004,Atanasov; Nikolay A.,9999,0,9999,0
1653601395527,ECE 200,003,091005,Bharadia; Dinesh,9999,0,9999,0
1653601395527,ECE 200,004,091006,Cheng; Chung Kuan,9999,0,9999,0
1653601395527,ECE 200,005,091007,Cosman; Pamela C.,9999,0,9999,0
1653601395527,ECE 200,006,091008,Staff,9999,0,9999,0
1653601395527,ECE 200,007,091009,Dayeh; Shadi Ahmad,9999,0,9999,0
1653601395527,ECE 200,008,091010,Fainman; Yeshaiahu,9999,0,9999,0
1653601395527,ECE 200,009,091011,Ford; Joseph Earl,9999,0,9999,0
1653601395527,ECE 200,010,091012,Franceschetti; Massimo,9999,0,9999,0
1653601395527,ECE 200,011,091013,Fullerton; Eric E,9999,0,9999,0
1653601395527,ECE 200,012,091014,Galton; Ian A,9999,0,9999,0
1653601395527,ECE 200,013,091015,Gilja; Vikash,9999,0,9999,0
1653601395527,ECE 200,014,091016,Hall; Drew A.,9999,0,9999,0
1653601395527,ECE 200,015,091017,Hsueh; Tzu-Chien,9999,0,9999,0
1653601395527,ECE 200,016,091018,Javidi; Tara,9999,0,9999,0
1653601395527,ECE 200,017,091019,Kahng; Andrew Byun,9999,0,9999,0
1653601395527,ECE 200,018,091020,Kim; Young-Han,9999,0,9999,0
1653601395527,ECE 200,019,091021,Koushanfar; Farinaz,9999,0,9999,0
1653601395527,ECE 200,020,091022,Kuzum; Duygu,9999,0,9999,0
1653601395527,ECE 200,021,091023,Le; Hanh-Phuc,9999,0,9999,0
1653601395527,ECE 200,022,091024,Lin; Bill,9999,0,9999,0
1653601395527,ECE 200,023,091025,Liu; Zhaowei,9999,0,9999,0
1653601395527,ECE 200,024,091026,Lo; Yu-Hwa,9999,0,9999,0
1653601395527,ECE 200,025,091027,Lomakin; Vitaliy,9999,0,9999,0
1653601395527,ECE 200,026,091028,Mercier; Patrick Philip,9999,0,9999,0
1653601395527,ECE 200,027,091029,Meyer; Florian,9999,0,9999,0
1653601395527,ECE 200,028,091030,Milstein; Laurence B.,9999,0,9999,0
1653601395527,ECE 200,029,091031,Mir Arabbaygi; Siavash,9999,0,9999,0
1653601395527,ECE 200,030,091032,Mookherjea; Shayan,9999,0,9999,0
1653601395527,ECE 200,031,091033,Morris; Karcher William,9999,0,9999,0
1653601395527,ECE 200,032,091034,Ng; Tse Nga,9999,0,9999,0
1653601395527,ECE 200,033,091035,Nguyen; Truong Quang,9999,0,9999,0
1653601395527,ECE 200,034,091036,Nomura; Kenji,9999,0,9999,0
1653601395527,ECE 200,035,091037,Orlitsky; Alon,9999,0,9999,0
1653601395527,ECE 200,036,091038,Pal; Piya,9999,0,9999,0
1653601395527,ECE 200,037,091039,Papen; George C.,9999,0,9999,0
1653601395527,ECE 200,038,091040,Radic; Stojan,9999,0,9999,0
1653601395527,ECE 200,039,091041,Rao; Bhaskar D.,9999,0,9999,0
1653601395527,ECE 200,040,091042,Rao; Ramesh R,9999,0,9999,0
1653601395527,ECE 200,041,091043,Rebeiz; Gabriel,9999,0,9999,0
1653601395527,ECE 200,042,091044,Sanford; John R,9999,0,9999,0
1653601395527,ECE 200,043,091045,Siegel; Paul H.,9999,0,9999,0
1653601395527,ECE 200,044,091046,Sievenpiper; Daniel F.,9999,0,9999,0
1653601395527,ECE 200,045,091047,Sworder; David D.,9999,0,9999,0
1653601395527,ECE 200,046,091048,Taur; Yuan,9999,0,9999,0
1653601395527,ECE 200,047,091049,Touri; Behrouz,9999,0,9999,0
1653601395527,ECE 200,048,091050,Trivedi; Mohan M.,9999,0,9999,0
1653601395527,ECE 200,049,091051,Vardy; Alexander,9999,0,9999,0
1653601395527,ECE 200,050,091052,Vasconcelos; Nuno,9999,0,9999,0
1653601395527,ECE 200,051,091053,Wang; Xiaolong,9999,0,9999,0
1653601395527,ECE 200,052,091054,Xie; Pengtao,9999,0,9999,0
1653601395527,ECE 200,053,091055,Yip; Michael,9999,0,9999,0
1653601395527,ECE 200,054,091056,Zeger; Kenneth A.,9999,0,9999,0
1653601395527,ECE 200,055,091057,Zhang; Xinyu,9999,0,9999,0
1653601395527,ECE 200,056,091058,Turakhia; Yatish Girish,9999,0,9999,0
1653601395527,ECE 200,057,091059,Kang; Mingu,9999,0,9999,0
1653601395527,ECE 200,058,091060,Shi; Yuanyuan,9999,0,9999,0
1653601395527,ECE 200,059,091061,Wang; Edward Jay,9999,0,9999,0
1653601395527,ECE 200,060,091062,Zheng; Yang,9999,0,9999,0
1653601396054,ECE 201,A00,095526,Lo; Yu-Hwa,0,0,0,0
1653601396581,ECE 203,A00,091065,Mercier; Patrick Philip,0,0,0,0
1653601397104,ECE 207A,A00,091605,Liu; Thomas Tao-Ming,0,0,0,0
1653601397627,ECE 212AN,A00,091068,Nomura; Kenji,0,0,0,0
1653601398151,ECE 222A,A00,091069,Rebeiz; Gabriel,0,0,0,0
1653601398689,ECE 225A,A00,091070,Orlitsky; Alon,0,0,0,0
1653601399215,ECE 230A,A00,091071,Nomura; Kenji,0,0,0,0
1653601399757,ECE 236A,A00,091072,Dayeh; Shadi Ahmad,0,0,0,0
1653601400292,ECE 238A,A00,091073,Luo; Jian,0,0,0,0
1653601400292,ECE 238A,B00,091074,Luo; Jian,0,0,0,0
1653601400830,ECE 240A,A00,091075,Radic; Stojan,0,0,0,0
1653601401357,ECE 247A,A00,091592,Shi; Lingyan,0,0,0,0
1653601401880,ECE 250,A00,091076,Touri; Behrouz,0,0,0,0
1653601402415,ECE 251C,A00,091078,Nguyen; Truong Quang,0,0,0,0
1653601402937,ECE 253,A00,091079,Cosman; Pamela C.,0,0,0,0
1653601403460,ECE 255A,A00,091080,Orlitsky; Alon,0,0,0,0
1653601403991,ECE 257A,A00,091081,Zhang; Xinyu,0,0,0,0
1653601404598,ECE 260A,A01,091084,Eldon; John,0,0,0,0
1653601405120,ECE 264C,A00,091085,Galton; Ian A,0,0,0,0
1653601405643,ECE 265C,A00,094889,Presti; Calogero Davide,0,0,0,9
1653601406165,ECE 266,A01,091087,Hall; Drew A.,0,0,0,0
1653601407215,ECE 271A,A00,091090,Vasconcelos; Nuno,0,0,0,0
1653601407741,ECE 272B,A00,091091,Sworder; David D.,0,0,0,0
1653601408266,ECE 275A,A00,091092,Meyer; Florian,0,0,0,0
1653601408798,ECE 277,A00,091093,An; Cheolhong,0,0,0,0
1653601409322,ECE 283,A00,091094,Le; Hanh-Phuc,0,0,0,0
1653601409848,ECE 284,A00,091095,Kang; Mingu,0,0,0,0
1653601409848,ECE 284,B00,091096,Wang; Edward Jay,0,0,0,0
1653601410371,ECE 285,A00,094334,Touri; Behrouz,0,0,0,0
1653601410946,ECE 289,A00,091097,Whelan; David Arthur,0,0,0,0
1653601411482,MATH 200A,A00,087414,Salehi Golsefidy; Alireza,7,0,8,1
1653601412018,MATH 202A,A00,087415,Gill; Philip E.,2,0,8,6
1653601412549,MATH 203A,A00,087416,Oprea; Dragos N.,6,0,8,2
1653601413081,MATH 204A,A00,087417,Kedlaya; Kiran S.,6,0,8,2
1653601413608,MATH 205,A00,087418,Sorensen; Claus M,6,0,8,2
1653601414143,MATH 206A,A00,087419,Izadi; Elham,7,0,8,1
1653601414667,MATH 207A,A00,087420,Mohammadi; Amir,5,0,8,3
1653601415199,MATH 208,A00,087421,Staff,9,0,10,1
1653601415730,MATH 209,A00,087422,Staff,10,0,10,0
1653601416252,MATH 218,A00,087423,Staff,10,0,10,0
1653601416785,MATH 220A,A00,087424,Novak; Jonathan I,6,0,8,2
1653601417317,MATH 231A,A00,087425,Bejenaru; Ioan,3,0,8,5
1653601417852,MATH 240A,A00,087426,Ebenfelt; Peter F,5,0,8,3
1653601418379,MATH 243,A00,087427,Staff,9,0,10,1
1653601418908,MATH 248,A00,087429,Staff,10,0,10,0
1653601419434,MATH 250A,A00,087430,Spolaor; Luca,4,0,8,4
1653601419965,MATH 257A,A00,087431,Spolaor; Luca,7,0,8,1
1653601420494,MATH 258,A00,087432,Staff,9,0,10,1
1653601421020,MATH 264A,A00,087433,Warnke; Lutz Peter,5,0,8,3
1653601421545,MATH 268,A00,087434,Staff,15,0,15,0
1653601422069,MATH 269,A00,087435,Staff,14,0,15,1
1653601422605,MATH 270A,A00,087436,Nie; Jiawang,0,0,8,8
1653601423128,MATH 272A,A00,087437,Tian; Xiaochuan,0,0,8,8
1653601423658,MATH 274,A01,087439,Cheng; Li-Tien,9,0,10,1
1653601423658,MATH 274,A02,087440,Cheng; Li-Tien,10,0,10,0
1653601424188,MATH 278A,A00,087441,Staff,8,0,10,2
1653601424719,MATH 278B,A00,087442,Staff,8,0,10,2
1653601425255,MATH 278C,A00,087443,Staff,8,0,10,2
1653601425786,MATH 280A,A00,087444,Zheng; Tianyi,0,0,8,8
1653601426316,MATH 281A,A00,087445,Bradic; Jelena,0,0,8,8
1653601426844,MATH 282A,A00,087446,Zhang; Danna,0,0,8,8
1653601427369,MATH 283,A00,087447,Tesler; Glenn,0,0,0,16
1653601427892,MATH 286,B00,095535,Kemp; Todd Aahron,7,0,8,1
1653601428418,MATH 287D,B00,095536,Bradic; Jelena,5,0,8,3
1653601428942,MATH 288,A00,087450,Staff,14,0,15,1
1653601428942,MATH 288,B00,087451,Staff,15,0,15,0
1653601428942,MATH 288,C00,087452,Staff,15,0,15,0
1653601429474,MATH 290A,A00,087453,Xu; Zhouli,6,0,8,2
1653601430001,MATH 291A,A00,087454,Xu; Zhouli,7,0,8,1
1653601430523,MATH 292,A00,087455,Staff,10,0,10,0
1653601431046,MATH 295,A00,087456,Staff,50,0,50,0
1653601431568,MATH 297,001,087457,Staff,997,0,999,2
1653601992568,COGS 200,A01,087991,Staff,47,0,50,3
1653601993184,COGS 201,A01,094504,Rangel; Lara M,16,0,25,9
1653601993713,COGS 203,A00,087992,Coulson; Seana M,18,0,20,2
1653601994242,COGS 210A,001,087993,Greene; Deanna Jacquelyn,9998,0,9999,1
1653601994242,COGS 210A,002,087994,Saygin; Ayse P,9999,0,9999,0
1653601994242,COGS 210A,003,087995,Xia; Haijun,9999,0,9999,0
1653601994242,COGS 210A,004,087996,Nitz; Douglas A.,9999,0,9999,0
1653601994242,COGS 210A,005,087997,Hollan; James D.,9999,0,9999,0
1653601994242,COGS 210A,006,087998,Deak; Gedeon O.,9998,0,9999,1
1653601994242,COGS 210A,007,087999,Rossano; Federico,9999,0,9999,0
1653601994773,COGS 211A,A00,088000,Coulson; Seana M,9997,0,9999,2
1653601995296,COGS 229,A00,088002,Staff,22,0,25,3
1653601995818,COGS 260,B00,094231,Staff,17,0,20,3
1653601995818,COGS 260,A00,088004,Nitz; Douglas A.,9998,0,9999,1
1653601996351,CSE 202,A00,090110,Paturi; Ramamohan,0,0,0,0
1653601996351,CSE 202,B00,090111,Paturi; Ramamohan,0,0,0,0
1653601996876,CSE 207B,A00,090112,Heninger; Nadia A,0,0,0,0
1653601997404,CSE 208,A00,094858,Micciancio; Daniele,0,0,0,0
1653601997936,CSE 210,A00,090113,Powell; Thomas Allan,0,0,0,0
1653601998460,CSE 219,A00,090898,Staff,0,0,0,0
1653601998985,CSE 221,A00,090114,Zhou; Yuan-Yuan,0,0,0,0
1653601999508,CSE 229A,A00,090115,Porter; George M,0,0,0,0
1653602000030,CSE 229C,A00,090116,Savage; Stefan,0,0,0,0
1653602000553,CSE 230,A00,090117,Jhala; Ranjit,0,0,0,0
1653602001074,CSE 232,A00,090118,Papakonstantinou; Yannis,0,0,0,0
1653602001606,CSE 239A,A00,090121,Kumar; Arun Kumar,0,0,0,0
1653602002131,CSE 239B,A00,090122,Jhala; Ranjit,0,0,0,0
1653602002654,CSE 240A,A00,090123,Zhao; Jishen,0,0,189,189
1653602003181,CSE 243A,A00,090124,Orailoglu; Alex,0,0,15,15
1653602003719,CSE 249B,A00,090125,Kahng; Andrew Byun,12,0,20,8
1653602004245,CSE 250A,A00,090126,Berg-Kirkpatrick; Taylor D,0,0,0,0
1653602004768,CSE 252A,A00,090127,Ochoa; Benjamin Lawrence,0,0,0,0
1653602005300,CSE 258,A01,090129,McAuley; Julian John,0,0,0,0
1653602005825,CSE 258R,A01,090131,McAuley; Julian John,0,0,0,0
1653602006351,CSE 274,A00,090132,Ramamoorthi; Ravi,0,0,0,0
1653602006874,CSE 276A,A00,090133,Christensen; Henrik I,0,0,0,0
1653602007399,CSE 276C,A00,090134,Christensen; Henrik I,0,0,0,0
1653602007923,CSE 290,A00,090135,Bafna; Vineet,0,0,0,0
1653602007923,CSE 290,B00,090136,Ramamoorthi; Ravi,0,0,0,0
1653602007923,CSE 290,C00,090137,Li; Tzumao,7,0,10,3
1653602007923,CSE 290,D00,090138,Zhou; Yuan-Yuan,9,0,10,1
1653602007923,CSE 290,E00,090139,Christensen; Henrik I,8,0,10,2
1653602007923,CSE 290,F00,094053,Shalev; Aaron D,0,0,0,0
1653602008457,CSE 291,A00,090140,Munyaka; Imani N. S.,0,0,0,0
1653602008457,CSE 291,B00,094880,Yu; Qi,0,0,0,0
1653602008457,CSE 291,C00,090142,Pannuto; Patrick William,0,0,0,0
1653602008457,CSE 291,D00,094881,Zhang; Yiying,0,0,0,0
1653602008457,CSE 291,E00,095118,Su; Hao,0,0,0,0
1653602008990,CSE 293,001,094905,Bafna; Vineet,9999,0,9999,0
1653602008990,CSE 293,002,094906,Bellare; Mihir,9999,0,9999,0
1653602008990,CSE 293,003,094907,Berg-Kirkpatrick; Taylor D,9999,0,9999,0
1653602008990,CSE 293,004,094908,Christensen; Henrik I,9999,0,9999,0
1653602008990,CSE 293,005,094909,Cottrell; Garrison W,9999,0,9999,0
1653602008990,CSE 293,006,094910,Deutsch; Alin Bernard,9999,0,9999,0
1653602008990,CSE 293,007,094911,Esmaeilzadeh; Hadi,9999,0,9999,0
1653602008990,CSE 293,008,094912,Freund; Yoav,9999,0,9999,0
1653602008990,CSE 293,009,094913,Griswold; William G.,9999,0,9999,0
1653602008990,CSE 293,010,094914,Gymrek; Melissa Ann,9999,0,9999,0
1653602008990,CSE 293,011,094915,Heninger; Nadia A,9999,0,9999,0
1653602008990,CSE 293,012,094916,Impagliazzo; Russell,9999,0,9999,0
1653602008990,CSE 293,013,094917,Jhala; Ranjit,9999,0,9999,0
1653602008990,CSE 293,014,094918,Kahng; Andrew Byun,9999,0,9999,0
1653602008990,CSE 293,015,094919,Kane; Daniel Mertz,9999,0,9999,0
1653602008990,CSE 293,016,094920,Kriegman; David J,9999,0,9999,0
1653602008990,CSE 293,017,094921,Kumar; Arun Kumar,9999,0,9999,0
1653602008990,CSE 293,018,094922,Lerner; Sorin,9999,0,9999,0
1653602008990,CSE 293,019,094923,Lovett; Shachar,9999,0,9999,0
1653602008990,CSE 293,020,094924,McAuley; Julian John,9999,0,9999,0
1653602008990,CSE 293,021,094925,Micciancio; Daniele,9999,0,9999,0
1653602008990,CSE 293,022,094926,Orailoglu; Alex,9999,0,9999,0
1653602008990,CSE 293,023,094927,Paturi; Ramamohan,9999,0,9999,0
1653602008990,CSE 293,024,094928,Polikarpova; Nadezhda,9999,0,9999,0
1653602008990,CSE 293,025,094929,Politz; Joseph Gibbs,9999,0,9999,0
1653602008990,CSE 293,026,094930,Porter; George M,9999,0,9999,0
1653602008990,CSE 293,027,094931,Porter; Leonard Emerson,9999,0,9999,0
1653602008990,CSE 293,028,094932,Ramamoorthi; Ravi,9999,0,9999,0
1653602008990,CSE 293,029,094933,Sahoo; Debashis,9999,0,9999,0
1653602008990,CSE 293,030,094934,Saul; Lawrence,9999,0,9999,0
1653602008990,CSE 293,031,094935,Savage; Stefan,9999,0,9999,0
1653602008990,CSE 293,032,094936,Schulze; Jurgen P.,9999,0,9999,0
1653602008990,CSE 293,033,094937,Snoeren; Alex C.,9999,0,9999,0
1653602008990,CSE 293,034,094938,Shang; Jingbo,9999,0,9999,0
1653602008990,CSE 293,035,094939,Stefan; Deian,9999,0,9999,0
1653602008990,CSE 293,036,094940,Su; Hao,9999,0,9999,0
1653602008990,CSE 293,037,094941,Swanson; Steven James,9999,0,9999,0
1653602008990,CSE 293,038,094942,Tullsen; Dean Michael,9999,0,9999,0
1653602008990,CSE 293,039,094943,Voelker; Geoffrey M.,9999,0,9999,0
1653602008990,CSE 293,040,094944,Zhao; Jishen,9999,0,9999,0
1653602008990,CSE 293,041,094945,Zhou; Yuan-Yuan,9999,0,9999,0
1653602008990,CSE 293,042,094946,Gao; Sicun,9998,0,9999,1
1653602008990,CSE 293,043,094947,Weibel; Nadir,9999,0,9999,0
1653602008990,CSE 293,044,094948,Gupta; Rajesh K.,9999,0,9999,0
1653602009512,CSE 294,A00,090143,Porter; George M,8,0,10,2
1653602010038,DSE 200,A00,091799,Staff,50,0,50,0
1653602010563,DSE 203,A00,091800,Gupta; Amarnath,30,0,30,0
1653602011085,DSE 250,A00,091801,Deutsch; Alin Bernard,30,0,30,0
1653602011612,DSE 290,A00,091802,Altintas De Callaf; Ilkay,50,0,50,0
1653602012149,ECE 200,001,091003,Antipa; Nicholas A,9999,0,9999,0
1653602012149,ECE 200,002,091004,Atanasov; Nikolay A.,9999,0,9999,0
1653602012149,ECE 200,003,091005,Bharadia; Dinesh,9999,0,9999,0
1653602012149,ECE 200,004,091006,Cheng; Chung Kuan,9999,0,9999,0
1653602012149,ECE 200,005,091007,Cosman; Pamela C.,9999,0,9999,0
1653602012149,ECE 200,006,091008,Staff,9999,0,9999,0
1653602012149,ECE 200,007,091009,Dayeh; Shadi Ahmad,9999,0,9999,0
1653602012149,ECE 200,008,091010,Fainman; Yeshaiahu,9999,0,9999,0
1653602012149,ECE 200,009,091011,Ford; Joseph Earl,9999,0,9999,0
1653602012149,ECE 200,010,091012,Franceschetti; Massimo,9999,0,9999,0
1653602012149,ECE 200,011,091013,Fullerton; Eric E,9999,0,9999,0
1653602012149,ECE 200,012,091014,Galton; Ian A,9999,0,9999,0
1653602012149,ECE 200,013,091015,Gilja; Vikash,9999,0,9999,0
1653602012149,ECE 200,014,091016,Hall; Drew A.,9999,0,9999,0
1653602012149,ECE 200,015,091017,Hsueh; Tzu-Chien,9999,0,9999,0
1653602012149,ECE 200,016,091018,Javidi; Tara,9999,0,9999,0
1653602012149,ECE 200,017,091019,Kahng; Andrew Byun,9999,0,9999,0
1653602012149,ECE 200,018,091020,Kim; Young-Han,9999,0,9999,0
1653602012149,ECE 200,019,091021,Koushanfar; Farinaz,9999,0,9999,0
1653602012149,ECE 200,020,091022,Kuzum; Duygu,9999,0,9999,0
1653602012149,ECE 200,021,091023,Le; Hanh-Phuc,9999,0,9999,0
1653602012149,ECE 200,022,091024,Lin; Bill,9999,0,9999,0
1653602012149,ECE 200,023,091025,Liu; Zhaowei,9999,0,9999,0
1653602012149,ECE 200,024,091026,Lo; Yu-Hwa,9999,0,9999,0
1653602012149,ECE 200,025,091027,Lomakin; Vitaliy,9999,0,9999,0
1653602012149,ECE 200,026,091028,Mercier; Patrick Philip,9999,0,9999,0
1653602012149,ECE 200,027,091029,Meyer; Florian,9999,0,9999,0
1653602012149,ECE 200,028,091030,Milstein; Laurence B.,9999,0,9999,0
1653602012149,ECE 200,029,091031,Mir Arabbaygi; Siavash,9999,0,9999,0
1653602012149,ECE 200,030,091032,Mookherjea; Shayan,9999,0,9999,0
1653602012149,ECE 200,031,091033,Morris; Karcher William,9999,0,9999,0
1653602012149,ECE 200,032,091034,Ng; Tse Nga,9999,0,9999,0
1653602012149,ECE 200,033,091035,Nguyen; Truong Quang,9999,0,9999,0
1653602012149,ECE 200,034,091036,Nomura; Kenji,9999,0,9999,0
1653602012149,ECE 200,035,091037,Orlitsky; Alon,9999,0,9999,0
1653602012149,ECE 200,036,091038,Pal; Piya,9999,0,9999,0
1653602012149,ECE 200,037,091039,Papen; George C.,9999,0,9999,0
1653602012149,ECE 200,038,091040,Radic; Stojan,9999,0,9999,0
1653602012149,ECE 200,039,091041,Rao; Bhaskar D.,9999,0,9999,0
1653602012149,ECE 200,040,091042,Rao; Ramesh R,9999,0,9999,0
1653602012149,ECE 200,041,091043,Rebeiz; Gabriel,9999,0,9999,0
1653602012149,ECE 200,042,091044,Sanford; John R,9999,0,9999,0
1653602012149,ECE 200,043,091045,Siegel; Paul H.,9999,0,9999,0
1653602012149,ECE 200,044,091046,Sievenpiper; Daniel F.,9999,0,9999,0
1653602012149,ECE 200,045,091047,Sworder; David D.,9999,0,9999,0
1653602012149,ECE 200,046,091048,Taur; Yuan,9999,0,9999,0
1653602012149,ECE 200,047,091049,Touri; Behrouz,9999,0,9999,0
1653602012149,ECE 200,048,091050,Trivedi; Mohan M.,9999,0,9999,0
1653602012149,ECE 200,049,091051,Vardy; Alexander,9999,0,9999,0
1653602012149,ECE 200,050,091052,Vasconcelos; Nuno,9999,0,9999,0
1653602012149,ECE 200,051,091053,Wang; Xiaolong,9999,0,9999,0
1653602012149,ECE 200,052,091054,Xie; Pengtao,9999,0,9999,0
1653602012149,ECE 200,053,091055,Yip; Michael,9999,0,9999,0
1653602012149,ECE 200,054,091056,Zeger; Kenneth A.,9999,0,9999,0
1653602012149,ECE 200,055,091057,Zhang; Xinyu,9999,0,9999,0
1653602012149,ECE 200,056,091058,Turakhia; Yatish Girish,9999,0,9999,0
1653602012149,ECE 200,057,091059,Kang; Mingu,9999,0,9999,0
1653602012149,ECE 200,058,091060,Shi; Yuanyuan,9999,0,9999,0
1653602012149,ECE 200,059,091061,Wang; Edward Jay,9999,0,9999,0
1653602012149,ECE 200,060,091062,Zheng; Yang,9999,0,9999,0
1653602012672,ECE 201,A00,095526,Lo; Yu-Hwa,0,0,0,0
1653602013195,ECE 203,A00,091065,Mercier; Patrick Philip,0,0,0,0
1653602013717,ECE 207A,A00,091605,Liu; Thomas Tao-Ming,0,0,0,0
1653602014243,ECE 212AN,A00,091068,Nomura; Kenji,0,0,0,0
1653602014766,ECE 222A,A00,091069,Rebeiz; Gabriel,0,0,0,0
1653602015291,ECE 225A,A00,091070,Orlitsky; Alon,0,0,0,0
1653602015822,ECE 230A,A00,091071,Nomura; Kenji,0,0,0,0
1653602016343,ECE 236A,A00,091072,Dayeh; Shadi Ahmad,0,0,0,0
1653602016869,ECE 238A,A00,091073,Luo; Jian,0,0,0,0
1653602016869,ECE 238A,B00,091074,Luo; Jian,0,0,0,0
1653602017394,ECE 240A,A00,091075,Radic; Stojan,0,0,0,0
1653602017936,ECE 247A,A00,091592,Shi; Lingyan,0,0,0,0
1653602018465,ECE 250,A00,091076,Touri; Behrouz,0,0,0,0
1653602018987,ECE 251C,A00,091078,Nguyen; Truong Quang,0,0,0,0
1653602019510,ECE 253,A00,091079,Cosman; Pamela C.,0,0,0,0
1653602020032,ECE 255A,A00,091080,Orlitsky; Alon,0,0,0,0
1653602020559,ECE 257A,A00,091081,Zhang; Xinyu,0,0,0,0
1653602021090,ECE 260A,A01,091084,Eldon; John,0,0,0,0
1653602021619,ECE 264C,A00,091085,Galton; Ian A,0,0,0,0
1653602022145,ECE 265C,A00,094889,Presti; Calogero Davide,0,0,0,9
1653602022670,ECE 266,A01,091087,Hall; Drew A.,0,0,0,0
1653602023719,ECE 271A,A00,091090,Vasconcelos; Nuno,0,0,0,0
1653602024241,ECE 272B,A00,091091,Sworder; David D.,0,0,0,0
1653602024772,ECE 275A,A00,091092,Meyer; Florian,0,0,0,0
1653602025307,ECE 277,A00,091093,An; Cheolhong,0,0,0,0
1653602025830,ECE 283,A00,091094,Le; Hanh-Phuc,0,0,0,0
1653602026351,ECE 284,A00,091095,Kang; Mingu,0,0,0,0
1653602026351,ECE 284,B00,091096,Wang; Edward Jay,0,0,0,0
1653602026876,ECE 285,A00,094334,Touri; Behrouz,0,0,0,0
1653602027402,ECE 289,A00,091097,Whelan; David Arthur,0,0,0,0
1653602027929,MATH 200A,A00,087414,Salehi Golsefidy; Alireza,7,0,8,1
1653602028456,MATH 202A,A00,087415,Gill; Philip E.,2,0,8,6
1653602028991,MATH 203A,A00,087416,Oprea; Dragos N.,6,0,8,2
1653602029514,MATH 204A,A00,087417,Kedlaya; Kiran S.,6,0,8,2
1653602030037,MATH 205,A00,087418,Sorensen; Claus M,6,0,8,2
1653602030573,MATH 206A,A00,087419,Izadi; Elham,7,0,8,1
1653602031096,MATH 207A,A00,087420,Mohammadi; Amir,5,0,8,3
1653602031624,MATH 208,A00,087421,Staff,9,0,10,1
1653602032148,MATH 209,A00,087422,Staff,10,0,10,0
1653602032672,MATH 218,A00,087423,Staff,10,0,10,0
1653602033196,MATH 220A,A00,087424,Novak; Jonathan I,6,0,8,2
1653602033723,MATH 231A,A00,087425,Bejenaru; Ioan,3,0,8,5
1653602034255,MATH 240A,A00,087426,Ebenfelt; Peter F,5,0,8,3
1653602034779,MATH 243,A00,087427,Staff,9,0,10,1
1653602035320,MATH 248,A00,087429,Staff,10,0,10,0
1653602035853,MATH 250A,A00,087430,Spolaor; Luca,4,0,8,4
1653602036380,MATH 257A,A00,087431,Spolaor; Luca,7,0,8,1
1653602036904,MATH 258,A00,087432,Staff,9,0,10,1
1653602037435,MATH 264A,A00,087433,Warnke; Lutz Peter,5,0,8,3
1653602037966,MATH 268,A00,087434,Staff,15,0,15,0
1653602038488,MATH 269,A00,087435,Staff,14,0,15,1
1653602039011,MATH 270A,A00,087436,Nie; Jiawang,0,0,8,8
1653602039535,MATH 272A,A00,087437,Tian; Xiaochuan,0,0,8,8
1653602040058,MATH 274,A01,087439,Cheng; Li-Tien,9,0,10,1
1653602040058,MATH 274,A02,087440,Cheng; Li-Tien,10,0,10,0
1653602040584,MATH 278A,A00,087441,Staff,8,0,10,2
1653602041106,MATH 278B,A00,087442,Staff,8,0,10,2
1653602041630,MATH 278C,A00,087443,Staff,8,0,10,2
1653602042155,MATH 280A,A00,087444,Zheng; Tianyi,0,0,8,8
1653602042679,MATH 281A,A00,087445,Bradic; Jelena,0,0,8,8
1653602043201,MATH 282A,A00,087446,Zhang; Danna,0,0,8,8
1653602043723,MATH 283,A00,087447,Tesler; Glenn,0,0,0,16
1653602044246,MATH 286,B00,095535,Kemp; Todd Aahron,7,0,8,1
1653602044773,MATH 287D,B00,095536,Bradic; Jelena,5,0,8,3
1653602045295,MATH 288,A00,087450,Staff,14,0,15,1
1653602045295,MATH 288,B00,087451,Staff,15,0,15,0
1653602045295,MATH 288,C00,087452,Staff,15,0,15,0
1653602045822,MATH 290A,A00,087453,Xu; Zhouli,6,0,8,2
1653602046424,MATH 291A,A00,087454,Xu; Zhouli,7,0,8,1
1653602046964,MATH 292,A00,087455,Staff,10,0,10,0
1653602047487,MATH 295,A00,087456,Staff,50,0,50,0
1653602048014,MATH 297,001,087457,Staff,997,0,999,2
1653602620707,COGS 200,A01,087991,Staff,47,0,50,3
1653602621230,COGS 201,A01,094504,Rangel; Lara M,16,0,25,9
1653602621761,COGS 203,A00,087992,Coulson; Seana M,18,0,20,2
1653602622284,COGS 210A,001,087993,Greene; Deanna Jacquelyn,9998,0,9999,1
1653602622284,COGS 210A,002,087994,Saygin; Ayse P,9999,0,9999,0
1653602622284,COGS 210A,003,087995,Xia; Haijun,9999,0,9999,0
1653602622284,COGS 210A,004,087996,Nitz; Douglas A.,9999,0,9999,0
1653602622284,COGS 210A,005,087997,Hollan; James D.,9999,0,9999,0
1653602622284,COGS 210A,006,087998,Deak; Gedeon O.,9998,0,9999,1
1653602622284,COGS 210A,007,087999,Rossano; Federico,9999,0,9999,0
1653602622807,COGS 211A,A00,088000,Coulson; Seana M,9997,0,9999,2
1653602623333,COGS 229,A00,088002,Staff,22,0,25,3
1653602623860,COGS 260,B00,094231,Staff,17,0,20,3
1653602623860,COGS 260,A00,088004,Nitz; Douglas A.,9998,0,9999,1
1653602624384,CSE 202,A00,090110,Paturi; Ramamohan,0,0,0,0
1653602624384,CSE 202,B00,090111,Paturi; Ramamohan,0,0,0,0
1653602624941,CSE 207B,A00,090112,Heninger; Nadia A,0,0,0,0
1653602625481,CSE 208,A00,094858,Micciancio; Daniele,0,0,0,0
1653602626006,CSE 210,A00,090113,Powell; Thomas Allan,0,0,0,0
1653602626532,CSE 219,A00,090898,Staff,0,0,0,0
1653602627055,CSE 221,A00,090114,Zhou; Yuan-Yuan,0,0,0,0
1653602627580,CSE 229A,A00,090115,Porter; George M,0,0,0,0
1653602628101,CSE 229C,A00,090116,Savage; Stefan,0,0,0,0
1653602628625,CSE 230,A00,090117,Jhala; Ranjit,0,0,0,0
1653602629148,CSE 232,A00,090118,Papakonstantinou; Yannis,0,0,0,0
1653602629674,CSE 239A,A00,090121,Kumar; Arun Kumar,0,0,0,0
1653602630197,CSE 239B,A00,090122,Jhala; Ranjit,0,0,0,0
1653602630731,CSE 240A,A00,090123,Zhao; Jishen,0,0,189,189
1653602631253,CSE 243A,A00,090124,Orailoglu; Alex,0,0,15,15
1653602631776,CSE 249B,A00,090125,Kahng; Andrew Byun,12,0,20,8
1653602632301,CSE 250A,A00,090126,Berg-Kirkpatrick; Taylor D,0,0,0,0
1653602632832,CSE 252A,A00,090127,Ochoa; Benjamin Lawrence,0,0,0,0
1653602633356,CSE 258,A01,090129,McAuley; Julian John,0,0,0,0
1653602633885,CSE 258R,A01,090131,McAuley; Julian John,0,0,0,0
1653602634411,CSE 274,A00,090132,Ramamoorthi; Ravi,0,0,0,0
1653602634934,CSE 276A,A00,090133,Christensen; Henrik I,0,0,0,0
1653602635461,CSE 276C,A00,090134,Christensen; Henrik I,0,0,0,0
1653602635988,CSE 290,A00,090135,Bafna; Vineet,0,0,0,0
1653602635988,CSE 290,B00,090136,Ramamoorthi; Ravi,0,0,0,0
1653602635988,CSE 290,C00,090137,Li; Tzumao,7,0,10,3
1653602635988,CSE 290,D00,090138,Zhou; Yuan-Yuan,9,0,10,1
1653602635988,CSE 290,E00,090139,Christensen; Henrik I,8,0,10,2
1653602635988,CSE 290,F00,094053,Shalev; Aaron D,0,0,0,0
1653602636516,CSE 291,A00,090140,Munyaka; Imani N. S.,0,0,0,0
1653602636516,CSE 291,B00,094880,Yu; Qi,0,0,0,0
1653602636516,CSE 291,C00,090142,Pannuto; Patrick William,0,0,0,0
1653602636516,CSE 291,D00,094881,Zhang; Yiying,0,0,0,0
1653602636516,CSE 291,E00,095118,Su; Hao,0,0,0,0
1653602637051,CSE 293,001,094905,Bafna; Vineet,9999,0,9999,0
1653602637051,CSE 293,002,094906,Bellare; Mihir,9999,0,9999,0
1653602637051,CSE 293,003,094907,Berg-Kirkpatrick; Taylor D,9999,0,9999,0
1653602637051,CSE 293,004,094908,Christensen; Henrik I,9999,0,9999,0
1653602637051,CSE 293,005,094909,Cottrell; Garrison W,9999,0,9999,0
1653602637051,CSE 293,006,094910,Deutsch; Alin Bernard,9999,0,9999,0
1653602637051,CSE 293,007,094911,Esmaeilzadeh; Hadi,9999,0,9999,0
1653602637051,CSE 293,008,094912,Freund; Yoav,9999,0,9999,0
1653602637051,CSE 293,009,094913,Griswold; William G.,9999,0,9999,0
1653602637051,CSE 293,010,094914,Gymrek; Melissa Ann,9999,0,9999,0
1653602637051,CSE 293,011,094915,Heninger; Nadia A,9999,0,9999,0
1653602637051,CSE 293,012,094916,Impagliazzo; Russell,9999,0,9999,0
1653602637051,CSE 293,013,094917,Jhala; Ranjit,9999,0,9999,0
1653602637051,CSE 293,014,094918,Kahng; Andrew Byun,9999,0,9999,0
1653602637051,CSE 293,015,094919,Kane; Daniel Mertz,9999,0,9999,0
1653602637051,CSE 293,016,094920,Kriegman; David J,9999,0,9999,0
1653602637051,CSE 293,017,094921,Kumar; Arun Kumar,9999,0,9999,0
1653602637051,CSE 293,018,094922,Lerner; Sorin,9999,0,9999,0
1653602637051,CSE 293,019,094923,Lovett; Shachar,9999,0,9999,0
1653602637051,CSE 293,020,094924,McAuley; Julian John,9999,0,9999,0
1653602637051,CSE 293,021,094925,Micciancio; Daniele,9999,0,9999,0
1653602637051,CSE 293,022,094926,Orailoglu; Alex,9999,0,9999,0
1653602637051,CSE 293,023,094927,Paturi; Ramamohan,9999,0,9999,0
1653602637051,CSE 293,024,094928,Polikarpova; Nadezhda,9999,0,9999,0
1653602637051,CSE 293,025,094929,Politz; Joseph Gibbs,9999,0,9999,0
1653602637051,CSE 293,026,094930,Porter; George M,9999,0,9999,0
1653602637051,CSE 293,027,094931,Porter; Leonard Emerson,9999,0,9999,0
1653602637051,CSE 293,028,094932,Ramamoorthi; Ravi,9999,0,9999,0
1653602637051,CSE 293,029,094933,Sahoo; Debashis,9999,0,9999,0
1653602637051,CSE 293,030,094934,Saul; Lawrence,9999,0,9999,0
1653602637051,CSE 293,031,094935,Savage; Stefan,9999,0,9999,0
1653602637051,CSE 293,032,094936,Schulze; Jurgen P.,9999,0,9999,0
1653602637051,CSE 293,033,094937,Snoeren; Alex C.,9999,0,9999,0
1653602637051,CSE 293,034,094938,Shang; Jingbo,9999,0,9999,0
1653602637051,CSE 293,035,094939,Stefan; Deian,9999,0,9999,0
1653602637051,CSE 293,036,094940,Su; Hao,9999,0,9999,0
1653602637051,CSE 293,037,094941,Swanson; Steven James,9999,0,9999,0
1653602637051,CSE 293,038,094942,Tullsen; Dean Michael,9999,0,9999,0
1653602637051,CSE 293,039,094943,Voelker; Geoffrey M.,9999,0,9999,0
1653602637051,CSE 293,040,094944,Zhao; Jishen,9999,0,9999,0
1653602637051,CSE 293,041,094945,Zhou; Yuan-Yuan,9999,0,9999,0
1653602637051,CSE 293,042,094946,Gao; Sicun,9998,0,9999,1
1653602637051,CSE 293,043,094947,Weibel; Nadir,9999,0,9999,0
1653602637051,CSE 293,044,094948,Gupta; Rajesh K.,9999,0,9999,0
1653602637576,CSE 294,A00,090143,Porter; George M,8,0,10,2
1653602638099,DSE 200,A00,091799,Staff,50,0,50,0
1653602638637,DSE 203,A00,091800,Gupta; Amarnath,30,0,30,0
1653602639164,DSE 250,A00,091801,Deutsch; Alin Bernard,30,0,30,0
1653602639698,DSE 290,A00,091802,Altintas De Callaf; Ilkay,50,0,50,0
1653602640251,ECE 200,001,091003,Antipa; Nicholas A,9999,0,9999,0
1653602640251,ECE 200,002,091004,Atanasov; Nikolay A.,9999,0,9999,0
1653602640251,ECE 200,003,091005,Bharadia; Dinesh,9999,0,9999,0
1653602640251,ECE 200,004,091006,Cheng; Chung Kuan,9999,0,9999,0
1653602640251,ECE 200,005,091007,Cosman; Pamela C.,9999,0,9999,0
1653602640251,ECE 200,006,091008,Staff,9999,0,9999,0
1653602640251,ECE 200,007,091009,Dayeh; Shadi Ahmad,9999,0,9999,0
1653602640251,ECE 200,008,091010,Fainman; Yeshaiahu,9999,0,9999,0
1653602640251,ECE 200,009,091011,Ford; Joseph Earl,9999,0,9999,0
1653602640251,ECE 200,010,091012,Franceschetti; Massimo,9999,0,9999,0
1653602640251,ECE 200,011,091013,Fullerton; Eric E,9999,0,9999,0
1653602640251,ECE 200,012,091014,Galton; Ian A,9999,0,9999,0
1653602640251,ECE 200,013,091015,Gilja; Vikash,9999,0,9999,0
1653602640251,ECE 200,014,091016,Hall; Drew A.,9999,0,9999,0
1653602640251,ECE 200,015,091017,Hsueh; Tzu-Chien,9999,0,9999,0
1653602640251,ECE 200,016,091018,Javidi; Tara,9999,0,9999,0
1653602640251,ECE 200,017,091019,Kahng; Andrew Byun,9999,0,9999,0
1653602640251,ECE 200,018,091020,Kim; Young-Han,9999,0,9999,0
1653602640251,ECE 200,019,091021,Koushanfar; Farinaz,9999,0,9999,0
1653602640251,ECE 200,020,091022,Kuzum; Duygu,9999,0,9999,0
1653602640251,ECE 200,021,091023,Le; Hanh-Phuc,9999,0,9999,0
1653602640251,ECE 200,022,091024,Lin; Bill,9999,0,9999,0
1653602640251,ECE 200,023,091025,Liu; Zhaowei,9999,0,9999,0
1653602640251,ECE 200,024,091026,Lo; Yu-Hwa,9999,0,9999,0
1653602640251,ECE 200,025,091027,Lomakin; Vitaliy,9999,0,9999,0
1653602640251,ECE 200,026,091028,Mercier; Patrick Philip,9999,0,9999,0
1653602640251,ECE 200,027,091029,Meyer; Florian,9999,0,9999,0
1653602640251,ECE 200,028,091030,Milstein; Laurence B.,9999,0,9999,0
1653602640251,ECE 200,029,091031,Mir Arabbaygi; Siavash,9999,0,9999,0
1653602640251,ECE 200,030,091032,Mookherjea; Shayan,9999,0,9999,0
1653602640251,ECE 200,031,091033,Morris; Karcher William,9999,0,9999,0
1653602640251,ECE 200,032,091034,Ng; Tse Nga,9999,0,9999,0
1653602640251,ECE 200,033,091035,Nguyen; Truong Quang,9999,0,9999,0
1653602640251,ECE 200,034,091036,Nomura; Kenji,9999,0,9999,0
1653602640251,ECE 200,035,091037,Orlitsky; Alon,9999,0,9999,0
1653602640251,ECE 200,036,091038,Pal; Piya,9999,0,9999,0
1653602640251,ECE 200,037,091039,Papen; George C.,9999,0,9999,0
1653602640251,ECE 200,038,091040,Radic; Stojan,9999,0,9999,0
1653602640251,ECE 200,039,091041,Rao; Bhaskar D.,9999,0,9999,0
1653602640251,ECE 200,040,091042,Rao; Ramesh R,9999,0,9999,0
1653602640251,ECE 200,041,091043,Rebeiz; Gabriel,9999,0,9999,0
1653602640251,ECE 200,042,091044,Sanford; John R,9999,0,9999,0
1653602640251,ECE 200,043,091045,Siegel; Paul H.,9999,0,9999,0
1653602640251,ECE 200,044,091046,Sievenpiper; Daniel F.,9999,0,9999,0
1653602640251,ECE 200,045,091047,Sworder; David D.,9999,0,9999,0
1653602640251,ECE 200,046,091048,Taur; Yuan,9999,0,9999,0
1653602640251,ECE 200,047,091049,Touri; Behrouz,9999,0,9999,0
1653602640251,ECE 200,048,091050,Trivedi; Mohan M.,9999,0,9999,0
1653602640251,ECE 200,049,091051,Vardy; Alexander,9999,0,9999,0
1653602640251,ECE 200,050,091052,Vasconcelos; Nuno,9999,0,9999,0
1653602640251,ECE 200,051,091053,Wang; Xiaolong,9999,0,9999,0
1653602640251,ECE 200,052,091054,Xie; Pengtao,9999,0,9999,0
1653602640251,ECE 200,053,091055,Yip; Michael,9999,0,9999,0
1653602640251,ECE 200,054,091056,Zeger; Kenneth A.,9999,0,9999,0
1653602640251,ECE 200,055,091057,Zhang; Xinyu,9999,0,9999,0
1653602640251,ECE 200,056,091058,Turakhia; Yatish Girish,9999,0,9999,0
1653602640251,ECE 200,057,091059,Kang; Mingu,9999,0,9999,0
1653602640251,ECE 200,058,091060,Shi; Yuanyuan,9999,0,9999,0
1653602640251,ECE 200,059,091061,Wang; Edward Jay,9999,0,9999,0
1653602640251,ECE 200,060,091062,Zheng; Yang,9999,0,9999,0
1653602640794,ECE 201,A00,095526,Lo; Yu-Hwa,0,0,0,0
1653602641320,ECE 203,A00,091065,Mercier; Patrick Philip,0,0,0,0
1653602641850,ECE 207A,A00,091605,Liu; Thomas Tao-Ming,0,0,0,0
1653602642372,ECE 212AN,A00,091068,Nomura; Kenji,0,0,0,0
1653602642910,ECE 222A,A00,091069,Rebeiz; Gabriel,0,0,0,0
1653602643433,ECE 225A,A00,091070,Orlitsky; Alon,0,0,0,0
1653602643958,ECE 230A,A00,091071,Nomura; Kenji,0,0,0,0
1653602644480,ECE 236A,A00,091072,Dayeh; Shadi Ahmad,0,0,0,0
1653602645012,ECE 238A,A00,091073,Luo; Jian,0,0,0,0
1653602645012,ECE 238A,B00,091074,Luo; Jian,0,0,0,0
1653602645536,ECE 240A,A00,091075,Radic; Stojan,0,0,0,0
1653602646065,ECE 247A,A00,091592,Shi; Lingyan,0,0,0,0
1653602646672,ECE 250,A00,091076,Touri; Behrouz,0,0,0,0
1653602647196,ECE 251C,A00,091078,Nguyen; Truong Quang,0,0,0,0
1653602647724,ECE 253,A00,091079,Cosman; Pamela C.,0,0,0,0
1653602648250,ECE 255A,A00,091080,Orlitsky; Alon,0,0,0,0
1653602648772,ECE 257A,A00,091081,Zhang; Xinyu,0,0,0,0
1653602649293,ECE 260A,A01,091084,Eldon; John,0,0,0,0
1653602649819,ECE 264C,A00,091085,Galton; Ian A,0,0,0,0
1653602650344,ECE 265C,A00,094889,Presti; Calogero Davide,0,0,0,9
1653602650868,ECE 266,A01,091087,Hall; Drew A.,0,0,0,0
1653602651941,ECE 271A,A00,091090,Vasconcelos; Nuno,0,0,0,0
1653602652464,ECE 272B,A00,091091,Sworder; David D.,0,0,0,0
1653602652995,ECE 275A,A00,091092,Meyer; Florian,0,0,0,0
1653602653530,ECE 277,A00,091093,An; Cheolhong,0,0,0,0
1653602654053,ECE 283,A00,091094,Le; Hanh-Phuc,0,0,0,0
1653602654589,ECE 284,A00,091095,Kang; Mingu,0,0,0,0
1653602654589,ECE 284,B00,091096,Wang; Edward Jay,0,0,0,0
1653602655119,ECE 285,A00,094334,Touri; Behrouz,0,0,0,0
1653602655647,ECE 289,A00,091097,Whelan; David Arthur,0,0,0,0
1653602656170,MATH 200A,A00,087414,Salehi Golsefidy; Alireza,7,0,8,1
1653602656699,MATH 202A,A00,087415,Gill; Philip E.,2,0,8,6
1653602657224,MATH 203A,A00,087416,Oprea; Dragos N.,6,0,8,2
1653602657749,MATH 204A,A00,087417,Kedlaya; Kiran S.,6,0,8,2
1653602658278,MATH 205,A00,087418,Sorensen; Claus M,6,0,8,2
1653602658817,MATH 206A,A00,087419,Izadi; Elham,7,0,8,1
1653602659341,MATH 207A,A00,087420,Mohammadi; Amir,5,0,8,3
1653602659876,MATH 208,A00,087421,Staff,9,0,10,1
1653602660423,MATH 209,A00,087422,Staff,10,0,10,0
1653602660950,MATH 218,A00,087423,Staff,10,0,10,0
1653602661473,MATH 220A,A00,087424,Novak; Jonathan I,6,0,8,2
1653602662001,MATH 231A,A00,087425,Bejenaru; Ioan,3,0,8,5
1653602662528,MATH 240A,A00,087426,Ebenfelt; Peter F,5,0,8,3
1653602663050,MATH 243,A00,087427,Staff,9,0,10,1
1653602663586,MATH 248,A00,087429,Staff,10,0,10,0
1653602664111,MATH 250A,A00,087430,Spolaor; Luca,4,0,8,4
1653602664638,MATH 257A,A00,087431,Spolaor; Luca,7,0,8,1
1653602665160,MATH 258,A00,087432,Staff,9,0,10,1
1653602665700,MATH 264A,A00,087433,Warnke; Lutz Peter,5,0,8,3
1653602666223,MATH 268,A00,087434,Staff,15,0,15,0
1653602666745,MATH 269,A00,087435,Staff,14,0,15,1
1653602667283,MATH 270A,A00,087436,Nie; Jiawang,0,0,8,8
1653602667816,MATH 272A,A00,087437,Tian; Xiaochuan,0,0,8,8
1653602668351,MATH 274,A01,087439,Cheng; Li-Tien,9,0,10,1
1653602668351,MATH 274,A02,087440,Cheng; Li-Tien,10,0,10,0
1653602668881,MATH 278A,A00,087441,Staff,8,0,10,2
1653602669407,MATH 278B,A00,087442,Staff,8,0,10,2
1653602669940,MATH 278C,A00,087443,Staff,8,0,10,2
1653602670463,MATH 280A,A00,087444,Zheng; Tianyi,0,0,8,8
1653602670996,MATH 281A,A00,087445,Bradic; Jelena,0,0,8,8
1653602671522,MATH 282A,A00,087446,Zhang; Danna,0,0,8,8
1653602672045,MATH 283,A00,087447,Tesler; Glenn,0,0,0,16
1653602672568,MATH 286,B00,095535,Kemp; Todd Aahron,7,0,8,1
1653602673090,MATH 287D,B00,095536,Bradic; Jelena,5,0,8,3
1653602673613,MATH 288,A00,087450,Staff,14,0,15,1
1653602673613,MATH 288,B00,087451,Staff,15,0,15,0
1653602673613,MATH 288,C00,087452,Staff,15,0,15,0
1653602674139,MATH 290A,A00,087453,Xu; Zhouli,6,0,8,2
1653602674666,MATH 291A,A00,087454,Xu; Zhouli,7,0,8,1
1653602675198,MATH 292,A00,087455,Staff,10,0,10,0
1653602675720,MATH 295,A00,087456,Staff,50,0,50,0
1653602676245,MATH 297,001,087457,Staff,997,0,999,2
1653603237226,COGS 200,A01,087991,Staff,47,0,50,3
1653603237752,COGS 201,A01,094504,Rangel; Lara M,16,0,25,9
1653603238275,COGS 203,A00,087992,Coulson; Seana M,18,0,20,2
1653603238811,COGS 210A,001,087993,Greene; Deanna Jacquelyn,9998,0,9999,1
1653603238811,COGS 210A,002,087994,Saygin; Ayse P,9999,0,9999,0
1653603238811,COGS 210A,003,087995,Xia; Haijun,9999,0,9999,0
1653603238811,COGS 210A,004,087996,Nitz; Douglas A.,9999,0,9999,0
1653603238811,COGS 210A,005,087997,Hollan; James D.,9999,0,9999,0
1653603238811,COGS 210A,006,087998,Deak; Gedeon O.,9998,0,9999,1
1653603238811,COGS 210A,007,087999,Rossano; Federico,9999,0,9999,0
1653603239347,COGS 211A,A00,088000,Coulson; Seana M,9997,0,9999,2
1653603239872,COGS 229,A00,088002,Staff,22,0,25,3
1653603240394,COGS 260,B00,094231,Staff,17,0,20,3
1653603240394,COGS 260,A00,088004,Nitz; Douglas A.,9998,0,9999,1
1653603240939,CSE 202,A00,090110,Paturi; Ramamohan,0,0,0,0
1653603240939,CSE 202,B00,090111,Paturi; Ramamohan,0,0,0,0
1653603241460,CSE 207B,A00,090112,Heninger; Nadia A,0,0,0,0
1653603241984,CSE 208,A00,094858,Micciancio; Daniele,0,0,0,0
1653603242509,CSE 210,A00,090113,Powell; Thomas Allan,0,0,0,0
1653603243037,CSE 219,A00,090898,Staff,0,0,0,0
1653603243575,CSE 221,A00,090114,Zhou; Yuan-Yuan,0,0,0,0
1653603244101,CSE 229A,A00,090115,Porter; George M,0,0,0,0
1653603244626,CSE 229C,A00,090116,Savage; Stefan,0,0,0,0
1653603245157,CSE 230,A00,090117,Jhala; Ranjit,0,0,0,0
1653603245686,CSE 232,A00,090118,Papakonstantinou; Yannis,0,0,0,0
1653603246214,CSE 239A,A00,090121,Kumar; Arun Kumar,0,0,0,0
1653603246743,CSE 239B,A00,090122,Jhala; Ranjit,0,0,0,0
1653603247281,CSE 240A,A00,090123,Zhao; Jishen,0,0,189,189
1653603247804,CSE 243A,A00,090124,Orailoglu; Alex,0,0,15,15
1653603248328,CSE 249B,A00,090125,Kahng; Andrew Byun,12,0,20,8
1653603248858,CSE 250A,A00,090126,Berg-Kirkpatrick; Taylor D,0,0,0,0
1653603249390,CSE 252A,A00,090127,Ochoa; Benjamin Lawrence,0,0,0,0
1653603249919,CSE 258,A01,090129,McAuley; Julian John,0,0,0,0
1653603250457,CSE 258R,A01,090131,McAuley; Julian John,0,0,0,0
1653603250992,CSE 274,A00,090132,Ramamoorthi; Ravi,0,0,0,0
1653603251514,CSE 276A,A00,090133,Christensen; Henrik I,0,0,0,0
1653603252039,CSE 276C,A00,090134,Christensen; Henrik I,0,0,0,0
1653603252565,CSE 290,A00,090135,Bafna; Vineet,0,0,0,0
1653603252565,CSE 290,B00,090136,Ramamoorthi; Ravi,0,0,0,0
1653603252565,CSE 290,C00,090137,Li; Tzumao,7,0,10,3
1653603252565,CSE 290,D00,090138,Zhou; Yuan-Yuan,9,0,10,1
1653603252565,CSE 290,E00,090139,Christensen; Henrik I,8,0,10,2
1653603252565,CSE 290,F00,094053,Shalev; Aaron D,0,0,0,0
1653603253095,CSE 291,A00,090140,Munyaka; Imani N. S.,0,0,0,0
1653603253095,CSE 291,B00,094880,Yu; Qi,0,0,0,0
1653603253095,CSE 291,C00,090142,Pannuto; Patrick William,0,0,0,0
1653603253095,CSE 291,D00,094881,Zhang; Yiying,0,0,0,0
1653603253095,CSE 291,E00,095118,Su; Hao,0,0,0,0
1653603253624,CSE 293,001,094905,Bafna; Vineet,9999,0,9999,0
1653603253624,CSE 293,002,094906,Bellare; Mihir,9999,0,9999,0
1653603253624,CSE 293,003,094907,Berg-Kirkpatrick; Taylor D,9999,0,9999,0
1653603253624,CSE 293,004,094908,Christensen; Henrik I,9999,0,9999,0
1653603253624,CSE 293,005,094909,Cottrell; Garrison W,9999,0,9999,0
1653603253624,CSE 293,006,094910,Deutsch; Alin Bernard,9999,0,9999,0
1653603253624,CSE 293,007,094911,Esmaeilzadeh; Hadi,9999,0,9999,0
1653603253624,CSE 293,008,094912,Freund; Yoav,9999,0,9999,0
1653603253624,CSE 293,009,094913,Griswold; William G.,9999,0,9999,0
1653603253624,CSE 293,010,094914,Gymrek; Melissa Ann,9999,0,9999,0
1653603253624,CSE 293,011,094915,Heninger; Nadia A,9999,0,9999,0
1653603253624,CSE 293,012,094916,Impagliazzo; Russell,9999,0,9999,0
1653603253624,CSE 293,013,094917,Jhala; Ranjit,9999,0,9999,0
1653603253624,CSE 293,014,094918,Kahng; Andrew Byun,9999,0,9999,0
1653603253624,CSE 293,015,094919,Kane; Daniel Mertz,9999,0,9999,0
1653603253624,CSE 293,016,094920,Kriegman; David J,9999,0,9999,0
1653603253624,CSE 293,017,094921,Kumar; Arun Kumar,9999,0,9999,0
1653603253624,CSE 293,018,094922,Lerner; Sorin,9999,0,9999,0
1653603253624,CSE 293,019,094923,Lovett; Shachar,9999,0,9999,0
1653603253624,CSE 293,020,094924,McAuley; Julian John,9999,0,9999,0
1653603253624,CSE 293,021,094925,Micciancio; Daniele,9999,0,9999,0
1653603253624,CSE 293,022,094926,Orailoglu; Alex,9999,0,9999,0
1653603253624,CSE 293,023,094927,Paturi; Ramamohan,9999,0,9999,0
1653603253624,CSE 293,024,094928,Polikarpova; Nadezhda,9999,0,9999,0
1653603253624,CSE 293,025,094929,Politz; Joseph Gibbs,9999,0,9999,0
1653603253624,CSE 293,026,094930,Porter; George M,9999,0,9999,0
1653603253624,CSE 293,027,094931,Porter; Leonard Emerson,9999,0,9999,0
1653603253624,CSE 293,028,094932,Ramamoorthi; Ravi,9999,0,9999,0
1653603253624,CSE 293,029,094933,Sahoo; Debashis,9999,0,9999,0
1653603253624,CSE 293,030,094934,Saul; Lawrence,9999,0,9999,0
1653603253624,CSE 293,031,094935,Savage; Stefan,9999,0,9999,0
1653603253624,CSE 293,032,094936,Schulze; Jurgen P.,9999,0,9999,0
1653603253624,CSE 293,033,094937,Snoeren; Alex C.,9999,0,9999,0
1653603253624,CSE 293,034,094938,Shang; Jingbo,9999,0,9999,0
1653603253624,CSE 293,035,094939,Stefan; Deian,9999,0,9999,0
1653603253624,CSE 293,036,094940,Su; Hao,9999,0,9999,0
1653603253624,CSE 293,037,094941,Swanson; Steven James,9999,0,9999,0
1653603253624,CSE 293,038,094942,Tullsen; Dean Michael,9999,0,9999,0
1653603253624,CSE 293,039,094943,Voelker; Geoffrey M.,9999,0,9999,0
1653603253624,CSE 293,040,094944,Zhao; Jishen,9999,0,9999,0
1653603253624,CSE 293,041,094945,Zhou; Yuan-Yuan,9999,0,9999,0
1653603253624,CSE 293,042,094946,Gao; Sicun,9998,0,9999,1
1653603253624,CSE 293,043,094947,Weibel; Nadir,9999,0,9999,0
1653603253624,CSE 293,044,094948,Gupta; Rajesh K.,9999,0,9999,0
1653603254147,CSE 294,A00,090143,Porter; George M,8,0,10,2
1653603254669,DSE 200,A00,091799,Staff,50,0,50,0
1653603255192,DSE 203,A00,091800,Gupta; Amarnath,30,0,30,0
1653603255727,DSE 250,A00,091801,Deutsch; Alin Bernard,30,0,30,0
1653603256249,DSE 290,A00,091802,Altintas De Callaf; Ilkay,50,0,50,0
1653603256791,ECE 200,001,091003,Antipa; Nicholas A,9999,0,9999,0
1653603256791,ECE 200,002,091004,Atanasov; Nikolay A.,9999,0,9999,0
1653603256791,ECE 200,003,091005,Bharadia; Dinesh,9999,0,9999,0
1653603256791,ECE 200,004,091006,Cheng; Chung Kuan,9999,0,9999,0
1653603256791,ECE 200,005,091007,Cosman; Pamela C.,9999,0,9999,0
1653603256791,ECE 200,006,091008,Staff,9999,0,9999,0
1653603256791,ECE 200,007,091009,Dayeh; Shadi Ahmad,9999,0,9999,0
1653603256791,ECE 200,008,091010,Fainman; Yeshaiahu,9999,0,9999,0
1653603256791,ECE 200,009,091011,Ford; Joseph Earl,9999,0,9999,0
1653603256791,ECE 200,010,091012,Franceschetti; Massimo,9999,0,9999,0
1653603256791,ECE 200,011,091013,Fullerton; Eric E,9999,0,9999,0
1653603256791,ECE 200,012,091014,Galton; Ian A,9999,0,9999,0
1653603256791,ECE 200,013,091015,Gilja; Vikash,9999,0,9999,0
1653603256791,ECE 200,014,091016,Hall; Drew A.,9999,0,9999,0
1653603256791,ECE 200,015,091017,Hsueh; Tzu-Chien,9999,0,9999,0
1653603256791,ECE 200,016,091018,Javidi; Tara,9999,0,9999,0
1653603256791,ECE 200,017,091019,Kahng; Andrew Byun,9999,0,9999,0
1653603256791,ECE 200,018,091020,Kim; Young-Han,9999,0,9999,0
1653603256791,ECE 200,019,091021,Koushanfar; Farinaz,9999,0,9999,0
1653603256791,ECE 200,020,091022,Kuzum; Duygu,9999,0,9999,0
1653603256791,ECE 200,021,091023,Le; Hanh-Phuc,9999,0,9999,0
1653603256791,ECE 200,022,091024,Lin; Bill,9999,0,9999,0
1653603256791,ECE 200,023,091025,Liu; Zhaowei,9999,0,9999,0
1653603256791,ECE 200,024,091026,Lo; Yu-Hwa,9999,0,9999,0
1653603256791,ECE 200,025,091027,Lomakin; Vitaliy,9999,0,9999,0
1653603256791,ECE 200,026,091028,Mercier; Patrick Philip,9999,0,9999,0
1653603256791,ECE 200,027,091029,Meyer; Florian,9999,0,9999,0
1653603256791,ECE 200,028,091030,Milstein; Laurence B.,9999,0,9999,0
1653603256791,ECE 200,029,091031,Mir Arabbaygi; Siavash,9999,0,9999,0
1653603256791,ECE 200,030,091032,Mookherjea; Shayan,9999,0,9999,0
1653603256791,ECE 200,031,091033,Morris; Karcher William,9999,0,9999,0
1653603256791,ECE 200,032,091034,Ng; Tse Nga,9999,0,9999,0
1653603256791,ECE 200,033,091035,Nguyen; Truong Quang,9999,0,9999,0
1653603256791,ECE 200,034,091036,Nomura; Kenji,9999,0,9999,0
1653603256791,ECE 200,035,091037,Orlitsky; Alon,9999,0,9999,0
1653603256791,ECE 200,036,091038,Pal; Piya,9999,0,9999,0
1653603256791,ECE 200,037,091039,Papen; George C.,9999,0,9999,0
1653603256791,ECE 200,038,091040,Radic; Stojan,9999,0,9999,0
1653603256791,ECE 200,039,091041,Rao; Bhaskar D.,9999,0,9999,0
1653603256791,ECE 200,040,091042,Rao; Ramesh R,9999,0,9999,0
1653603256791,ECE 200,041,091043,Rebeiz; Gabriel,9999,0,9999,0
1653603256791,ECE 200,042,091044,Sanford; John R,9999,0,9999,0
1653603256791,ECE 200,043,091045,Siegel; Paul H.,9999,0,9999,0
1653603256791,ECE 200,044,091046,Sievenpiper; Daniel F.,9999,0,9999,0
1653603256791,ECE 200,045,091047,Sworder; David D.,9999,0,9999,0
1653603256791,ECE 200,046,091048,Taur; Yuan,9999,0,9999,0
1653603256791,ECE 200,047,091049,Touri; Behrouz,9999,0,9999,0
1653603256791,ECE 200,048,091050,Trivedi; Mohan M.,9999,0,9999,0
1653603256791,ECE 200,049,091051,Vardy; Alexander,9999,0,9999,0
1653603256791,ECE 200,050,091052,Vasconcelos; Nuno,9999,0,9999,0
1653603256791,ECE 200,051,091053,Wang; Xiaolong,9999,0,9999,0
1653603256791,ECE 200,052,091054,Xie; Pengtao,9999,0,9999,0
1653603256791,ECE 200,053,091055,Yip; Michael,9999,0,9999,0
1653603256791,ECE 200,054,091056,Zeger; Kenneth A.,9999,0,9999,0
1653603256791,ECE 200,055,091057,Zhang; Xinyu,9999,0,9999,0
1653603256791,ECE 200,056,091058,Turakhia; Yatish Girish,9999,0,9999,0
1653603256791,ECE 200,057,091059,Kang; Mingu,9999,0,9999,0
1653603256791,ECE 200,058,091060,Shi; Yuanyuan,9999,0,9999,0
1653603256791,ECE 200,059,091061,Wang; Edward Jay,9999,0,9999,0
1653603256791,ECE 200,060,091062,Zheng; Yang,9999,0,9999,0
1653603257317,ECE 201,A00,095526,Lo; Yu-Hwa,0,0,0,0
1653603257844,ECE 203,A00,091065,Mercier; Patrick Philip,0,0,0,0
1653603258370,ECE 207A,A00,091605,Liu; Thomas Tao-Ming,0,0,0,0
1653603258892,ECE 212AN,A00,091068,Nomura; Kenji,0,0,0,0
1653603259424,ECE 222A,A00,091069,Rebeiz; Gabriel,0,0,0,0
1653603259947,ECE 225A,A00,091070,Orlitsky; Alon,0,0,0,0
1653603260475,ECE 230A,A00,091071,Nomura; Kenji,0,0,0,0
1653603261003,ECE 236A,A00,091072,Dayeh; Shadi Ahmad,0,0,0,0
1653603261532,ECE 238A,A00,091073,Luo; Jian,0,0,0,0
1653603261532,ECE 238A,B00,091074,Luo; Jian,0,0,0,0
1653603262070,ECE 240A,A00,091075,Radic; Stojan,0,0,0,0
1653603262594,ECE 247A,A00,091592,Shi; Lingyan,0,0,0,0
1653603263116,ECE 250,A00,091076,Touri; Behrouz,0,0,0,0
1653603263650,ECE 251C,A00,091078,Nguyen; Truong Quang,0,0,0,0
1653603264174,ECE 253,A00,091079,Cosman; Pamela C.,0,0,0,0
1653603264703,ECE 255A,A00,091080,Orlitsky; Alon,0,0,0,0
1653603265233,ECE 257A,A00,091081,Zhang; Xinyu,0,0,0,0
1653603265760,ECE 260A,A01,091084,Eldon; John,0,0,0,0
1653603266283,ECE 264C,A00,091085,Galton; Ian A,0,0,0,0
1653603266806,ECE 265C,A00,094889,Presti; Calogero Davide,0,0,0,9
1653603267333,ECE 266,A01,091087,Hall; Drew A.,0,0,0,0
1653603268383,ECE 271A,A00,091090,Vasconcelos; Nuno,0,0,0,0
1653603268906,ECE 272B,A00,091091,Sworder; David D.,0,0,0,0
1653603269435,ECE 275A,A00,091092,Meyer; Florian,0,0,0,0
1653603269967,ECE 277,A00,091093,An; Cheolhong,0,0,0,0
1653603270492,ECE 283,A00,091094,Le; Hanh-Phuc,0,0,0,0
1653603271018,ECE 284,A00,091095,Kang; Mingu,0,0,0,0
1653603271018,ECE 284,B00,091096,Wang; Edward Jay,0,0,0,0
1653603271561,ECE 285,A00,094334,Touri; Behrouz,0,0,0,0
1653603272085,ECE 289,A00,091097,Whelan; David Arthur,0,0,0,0
1653603272611,MATH 200A,A00,087414,Salehi Golsefidy; Alireza,7,0,8,1
1653603273146,MATH 202A,A00,087415,Gill; Philip E.,2,0,8,6
1653603273672,MATH 203A,A00,087416,Oprea; Dragos N.,6,0,8,2
1653603274194,MATH 204A,A00,087417,Kedlaya; Kiran S.,6,0,8,2
1653603274722,MATH 205,A00,087418,Sorensen; Claus M,6,0,8,2
1653603275248,MATH 206A,A00,087419,Izadi; Elham,7,0,8,1
1653603275774,MATH 207A,A00,087420,Mohammadi; Amir,5,0,8,3
1653603276297,MATH 208,A00,087421,Staff,9,0,10,1
1653603276825,MATH 209,A00,087422,Staff,10,0,10,0
1653603277347,MATH 218,A00,087423,Staff,10,0,10,0
1653603277876,MATH 220A,A00,087424,Novak; Jonathan I,6,0,8,2
1653603278405,MATH 231A,A00,087425,Bejenaru; Ioan,3,0,8,5
1653603278937,MATH 240A,A00,087426,Ebenfelt; Peter F,5,0,8,3
1653603279468,MATH 243,A00,087427,Staff,9,0,10,1
1653603279994,MATH 248,A00,087429,Staff,10,0,10,0
1653603280517,MATH 250A,A00,087430,Spolaor; Luca,4,0,8,4
1653603281043,MATH 257A,A00,087431,Spolaor; Luca,7,0,8,1
1653603281566,MATH 258,A00,087432,Staff,9,0,10,1
1653603282089,MATH 264A,A00,087433,Warnke; Lutz Peter,5,0,8,3
1653603282613,MATH 268,A00,087434,Staff,15,0,15,0
1653603283140,MATH 269,A00,087435,Staff,14,0,15,1
1653603283672,MATH 270A,A00,087436,Nie; Jiawang,0,0,8,8
1653603284215,MATH 272A,A00,087437,Tian; Xiaochuan,0,0,8,8
1653603284741,MATH 274,A01,087439,Cheng; Li-Tien,9,0,10,1
1653603284741,MATH 274,A02,087440,Cheng; Li-Tien,10,0,10,0
1653603285265,MATH 278A,A00,087441,Staff,8,0,10,2
1653603285787,MATH 278B,A00,087442,Staff,8,0,10,2
1653603286313,MATH 278C,A00,087443,Staff,8,0,10,2
1653603286836,MATH 280A,A00,087444,Zheng; Tianyi,0,0,8,8
1653603287365,MATH 281A,A00,087445,Bradic; Jelena,0,0,8,8
1653603287903,MATH 282A,A00,087446,Zhang; Danna,0,0,8,8
1653603288511,MATH 283,A00,087447,Tesler; Glenn,0,0,0,16
1653603289032,MATH 286,B00,095535,Kemp; Todd Aahron,7,0,8,1
1653603289557,MATH 287D,B00,095536,Bradic; Jelena,5,0,8,3
1653603290079,MATH 288,A00,087450,Staff,14,0,15,1
1653603290079,MATH 288,B00,087451,Staff,15,0,15,0
1653603290079,MATH 288,C00,087452,Staff,15,0,15,0
1653603290608,MATH 290A,A00,087453,Xu; Zhouli,6,0,8,2
1653603291134,MATH 291A,A00,087454,Xu; Zhouli,7,0,8,1
1653603291659,MATH 292,A00,087455,Staff,10,0,10,0
1653603292192,MATH 295,A00,087456,Staff,50,0,50,0
1653603292716,MATH 297,001,087457,Staff,997,0,999,2
1653603853245,COGS 200,A01,087991,Staff,47,0,50,3
1653603853768,COGS 201,A01,094504,Rangel; Lara M,16,0,25,9
1653603854292,COGS 203,A00,087992,Coulson; Seana M,18,0,20,2
1653603854816,COGS 210A,001,087993,Greene; Deanna Jacquelyn,9998,0,9999,1
1653603854816,COGS 210A,002,087994,Saygin; Ayse P,9999,0,9999,0
1653603854816,COGS 210A,003,087995,Xia; Haijun,9999,0,9999,0
1653603854816,COGS 210A,004,087996,Nitz; Douglas A.,9999,0,9999,0
1653603854816,COGS 210A,005,087997,Hollan; James D.,9999,0,9999,0
1653603854816,COGS 210A,006,087998,Deak; Gedeon O.,9998,0,9999,1
1653603854816,COGS 210A,007,087999,Rossano; Federico,9999,0,9999,0
1653603855350,COGS 211A,A00,088000,Coulson; Seana M,9997,0,9999,2
1653603855873,COGS 229,A00,088002,Staff,22,0,25,3
1653603856405,COGS 260,B00,094231,Staff,17,0,20,3
1653603856405,COGS 260,A00,088004,Nitz; Douglas A.,9998,0,9999,1
1653603856937,CSE 202,A00,090110,Paturi; Ramamohan,0,0,0,0
1653603856937,CSE 202,B00,090111,Paturi; Ramamohan,0,0,0,0
1653603857462,CSE 207B,A00,090112,Heninger; Nadia A,0,0,0,0
1653603857984,CSE 208,A00,094858,Micciancio; Daniele,0,0,0,0
1653603858511,CSE 210,A00,090113,Powell; Thomas Allan,0,0,0,0
1653603859033,CSE 219,A00,090898,Staff,0,0,0,0
1653603859556,CSE 221,A00,090114,Zhou; Yuan-Yuan,0,0,0,0
1653603860092,CSE 229A,A00,090115,Porter; George M,0,0,0,0
1653603860616,CSE 229C,A00,090116,Savage; Stefan,0,0,0,0
1653603861148,CSE 230,A00,090117,Jhala; Ranjit,0,0,0,0
1653603861674,CSE 232,A00,090118,Papakonstantinou; Yannis,0,0,0,0
1653603862197,CSE 239A,A00,090121,Kumar; Arun Kumar,0,0,0,0
1653603862725,CSE 239B,A00,090122,Jhala; Ranjit,0,0,0,0
1653603863250,CSE 240A,A00,090123,Zhao; Jishen,0,0,189,189
1653603863784,CSE 243A,A00,090124,Orailoglu; Alex,0,0,15,15
1653603864309,CSE 249B,A00,090125,Kahng; Andrew Byun,12,0,20,8
1653603864841,CSE 250A,A00,090126,Berg-Kirkpatrick; Taylor D,0,0,0,0
1653603865366,CSE 252A,A00,090127,Ochoa; Benjamin Lawrence,0,0,0,0
1653603865900,CSE 258,A01,090129,McAuley; Julian John,0,0,0,0
1653603866425,CSE 258R,A01,090131,McAuley; Julian John,0,0,0,0
1653603866950,CSE 274,A00,090132,Ramamoorthi; Ravi,0,0,0,0
1653603867474,CSE 276A,A00,090133,Christensen; Henrik I,0,0,0,0
1653603867997,CSE 276C,A00,090134,Christensen; Henrik I,0,0,0,0
1653603868525,CSE 290,A00,090135,Bafna; Vineet,0,0,0,0
1653603868525,CSE 290,B00,090136,Ramamoorthi; Ravi,0,0,0,0
1653603868525,CSE 290,C00,090137,Li; Tzumao,7,0,10,3
1653603868525,CSE 290,D00,090138,Zhou; Yuan-Yuan,9,0,10,1
1653603868525,CSE 290,E00,090139,Christensen; Henrik I,8,0,10,2
1653603868525,CSE 290,F00,094053,Shalev; Aaron D,0,0,0,0
1653603869055,CSE 291,A00,090140,Munyaka; Imani N. S.,0,0,0,0
1653603869055,CSE 291,B00,094880,Yu; Qi,0,0,0,0
1653603869055,CSE 291,C00,090142,Pannuto; Patrick William,0,0,0,0
1653603869055,CSE 291,D00,094881,Zhang; Yiying,0,0,0,0
1653603869055,CSE 291,E00,095118,Su; Hao,0,0,0,0
1653603869582,CSE 293,001,094905,Bafna; Vineet,9999,0,9999,0
1653603869582,CSE 293,002,094906,Bellare; Mihir,9999,0,9999,0
1653603869582,CSE 293,003,094907,Berg-Kirkpatrick; Taylor D,9999,0,9999,0
1653603869582,CSE 293,004,094908,Christensen; Henrik I,9999,0,9999,0
1653603869582,CSE 293,005,094909,Cottrell; Garrison W,9999,0,9999,0
1653603869582,CSE 293,006,094910,Deutsch; Alin Bernard,9999,0,9999,0
1653603869582,CSE 293,007,094911,Esmaeilzadeh; Hadi,9999,0,9999,0
1653603869582,CSE 293,008,094912,Freund; Yoav,9999,0,9999,0
1653603869582,CSE 293,009,094913,Griswold; William G.,9999,0,9999,0
1653603869582,CSE 293,010,094914,Gymrek; Melissa Ann,9999,0,9999,0
1653603869582,CSE 293,011,094915,Heninger; Nadia A,9999,0,9999,0
1653603869582,CSE 293,012,094916,Impagliazzo; Russell,9999,0,9999,0
1653603869582,CSE 293,013,094917,Jhala; Ranjit,9999,0,9999,0
1653603869582,CSE 293,014,094918,Kahng; Andrew Byun,9999,0,9999,0
1653603869582,CSE 293,015,094919,Kane; Daniel Mertz,9999,0,9999,0
1653603869582,CSE 293,016,094920,Kriegman; David J,9999,0,9999,0
1653603869582,CSE 293,017,094921,Kumar; Arun Kumar,9999,0,9999,0
1653603869582,CSE 293,018,094922,Lerner; Sorin,9999,0,9999,0
1653603869582,CSE 293,019,094923,Lovett; Shachar,9999,0,9999,0
1653603869582,CSE 293,020,094924,McAuley; Julian John,9999,0,9999,0
1653603869582,CSE 293,021,094925,Micciancio; Daniele,9999,0,9999,0
1653603869582,CSE 293,022,094926,Orailoglu; Alex,9999,0,9999,0
1653603869582,CSE 293,023,094927,Paturi; Ramamohan,9999,0,9999,0
1653603869582,CSE 293,024,094928,Polikarpova; Nadezhda,9999,0,9999,0
1653603869582,CSE 293,025,094929,Politz; Joseph Gibbs,9999,0,9999,0
1653603869582,CSE 293,026,094930,Porter; George M,9999,0,9999,0
1653603869582,CSE 293,027,094931,Porter; Leonard Emerson,9999,0,9999,0
1653603869582,CSE 293,028,094932,Ramamoorthi; Ravi,9999,0,9999,0
1653603869582,CSE 293,029,094933,Sahoo; Debashis,9999,0,9999,0
1653603869582,CSE 293,030,094934,Saul; Lawrence,9999,0,9999,0
1653603869582,CSE 293,031,094935,Savage; Stefan,9999,0,9999,0
1653603869582,CSE 293,032,094936,Schulze; Jurgen P.,9999,0,9999,0
1653603869582,CSE 293,033,094937,Snoeren; Alex C.,9999,0,9999,0
1653603869582,CSE 293,034,094938,Shang; Jingbo,9999,0,9999,0
1653603869582,CSE 293,035,094939,Stefan; Deian,9999,0,9999,0
1653603869582,CSE 293,036,094940,Su; Hao,9999,0,9999,0
1653603869582,CSE 293,037,094941,Swanson; Steven James,9999,0,9999,0
1653603869582,CSE 293,038,094942,Tullsen; Dean Michael,9999,0,9999,0
1653603869582,CSE 293,039,094943,Voelker; Geoffrey M.,9999,0,9999,0
1653603869582,CSE 293,040,094944,Zhao; Jishen,9999,0,9999,0
1653603869582,CSE 293,041,094945,Zhou; Yuan-Yuan,9999,0,9999,0
1653603869582,CSE 293,042,094946,Gao; Sicun,9998,0,9999,1
1653603869582,CSE 293,043,094947,Weibel; Nadir,9999,0,9999,0
1653603869582,CSE 293,044,094948,Gupta; Rajesh K.,9999,0,9999,0
1653603870126,CSE 294,A00,090143,Porter; George M,8,0,10,2
1653603870652,DSE 200,A00,091799,Staff,50,0,50,0
1653603871187,DSE 203,A00,091800,Gupta; Amarnath,30,0,30,0
1653603871713,DSE 250,A00,091801,Deutsch; Alin Bernard,30,0,30,0
1653603872242,DSE 290,A00,091802,Altintas De Callaf; Ilkay,50,0,50,0
1653603872774,ECE 200,001,091003,Antipa; Nicholas A,9999,0,9999,0
1653603872774,ECE 200,002,091004,Atanasov; Nikolay A.,9999,0,9999,0
1653603872774,ECE 200,003,091005,Bharadia; Dinesh,9999,0,9999,0
1653603872774,ECE 200,004,091006,Cheng; Chung Kuan,9999,0,9999,0
1653603872774,ECE 200,005,091007,Cosman; Pamela C.,9999,0,9999,0
1653603872774,ECE 200,006,091008,Staff,9999,0,9999,0
1653603872774,ECE 200,007,091009,Dayeh; Shadi Ahmad,9999,0,9999,0
1653603872774,ECE 200,008,091010,Fainman; Yeshaiahu,9999,0,9999,0
1653603872774,ECE 200,009,091011,Ford; Joseph Earl,9999,0,9999,0
1653603872774,ECE 200,010,091012,Franceschetti; Massimo,9999,0,9999,0
1653603872774,ECE 200,011,091013,Fullerton; Eric E,9999,0,9999,0
1653603872774,ECE 200,012,091014,Galton; Ian A,9999,0,9999,0
1653603872774,ECE 200,013,091015,Gilja; Vikash,9999,0,9999,0
1653603872774,ECE 200,014,091016,Hall; Drew A.,9999,0,9999,0
1653603872774,ECE 200,015,091017,Hsueh; Tzu-Chien,9999,0,9999,0
1653603872774,ECE 200,016,091018,Javidi; Tara,9999,0,9999,0
1653603872774,ECE 200,017,091019,Kahng; Andrew Byun,9999,0,9999,0
1653603872774,ECE 200,018,091020,Kim; Young-Han,9999,0,9999,0
1653603872774,ECE 200,019,091021,Koushanfar; Farinaz,9999,0,9999,0
1653603872774,ECE 200,020,091022,Kuzum; Duygu,9999,0,9999,0
1653603872774,ECE 200,021,091023,Le; Hanh-Phuc,9999,0,9999,0
1653603872774,ECE 200,022,091024,Lin; Bill,9999,0,9999,0
1653603872774,ECE 200,023,091025,Liu; Zhaowei,9999,0,9999,0
1653603872774,ECE 200,024,091026,Lo; Yu-Hwa,9999,0,9999,0
1653603872774,ECE 200,025,091027,Lomakin; Vitaliy,9999,0,9999,0
1653603872774,ECE 200,026,091028,Mercier; Patrick Philip,9999,0,9999,0
1653603872774,ECE 200,027,091029,Meyer; Florian,9999,0,9999,0
1653603872774,ECE 200,028,091030,Milstein; Laurence B.,9999,0,9999,0
1653603872774,ECE 200,029,091031,Mir Arabbaygi; Siavash,9999,0,9999,0
1653603872774,ECE 200,030,091032,Mookherjea; Shayan,9999,0,9999,0
1653603872774,ECE 200,031,091033,Morris; Karcher William,9999,0,9999,0
1653603872774,ECE 200,032,091034,Ng; Tse Nga,9999,0,9999,0
1653603872774,ECE 200,033,091035,Nguyen; Truong Quang,9999,0,9999,0
1653603872774,ECE 200,034,091036,Nomura; Kenji,9999,0,9999,0
1653603872774,ECE 200,035,091037,Orlitsky; Alon,9999,0,9999,0
1653603872774,ECE 200,036,091038,Pal; Piya,9999,0,9999,0
1653603872774,ECE 200,037,091039,Papen; George C.,9999,0,9999,0
1653603872774,ECE 200,038,091040,Radic; Stojan,9999,0,9999,0
1653603872774,ECE 200,039,091041,Rao; Bhaskar D.,9999,0,9999,0
1653603872774,ECE 200,040,091042,Rao; Ramesh R,9999,0,9999,0
1653603872774,ECE 200,041,091043,Rebeiz; Gabriel,9999,0,9999,0
1653603872774,ECE 200,042,091044,Sanford; John R,9999,0,9999,0
1653603872774,ECE 200,043,091045,Siegel; Paul H.,9999,0,9999,0
1653603872774,ECE 200,044,091046,Sievenpiper; Daniel F.,9999,0,9999,0
1653603872774,ECE 200,045,091047,Sworder; David D.,9999,0,9999,0
1653603872774,ECE 200,046,091048,Taur; Yuan,9999,0,9999,0
1653603872774,ECE 200,047,091049,Touri; Behrouz,9999,0,9999,0
1653603872774,ECE 200,048,091050,Trivedi; Mohan M.,9999,0,9999,0
1653603872774,ECE 200,049,091051,Vardy; Alexander,9999,0,9999,0
1653603872774,ECE 200,050,091052,Vasconcelos; Nuno,9999,0,9999,0
1653603872774,ECE 200,051,091053,Wang; Xiaolong,9999,0,9999,0
1653603872774,ECE 200,052,091054,Xie; Pengtao,9999,0,9999,0
1653603872774,ECE 200,053,091055,Yip; Michael,9999,0,9999,0
1653603872774,ECE 200,054,091056,Zeger; Kenneth A.,9999,0,9999,0
1653603872774,ECE 200,055,091057,Zhang; Xinyu,9999,0,9999,0
1653603872774,ECE 200,056,091058,Turakhia; Yatish Girish,9999,0,9999,0
1653603872774,ECE 200,057,091059,Kang; Mingu,9999,0,9999,0
1653603872774,ECE 200,058,091060,Shi; Yuanyuan,9999,0,9999,0
1653603872774,ECE 200,059,091061,Wang; Edward Jay,9999,0,9999,0
1653603872774,ECE 200,060,091062,Zheng; Yang,9999,0,9999,0
1653603873299,ECE 201,A00,095526,Lo; Yu-Hwa,0,0,0,0
1653603873822,ECE 203,A00,091065,Mercier; Patrick Philip,0,0,0,0
1653603874358,ECE 207A,A00,091605,Liu; Thomas Tao-Ming,0,0,0,0
1653603874883,ECE 212AN,A00,091068,Nomura; Kenji,0,0,0,0
1653603875405,ECE 222A,A00,091069,Rebeiz; Gabriel,0,0,0,0
1653603875941,ECE 225A,A00,091070,Orlitsky; Alon,0,0,0,0
1653603876555,ECE 230A,A00,091071,Nomura; Kenji,0,0,0,0
1653603877078,ECE 236A,A00,091072,Dayeh; Shadi Ahmad,0,0,0,0
1653603877604,ECE 238A,A00,091073,Luo; Jian,0,0,0,0
1653603877604,ECE 238A,B00,091074,Luo; Jian,0,0,0,0
1653603878129,ECE 240A,A00,091075,Radic; Stojan,0,0,0,0
1653603878660,ECE 247A,A00,091592,Shi; Lingyan,0,0,0,0
1653603879185,ECE 250,A00,091076,Touri; Behrouz,0,0,0,0
1653603879708,ECE 251C,A00,091078,Nguyen; Truong Quang,0,0,0,0
1653603880230,ECE 253,A00,091079,Cosman; Pamela C.,0,0,0,0
1653603880757,ECE 255A,A00,091080,Orlitsky; Alon,0,0,0,0
1653603881280,ECE 257A,A00,091081,Zhang; Xinyu,0,0,0,0
1653603881802,ECE 260A,A01,091084,Eldon; John,0,0,0,0
1653603882325,ECE 264C,A00,091085,Galton; Ian A,0,0,0,0
1653603882851,ECE 265C,A00,094889,Presti; Calogero Davide,0,0,0,9
1653603883374,ECE 266,A01,091087,Hall; Drew A.,0,0,0,0
1653603884424,ECE 271A,A00,091090,Vasconcelos; Nuno,0,0,0,0
1653603884947,ECE 272B,A00,091091,Sworder; David D.,0,0,0,0
1653603885472,ECE 275A,A00,091092,Meyer; Florian,0,0,0,0
1653603885995,ECE 277,A00,091093,An; Cheolhong,0,0,0,0
1653603886517,ECE 283,A00,091094,Le; Hanh-Phuc,0,0,0,0
1653603887045,ECE 284,A00,091095,Kang; Mingu,0,0,0,0
1653603887045,ECE 284,B00,091096,Wang; Edward Jay,0,0,0,0
1653603887571,ECE 285,A00,094334,Touri; Behrouz,0,0,0,0
1653603888104,ECE 289,A00,091097,Whelan; David Arthur,0,0,0,0
1653603888628,MATH 200A,A00,087414,Salehi Golsefidy; Alireza,7,0,8,1
1653603889151,MATH 202A,A00,087415,Gill; Philip E.,2,0,8,6
1653603889682,MATH 203A,A00,087416,Oprea; Dragos N.,6,0,8,2
1653603890209,MATH 204A,A00,087417,Kedlaya; Kiran S.,6,0,8,2
1653603890732,MATH 205,A00,087418,Sorensen; Claus M,6,0,8,2
1653603891262,MATH 206A,A00,087419,Izadi; Elham,7,0,8,1
1653603891784,MATH 207A,A00,087420,Mohammadi; Amir,5,0,8,3
1653603892307,MATH 208,A00,087421,Staff,9,0,10,1
1653603892837,MATH 209,A00,087422,Staff,10,0,10,0
1653603893364,MATH 218,A00,087423,Staff,10,0,10,0
1653603893894,MATH 220A,A00,087424,Novak; Jonathan I,6,0,8,2
1653603894424,MATH 231A,A00,087425,Bejenaru; Ioan,3,0,8,5
1653603894948,MATH 240A,A00,087426,Ebenfelt; Peter F,5,0,8,3
1653603895473,MATH 243,A00,087427,Staff,9,0,10,1
1653603895999,MATH 248,A00,087429,Staff,10,0,10,0
1653603896522,MATH 250A,A00,087430,Spolaor; Luca,4,0,8,4
1653603897043,MATH 257A,A00,087431,Spolaor; Luca,7,0,8,1
1653603897568,MATH 258,A00,087432,Staff,9,0,10,1
1653603898090,MATH 264A,A00,087433,Warnke; Lutz Peter,5,0,8,3
1653603898614,MATH 268,A00,087434,Staff,15,0,15,0
1653603899149,MATH 269,A00,087435,Staff,14,0,15,1
1653603899671,MATH 270A,A00,087436,Nie; Jiawang,0,0,8,8
1653603900196,MATH 272A,A00,087437,Tian; Xiaochuan,0,0,8,8
1653603900724,MATH 274,A01,087439,Cheng; Li-Tien,9,0,10,1
1653603900724,MATH 274,A02,087440,Cheng; Li-Tien,10,0,10,0
1653603901254,MATH 278A,A00,087441,Staff,8,0,10,2
1653603901781,MATH 278B,A00,087442,Staff,8,0,10,2
1653603902304,MATH 278C,A00,087443,Staff,8,0,10,2
1653603902836,MATH 280A,A00,087444,Zheng; Tianyi,0,0,8,8
1653603903358,MATH 281A,A00,087445,Bradic; Jelena,0,0,8,8
1653603903881,MATH 282A,A00,087446,Zhang; Danna,0,0,8,8
1653603904403,MATH 283,A00,087447,Tesler; Glenn,0,0,0,16
1653603904930,MATH 286,B00,095535,Kemp; Todd Aahron,7,0,8,1
1653603905459,MATH 287D,B00,095536,Bradic; Jelena,5,0,8,3
1653603905982,MATH 288,A00,087450,Staff,14,0,15,1
1653603905982,MATH 288,B00,087451,Staff,15,0,15,0
1653603905982,MATH 288,C00,087452,Staff,15,0,15,0
1653603906504,MATH 290A,A00,087453,Xu; Zhouli,6,0,8,2
1653603907027,MATH 291A,A00,087454,Xu; Zhouli,7,0,8,1
1653603907553,MATH 292,A00,087455,Staff,10,0,10,0
1653603908081,MATH 295,A00,087456,Staff,50,0,50,0
1653603908623,MATH 297,001,087457,Staff,997,0,999,2
1653604469482,COGS 200,A01,087991,Staff,47,0,50,3
1653604470009,COGS 201,A01,094504,Rangel; Lara M,16,0,25,9
1653604470532,COGS 203,A00,087992,Coulson; Seana M,18,0,20,2
1653604471065,COGS 210A,001,087993,Greene; Deanna Jacquelyn,9998,0,9999,1
1653604471065,COGS 210A,002,087994,Saygin; Ayse P,9999,0,9999,0
1653604471065,COGS 210A,003,087995,Xia; Haijun,9999,0,9999,0
1653604471065,COGS 210A,004,087996,Nitz; Douglas A.,9999,0,9999,0
1653604471065,COGS 210A,005,087997,Hollan; James D.,9999,0,9999,0
1653604471065,COGS 210A,006,087998,Deak; Gedeon O.,9998,0,9999,1
1653604471065,COGS 210A,007,087999,Rossano; Federico,9999,0,9999,0
1653604471603,COGS 211A,A00,088000,Coulson; Seana M,9997,0,9999,2
1653604472133,COGS 229,A00,088002,Staff,22,0,25,3
1653604472660,COGS 260,B00,094231,Staff,17,0,20,3
1653604472660,COGS 260,A00,088004,Nitz; Douglas A.,9998,0,9999,1
1653604473182,CSE 202,A00,090110,Paturi; Ramamohan,0,0,0,0
1653604473182,CSE 202,B00,090111,Paturi; Ramamohan,0,0,0,0
1653604473704,CSE 207B,A00,090112,Heninger; Nadia A,0,0,0,0
1653604474237,CSE 208,A00,094858,Micciancio; Daniele,0,0,0,0
1653604474762,CSE 210,A00,090113,Powell; Thomas Allan,0,0,0,0
1653604475285,CSE 219,A00,090898,Staff,0,0,0,0
1653604475807,CSE 221,A00,090114,Zhou; Yuan-Yuan,0,0,0,0
1653604476332,CSE 229A,A00,090115,Porter; George M,0,0,0,0
1653604476868,CSE 229C,A00,090116,Savage; Stefan,0,0,0,0
1653604477400,CSE 230,A00,090117,Jhala; Ranjit,0,0,0,0
1653604477926,CSE 232,A00,090118,Papakonstantinou; Yannis,0,0,0,0
1653604478473,CSE 239A,A00,090121,Kumar; Arun Kumar,0,0,0,0
1653604479009,CSE 239B,A00,090122,Jhala; Ranjit,0,0,0,0
1653604479542,CSE 240A,A00,090123,Zhao; Jishen,0,0,189,189
1653604480069,CSE 243A,A00,090124,Orailoglu; Alex,0,0,15,15
1653604480598,CSE 249B,A00,090125,Kahng; Andrew Byun,12,0,20,8
1653604481121,CSE 250A,A00,090126,Berg-Kirkpatrick; Taylor D,0,0,0,0
1653604481647,CSE 252A,A00,090127,Ochoa; Benjamin Lawrence,0,0,0,0
1653604482170,CSE 258,A01,090129,McAuley; Julian John,0,0,0,0
1653604482697,CSE 258R,A01,090131,McAuley; Julian John,0,0,0,0
1653604483223,CSE 274,A00,090132,Ramamoorthi; Ravi,0,0,0,0
1653604483751,CSE 276A,A00,090133,Christensen; Henrik I,0,0,0,0
1653604484289,CSE 276C,A00,090134,Christensen; Henrik I,0,0,0,0
1653604484816,CSE 290,A00,090135,Bafna; Vineet,0,0,0,0
1653604484816,CSE 290,B00,090136,Ramamoorthi; Ravi,0,0,0,0
1653604484816,CSE 290,C00,090137,Li; Tzumao,7,0,10,3
1653604484816,CSE 290,D00,090138,Zhou; Yuan-Yuan,9,0,10,1
1653604484816,CSE 290,E00,090139,Christensen; Henrik I,8,0,10,2
1653604484816,CSE 290,F00,094053,Shalev; Aaron D,0,0,0,0
1653604485342,CSE 291,A00,090140,Munyaka; Imani N. S.,0,0,0,0
1653604485342,CSE 291,B00,094880,Yu; Qi,0,0,0,0
1653604485342,CSE 291,C00,090142,Pannuto; Patrick William,0,0,0,0
1653604485342,CSE 291,D00,094881,Zhang; Yiying,0,0,0,0
1653604485342,CSE 291,E00,095118,Su; Hao,0,0,0,0
1653604485876,CSE 293,001,094905,Bafna; Vineet,9999,0,9999,0
1653604485876,CSE 293,002,094906,Bellare; Mihir,9999,0,9999,0
1653604485876,CSE 293,003,094907,Berg-Kirkpatrick; Taylor D,9999,0,9999,0
1653604485876,CSE 293,004,094908,Christensen; Henrik I,9999,0,9999,0
1653604485876,CSE 293,005,094909,Cottrell; Garrison W,9999,0,9999,0
1653604485876,CSE 293,006,094910,Deutsch; Alin Bernard,9999,0,9999,0
1653604485876,CSE 293,007,094911,Esmaeilzadeh; Hadi,9999,0,9999,0
1653604485876,CSE 293,008,094912,Freund; Yoav,9999,0,9999,0
1653604485876,CSE 293,009,094913,Griswold; William G.,9999,0,9999,0
1653604485876,CSE 293,010,094914,Gymrek; Melissa Ann,9999,0,9999,0
1653604485876,CSE 293,011,094915,Heninger; Nadia A,9999,0,9999,0
1653604485876,CSE 293,012,094916,Impagliazzo; Russell,9999,0,9999,0
1653604485876,CSE 293,013,094917,Jhala; Ranjit,9999,0,9999,0
1653604485876,CSE 293,014,094918,Kahng; Andrew Byun,9999,0,9999,0
1653604485876,CSE 293,015,094919,Kane; Daniel Mertz,9999,0,9999,0
1653604485876,CSE 293,016,094920,Kriegman; David J,9999,0,9999,0
1653604485876,CSE 293,017,094921,Kumar; Arun Kumar,9999,0,9999,0
1653604485876,CSE 293,018,094922,Lerner; Sorin,9999,0,9999,0
1653604485876,CSE 293,019,094923,Lovett; Shachar,9999,0,9999,0
1653604485876,CSE 293,020,094924,McAuley; Julian John,9999,0,9999,0
1653604485876,CSE 293,021,094925,Micciancio; Daniele,9999,0,9999,0
1653604485876,CSE 293,022,094926,Orailoglu; Alex,9999,0,9999,0
1653604485876,CSE 293,023,094927,Paturi; Ramamohan,9999,0,9999,0
1653604485876,CSE 293,024,094928,Polikarpova; Nadezhda,9999,0,9999,0
1653604485876,CSE 293,025,094929,Politz; Joseph Gibbs,9999,0,9999,0
1653604485876,CSE 293,026,094930,Porter; George M,9999,0,9999,0
1653604485876,CSE 293,027,094931,Porter; Leonard Emerson,9999,0,9999,0
1653604485876,CSE 293,028,094932,Ramamoorthi; Ravi,9999,0,9999,0
1653604485876,CSE 293,029,094933,Sahoo; Debashis,9999,0,9999,0
1653604485876,CSE 293,030,094934,Saul; Lawrence,9999,0,9999,0
1653604485876,CSE 293,031,094935,Savage; Stefan,9999,0,9999,0
1653604485876,CSE 293,032,094936,Schulze; Jurgen P.,9999,0,9999,0
1653604485876,CSE 293,033,094937,Snoeren; Alex C.,9999,0,9999,0
1653604485876,CSE 293,034,094938,Shang; Jingbo,9999,0,9999,0
1653604485876,CSE 293,035,094939,Stefan; Deian,9999,0,9999,0
1653604485876,CSE 293,036,094940,Su; Hao,9999,0,9999,0
1653604485876,CSE 293,037,094941,Swanson; Steven James,9999,0,9999,0
1653604485876,CSE 293,038,094942,Tullsen; Dean Michael,9999,0,9999,0
1653604485876,CSE 293,039,094943,Voelker; Geoffrey M.,9999,0,9999,0
1653604485876,CSE 293,040,094944,Zhao; Jishen,9999,0,9999,0
1653604485876,CSE 293,041,094945,Zhou; Yuan-Yuan,9999,0,9999,0
1653604485876,CSE 293,042,094946,Gao; Sicun,9998,0,9999,1
1653604485876,CSE 293,043,094947,Weibel; Nadir,9999,0,9999,0
1653604485876,CSE 293,044,094948,Gupta; Rajesh K.,9999,0,9999,0
1653604486408,CSE 294,A00,090143,Porter; George M,8,0,10,2
1653604486935,DSE 200,A00,091799,Staff,50,0,50,0
1653604487460,DSE 203,A00,091800,Gupta; Amarnath,30,0,30,0
1653604487996,DSE 250,A00,091801,Deutsch; Alin Bernard,30,0,30,0
1653604488523,DSE 290,A00,091802,Altintas De Callaf; Ilkay,50,0,50,0
1653604489050,ECE 200,001,091003,Antipa; Nicholas A,9999,0,9999,0
1653604489050,ECE 200,002,091004,Atanasov; Nikolay A.,9999,0,9999,0
1653604489050,ECE 200,003,091005,Bharadia; Dinesh,9999,0,9999,0
1653604489050,ECE 200,004,091006,Cheng; Chung Kuan,9999,0,9999,0
1653604489050,ECE 200,005,091007,Cosman; Pamela C.,9999,0,9999,0
1653604489050,ECE 200,006,091008,Staff,9999,0,9999,0
1653604489050,ECE 200,007,091009,Dayeh; Shadi Ahmad,9999,0,9999,0
1653604489050,ECE 200,008,091010,Fainman; Yeshaiahu,9999,0,9999,0
1653604489050,ECE 200,009,091011,Ford; Joseph Earl,9999,0,9999,0
1653604489050,ECE 200,010,091012,Franceschetti; Massimo,9999,0,9999,0
1653604489050,ECE 200,011,091013,Fullerton; Eric E,9999,0,9999,0
1653604489050,ECE 200,012,091014,Galton; Ian A,9999,0,9999,0
1653604489050,ECE 200,013,091015,Gilja; Vikash,9999,0,9999,0
1653604489050,ECE 200,014,091016,Hall; Drew A.,9999,0,9999,0
1653604489050,ECE 200,015,091017,Hsueh; Tzu-Chien,9999,0,9999,0
1653604489050,ECE 200,016,091018,Javidi; Tara,9999,0,9999,0
1653604489050,ECE 200,017,091019,Kahng; Andrew Byun,9999,0,9999,0
1653604489050,ECE 200,018,091020,Kim; Young-Han,9999,0,9999,0
1653604489050,ECE 200,019,091021,Koushanfar; Farinaz,9999,0,9999,0
1653604489050,ECE 200,020,091022,Kuzum; Duygu,9999,0,9999,0
1653604489050,ECE 200,021,091023,Le; Hanh-Phuc,9999,0,9999,0
1653604489050,ECE 200,022,091024,Lin; Bill,9999,0,9999,0
1653604489050,ECE 200,023,091025,Liu; Zhaowei,9999,0,9999,0
1653604489050,ECE 200,024,091026,Lo; Yu-Hwa,9999,0,9999,0
1653604489050,ECE 200,025,091027,Lomakin; Vitaliy,9999,0,9999,0
1653604489050,ECE 200,026,091028,Mercier; Patrick Philip,9999,0,9999,0
1653604489050,ECE 200,027,091029,Meyer; Florian,9999,0,9999,0
1653604489050,ECE 200,028,091030,Milstein; Laurence B.,9999,0,9999,0
1653604489050,ECE 200,029,091031,Mir Arabbaygi; Siavash,9999,0,9999,0
1653604489050,ECE 200,030,091032,Mookherjea; Shayan,9999,0,9999,0
1653604489050,ECE 200,031,091033,Morris; Karcher William,9999,0,9999,0
1653604489050,ECE 200,032,091034,Ng; Tse Nga,9999,0,9999,0
1653604489050,ECE 200,033,091035,Nguyen; Truong Quang,9999,0,9999,0
1653604489050,ECE 200,034,091036,Nomura; Kenji,9999,0,9999,0
1653604489050,ECE 200,035,091037,Orlitsky; Alon,9999,0,9999,0
1653604489050,ECE 200,036,091038,Pal; Piya,9999,0,9999,0
1653604489050,ECE 200,037,091039,Papen; George C.,9999,0,9999,0
1653604489050,ECE 200,038,091040,Radic; Stojan,9999,0,9999,0
1653604489050,ECE 200,039,091041,Rao; Bhaskar D.,9999,0,9999,0
1653604489050,ECE 200,040,091042,Rao; Ramesh R,9999,0,9999,0
1653604489050,ECE 200,041,091043,Rebeiz; Gabriel,9999,0,9999,0
1653604489050,ECE 200,042,091044,Sanford; John R,9999,0,9999,0
1653604489050,ECE 200,043,091045,Siegel; Paul H.,9999,0,9999,0
1653604489050,ECE 200,044,091046,Sievenpiper; Daniel F.,9999,0,9999,0
1653604489050,ECE 200,045,091047,Sworder; David D.,9999,0,9999,0
1653604489050,ECE 200,046,091048,Taur; Yuan,9999,0,9999,0
1653604489050,ECE 200,047,091049,Touri; Behrouz,9999,0,9999,0
1653604489050,ECE 200,048,091050,Trivedi; Mohan M.,9999,0,9999,0
1653604489050,ECE 200,049,091051,Vardy; Alexander,9999,0,9999,0
1653604489050,ECE 200,050,091052,Vasconcelos; Nuno,9999,0,9999,0
1653604489050,ECE 200,051,091053,Wang; Xiaolong,9999,0,9999,0
1653604489050,ECE 200,052,091054,Xie; Pengtao,9999,0,9999,0
1653604489050,ECE 200,053,091055,Yip; Michael,9999,0,9999,0
1653604489050,ECE 200,054,091056,Zeger; Kenneth A.,9999,0,9999,0
1653604489050,ECE 200,055,091057,Zhang; Xinyu,9999,0,9999,0
1653604489050,ECE 200,056,091058,Turakhia; Yatish Girish,9999,0,9999,0
1653604489050,ECE 200,057,091059,Kang; Mingu,9999,0,9999,0
1653604489050,ECE 200,058,091060,Shi; Yuanyuan,9999,0,9999,0
1653604489050,ECE 200,059,091061,Wang; Edward Jay,9999,0,9999,0
1653604489050,ECE 200,060,091062,Zheng; Yang,9999,0,9999,0
1653604489575,ECE 201,A00,095526,Lo; Yu-Hwa,0,0,0,0
1653604490102,ECE 203,A00,091065,Mercier; Patrick Philip,0,0,0,0
1653604490627,ECE 207A,A00,091605,Liu; Thomas Tao-Ming,0,0,0,0
1653604491148,ECE 212AN,A00,091068,Nomura; Kenji,0,0,0,0
1653604491671,ECE 222A,A00,091069,Rebeiz; Gabriel,0,0,0,0
1653604492194,ECE 225A,A00,091070,Orlitsky; Alon,0,0,0,0
1653604492717,ECE 230A,A00,091071,Nomura; Kenji,0,0,0,0
1653604493256,ECE 236A,A00,091072,Dayeh; Shadi Ahmad,0,0,0,0
1653604493780,ECE 238A,A00,091073,Luo; Jian,0,0,0,0
1653604493780,ECE 238A,B00,091074,Luo; Jian,0,0,0,0
1653604494319,ECE 240A,A00,091075,Radic; Stojan,0,0,0,0
1653604494844,ECE 247A,A00,091592,Shi; Lingyan,0,0,0,0
1653604495367,ECE 250,A00,091076,Touri; Behrouz,0,0,0,0
1653604495901,ECE 251C,A00,091078,Nguyen; Truong Quang,0,0,0,0
1653604496441,ECE 253,A00,091079,Cosman; Pamela C.,0,0,0,0
1653604496964,ECE 255A,A00,091080,Orlitsky; Alon,0,0,0,0
1653604497495,ECE 257A,A00,091081,Zhang; Xinyu,0,0,0,0
1653604498032,ECE 260A,A01,091084,Eldon; John,0,0,0,0
1653604498571,ECE 264C,A00,091085,Galton; Ian A,0,0,0,0
1653604499094,ECE 265C,A00,094889,Presti; Calogero Davide,0,0,0,9
1653604499618,ECE 266,A01,091087,Hall; Drew A.,0,0,0,0
1653604500678,ECE 271A,A00,091090,Vasconcelos; Nuno,0,0,0,0
1653604501213,ECE 272B,A00,091091,Sworder; David D.,0,0,0,0
1653604501738,ECE 275A,A00,091092,Meyer; Florian,0,0,0,0
1653604502274,ECE 277,A00,091093,An; Cheolhong,0,0,0,0
1653604502798,ECE 283,A00,091094,Le; Hanh-Phuc,0,0,0,0
1653604503325,ECE 284,A00,091095,Kang; Mingu,0,0,0,0
1653604503325,ECE 284,B00,091096,Wang; Edward Jay,0,0,0,0
1653604503849,ECE 285,A00,094334,Touri; Behrouz,0,0,0,0
1653604504373,ECE 289,A00,091097,Whelan; David Arthur,0,0,0,0
1653604504896,MATH 200A,A00,087414,Salehi Golsefidy; Alireza,7,0,8,1
1653604505421,MATH 202A,A00,087415,Gill; Philip E.,2,0,8,6
1653604505948,MATH 203A,A00,087416,Oprea; Dragos N.,6,0,8,2
1653604506475,MATH 204A,A00,087417,Kedlaya; Kiran S.,6,0,8,2
1653604507001,MATH 205,A00,087418,Sorensen; Claus M,6,0,8,2
1653604507529,MATH 206A,A00,087419,Izadi; Elham,7,0,8,1
1653604508052,MATH 207A,A00,087420,Mohammadi; Amir,5,0,8,3
1653604508577,MATH 208,A00,087421,Staff,9,0,10,1
1653604509100,MATH 209,A00,087422,Staff,10,0,10,0
1653604509622,MATH 218,A00,087423,Staff,10,0,10,0
1653604510147,MATH 220A,A00,087424,Novak; Jonathan I,6,0,8,2
1653604510671,MATH 231A,A00,087425,Bejenaru; Ioan,3,0,8,5
1653604511198,MATH 240A,A00,087426,Ebenfelt; Peter F,5,0,8,3
1653604511721,MATH 243,A00,087427,Staff,9,0,10,1
1653604512247,MATH 248,A00,087429,Staff,10,0,10,0
1653604512772,MATH 250A,A00,087430,Spolaor; Luca,4,0,8,4
1653604513310,MATH 257A,A00,087431,Spolaor; Luca,7,0,8,1
1653604513834,MATH 258,A00,087432,Staff,9,0,10,1
1653604514357,MATH 264A,A00,087433,Warnke; Lutz Peter,5,0,8,3
1653604514880,MATH 268,A00,087434,Staff,15,0,15,0
1653604515402,MATH 269,A00,087435,Staff,14,0,15,1
1653604515926,MATH 270A,A00,087436,Nie; Jiawang,0,0,8,8
1653604516451,MATH 272A,A00,087437,Tian; Xiaochuan,0,0,8,8
1653604516979,MATH 274,A01,087439,Cheng; Li-Tien,9,0,10,1
1653604516979,MATH 274,A02,087440,Cheng; Li-Tien,10,0,10,0
1653604517505,MATH 278A,A00,087441,Staff,8,0,10,2
1653604518124,MATH 278B,A00,087442,Staff,8,0,10,2
1653604518647,MATH 278C,A00,087443,Staff,8,0,10,2
1653604519170,MATH 280A,A00,087444,Zheng; Tianyi,0,0,8,8
1653604519703,MATH 281A,A00,087445,Bradic; Jelena,0,0,8,8
1653604520236,MATH 282A,A00,087446,Zhang; Danna,0,0,8,8
1653604520770,MATH 283,A00,087447,Tesler; Glenn,0,0,0,16
1653604521293,MATH 286,B00,095535,Kemp; Todd Aahron,7,0,8,1
1653604521819,MATH 287D,B00,095536,Bradic; Jelena,5,0,8,3
1653604522345,MATH 288,A00,087450,Staff,14,0,15,1
1653604522345,MATH 288,B00,087451,Staff,15,0,15,0
1653604522345,MATH 288,C00,087452,Staff,15,0,15,0
1653604522868,MATH 290A,A00,087453,Xu; Zhouli,6,0,8,2
1653604523398,MATH 291A,A00,087454,Xu; Zhouli,7,0,8,1
1653604523922,MATH 292,A00,087455,Staff,10,0,10,0
1653604524444,MATH 295,A00,087456,Staff,50,0,50,0
1653604524971,MATH 297,001,087457,Staff,997,0,999,2
1653605085896,COGS 200,A01,087991,Staff,47,0,50,3
1653605086420,COGS 201,A01,094504,Rangel; Lara M,16,0,25,9
1653605086944,COGS 203,A00,087992,Coulson; Seana M,18,0,20,2
1653605087467,COGS 210A,001,087993,Greene; Deanna Jacquelyn,9998,0,9999,1
1653605087467,COGS 210A,002,087994,Saygin; Ayse P,9999,0,9999,0
1653605087467,COGS 210A,003,087995,Xia; Haijun,9999,0,9999,0
1653605087467,COGS 210A,004,087996,Nitz; Douglas A.,9999,0,9999,0
1653605087467,COGS 210A,005,087997,Hollan; James D.,9999,0,9999,0
1653605087467,COGS 210A,006,087998,Deak; Gedeon O.,9998,0,9999,1
1653605087467,COGS 210A,007,087999,Rossano; Federico,9999,0,9999,0
1653605087992,COGS 211A,A00,088000,Coulson; Seana M,9997,0,9999,2
1653605088517,COGS 229,A00,088002,Staff,22,0,25,3
1653605089041,COGS 260,B00,094231,Staff,17,0,20,3
1653605089041,COGS 260,A00,088004,Nitz; Douglas A.,9998,0,9999,1
1653605089577,CSE 202,A00,090110,Paturi; Ramamohan,0,0,0,0
1653605089577,CSE 202,B00,090111,Paturi; Ramamohan,0,0,0,0
1653605090103,CSE 207B,A00,090112,Heninger; Nadia A,0,0,0,0
1653605090626,CSE 208,A00,094858,Micciancio; Daniele,0,0,0,0
1653605091148,CSE 210,A00,090113,Powell; Thomas Allan,0,0,0,0
1653605091673,CSE 219,A00,090898,Staff,0,0,0,0
1653605092198,CSE 221,A00,090114,Zhou; Yuan-Yuan,0,0,0,0
1653605092721,CSE 229A,A00,090115,Porter; George M,0,0,0,0
1653605093254,CSE 229C,A00,090116,Savage; Stefan,0,0,0,0
1653605093786,CSE 230,A00,090117,Jhala; Ranjit,0,0,0,0
1653605094313,CSE 232,A00,090118,Papakonstantinou; Yannis,0,0,0,0
1653605094835,CSE 239A,A00,090121,Kumar; Arun Kumar,0,0,0,0
1653605095358,CSE 239B,A00,090122,Jhala; Ranjit,0,0,0,0
1653605095885,CSE 240A,A00,090123,Zhao; Jishen,0,0,189,189
1653605096411,CSE 243A,A00,090124,Orailoglu; Alex,0,0,15,15
1653605096943,CSE 249B,A00,090125,Kahng; Andrew Byun,12,0,20,8
1653605097465,CSE 250A,A00,090126,Berg-Kirkpatrick; Taylor D,0,0,0,0
1653605097991,CSE 252A,A00,090127,Ochoa; Benjamin Lawrence,0,0,0,0
1653605098513,CSE 258,A01,090129,McAuley; Julian John,0,0,0,0
1653605099035,CSE 258R,A01,090131,McAuley; Julian John,0,0,0,0
1653605099566,CSE 274,A00,090132,Ramamoorthi; Ravi,0,0,0,0
1653605100091,CSE 276A,A00,090133,Christensen; Henrik I,0,0,0,0
1653605100614,CSE 276C,A00,090134,Christensen; Henrik I,0,0,0,0
1653605101138,CSE 290,A00,090135,Bafna; Vineet,0,0,0,0
1653605101138,CSE 290,B00,090136,Ramamoorthi; Ravi,0,0,0,0
1653605101138,CSE 290,C00,090137,Li; Tzumao,7,0,10,3
1653605101138,CSE 290,D00,090138,Zhou; Yuan-Yuan,9,0,10,1
1653605101138,CSE 290,E00,090139,Christensen; Henrik I,8,0,10,2
1653605101138,CSE 290,F00,094053,Shalev; Aaron D,0,0,0,0
1653605101663,CSE 291,A00,090140,Munyaka; Imani N. S.,0,0,0,0
1653605101663,CSE 291,B00,094880,Yu; Qi,0,0,0,0
1653605101663,CSE 291,C00,090142,Pannuto; Patrick William,0,0,0,0
1653605101663,CSE 291,D00,094881,Zhang; Yiying,0,0,0,0
1653605101663,CSE 291,E00,095118,Su; Hao,0,0,0,0
1653605102201,CSE 293,001,094905,Bafna; Vineet,9999,0,9999,0
1653605102201,CSE 293,002,094906,Bellare; Mihir,9999,0,9999,0
1653605102201,CSE 293,003,094907,Berg-Kirkpatrick; Taylor D,9999,0,9999,0
1653605102201,CSE 293,004,094908,Christensen; Henrik I,9999,0,9999,0
1653605102201,CSE 293,005,094909,Cottrell; Garrison W,9999,0,9999,0
1653605102201,CSE 293,006,094910,Deutsch; Alin Bernard,9999,0,9999,0
1653605102201,CSE 293,007,094911,Esmaeilzadeh; Hadi,9999,0,9999,0
1653605102201,CSE 293,008,094912,Freund; Yoav,9999,0,9999,0
1653605102201,CSE 293,009,094913,Griswold; William G.,9999,0,9999,0
1653605102201,CSE 293,010,094914,Gymrek; Melissa Ann,9999,0,9999,0
1653605102201,CSE 293,011,094915,Heninger; Nadia A,9999,0,9999,0
1653605102201,CSE 293,012,094916,Impagliazzo; Russell,9999,0,9999,0
1653605102201,CSE 293,013,094917,Jhala; Ranjit,9999,0,9999,0
1653605102201,CSE 293,014,094918,Kahng; Andrew Byun,9999,0,9999,0
1653605102201,CSE 293,015,094919,Kane; Daniel Mertz,9999,0,9999,0
1653605102201,CSE 293,016,094920,Kriegman; David J,9999,0,9999,0
1653605102201,CSE 293,017,094921,Kumar; Arun Kumar,9999,0,9999,0
1653605102201,CSE 293,018,094922,Lerner; Sorin,9999,0,9999,0
1653605102201,CSE 293,019,094923,Lovett; Shachar,9999,0,9999,0
1653605102201,CSE 293,020,094924,McAuley; Julian John,9999,0,9999,0
1653605102201,CSE 293,021,094925,Micciancio; Daniele,9999,0,9999,0
1653605102201,CSE 293,022,094926,Orailoglu; Alex,9999,0,9999,0
1653605102201,CSE 293,023,094927,Paturi; Ramamohan,9999,0,9999,0
1653605102201,CSE 293,024,094928,Polikarpova; Nadezhda,9999,0,9999,0
1653605102201,CSE 293,025,094929,Politz; Joseph Gibbs,9999,0,9999,0
1653605102201,CSE 293,026,094930,Porter; George M,9999,0,9999,0
1653605102201,CSE 293,027,094931,Porter; Leonard Emerson,9999,0,9999,0
1653605102201,CSE 293,028,094932,Ramamoorthi; Ravi,9999,0,9999,0
1653605102201,CSE 293,029,094933,Sahoo; Debashis,9999,0,9999,0
1653605102201,CSE 293,030,094934,Saul; Lawrence,9999,0,9999,0
1653605102201,CSE 293,031,094935,Savage; Stefan,9999,0,9999,0
1653605102201,CSE 293,032,094936,Schulze; Jurgen P.,9999,0,9999,0
1653605102201,CSE 293,033,094937,Snoeren; Alex C.,9999,0,9999,0
1653605102201,CSE 293,034,094938,Shang; Jingbo,9999,0,9999,0
1653605102201,CSE 293,035,094939,Stefan; Deian,9999,0,9999,0
1653605102201,CSE 293,036,094940,Su; Hao,9999,0,9999,0
1653605102201,CSE 293,037,094941,Swanson; Steven James,9999,0,9999,0
1653605102201,CSE 293,038,094942,Tullsen; Dean Michael,9999,0,9999,0
1653605102201,CSE 293,039,094943,Voelker; Geoffrey M.,9999,0,9999,0
1653605102201,CSE 293,040,094944,Zhao; Jishen,9999,0,9999,0
1653605102201,CSE 293,041,094945,Zhou; Yuan-Yuan,9999,0,9999,0
1653605102201,CSE 293,042,094946,Gao; Sicun,9998,0,9999,1
1653605102201,CSE 293,043,094947,Weibel; Nadir,9999,0,9999,0
1653605102201,CSE 293,044,094948,Gupta; Rajesh K.,9999,0,9999,0
1653605102733,CSE 294,A00,090143,Porter; George M,8,0,10,2
1653605103262,DSE 200,A00,091799,Staff,50,0,50,0
1653605103785,DSE 203,A00,091800,Gupta; Amarnath,30,0,30,0
1653605104309,DSE 250,A00,091801,Deutsch; Alin Bernard,30,0,30,0
1653605104831,DSE 290,A00,091802,Altintas De Callaf; Ilkay,50,0,50,0
1653605105357,ECE 200,001,091003,Antipa; Nicholas A,9999,0,9999,0
1653605105357,ECE 200,002,091004,Atanasov; Nikolay A.,9999,0,9999,0
1653605105357,ECE 200,003,091005,Bharadia; Dinesh,9999,0,9999,0
1653605105357,ECE 200,004,091006,Cheng; Chung Kuan,9999,0,9999,0
1653605105357,ECE 200,005,091007,Cosman; Pamela C.,9999,0,9999,0
1653605105357,ECE 200,006,091008,Staff,9999,0,9999,0
1653605105357,ECE 200,007,091009,Dayeh; Shadi Ahmad,9999,0,9999,0
1653605105357,ECE 200,008,091010,Fainman; Yeshaiahu,9999,0,9999,0
1653605105357,ECE 200,009,091011,Ford; Joseph Earl,9999,0,9999,0
1653605105357,ECE 200,010,091012,Franceschetti; Massimo,9999,0,9999,0
1653605105357,ECE 200,011,091013,Fullerton; Eric E,9999,0,9999,0
1653605105357,ECE 200,012,091014,Galton; Ian A,9999,0,9999,0
1653605105357,ECE 200,013,091015,Gilja; Vikash,9999,0,9999,0
1653605105357,ECE 200,014,091016,Hall; Drew A.,9999,0,9999,0
1653605105357,ECE 200,015,091017,Hsueh; Tzu-Chien,9999,0,9999,0
1653605105357,ECE 200,016,091018,Javidi; Tara,9999,0,9999,0
1653605105357,ECE 200,017,091019,Kahng; Andrew Byun,9999,0,9999,0
1653605105357,ECE 200,018,091020,Kim; Young-Han,9999,0,9999,0
1653605105357,ECE 200,019,091021,Koushanfar; Farinaz,9999,0,9999,0
1653605105357,ECE 200,020,091022,Kuzum; Duygu,9999,0,9999,0
1653605105357,ECE 200,021,091023,Le; Hanh-Phuc,9999,0,9999,0
1653605105357,ECE 200,022,091024,Lin; Bill,9999,0,9999,0
1653605105357,ECE 200,023,091025,Liu; Zhaowei,9999,0,9999,0
1653605105357,ECE 200,024,091026,Lo; Yu-Hwa,9999,0,9999,0
1653605105357,ECE 200,025,091027,Lomakin; Vitaliy,9999,0,9999,0
1653605105357,ECE 200,026,091028,Mercier; Patrick Philip,9999,0,9999,0
1653605105357,ECE 200,027,091029,Meyer; Florian,9999,0,9999,0
1653605105357,ECE 200,028,091030,Milstein; Laurence B.,9999,0,9999,0
1653605105357,ECE 200,029,091031,Mir Arabbaygi; Siavash,9999,0,9999,0
1653605105357,ECE 200,030,091032,Mookherjea; Shayan,9999,0,9999,0
1653605105357,ECE 200,031,091033,Morris; Karcher William,9999,0,9999,0
1653605105357,ECE 200,032,091034,Ng; Tse Nga,9999,0,9999,0
1653605105357,ECE 200,033,091035,Nguyen; Truong Quang,9999,0,9999,0
1653605105357,ECE 200,034,091036,Nomura; Kenji,9999,0,9999,0
1653605105357,ECE 200,035,091037,Orlitsky; Alon,9999,0,9999,0
1653605105357,ECE 200,036,091038,Pal; Piya,9999,0,9999,0
1653605105357,ECE 200,037,091039,Papen; George C.,9999,0,9999,0
1653605105357,ECE 200,038,091040,Radic; Stojan,9999,0,9999,0
1653605105357,ECE 200,039,091041,Rao; Bhaskar D.,9999,0,9999,0
1653605105357,ECE 200,040,091042,Rao; Ramesh R,9999,0,9999,0
1653605105357,ECE 200,041,091043,Rebeiz; Gabriel,9999,0,9999,0
1653605105357,ECE 200,042,091044,Sanford; John R,9999,0,9999,0
1653605105357,ECE 200,043,091045,Siegel; Paul H.,9999,0,9999,0
1653605105357,ECE 200,044,091046,Sievenpiper; Daniel F.,9999,0,9999,0
1653605105357,ECE 200,045,091047,Sworder; David D.,9999,0,9999,0
1653605105357,ECE 200,046,091048,Taur; Yuan,9999,0,9999,0
1653605105357,ECE 200,047,091049,Touri; Behrouz,9999,0,9999,0
1653605105357,ECE 200,048,091050,Trivedi; Mohan M.,9999,0,9999,0
1653605105357,ECE 200,049,091051,Vardy; Alexander,9999,0,9999,0
1653605105357,ECE 200,050,091052,Vasconcelos; Nuno,9999,0,9999,0
1653605105357,ECE 200,051,091053,Wang; Xiaolong,9999,0,9999,0
1653605105357,ECE 200,052,091054,Xie; Pengtao,9999,0,9999,0
1653605105357,ECE 200,053,091055,Yip; Michael,9999,0,9999,0
1653605105357,ECE 200,054,091056,Zeger; Kenneth A.,9999,0,9999,0
1653605105357,ECE 200,055,091057,Zhang; Xinyu,9999,0,9999,0
1653605105357,ECE 200,056,091058,Turakhia; Yatish Girish,9999,0,9999,0
1653605105357,ECE 200,057,091059,Kang; Mingu,9999,0,9999,0
1653605105357,ECE 200,058,091060,Shi; Yuanyuan,9999,0,9999,0
1653605105357,ECE 200,059,091061,Wang; Edward Jay,9999,0,9999,0
1653605105357,ECE 200,060,091062,Zheng; Yang,9999,0,9999,0
1653605105883,ECE 201,A00,095526,Lo; Yu-Hwa,0,0,0,0
1653605106511,ECE 203,A00,091065,Mercier; Patrick Philip,0,0,0,0
1653605107032,ECE 207A,A00,091605,Liu; Thomas Tao-Ming,0,0,0,0
1653605107557,ECE 212AN,A00,091068,Nomura; Kenji,0,0,0,0
1653605108087,ECE 222A,A00,091069,Rebeiz; Gabriel,0,0,0,0
1653605108618,ECE 225A,A00,091070,Orlitsky; Alon,0,0,0,0
1653605109143,ECE 230A,A00,091071,Nomura; Kenji,0,0,0,0
1653605109665,ECE 236A,A00,091072,Dayeh; Shadi Ahmad,0,0,0,0
1653605110189,ECE 238A,A00,091073,Luo; Jian,0,0,0,0
1653605110189,ECE 238A,B00,091074,Luo; Jian,0,0,0,0
1653605110715,ECE 240A,A00,091075,Radic; Stojan,0,0,0,0
1653605111238,ECE 247A,A00,091592,Shi; Lingyan,0,0,0,0
1653605111761,ECE 250,A00,091076,Touri; Behrouz,0,0,0,0
1653605112282,ECE 251C,A00,091078,Nguyen; Truong Quang,0,0,0,0
1653605112805,ECE 253,A00,091079,Cosman; Pamela C.,0,0,0,0
1653605113325,ECE 255A,A00,091080,Orlitsky; Alon,0,0,0,0
1653605113858,ECE 257A,A00,091081,Zhang; Xinyu,0,0,0,0
1653605114380,ECE 260A,A01,091084,Eldon; John,0,0,0,0
1653605114905,ECE 264C,A00,091085,Galton; Ian A,0,0,0,0
1653605115428,ECE 265C,A00,094889,Presti; Calogero Davide,0,0,0,9
1653605115962,ECE 266,A01,091087,Hall; Drew A.,0,0,0,0
1653605117018,ECE 271A,A00,091090,Vasconcelos; Nuno,0,0,0,0
1653605117547,ECE 272B,A00,091091,Sworder; David D.,0,0,0,0
1653605118079,ECE 275A,A00,091092,Meyer; Florian,0,0,0,0
1653605118605,ECE 277,A00,091093,An; Cheolhong,0,0,0,0
1653605119137,ECE 283,A00,091094,Le; Hanh-Phuc,0,0,0,0
1653605119663,ECE 284,A00,091095,Kang; Mingu,0,0,0,0
1653605119663,ECE 284,B00,091096,Wang; Edward Jay,0,0,0,0
1653605120206,ECE 285,A00,094334,Touri; Behrouz,0,0,0,0
1653605120741,ECE 289,A00,091097,Whelan; David Arthur,0,0,0,0
1653605121266,MATH 200A,A00,087414,Salehi Golsefidy; Alireza,7,0,8,1
1653605121812,MATH 202A,A00,087415,Gill; Philip E.,2,0,8,6
1653605122344,MATH 203A,A00,087416,Oprea; Dragos N.,6,0,8,2
1653605122871,MATH 204A,A00,087417,Kedlaya; Kiran S.,6,0,8,2
1653605123405,MATH 205,A00,087418,Sorensen; Claus M,6,0,8,2
1653605123930,MATH 206A,A00,087419,Izadi; Elham,7,0,8,1
1653605124455,MATH 207A,A00,087420,Mohammadi; Amir,5,0,8,3
1653605124976,MATH 208,A00,087421,Staff,9,0,10,1
1653605125502,MATH 209,A00,087422,Staff,10,0,10,0
1653605126029,MATH 218,A00,087423,Staff,10,0,10,0
1653605126555,MATH 220A,A00,087424,Novak; Jonathan I,6,0,8,2
1653605127093,MATH 231A,A00,087425,Bejenaru; Ioan,3,0,8,5
1653605127620,MATH 240A,A00,087426,Ebenfelt; Peter F,5,0,8,3
1653605128150,MATH 243,A00,087427,Staff,9,0,10,1
1653605128679,MATH 248,A00,087429,Staff,10,0,10,0
1653605129204,MATH 250A,A00,087430,Spolaor; Luca,4,0,8,4
1653605129745,MATH 257A,A00,087431,Spolaor; Luca,7,0,8,1
1653605130270,MATH 258,A00,087432,Staff,9,0,10,1
1653605130803,MATH 264A,A00,087433,Warnke; Lutz Peter,5,0,8,3
1653605131335,MATH 268,A00,087434,Staff,15,0,15,0
1653605131868,MATH 269,A00,087435,Staff,14,0,15,1
1653605132397,MATH 270A,A00,087436,Nie; Jiawang,0,0,8,8
1653605132926,MATH 272A,A00,087437,Tian; Xiaochuan,0,0,8,8
1653605133451,MATH 274,A01,087439,Cheng; Li-Tien,9,0,10,1
1653605133451,MATH 274,A02,087440,Cheng; Li-Tien,10,0,10,0
1653605133975,MATH 278A,A00,087441,Staff,8,0,10,2
1653605134501,MATH 278B,A00,087442,Staff,8,0,10,2
1653605135032,MATH 278C,A00,087443,Staff,8,0,10,2
1653605135553,MATH 280A,A00,087444,Zheng; Tianyi,0,0,8,8
1653605136076,MATH 281A,A00,087445,Bradic; Jelena,0,0,8,8
1653605136602,MATH 282A,A00,087446,Zhang; Danna,0,0,8,8
1653605137125,MATH 283,A00,087447,Tesler; Glenn,0,0,0,16
1653605137652,MATH 286,B00,095535,Kemp; Todd Aahron,6,0,8,2
1653605138191,MATH 287D,B00,095536,Bradic; Jelena,5,0,8,3
1653605138716,MATH 288,A00,087450,Staff,14,0,15,1
1653605138716,MATH 288,B00,087451,Staff,15,0,15,0
1653605138716,MATH 288,C00,087452,Staff,15,0,15,0
1653605139240,MATH 290A,A00,087453,Xu; Zhouli,6,0,8,2
1653605139762,MATH 291A,A00,087454,Xu; Zhouli,7,0,8,1
1653605140286,MATH 292,A00,087455,Staff,10,0,10,0
1653605140818,MATH 295,A00,087456,Staff,50,0,50,0
1653605141343,MATH 297,001,087457,Staff,997,0,999,2
1653605701740,COGS 200,A01,087991,Staff,47,0,50,3
1653605702279,COGS 201,A01,094504,Rangel; Lara M,16,0,25,9
1653605702805,COGS 203,A00,087992,Coulson; Seana M,18,0,20,2
1653605703382,COGS 210A,001,087993,Greene; Deanna Jacquelyn,9998,0,9999,1
1653605703382,COGS 210A,002,087994,Saygin; Ayse P,9999,0,9999,0
1653605703382,COGS 210A,003,087995,Xia; Haijun,9999,0,9999,0
1653605703382,COGS 210A,004,087996,Nitz; Douglas A.,9999,0,9999,0
1653605703382,COGS 210A,005,087997,Hollan; James D.,9999,0,9999,0
1653605703382,COGS 210A,006,087998,Deak; Gedeon O.,9998,0,9999,1
1653605703382,COGS 210A,007,087999,Rossano; Federico,9999,0,9999,0
1653605703909,COGS 211A,A00,088000,Coulson; Seana M,9997,0,9999,2
1653605704433,COGS 229,A00,088002,Staff,22,0,25,3
1653605704964,COGS 260,B00,094231,Staff,17,0,20,3
1653605704964,COGS 260,A00,088004,Nitz; Douglas A.,9998,0,9999,1
1653605705491,CSE 202,A00,090110,Paturi; Ramamohan,0,0,0,0
1653605705491,CSE 202,B00,090111,Paturi; Ramamohan,0,0,0,0
1653605706019,CSE 207B,A00,090112,Heninger; Nadia A,0,0,0,0
1653605706551,CSE 208,A00,094858,Micciancio; Daniele,0,0,0,0
1653605707073,CSE 210,A00,090113,Powell; Thomas Allan,0,0,0,0
1653605707598,CSE 219,A00,090898,Staff,0,0,0,0
1653605708124,CSE 221,A00,090114,Zhou; Yuan-Yuan,0,0,0,0
1653605708647,CSE 229A,A00,090115,Porter; George M,0,0,0,0
1653605709170,CSE 229C,A00,090116,Savage; Stefan,0,0,0,0
1653605709698,CSE 230,A00,090117,Jhala; Ranjit,0,0,0,0
1653605710240,CSE 232,A00,090118,Papakonstantinou; Yannis,0,0,0,0
1653605710762,CSE 239A,A00,090121,Kumar; Arun Kumar,0,0,0,0
1653605711290,CSE 239B,A00,090122,Jhala; Ranjit,0,0,0,0
1653605711817,CSE 240A,A00,090123,Zhao; Jishen,0,0,189,189
1653605712341,CSE 243A,A00,090124,Orailoglu; Alex,0,0,15,15
1653605712869,CSE 249B,A00,090125,Kahng; Andrew Byun,12,0,20,8
1653605713401,CSE 250A,A00,090126,Berg-Kirkpatrick; Taylor D,0,0,0,0
1653605713926,CSE 252A,A00,090127,Ochoa; Benjamin Lawrence,0,0,0,0
1653605714448,CSE 258,A01,090129,McAuley; Julian John,0,0,0,0
1653605714974,CSE 258R,A01,090131,McAuley; Julian John,0,0,0,0
1653605715497,CSE 274,A00,090132,Ramamoorthi; Ravi,0,0,0,0
1653605716019,CSE 276A,A00,090133,Christensen; Henrik I,0,0,0,0
1653605716545,CSE 276C,A00,090134,Christensen; Henrik I,0,0,0,0
1653605717068,CSE 290,A00,090135,Bafna; Vineet,0,0,0,0
1653605717068,CSE 290,B00,090136,Ramamoorthi; Ravi,0,0,0,0
1653605717068,CSE 290,C00,090137,Li; Tzumao,7,0,10,3
1653605717068,CSE 290,D00,090138,Zhou; Yuan-Yuan,9,0,10,1
1653605717068,CSE 290,E00,090139,Christensen; Henrik I,8,0,10,2
1653605717068,CSE 290,F00,094053,Shalev; Aaron D,0,0,0,0
1653605717597,CSE 291,A00,090140,Munyaka; Imani N. S.,0,0,0,0
1653605717597,CSE 291,B00,094880,Yu; Qi,0,0,0,0
1653605717597,CSE 291,C00,090142,Pannuto; Patrick William,0,0,0,0
1653605717597,CSE 291,D00,094881,Zhang; Yiying,0,0,0,0
1653605717597,CSE 291,E00,095118,Su; Hao,0,0,0,0
1653605718153,CSE 293,001,094905,Bafna; Vineet,9999,0,9999,0
1653605718153,CSE 293,002,094906,Bellare; Mihir,9999,0,9999,0
1653605718153,CSE 293,003,094907,Berg-Kirkpatrick; Taylor D,9999,0,9999,0
1653605718153,CSE 293,004,094908,Christensen; Henrik I,9999,0,9999,0
1653605718153,CSE 293,005,094909,Cottrell; Garrison W,9999,0,9999,0
1653605718153,CSE 293,006,094910,Deutsch; Alin Bernard,9999,0,9999,0
1653605718153,CSE 293,007,094911,Esmaeilzadeh; Hadi,9999,0,9999,0
1653605718153,CSE 293,008,094912,Freund; Yoav,9999,0,9999,0
1653605718153,CSE 293,009,094913,Griswold; William G.,9999,0,9999,0
1653605718153,CSE 293,010,094914,Gymrek; Melissa Ann,9999,0,9999,0
1653605718153,CSE 293,011,094915,Heninger; Nadia A,9999,0,9999,0
1653605718153,CSE 293,012,094916,Impagliazzo; Russell,9999,0,9999,0
1653605718153,CSE 293,013,094917,Jhala; Ranjit,9999,0,9999,0
1653605718153,CSE 293,014,094918,Kahng; Andrew Byun,9999,0,9999,0
1653605718153,CSE 293,015,094919,Kane; Daniel Mertz,9999,0,9999,0
1653605718153,CSE 293,016,094920,Kriegman; David J,9999,0,9999,0
1653605718153,CSE 293,017,094921,Kumar; Arun Kumar,9999,0,9999,0
1653605718153,CSE 293,018,094922,Lerner; Sorin,9999,0,9999,0
1653605718153,CSE 293,019,094923,Lovett; Shachar,9999,0,9999,0
1653605718153,CSE 293,020,094924,McAuley; Julian John,9999,0,9999,0
1653605718153,CSE 293,021,094925,Micciancio; Daniele,9999,0,9999,0
1653605718153,CSE 293,022,094926,Orailoglu; Alex,9999,0,9999,0
1653605718153,CSE 293,023,094927,Paturi; Ramamohan,9999,0,9999,0
1653605718153,CSE 293,024,094928,Polikarpova; Nadezhda,9999,0,9999,0
1653605718153,CSE 293,025,094929,Politz; Joseph Gibbs,9999,0,9999,0
1653605718153,CSE 293,026,094930,Porter; George M,9999,0,9999,0
1653605718153,CSE 293,027,094931,Porter; Leonard Emerson,9999,0,9999,0
1653605718153,CSE 293,028,094932,Ramamoorthi; Ravi,9999,0,9999,0
1653605718153,CSE 293,029,094933,Sahoo; Debashis,9999,0,9999,0
1653605718153,CSE 293,030,094934,Saul; Lawrence,9999,0,9999,0
1653605718153,CSE 293,031,094935,Savage; Stefan,9999,0,9999,0
1653605718153,CSE 293,032,094936,Schulze; Jurgen P.,9999,0,9999,0
1653605718153,CSE 293,033,094937,Snoeren; Alex C.,9999,0,9999,0
1653605718153,CSE 293,034,094938,Shang; Jingbo,9999,0,9999,0
1653605718153,CSE 293,035,094939,Stefan; Deian,9999,0,9999,0
1653605718153,CSE 293,036,094940,Su; Hao,9999,0,9999,0
1653605718153,CSE 293,037,094941,Swanson; Steven James,9999,0,9999,0
1653605718153,CSE 293,038,094942,Tullsen; Dean Michael,9999,0,9999,0
1653605718153,CSE 293,039,094943,Voelker; Geoffrey M.,9999,0,9999,0
1653605718153,CSE 293,040,094944,Zhao; Jishen,9999,0,9999,0
1653605718153,CSE 293,041,094945,Zhou; Yuan-Yuan,9999,0,9999,0
1653605718153,CSE 293,042,094946,Gao; Sicun,9998,0,9999,1
1653605718153,CSE 293,043,094947,Weibel; Nadir,9999,0,9999,0
1653605718153,CSE 293,044,094948,Gupta; Rajesh K.,9999,0,9999,0
1653605718675,CSE 294,A00,090143,Porter; George M,8,0,10,2
1653605719213,DSE 200,A00,091799,Staff,50,0,50,0
1653605719737,DSE 203,A00,091800,Gupta; Amarnath,30,0,30,0
1653605720260,DSE 250,A00,091801,Deutsch; Alin Bernard,30,0,30,0
1653605720787,DSE 290,A00,091802,Altintas De Callaf; Ilkay,50,0,50,0
1653605721316,ECE 200,001,091003,Antipa; Nicholas A,9999,0,9999,0
1653605721316,ECE 200,002,091004,Atanasov; Nikolay A.,9999,0,9999,0
1653605721316,ECE 200,003,091005,Bharadia; Dinesh,9999,0,9999,0
1653605721316,ECE 200,004,091006,Cheng; Chung Kuan,9999,0,9999,0
1653605721316,ECE 200,005,091007,Cosman; Pamela C.,9999,0,9999,0
1653605721316,ECE 200,006,091008,Staff,9999,0,9999,0
1653605721316,ECE 200,007,091009,Dayeh; Shadi Ahmad,9999,0,9999,0
1653605721316,ECE 200,008,091010,Fainman; Yeshaiahu,9999,0,9999,0
1653605721316,ECE 200,009,091011,Ford; Joseph Earl,9999,0,9999,0
1653605721316,ECE 200,010,091012,Franceschetti; Massimo,9999,0,9999,0
1653605721316,ECE 200,011,091013,Fullerton; Eric E,9999,0,9999,0
1653605721316,ECE 200,012,091014,Galton; Ian A,9999,0,9999,0
1653605721316,ECE 200,013,091015,Gilja; Vikash,9999,0,9999,0
1653605721316,ECE 200,014,091016,Hall; Drew A.,9999,0,9999,0
1653605721316,ECE 200,015,091017,Hsueh; Tzu-Chien,9999,0,9999,0
1653605721316,ECE 200,016,091018,Javidi; Tara,9999,0,9999,0
1653605721316,ECE 200,017,091019,Kahng; Andrew Byun,9999,0,9999,0
1653605721316,ECE 200,018,091020,Kim; Young-Han,9999,0,9999,0
1653605721316,ECE 200,019,091021,Koushanfar; Farinaz,9999,0,9999,0
1653605721316,ECE 200,020,091022,Kuzum; Duygu,9999,0,9999,0
1653605721316,ECE 200,021,091023,Le; Hanh-Phuc,9999,0,9999,0
1653605721316,ECE 200,022,091024,Lin; Bill,9999,0,9999,0
1653605721316,ECE 200,023,091025,Liu; Zhaowei,9999,0,9999,0
1653605721316,ECE 200,024,091026,Lo; Yu-Hwa,9999,0,9999,0
1653605721316,ECE 200,025,091027,Lomakin; Vitaliy,9999,0,9999,0
1653605721316,ECE 200,026,091028,Mercier; Patrick Philip,9999,0,9999,0
1653605721316,ECE 200,027,091029,Meyer; Florian,9999,0,9999,0
1653605721316,ECE 200,028,091030,Milstein; Laurence B.,9999,0,9999,0
1653605721316,ECE 200,029,091031,Mir Arabbaygi; Siavash,9999,0,9999,0
1653605721316,ECE 200,030,091032,Mookherjea; Shayan,9999,0,9999,0
1653605721316,ECE 200,031,091033,Morris; Karcher William,9999,0,9999,0
1653605721316,ECE 200,032,091034,Ng; Tse Nga,9999,0,9999,0
1653605721316,ECE 200,033,091035,Nguyen; Truong Quang,9999,0,9999,0
1653605721316,ECE 200,034,091036,Nomura; Kenji,9999,0,9999,0
1653605721316,ECE 200,035,091037,Orlitsky; Alon,9999,0,9999,0
1653605721316,ECE 200,036,091038,Pal; Piya,9999,0,9999,0
1653605721316,ECE 200,037,091039,Papen; George C.,9999,0,9999,0
1653605721316,ECE 200,038,091040,Radic; Stojan,9999,0,9999,0
1653605721316,ECE 200,039,091041,Rao; Bhaskar D.,9999,0,9999,0
1653605721316,ECE 200,040,091042,Rao; Ramesh R,9999,0,9999,0
1653605721316,ECE 200,041,091043,Rebeiz; Gabriel,9999,0,9999,0
1653605721316,ECE 200,042,091044,Sanford; John R,9999,0,9999,0
1653605721316,ECE 200,043,091045,Siegel; Paul H.,9999,0,9999,0
1653605721316,ECE 200,044,091046,Sievenpiper; Daniel F.,9999,0,9999,0
1653605721316,ECE 200,045,091047,Sworder; David D.,9999,0,9999,0
1653605721316,ECE 200,046,091048,Taur; Yuan,9999,0,9999,0
1653605721316,ECE 200,047,091049,Touri; Behrouz,9999,0,9999,0
1653605721316,ECE 200,048,091050,Trivedi; Mohan M.,9999,0,9999,0
1653605721316,ECE 200,049,091051,Vardy; Alexander,9999,0,9999,0
1653605721316,ECE 200,050,091052,Vasconcelos; Nuno,9999,0,9999,0
1653605721316,ECE 200,051,091053,Wang; Xiaolong,9999,0,9999,0
1653605721316,ECE 200,052,091054,Xie; Pengtao,9999,0,9999,0
1653605721316,ECE 200,053,091055,Yip; Michael,9999,0,9999,0
1653605721316,ECE 200,054,091056,Zeger; Kenneth A.,9999,0,9999,0
1653605721316,ECE 200,055,091057,Zhang; Xinyu,9999,0,9999,0
1653605721316,ECE 200,056,091058,Turakhia; Yatish Girish,9999,0,9999,0
1653605721316,ECE 200,057,091059,Kang; Mingu,9999,0,9999,0
1653605721316,ECE 200,058,091060,Shi; Yuanyuan,9999,0,9999,0
1653605721316,ECE 200,059,091061,Wang; Edward Jay,9999,0,9999,0
1653605721316,ECE 200,060,091062,Zheng; Yang,9999,0,9999,0
1653605721846,ECE 201,A00,095526,Lo; Yu-Hwa,0,0,0,0
1653605722369,ECE 203,A00,091065,Mercier; Patrick Philip,0,0,0,0
1653605722892,ECE 207A,A00,091605,Liu; Thomas Tao-Ming,0,0,0,0
1653605723418,ECE 212AN,A00,091068,Nomura; Kenji,0,0,0,0
1653605723943,ECE 222A,A00,091069,Rebeiz; Gabriel,0,0,0,0
1653605724469,ECE 225A,A00,091070,Orlitsky; Alon,0,0,0,0
1653605724990,ECE 230A,A00,091071,Nomura; Kenji,0,0,0,0
1653605725516,ECE 236A,A00,091072,Dayeh; Shadi Ahmad,0,0,0,0
1653605726041,ECE 238A,A00,091073,Luo; Jian,0,0,0,0
1653605726041,ECE 238A,B00,091074,Luo; Jian,0,0,0,0
1653605726564,ECE 240A,A00,091075,Radic; Stojan,0,0,0,0
1653605727096,ECE 247A,A00,091592,Shi; Lingyan,0,0,0,0
1653605727623,ECE 250,A00,091076,Touri; Behrouz,0,0,0,0
1653605728151,ECE 251C,A00,091078,Nguyen; Truong Quang,0,0,0,0
1653605728673,ECE 253,A00,091079,Cosman; Pamela C.,0,0,0,0
1653605729200,ECE 255A,A00,091080,Orlitsky; Alon,0,0,0,0
1653605729730,ECE 257A,A00,091081,Zhang; Xinyu,0,0,0,0
1653605730253,ECE 260A,A01,091084,Eldon; John,0,0,0,0
1653605730775,ECE 264C,A00,091085,Galton; Ian A,0,0,0,0
1653605731298,ECE 265C,A00,094889,Presti; Calogero Davide,0,0,0,9
1653605731822,ECE 266,A01,091087,Hall; Drew A.,0,0,0,0
1653605732866,ECE 271A,A00,091090,Vasconcelos; Nuno,0,0,0,0
1653605733388,ECE 272B,A00,091091,Sworder; David D.,0,0,0,0
1653605733916,ECE 275A,A00,091092,Meyer; Florian,0,0,0,0
1653605734442,ECE 277,A00,091093,An; Cheolhong,0,0,0,0
1653605734974,ECE 283,A00,091094,Le; Hanh-Phuc,0,0,0,0
1653605735501,ECE 284,A00,091095,Kang; Mingu,0,0,0,0
1653605735501,ECE 284,B00,091096,Wang; Edward Jay,0,0,0,0
1653605736024,ECE 285,A00,094334,Touri; Behrouz,0,0,0,0
1653605736548,ECE 289,A00,091097,Whelan; David Arthur,0,0,0,0
1653605737072,MATH 200A,A00,087414,Salehi Golsefidy; Alireza,7,0,8,1
1653605737594,MATH 202A,A00,087415,Gill; Philip E.,2,0,8,6
1653605738117,MATH 203A,A00,087416,Oprea; Dragos N.,6,0,8,2
1653605738639,MATH 204A,A00,087417,Kedlaya; Kiran S.,6,0,8,2
1653605739161,MATH 205,A00,087418,Sorensen; Claus M,6,0,8,2
1653605739684,MATH 206A,A00,087419,Izadi; Elham,7,0,8,1
1653605740213,MATH 207A,A00,087420,Mohammadi; Amir,5,0,8,3
1653605740735,MATH 208,A00,087421,Staff,9,0,10,1
1653605741266,MATH 209,A00,087422,Staff,10,0,10,0
1653605741791,MATH 218,A00,087423,Staff,10,0,10,0
1653605742311,MATH 220A,A00,087424,Novak; Jonathan I,6,0,8,2
1653605742842,MATH 231A,A00,087425,Bejenaru; Ioan,3,0,8,5
1653605743368,MATH 240A,A00,087426,Ebenfelt; Peter F,5,0,8,3
1653605743894,MATH 243,A00,087427,Staff,9,0,10,1
1653605744418,MATH 248,A00,087429,Staff,10,0,10,0
1653605744944,MATH 250A,A00,087430,Spolaor; Luca,4,0,8,4
1653605745470,MATH 257A,A00,087431,Spolaor; Luca,7,0,8,1
1653605745993,MATH 258,A00,087432,Staff,9,0,10,1
1653605746521,MATH 264A,A00,087433,Warnke; Lutz Peter,5,0,8,3
1653605747046,MATH 268,A00,087434,Staff,15,0,15,0
1653605747656,MATH 269,A00,087435,Staff,14,0,15,1
1653605748183,MATH 270A,A00,087436,Nie; Jiawang,0,0,8,8
1653605748705,MATH 272A,A00,087437,Tian; Xiaochuan,0,0,8,8
1653605749232,MATH 274,A01,087439,Cheng; Li-Tien,9,0,10,1
1653605749232,MATH 274,A02,087440,Cheng; Li-Tien,10,0,10,0
1653605749758,MATH 278A,A00,087441,Staff,8,0,10,2
1653605750281,MATH 278B,A00,087442,Staff,8,0,10,2
1653605750806,MATH 278C,A00,087443,Staff,8,0,10,2
1653605751340,MATH 280A,A00,087444,Zheng; Tianyi,0,0,8,8
1653605751867,MATH 281A,A00,087445,Bradic; Jelena,0,0,8,8
1653605752390,MATH 282A,A00,087446,Zhang; Danna,0,0,8,8
1653605752928,MATH 283,A00,087447,Tesler; Glenn,0,0,0,16
1653605753454,MATH 286,B00,095535,Kemp; Todd Aahron,6,0,8,2
1653605753978,MATH 287D,B00,095536,Bradic; Jelena,5,0,8,3
1653605754500,MATH 288,A00,087450,Staff,14,0,15,1
1653605754500,MATH 288,B00,087451,Staff,15,0,15,0
1653605754500,MATH 288,C00,087452,Staff,15,0,15,0
1653605755026,MATH 290A,A00,087453,Xu; Zhouli,6,0,8,2
1653605755549,MATH 291A,A00,087454,Xu; Zhouli,7,0,8,1
1653605756073,MATH 292,A00,087455,Staff,10,0,10,0
1653605756594,MATH 295,A00,087456,Staff,50,0,50,0
1653605757123,MATH 297,001,087457,Staff,997,0,999,2
1653606317272,COGS 200,A01,087991,Staff,47,0,50,3
1653606317808,COGS 201,A01,094504,Rangel; Lara M,16,0,25,9
1653606318339,COGS 203,A00,087992,Coulson; Seana M,18,0,20,2
1653606318877,COGS 210A,001,087993,Greene; Deanna Jacquelyn,9998,0,9999,1
1653606318877,COGS 210A,002,087994,Saygin; Ayse P,9999,0,9999,0
1653606318877,COGS 210A,003,087995,Xia; Haijun,9999,0,9999,0
1653606318877,COGS 210A,004,087996,Nitz; Douglas A.,9999,0,9999,0
1653606318877,COGS 210A,005,087997,Hollan; James D.,9999,0,9999,0
1653606318877,COGS 210A,006,087998,Deak; Gedeon O.,9998,0,9999,1
1653606318877,COGS 210A,007,087999,Rossano; Federico,9999,0,9999,0
1653606319406,COGS 211A,A00,088000,Coulson; Seana M,9997,0,9999,2
1653606319933,COGS 229,A00,088002,Staff,22,0,25,3
1653606320456,COGS 260,B00,094231,Staff,17,0,20,3
1653606320456,COGS 260,A00,088004,Nitz; Douglas A.,9998,0,9999,1
1653606320981,CSE 202,A00,090110,Paturi; Ramamohan,0,0,0,0
1653606320981,CSE 202,B00,090111,Paturi; Ramamohan,0,0,0,0
1653606321518,CSE 207B,A00,090112,Heninger; Nadia A,0,0,0,0
1653606322053,CSE 208,A00,094858,Micciancio; Daniele,0,0,0,0
1653606322575,CSE 210,A00,090113,Powell; Thomas Allan,0,0,0,0
1653606323100,CSE 219,A00,090898,Staff,0,0,0,0
1653606323623,CSE 221,A00,090114,Zhou; Yuan-Yuan,0,0,0,0
1653606324211,CSE 229A,A00,090115,Porter; George M,0,0,0,0
1653606324734,CSE 229C,A00,090116,Savage; Stefan,0,0,0,0
1653606325261,CSE 230,A00,090117,Jhala; Ranjit,0,0,0,0
1653606325797,CSE 232,A00,090118,Papakonstantinou; Yannis,0,0,0,0
1653606326323,CSE 239A,A00,090121,Kumar; Arun Kumar,0,0,0,0
1653606326848,CSE 239B,A00,090122,Jhala; Ranjit,0,0,0,0
1653606327371,CSE 240A,A00,090123,Zhao; Jishen,0,0,189,189
1653606327895,CSE 243A,A00,090124,Orailoglu; Alex,0,0,15,15
1653606328426,CSE 249B,A00,090125,Kahng; Andrew Byun,12,0,20,8
1653606328949,CSE 250A,A00,090126,Berg-Kirkpatrick; Taylor D,0,0,0,0
1653606329486,CSE 252A,A00,090127,Ochoa; Benjamin Lawrence,0,0,0,0
1653606330013,CSE 258,A01,090129,McAuley; Julian John,0,0,0,0
1653606330536,CSE 258R,A01,090131,McAuley; Julian John,0,0,0,0
1653606331061,CSE 274,A00,090132,Ramamoorthi; Ravi,0,0,0,0
1653606331583,CSE 276A,A00,090133,Christensen; Henrik I,0,0,0,0
1653606332110,CSE 276C,A00,090134,Christensen; Henrik I,0,0,0,0
1653606332633,CSE 290,A00,090135,Bafna; Vineet,0,0,0,0
1653606332633,CSE 290,B00,090136,Ramamoorthi; Ravi,0,0,0,0
1653606332633,CSE 290,C00,090137,Li; Tzumao,7,0,10,3
1653606332633,CSE 290,D00,090138,Zhou; Yuan-Yuan,9,0,10,1
1653606332633,CSE 290,E00,090139,Christensen; Henrik I,8,0,10,2
1653606332633,CSE 290,F00,094053,Shalev; Aaron D,0,0,0,0
1653606333160,CSE 291,A00,090140,Munyaka; Imani N. S.,0,0,0,0
1653606333160,CSE 291,B00,094880,Yu; Qi,0,0,0,0
1653606333160,CSE 291,C00,090142,Pannuto; Patrick William,0,0,0,0
1653606333160,CSE 291,D00,094881,Zhang; Yiying,0,0,0,0
1653606333160,CSE 291,E00,095118,Su; Hao,0,0,0,0
1653606333691,CSE 293,001,094905,Bafna; Vineet,9999,0,9999,0
1653606333691,CSE 293,002,094906,Bellare; Mihir,9999,0,9999,0
1653606333691,CSE 293,003,094907,Berg-Kirkpatrick; Taylor D,9999,0,9999,0
1653606333691,CSE 293,004,094908,Christensen; Henrik I,9999,0,9999,0
1653606333691,CSE 293,005,094909,Cottrell; Garrison W,9999,0,9999,0
1653606333691,CSE 293,006,094910,Deutsch; Alin Bernard,9999,0,9999,0
1653606333691,CSE 293,007,094911,Esmaeilzadeh; Hadi,9999,0,9999,0
1653606333691,CSE 293,008,094912,Freund; Yoav,9999,0,9999,0
1653606333691,CSE 293,009,094913,Griswold; William G.,9999,0,9999,0
1653606333691,CSE 293,010,094914,Gymrek; Melissa Ann,9999,0,9999,0
1653606333691,CSE 293,011,094915,Heninger; Nadia A,9999,0,9999,0
1653606333691,CSE 293,012,094916,Impagliazzo; Russell,9999,0,9999,0
1653606333691,CSE 293,013,094917,Jhala; Ranjit,9999,0,9999,0
1653606333691,CSE 293,014,094918,Kahng; Andrew Byun,9999,0,9999,0
1653606333691,CSE 293,015,094919,Kane; Daniel Mertz,9999,0,9999,0
1653606333691,CSE 293,016,094920,Kriegman; David J,9999,0,9999,0
1653606333691,CSE 293,017,094921,Kumar; Arun Kumar,9999,0,9999,0
1653606333691,CSE 293,018,094922,Lerner; Sorin,9999,0,9999,0
1653606333691,CSE 293,019,094923,Lovett; Shachar,9999,0,9999,0
1653606333691,CSE 293,020,094924,McAuley; Julian John,9999,0,9999,0
1653606333691,CSE 293,021,094925,Micciancio; Daniele,9999,0,9999,0
1653606333691,CSE 293,022,094926,Orailoglu; Alex,9999,0,9999,0
1653606333691,CSE 293,023,094927,Paturi; Ramamohan,9999,0,9999,0
1653606333691,CSE 293,024,094928,Polikarpova; Nadezhda,9999,0,9999,0
1653606333691,CSE 293,025,094929,Politz; Joseph Gibbs,9999,0,9999,0
1653606333691,CSE 293,026,094930,Porter; George M,9999,0,9999,0
1653606333691,CSE 293,027,094931,Porter; Leonard Emerson,9999,0,9999,0
1653606333691,CSE 293,028,094932,Ramamoorthi; Ravi,9999,0,9999,0
1653606333691,CSE 293,029,094933,Sahoo; Debashis,9999,0,9999,0
1653606333691,CSE 293,030,094934,Saul; Lawrence,9999,0,9999,0
1653606333691,CSE 293,031,094935,Savage; Stefan,9999,0,9999,0
1653606333691,CSE 293,032,094936,Schulze; Jurgen P.,9999,0,9999,0
1653606333691,CSE 293,033,094937,Snoeren; Alex C.,9999,0,9999,0
1653606333691,CSE 293,034,094938,Shang; Jingbo,9999,0,9999,0
1653606333691,CSE 293,035,094939,Stefan; Deian,9999,0,9999,0
1653606333691,CSE 293,036,094940,Su; Hao,9999,0,9999,0
1653606333691,CSE 293,037,094941,Swanson; Steven James,9999,0,9999,0
1653606333691,CSE 293,038,094942,Tullsen; Dean Michael,9999,0,9999,0
1653606333691,CSE 293,039,094943,Voelker; Geoffrey M.,9999,0,9999,0
1653606333691,CSE 293,040,094944,Zhao; Jishen,9999,0,9999,0
1653606333691,CSE 293,041,094945,Zhou; Yuan-Yuan,9999,0,9999,0
1653606333691,CSE 293,042,094946,Gao; Sicun,9998,0,9999,1
1653606333691,CSE 293,043,094947,Weibel; Nadir,9999,0,9999,0
1653606333691,CSE 293,044,094948,Gupta; Rajesh K.,9999,0,9999,0
1653606334223,CSE 294,A00,090143,Porter; George M,8,0,10,2
1653606334744,DSE 200,A00,091799,Staff,50,0,50,0
1653606335353,DSE 203,A00,091800,Gupta; Amarnath,30,0,30,0
1653606335886,DSE 250,A00,091801,Deutsch; Alin Bernard,30,0,30,0
1653606336416,DSE 290,A00,091802,Altintas De Callaf; Ilkay,50,0,50,0
1653606336957,ECE 200,001,091003,Antipa; Nicholas A,9999,0,9999,0
1653606336957,ECE 200,002,091004,Atanasov; Nikolay A.,9999,0,9999,0
1653606336957,ECE 200,003,091005,Bharadia; Dinesh,9999,0,9999,0
1653606336957,ECE 200,004,091006,Cheng; Chung Kuan,9999,0,9999,0
1653606336957,ECE 200,005,091007,Cosman; Pamela C.,9999,0,9999,0
1653606336957,ECE 200,006,091008,Staff,9999,0,9999,0
1653606336957,ECE 200,007,091009,Dayeh; Shadi Ahmad,9999,0,9999,0
1653606336957,ECE 200,008,091010,Fainman; Yeshaiahu,9999,0,9999,0
1653606336957,ECE 200,009,091011,Ford; Joseph Earl,9999,0,9999,0
1653606336957,ECE 200,010,091012,Franceschetti; Massimo,9999,0,9999,0
1653606336957,ECE 200,011,091013,Fullerton; Eric E,9999,0,9999,0
1653606336957,ECE 200,012,091014,Galton; Ian A,9999,0,9999,0
1653606336957,ECE 200,013,091015,Gilja; Vikash,9999,0,9999,0
1653606336957,ECE 200,014,091016,Hall; Drew A.,9999,0,9999,0
1653606336957,ECE 200,015,091017,Hsueh; Tzu-Chien,9999,0,9999,0
1653606336957,ECE 200,016,091018,Javidi; Tara,9999,0,9999,0
1653606336957,ECE 200,017,091019,Kahng; Andrew Byun,9999,0,9999,0
1653606336957,ECE 200,018,091020,Kim; Young-Han,9999,0,9999,0
1653606336957,ECE 200,019,091021,Koushanfar; Farinaz,9999,0,9999,0
1653606336957,ECE 200,020,091022,Kuzum; Duygu,9999,0,9999,0
1653606336957,ECE 200,021,091023,Le; Hanh-Phuc,9999,0,9999,0
1653606336957,ECE 200,022,091024,Lin; Bill,9999,0,9999,0
1653606336957,ECE 200,023,091025,Liu; Zhaowei,9999,0,9999,0
1653606336957,ECE 200,024,091026,Lo; Yu-Hwa,9999,0,9999,0
1653606336957,ECE 200,025,091027,Lomakin; Vitaliy,9999,0,9999,0
1653606336957,ECE 200,026,091028,Mercier; Patrick Philip,9999,0,9999,0
1653606336957,ECE 200,027,091029,Meyer; Florian,9999,0,9999,0
1653606336957,ECE 200,028,091030,Milstein; Laurence B.,9999,0,9999,0
1653606336957,ECE 200,029,091031,Mir Arabbaygi; Siavash,9999,0,9999,0
1653606336957,ECE 200,030,091032,Mookherjea; Shayan,9999,0,9999,0
1653606336957,ECE 200,031,091033,Morris; Karcher William,9999,0,9999,0
1653606336957,ECE 200,032,091034,Ng; Tse Nga,9999,0,9999,0
1653606336957,ECE 200,033,091035,Nguyen; Truong Quang,9999,0,9999,0
1653606336957,ECE 200,034,091036,Nomura; Kenji,9999,0,9999,0
1653606336957,ECE 200,035,091037,Orlitsky; Alon,9999,0,9999,0
1653606336957,ECE 200,036,091038,Pal; Piya,9999,0,9999,0
1653606336957,ECE 200,037,091039,Papen; George C.,9999,0,9999,0
1653606336957,ECE 200,038,091040,Radic; Stojan,9999,0,9999,0
1653606336957,ECE 200,039,091041,Rao; Bhaskar D.,9999,0,9999,0
1653606336957,ECE 200,040,091042,Rao; Ramesh R,9999,0,9999,0
1653606336957,ECE 200,041,091043,Rebeiz; Gabriel,9999,0,9999,0
1653606336957,ECE 200,042,091044,Sanford; John R,9999,0,9999,0
1653606336957,ECE 200,043,091045,Siegel; Paul H.,9999,0,9999,0
1653606336957,ECE 200,044,091046,Sievenpiper; Daniel F.,9999,0,9999,0
1653606336957,ECE 200,045,091047,Sworder; David D.,9999,0,9999,0
1653606336957,ECE 200,046,091048,Taur; Yuan,9999,0,9999,0
1653606336957,ECE 200,047,091049,Touri; Behrouz,9999,0,9999,0
1653606336957,ECE 200,048,091050,Trivedi; Mohan M.,9999,0,9999,0
1653606336957,ECE 200,049,091051,Vardy; Alexander,9999,0,9999,0
1653606336957,ECE 200,050,091052,Vasconcelos; Nuno,9999,0,9999,0
1653606336957,ECE 200,051,091053,Wang; Xiaolong,9999,0,9999,0
1653606336957,ECE 200,052,091054,Xie; Pengtao,9999,0,9999,0
1653606336957,ECE 200,053,091055,Yip; Michael,9999,0,9999,0
1653606336957,ECE 200,054,091056,Zeger; Kenneth A.,9999,0,9999,0
1653606336957,ECE 200,055,091057,Zhang; Xinyu,9999,0,9999,0
1653606336957,ECE 200,056,091058,Turakhia; Yatish Girish,9999,0,9999,0
1653606336957,ECE 200,057,091059,Kang; Mingu,9999,0,9999,0
1653606336957,ECE 200,058,091060,Shi; Yuanyuan,9999,0,9999,0
1653606336957,ECE 200,059,091061,Wang; Edward Jay,9999,0,9999,0
1653606336957,ECE 200,060,091062,Zheng; Yang,9999,0,9999,0
1653606337479,ECE 201,A00,095526,Lo; Yu-Hwa,0,0,0,0
1653606338006,ECE 203,A00,091065,Mercier; Patrick Philip,0,0,0,0
1653606338529,ECE 207A,A00,091605,Liu; Thomas Tao-Ming,0,0,0,0
1653606339064,ECE 212AN,A00,091068,Nomura; Kenji,0,0,0,0
1653606339587,ECE 222A,A00,091069,Rebeiz; Gabriel,0,0,0,0
1653606340112,ECE 225A,A00,091070,Orlitsky; Alon,0,0,0,0
1653606340637,ECE 230A,A00,091071,Nomura; Kenji,0,0,0,0
1653606341172,ECE 236A,A00,091072,Dayeh; Shadi Ahmad,0,0,0,0
1653606341699,ECE 238A,A00,091073,Luo; Jian,0,0,0,0
1653606341699,ECE 238A,B00,091074,Luo; Jian,0,0,0,0
1653606342220,ECE 240A,A00,091075,Radic; Stojan,0,0,0,0
1653606342750,ECE 247A,A00,091592,Shi; Lingyan,0,0,0,0
1653606343278,ECE 250,A00,091076,Touri; Behrouz,0,0,0,0
1653606343800,ECE 251C,A00,091078,Nguyen; Truong Quang,0,0,0,0
1653606344324,ECE 253,A00,091079,Cosman; Pamela C.,0,0,0,0
1653606344847,ECE 255A,A00,091080,Orlitsky; Alon,0,0,0,0
1653606345382,ECE 257A,A00,091081,Zhang; Xinyu,0,0,0,0
1653606345905,ECE 260A,A01,091084,Eldon; John,0,0,0,0
1653606346428,ECE 264C,A00,091085,Galton; Ian A,0,0,0,0
1653606346966,ECE 265C,A00,094889,Presti; Calogero Davide,0,0,0,9
1653606347489,ECE 266,A01,091087,Hall; Drew A.,0,0,0,0
1653606348540,ECE 271A,A00,091090,Vasconcelos; Nuno,0,0,0,0
1653606349065,ECE 272B,A00,091091,Sworder; David D.,0,0,0,0
1653606349587,ECE 275A,A00,091092,Meyer; Florian,0,0,0,0
1653606350110,ECE 277,A00,091093,An; Cheolhong,0,0,0,0
1653606350636,ECE 283,A00,091094,Le; Hanh-Phuc,0,0,0,0
1653606351173,ECE 284,A00,091095,Kang; Mingu,0,0,0,0
1653606351173,ECE 284,B00,091096,Wang; Edward Jay,0,0,0,0
1653606351698,ECE 285,A00,094334,Touri; Behrouz,0,0,0,0
1653606352224,ECE 289,A00,091097,Whelan; David Arthur,0,0,0,0
1653606352748,MATH 200A,A00,087414,Salehi Golsefidy; Alireza,7,0,8,1
1653606353273,MATH 202A,A00,087415,Gill; Philip E.,2,0,8,6
1653606353795,MATH 203A,A00,087416,Oprea; Dragos N.,6,0,8,2
1653606354317,MATH 204A,A00,087417,Kedlaya; Kiran S.,6,0,8,2
1653606354839,MATH 205,A00,087418,Sorensen; Claus M,6,0,8,2
1653606355366,MATH 206A,A00,087419,Izadi; Elham,7,0,8,1
1653606355888,MATH 207A,A00,087420,Mohammadi; Amir,5,0,8,3
1653606356410,MATH 208,A00,087421,Staff,9,0,10,1
1653606356936,MATH 209,A00,087422,Staff,10,0,10,0
1653606357462,MATH 218,A00,087423,Staff,10,0,10,0
1653606357989,MATH 220A,A00,087424,Novak; Jonathan I,6,0,8,2
1653606358511,MATH 231A,A00,087425,Bejenaru; Ioan,3,0,8,5
1653606359037,MATH 240A,A00,087426,Ebenfelt; Peter F,5,0,8,3
1653606359567,MATH 243,A00,087427,Staff,9,0,10,1
1653606360091,MATH 248,A00,087429,Staff,10,0,10,0
1653606360615,MATH 250A,A00,087430,Spolaor; Luca,4,0,8,4
1653606361141,MATH 257A,A00,087431,Spolaor; Luca,7,0,8,1
1653606361663,MATH 258,A00,087432,Staff,9,0,10,1
1653606362193,MATH 264A,A00,087433,Warnke; Lutz Peter,5,0,8,3
1653606362726,MATH 268,A00,087434,Staff,15,0,15,0
1653606363272,MATH 269,A00,087435,Staff,14,0,15,1
1653606363812,MATH 270A,A00,087436,Nie; Jiawang,0,0,8,8
1653606364337,MATH 272A,A00,087437,Tian; Xiaochuan,0,0,8,8
1653606364870,MATH 274,A01,087439,Cheng; Li-Tien,9,0,10,1
1653606364870,MATH 274,A02,087440,Cheng; Li-Tien,10,0,10,0
1653606365393,MATH 278A,A00,087441,Staff,8,0,10,2
1653606365926,MATH 278B,A00,087442,Staff,8,0,10,2
1653606366447,MATH 278C,A00,087443,Staff,8,0,10,2
1653606366970,MATH 280A,A00,087444,Zheng; Tianyi,0,0,8,8
1653606367492,MATH 281A,A00,087445,Bradic; Jelena,0,0,8,8
1653606368018,MATH 282A,A00,087446,Zhang; Danna,0,0,8,8
1653606368540,MATH 283,A00,087447,Tesler; Glenn,0,0,0,16
1653606369069,MATH 286,B00,095535,Kemp; Todd Aahron,6,0,8,2
1653606369595,MATH 287D,B00,095536,Bradic; Jelena,5,0,8,3
1653606370127,MATH 288,A00,087450,Staff,14,0,15,1
1653606370127,MATH 288,B00,087451,Staff,15,0,15,0
1653606370127,MATH 288,C00,087452,Staff,15,0,15,0
1653606370658,MATH 290A,A00,087453,Xu; Zhouli,6,0,8,2
1653606371180,MATH 291A,A00,087454,Xu; Zhouli,7,0,8,1
1653606371711,MATH 292,A00,087455,Staff,10,0,10,0
1653606372236,MATH 295,A00,087456,Staff,50,0,50,0
1653606372763,MATH 297,001,087457,Staff,997,0,999,2
1653606933358,COGS 200,A01,087991,Staff,47,0,50,3
1653606933881,COGS 201,A01,094504,Rangel; Lara M,16,0,25,9
1653606934407,COGS 203,A00,087992,Coulson; Seana M,18,0,20,2
1653606934940,COGS 210A,001,087993,Greene; Deanna Jacquelyn,9998,0,9999,1
1653606934940,COGS 210A,002,087994,Saygin; Ayse P,9999,0,9999,0
1653606934940,COGS 210A,003,087995,Xia; Haijun,9999,0,9999,0
1653606934940,COGS 210A,004,087996,Nitz; Douglas A.,9999,0,9999,0
1653606934940,COGS 210A,005,087997,Hollan; James D.,9999,0,9999,0
1653606934940,COGS 210A,006,087998,Deak; Gedeon O.,9998,0,9999,1
1653606934940,COGS 210A,007,087999,Rossano; Federico,9999,0,9999,0
1653606935466,COGS 211A,A00,088000,Coulson; Seana M,9997,0,9999,2
1653606935995,COGS 229,A00,088002,Staff,22,0,25,3
1653606936524,COGS 260,B00,094231,Staff,17,0,20,3
1653606936524,COGS 260,A00,088004,Nitz; Douglas A.,9998,0,9999,1
1653606937051,CSE 202,A00,090110,Paturi; Ramamohan,0,0,0,0
1653606937051,CSE 202,B00,090111,Paturi; Ramamohan,0,0,0,0
1653606937574,CSE 207B,A00,090112,Heninger; Nadia A,0,0,0,0
1653606938101,CSE 208,A00,094858,Micciancio; Daniele,0,0,0,0
1653606938630,CSE 210,A00,090113,Powell; Thomas Allan,0,0,0,0
1653606939152,CSE 219,A00,090898,Staff,0,0,0,0
1653606939679,CSE 221,A00,090114,Zhou; Yuan-Yuan,0,0,0,0
1653606940202,CSE 229A,A00,090115,Porter; George M,0,0,0,0
1653606940723,CSE 229C,A00,090116,Savage; Stefan,0,0,0,0
1653606941246,CSE 230,A00,090117,Jhala; Ranjit,0,0,0,0
1653606941769,CSE 232,A00,090118,Papakonstantinou; Yannis,0,0,0,0
1653606942291,CSE 239A,A00,090121,Kumar; Arun Kumar,0,0,0,0
1653606942816,CSE 239B,A00,090122,Jhala; Ranjit,0,0,0,0
1653606943350,CSE 240A,A00,090123,Zhao; Jishen,0,0,189,189
1653606943875,CSE 243A,A00,090124,Orailoglu; Alex,0,0,15,15
1653606944424,CSE 249B,A00,090125,Kahng; Andrew Byun,12,0,20,8
1653606944949,CSE 250A,A00,090126,Berg-Kirkpatrick; Taylor D,0,0,0,0
1653606945471,CSE 252A,A00,090127,Ochoa; Benjamin Lawrence,0,0,0,0
1653606945994,CSE 258,A01,090129,McAuley; Julian John,0,0,0,0
1653606946518,CSE 258R,A01,090131,McAuley; Julian John,0,0,0,0
1653606947044,CSE 274,A00,090132,Ramamoorthi; Ravi,0,0,0,0
1653606947566,CSE 276A,A00,090133,Christensen; Henrik I,0,0,0,0
1653606948087,CSE 276C,A00,090134,Christensen; Henrik I,0,0,0,0
1653606948609,CSE 290,A00,090135,Bafna; Vineet,0,0,0,0
1653606948609,CSE 290,B00,090136,Ramamoorthi; Ravi,0,0,0,0
1653606948609,CSE 290,C00,090137,Li; Tzumao,7,0,10,3
1653606948609,CSE 290,D00,090138,Zhou; Yuan-Yuan,9,0,10,1
1653606948609,CSE 290,E00,090139,Christensen; Henrik I,8,0,10,2
1653606948609,CSE 290,F00,094053,Shalev; Aaron D,0,0,0,0
1653606949148,CSE 291,A00,090140,Munyaka; Imani N. S.,0,0,0,0
1653606949148,CSE 291,B00,094880,Yu; Qi,0,0,0,0
1653606949148,CSE 291,C00,090142,Pannuto; Patrick William,0,0,0,0
1653606949148,CSE 291,D00,094881,Zhang; Yiying,0,0,0,0
1653606949148,CSE 291,E00,095118,Su; Hao,0,0,0,0
1653606949674,CSE 293,001,094905,Bafna; Vineet,9999,0,9999,0
1653606949674,CSE 293,002,094906,Bellare; Mihir,9999,0,9999,0
1653606949674,CSE 293,003,094907,Berg-Kirkpatrick; Taylor D,9999,0,9999,0
1653606949674,CSE 293,004,094908,Christensen; Henrik I,9999,0,9999,0
1653606949674,CSE 293,005,094909,Cottrell; Garrison W,9999,0,9999,0
1653606949674,CSE 293,006,094910,Deutsch; Alin Bernard,9999,0,9999,0
1653606949674,CSE 293,007,094911,Esmaeilzadeh; Hadi,9999,0,9999,0
1653606949674,CSE 293,008,094912,Freund; Yoav,9999,0,9999,0
1653606949674,CSE 293,009,094913,Griswold; William G.,9999,0,9999,0
1653606949674,CSE 293,010,094914,Gymrek; Melissa Ann,9999,0,9999,0
1653606949674,CSE 293,011,094915,Heninger; Nadia A,9999,0,9999,0
1653606949674,CSE 293,012,094916,Impagliazzo; Russell,9999,0,9999,0
1653606949674,CSE 293,013,094917,Jhala; Ranjit,9999,0,9999,0
1653606949674,CSE 293,014,094918,Kahng; Andrew Byun,9999,0,9999,0
1653606949674,CSE 293,015,094919,Kane; Daniel Mertz,9999,0,9999,0
1653606949674,CSE 293,016,094920,Kriegman; David J,9999,0,9999,0
1653606949674,CSE 293,017,094921,Kumar; Arun Kumar,9999,0,9999,0
1653606949674,CSE 293,018,094922,Lerner; Sorin,9999,0,9999,0
1653606949674,CSE 293,019,094923,Lovett; Shachar,9999,0,9999,0
1653606949674,CSE 293,020,094924,McAuley; Julian John,9999,0,9999,0
1653606949674,CSE 293,021,094925,Micciancio; Daniele,9999,0,9999,0
1653606949674,CSE 293,022,094926,Orailoglu; Alex,9999,0,9999,0
1653606949674,CSE 293,023,094927,Paturi; Ramamohan,9999,0,9999,0
1653606949674,CSE 293,024,094928,Polikarpova; Nadezhda,9999,0,9999,0
1653606949674,CSE 293,025,094929,Politz; Joseph Gibbs,9999,0,9999,0
1653606949674,CSE 293,026,094930,Porter; George M,9999,0,9999,0
1653606949674,CSE 293,027,094931,Porter; Leonard Emerson,9999,0,9999,0
1653606949674,CSE 293,028,094932,Ramamoorthi; Ravi,9999,0,9999,0
1653606949674,CSE 293,029,094933,Sahoo; Debashis,9999,0,9999,0
1653606949674,CSE 293,030,094934,Saul; Lawrence,9999,0,9999,0
1653606949674,CSE 293,031,094935,Savage; Stefan,9999,0,9999,0
1653606949674,CSE 293,032,094936,Schulze; Jurgen P.,9999,0,9999,0
1653606949674,CSE 293,033,094937,Snoeren; Alex C.,9999,0,9999,0
1653606949674,CSE 293,034,094938,Shang; Jingbo,9999,0,9999,0
1653606949674,CSE 293,035,094939,Stefan; Deian,9999,0,9999,0
1653606949674,CSE 293,036,094940,Su; Hao,9999,0,9999,0
1653606949674,CSE 293,037,094941,Swanson; Steven James,9999,0,9999,0
1653606949674,CSE 293,038,094942,Tullsen; Dean Michael,9999,0,9999,0
1653606949674,CSE 293,039,094943,Voelker; Geoffrey M.,9999,0,9999,0
1653606949674,CSE 293,040,094944,Zhao; Jishen,9999,0,9999,0
1653606949674,CSE 293,041,094945,Zhou; Yuan-Yuan,9999,0,9999,0
1653606949674,CSE 293,042,094946,Gao; Sicun,9998,0,9999,1
1653606949674,CSE 293,043,094947,Weibel; Nadir,9999,0,9999,0
1653606949674,CSE 293,044,094948,Gupta; Rajesh K.,9999,0,9999,0
1653606950197,CSE 294,A00,090143,Porter; George M,8,0,10,2
1653606950722,DSE 200,A00,091799,Staff,50,0,50,0
1653606951253,DSE 203,A00,091800,Gupta; Amarnath,30,0,30,0
1653606951775,DSE 250,A00,091801,Deutsch; Alin Bernard,30,0,30,0
1653606952301,DSE 290,A00,091802,Altintas De Callaf; Ilkay,50,0,50,0
1653606952830,ECE 200,001,091003,Antipa; Nicholas A,9999,0,9999,0
1653606952830,ECE 200,002,091004,Atanasov; Nikolay A.,9999,0,9999,0
1653606952830,ECE 200,003,091005,Bharadia; Dinesh,9999,0,9999,0
1653606952830,ECE 200,004,091006,Cheng; Chung Kuan,9999,0,9999,0
1653606952830,ECE 200,005,091007,Cosman; Pamela C.,9999,0,9999,0
1653606952830,ECE 200,006,091008,Staff,9999,0,9999,0
1653606952830,ECE 200,007,091009,Dayeh; Shadi Ahmad,9999,0,9999,0
1653606952830,ECE 200,008,091010,Fainman; Yeshaiahu,9999,0,9999,0
1653606952830,ECE 200,009,091011,Ford; Joseph Earl,9999,0,9999,0
1653606952830,ECE 200,010,091012,Franceschetti; Massimo,9999,0,9999,0
1653606952830,ECE 200,011,091013,Fullerton; Eric E,9999,0,9999,0
1653606952830,ECE 200,012,091014,Galton; Ian A,9999,0,9999,0
1653606952830,ECE 200,013,091015,Gilja; Vikash,9999,0,9999,0
1653606952830,ECE 200,014,091016,Hall; Drew A.,9999,0,9999,0
1653606952830,ECE 200,015,091017,Hsueh; Tzu-Chien,9999,0,9999,0
1653606952830,ECE 200,016,091018,Javidi; Tara,9999,0,9999,0
1653606952830,ECE 200,017,091019,Kahng; Andrew Byun,9999,0,9999,0
1653606952830,ECE 200,018,091020,Kim; Young-Han,9999,0,9999,0
1653606952830,ECE 200,019,091021,Koushanfar; Farinaz,9999,0,9999,0
1653606952830,ECE 200,020,091022,Kuzum; Duygu,9999,0,9999,0
1653606952830,ECE 200,021,091023,Le; Hanh-Phuc,9999,0,9999,0
1653606952830,ECE 200,022,091024,Lin; Bill,9999,0,9999,0
1653606952830,ECE 200,023,091025,Liu; Zhaowei,9999,0,9999,0
1653606952830,ECE 200,024,091026,Lo; Yu-Hwa,9999,0,9999,0
1653606952830,ECE 200,025,091027,Lomakin; Vitaliy,9999,0,9999,0
1653606952830,ECE 200,026,091028,Mercier; Patrick Philip,9999,0,9999,0
1653606952830,ECE 200,027,091029,Meyer; Florian,9999,0,9999,0
1653606952830,ECE 200,028,091030,Milstein; Laurence B.,9999,0,9999,0
1653606952830,ECE 200,029,091031,Mir Arabbaygi; Siavash,9999,0,9999,0
1653606952830,ECE 200,030,091032,Mookherjea; Shayan,9999,0,9999,0
1653606952830,ECE 200,031,091033,Morris; Karcher William,9999,0,9999,0
1653606952830,ECE 200,032,091034,Ng; Tse Nga,9999,0,9999,0
1653606952830,ECE 200,033,091035,Nguyen; Truong Quang,9999,0,9999,0
1653606952830,ECE 200,034,091036,Nomura; Kenji,9999,0,9999,0
1653606952830,ECE 200,035,091037,Orlitsky; Alon,9999,0,9999,0
1653606952830,ECE 200,036,091038,Pal; Piya,9999,0,9999,0
1653606952830,ECE 200,037,091039,Papen; George C.,9999,0,9999,0
1653606952830,ECE 200,038,091040,Radic; Stojan,9999,0,9999,0
1653606952830,ECE 200,039,091041,Rao; Bhaskar D.,9999,0,9999,0
1653606952830,ECE 200,040,091042,Rao; Ramesh R,9999,0,9999,0
1653606952830,ECE 200,041,091043,Rebeiz; Gabriel,9999,0,9999,0
1653606952830,ECE 200,042,091044,Sanford; John R,9999,0,9999,0
1653606952830,ECE 200,043,091045,Siegel; Paul H.,9999,0,9999,0
1653606952830,ECE 200,044,091046,Sievenpiper; Daniel F.,9999,0,9999,0
1653606952830,ECE 200,045,091047,Sworder; David D.,9999,0,9999,0
1653606952830,ECE 200,046,091048,Taur; Yuan,9999,0,9999,0
1653606952830,ECE 200,047,091049,Touri; Behrouz,9999,0,9999,0
1653606952830,ECE 200,048,091050,Trivedi; Mohan M.,9999,0,9999,0
1653606952830,ECE 200,049,091051,Vardy; Alexander,9999,0,9999,0
1653606952830,ECE 200,050,091052,Vasconcelos; Nuno,9999,0,9999,0
1653606952830,ECE 200,051,091053,Wang; Xiaolong,9999,0,9999,0
1653606952830,ECE 200,052,091054,Xie; Pengtao,9999,0,9999,0
1653606952830,ECE 200,053,091055,Yip; Michael,9999,0,9999,0
1653606952830,ECE 200,054,091056,Zeger; Kenneth A.,9999,0,9999,0
1653606952830,ECE 200,055,091057,Zhang; Xinyu,9999,0,9999,0
1653606952830,ECE 200,056,091058,Turakhia; Yatish Girish,9999,0,9999,0
1653606952830,ECE 200,057,091059,Kang; Mingu,9999,0,9999,0
1653606952830,ECE 200,058,091060,Shi; Yuanyuan,9999,0,9999,0
1653606952830,ECE 200,059,091061,Wang; Edward Jay,9999,0,9999,0
1653606952830,ECE 200,060,091062,Zheng; Yang,9999,0,9999,0
1653606953355,ECE 201,A00,095526,Lo; Yu-Hwa,0,0,0,0
1653606953886,ECE 203,A00,091065,Mercier; Patrick Philip,0,0,0,0
1653606954409,ECE 207A,A00,091605,Liu; Thomas Tao-Ming,0,0,0,0
1653606954935,ECE 212AN,A00,091068,Nomura; Kenji,0,0,0,0
1653606955459,ECE 222A,A00,091069,Rebeiz; Gabriel,0,0,0,0
1653606955993,ECE 225A,A00,091070,Orlitsky; Alon,0,0,0,0
1653606956515,ECE 230A,A00,091071,Nomura; Kenji,0,0,0,0
1653606957044,ECE 236A,A00,091072,Dayeh; Shadi Ahmad,0,0,0,0
1653606957575,ECE 238A,A00,091073,Luo; Jian,0,0,0,0
1653606957575,ECE 238A,B00,091074,Luo; Jian,0,0,0,0
1653606958098,ECE 240A,A00,091075,Radic; Stojan,0,0,0,0
1653606958623,ECE 247A,A00,091592,Shi; Lingyan,0,0,0,0
1653606959148,ECE 250,A00,091076,Touri; Behrouz,0,0,0,0
1653606959671,ECE 251C,A00,091078,Nguyen; Truong Quang,0,0,0,0
1653606960197,ECE 253,A00,091079,Cosman; Pamela C.,0,0,0,0
1653606960724,ECE 255A,A00,091080,Orlitsky; Alon,0,0,0,0
1653606961251,ECE 257A,A00,091081,Zhang; Xinyu,0,0,0,0
1653606961778,ECE 260A,A01,091084,Eldon; John,0,0,0,0
1653606962300,ECE 264C,A00,091085,Galton; Ian A,0,0,0,0
1653606962824,ECE 265C,A00,094889,Presti; Calogero Davide,0,0,0,9
1653606963346,ECE 266,A01,091087,Hall; Drew A.,0,0,0,0
1653606964395,ECE 271A,A00,091090,Vasconcelos; Nuno,0,0,0,0
1653606964921,ECE 272B,A00,091091,Sworder; David D.,0,0,0,0
1653606965445,ECE 275A,A00,091092,Meyer; Florian,0,0,0,0
1653606965968,ECE 277,A00,091093,An; Cheolhong,0,0,0,0
1653606966491,ECE 283,A00,091094,Le; Hanh-Phuc,0,0,0,0
1653606967022,ECE 284,A00,091095,Kang; Mingu,0,0,0,0
1653606967022,ECE 284,B00,091096,Wang; Edward Jay,0,0,0,0
1653606967549,ECE 285,A00,094334,Touri; Behrouz,0,0,0,0
1653606968074,ECE 289,A00,091097,Whelan; David Arthur,0,0,0,0
1653606968609,MATH 200A,A00,087414,Salehi Golsefidy; Alireza,7,0,8,1
1653606969130,MATH 202A,A00,087415,Gill; Philip E.,2,0,8,6
1653606969655,MATH 203A,A00,087416,Oprea; Dragos N.,6,0,8,2
1653606970194,MATH 204A,A00,087417,Kedlaya; Kiran S.,6,0,8,2
1653606970722,MATH 205,A00,087418,Sorensen; Claus M,6,0,8,2
1653606971245,MATH 206A,A00,087419,Izadi; Elham,7,0,8,1
1653606971768,MATH 207A,A00,087420,Mohammadi; Amir,5,0,8,3
1653606972298,MATH 208,A00,087421,Staff,9,0,10,1
1653606972821,MATH 209,A00,087422,Staff,10,0,10,0
1653606973359,MATH 218,A00,087423,Staff,10,0,10,0
1653606973882,MATH 220A,A00,087424,Novak; Jonathan I,6,0,8,2
1653606974415,MATH 231A,A00,087425,Bejenaru; Ioan,3,0,8,5
1653606974939,MATH 240A,A00,087426,Ebenfelt; Peter F,5,0,8,3
1653606975463,MATH 243,A00,087427,Staff,9,0,10,1
1653606975994,MATH 248,A00,087429,Staff,10,0,10,0
1653606976595,MATH 250A,A00,087430,Spolaor; Luca,4,0,8,4
1653606977118,MATH 257A,A00,087431,Spolaor; Luca,7,0,8,1
1653606977643,MATH 258,A00,087432,Staff,9,0,10,1
1653606978165,MATH 264A,A00,087433,Warnke; Lutz Peter,5,0,8,3
1653606978690,MATH 268,A00,087434,Staff,15,0,15,0
1653606979226,MATH 269,A00,087435,Staff,14,0,15,1
1653606979757,MATH 270A,A00,087436,Nie; Jiawang,0,0,8,8
1653606980288,MATH 272A,A00,087437,Tian; Xiaochuan,0,0,8,8
1653606980815,MATH 274,A01,087439,Cheng; Li-Tien,9,0,10,1
1653606980815,MATH 274,A02,087440,Cheng; Li-Tien,10,0,10,0
1653606981348,MATH 278A,A00,087441,Staff,8,0,10,2
1653606981873,MATH 278B,A00,087442,Staff,8,0,10,2
1653606982396,MATH 278C,A00,087443,Staff,8,0,10,2
1653606982923,MATH 280A,A00,087444,Zheng; Tianyi,0,0,8,8
1653606983446,MATH 281A,A00,087445,Bradic; Jelena,0,0,8,8
1653606983978,MATH 282A,A00,087446,Zhang; Danna,0,0,8,8
1653606984501,MATH 283,A00,087447,Tesler; Glenn,0,0,0,16
1653606985023,MATH 286,B00,095535,Kemp; Todd Aahron,6,0,8,2
1653606985549,MATH 287D,B00,095536,Bradic; Jelena,5,0,8,3
1653606986071,MATH 288,A00,087450,Staff,14,0,15,1
1653606986071,MATH 288,B00,087451,Staff,15,0,15,0
1653606986071,MATH 288,C00,087452,Staff,15,0,15,0
1653606986610,MATH 290A,A00,087453,Xu; Zhouli,6,0,8,2
1653606987136,MATH 291A,A00,087454,Xu; Zhouli,7,0,8,1
1653606987659,MATH 292,A00,087455,Staff,10,0,10,0
1653606988182,MATH 295,A00,087456,Staff,50,0,50,0
1653606988716,MATH 297,001,087457,Staff,997,0,999,2
1653607558356,COGS 200,A01,087991,Staff,47,0,50,3
1653607558885,COGS 201,A01,094504,Rangel; Lara M,16,0,25,9
1653607559410,COGS 203,A00,087992,Coulson; Seana M,18,0,20,2
1653607559933,COGS 210A,001,087993,Greene; Deanna Jacquelyn,9998,0,9999,1
1653607559933,COGS 210A,002,087994,Saygin; Ayse P,9999,0,9999,0
1653607559933,COGS 210A,003,087995,Xia; Haijun,9999,0,9999,0
1653607559933,COGS 210A,004,087996,Nitz; Douglas A.,9999,0,9999,0
1653607559933,COGS 210A,005,087997,Hollan; James D.,9999,0,9999,0
1653607559933,COGS 210A,006,087998,Deak; Gedeon O.,9998,0,9999,1
1653607559933,COGS 210A,007,087999,Rossano; Federico,9999,0,9999,0
1653607560457,COGS 211A,A00,088000,Coulson; Seana M,9997,0,9999,2
1653607560979,COGS 229,A00,088002,Staff,22,0,25,3
1653607561501,COGS 260,B00,094231,Staff,17,0,20,3
1653607561501,COGS 260,A00,088004,Nitz; Douglas A.,9998,0,9999,1
1653607562031,CSE 202,A00,090110,Paturi; Ramamohan,0,0,0,0
1653607562031,CSE 202,B00,090111,Paturi; Ramamohan,0,0,0,0
1653607562553,CSE 207B,A00,090112,Heninger; Nadia A,0,0,0,0
1653607563085,CSE 208,A00,094858,Micciancio; Daniele,0,0,0,0
1653607563611,CSE 210,A00,090113,Powell; Thomas Allan,0,0,0,0
1653607564133,CSE 219,A00,090898,Staff,0,0,0,0
1653607564661,CSE 221,A00,090114,Zhou; Yuan-Yuan,0,0,0,0
1653607565187,CSE 229A,A00,090115,Porter; George M,0,0,0,0
1653607565711,CSE 229C,A00,090116,Savage; Stefan,0,0,0,0
1653607566235,CSE 230,A00,090117,Jhala; Ranjit,0,0,0,0
1653607566762,CSE 232,A00,090118,Papakonstantinou; Yannis,0,0,0,0
1653607567284,CSE 239A,A00,090121,Kumar; Arun Kumar,0,0,0,0
1653607567810,CSE 239B,A00,090122,Jhala; Ranjit,0,0,0,0
1653607568336,CSE 240A,A00,090123,Zhao; Jishen,0,0,189,189
1653607568860,CSE 243A,A00,090124,Orailoglu; Alex,0,0,15,15
1653607569388,CSE 249B,A00,090125,Kahng; Andrew Byun,12,0,20,8
1653607569910,CSE 250A,A00,090126,Berg-Kirkpatrick; Taylor D,0,0,0,0
1653607570438,CSE 252A,A00,090127,Ochoa; Benjamin Lawrence,0,0,0,0
1653607570963,CSE 258,A01,090129,McAuley; Julian John,0,0,0,0
1653607571489,CSE 258R,A01,090131,McAuley; Julian John,0,0,0,0
1653607572015,CSE 274,A00,090132,Ramamoorthi; Ravi,0,0,0,0
1653607572543,CSE 276A,A00,090133,Christensen; Henrik I,0,0,0,0
1653607573066,CSE 276C,A00,090134,Christensen; Henrik I,0,0,0,0
1653607573678,CSE 290,A00,090135,Bafna; Vineet,0,0,0,0
1653607573678,CSE 290,B00,090136,Ramamoorthi; Ravi,0,0,0,0
1653607573678,CSE 290,C00,090137,Li; Tzumao,7,0,10,3
1653607573678,CSE 290,D00,090138,Zhou; Yuan-Yuan,9,0,10,1
1653607573678,CSE 290,E00,090139,Christensen; Henrik I,8,0,10,2
1653607573678,CSE 290,F00,094053,Shalev; Aaron D,0,0,0,0
1653607574209,CSE 291,A00,090140,Munyaka; Imani N. S.,0,0,0,0
1653607574209,CSE 291,B00,094880,Yu; Qi,0,0,0,0
1653607574209,CSE 291,C00,090142,Pannuto; Patrick William,0,0,0,0
1653607574209,CSE 291,D00,094881,Zhang; Yiying,0,0,0,0
1653607574209,CSE 291,E00,095118,Su; Hao,0,0,0,0
1653607574753,CSE 293,001,094905,Bafna; Vineet,9999,0,9999,0
1653607574753,CSE 293,002,094906,Bellare; Mihir,9999,0,9999,0
1653607574753,CSE 293,003,094907,Berg-Kirkpatrick; Taylor D,9999,0,9999,0
1653607574753,CSE 293,004,094908,Christensen; Henrik I,9999,0,9999,0
1653607574753,CSE 293,005,094909,Cottrell; Garrison W,9999,0,9999,0
1653607574753,CSE 293,006,094910,Deutsch; Alin Bernard,9999,0,9999,0
1653607574753,CSE 293,007,094911,Esmaeilzadeh; Hadi,9999,0,9999,0
1653607574753,CSE 293,008,094912,Freund; Yoav,9999,0,9999,0
1653607574753,CSE 293,009,094913,Griswold; William G.,9999,0,9999,0
1653607574753,CSE 293,010,094914,Gymrek; Melissa Ann,9999,0,9999,0
1653607574753,CSE 293,011,094915,Heninger; Nadia A,9999,0,9999,0
1653607574753,CSE 293,012,094916,Impagliazzo; Russell,9999,0,9999,0
1653607574753,CSE 293,013,094917,Jhala; Ranjit,9999,0,9999,0
1653607574753,CSE 293,014,094918,Kahng; Andrew Byun,9999,0,9999,0
1653607574753,CSE 293,015,094919,Kane; Daniel Mertz,9999,0,9999,0
1653607574753,CSE 293,016,094920,Kriegman; David J,9999,0,9999,0
1653607574753,CSE 293,017,094921,Kumar; Arun Kumar,9999,0,9999,0
1653607574753,CSE 293,018,094922,Lerner; Sorin,9999,0,9999,0
1653607574753,CSE 293,019,094923,Lovett; Shachar,9999,0,9999,0
1653607574753,CSE 293,020,094924,McAuley; Julian John,9999,0,9999,0
1653607574753,CSE 293,021,094925,Micciancio; Daniele,9999,0,9999,0
1653607574753,CSE 293,022,094926,Orailoglu; Alex,9999,0,9999,0
1653607574753,CSE 293,023,094927,Paturi; Ramamohan,9999,0,9999,0
1653607574753,CSE 293,024,094928,Polikarpova; Nadezhda,9999,0,9999,0
1653607574753,CSE 293,025,094929,Politz; Joseph Gibbs,9999,0,9999,0
1653607574753,CSE 293,026,094930,Porter; George M,9999,0,9999,0
1653607574753,CSE 293,027,094931,Porter; Leonard Emerson,9999,0,9999,0
1653607574753,CSE 293,028,094932,Ramamoorthi; Ravi,9999,0,9999,0
1653607574753,CSE 293,029,094933,Sahoo; Debashis,9999,0,9999,0
1653607574753,CSE 293,030,094934,Saul; Lawrence,9999,0,9999,0
1653607574753,CSE 293,031,094935,Savage; Stefan,9999,0,9999,0
1653607574753,CSE 293,032,094936,Schulze; Jurgen P.,9999,0,9999,0
1653607574753,CSE 293,033,094937,Snoeren; Alex C.,9999,0,9999,0
1653607574753,CSE 293,034,094938,Shang; Jingbo,9999,0,9999,0
1653607574753,CSE 293,035,094939,Stefan; Deian,9999,0,9999,0
1653607574753,CSE 293,036,094940,Su; Hao,9999,0,9999,0
1653607574753,CSE 293,037,094941,Swanson; Steven James,9999,0,9999,0
1653607574753,CSE 293,038,094942,Tullsen; Dean Michael,9999,0,9999,0
1653607574753,CSE 293,039,094943,Voelker; Geoffrey M.,9999,0,9999,0
1653607574753,CSE 293,040,094944,Zhao; Jishen,9999,0,9999,0
1653607574753,CSE 293,041,094945,Zhou; Yuan-Yuan,9999,0,9999,0
1653607574753,CSE 293,042,094946,Gao; Sicun,9998,0,9999,1
1653607574753,CSE 293,043,094947,Weibel; Nadir,9999,0,9999,0
1653607574753,CSE 293,044,094948,Gupta; Rajesh K.,9999,0,9999,0
1653607575285,CSE 294,A00,090143,Porter; George M,8,0,10,2
1653607575808,DSE 200,A00,091799,Staff,50,0,50,0
1653607576342,DSE 203,A00,091800,Gupta; Amarnath,30,0,30,0
1653607576866,DSE 250,A00,091801,Deutsch; Alin Bernard,30,0,30,0
1653607577390,DSE 290,A00,091802,Altintas De Callaf; Ilkay,50,0,50,0
1653607577930,ECE 200,001,091003,Antipa; Nicholas A,9999,0,9999,0
1653607577930,ECE 200,002,091004,Atanasov; Nikolay A.,9999,0,9999,0
1653607577930,ECE 200,003,091005,Bharadia; Dinesh,9999,0,9999,0
1653607577930,ECE 200,004,091006,Cheng; Chung Kuan,9999,0,9999,0
1653607577930,ECE 200,005,091007,Cosman; Pamela C.,9999,0,9999,0
1653607577930,ECE 200,006,091008,Staff,9999,0,9999,0
1653607577930,ECE 200,007,091009,Dayeh; Shadi Ahmad,9999,0,9999,0
1653607577930,ECE 200,008,091010,Fainman; Yeshaiahu,9999,0,9999,0
1653607577930,ECE 200,009,091011,Ford; Joseph Earl,9999,0,9999,0
1653607577930,ECE 200,010,091012,Franceschetti; Massimo,9999,0,9999,0
1653607577930,ECE 200,011,091013,Fullerton; Eric E,9999,0,9999,0
1653607577930,ECE 200,012,091014,Galton; Ian A,9999,0,9999,0
1653607577930,ECE 200,013,091015,Gilja; Vikash,9999,0,9999,0
1653607577930,ECE 200,014,091016,Hall; Drew A.,9999,0,9999,0
1653607577930,ECE 200,015,091017,Hsueh; Tzu-Chien,9999,0,9999,0
1653607577930,ECE 200,016,091018,Javidi; Tara,9999,0,9999,0
1653607577930,ECE 200,017,091019,Kahng; Andrew Byun,9999,0,9999,0
1653607577930,ECE 200,018,091020,Kim; Young-Han,9999,0,9999,0
1653607577930,ECE 200,019,091021,Koushanfar; Farinaz,9999,0,9999,0
1653607577930,ECE 200,020,091022,Kuzum; Duygu,9999,0,9999,0
1653607577930,ECE 200,021,091023,Le; Hanh-Phuc,9999,0,9999,0
1653607577930,ECE 200,022,091024,Lin; Bill,9999,0,9999,0
1653607577930,ECE 200,023,091025,Liu; Zhaowei,9999,0,9999,0
1653607577930,ECE 200,024,091026,Lo; Yu-Hwa,9999,0,9999,0
1653607577930,ECE 200,025,091027,Lomakin; Vitaliy,9999,0,9999,0
1653607577930,ECE 200,026,091028,Mercier; Patrick Philip,9999,0,9999,0
1653607577930,ECE 200,027,091029,Meyer; Florian,9999,0,9999,0
1653607577930,ECE 200,028,091030,Milstein; Laurence B.,9999,0,9999,0
1653607577930,ECE 200,029,091031,Mir Arabbaygi; Siavash,9999,0,9999,0
1653607577930,ECE 200,030,091032,Mookherjea; Shayan,9999,0,9999,0
1653607577930,ECE 200,031,091033,Morris; Karcher William,9999,0,9999,0
1653607577930,ECE 200,032,091034,Ng; Tse Nga,9999,0,9999,0
1653607577930,ECE 200,033,091035,Nguyen; Truong Quang,9999,0,9999,0
1653607577930,ECE 200,034,091036,Nomura; Kenji,9999,0,9999,0
1653607577930,ECE 200,035,091037,Orlitsky; Alon,9999,0,9999,0
1653607577930,ECE 200,036,091038,Pal; Piya,9999,0,9999,0
1653607577930,ECE 200,037,091039,Papen; George C.,9999,0,9999,0
1653607577930,ECE 200,038,091040,Radic; Stojan,9999,0,9999,0
1653607577930,ECE 200,039,091041,Rao; Bhaskar D.,9999,0,9999,0
1653607577930,ECE 200,040,091042,Rao; Ramesh R,9999,0,9999,0
1653607577930,ECE 200,041,091043,Rebeiz; Gabriel,9999,0,9999,0
1653607577930,ECE 200,042,091044,Sanford; John R,9999,0,9999,0
1653607577930,ECE 200,043,091045,Siegel; Paul H.,9999,0,9999,0
1653607577930,ECE 200,044,091046,Sievenpiper; Daniel F.,9999,0,9999,0
1653607577930,ECE 200,045,091047,Sworder; David D.,9999,0,9999,0
1653607577930,ECE 200,046,091048,Taur; Yuan,9999,0,9999,0
1653607577930,ECE 200,047,091049,Touri; Behrouz,9999,0,9999,0
1653607577930,ECE 200,048,091050,Trivedi; Mohan M.,9999,0,9999,0
1653607577930,ECE 200,049,091051,Vardy; Alexander,9999,0,9999,0
1653607577930,ECE 200,050,091052,Vasconcelos; Nuno,9999,0,9999,0
1653607577930,ECE 200,051,091053,Wang; Xiaolong,9999,0,9999,0
1653607577930,ECE 200,052,091054,Xie; Pengtao,9999,0,9999,0
1653607577930,ECE 200,053,091055,Yip; Michael,9999,0,9999,0
1653607577930,ECE 200,054,091056,Zeger; Kenneth A.,9999,0,9999,0
1653607577930,ECE 200,055,091057,Zhang; Xinyu,9999,0,9999,0
1653607577930,ECE 200,056,091058,Turakhia; Yatish Girish,9999,0,9999,0
1653607577930,ECE 200,057,091059,Kang; Mingu,9999,0,9999,0
1653607577930,ECE 200,058,091060,Shi; Yuanyuan,9999,0,9999,0
1653607577930,ECE 200,059,091061,Wang; Edward Jay,9999,0,9999,0
1653607577930,ECE 200,060,091062,Zheng; Yang,9999,0,9999,0
1653607578453,ECE 201,A00,095526,Lo; Yu-Hwa,0,0,0,0
1653607578981,ECE 203,A00,091065,Mercier; Patrick Philip,0,0,0,0
1653607579510,ECE 207A,A00,091605,Liu; Thomas Tao-Ming,0,0,0,0
1653607580033,ECE 212AN,A00,091068,Nomura; Kenji,0,0,0,0
1653607580559,ECE 222A,A00,091069,Rebeiz; Gabriel,0,0,0,0
1653607581092,ECE 225A,A00,091070,Orlitsky; Alon,0,0,0,0
1653607581634,ECE 230A,A00,091071,Nomura; Kenji,0,0,0,0
1653607582161,ECE 236A,A00,091072,Dayeh; Shadi Ahmad,0,0,0,0
1653607582687,ECE 238A,A00,091073,Luo; Jian,0,0,0,0
1653607582687,ECE 238A,B00,091074,Luo; Jian,0,0,0,0
1653607583221,ECE 240A,A00,091075,Radic; Stojan,0,0,0,0
1653607583746,ECE 247A,A00,091592,Shi; Lingyan,0,0,0,0
1653607584275,ECE 250,A00,091076,Touri; Behrouz,0,0,0,0
1653607584798,ECE 251C,A00,091078,Nguyen; Truong Quang,0,0,0,0
1653607585323,ECE 253,A00,091079,Cosman; Pamela C.,0,0,0,0
1653607585846,ECE 255A,A00,091080,Orlitsky; Alon,0,0,0,0
1653607586371,ECE 257A,A00,091081,Zhang; Xinyu,0,0,0,0
1653607586894,ECE 260A,A01,091084,Eldon; John,0,0,0,0
1653607587422,ECE 264C,A00,091085,Galton; Ian A,0,0,0,0
1653607587945,ECE 265C,A00,094889,Presti; Calogero Davide,0,0,0,9
1653607588487,ECE 266,A01,091087,Hall; Drew A.,0,0,0,0
1653607589540,ECE 271A,A00,091090,Vasconcelos; Nuno,0,0,0,0
1653607590063,ECE 272B,A00,091091,Sworder; David D.,0,0,0,0
1653607590589,ECE 275A,A00,091092,Meyer; Florian,0,0,0,0
1653607591112,ECE 277,A00,091093,An; Cheolhong,0,0,0,0
1653607591638,ECE 283,A00,091094,Le; Hanh-Phuc,0,0,0,0
1653607592165,ECE 284,A00,091095,Kang; Mingu,0,0,0,0
1653607592165,ECE 284,B00,091096,Wang; Edward Jay,0,0,0,0
1653607592688,ECE 285,A00,094334,Touri; Behrouz,0,0,0,0
1653607593211,ECE 289,A00,091097,Whelan; David Arthur,0,0,0,0
1653607593737,MATH 200A,A00,087414,Salehi Golsefidy; Alireza,7,0,8,1
1653607594272,MATH 202A,A00,087415,Gill; Philip E.,2,0,8,6
1653607594795,MATH 203A,A00,087416,Oprea; Dragos N.,6,0,8,2
1653607595320,MATH 204A,A00,087417,Kedlaya; Kiran S.,6,0,8,2
1653607595843,MATH 205,A00,087418,Sorensen; Claus M,6,0,8,2
1653607596374,MATH 206A,A00,087419,Izadi; Elham,7,0,8,1
1653607596897,MATH 207A,A00,087420,Mohammadi; Amir,5,0,8,3
1653607597425,MATH 208,A00,087421,Staff,9,0,10,1
1653607597948,MATH 209,A00,087422,Staff,10,0,10,0
1653607598470,MATH 218,A00,087423,Staff,10,0,10,0
1653607598997,MATH 220A,A00,087424,Novak; Jonathan I,6,0,8,2
1653607599526,MATH 231A,A00,087425,Bejenaru; Ioan,3,0,8,5
1653607600049,MATH 240A,A00,087426,Ebenfelt; Peter F,5,0,8,3
1653607600575,MATH 243,A00,087427,Staff,9,0,10,1
1653607601101,MATH 248,A00,087429,Staff,10,0,10,0
1653607601626,MATH 250A,A00,087430,Spolaor; Luca,4,0,8,4
1653607602151,MATH 257A,A00,087431,Spolaor; Luca,7,0,8,1
1653607602677,MATH 258,A00,087432,Staff,9,0,10,1
1653607603200,MATH 264A,A00,087433,Warnke; Lutz Peter,5,0,8,3
1653607603725,MATH 268,A00,087434,Staff,15,0,15,0
1653607604254,MATH 269,A00,087435,Staff,14,0,15,1
1653607604781,MATH 270A,A00,087436,Nie; Jiawang,0,0,8,8
1653607605308,MATH 272A,A00,087437,Tian; Xiaochuan,0,0,8,8
1653607605840,MATH 274,A01,087439,Cheng; Li-Tien,9,0,10,1
1653607605840,MATH 274,A02,087440,Cheng; Li-Tien,10,0,10,0
1653607606368,MATH 278A,A00,087441,Staff,8,0,10,2
1653607606894,MATH 278B,A00,087442,Staff,8,0,10,2
1653607607423,MATH 278C,A00,087443,Staff,8,0,10,2
1653607607948,MATH 280A,A00,087444,Zheng; Tianyi,0,0,8,8
1653607608477,MATH 281A,A00,087445,Bradic; Jelena,0,0,8,8
1653607609003,MATH 282A,A00,087446,Zhang; Danna,0,0,8,8
1653607609526,MATH 283,A00,087447,Tesler; Glenn,0,0,0,16
1653607610049,MATH 286,B00,095535,Kemp; Todd Aahron,6,0,8,2
1653607610573,MATH 287D,B00,095536,Bradic; Jelena,5,0,8,3
1653607611098,MATH 288,A00,087450,Staff,14,0,15,1
1653607611098,MATH 288,B00,087451,Staff,15,0,15,0
1653607611098,MATH 288,C00,087452,Staff,15,0,15,0
1653607611625,MATH 290A,A00,087453,Xu; Zhouli,6,0,8,2
1653607612150,MATH 291A,A00,087454,Xu; Zhouli,7,0,8,1
1653607612678,MATH 292,A00,087455,Staff,10,0,10,0
1653607613209,MATH 295,A00,087456,Staff,50,0,50,0
1653607613746,MATH 297,001,087457,Staff,997,0,999,2
1653608174056,COGS 200,A01,087991,Staff,47,0,50,3
1653608174582,COGS 201,A01,094504,Rangel; Lara M,16,0,25,9
1653608175106,COGS 203,A00,087992,Coulson; Seana M,18,0,20,2
1653608175629,COGS 210A,001,087993,Greene; Deanna Jacquelyn,9998,0,9999,1
1653608175629,COGS 210A,002,087994,Saygin; Ayse P,9999,0,9999,0
1653608175629,COGS 210A,003,087995,Xia; Haijun,9999,0,9999,0
1653608175629,COGS 210A,004,087996,Nitz; Douglas A.,9999,0,9999,0
1653608175629,COGS 210A,005,087997,Hollan; James D.,9999,0,9999,0
1653608175629,COGS 210A,006,087998,Deak; Gedeon O.,9998,0,9999,1
1653608175629,COGS 210A,007,087999,Rossano; Federico,9999,0,9999,0
1653608176153,COGS 211A,A00,088000,Coulson; Seana M,9997,0,9999,2
1653608176678,COGS 229,A00,088002,Staff,22,0,25,3
1653608177200,COGS 260,B00,094231,Staff,17,0,20,3
1653608177200,COGS 260,A00,088004,Nitz; Douglas A.,9998,0,9999,1
1653608177728,CSE 202,A00,090110,Paturi; Ramamohan,0,0,0,0
1653608177728,CSE 202,B00,090111,Paturi; Ramamohan,0,0,0,0
1653608178252,CSE 207B,A00,090112,Heninger; Nadia A,0,0,0,0
1653608178776,CSE 208,A00,094858,Micciancio; Daniele,0,0,0,0
1653608179299,CSE 210,A00,090113,Powell; Thomas Allan,0,0,0,0
1653608179831,CSE 219,A00,090898,Staff,0,0,0,0
1653608180356,CSE 221,A00,090114,Zhou; Yuan-Yuan,0,0,0,0
1653608180882,CSE 229A,A00,090115,Porter; George M,0,0,0,0
1653608181404,CSE 229C,A00,090116,Savage; Stefan,0,0,0,0
1653608181926,CSE 230,A00,090117,Jhala; Ranjit,0,0,0,0
1653608182449,CSE 232,A00,090118,Papakonstantinou; Yannis,0,0,0,0
1653608182972,CSE 239A,A00,090121,Kumar; Arun Kumar,0,0,0,0
1653608183496,CSE 239B,A00,090122,Jhala; Ranjit,0,0,0,0
1653608184018,CSE 240A,A00,090123,Zhao; Jishen,0,0,189,189
1653608184551,CSE 243A,A00,090124,Orailoglu; Alex,0,0,15,15
1653608185073,CSE 249B,A00,090125,Kahng; Andrew Byun,12,0,20,8
1653608185595,CSE 250A,A00,090126,Berg-Kirkpatrick; Taylor D,0,0,0,0
1653608186118,CSE 252A,A00,090127,Ochoa; Benjamin Lawrence,0,0,0,0
1653608186641,CSE 258,A01,090129,McAuley; Julian John,0,0,0,0
1653608187165,CSE 258R,A01,090131,McAuley; Julian John,0,0,0,0
1653608187687,CSE 274,A00,090132,Ramamoorthi; Ravi,0,0,0,0
1653608188210,CSE 276A,A00,090133,Christensen; Henrik I,0,0,0,0
1653608188735,CSE 276C,A00,090134,Christensen; Henrik I,0,0,0,0
1653608189258,CSE 290,A00,090135,Bafna; Vineet,0,0,0,0
1653608189258,CSE 290,B00,090136,Ramamoorthi; Ravi,0,0,0,0
1653608189258,CSE 290,C00,090137,Li; Tzumao,7,0,10,3
1653608189258,CSE 290,D00,090138,Zhou; Yuan-Yuan,9,0,10,1
1653608189258,CSE 290,E00,090139,Christensen; Henrik I,8,0,10,2
1653608189258,CSE 290,F00,094053,Shalev; Aaron D,0,0,0,0
1653608189783,CSE 291,A00,090140,Munyaka; Imani N. S.,0,0,0,0
1653608189783,CSE 291,B00,094880,Yu; Qi,0,0,0,0
1653608189783,CSE 291,C00,090142,Pannuto; Patrick William,0,0,0,0
1653608189783,CSE 291,D00,094881,Zhang; Yiying,0,0,0,0
1653608189783,CSE 291,E00,095118,Su; Hao,0,0,0,0
1653608190314,CSE 293,001,094905,Bafna; Vineet,9999,0,9999,0
1653608190314,CSE 293,002,094906,Bellare; Mihir,9999,0,9999,0
1653608190314,CSE 293,003,094907,Berg-Kirkpatrick; Taylor D,9999,0,9999,0
1653608190314,CSE 293,004,094908,Christensen; Henrik I,9999,0,9999,0
1653608190314,CSE 293,005,094909,Cottrell; Garrison W,9999,0,9999,0
1653608190314,CSE 293,006,094910,Deutsch; Alin Bernard,9999,0,9999,0
1653608190314,CSE 293,007,094911,Esmaeilzadeh; Hadi,9999,0,9999,0
1653608190314,CSE 293,008,094912,Freund; Yoav,9999,0,9999,0
1653608190314,CSE 293,009,094913,Griswold; William G.,9999,0,9999,0
1653608190314,CSE 293,010,094914,Gymrek; Melissa Ann,9999,0,9999,0
1653608190314,CSE 293,011,094915,Heninger; Nadia A,9999,0,9999,0
1653608190314,CSE 293,012,094916,Impagliazzo; Russell,9999,0,9999,0
1653608190314,CSE 293,013,094917,Jhala; Ranjit,9999,0,9999,0
1653608190314,CSE 293,014,094918,Kahng; Andrew Byun,9999,0,9999,0
1653608190314,CSE 293,015,094919,Kane; Daniel Mertz,9999,0,9999,0
1653608190314,CSE 293,016,094920,Kriegman; David J,9999,0,9999,0
1653608190314,CSE 293,017,094921,Kumar; Arun Kumar,9999,0,9999,0
1653608190314,CSE 293,018,094922,Lerner; Sorin,9999,0,9999,0
1653608190314,CSE 293,019,094923,Lovett; Shachar,9999,0,9999,0
1653608190314,CSE 293,020,094924,McAuley; Julian John,9999,0,9999,0
1653608190314,CSE 293,021,094925,Micciancio; Daniele,9999,0,9999,0
1653608190314,CSE 293,022,094926,Orailoglu; Alex,9999,0,9999,0
1653608190314,CSE 293,023,094927,Paturi; Ramamohan,9999,0,9999,0
1653608190314,CSE 293,024,094928,Polikarpova; Nadezhda,9999,0,9999,0
1653608190314,CSE 293,025,094929,Politz; Joseph Gibbs,9999,0,9999,0
1653608190314,CSE 293,026,094930,Porter; George M,9999,0,9999,0
1653608190314,CSE 293,027,094931,Porter; Leonard Emerson,9999,0,9999,0
1653608190314,CSE 293,028,094932,Ramamoorthi; Ravi,9999,0,9999,0
1653608190314,CSE 293,029,094933,Sahoo; Debashis,9999,0,9999,0
1653608190314,CSE 293,030,094934,Saul; Lawrence,9999,0,9999,0
1653608190314,CSE 293,031,094935,Savage; Stefan,9999,0,9999,0
1653608190314,CSE 293,032,094936,Schulze; Jurgen P.,9999,0,9999,0
1653608190314,CSE 293,033,094937,Snoeren; Alex C.,9999,0,9999,0
1653608190314,CSE 293,034,094938,Shang; Jingbo,9999,0,9999,0
1653608190314,CSE 293,035,094939,Stefan; Deian,9999,0,9999,0
1653608190314,CSE 293,036,094940,Su; Hao,9999,0,9999,0
1653608190314,CSE 293,037,094941,Swanson; Steven James,9999,0,9999,0
1653608190314,CSE 293,038,094942,Tullsen; Dean Michael,9999,0,9999,0
1653608190314,CSE 293,039,094943,Voelker; Geoffrey M.,9999,0,9999,0
1653608190314,CSE 293,040,094944,Zhao; Jishen,9999,0,9999,0
1653608190314,CSE 293,041,094945,Zhou; Yuan-Yuan,9999,0,9999,0
1653608190314,CSE 293,042,094946,Gao; Sicun,9998,0,9999,1
1653608190314,CSE 293,043,094947,Weibel; Nadir,9999,0,9999,0
1653608190314,CSE 293,044,094948,Gupta; Rajesh K.,9999,0,9999,0
1653608190837,CSE 294,A00,090143,Porter; George M,8,0,10,2
1653608191359,DSE 200,A00,091799,Staff,50,0,50,0
1653608191881,DSE 203,A00,091800,Gupta; Amarnath,30,0,30,0
1653608192403,DSE 250,A00,091801,Deutsch; Alin Bernard,30,0,30,0
1653608192925,DSE 290,A00,091802,Altintas De Callaf; Ilkay,50,0,50,0
1653608193456,ECE 200,001,091003,Antipa; Nicholas A,9999,0,9999,0
1653608193456,ECE 200,002,091004,Atanasov; Nikolay A.,9999,0,9999,0
1653608193456,ECE 200,003,091005,Bharadia; Dinesh,9999,0,9999,0
1653608193456,ECE 200,004,091006,Cheng; Chung Kuan,9999,0,9999,0
1653608193456,ECE 200,005,091007,Cosman; Pamela C.,9999,0,9999,0
1653608193456,ECE 200,006,091008,Staff,9999,0,9999,0
1653608193456,ECE 200,007,091009,Dayeh; Shadi Ahmad,9999,0,9999,0
1653608193456,ECE 200,008,091010,Fainman; Yeshaiahu,9999,0,9999,0
1653608193456,ECE 200,009,091011,Ford; Joseph Earl,9999,0,9999,0
1653608193456,ECE 200,010,091012,Franceschetti; Massimo,9999,0,9999,0
1653608193456,ECE 200,011,091013,Fullerton; Eric E,9999,0,9999,0
1653608193456,ECE 200,012,091014,Galton; Ian A,9999,0,9999,0
1653608193456,ECE 200,013,091015,Gilja; Vikash,9999,0,9999,0
1653608193456,ECE 200,014,091016,Hall; Drew A.,9999,0,9999,0
1653608193456,ECE 200,015,091017,Hsueh; Tzu-Chien,9999,0,9999,0
1653608193456,ECE 200,016,091018,Javidi; Tara,9999,0,9999,0
1653608193456,ECE 200,017,091019,Kahng; Andrew Byun,9999,0,9999,0
1653608193456,ECE 200,018,091020,Kim; Young-Han,9999,0,9999,0
1653608193456,ECE 200,019,091021,Koushanfar; Farinaz,9999,0,9999,0
1653608193456,ECE 200,020,091022,Kuzum; Duygu,9999,0,9999,0
1653608193456,ECE 200,021,091023,Le; Hanh-Phuc,9999,0,9999,0
1653608193456,ECE 200,022,091024,Lin; Bill,9999,0,9999,0
1653608193456,ECE 200,023,091025,Liu; Zhaowei,9999,0,9999,0
1653608193456,ECE 200,024,091026,Lo; Yu-Hwa,9999,0,9999,0
1653608193456,ECE 200,025,091027,Lomakin; Vitaliy,9999,0,9999,0
1653608193456,ECE 200,026,091028,Mercier; Patrick Philip,9999,0,9999,0
1653608193456,ECE 200,027,091029,Meyer; Florian,9999,0,9999,0
1653608193456,ECE 200,028,091030,Milstein; Laurence B.,9999,0,9999,0
1653608193456,ECE 200,029,091031,Mir Arabbaygi; Siavash,9999,0,9999,0
1653608193456,ECE 200,030,091032,Mookherjea; Shayan,9999,0,9999,0
1653608193456,ECE 200,031,091033,Morris; Karcher William,9999,0,9999,0
1653608193456,ECE 200,032,091034,Ng; Tse Nga,9999,0,9999,0
1653608193456,ECE 200,033,091035,Nguyen; Truong Quang,9999,0,9999,0
1653608193456,ECE 200,034,091036,Nomura; Kenji,9999,0,9999,0
1653608193456,ECE 200,035,091037,Orlitsky; Alon,9999,0,9999,0
1653608193456,ECE 200,036,091038,Pal; Piya,9999,0,9999,0
1653608193456,ECE 200,037,091039,Papen; George C.,9999,0,9999,0
1653608193456,ECE 200,038,091040,Radic; Stojan,9999,0,9999,0
1653608193456,ECE 200,039,091041,Rao; Bhaskar D.,9999,0,9999,0
1653608193456,ECE 200,040,091042,Rao; Ramesh R,9999,0,9999,0
1653608193456,ECE 200,041,091043,Rebeiz; Gabriel,9999,0,9999,0
1653608193456,ECE 200,042,091044,Sanford; John R,9999,0,9999,0
1653608193456,ECE 200,043,091045,Siegel; Paul H.,9999,0,9999,0
1653608193456,ECE 200,044,091046,Sievenpiper; Daniel F.,9999,0,9999,0
1653608193456,ECE 200,045,091047,Sworder; David D.,9999,0,9999,0
1653608193456,ECE 200,046,091048,Taur; Yuan,9999,0,9999,0
1653608193456,ECE 200,047,091049,Touri; Behrouz,9999,0,9999,0
1653608193456,ECE 200,048,091050,Trivedi; Mohan M.,9999,0,9999,0
1653608193456,ECE 200,049,091051,Vardy; Alexander,9999,0,9999,0
1653608193456,ECE 200,050,091052,Vasconcelos; Nuno,9999,0,9999,0
1653608193456,ECE 200,051,091053,Wang; Xiaolong,9999,0,9999,0
1653608193456,ECE 200,052,091054,Xie; Pengtao,9999,0,9999,0
1653608193456,ECE 200,053,091055,Yip; Michael,9999,0,9999,0
1653608193456,ECE 200,054,091056,Zeger; Kenneth A.,9999,0,9999,0
1653608193456,ECE 200,055,091057,Zhang; Xinyu,9999,0,9999,0
1653608193456,ECE 200,056,091058,Turakhia; Yatish Girish,9999,0,9999,0
1653608193456,ECE 200,057,091059,Kang; Mingu,9999,0,9999,0
1653608193456,ECE 200,058,091060,Shi; Yuanyuan,9999,0,9999,0
1653608193456,ECE 200,059,091061,Wang; Edward Jay,9999,0,9999,0
1653608193456,ECE 200,060,091062,Zheng; Yang,9999,0,9999,0
1653608193980,ECE 201,A00,095526,Lo; Yu-Hwa,0,0,0,0
1653608194503,ECE 203,A00,091065,Mercier; Patrick Philip,0,0,0,0
1653608195029,ECE 207A,A00,091605,Liu; Thomas Tao-Ming,0,0,0,0
1653608195551,ECE 212AN,A00,091068,Nomura; Kenji,0,0,0,0
1653608196076,ECE 222A,A00,091069,Rebeiz; Gabriel,0,0,0,0
1653608196598,ECE 225A,A00,091070,Orlitsky; Alon,0,0,0,0
1653608197122,ECE 230A,A00,091071,Nomura; Kenji,0,0,0,0
1653608197645,ECE 236A,A00,091072,Dayeh; Shadi Ahmad,0,0,0,0
1653608198182,ECE 238A,A00,091073,Luo; Jian,0,0,0,0
1653608198182,ECE 238A,B00,091074,Luo; Jian,0,0,0,0
1653608198708,ECE 240A,A00,091075,Radic; Stojan,0,0,0,0
1653608199231,ECE 247A,A00,091592,Shi; Lingyan,0,0,0,0
1653608199763,ECE 250,A00,091076,Touri; Behrouz,0,0,0,0
1653608200286,ECE 251C,A00,091078,Nguyen; Truong Quang,0,0,0,0
1653608200811,ECE 253,A00,091079,Cosman; Pamela C.,0,0,0,0
1653608201344,ECE 255A,A00,091080,Orlitsky; Alon,0,0,0,0
1653608201867,ECE 257A,A00,091081,Zhang; Xinyu,0,0,0,0
1653608202391,ECE 260A,A01,091084,Eldon; John,0,0,0,0
1653608202917,ECE 264C,A00,091085,Galton; Ian A,0,0,0,0
1653608203444,ECE 265C,A00,094889,Presti; Calogero Davide,0,0,0,9
1653608203966,ECE 266,A01,091087,Hall; Drew A.,0,0,0,0
1653608205020,ECE 271A,A00,091090,Vasconcelos; Nuno,0,0,0,0
1653608205561,ECE 272B,A00,091091,Sworder; David D.,0,0,0,0
1653608206083,ECE 275A,A00,091092,Meyer; Florian,0,0,0,0
1653608206607,ECE 277,A00,091093,An; Cheolhong,0,0,0,0
1653608207137,ECE 283,A00,091094,Le; Hanh-Phuc,0,0,0,0
1653608207660,ECE 284,A00,091095,Kang; Mingu,0,0,0,0
1653608207660,ECE 284,B00,091096,Wang; Edward Jay,0,0,0,0
1653608208184,ECE 285,A00,094334,Touri; Behrouz,0,0,0,0
1653608208707,ECE 289,A00,091097,Whelan; David Arthur,0,0,0,0
1653608209233,MATH 200A,A00,087414,Salehi Golsefidy; Alireza,7,0,8,1
1653608209755,MATH 202A,A00,087415,Gill; Philip E.,2,0,8,6
1653608210278,MATH 203A,A00,087416,Oprea; Dragos N.,6,0,8,2
1653608210811,MATH 204A,A00,087417,Kedlaya; Kiran S.,6,0,8,2
1653608211338,MATH 205,A00,087418,Sorensen; Claus M,6,0,8,2
1653608211872,MATH 206A,A00,087419,Izadi; Elham,7,0,8,1
1653608212395,MATH 207A,A00,087420,Mohammadi; Amir,5,0,8,3
1653608212919,MATH 208,A00,087421,Staff,9,0,10,1
1653608213444,MATH 209,A00,087422,Staff,10,0,10,0
1653608213973,MATH 218,A00,087423,Staff,10,0,10,0
1653608214600,MATH 220A,A00,087424,Novak; Jonathan I,6,0,8,2
1653608215122,MATH 231A,A00,087425,Bejenaru; Ioan,3,0,8,5
1653608215648,MATH 240A,A00,087426,Ebenfelt; Peter F,5,0,8,3
1653608216182,MATH 243,A00,087427,Staff,9,0,10,1
1653608216704,MATH 248,A00,087429,Staff,10,0,10,0
1653608217233,MATH 250A,A00,087430,Spolaor; Luca,4,0,8,4
1653608217756,MATH 257A,A00,087431,Spolaor; Luca,7,0,8,1
1653608218278,MATH 258,A00,087432,Staff,9,0,10,1
1653608218800,MATH 264A,A00,087433,Warnke; Lutz Peter,5,0,8,3
1653608219334,MATH 268,A00,087434,Staff,15,0,15,0
1653608219857,MATH 269,A00,087435,Staff,14,0,15,1
1653608220385,MATH 270A,A00,087436,Nie; Jiawang,0,0,8,8
1653608220922,MATH 272A,A00,087437,Tian; Xiaochuan,0,0,8,8
1653608221445,MATH 274,A01,087439,Cheng; Li-Tien,9,0,10,1
1653608221445,MATH 274,A02,087440,Cheng; Li-Tien,10,0,10,0
1653608221969,MATH 278A,A00,087441,Staff,8,0,10,2
1653608222500,MATH 278B,A00,087442,Staff,8,0,10,2
1653608223024,MATH 278C,A00,087443,Staff,8,0,10,2
1653608223549,MATH 280A,A00,087444,Zheng; Tianyi,0,0,8,8
1653608224077,MATH 281A,A00,087445,Bradic; Jelena,0,0,8,8
1653608224600,MATH 282A,A00,087446,Zhang; Danna,0,0,8,8
1653608225142,MATH 283,A00,087447,Tesler; Glenn,0,0,0,16
1653608225665,MATH 286,B00,095535,Kemp; Todd Aahron,6,0,8,2
1653608226198,MATH 287D,B00,095536,Bradic; Jelena,5,0,8,3
1653608226729,MATH 288,A00,087450,Staff,14,0,15,1
1653608226729,MATH 288,B00,087451,Staff,15,0,15,0
1653608226729,MATH 288,C00,087452,Staff,15,0,15,0
1653608227255,MATH 290A,A00,087453,Xu; Zhouli,6,0,8,2
1653608227786,MATH 291A,A00,087454,Xu; Zhouli,7,0,8,1
1653608228321,MATH 292,A00,087455,Staff,10,0,10,0
1653608228855,MATH 295,A00,087456,Staff,50,0,50,0
1653608229378,MATH 297,001,087457,Staff,997,0,999,2
1653608788848,COGS 200,A01,087991,Staff,47,0,50,3
1653608789375,COGS 201,A01,094504,Rangel; Lara M,16,0,25,9
1653608789903,COGS 203,A00,087992,Coulson; Seana M,18,0,20,2
1653608790428,COGS 210A,001,087993,Greene; Deanna Jacquelyn,9998,0,9999,1
1653608790428,COGS 210A,002,087994,Saygin; Ayse P,9999,0,9999,0
1653608790428,COGS 210A,003,087995,Xia; Haijun,9999,0,9999,0
1653608790428,COGS 210A,004,087996,Nitz; Douglas A.,9999,0,9999,0
1653608790428,COGS 210A,005,087997,Hollan; James D.,9999,0,9999,0
1653608790428,COGS 210A,006,087998,Deak; Gedeon O.,9998,0,9999,1
1653608790428,COGS 210A,007,087999,Rossano; Federico,9999,0,9999,0
1653608790950,COGS 211A,A00,088000,Coulson; Seana M,9997,0,9999,2
1653608791472,COGS 229,A00,088002,Staff,22,0,25,3
1653608792004,COGS 260,B00,094231,Staff,17,0,20,3
1653608792004,COGS 260,A00,088004,Nitz; Douglas A.,9998,0,9999,1
1653608792527,CSE 202,A00,090110,Paturi; Ramamohan,0,0,0,0
1653608792527,CSE 202,B00,090111,Paturi; Ramamohan,0,0,0,0
1653608793050,CSE 207B,A00,090112,Heninger; Nadia A,0,0,0,0
1653608793576,CSE 208,A00,094858,Micciancio; Daniele,0,0,0,0
1653608794099,CSE 210,A00,090113,Powell; Thomas Allan,0,0,0,0
1653608794621,CSE 219,A00,090898,Staff,0,0,0,0
1653608795143,CSE 221,A00,090114,Zhou; Yuan-Yuan,0,0,0,0
1653608795665,CSE 229A,A00,090115,Porter; George M,0,0,0,0
1653608796193,CSE 229C,A00,090116,Savage; Stefan,0,0,0,0
1653608796716,CSE 230,A00,090117,Jhala; Ranjit,0,0,0,0
1653608797243,CSE 232,A00,090118,Papakonstantinou; Yannis,0,0,0,0
1653608797767,CSE 239A,A00,090121,Kumar; Arun Kumar,0,0,0,0
1653608798289,CSE 239B,A00,090122,Jhala; Ranjit,0,0,0,0
1653608798815,CSE 240A,A00,090123,Zhao; Jishen,0,0,189,189
1653608799344,CSE 243A,A00,090124,Orailoglu; Alex,0,0,15,15
1653608799880,CSE 249B,A00,090125,Kahng; Andrew Byun,12,0,20,8
1653608800403,CSE 250A,A00,090126,Berg-Kirkpatrick; Taylor D,0,0,0,0
1653608800930,CSE 252A,A00,090127,Ochoa; Benjamin Lawrence,0,0,0,0
1653608801543,CSE 258,A01,090129,McAuley; Julian John,0,0,0,0
1653608802066,CSE 258R,A01,090131,McAuley; Julian John,0,0,0,0
1653608802591,CSE 274,A00,090132,Ramamoorthi; Ravi,0,0,0,0
1653608803119,CSE 276A,A00,090133,Christensen; Henrik I,0,0,0,0
1653608803647,CSE 276C,A00,090134,Christensen; Henrik I,0,0,0,0
1653608804177,CSE 290,A00,090135,Bafna; Vineet,0,0,0,0
1653608804177,CSE 290,B00,090136,Ramamoorthi; Ravi,0,0,0,0
1653608804177,CSE 290,C00,090137,Li; Tzumao,7,0,10,3
1653608804177,CSE 290,D00,090138,Zhou; Yuan-Yuan,9,0,10,1
1653608804177,CSE 290,E00,090139,Christensen; Henrik I,8,0,10,2
1653608804177,CSE 290,F00,094053,Shalev; Aaron D,0,0,0,0
1653608804710,CSE 291,A00,090140,Munyaka; Imani N. S.,0,0,0,0
1653608804710,CSE 291,B00,094880,Yu; Qi,0,0,0,0
1653608804710,CSE 291,C00,090142,Pannuto; Patrick William,0,0,0,0
1653608804710,CSE 291,D00,094881,Zhang; Yiying,0,0,0,0
1653608804710,CSE 291,E00,095118,Su; Hao,0,0,0,0
1653608805233,CSE 293,001,094905,Bafna; Vineet,9999,0,9999,0
1653608805233,CSE 293,002,094906,Bellare; Mihir,9999,0,9999,0
1653608805233,CSE 293,003,094907,Berg-Kirkpatrick; Taylor D,9999,0,9999,0
1653608805233,CSE 293,004,094908,Christensen; Henrik I,9999,0,9999,0
1653608805233,CSE 293,005,094909,Cottrell; Garrison W,9999,0,9999,0
1653608805233,CSE 293,006,094910,Deutsch; Alin Bernard,9999,0,9999,0
1653608805233,CSE 293,007,094911,Esmaeilzadeh; Hadi,9999,0,9999,0
1653608805233,CSE 293,008,094912,Freund; Yoav,9999,0,9999,0
1653608805233,CSE 293,009,094913,Griswold; William G.,9999,0,9999,0
1653608805233,CSE 293,010,094914,Gymrek; Melissa Ann,9999,0,9999,0
1653608805233,CSE 293,011,094915,Heninger; Nadia A,9999,0,9999,0
1653608805233,CSE 293,012,094916,Impagliazzo; Russell,9999,0,9999,0
1653608805233,CSE 293,013,094917,Jhala; Ranjit,9999,0,9999,0
1653608805233,CSE 293,014,094918,Kahng; Andrew Byun,9999,0,9999,0
1653608805233,CSE 293,015,094919,Kane; Daniel Mertz,9999,0,9999,0
1653608805233,CSE 293,016,094920,Kriegman; David J,9999,0,9999,0
1653608805233,CSE 293,017,094921,Kumar; Arun Kumar,9999,0,9999,0
1653608805233,CSE 293,018,094922,Lerner; Sorin,9999,0,9999,0
1653608805233,CSE 293,019,094923,Lovett; Shachar,9999,0,9999,0
1653608805233,CSE 293,020,094924,McAuley; Julian John,9999,0,9999,0
1653608805233,CSE 293,021,094925,Micciancio; Daniele,9999,0,9999,0
1653608805233,CSE 293,022,094926,Orailoglu; Alex,9999,0,9999,0
1653608805233,CSE 293,023,094927,Paturi; Ramamohan,9999,0,9999,0
1653608805233,CSE 293,024,094928,Polikarpova; Nadezhda,9999,0,9999,0
1653608805233,CSE 293,025,094929,Politz; Joseph Gibbs,9999,0,9999,0
1653608805233,CSE 293,026,094930,Porter; George M,9999,0,9999,0
1653608805233,CSE 293,027,094931,Porter; Leonard Emerson,9999,0,9999,0
1653608805233,CSE 293,028,094932,Ramamoorthi; Ravi,9999,0,9999,0
1653608805233,CSE 293,029,094933,Sahoo; Debashis,9999,0,9999,0
1653608805233,CSE 293,030,094934,Saul; Lawrence,9999,0,9999,0
1653608805233,CSE 293,031,094935,Savage; Stefan,9999,0,9999,0
1653608805233,CSE 293,032,094936,Schulze; Jurgen P.,9999,0,9999,0
1653608805233,CSE 293,033,094937,Snoeren; Alex C.,9999,0,9999,0
1653608805233,CSE 293,034,094938,Shang; Jingbo,9999,0,9999,0
1653608805233,CSE 293,035,094939,Stefan; Deian,9999,0,9999,0
1653608805233,CSE 293,036,094940,Su; Hao,9999,0,9999,0
1653608805233,CSE 293,037,094941,Swanson; Steven James,9999,0,9999,0
1653608805233,CSE 293,038,094942,Tullsen; Dean Michael,9999,0,9999,0
1653608805233,CSE 293,039,094943,Voelker; Geoffrey M.,9999,0,9999,0
1653608805233,CSE 293,040,094944,Zhao; Jishen,9999,0,9999,0
1653608805233,CSE 293,041,094945,Zhou; Yuan-Yuan,9999,0,9999,0
1653608805233,CSE 293,042,094946,Gao; Sicun,9998,0,9999,1
1653608805233,CSE 293,043,094947,Weibel; Nadir,9999,0,9999,0
1653608805233,CSE 293,044,094948,Gupta; Rajesh K.,9999,0,9999,0
1653608805758,CSE 294,A00,090143,Porter; George M,8,0,10,2
1653608806292,DSE 200,A00,091799,Staff,50,0,50,0
1653608806824,DSE 203,A00,091800,Gupta; Amarnath,30,0,30,0
1653608807346,DSE 250,A00,091801,Deutsch; Alin Bernard,30,0,30,0
1653608807872,DSE 290,A00,091802,Altintas De Callaf; Ilkay,50,0,50,0
1653608808445,ECE 200,001,091003,Antipa; Nicholas A,9999,0,9999,0
1653608808445,ECE 200,002,091004,Atanasov; Nikolay A.,9999,0,9999,0
1653608808445,ECE 200,003,091005,Bharadia; Dinesh,9999,0,9999,0
1653608808445,ECE 200,004,091006,Cheng; Chung Kuan,9999,0,9999,0
1653608808445,ECE 200,005,091007,Cosman; Pamela C.,9999,0,9999,0
1653608808445,ECE 200,006,091008,Staff,9999,0,9999,0
1653608808445,ECE 200,007,091009,Dayeh; Shadi Ahmad,9999,0,9999,0
1653608808445,ECE 200,008,091010,Fainman; Yeshaiahu,9999,0,9999,0
1653608808445,ECE 200,009,091011,Ford; Joseph Earl,9999,0,9999,0
1653608808445,ECE 200,010,091012,Franceschetti; Massimo,9999,0,9999,0
1653608808445,ECE 200,011,091013,Fullerton; Eric E,9999,0,9999,0
1653608808445,ECE 200,012,091014,Galton; Ian A,9999,0,9999,0
1653608808445,ECE 200,013,091015,Gilja; Vikash,9999,0,9999,0
1653608808445,ECE 200,014,091016,Hall; Drew A.,9999,0,9999,0
1653608808445,ECE 200,015,091017,Hsueh; Tzu-Chien,9999,0,9999,0
1653608808445,ECE 200,016,091018,Javidi; Tara,9999,0,9999,0
1653608808445,ECE 200,017,091019,Kahng; Andrew Byun,9999,0,9999,0
1653608808445,ECE 200,018,091020,Kim; Young-Han,9999,0,9999,0
1653608808445,ECE 200,019,091021,Koushanfar; Farinaz,9999,0,9999,0
1653608808445,ECE 200,020,091022,Kuzum; Duygu,9999,0,9999,0
1653608808445,ECE 200,021,091023,Le; Hanh-Phuc,9999,0,9999,0
1653608808445,ECE 200,022,091024,Lin; Bill,9999,0,9999,0
1653608808445,ECE 200,023,091025,Liu; Zhaowei,9999,0,9999,0
1653608808445,ECE 200,024,091026,Lo; Yu-Hwa,9999,0,9999,0
1653608808445,ECE 200,025,091027,Lomakin; Vitaliy,9999,0,9999,0
1653608808445,ECE 200,026,091028,Mercier; Patrick Philip,9999,0,9999,0
1653608808445,ECE 200,027,091029,Meyer; Florian,9999,0,9999,0
1653608808445,ECE 200,028,091030,Milstein; Laurence B.,9999,0,9999,0
1653608808445,ECE 200,029,091031,Mir Arabbaygi; Siavash,9999,0,9999,0
1653608808445,ECE 200,030,091032,Mookherjea; Shayan,9999,0,9999,0
1653608808445,ECE 200,031,091033,Morris; Karcher William,9999,0,9999,0
1653608808445,ECE 200,032,091034,Ng; Tse Nga,9999,0,9999,0
1653608808445,ECE 200,033,091035,Nguyen; Truong Quang,9999,0,9999,0
1653608808445,ECE 200,034,091036,Nomura; Kenji,9999,0,9999,0
1653608808445,ECE 200,035,091037,Orlitsky; Alon,9999,0,9999,0
1653608808445,ECE 200,036,091038,Pal; Piya,9999,0,9999,0
1653608808445,ECE 200,037,091039,Papen; George C.,9999,0,9999,0
1653608808445,ECE 200,038,091040,Radic; Stojan,9999,0,9999,0
1653608808445,ECE 200,039,091041,Rao; Bhaskar D.,9999,0,9999,0
1653608808445,ECE 200,040,091042,Rao; Ramesh R,9999,0,9999,0
1653608808445,ECE 200,041,091043,Rebeiz; Gabriel,9999,0,9999,0
1653608808445,ECE 200,042,091044,Sanford; John R,9999,0,9999,0
1653608808445,ECE 200,043,091045,Siegel; Paul H.,9999,0,9999,0
1653608808445,ECE 200,044,091046,Sievenpiper; Daniel F.,9999,0,9999,0
1653608808445,ECE 200,045,091047,Sworder; David D.,9999,0,9999,0
1653608808445,ECE 200,046,091048,Taur; Yuan,9999,0,9999,0
1653608808445,ECE 200,047,091049,Touri; Behrouz,9999,0,9999,0
1653608808445,ECE 200,048,091050,Trivedi; Mohan M.,9999,0,9999,0
1653608808445,ECE 200,049,091051,Vardy; Alexander,9999,0,9999,0
1653608808445,ECE 200,050,091052,Vasconcelos; Nuno,9999,0,9999,0
1653608808445,ECE 200,051,091053,Wang; Xiaolong,9999,0,9999,0
1653608808445,ECE 200,052,091054,Xie; Pengtao,9999,0,9999,0
1653608808445,ECE 200,053,091055,Yip; Michael,9999,0,9999,0
1653608808445,ECE 200,054,091056,Zeger; Kenneth A.,9999,0,9999,0
1653608808445,ECE 200,055,091057,Zhang; Xinyu,9999,0,9999,0
1653608808445,ECE 200,056,091058,Turakhia; Yatish Girish,9999,0,9999,0
1653608808445,ECE 200,057,091059,Kang; Mingu,9999,0,9999,0
1653608808445,ECE 200,058,091060,Shi; Yuanyuan,9999,0,9999,0
1653608808445,ECE 200,059,091061,Wang; Edward Jay,9999,0,9999,0
1653608808445,ECE 200,060,091062,Zheng; Yang,9999,0,9999,0
1653608808980,ECE 201,A00,095526,Lo; Yu-Hwa,0,0,0,0
1653608809503,ECE 203,A00,091065,Mercier; Patrick Philip,0,0,0,0
1653608810035,ECE 207A,A00,091605,Liu; Thomas Tao-Ming,0,0,0,0
1653608810557,ECE 212AN,A00,091068,Nomura; Kenji,0,0,0,0
1653608811083,ECE 222A,A00,091069,Rebeiz; Gabriel,0,0,0,0
1653608811608,ECE 225A,A00,091070,Orlitsky; Alon,0,0,0,0
1653608812140,ECE 230A,A00,091071,Nomura; Kenji,0,0,0,0
1653608812664,ECE 236A,A00,091072,Dayeh; Shadi Ahmad,0,0,0,0
1653608813201,ECE 238A,A00,091073,Luo; Jian,0,0,0,0
1653608813201,ECE 238A,B00,091074,Luo; Jian,0,0,0,0
1653608813737,ECE 240A,A00,091075,Radic; Stojan,0,0,0,0
1653608814259,ECE 247A,A00,091592,Shi; Lingyan,0,0,0,0
1653608814786,ECE 250,A00,091076,Touri; Behrouz,0,0,0,0
1653608815312,ECE 251C,A00,091078,Nguyen; Truong Quang,0,0,0,0
1653608815839,ECE 253,A00,091079,Cosman; Pamela C.,0,0,0,0
1653608816362,ECE 255A,A00,091080,Orlitsky; Alon,0,0,0,0
1653608816885,ECE 257A,A00,091081,Zhang; Xinyu,0,0,0,0
1653608817407,ECE 260A,A01,091084,Eldon; John,0,0,0,0
1653608817933,ECE 264C,A00,091085,Galton; Ian A,0,0,0,0
1653608818456,ECE 265C,A00,094889,Presti; Calogero Davide,0,0,0,9
1653608818981,ECE 266,A01,091087,Hall; Drew A.,0,0,0,0
1653608820029,ECE 271A,A00,091090,Vasconcelos; Nuno,0,0,0,0
1653608820559,ECE 272B,A00,091091,Sworder; David D.,0,0,0,0
1653608821090,ECE 275A,A00,091092,Meyer; Florian,0,0,0,0
1653608821616,ECE 277,A00,091093,An; Cheolhong,0,0,0,0
1653608822137,ECE 283,A00,091094,Le; Hanh-Phuc,0,0,0,0
1653608822667,ECE 284,A00,091095,Kang; Mingu,0,0,0,0
1653608822667,ECE 284,B00,091096,Wang; Edward Jay,0,0,0,0
1653608823191,ECE 285,A00,094334,Touri; Behrouz,0,0,0,0
1653608823724,ECE 289,A00,091097,Whelan; David Arthur,0,0,0,0
1653608824247,MATH 200A,A00,087414,Salehi Golsefidy; Alireza,7,0,8,1
1653608824775,MATH 202A,A00,087415,Gill; Philip E.,2,0,8,6
1653608825299,MATH 203A,A00,087416,Oprea; Dragos N.,6,0,8,2
1653608825827,MATH 204A,A00,087417,Kedlaya; Kiran S.,6,0,8,2
1653608826351,MATH 205,A00,087418,Sorensen; Claus M,6,0,8,2
1653608826883,MATH 206A,A00,087419,Izadi; Elham,7,0,8,1
1653608827409,MATH 207A,A00,087420,Mohammadi; Amir,5,0,8,3
1653608827931,MATH 208,A00,087421,Staff,9,0,10,1
1653608828465,MATH 209,A00,087422,Staff,10,0,10,0
1653608828987,MATH 218,A00,087423,Staff,10,0,10,0
1653608829515,MATH 220A,A00,087424,Novak; Jonathan I,6,0,8,2
1653608830047,MATH 231A,A00,087425,Bejenaru; Ioan,3,0,8,5
1653608830569,MATH 240A,A00,087426,Ebenfelt; Peter F,5,0,8,3
1653608831098,MATH 243,A00,087427,Staff,9,0,10,1
1653608831620,MATH 248,A00,087429,Staff,10,0,10,0
1653608832142,MATH 250A,A00,087430,Spolaor; Luca,4,0,8,4
1653608832667,MATH 257A,A00,087431,Spolaor; Luca,7,0,8,1
1653608833190,MATH 258,A00,087432,Staff,9,0,10,1
1653608833714,MATH 264A,A00,087433,Warnke; Lutz Peter,5,0,8,3
1653608834236,MATH 268,A00,087434,Staff,15,0,15,0
1653608834759,MATH 269,A00,087435,Staff,14,0,15,1
1653608835282,MATH 270A,A00,087436,Nie; Jiawang,0,0,8,8
1653608835805,MATH 272A,A00,087437,Tian; Xiaochuan,0,0,8,8
1653608836327,MATH 274,A01,087439,Cheng; Li-Tien,9,0,10,1
1653608836327,MATH 274,A02,087440,Cheng; Li-Tien,10,0,10,0
1653608836853,MATH 278A,A00,087441,Staff,8,0,10,2
1653608837385,MATH 278B,A00,087442,Staff,8,0,10,2
1653608837914,MATH 278C,A00,087443,Staff,8,0,10,2
1653608838439,MATH 280A,A00,087444,Zheng; Tianyi,0,0,8,8
1653608838961,MATH 281A,A00,087445,Bradic; Jelena,0,0,8,8
1653608839484,MATH 282A,A00,087446,Zhang; Danna,0,0,8,8
1653608840007,MATH 283,A00,087447,Tesler; Glenn,0,0,0,16
1653608840530,MATH 286,B00,095535,Kemp; Todd Aahron,5,0,8,3
1653608841052,MATH 287D,B00,095536,Bradic; Jelena,5,0,8,3
1653608841578,MATH 288,A00,087450,Staff,14,0,15,1
1653608841578,MATH 288,B00,087451,Staff,15,0,15,0
1653608841578,MATH 288,C00,087452,Staff,15,0,15,0
1653608842106,MATH 290A,A00,087453,Xu; Zhouli,6,0,8,2
1653608842631,MATH 291A,A00,087454,Xu; Zhouli,7,0,8,1
1653608843156,MATH 292,A00,087455,Staff,10,0,10,0
1653608843689,MATH 295,A00,087456,Staff,50,0,50,0
1653608844210,MATH 297,001,087457,Staff,997,0,999,2
1653609404038,COGS 200,A01,087991,Staff,47,0,50,3
1653609404569,COGS 201,A01,094504,Rangel; Lara M,16,0,25,9
1653609405090,COGS 203,A00,087992,Coulson; Seana M,18,0,20,2
1653609405623,COGS 210A,001,087993,Greene; Deanna Jacquelyn,9998,0,9999,1
1653609405623,COGS 210A,002,087994,Saygin; Ayse P,9999,0,9999,0
1653609405623,COGS 210A,003,087995,Xia; Haijun,9999,0,9999,0
1653609405623,COGS 210A,004,087996,Nitz; Douglas A.,9999,0,9999,0
1653609405623,COGS 210A,005,087997,Hollan; James D.,9999,0,9999,0
1653609405623,COGS 210A,006,087998,Deak; Gedeon O.,9998,0,9999,1
1653609405623,COGS 210A,007,087999,Rossano; Federico,9999,0,9999,0
1653609406148,COGS 211A,A00,088000,Coulson; Seana M,9997,0,9999,2
1653609406670,COGS 229,A00,088002,Staff,22,0,25,3
1653609407196,COGS 260,B00,094231,Staff,17,0,20,3
1653609407196,COGS 260,A00,088004,Nitz; Douglas A.,9998,0,9999,1
1653609407730,CSE 202,A00,090110,Paturi; Ramamohan,0,0,0,0
1653609407730,CSE 202,B00,090111,Paturi; Ramamohan,0,0,0,0
1653609408258,CSE 207B,A00,090112,Heninger; Nadia A,0,0,0,0
1653609408788,CSE 208,A00,094858,Micciancio; Daniele,0,0,0,0
1653609409313,CSE 210,A00,090113,Powell; Thomas Allan,0,0,0,0
1653609409850,CSE 219,A00,090898,Staff,0,0,0,0
1653609410379,CSE 221,A00,090114,Zhou; Yuan-Yuan,0,0,0,0
1653609410904,CSE 229A,A00,090115,Porter; George M,0,0,0,0
1653609411431,CSE 229C,A00,090116,Savage; Stefan,0,0,0,0
1653609411954,CSE 230,A00,090117,Jhala; Ranjit,0,0,0,0
1653609412476,CSE 232,A00,090118,Papakonstantinou; Yannis,0,0,0,0
1653609413002,CSE 239A,A00,090121,Kumar; Arun Kumar,0,0,0,0
1653609413524,CSE 239B,A00,090122,Jhala; Ranjit,0,0,0,0
1653609414048,CSE 240A,A00,090123,Zhao; Jishen,0,0,189,189
1653609414580,CSE 243A,A00,090124,Orailoglu; Alex,0,0,15,15
1653609415103,CSE 249B,A00,090125,Kahng; Andrew Byun,12,0,20,8
1653609415625,CSE 250A,A00,090126,Berg-Kirkpatrick; Taylor D,0,0,0,0
1653609416147,CSE 252A,A00,090127,Ochoa; Benjamin Lawrence,0,0,0,0
1653609416670,CSE 258,A01,090129,McAuley; Julian John,0,0,0,0
1653609417210,CSE 258R,A01,090131,McAuley; Julian John,0,0,0,0
1653609417734,CSE 274,A00,090132,Ramamoorthi; Ravi,0,0,0,0
1653609418256,CSE 276A,A00,090133,Christensen; Henrik I,0,0,0,0
1653609418782,CSE 276C,A00,090134,Christensen; Henrik I,0,0,0,0
1653609419309,CSE 290,A00,090135,Bafna; Vineet,0,0,0,0
1653609419309,CSE 290,B00,090136,Ramamoorthi; Ravi,0,0,0,0
1653609419309,CSE 290,C00,090137,Li; Tzumao,7,0,10,3
1653609419309,CSE 290,D00,090138,Zhou; Yuan-Yuan,9,0,10,1
1653609419309,CSE 290,E00,090139,Christensen; Henrik I,8,0,10,2
1653609419309,CSE 290,F00,094053,Shalev; Aaron D,0,0,0,0
1653609419845,CSE 291,A00,090140,Munyaka; Imani N. S.,0,0,0,0
1653609419845,CSE 291,B00,094880,Yu; Qi,0,0,0,0
1653609419845,CSE 291,C00,090142,Pannuto; Patrick William,0,0,0,0
1653609419845,CSE 291,D00,094881,Zhang; Yiying,0,0,0,0
1653609419845,CSE 291,E00,095118,Su; Hao,0,0,0,0
1653609420373,CSE 293,001,094905,Bafna; Vineet,9999,0,9999,0
1653609420373,CSE 293,002,094906,Bellare; Mihir,9999,0,9999,0
1653609420373,CSE 293,003,094907,Berg-Kirkpatrick; Taylor D,9999,0,9999,0
1653609420373,CSE 293,004,094908,Christensen; Henrik I,9999,0,9999,0
1653609420373,CSE 293,005,094909,Cottrell; Garrison W,9999,0,9999,0
1653609420373,CSE 293,006,094910,Deutsch; Alin Bernard,9999,0,9999,0
1653609420373,CSE 293,007,094911,Esmaeilzadeh; Hadi,9999,0,9999,0
1653609420373,CSE 293,008,094912,Freund; Yoav,9999,0,9999,0
1653609420373,CSE 293,009,094913,Griswold; William G.,9999,0,9999,0
1653609420373,CSE 293,010,094914,Gymrek; Melissa Ann,9999,0,9999,0
1653609420373,CSE 293,011,094915,Heninger; Nadia A,9999,0,9999,0
1653609420373,CSE 293,012,094916,Impagliazzo; Russell,9999,0,9999,0
1653609420373,CSE 293,013,094917,Jhala; Ranjit,9999,0,9999,0
1653609420373,CSE 293,014,094918,Kahng; Andrew Byun,9999,0,9999,0
1653609420373,CSE 293,015,094919,Kane; Daniel Mertz,9999,0,9999,0
1653609420373,CSE 293,016,094920,Kriegman; David J,9999,0,9999,0
1653609420373,CSE 293,017,094921,Kumar; Arun Kumar,9999,0,9999,0
1653609420373,CSE 293,018,094922,Lerner; Sorin,9999,0,9999,0
1653609420373,CSE 293,019,094923,Lovett; Shachar,9999,0,9999,0
1653609420373,CSE 293,020,094924,McAuley; Julian John,9999,0,9999,0
1653609420373,CSE 293,021,094925,Micciancio; Daniele,9999,0,9999,0
1653609420373,CSE 293,022,094926,Orailoglu; Alex,9999,0,9999,0
1653609420373,CSE 293,023,094927,Paturi; Ramamohan,9999,0,9999,0
1653609420373,CSE 293,024,094928,Polikarpova; Nadezhda,9999,0,9999,0
1653609420373,CSE 293,025,094929,Politz; Joseph Gibbs,9999,0,9999,0
1653609420373,CSE 293,026,094930,Porter; George M,9999,0,9999,0
1653609420373,CSE 293,027,094931,Porter; Leonard Emerson,9999,0,9999,0
1653609420373,CSE 293,028,094932,Ramamoorthi; Ravi,9999,0,9999,0
1653609420373,CSE 293,029,094933,Sahoo; Debashis,9999,0,9999,0
1653609420373,CSE 293,030,094934,Saul; Lawrence,9999,0,9999,0
1653609420373,CSE 293,031,094935,Savage; Stefan,9999,0,9999,0
1653609420373,CSE 293,032,094936,Schulze; Jurgen P.,9999,0,9999,0
1653609420373,CSE 293,033,094937,Snoeren; Alex C.,9999,0,9999,0
1653609420373,CSE 293,034,094938,Shang; Jingbo,9999,0,9999,0
1653609420373,CSE 293,035,094939,Stefan; Deian,9999,0,9999,0
1653609420373,CSE 293,036,094940,Su; Hao,9999,0,9999,0
1653609420373,CSE 293,037,094941,Swanson; Steven James,9999,0,9999,0
1653609420373,CSE 293,038,094942,Tullsen; Dean Michael,9999,0,9999,0
1653609420373,CSE 293,039,094943,Voelker; Geoffrey M.,9999,0,9999,0
1653609420373,CSE 293,040,094944,Zhao; Jishen,9999,0,9999,0
1653609420373,CSE 293,041,094945,Zhou; Yuan-Yuan,9999,0,9999,0
1653609420373,CSE 293,042,094946,Gao; Sicun,9998,0,9999,1
1653609420373,CSE 293,043,094947,Weibel; Nadir,9999,0,9999,0
1653609420373,CSE 293,044,094948,Gupta; Rajesh K.,9999,0,9999,0
1653609420896,CSE 294,A00,090143,Porter; George M,8,0,10,2
1653609421419,DSE 200,A00,091799,Staff,50,0,50,0
1653609421944,DSE 203,A00,091800,Gupta; Amarnath,30,0,30,0
1653609422465,DSE 250,A00,091801,Deutsch; Alin Bernard,30,0,30,0
1653609422990,DSE 290,A00,091802,Altintas De Callaf; Ilkay,50,0,50,0
1653609423519,ECE 200,001,091003,Antipa; Nicholas A,9999,0,9999,0
1653609423519,ECE 200,002,091004,Atanasov; Nikolay A.,9999,0,9999,0
1653609423519,ECE 200,003,091005,Bharadia; Dinesh,9999,0,9999,0
1653609423519,ECE 200,004,091006,Cheng; Chung Kuan,9999,0,9999,0
1653609423519,ECE 200,005,091007,Cosman; Pamela C.,9999,0,9999,0
1653609423519,ECE 200,006,091008,Staff,9999,0,9999,0
1653609423519,ECE 200,007,091009,Dayeh; Shadi Ahmad,9999,0,9999,0
1653609423519,ECE 200,008,091010,Fainman; Yeshaiahu,9999,0,9999,0
1653609423519,ECE 200,009,091011,Ford; Joseph Earl,9999,0,9999,0
1653609423519,ECE 200,010,091012,Franceschetti; Massimo,9999,0,9999,0
1653609423519,ECE 200,011,091013,Fullerton; Eric E,9999,0,9999,0
1653609423519,ECE 200,012,091014,Galton; Ian A,9999,0,9999,0
1653609423519,ECE 200,013,091015,Gilja; Vikash,9999,0,9999,0
1653609423519,ECE 200,014,091016,Hall; Drew A.,9999,0,9999,0
1653609423519,ECE 200,015,091017,Hsueh; Tzu-Chien,9999,0,9999,0
1653609423519,ECE 200,016,091018,Javidi; Tara,9999,0,9999,0
1653609423519,ECE 200,017,091019,Kahng; Andrew Byun,9999,0,9999,0
1653609423519,ECE 200,018,091020,Kim; Young-Han,9999,0,9999,0
1653609423519,ECE 200,019,091021,Koushanfar; Farinaz,9999,0,9999,0
1653609423519,ECE 200,020,091022,Kuzum; Duygu,9999,0,9999,0
1653609423519,ECE 200,021,091023,Le; Hanh-Phuc,9999,0,9999,0
1653609423519,ECE 200,022,091024,Lin; Bill,9999,0,9999,0
1653609423519,ECE 200,023,091025,Liu; Zhaowei,9999,0,9999,0
1653609423519,ECE 200,024,091026,Lo; Yu-Hwa,9999,0,9999,0
1653609423519,ECE 200,025,091027,Lomakin; Vitaliy,9999,0,9999,0
1653609423519,ECE 200,026,091028,Mercier; Patrick Philip,9999,0,9999,0
1653609423519,ECE 200,027,091029,Meyer; Florian,9999,0,9999,0
1653609423519,ECE 200,028,091030,Milstein; Laurence B.,9999,0,9999,0
1653609423519,ECE 200,029,091031,Mir Arabbaygi; Siavash,9999,0,9999,0
1653609423519,ECE 200,030,091032,Mookherjea; Shayan,9999,0,9999,0
1653609423519,ECE 200,031,091033,Morris; Karcher William,9999,0,9999,0
1653609423519,ECE 200,032,091034,Ng; Tse Nga,9999,0,9999,0
1653609423519,ECE 200,033,091035,Nguyen; Truong Quang,9999,0,9999,0
1653609423519,ECE 200,034,091036,Nomura; Kenji,9999,0,9999,0
1653609423519,ECE 200,035,091037,Orlitsky; Alon,9999,0,9999,0
1653609423519,ECE 200,036,091038,Pal; Piya,9999,0,9999,0
1653609423519,ECE 200,037,091039,Papen; George C.,9999,0,9999,0
1653609423519,ECE 200,038,091040,Radic; Stojan,9999,0,9999,0
1653609423519,ECE 200,039,091041,Rao; Bhaskar D.,9999,0,9999,0
1653609423519,ECE 200,040,091042,Rao; Ramesh R,9999,0,9999,0
1653609423519,ECE 200,041,091043,Rebeiz; Gabriel,9999,0,9999,0
1653609423519,ECE 200,042,091044,Sanford; John R,9999,0,9999,0
1653609423519,ECE 200,043,091045,Siegel; Paul H.,9999,0,9999,0
1653609423519,ECE 200,044,091046,Sievenpiper; Daniel F.,9999,0,9999,0
1653609423519,ECE 200,045,091047,Sworder; David D.,9999,0,9999,0
1653609423519,ECE 200,046,091048,Taur; Yuan,9999,0,9999,0
1653609423519,ECE 200,047,091049,Touri; Behrouz,9999,0,9999,0
1653609423519,ECE 200,048,091050,Trivedi; Mohan M.,9999,0,9999,0
1653609423519,ECE 200,049,091051,Vardy; Alexander,9999,0,9999,0
1653609423519,ECE 200,050,091052,Vasconcelos; Nuno,9999,0,9999,0
1653609423519,ECE 200,051,091053,Wang; Xiaolong,9999,0,9999,0
1653609423519,ECE 200,052,091054,Xie; Pengtao,9999,0,9999,0
1653609423519,ECE 200,053,091055,Yip; Michael,9999,0,9999,0
1653609423519,ECE 200,054,091056,Zeger; Kenneth A.,9999,0,9999,0
1653609423519,ECE 200,055,091057,Zhang; Xinyu,9999,0,9999,0
1653609423519,ECE 200,056,091058,Turakhia; Yatish Girish,9999,0,9999,0
1653609423519,ECE 200,057,091059,Kang; Mingu,9999,0,9999,0
1653609423519,ECE 200,058,091060,Shi; Yuanyuan,9999,0,9999,0
1653609423519,ECE 200,059,091061,Wang; Edward Jay,9999,0,9999,0
1653609423519,ECE 200,060,091062,Zheng; Yang,9999,0,9999,0
1653609424052,ECE 201,A00,095526,Lo; Yu-Hwa,0,0,0,0
1653609424576,ECE 203,A00,091065,Mercier; Patrick Philip,0,0,0,0
1653609425103,ECE 207A,A00,091605,Liu; Thomas Tao-Ming,0,0,0,0
1653609425638,ECE 212AN,A00,091068,Nomura; Kenji,0,0,0,0
1653609426170,ECE 222A,A00,091069,Rebeiz; Gabriel,0,0,0,0
1653609426692,ECE 225A,A00,091070,Orlitsky; Alon,0,0,0,0
1653609427215,ECE 230A,A00,091071,Nomura; Kenji,0,0,0,0
1653609427754,ECE 236A,A00,091072,Dayeh; Shadi Ahmad,0,0,0,0
1653609428281,ECE 238A,A00,091073,Luo; Jian,0,0,0,0
1653609428281,ECE 238A,B00,091074,Luo; Jian,0,0,0,0
1653609428810,ECE 240A,A00,091075,Radic; Stojan,0,0,0,0
1653609429331,ECE 247A,A00,091592,Shi; Lingyan,0,0,0,0
1653609429857,ECE 250,A00,091076,Touri; Behrouz,0,0,0,0
1653609430379,ECE 251C,A00,091078,Nguyen; Truong Quang,0,0,0,0
1653609430904,ECE 253,A00,091079,Cosman; Pamela C.,0,0,0,0
1653609431428,ECE 255A,A00,091080,Orlitsky; Alon,0,0,0,0
1653609431954,ECE 257A,A00,091081,Zhang; Xinyu,0,0,0,0
1653609432480,ECE 260A,A01,091084,Eldon; John,0,0,0,0
1653609433006,ECE 264C,A00,091085,Galton; Ian A,0,0,0,0
1653609433533,ECE 265C,A00,094889,Presti; Calogero Davide,0,0,0,9
1653609434054,ECE 266,A01,091087,Hall; Drew A.,0,0,0,0
1653609435104,ECE 271A,A00,091090,Vasconcelos; Nuno,0,0,0,0
1653609435626,ECE 272B,A00,091091,Sworder; David D.,0,0,0,0
1653609436148,ECE 275A,A00,091092,Meyer; Florian,0,0,0,0
1653609436679,ECE 277,A00,091093,An; Cheolhong,0,0,0,0
1653609437203,ECE 283,A00,091094,Le; Hanh-Phuc,0,0,0,0
1653609437725,ECE 284,A00,091095,Kang; Mingu,0,0,0,0
1653609437725,ECE 284,B00,091096,Wang; Edward Jay,0,0,0,0
1653609438248,ECE 285,A00,094334,Touri; Behrouz,0,0,0,0
1653609438774,ECE 289,A00,091097,Whelan; David Arthur,0,0,0,0
1653609439307,MATH 200A,A00,087414,Salehi Golsefidy; Alireza,7,0,8,1
1653609439854,MATH 202A,A00,087415,Gill; Philip E.,2,0,8,6
1653609440387,MATH 203A,A00,087416,Oprea; Dragos N.,6,0,8,2
1653609440910,MATH 204A,A00,087417,Kedlaya; Kiran S.,6,0,8,2
1653609441432,MATH 205,A00,087418,Sorensen; Claus M,6,0,8,2
1653609442059,MATH 206A,A00,087419,Izadi; Elham,7,0,8,1
1653609442584,MATH 207A,A00,087420,Mohammadi; Amir,5,0,8,3
1653609443107,MATH 208,A00,087421,Staff,9,0,10,1
1653609443634,MATH 209,A00,087422,Staff,10,0,10,0
1653609444164,MATH 218,A00,087423,Staff,10,0,10,0
1653609444689,MATH 220A,A00,087424,Novak; Jonathan I,6,0,8,2
1653609445213,MATH 231A,A00,087425,Bejenaru; Ioan,3,0,8,5
1653609445746,MATH 240A,A00,087426,Ebenfelt; Peter F,5,0,8,3
1653609446281,MATH 243,A00,087427,Staff,9,0,10,1
1653609446804,MATH 248,A00,087429,Staff,10,0,10,0
1653609447330,MATH 250A,A00,087430,Spolaor; Luca,4,0,8,4
1653609447855,MATH 257A,A00,087431,Spolaor; Luca,7,0,8,1
1653609448376,MATH 258,A00,087432,Staff,9,0,10,1
1653609448900,MATH 264A,A00,087433,Warnke; Lutz Peter,5,0,8,3
1653609449427,MATH 268,A00,087434,Staff,15,0,15,0
1653609449952,MATH 269,A00,087435,Staff,14,0,15,1
1653609450481,MATH 270A,A00,087436,Nie; Jiawang,0,0,8,8
1653609451005,MATH 272A,A00,087437,Tian; Xiaochuan,0,0,8,8
1653609451531,MATH 274,A01,087439,Cheng; Li-Tien,9,0,10,1
1653609451531,MATH 274,A02,087440,Cheng; Li-Tien,10,0,10,0
1653609452055,MATH 278A,A00,087441,Staff,8,0,10,2
1653609452578,MATH 278B,A00,087442,Staff,8,0,10,2
1653609453112,MATH 278C,A00,087443,Staff,8,0,10,2
1653609453638,MATH 280A,A00,087444,Zheng; Tianyi,0,0,8,8
1653609454166,MATH 281A,A00,087445,Bradic; Jelena,0,0,8,8
1653609454689,MATH 282A,A00,087446,Zhang; Danna,0,0,8,8
1653609455212,MATH 283,A00,087447,Tesler; Glenn,0,0,0,16
1653609455738,MATH 286,B00,095535,Kemp; Todd Aahron,5,0,8,3
1653609456264,MATH 287D,B00,095536,Bradic; Jelena,5,0,8,3
1653609456786,MATH 288,A00,087450,Staff,14,0,15,1
1653609456786,MATH 288,B00,087451,Staff,15,0,15,0
1653609456786,MATH 288,C00,087452,Staff,15,0,15,0
1653609457309,MATH 290A,A00,087453,Xu; Zhouli,6,0,8,2
1653609457838,MATH 291A,A00,087454,Xu; Zhouli,7,0,8,1
1653609458365,MATH 292,A00,087455,Staff,10,0,10,0
1653609458895,MATH 295,A00,087456,Staff,50,0,50,0
1653609459425,MATH 297,001,087457,Staff,997,0,999,2
1653610019837,COGS 200,A01,087991,Staff,47,0,50,3
1653610020368,COGS 201,A01,094504,Rangel; Lara M,16,0,25,9
1653610020894,COGS 203,A00,087992,Coulson; Seana M,18,0,20,2
1653610021418,COGS 210A,001,087993,Greene; Deanna Jacquelyn,9998,0,9999,1
1653610021418,COGS 210A,002,087994,Saygin; Ayse P,9999,0,9999,0
1653610021418,COGS 210A,003,087995,Xia; Haijun,9999,0,9999,0
1653610021418,COGS 210A,004,087996,Nitz; Douglas A.,9999,0,9999,0
1653610021418,COGS 210A,005,087997,Hollan; James D.,9999,0,9999,0
1653610021418,COGS 210A,006,087998,Deak; Gedeon O.,9998,0,9999,1
1653610021418,COGS 210A,007,087999,Rossano; Federico,9999,0,9999,0
1653610021948,COGS 211A,A00,088000,Coulson; Seana M,9997,0,9999,2
1653610022469,COGS 229,A00,088002,Staff,22,0,25,3
1653610023000,COGS 260,B00,094231,Staff,17,0,20,3
1653610023000,COGS 260,A00,088004,Nitz; Douglas A.,9998,0,9999,1
1653610023527,CSE 202,A00,090110,Paturi; Ramamohan,0,0,0,0
1653610023527,CSE 202,B00,090111,Paturi; Ramamohan,0,0,0,0
1653610024050,CSE 207B,A00,090112,Heninger; Nadia A,0,0,0,0
1653610024573,CSE 208,A00,094858,Micciancio; Daniele,0,0,0,0
1653610025105,CSE 210,A00,090113,Powell; Thomas Allan,0,0,0,0
1653610025638,CSE 219,A00,090898,Staff,0,0,0,0
1653610026161,CSE 221,A00,090114,Zhou; Yuan-Yuan,0,0,0,0
1653610026682,CSE 229A,A00,090115,Porter; George M,0,0,0,0
1653610027203,CSE 229C,A00,090116,Savage; Stefan,0,0,0,0
1653610027727,CSE 230,A00,090117,Jhala; Ranjit,0,0,0,0
1653610028263,CSE 232,A00,090118,Papakonstantinou; Yannis,0,0,0,0
1653610028786,CSE 239A,A00,090121,Kumar; Arun Kumar,0,0,0,0
1653610029316,CSE 239B,A00,090122,Jhala; Ranjit,0,0,0,0
1653610029938,CSE 240A,A00,090123,Zhao; Jishen,0,0,189,189
1653610030467,CSE 243A,A00,090124,Orailoglu; Alex,0,0,15,15
1653610030994,CSE 249B,A00,090125,Kahng; Andrew Byun,12,0,20,8
1653610031516,CSE 250A,A00,090126,Berg-Kirkpatrick; Taylor D,0,0,0,0
1653610032038,CSE 252A,A00,090127,Ochoa; Benjamin Lawrence,0,0,0,0
1653610032559,CSE 258,A01,090129,McAuley; Julian John,0,0,0,0
1653610033081,CSE 258R,A01,090131,McAuley; Julian John,0,0,0,0
1653610033603,CSE 274,A00,090132,Ramamoorthi; Ravi,0,0,0,0
1653610034130,CSE 276A,A00,090133,Christensen; Henrik I,0,0,0,0
1653610034659,CSE 276C,A00,090134,Christensen; Henrik I,0,0,0,0
1653610035185,CSE 290,A00,090135,Bafna; Vineet,0,0,0,0
1653610035185,CSE 290,B00,090136,Ramamoorthi; Ravi,0,0,0,0
1653610035185,CSE 290,C00,090137,Li; Tzumao,7,0,10,3
1653610035185,CSE 290,D00,090138,Zhou; Yuan-Yuan,9,0,10,1
1653610035185,CSE 290,E00,090139,Christensen; Henrik I,8,0,10,2
1653610035185,CSE 290,F00,094053,Shalev; Aaron D,0,0,0,0
1653610035715,CSE 291,A00,090140,Munyaka; Imani N. S.,0,0,0,0
1653610035715,CSE 291,B00,094880,Yu; Qi,0,0,0,0
1653610035715,CSE 291,C00,090142,Pannuto; Patrick William,0,0,0,0
1653610035715,CSE 291,D00,094881,Zhang; Yiying,0,0,0,0
1653610035715,CSE 291,E00,095118,Su; Hao,0,0,0,0
1653610036285,CSE 293,001,094905,Bafna; Vineet,9999,0,9999,0
1653610036285,CSE 293,002,094906,Bellare; Mihir,9999,0,9999,0
1653610036285,CSE 293,003,094907,Berg-Kirkpatrick; Taylor D,9999,0,9999,0
1653610036285,CSE 293,004,094908,Christensen; Henrik I,9999,0,9999,0
1653610036285,CSE 293,005,094909,Cottrell; Garrison W,9999,0,9999,0
1653610036285,CSE 293,006,094910,Deutsch; Alin Bernard,9999,0,9999,0
1653610036285,CSE 293,007,094911,Esmaeilzadeh; Hadi,9999,0,9999,0
1653610036285,CSE 293,008,094912,Freund; Yoav,9999,0,9999,0
1653610036285,CSE 293,009,094913,Griswold; William G.,9999,0,9999,0
1653610036285,CSE 293,010,094914,Gymrek; Melissa Ann,9999,0,9999,0
1653610036285,CSE 293,011,094915,Heninger; Nadia A,9999,0,9999,0
1653610036285,CSE 293,012,094916,Impagliazzo; Russell,9999,0,9999,0
1653610036285,CSE 293,013,094917,Jhala; Ranjit,9999,0,9999,0
1653610036285,CSE 293,014,094918,Kahng; Andrew Byun,9999,0,9999,0
1653610036285,CSE 293,015,094919,Kane; Daniel Mertz,9999,0,9999,0
1653610036285,CSE 293,016,094920,Kriegman; David J,9999,0,9999,0
1653610036285,CSE 293,017,094921,Kumar; Arun Kumar,9999,0,9999,0
1653610036285,CSE 293,018,094922,Lerner; Sorin,9999,0,9999,0
1653610036285,CSE 293,019,094923,Lovett; Shachar,9999,0,9999,0
1653610036285,CSE 293,020,094924,McAuley; Julian John,9999,0,9999,0
1653610036285,CSE 293,021,094925,Micciancio; Daniele,9999,0,9999,0
1653610036285,CSE 293,022,094926,Orailoglu; Alex,9999,0,9999,0
1653610036285,CSE 293,023,094927,Paturi; Ramamohan,9999,0,9999,0
1653610036285,CSE 293,024,094928,Polikarpova; Nadezhda,9999,0,9999,0
1653610036285,CSE 293,025,094929,Politz; Joseph Gibbs,9999,0,9999,0
1653610036285,CSE 293,026,094930,Porter; George M,9999,0,9999,0
1653610036285,CSE 293,027,094931,Porter; Leonard Emerson,9999,0,9999,0
1653610036285,CSE 293,028,094932,Ramamoorthi; Ravi,9999,0,9999,0
1653610036285,CSE 293,029,094933,Sahoo; Debashis,9999,0,9999,0
1653610036285,CSE 293,030,094934,Saul; Lawrence,9999,0,9999,0
1653610036285,CSE 293,031,094935,Savage; Stefan,9999,0,9999,0
1653610036285,CSE 293,032,094936,Schulze; Jurgen P.,9999,0,9999,0
1653610036285,CSE 293,033,094937,Snoeren; Alex C.,9999,0,9999,0
1653610036285,CSE 293,034,094938,Shang; Jingbo,9999,0,9999,0
1653610036285,CSE 293,035,094939,Stefan; Deian,9999,0,9999,0
1653610036285,CSE 293,036,094940,Su; Hao,9999,0,9999,0
1653610036285,CSE 293,037,094941,Swanson; Steven James,9999,0,9999,0
1653610036285,CSE 293,038,094942,Tullsen; Dean Michael,9999,0,9999,0
1653610036285,CSE 293,039,094943,Voelker; Geoffrey M.,9999,0,9999,0
1653610036285,CSE 293,040,094944,Zhao; Jishen,9999,0,9999,0
1653610036285,CSE 293,041,094945,Zhou; Yuan-Yuan,9999,0,9999,0
1653610036285,CSE 293,042,094946,Gao; Sicun,9998,0,9999,1
1653610036285,CSE 293,043,094947,Weibel; Nadir,9999,0,9999,0
1653610036285,CSE 293,044,094948,Gupta; Rajesh K.,9999,0,9999,0
1653610036807,CSE 294,A00,090143,Porter; George M,8,0,10,2
1653610037329,DSE 200,A00,091799,Staff,50,0,50,0
1653610037852,DSE 203,A00,091800,Gupta; Amarnath,30,0,30,0
1653610038374,DSE 250,A00,091801,Deutsch; Alin Bernard,30,0,30,0
1653610038901,DSE 290,A00,091802,Altintas De Callaf; Ilkay,50,0,50,0
1653610039461,ECE 200,001,091003,Antipa; Nicholas A,9999,0,9999,0
1653610039461,ECE 200,002,091004,Atanasov; Nikolay A.,9999,0,9999,0
1653610039461,ECE 200,003,091005,Bharadia; Dinesh,9999,0,9999,0
1653610039461,ECE 200,004,091006,Cheng; Chung Kuan,9999,0,9999,0
1653610039461,ECE 200,005,091007,Cosman; Pamela C.,9999,0,9999,0
1653610039461,ECE 200,006,091008,Staff,9999,0,9999,0
1653610039461,ECE 200,007,091009,Dayeh; Shadi Ahmad,9999,0,9999,0
1653610039461,ECE 200,008,091010,Fainman; Yeshaiahu,9999,0,9999,0
1653610039461,ECE 200,009,091011,Ford; Joseph Earl,9999,0,9999,0
1653610039461,ECE 200,010,091012,Franceschetti; Massimo,9999,0,9999,0
1653610039461,ECE 200,011,091013,Fullerton; Eric E,9999,0,9999,0
1653610039461,ECE 200,012,091014,Galton; Ian A,9999,0,9999,0
1653610039461,ECE 200,013,091015,Gilja; Vikash,9999,0,9999,0
1653610039461,ECE 200,014,091016,Hall; Drew A.,9999,0,9999,0
1653610039461,ECE 200,015,091017,Hsueh; Tzu-Chien,9999,0,9999,0
1653610039461,ECE 200,016,091018,Javidi; Tara,9999,0,9999,0
1653610039461,ECE 200,017,091019,Kahng; Andrew Byun,9999,0,9999,0
1653610039461,ECE 200,018,091020,Kim; Young-Han,9999,0,9999,0
1653610039461,ECE 200,019,091021,Koushanfar; Farinaz,9999,0,9999,0
1653610039461,ECE 200,020,091022,Kuzum; Duygu,9999,0,9999,0
1653610039461,ECE 200,021,091023,Le; Hanh-Phuc,9999,0,9999,0
1653610039461,ECE 200,022,091024,Lin; Bill,9999,0,9999,0
1653610039461,ECE 200,023,091025,Liu; Zhaowei,9999,0,9999,0
1653610039461,ECE 200,024,091026,Lo; Yu-Hwa,9999,0,9999,0
1653610039461,ECE 200,025,091027,Lomakin; Vitaliy,9999,0,9999,0
1653610039461,ECE 200,026,091028,Mercier; Patrick Philip,9999,0,9999,0
1653610039461,ECE 200,027,091029,Meyer; Florian,9999,0,9999,0
1653610039461,ECE 200,028,091030,Milstein; Laurence B.,9999,0,9999,0
1653610039461,ECE 200,029,091031,Mir Arabbaygi; Siavash,9999,0,9999,0
1653610039461,ECE 200,030,091032,Mookherjea; Shayan,9999,0,9999,0
1653610039461,ECE 200,031,091033,Morris; Karcher William,9999,0,9999,0
1653610039461,ECE 200,032,091034,Ng; Tse Nga,9999,0,9999,0
1653610039461,ECE 200,033,091035,Nguyen; Truong Quang,9999,0,9999,0
1653610039461,ECE 200,034,091036,Nomura; Kenji,9999,0,9999,0
1653610039461,ECE 200,035,091037,Orlitsky; Alon,9999,0,9999,0
1653610039461,ECE 200,036,091038,Pal; Piya,9999,0,9999,0
1653610039461,ECE 200,037,091039,Papen; George C.,9999,0,9999,0
1653610039461,ECE 200,038,091040,Radic; Stojan,9999,0,9999,0
1653610039461,ECE 200,039,091041,Rao; Bhaskar D.,9999,0,9999,0
1653610039461,ECE 200,040,091042,Rao; Ramesh R,9999,0,9999,0
1653610039461,ECE 200,041,091043,Rebeiz; Gabriel,9999,0,9999,0
1653610039461,ECE 200,042,091044,Sanford; John R,9999,0,9999,0
1653610039461,ECE 200,043,091045,Siegel; Paul H.,9999,0,9999,0
1653610039461,ECE 200,044,091046,Sievenpiper; Daniel F.,9999,0,9999,0
1653610039461,ECE 200,045,091047,Sworder; David D.,9999,0,9999,0
1653610039461,ECE 200,046,091048,Taur; Yuan,9999,0,9999,0
1653610039461,ECE 200,047,091049,Touri; Behrouz,9999,0,9999,0
1653610039461,ECE 200,048,091050,Trivedi; Mohan M.,9999,0,9999,0
1653610039461,ECE 200,049,091051,Vardy; Alexander,9999,0,9999,0
1653610039461,ECE 200,050,091052,Vasconcelos; Nuno,9999,0,9999,0
1653610039461,ECE 200,051,091053,Wang; Xiaolong,9999,0,9999,0
1653610039461,ECE 200,052,091054,Xie; Pengtao,9999,0,9999,0
1653610039461,ECE 200,053,091055,Yip; Michael,9999,0,9999,0
1653610039461,ECE 200,054,091056,Zeger; Kenneth A.,9999,0,9999,0
1653610039461,ECE 200,055,091057,Zhang; Xinyu,9999,0,9999,0
1653610039461,ECE 200,056,091058,Turakhia; Yatish Girish,9999,0,9999,0
1653610039461,ECE 200,057,091059,Kang; Mingu,9999,0,9999,0
1653610039461,ECE 200,058,091060,Shi; Yuanyuan,9999,0,9999,0
1653610039461,ECE 200,059,091061,Wang; Edward Jay,9999,0,9999,0
1653610039461,ECE 200,060,091062,Zheng; Yang,9999,0,9999,0
1653610039985,ECE 201,A00,095526,Lo; Yu-Hwa,0,0,0,0
1653610040509,ECE 203,A00,091065,Mercier; Patrick Philip,0,0,0,0
1653610041034,ECE 207A,A00,091605,Liu; Thomas Tao-Ming,0,0,0,0
1653610041559,ECE 212AN,A00,091068,Nomura; Kenji,0,0,0,0
1653610042081,ECE 222A,A00,091069,Rebeiz; Gabriel,0,0,0,0
1653610042616,ECE 225A,A00,091070,Orlitsky; Alon,0,0,0,0
1653610043141,ECE 230A,A00,091071,Nomura; Kenji,0,0,0,0
1653610043667,ECE 236A,A00,091072,Dayeh; Shadi Ahmad,0,0,0,0
1653610044192,ECE 238A,A00,091073,Luo; Jian,0,0,0,0
1653610044192,ECE 238A,B00,091074,Luo; Jian,0,0,0,0
1653610044714,ECE 240A,A00,091075,Radic; Stojan,0,0,0,0
1653610045237,ECE 247A,A00,091592,Shi; Lingyan,0,0,0,0
1653610045759,ECE 250,A00,091076,Touri; Behrouz,0,0,0,0
1653610046287,ECE 251C,A00,091078,Nguyen; Truong Quang,0,0,0,0
1653610046827,ECE 253,A00,091079,Cosman; Pamela C.,0,0,0,0
1653610047355,ECE 255A,A00,091080,Orlitsky; Alon,0,0,0,0
1653610047889,ECE 257A,A00,091081,Zhang; Xinyu,0,0,0,0
1653610048416,ECE 260A,A01,091084,Eldon; John,0,0,0,0
1653610048939,ECE 264C,A00,091085,Galton; Ian A,0,0,0,0
1653610049464,ECE 265C,A00,094889,Presti; Calogero Davide,0,0,0,9
1653610049995,ECE 266,A01,091087,Hall; Drew A.,0,0,0,0
1653610051062,ECE 271A,A00,091090,Vasconcelos; Nuno,0,0,0,0
1653610051588,ECE 272B,A00,091091,Sworder; David D.,0,0,0,0
1653610052115,ECE 275A,A00,091092,Meyer; Florian,0,0,0,0
1653610052641,ECE 277,A00,091093,An; Cheolhong,0,0,0,0
1653610053168,ECE 283,A00,091094,Le; Hanh-Phuc,0,0,0,0
1653610053689,ECE 284,A00,091095,Kang; Mingu,0,0,0,0
1653610053689,ECE 284,B00,091096,Wang; Edward Jay,0,0,0,0
1653610054214,ECE 285,A00,094334,Touri; Behrouz,0,0,0,0
1653610054746,ECE 289,A00,091097,Whelan; David Arthur,0,0,0,0
1653610055273,MATH 200A,A00,087414,Salehi Golsefidy; Alireza,7,0,8,1
1653610055805,MATH 202A,A00,087415,Gill; Philip E.,2,0,8,6
1653610056327,MATH 203A,A00,087416,Oprea; Dragos N.,6,0,8,2
1653610056853,MATH 204A,A00,087417,Kedlaya; Kiran S.,6,0,8,2
1653610057377,MATH 205,A00,087418,Sorensen; Claus M,6,0,8,2
1653610057899,MATH 206A,A00,087419,Izadi; Elham,7,0,8,1
1653610058423,MATH 207A,A00,087420,Mohammadi; Amir,5,0,8,3
1653610058947,MATH 208,A00,087421,Staff,9,0,10,1
1653610059471,MATH 209,A00,087422,Staff,10,0,10,0
1653610059994,MATH 218,A00,087423,Staff,10,0,10,0
1653610060517,MATH 220A,A00,087424,Novak; Jonathan I,6,0,8,2
1653610061041,MATH 231A,A00,087425,Bejenaru; Ioan,3,0,8,5
1653610061567,MATH 240A,A00,087426,Ebenfelt; Peter F,5,0,8,3
1653610062092,MATH 243,A00,087427,Staff,9,0,10,1
1653610062620,MATH 248,A00,087429,Staff,10,0,10,0
1653610063146,MATH 250A,A00,087430,Spolaor; Luca,4,0,8,4
1653610063669,MATH 257A,A00,087431,Spolaor; Luca,7,0,8,1
1653610064194,MATH 258,A00,087432,Staff,9,0,10,1
1653610064719,MATH 264A,A00,087433,Warnke; Lutz Peter,5,0,8,3
1653610065240,MATH 268,A00,087434,Staff,15,0,15,0
1653610065765,MATH 269,A00,087435,Staff,14,0,15,1
1653610066287,MATH 270A,A00,087436,Nie; Jiawang,0,0,8,8
1653610066816,MATH 272A,A00,087437,Tian; Xiaochuan,0,0,8,9
1653610067343,MATH 274,A01,087439,Cheng; Li-Tien,9,0,10,1
1653610067343,MATH 274,A02,087440,Cheng; Li-Tien,10,0,10,0
1653610067866,MATH 278A,A00,087441,Staff,8,0,10,2
1653610068393,MATH 278B,A00,087442,Staff,8,0,10,2
1653610068916,MATH 278C,A00,087443,Staff,8,0,10,2
1653610069441,MATH 280A,A00,087444,Zheng; Tianyi,0,0,8,8
1653610069967,MATH 281A,A00,087445,Bradic; Jelena,0,0,8,9
1653610070496,MATH 282A,A00,087446,Zhang; Danna,0,0,8,8
1653610071028,MATH 283,A00,087447,Tesler; Glenn,0,0,0,16
1653610071550,MATH 286,B00,095535,Kemp; Todd Aahron,5,0,8,3
1653610072073,MATH 287D,B00,095536,Bradic; Jelena,5,0,8,3
1653610072599,MATH 288,A00,087450,Staff,14,0,15,1
1653610072599,MATH 288,B00,087451,Staff,15,0,15,0
1653610072599,MATH 288,C00,087452,Staff,15,0,15,0
1653610073130,MATH 290A,A00,087453,Xu; Zhouli,6,0,8,2
1653610073653,MATH 291A,A00,087454,Xu; Zhouli,7,0,8,1
1653610074175,MATH 292,A00,087455,Staff,10,0,10,0
1653610074706,MATH 295,A00,087456,Staff,50,0,50,0
1653610075236,MATH 297,001,087457,Staff,997,0,999,2
1653610635811,COGS 200,A01,087991,Staff,47,0,50,3
1653610636333,COGS 201,A01,094504,Rangel; Lara M,16,0,25,9
1653610636855,COGS 203,A00,087992,Coulson; Seana M,18,0,20,2
1653610637384,COGS 210A,001,087993,Greene; Deanna Jacquelyn,9998,0,9999,1
1653610637384,COGS 210A,002,087994,Saygin; Ayse P,9999,0,9999,0
1653610637384,COGS 210A,003,087995,Xia; Haijun,9999,0,9999,0
1653610637384,COGS 210A,004,087996,Nitz; Douglas A.,9999,0,9999,0
1653610637384,COGS 210A,005,087997,Hollan; James D.,9999,0,9999,0
1653610637384,COGS 210A,006,087998,Deak; Gedeon O.,9998,0,9999,1
1653610637384,COGS 210A,007,087999,Rossano; Federico,9999,0,9999,0
1653610637908,COGS 211A,A00,088000,Coulson; Seana M,9997,0,9999,2
1653610638432,COGS 229,A00,088002,Staff,22,0,25,3
1653610638956,COGS 260,B00,094231,Staff,17,0,20,3
1653610638956,COGS 260,A00,088004,Nitz; Douglas A.,9998,0,9999,1
1653610639482,CSE 202,A00,090110,Paturi; Ramamohan,0,0,0,0
1653610639482,CSE 202,B00,090111,Paturi; Ramamohan,0,0,0,0
1653610640006,CSE 207B,A00,090112,Heninger; Nadia A,0,0,0,0
1653610640540,CSE 208,A00,094858,Micciancio; Daniele,0,0,0,0
1653610641063,CSE 210,A00,090113,Powell; Thomas Allan,0,0,0,0
1653610641589,CSE 219,A00,090898,Staff,0,0,0,0
1653610642111,CSE 221,A00,090114,Zhou; Yuan-Yuan,0,0,0,0
1653610642639,CSE 229A,A00,090115,Porter; George M,0,0,0,0
1653610643169,CSE 229C,A00,090116,Savage; Stefan,0,0,0,0
1653610643692,CSE 230,A00,090117,Jhala; Ranjit,0,0,0,0
1653610644226,CSE 232,A00,090118,Papakonstantinou; Yannis,0,0,0,0
1653610644747,CSE 239A,A00,090121,Kumar; Arun Kumar,0,0,0,0
1653610645269,CSE 239B,A00,090122,Jhala; Ranjit,0,0,0,0
1653610645797,CSE 240A,A00,090123,Zhao; Jishen,0,0,189,189
1653610646319,CSE 243A,A00,090124,Orailoglu; Alex,0,0,15,15
1653610646845,CSE 249B,A00,090125,Kahng; Andrew Byun,12,0,20,8
1653610647367,CSE 250A,A00,090126,Berg-Kirkpatrick; Taylor D,0,0,0,0
1653610647893,CSE 252A,A00,090127,Ochoa; Benjamin Lawrence,0,0,0,0
1653610648419,CSE 258,A01,090129,McAuley; Julian John,0,0,0,0
1653610648944,CSE 258R,A01,090131,McAuley; Julian John,0,0,0,0
1653610649466,CSE 274,A00,090132,Ramamoorthi; Ravi,0,0,0,0
1653610649992,CSE 276A,A00,090133,Christensen; Henrik I,0,0,0,0
1653610650522,CSE 276C,A00,090134,Christensen; Henrik I,0,0,0,0
1653610651049,CSE 290,A00,090135,Bafna; Vineet,0,0,0,0
1653610651049,CSE 290,B00,090136,Ramamoorthi; Ravi,0,0,0,0
1653610651049,CSE 290,C00,090137,Li; Tzumao,7,0,10,3
1653610651049,CSE 290,D00,090138,Zhou; Yuan-Yuan,9,0,10,1
1653610651049,CSE 290,E00,090139,Christensen; Henrik I,8,0,10,2
1653610651049,CSE 290,F00,094053,Shalev; Aaron D,0,0,0,0
1653610651577,CSE 291,A00,090140,Munyaka; Imani N. S.,0,0,0,0
1653610651577,CSE 291,B00,094880,Yu; Qi,0,0,0,0
1653610651577,CSE 291,C00,090142,Pannuto; Patrick William,0,0,0,0
1653610651577,CSE 291,D00,094881,Zhang; Yiying,0,0,0,0
1653610651577,CSE 291,E00,095118,Su; Hao,0,0,0,0
1653610652102,CSE 293,001,094905,Bafna; Vineet,9999,0,9999,0
1653610652102,CSE 293,002,094906,Bellare; Mihir,9999,0,9999,0
1653610652102,CSE 293,003,094907,Berg-Kirkpatrick; Taylor D,9999,0,9999,0
1653610652102,CSE 293,004,094908,Christensen; Henrik I,9999,0,9999,0
1653610652102,CSE 293,005,094909,Cottrell; Garrison W,9999,0,9999,0
1653610652102,CSE 293,006,094910,Deutsch; Alin Bernard,9999,0,9999,0
1653610652102,CSE 293,007,094911,Esmaeilzadeh; Hadi,9999,0,9999,0
1653610652102,CSE 293,008,094912,Freund; Yoav,9999,0,9999,0
1653610652102,CSE 293,009,094913,Griswold; William G.,9999,0,9999,0
1653610652102,CSE 293,010,094914,Gymrek; Melissa Ann,9999,0,9999,0
1653610652102,CSE 293,011,094915,Heninger; Nadia A,9999,0,9999,0
1653610652102,CSE 293,012,094916,Impagliazzo; Russell,9999,0,9999,0
1653610652102,CSE 293,013,094917,Jhala; Ranjit,9999,0,9999,0
1653610652102,CSE 293,014,094918,Kahng; Andrew Byun,9999,0,9999,0
1653610652102,CSE 293,015,094919,Kane; Daniel Mertz,9999,0,9999,0
1653610652102,CSE 293,016,094920,Kriegman; David J,9999,0,9999,0
1653610652102,CSE 293,017,094921,Kumar; Arun Kumar,9999,0,9999,0
1653610652102,CSE 293,018,094922,Lerner; Sorin,9999,0,9999,0
1653610652102,CSE 293,019,094923,Lovett; Shachar,9999,0,9999,0
1653610652102,CSE 293,020,094924,McAuley; Julian John,9999,0,9999,0
1653610652102,CSE 293,021,094925,Micciancio; Daniele,9999,0,9999,0
1653610652102,CSE 293,022,094926,Orailoglu; Alex,9999,0,9999,0
1653610652102,CSE 293,023,094927,Paturi; Ramamohan,9999,0,9999,0
1653610652102,CSE 293,024,094928,Polikarpova; Nadezhda,9999,0,9999,0
1653610652102,CSE 293,025,094929,Politz; Joseph Gibbs,9999,0,9999,0
1653610652102,CSE 293,026,094930,Porter; George M,9999,0,9999,0
1653610652102,CSE 293,027,094931,Porter; Leonard Emerson,9999,0,9999,0
1653610652102,CSE 293,028,094932,Ramamoorthi; Ravi,9999,0,9999,0
1653610652102,CSE 293,029,094933,Sahoo; Debashis,9999,0,9999,0
1653610652102,CSE 293,030,094934,Saul; Lawrence,9999,0,9999,0
1653610652102,CSE 293,031,094935,Savage; Stefan,9999,0,9999,0
1653610652102,CSE 293,032,094936,Schulze; Jurgen P.,9999,0,9999,0
1653610652102,CSE 293,033,094937,Snoeren; Alex C.,9999,0,9999,0
1653610652102,CSE 293,034,094938,Shang; Jingbo,9999,0,9999,0
1653610652102,CSE 293,035,094939,Stefan; Deian,9999,0,9999,0
1653610652102,CSE 293,036,094940,Su; Hao,9999,0,9999,0
1653610652102,CSE 293,037,094941,Swanson; Steven James,9999,0,9999,0
1653610652102,CSE 293,038,094942,Tullsen; Dean Michael,9999,0,9999,0
1653610652102,CSE 293,039,094943,Voelker; Geoffrey M.,9999,0,9999,0
1653610652102,CSE 293,040,094944,Zhao; Jishen,9999,0,9999,0
1653610652102,CSE 293,041,094945,Zhou; Yuan-Yuan,9999,0,9999,0
1653610652102,CSE 293,042,094946,Gao; Sicun,9998,0,9999,1
1653610652102,CSE 293,043,094947,Weibel; Nadir,9999,0,9999,0
1653610652102,CSE 293,044,094948,Gupta; Rajesh K.,9999,0,9999,0
1653610652624,CSE 294,A00,090143,Porter; George M,9,0,10,1
1653610653149,DSE 200,A00,091799,Staff,50,0,50,0
1653610653683,DSE 203,A00,091800,Gupta; Amarnath,30,0,30,0
1653610654208,DSE 250,A00,091801,Deutsch; Alin Bernard,30,0,30,0
1653610654738,DSE 290,A00,091802,Altintas De Callaf; Ilkay,50,0,50,0
1653610655265,ECE 200,001,091003,Antipa; Nicholas A,9999,0,9999,0
1653610655265,ECE 200,002,091004,Atanasov; Nikolay A.,9999,0,9999,0
1653610655265,ECE 200,003,091005,Bharadia; Dinesh,9999,0,9999,0
1653610655265,ECE 200,004,091006,Cheng; Chung Kuan,9999,0,9999,0
1653610655265,ECE 200,005,091007,Cosman; Pamela C.,9999,0,9999,0
1653610655265,ECE 200,006,091008,Staff,9999,0,9999,0
1653610655265,ECE 200,007,091009,Dayeh; Shadi Ahmad,9999,0,9999,0
1653610655265,ECE 200,008,091010,Fainman; Yeshaiahu,9999,0,9999,0
1653610655265,ECE 200,009,091011,Ford; Joseph Earl,9999,0,9999,0
1653610655265,ECE 200,010,091012,Franceschetti; Massimo,9999,0,9999,0
1653610655265,ECE 200,011,091013,Fullerton; Eric E,9999,0,9999,0
1653610655265,ECE 200,012,091014,Galton; Ian A,9999,0,9999,0
1653610655265,ECE 200,013,091015,Gilja; Vikash,9999,0,9999,0
1653610655265,ECE 200,014,091016,Hall; Drew A.,9999,0,9999,0
1653610655265,ECE 200,015,091017,Hsueh; Tzu-Chien,9999,0,9999,0
1653610655265,ECE 200,016,091018,Javidi; Tara,9999,0,9999,0
1653610655265,ECE 200,017,091019,Kahng; Andrew Byun,9999,0,9999,0
1653610655265,ECE 200,018,091020,Kim; Young-Han,9999,0,9999,0
1653610655265,ECE 200,019,091021,Koushanfar; Farinaz,9999,0,9999,0
1653610655265,ECE 200,020,091022,Kuzum; Duygu,9999,0,9999,0
1653610655265,ECE 200,021,091023,Le; Hanh-Phuc,9999,0,9999,0
1653610655265,ECE 200,022,091024,Lin; Bill,9999,0,9999,0
1653610655265,ECE 200,023,091025,Liu; Zhaowei,9999,0,9999,0
1653610655265,ECE 200,024,091026,Lo; Yu-Hwa,9999,0,9999,0
1653610655265,ECE 200,025,091027,Lomakin; Vitaliy,9999,0,9999,0
1653610655265,ECE 200,026,091028,Mercier; Patrick Philip,9999,0,9999,0
1653610655265,ECE 200,027,091029,Meyer; Florian,9999,0,9999,0
1653610655265,ECE 200,028,091030,Milstein; Laurence B.,9999,0,9999,0
1653610655265,ECE 200,029,091031,Mir Arabbaygi; Siavash,9999,0,9999,0
1653610655265,ECE 200,030,091032,Mookherjea; Shayan,9999,0,9999,0
1653610655265,ECE 200,031,091033,Morris; Karcher William,9999,0,9999,0
1653610655265,ECE 200,032,091034,Ng; Tse Nga,9999,0,9999,0
1653610655265,ECE 200,033,091035,Nguyen; Truong Quang,9999,0,9999,0
1653610655265,ECE 200,034,091036,Nomura; Kenji,9999,0,9999,0
1653610655265,ECE 200,035,091037,Orlitsky; Alon,9999,0,9999,0
1653610655265,ECE 200,036,091038,Pal; Piya,9999,0,9999,0
1653610655265,ECE 200,037,091039,Papen; George C.,9999,0,9999,0
1653610655265,ECE 200,038,091040,Radic; Stojan,9999,0,9999,0
1653610655265,ECE 200,039,091041,Rao; Bhaskar D.,9999,0,9999,0
1653610655265,ECE 200,040,091042,Rao; Ramesh R,9999,0,9999,0
1653610655265,ECE 200,041,091043,Rebeiz; Gabriel,9999,0,9999,0
1653610655265,ECE 200,042,091044,Sanford; John R,9999,0,9999,0
1653610655265,ECE 200,043,091045,Siegel; Paul H.,9999,0,9999,0
1653610655265,ECE 200,044,091046,Sievenpiper; Daniel F.,9999,0,9999,0
1653610655265,ECE 200,045,091047,Sworder; David D.,9999,0,9999,0
1653610655265,ECE 200,046,091048,Taur; Yuan,9999,0,9999,0
1653610655265,ECE 200,047,091049,Touri; Behrouz,9999,0,9999,0
1653610655265,ECE 200,048,091050,Trivedi; Mohan M.,9999,0,9999,0
1653610655265,ECE 200,049,091051,Vardy; Alexander,9999,0,9999,0
1653610655265,ECE 200,050,091052,Vasconcelos; Nuno,9999,0,9999,0
1653610655265,ECE 200,051,091053,Wang; Xiaolong,9999,0,9999,0
1653610655265,ECE 200,052,091054,Xie; Pengtao,9999,0,9999,0
1653610655265,ECE 200,053,091055,Yip; Michael,9999,0,9999,0
1653610655265,ECE 200,054,091056,Zeger; Kenneth A.,9999,0,9999,0
1653610655265,ECE 200,055,091057,Zhang; Xinyu,9999,0,9999,0
1653610655265,ECE 200,056,091058,Turakhia; Yatish Girish,9999,0,9999,0
1653610655265,ECE 200,057,091059,Kang; Mingu,9999,0,9999,0
1653610655265,ECE 200,058,091060,Shi; Yuanyuan,9999,0,9999,0
1653610655265,ECE 200,059,091061,Wang; Edward Jay,9999,0,9999,0
1653610655265,ECE 200,060,091062,Zheng; Yang,9999,0,9999,0
1653610655788,ECE 201,A00,095526,Lo; Yu-Hwa,0,0,0,0
1653610656316,ECE 203,A00,091065,Mercier; Patrick Philip,0,0,0,0
1653610656845,ECE 207A,A00,091605,Liu; Thomas Tao-Ming,0,0,0,0
1653610657380,ECE 212AN,A00,091068,Nomura; Kenji,0,0,0,0
1653610657902,ECE 222A,A00,091069,Rebeiz; Gabriel,0,0,0,0
1653610658424,ECE 225A,A00,091070,Orlitsky; Alon,0,0,0,0
1653610658963,ECE 230A,A00,091071,Nomura; Kenji,0,0,0,0
1653610659487,ECE 236A,A00,091072,Dayeh; Shadi Ahmad,0,0,0,0
1653610660014,ECE 238A,A00,091073,Luo; Jian,0,0,0,0
1653610660014,ECE 238A,B00,091074,Luo; Jian,0,0,0,0
1653610660538,ECE 240A,A00,091075,Radic; Stojan,0,0,0,0
1653610661066,ECE 247A,A00,091592,Shi; Lingyan,0,0,0,0
1653610661593,ECE 250,A00,091076,Touri; Behrouz,0,0,0,0
1653610662115,ECE 251C,A00,091078,Nguyen; Truong Quang,0,0,0,0
1653610662648,ECE 253,A00,091079,Cosman; Pamela C.,0,0,0,0
1653610663171,ECE 255A,A00,091080,Orlitsky; Alon,0,0,0,0
1653610663698,ECE 257A,A00,091081,Zhang; Xinyu,0,0,0,0
1653610664220,ECE 260A,A01,091084,Eldon; John,0,0,0,0
1653610664745,ECE 264C,A00,091085,Galton; Ian A,0,0,0,0
1653610665268,ECE 265C,A00,094889,Presti; Calogero Davide,0,0,0,9
1653610665793,ECE 266,A01,091087,Hall; Drew A.,0,0,0,0
1653610666843,ECE 271A,A00,091090,Vasconcelos; Nuno,0,0,0,0
1653610667368,ECE 272B,A00,091091,Sworder; David D.,0,0,0,0
1653610667894,ECE 275A,A00,091092,Meyer; Florian,0,0,0,0
1653610668417,ECE 277,A00,091093,An; Cheolhong,0,0,0,0
1653610668951,ECE 283,A00,091094,Le; Hanh-Phuc,0,0,0,0
1653610669488,ECE 284,A00,091095,Kang; Mingu,0,0,0,0
1653610669488,ECE 284,B00,091096,Wang; Edward Jay,0,0,0,0
1653610670011,ECE 285,A00,094334,Touri; Behrouz,0,0,0,0
1653610670536,ECE 289,A00,091097,Whelan; David Arthur,0,0,0,0
1653610671147,MATH 200A,A00,087414,Salehi Golsefidy; Alireza,7,0,8,1
1653610671670,MATH 202A,A00,087415,Gill; Philip E.,2,0,8,6
1653610672200,MATH 203A,A00,087416,Oprea; Dragos N.,6,0,8,2
1653610672722,MATH 204A,A00,087417,Kedlaya; Kiran S.,6,0,8,2
1653610673256,MATH 205,A00,087418,Sorensen; Claus M,6,0,8,2
1653610673778,MATH 206A,A00,087419,Izadi; Elham,7,0,8,1
1653610674299,MATH 207A,A00,087420,Mohammadi; Amir,5,0,8,3
1653610674828,MATH 208,A00,087421,Staff,9,0,10,1
1653610675366,MATH 209,A00,087422,Staff,10,0,10,0
1653610675891,MATH 218,A00,087423,Staff,10,0,10,0
1653610676413,MATH 220A,A00,087424,Novak; Jonathan I,6,0,8,2
1653610676947,MATH 231A,A00,087425,Bejenaru; Ioan,3,0,8,5
1653610677479,MATH 240A,A00,087426,Ebenfelt; Peter F,5,0,8,3
1653610678004,MATH 243,A00,087427,Staff,9,0,10,1
1653610678527,MATH 248,A00,087429,Staff,10,0,10,0
1653610679049,MATH 250A,A00,087430,Spolaor; Luca,4,0,8,4
1653610679576,MATH 257A,A00,087431,Spolaor; Luca,7,0,8,1
1653610680101,MATH 258,A00,087432,Staff,9,0,10,1
1653610680642,MATH 264A,A00,087433,Warnke; Lutz Peter,5,0,8,3
1653610681165,MATH 268,A00,087434,Staff,15,0,15,0
1653610681690,MATH 269,A00,087435,Staff,14,0,15,1
1653610682215,MATH 270A,A00,087436,Nie; Jiawang,0,0,8,8
1653610682860,MATH 272A,A00,087437,Tian; Xiaochuan,0,0,8,8
1653610683387,MATH 274,A01,087439,Cheng; Li-Tien,9,0,10,1
1653610683387,MATH 274,A02,087440,Cheng; Li-Tien,10,0,10,0
1653610683913,MATH 278A,A00,087441,Staff,8,0,10,2
1653610684439,MATH 278B,A00,087442,Staff,8,0,10,2
1653610684965,MATH 278C,A00,087443,Staff,8,0,10,2
1653610685502,MATH 280A,A00,087444,Zheng; Tianyi,0,0,8,8
1653610686025,MATH 281A,A00,087445,Bradic; Jelena,0,0,8,9
1653610686550,MATH 282A,A00,087446,Zhang; Danna,0,0,8,8
1653610687076,MATH 283,A00,087447,Tesler; Glenn,0,0,0,16
1653610687600,MATH 286,B00,095535,Kemp; Todd Aahron,5,0,8,3
1653610688132,MATH 287D,B00,095536,Bradic; Jelena,5,0,8,3
1653610688658,MATH 288,A00,087450,Staff,14,0,15,1
1653610688658,MATH 288,B00,087451,Staff,15,0,15,0
1653610688658,MATH 288,C00,087452,Staff,15,0,15,0
1653610689182,MATH 290A,A00,087453,Xu; Zhouli,6,0,8,2
1653610689707,MATH 291A,A00,087454,Xu; Zhouli,7,0,8,1
1653610690237,MATH 292,A00,087455,Staff,10,0,10,0
1653610690762,MATH 295,A00,087456,Staff,50,0,50,0
1653610691288,MATH 297,001,087457,Staff,997,0,999,2
1653611252790,COGS 200,A01,087991,Staff,47,0,50,3
1653611253312,COGS 201,A01,094504,Rangel; Lara M,16,0,25,9
1653611253840,COGS 203,A00,087992,Coulson; Seana M,18,0,20,2
1653611254375,COGS 210A,001,087993,Greene; Deanna Jacquelyn,9998,0,9999,1
1653611254375,COGS 210A,002,087994,Saygin; Ayse P,9999,0,9999,0
1653611254375,COGS 210A,003,087995,Xia; Haijun,9999,0,9999,0
1653611254375,COGS 210A,004,087996,Nitz; Douglas A.,9999,0,9999,0
1653611254375,COGS 210A,005,087997,Hollan; James D.,9999,0,9999,0
1653611254375,COGS 210A,006,087998,Deak; Gedeon O.,9998,0,9999,1
1653611254375,COGS 210A,007,087999,Rossano; Federico,9999,0,9999,0
1653611254903,COGS 211A,A00,088000,Coulson; Seana M,9997,0,9999,2
1653611255425,COGS 229,A00,088002,Staff,22,0,25,3
1653611255949,COGS 260,B00,094231,Staff,17,0,20,3
1653611255949,COGS 260,A00,088004,Nitz; Douglas A.,9998,0,9999,1
1653611256471,CSE 202,A00,090110,Paturi; Ramamohan,0,0,0,0
1653611256471,CSE 202,B00,090111,Paturi; Ramamohan,0,0,0,0
1653611257000,CSE 207B,A00,090112,Heninger; Nadia A,0,0,0,0
1653611257522,CSE 208,A00,094858,Micciancio; Daniele,0,0,0,0
1653611258046,CSE 210,A00,090113,Powell; Thomas Allan,0,0,0,0
1653611258569,CSE 219,A00,090898,Staff,0,0,0,0
1653611259093,CSE 221,A00,090114,Zhou; Yuan-Yuan,0,0,0,0
1653611259615,CSE 229A,A00,090115,Porter; George M,0,0,0,0
1653611260223,CSE 229C,A00,090116,Savage; Stefan,0,0,0,0
1653611260746,CSE 230,A00,090117,Jhala; Ranjit,0,0,0,0
1653611261272,CSE 232,A00,090118,Papakonstantinou; Yannis,0,0,0,0
1653611261795,CSE 239A,A00,090121,Kumar; Arun Kumar,0,0,0,0
1653611262318,CSE 239B,A00,090122,Jhala; Ranjit,0,0,0,0
1653611262844,CSE 240A,A00,090123,Zhao; Jishen,0,0,189,189
1653611263366,CSE 243A,A00,090124,Orailoglu; Alex,0,0,15,15
1653611263901,CSE 249B,A00,090125,Kahng; Andrew Byun,12,0,20,8
1653611264423,CSE 250A,A00,090126,Berg-Kirkpatrick; Taylor D,0,0,0,0
1653611264946,CSE 252A,A00,090127,Ochoa; Benjamin Lawrence,0,0,0,0
1653611265475,CSE 258,A01,090129,McAuley; Julian John,0,0,0,0
1653611266001,CSE 258R,A01,090131,McAuley; Julian John,0,0,0,0
1653611266523,CSE 274,A00,090132,Ramamoorthi; Ravi,0,0,0,0
1653611267057,CSE 276A,A00,090133,Christensen; Henrik I,0,0,0,0
1653611267582,CSE 276C,A00,090134,Christensen; Henrik I,0,0,0,0
1653611268105,CSE 290,A00,090135,Bafna; Vineet,0,0,0,0
1653611268105,CSE 290,B00,090136,Ramamoorthi; Ravi,0,0,0,0
1653611268105,CSE 290,C00,090137,Li; Tzumao,7,0,10,3
1653611268105,CSE 290,D00,090138,Zhou; Yuan-Yuan,9,0,10,1
1653611268105,CSE 290,E00,090139,Christensen; Henrik I,8,0,10,2
1653611268105,CSE 290,F00,094053,Shalev; Aaron D,0,0,0,0
1653611268639,CSE 291,A00,090140,Munyaka; Imani N. S.,0,0,0,0
1653611268639,CSE 291,B00,094880,Yu; Qi,0,0,0,0
1653611268639,CSE 291,C00,090142,Pannuto; Patrick William,0,0,0,0
1653611268639,CSE 291,D00,094881,Zhang; Yiying,0,0,0,0
1653611268639,CSE 291,E00,095118,Su; Hao,0,0,0,0
1653611269173,CSE 293,001,094905,Bafna; Vineet,9999,0,9999,0
1653611269173,CSE 293,002,094906,Bellare; Mihir,9999,0,9999,0
1653611269173,CSE 293,003,094907,Berg-Kirkpatrick; Taylor D,9999,0,9999,0
1653611269173,CSE 293,004,094908,Christensen; Henrik I,9999,0,9999,0
1653611269173,CSE 293,005,094909,Cottrell; Garrison W,9999,0,9999,0
1653611269173,CSE 293,006,094910,Deutsch; Alin Bernard,9999,0,9999,0
1653611269173,CSE 293,007,094911,Esmaeilzadeh; Hadi,9999,0,9999,0
1653611269173,CSE 293,008,094912,Freund; Yoav,9999,0,9999,0
1653611269173,CSE 293,009,094913,Griswold; William G.,9999,0,9999,0
1653611269173,CSE 293,010,094914,Gymrek; Melissa Ann,9999,0,9999,0
1653611269173,CSE 293,011,094915,Heninger; Nadia A,9999,0,9999,0
1653611269173,CSE 293,012,094916,Impagliazzo; Russell,9999,0,9999,0
1653611269173,CSE 293,013,094917,Jhala; Ranjit,9999,0,9999,0
1653611269173,CSE 293,014,094918,Kahng; Andrew Byun,9999,0,9999,0
1653611269173,CSE 293,015,094919,Kane; Daniel Mertz,9999,0,9999,0
1653611269173,CSE 293,016,094920,Kriegman; David J,9999,0,9999,0
1653611269173,CSE 293,017,094921,Kumar; Arun Kumar,9999,0,9999,0
1653611269173,CSE 293,018,094922,Lerner; Sorin,9999,0,9999,0
1653611269173,CSE 293,019,094923,Lovett; Shachar,9999,0,9999,0
1653611269173,CSE 293,020,094924,McAuley; Julian John,9999,0,9999,0
1653611269173,CSE 293,021,094925,Micciancio; Daniele,9999,0,9999,0
1653611269173,CSE 293,022,094926,Orailoglu; Alex,9999,0,9999,0
1653611269173,CSE 293,023,094927,Paturi; Ramamohan,9999,0,9999,0
1653611269173,CSE 293,024,094928,Polikarpova; Nadezhda,9999,0,9999,0
1653611269173,CSE 293,025,094929,Politz; Joseph Gibbs,9999,0,9999,0
1653611269173,CSE 293,026,094930,Porter; George M,9999,0,9999,0
1653611269173,CSE 293,027,094931,Porter; Leonard Emerson,9999,0,9999,0
1653611269173,CSE 293,028,094932,Ramamoorthi; Ravi,9999,0,9999,0
1653611269173,CSE 293,029,094933,Sahoo; Debashis,9999,0,9999,0
1653611269173,CSE 293,030,094934,Saul; Lawrence,9999,0,9999,0
1653611269173,CSE 293,031,094935,Savage; Stefan,9999,0,9999,0
1653611269173,CSE 293,032,094936,Schulze; Jurgen P.,9999,0,9999,0
1653611269173,CSE 293,033,094937,Snoeren; Alex C.,9999,0,9999,0
1653611269173,CSE 293,034,094938,Shang; Jingbo,9999,0,9999,0
1653611269173,CSE 293,035,094939,Stefan; Deian,9999,0,9999,0
1653611269173,CSE 293,036,094940,Su; Hao,9999,0,9999,0
1653611269173,CSE 293,037,094941,Swanson; Steven James,9999,0,9999,0
1653611269173,CSE 293,038,094942,Tullsen; Dean Michael,9999,0,9999,0
1653611269173,CSE 293,039,094943,Voelker; Geoffrey M.,9999,0,9999,0
1653611269173,CSE 293,040,094944,Zhao; Jishen,9999,0,9999,0
1653611269173,CSE 293,041,094945,Zhou; Yuan-Yuan,9999,0,9999,0
1653611269173,CSE 293,042,094946,Gao; Sicun,9998,0,9999,1
1653611269173,CSE 293,043,094947,Weibel; Nadir,9999,0,9999,0
1653611269173,CSE 293,044,094948,Gupta; Rajesh K.,9999,0,9999,0
1653611269695,CSE 294,A00,090143,Porter; George M,9,0,10,1
1653611270226,DSE 200,A00,091799,Staff,50,0,50,0
1653611270750,DSE 203,A00,091800,Gupta; Amarnath,30,0,30,0
1653611271275,DSE 250,A00,091801,Deutsch; Alin Bernard,30,0,30,0
1653611271798,DSE 290,A00,091802,Altintas De Callaf; Ilkay,50,0,50,0
1653611272363,ECE 200,001,091003,Antipa; Nicholas A,9999,0,9999,0
1653611272363,ECE 200,002,091004,Atanasov; Nikolay A.,9999,0,9999,0
1653611272363,ECE 200,003,091005,Bharadia; Dinesh,9999,0,9999,0
1653611272363,ECE 200,004,091006,Cheng; Chung Kuan,9999,0,9999,0
1653611272363,ECE 200,005,091007,Cosman; Pamela C.,9999,0,9999,0
1653611272363,ECE 200,006,091008,Staff,9999,0,9999,0
1653611272363,ECE 200,007,091009,Dayeh; Shadi Ahmad,9999,0,9999,0
1653611272363,ECE 200,008,091010,Fainman; Yeshaiahu,9999,0,9999,0
1653611272363,ECE 200,009,091011,Ford; Joseph Earl,9999,0,9999,0
1653611272363,ECE 200,010,091012,Franceschetti; Massimo,9999,0,9999,0
1653611272363,ECE 200,011,091013,Fullerton; Eric E,9999,0,9999,0
1653611272363,ECE 200,012,091014,Galton; Ian A,9999,0,9999,0
1653611272363,ECE 200,013,091015,Gilja; Vikash,9999,0,9999,0
1653611272363,ECE 200,014,091016,Hall; Drew A.,9999,0,9999,0
1653611272363,ECE 200,015,091017,Hsueh; Tzu-Chien,9999,0,9999,0
1653611272363,ECE 200,016,091018,Javidi; Tara,9999,0,9999,0
1653611272363,ECE 200,017,091019,Kahng; Andrew Byun,9999,0,9999,0
1653611272363,ECE 200,018,091020,Kim; Young-Han,9999,0,9999,0
1653611272363,ECE 200,019,091021,Koushanfar; Farinaz,9999,0,9999,0
1653611272363,ECE 200,020,091022,Kuzum; Duygu,9999,0,9999,0
1653611272363,ECE 200,021,091023,Le; Hanh-Phuc,9999,0,9999,0
1653611272363,ECE 200,022,091024,Lin; Bill,9999,0,9999,0
1653611272363,ECE 200,023,091025,Liu; Zhaowei,9999,0,9999,0
1653611272363,ECE 200,024,091026,Lo; Yu-Hwa,9999,0,9999,0
1653611272363,ECE 200,025,091027,Lomakin; Vitaliy,9999,0,9999,0
1653611272363,ECE 200,026,091028,Mercier; Patrick Philip,9999,0,9999,0
1653611272363,ECE 200,027,091029,Meyer; Florian,9999,0,9999,0
1653611272363,ECE 200,028,091030,Milstein; Laurence B.,9999,0,9999,0
1653611272363,ECE 200,029,091031,Mir Arabbaygi; Siavash,9999,0,9999,0
1653611272363,ECE 200,030,091032,Mookherjea; Shayan,9999,0,9999,0
1653611272363,ECE 200,031,091033,Morris; Karcher William,9999,0,9999,0
1653611272363,ECE 200,032,091034,Ng; Tse Nga,9999,0,9999,0
1653611272363,ECE 200,033,091035,Nguyen; Truong Quang,9999,0,9999,0
1653611272363,ECE 200,034,091036,Nomura; Kenji,9999,0,9999,0
1653611272363,ECE 200,035,091037,Orlitsky; Alon,9999,0,9999,0
1653611272363,ECE 200,036,091038,Pal; Piya,9999,0,9999,0
1653611272363,ECE 200,037,091039,Papen; George C.,9999,0,9999,0
1653611272363,ECE 200,038,091040,Radic; Stojan,9999,0,9999,0
1653611272363,ECE 200,039,091041,Rao; Bhaskar D.,9999,0,9999,0
1653611272363,ECE 200,040,091042,Rao; Ramesh R,9999,0,9999,0
1653611272363,ECE 200,041,091043,Rebeiz; Gabriel,9999,0,9999,0
1653611272363,ECE 200,042,091044,Sanford; John R,9999,0,9999,0
1653611272363,ECE 200,043,091045,Siegel; Paul H.,9999,0,9999,0
1653611272363,ECE 200,044,091046,Sievenpiper; Daniel F.,9999,0,9999,0
1653611272363,ECE 200,045,091047,Sworder; David D.,9999,0,9999,0
1653611272363,ECE 200,046,091048,Taur; Yuan,9999,0,9999,0
1653611272363,ECE 200,047,091049,Touri; Behrouz,9999,0,9999,0
1653611272363,ECE 200,048,091050,Trivedi; Mohan M.,9999,0,9999,0
1653611272363,ECE 200,049,091051,Vardy; Alexander,9999,0,9999,0
1653611272363,ECE 200,050,091052,Vasconcelos; Nuno,9999,0,9999,0
1653611272363,ECE 200,051,091053,Wang; Xiaolong,9999,0,9999,0
1653611272363,ECE 200,052,091054,Xie; Pengtao,9999,0,9999,0
1653611272363,ECE 200,053,091055,Yip; Michael,9999,0,9999,0
1653611272363,ECE 200,054,091056,Zeger; Kenneth A.,9999,0,9999,0
1653611272363,ECE 200,055,091057,Zhang; Xinyu,9999,0,9999,0
1653611272363,ECE 200,056,091058,Turakhia; Yatish Girish,9999,0,9999,0
1653611272363,ECE 200,057,091059,Kang; Mingu,9999,0,9999,0
1653611272363,ECE 200,058,091060,Shi; Yuanyuan,9999,0,9999,0
1653611272363,ECE 200,059,091061,Wang; Edward Jay,9999,0,9999,0
1653611272363,ECE 200,060,091062,Zheng; Yang,9999,0,9999,0
1653611272890,ECE 201,A00,095526,Lo; Yu-Hwa,0,0,0,0
1653611273414,ECE 203,A00,091065,Mercier; Patrick Philip,0,0,0,0
1653611273952,ECE 207A,A00,091605,Liu; Thomas Tao-Ming,0,0,0,0
1653611274477,ECE 212AN,A00,091068,Nomura; Kenji,0,0,0,0
1653611275002,ECE 222A,A00,091069,Rebeiz; Gabriel,0,0,0,0
1653611275527,ECE 225A,A00,091070,Orlitsky; Alon,0,0,0,0
1653611276061,ECE 230A,A00,091071,Nomura; Kenji,0,0,0,0
1653611276596,ECE 236A,A00,091072,Dayeh; Shadi Ahmad,0,0,0,0
1653611277117,ECE 238A,A00,091073,Luo; Jian,0,0,0,0
1653611277117,ECE 238A,B00,091074,Luo; Jian,0,0,0,0
1653611277639,ECE 240A,A00,091075,Radic; Stojan,0,0,0,0
1653611278162,ECE 247A,A00,091592,Shi; Lingyan,0,0,0,0
1653611278688,ECE 250,A00,091076,Touri; Behrouz,0,0,0,0
1653611279220,ECE 251C,A00,091078,Nguyen; Truong Quang,0,0,0,0
1653611279742,ECE 253,A00,091079,Cosman; Pamela C.,0,0,0,0
1653611280265,ECE 255A,A00,091080,Orlitsky; Alon,0,0,0,0
1653611280788,ECE 257A,A00,091081,Zhang; Xinyu,0,0,0,0
1653611281315,ECE 260A,A01,091084,Eldon; John,0,0,0,0
1653611281838,ECE 264C,A00,091085,Galton; Ian A,0,0,0,0
1653611282363,ECE 265C,A00,094889,Presti; Calogero Davide,0,0,0,9
1653611282886,ECE 266,A01,091087,Hall; Drew A.,0,0,0,0
1653611283937,ECE 271A,A00,091090,Vasconcelos; Nuno,0,0,0,0
1653611284464,ECE 272B,A00,091091,Sworder; David D.,0,0,0,0
1653611284992,ECE 275A,A00,091092,Meyer; Florian,0,0,0,0
1653611285523,ECE 277,A00,091093,An; Cheolhong,0,0,0,0
1653611286046,ECE 283,A00,091094,Le; Hanh-Phuc,0,0,0,0
1653611286581,ECE 284,A00,091095,Kang; Mingu,0,0,0,0
1653611286581,ECE 284,B00,091096,Wang; Edward Jay,0,0,0,0
1653611287117,ECE 285,A00,094334,Touri; Behrouz,0,0,0,0
1653611287641,ECE 289,A00,091097,Whelan; David Arthur,0,0,0,0
1653611288163,MATH 200A,A00,087414,Salehi Golsefidy; Alireza,7,0,8,1
1653611288686,MATH 202A,A00,087415,Gill; Philip E.,2,0,8,6
1653611289207,MATH 203A,A00,087416,Oprea; Dragos N.,6,0,8,2
1653611289735,MATH 204A,A00,087417,Kedlaya; Kiran S.,6,0,8,2
1653611290258,MATH 205,A00,087418,Sorensen; Claus M,6,0,8,2
1653611290790,MATH 206A,A00,087419,Izadi; Elham,7,0,8,1
1653611291313,MATH 207A,A00,087420,Mohammadi; Amir,5,0,8,3
1653611291853,MATH 208,A00,087421,Staff,9,0,10,1
1653611292375,MATH 209,A00,087422,Staff,10,0,10,0
1653611292899,MATH 218,A00,087423,Staff,10,0,10,0
1653611293424,MATH 220A,A00,087424,Novak; Jonathan I,6,0,8,2
1653611293967,MATH 231A,A00,087425,Bejenaru; Ioan,3,0,8,5
1653611294494,MATH 240A,A00,087426,Ebenfelt; Peter F,5,0,8,3
1653611295020,MATH 243,A00,087427,Staff,9,0,10,1
1653611295545,MATH 248,A00,087429,Staff,10,0,10,0
1653611296067,MATH 250A,A00,087430,Spolaor; Luca,4,0,8,4
1653611296623,MATH 257A,A00,087431,Spolaor; Luca,7,0,8,1
1653611297145,MATH 258,A00,087432,Staff,9,0,10,1
1653611297679,MATH 264A,A00,087433,Warnke; Lutz Peter,5,0,8,3
1653611298201,MATH 268,A00,087434,Staff,15,0,15,0
1653611298731,MATH 269,A00,087435,Staff,14,0,15,1
1653611299255,MATH 270A,A00,087436,Nie; Jiawang,0,0,8,8
1653611299781,MATH 272A,A00,087437,Tian; Xiaochuan,0,0,8,8
1653611300313,MATH 274,A01,087439,Cheng; Li-Tien,9,0,10,1
1653611300313,MATH 274,A02,087440,Cheng; Li-Tien,10,0,10,0
1653611300836,MATH 278A,A00,087441,Staff,8,0,10,2
1653611301361,MATH 278B,A00,087442,Staff,8,0,10,2
1653611301891,MATH 278C,A00,087443,Staff,8,0,10,2
1653611302415,MATH 280A,A00,087444,Zheng; Tianyi,0,0,8,8
1653611302950,MATH 281A,A00,087445,Bradic; Jelena,0,0,8,9
1653611303485,MATH 282A,A00,087446,Zhang; Danna,0,0,8,8
1653611304011,MATH 283,A00,087447,Tesler; Glenn,0,0,0,16
1653611304538,MATH 286,B00,095535,Kemp; Todd Aahron,5,0,8,3
1653611305065,MATH 287D,B00,095536,Bradic; Jelena,5,0,8,3
1653611305588,MATH 288,A00,087450,Staff,14,0,15,1
1653611305588,MATH 288,B00,087451,Staff,15,0,15,0
1653611305588,MATH 288,C00,087452,Staff,15,0,15,0
1653611306110,MATH 290A,A00,087453,Xu; Zhouli,6,0,8,2
1653611306634,MATH 291A,A00,087454,Xu; Zhouli,7,0,8,1
1653611307157,MATH 292,A00,087455,Staff,10,0,10,0
1653611307681,MATH 295,A00,087456,Staff,50,0,50,0
1653611308208,MATH 297,001,087457,Staff,997,0,999,2
1653611878247,COGS 200,A01,087991,Staff,47,0,50,3
1653611878770,COGS 201,A01,094504,Rangel; Lara M,16,0,25,9
1653611879293,COGS 203,A00,087992,Coulson; Seana M,18,0,20,2
1653611879817,COGS 210A,001,087993,Greene; Deanna Jacquelyn,9998,0,9999,1
1653611879817,COGS 210A,002,087994,Saygin; Ayse P,9999,0,9999,0
1653611879817,COGS 210A,003,087995,Xia; Haijun,9999,0,9999,0
1653611879817,COGS 210A,004,087996,Nitz; Douglas A.,9999,0,9999,0
1653611879817,COGS 210A,005,087997,Hollan; James D.,9999,0,9999,0
1653611879817,COGS 210A,006,087998,Deak; Gedeon O.,9998,0,9999,1
1653611879817,COGS 210A,007,087999,Rossano; Federico,9999,0,9999,0
1653611880346,COGS 211A,A00,088000,Coulson; Seana M,9997,0,9999,2
1653611880882,COGS 229,A00,088002,Staff,22,0,25,3
1653611881406,COGS 260,B00,094231,Staff,17,0,20,3
1653611881406,COGS 260,A00,088004,Nitz; Douglas A.,9998,0,9999,1
1653611881931,CSE 202,A00,090110,Paturi; Ramamohan,0,0,0,0
1653611881931,CSE 202,B00,090111,Paturi; Ramamohan,0,0,0,0
1653611882458,CSE 207B,A00,090112,Heninger; Nadia A,0,0,0,0
1653611882994,CSE 208,A00,094858,Micciancio; Daniele,0,0,0,0
1653611883521,CSE 210,A00,090113,Powell; Thomas Allan,0,0,0,0
1653611884043,CSE 219,A00,090898,Staff,0,0,0,0
1653611884574,CSE 221,A00,090114,Zhou; Yuan-Yuan,0,0,0,0
1653611885097,CSE 229A,A00,090115,Porter; George M,0,0,0,0
1653611885621,CSE 229C,A00,090116,Savage; Stefan,0,0,0,0
1653611886143,CSE 230,A00,090117,Jhala; Ranjit,0,0,0,0
1653611886668,CSE 232,A00,090118,Papakonstantinou; Yannis,0,0,0,0
1653611887193,CSE 239A,A00,090121,Kumar; Arun Kumar,0,0,0,0
1653611887717,CSE 239B,A00,090122,Jhala; Ranjit,0,0,0,0
1653611888240,CSE 240A,A00,090123,Zhao; Jishen,0,0,189,189
1653611888765,CSE 243A,A00,090124,Orailoglu; Alex,0,0,15,15
1653611889294,CSE 249B,A00,090125,Kahng; Andrew Byun,12,0,20,8
1653611889830,CSE 250A,A00,090126,Berg-Kirkpatrick; Taylor D,0,0,0,0
1653611890353,CSE 252A,A00,090127,Ochoa; Benjamin Lawrence,0,0,0,0
1653611890875,CSE 258,A01,090129,McAuley; Julian John,0,0,0,0
1653611891399,CSE 258R,A01,090131,McAuley; Julian John,0,0,0,0
1653611891924,CSE 274,A00,090132,Ramamoorthi; Ravi,0,0,0,0
1653611892449,CSE 276A,A00,090133,Christensen; Henrik I,0,0,0,0
1653611892972,CSE 276C,A00,090134,Christensen; Henrik I,0,0,0,0
1653611893509,CSE 290,A00,090135,Bafna; Vineet,0,0,0,0
1653611893509,CSE 290,B00,090136,Ramamoorthi; Ravi,0,0,0,0
1653611893509,CSE 290,C00,090137,Li; Tzumao,7,0,10,3
1653611893509,CSE 290,D00,090138,Zhou; Yuan-Yuan,9,0,10,1
1653611893509,CSE 290,E00,090139,Christensen; Henrik I,8,0,10,2
1653611893509,CSE 290,F00,094053,Shalev; Aaron D,0,0,0,0
1653611894032,CSE 291,A00,090140,Munyaka; Imani N. S.,0,0,0,0
1653611894032,CSE 291,B00,094880,Yu; Qi,0,0,0,0
1653611894032,CSE 291,C00,090142,Pannuto; Patrick William,0,0,0,0
1653611894032,CSE 291,D00,094881,Zhang; Yiying,0,0,0,0
1653611894032,CSE 291,E00,095118,Su; Hao,0,0,0,0
1653611894556,CSE 293,001,094905,Bafna; Vineet,9999,0,9999,0
1653611894556,CSE 293,002,094906,Bellare; Mihir,9999,0,9999,0
1653611894556,CSE 293,003,094907,Berg-Kirkpatrick; Taylor D,9999,0,9999,0
1653611894556,CSE 293,004,094908,Christensen; Henrik I,9999,0,9999,0
1653611894556,CSE 293,005,094909,Cottrell; Garrison W,9999,0,9999,0
1653611894556,CSE 293,006,094910,Deutsch; Alin Bernard,9999,0,9999,0
1653611894556,CSE 293,007,094911,Esmaeilzadeh; Hadi,9999,0,9999,0
1653611894556,CSE 293,008,094912,Freund; Yoav,9999,0,9999,0
1653611894556,CSE 293,009,094913,Griswold; William G.,9999,0,9999,0
1653611894556,CSE 293,010,094914,Gymrek; Melissa Ann,9999,0,9999,0
1653611894556,CSE 293,011,094915,Heninger; Nadia A,9999,0,9999,0
1653611894556,CSE 293,012,094916,Impagliazzo; Russell,9999,0,9999,0
1653611894556,CSE 293,013,094917,Jhala; Ranjit,9999,0,9999,0
1653611894556,CSE 293,014,094918,Kahng; Andrew Byun,9999,0,9999,0
1653611894556,CSE 293,015,094919,Kane; Daniel Mertz,9999,0,9999,0
1653611894556,CSE 293,016,094920,Kriegman; David J,9999,0,9999,0
1653611894556,CSE 293,017,094921,Kumar; Arun Kumar,9999,0,9999,0
1653611894556,CSE 293,018,094922,Lerner; Sorin,9999,0,9999,0
1653611894556,CSE 293,019,094923,Lovett; Shachar,9999,0,9999,0
1653611894556,CSE 293,020,094924,McAuley; Julian John,9999,0,9999,0
1653611894556,CSE 293,021,094925,Micciancio; Daniele,9999,0,9999,0
1653611894556,CSE 293,022,094926,Orailoglu; Alex,9999,0,9999,0
1653611894556,CSE 293,023,094927,Paturi; Ramamohan,9999,0,9999,0
1653611894556,CSE 293,024,094928,Polikarpova; Nadezhda,9999,0,9999,0
1653611894556,CSE 293,025,094929,Politz; Joseph Gibbs,9999,0,9999,0
1653611894556,CSE 293,026,094930,Porter; George M,9999,0,9999,0
1653611894556,CSE 293,027,094931,Porter; Leonard Emerson,9999,0,9999,0
1653611894556,CSE 293,028,094932,Ramamoorthi; Ravi,9999,0,9999,0
1653611894556,CSE 293,029,094933,Sahoo; Debashis,9999,0,9999,0
1653611894556,CSE 293,030,094934,Saul; Lawrence,9999,0,9999,0
1653611894556,CSE 293,031,094935,Savage; Stefan,9999,0,9999,0
1653611894556,CSE 293,032,094936,Schulze; Jurgen P.,9999,0,9999,0
1653611894556,CSE 293,033,094937,Snoeren; Alex C.,9999,0,9999,0
1653611894556,CSE 293,034,094938,Shang; Jingbo,9999,0,9999,0
1653611894556,CSE 293,035,094939,Stefan; Deian,9999,0,9999,0
1653611894556,CSE 293,036,094940,Su; Hao,9999,0,9999,0
1653611894556,CSE 293,037,094941,Swanson; Steven James,9999,0,9999,0
1653611894556,CSE 293,038,094942,Tullsen; Dean Michael,9999,0,9999,0
1653611894556,CSE 293,039,094943,Voelker; Geoffrey M.,9999,0,9999,0
1653611894556,CSE 293,040,094944,Zhao; Jishen,9999,0,9999,0
1653611894556,CSE 293,041,094945,Zhou; Yuan-Yuan,9999,0,9999,0
1653611894556,CSE 293,042,094946,Gao; Sicun,9998,0,9999,1
1653611894556,CSE 293,043,094947,Weibel; Nadir,9999,0,9999,0
1653611894556,CSE 293,044,094948,Gupta; Rajesh K.,9999,0,9999,0
1653611895077,CSE 294,A00,090143,Porter; George M,9,0,10,1
1653611895600,DSE 200,A00,091799,Staff,50,0,50,0
1653611896123,DSE 203,A00,091800,Gupta; Amarnath,30,0,30,0
1653611896657,DSE 250,A00,091801,Deutsch; Alin Bernard,30,0,30,0
1653611897180,DSE 290,A00,091802,Altintas De Callaf; Ilkay,50,0,50,0
1653611897739,ECE 200,001,091003,Antipa; Nicholas A,9999,0,9999,0
1653611897739,ECE 200,002,091004,Atanasov; Nikolay A.,9999,0,9999,0
1653611897739,ECE 200,003,091005,Bharadia; Dinesh,9999,0,9999,0
1653611897739,ECE 200,004,091006,Cheng; Chung Kuan,9999,0,9999,0
1653611897739,ECE 200,005,091007,Cosman; Pamela C.,9999,0,9999,0
1653611897739,ECE 200,006,091008,Staff,9999,0,9999,0
1653611897739,ECE 200,007,091009,Dayeh; Shadi Ahmad,9999,0,9999,0
1653611897739,ECE 200,008,091010,Fainman; Yeshaiahu,9999,0,9999,0
1653611897739,ECE 200,009,091011,Ford; Joseph Earl,9999,0,9999,0
1653611897739,ECE 200,010,091012,Franceschetti; Massimo,9999,0,9999,0
1653611897739,ECE 200,011,091013,Fullerton; Eric E,9999,0,9999,0
1653611897739,ECE 200,012,091014,Galton; Ian A,9999,0,9999,0
1653611897739,ECE 200,013,091015,Gilja; Vikash,9999,0,9999,0
1653611897739,ECE 200,014,091016,Hall; Drew A.,9999,0,9999,0
1653611897739,ECE 200,015,091017,Hsueh; Tzu-Chien,9999,0,9999,0
1653611897739,ECE 200,016,091018,Javidi; Tara,9999,0,9999,0
1653611897739,ECE 200,017,091019,Kahng; Andrew Byun,9999,0,9999,0
1653611897739,ECE 200,018,091020,Kim; Young-Han,9999,0,9999,0
1653611897739,ECE 200,019,091021,Koushanfar; Farinaz,9999,0,9999,0
1653611897739,ECE 200,020,091022,Kuzum; Duygu,9999,0,9999,0
1653611897739,ECE 200,021,091023,Le; Hanh-Phuc,9999,0,9999,0
1653611897739,ECE 200,022,091024,Lin; Bill,9999,0,9999,0
1653611897739,ECE 200,023,091025,Liu; Zhaowei,9999,0,9999,0
1653611897739,ECE 200,024,091026,Lo; Yu-Hwa,9999,0,9999,0
1653611897739,ECE 200,025,091027,Lomakin; Vitaliy,9999,0,9999,0
1653611897739,ECE 200,026,091028,Mercier; Patrick Philip,9999,0,9999,0
1653611897739,ECE 200,027,091029,Meyer; Florian,9999,0,9999,0
1653611897739,ECE 200,028,091030,Milstein; Laurence B.,9999,0,9999,0
1653611897739,ECE 200,029,091031,Mir Arabbaygi; Siavash,9999,0,9999,0
1653611897739,ECE 200,030,091032,Mookherjea; Shayan,9999,0,9999,0
1653611897739,ECE 200,031,091033,Morris; Karcher William,9999,0,9999,0
1653611897739,ECE 200,032,091034,Ng; Tse Nga,9999,0,9999,0
1653611897739,ECE 200,033,091035,Nguyen; Truong Quang,9999,0,9999,0
1653611897739,ECE 200,034,091036,Nomura; Kenji,9999,0,9999,0
1653611897739,ECE 200,035,091037,Orlitsky; Alon,9999,0,9999,0
1653611897739,ECE 200,036,091038,Pal; Piya,9999,0,9999,0
1653611897739,ECE 200,037,091039,Papen; George C.,9999,0,9999,0
1653611897739,ECE 200,038,091040,Radic; Stojan,9999,0,9999,0
1653611897739,ECE 200,039,091041,Rao; Bhaskar D.,9999,0,9999,0
1653611897739,ECE 200,040,091042,Rao; Ramesh R,9999,0,9999,0
1653611897739,ECE 200,041,091043,Rebeiz; Gabriel,9999,0,9999,0
1653611897739,ECE 200,042,091044,Sanford; John R,9999,0,9999,0
1653611897739,ECE 200,043,091045,Siegel; Paul H.,9999,0,9999,0
1653611897739,ECE 200,044,091046,Sievenpiper; Daniel F.,9999,0,9999,0
1653611897739,ECE 200,045,091047,Sworder; David D.,9999,0,9999,0
1653611897739,ECE 200,046,091048,Taur; Yuan,9999,0,9999,0
1653611897739,ECE 200,047,091049,Touri; Behrouz,9999,0,9999,0
1653611897739,ECE 200,048,091050,Trivedi; Mohan M.,9999,0,9999,0
1653611897739,ECE 200,049,091051,Vardy; Alexander,9999,0,9999,0
1653611897739,ECE 200,050,091052,Vasconcelos; Nuno,9999,0,9999,0
1653611897739,ECE 200,051,091053,Wang; Xiaolong,9999,0,9999,0
1653611897739,ECE 200,052,091054,Xie; Pengtao,9999,0,9999,0
1653611897739,ECE 200,053,091055,Yip; Michael,9999,0,9999,0
1653611897739,ECE 200,054,091056,Zeger; Kenneth A.,9999,0,9999,0
1653611897739,ECE 200,055,091057,Zhang; Xinyu,9999,0,9999,0
1653611897739,ECE 200,056,091058,Turakhia; Yatish Girish,9999,0,9999,0
1653611897739,ECE 200,057,091059,Kang; Mingu,9999,0,9999,0
1653611897739,ECE 200,058,091060,Shi; Yuanyuan,9999,0,9999,0
1653611897739,ECE 200,059,091061,Wang; Edward Jay,9999,0,9999,0
1653611897739,ECE 200,060,091062,Zheng; Yang,9999,0,9999,0
1653611898264,ECE 201,A00,095526,Lo; Yu-Hwa,0,0,0,0
1653611898790,ECE 203,A00,091065,Mercier; Patrick Philip,0,0,0,0
1653611899316,ECE 207A,A00,091605,Liu; Thomas Tao-Ming,0,0,0,0
1653611899850,ECE 212AN,A00,091068,Nomura; Kenji,0,0,0,0
1653611900376,ECE 222A,A00,091069,Rebeiz; Gabriel,0,0,0,0
1653611900902,ECE 225A,A00,091070,Orlitsky; Alon,0,0,0,0
1653611901425,ECE 230A,A00,091071,Nomura; Kenji,0,0,0,0
1653611901958,ECE 236A,A00,091072,Dayeh; Shadi Ahmad,0,0,0,0
1653611902481,ECE 238A,A00,091073,Luo; Jian,0,0,0,0
1653611902481,ECE 238A,B00,091074,Luo; Jian,0,0,0,0
1653611903004,ECE 240A,A00,091075,Radic; Stojan,0,0,0,0
1653611903530,ECE 247A,A00,091592,Shi; Lingyan,0,0,0,0
1653611904053,ECE 250,A00,091076,Touri; Behrouz,0,0,0,0
1653611904586,ECE 251C,A00,091078,Nguyen; Truong Quang,0,0,0,0
1653611905110,ECE 253,A00,091079,Cosman; Pamela C.,0,0,0,0
1653611905634,ECE 255A,A00,091080,Orlitsky; Alon,0,0,0,0
1653611906158,ECE 257A,A00,091081,Zhang; Xinyu,0,0,0,0
1653611906680,ECE 260A,A01,091084,Eldon; John,0,0,0,0
1653611907205,ECE 264C,A00,091085,Galton; Ian A,0,0,0,0
1653611907730,ECE 265C,A00,094889,Presti; Calogero Davide,0,0,0,9
1653611908256,ECE 266,A01,091087,Hall; Drew A.,0,0,0,0
1653611909304,ECE 271A,A00,091090,Vasconcelos; Nuno,0,0,0,0
1653611909837,ECE 272B,A00,091091,Sworder; David D.,0,0,0,0
1653611910364,ECE 275A,A00,091092,Meyer; Florian,0,0,0,0
1653611910961,ECE 277,A00,091093,An; Cheolhong,0,0,0,0
1653611911486,ECE 283,A00,091094,Le; Hanh-Phuc,0,0,0,0
1653611912020,ECE 284,A00,091095,Kang; Mingu,0,0,0,0
1653611912020,ECE 284,B00,091096,Wang; Edward Jay,0,0,0,0
1653611912546,ECE 285,A00,094334,Touri; Behrouz,0,0,0,0
1653611913070,ECE 289,A00,091097,Whelan; David Arthur,0,0,0,0
1653611913601,MATH 200A,A00,087414,Salehi Golsefidy; Alireza,7,0,8,1
1653611914134,MATH 202A,A00,087415,Gill; Philip E.,2,0,8,6
1653611914672,MATH 203A,A00,087416,Oprea; Dragos N.,6,0,8,2
1653611915198,MATH 204A,A00,087417,Kedlaya; Kiran S.,6,0,8,2
1653611915732,MATH 205,A00,087418,Sorensen; Claus M,6,0,8,2
1653611916255,MATH 206A,A00,087419,Izadi; Elham,7,0,8,1
1653611916784,MATH 207A,A00,087420,Mohammadi; Amir,5,0,8,3
1653611917306,MATH 208,A00,087421,Staff,9,0,10,1
1653611917831,MATH 209,A00,087422,Staff,10,0,10,0
1653611918360,MATH 218,A00,087423,Staff,10,0,10,0
1653611918888,MATH 220A,A00,087424,Novak; Jonathan I,6,0,8,2
1653611919415,MATH 231A,A00,087425,Bejenaru; Ioan,3,0,8,5
1653611919938,MATH 240A,A00,087426,Ebenfelt; Peter F,5,0,8,3
1653611920464,MATH 243,A00,087427,Staff,9,0,10,1
1653611920986,MATH 248,A00,087429,Staff,10,0,10,0
1653611921509,MATH 250A,A00,087430,Spolaor; Luca,4,0,8,4
1653611922041,MATH 257A,A00,087431,Spolaor; Luca,7,0,8,1
1653611922574,MATH 258,A00,087432,Staff,9,0,10,1
1653611923100,MATH 264A,A00,087433,Warnke; Lutz Peter,5,0,8,3
1653611923623,MATH 268,A00,087434,Staff,15,0,15,0
1653611924146,MATH 269,A00,087435,Staff,14,0,15,1
1653611924669,MATH 270A,A00,087436,Nie; Jiawang,0,0,8,8
1653611925190,MATH 272A,A00,087437,Tian; Xiaochuan,0,0,8,8
1653611925719,MATH 274,A01,087439,Cheng; Li-Tien,9,0,10,1
1653611925719,MATH 274,A02,087440,Cheng; Li-Tien,10,0,10,0
1653611926244,MATH 278A,A00,087441,Staff,8,0,10,2
1653611926767,MATH 278B,A00,087442,Staff,8,0,10,2
1653611927293,MATH 278C,A00,087443,Staff,8,0,10,2
1653611927819,MATH 280A,A00,087444,Zheng; Tianyi,0,0,8,8
1653611928345,MATH 281A,A00,087445,Bradic; Jelena,0,0,8,9
1653611928870,MATH 282A,A00,087446,Zhang; Danna,0,0,8,8
1653611929396,MATH 283,A00,087447,Tesler; Glenn,0,0,0,16
1653611929919,MATH 286,B00,095535,Kemp; Todd Aahron,5,0,8,3
1653611930443,MATH 287D,B00,095536,Bradic; Jelena,5,0,8,3
1653611930968,MATH 288,A00,087450,Staff,14,0,15,1
1653611930968,MATH 288,B00,087451,Staff,15,0,15,0
1653611930968,MATH 288,C00,087452,Staff,15,0,15,0
1653611931498,MATH 290A,A00,087453,Xu; Zhouli,6,0,8,2
1653611932021,MATH 291A,A00,087454,Xu; Zhouli,7,0,8,1
1653611932546,MATH 292,A00,087455,Staff,10,0,10,0
1653611933068,MATH 295,A00,087456,Staff,50,0,50,0
1653611933591,MATH 297,001,087457,Staff,997,0,999,2
1653612493381,COGS 200,A01,087991,Staff,47,0,50,3
1653612493908,COGS 201,A01,094504,Rangel; Lara M,16,0,25,9
1653612494432,COGS 203,A00,087992,Coulson; Seana M,18,0,20,2
1653612494965,COGS 210A,001,087993,Greene; Deanna Jacquelyn,9998,0,9999,1
1653612494965,COGS 210A,002,087994,Saygin; Ayse P,9999,0,9999,0
1653612494965,COGS 210A,003,087995,Xia; Haijun,9999,0,9999,0
1653612494965,COGS 210A,004,087996,Nitz; Douglas A.,9999,0,9999,0
1653612494965,COGS 210A,005,087997,Hollan; James D.,9999,0,9999,0
1653612494965,COGS 210A,006,087998,Deak; Gedeon O.,9998,0,9999,1
1653612494965,COGS 210A,007,087999,Rossano; Federico,9999,0,9999,0
1653612495491,COGS 211A,A00,088000,Coulson; Seana M,9997,0,9999,2
1653612496017,COGS 229,A00,088002,Staff,22,0,25,3
1653612496540,COGS 260,B00,094231,Staff,17,0,20,3
1653612496540,COGS 260,A00,088004,Nitz; Douglas A.,9998,0,9999,1
1653612497067,CSE 202,A00,090110,Paturi; Ramamohan,0,0,0,0
1653612497067,CSE 202,B00,090111,Paturi; Ramamohan,0,0,0,0
1653612497590,CSE 207B,A00,090112,Heninger; Nadia A,0,0,0,0
1653612498206,CSE 208,A00,094858,Micciancio; Daniele,0,0,0,0
1653612498727,CSE 210,A00,090113,Powell; Thomas Allan,0,0,0,0
1653612499250,CSE 219,A00,090898,Staff,0,0,0,0
1653612499778,CSE 221,A00,090114,Zhou; Yuan-Yuan,0,0,0,0
1653612500307,CSE 229A,A00,090115,Porter; George M,0,0,0,0
1653612500833,CSE 229C,A00,090116,Savage; Stefan,0,0,0,0
1653612501355,CSE 230,A00,090117,Jhala; Ranjit,0,0,0,0
1653612501881,CSE 232,A00,090118,Papakonstantinou; Yannis,0,0,0,0
1653612502404,CSE 239A,A00,090121,Kumar; Arun Kumar,0,0,0,0
1653612502927,CSE 239B,A00,090122,Jhala; Ranjit,0,0,0,0
1653612503461,CSE 240A,A00,090123,Zhao; Jishen,0,0,189,189
1653612503990,CSE 243A,A00,090124,Orailoglu; Alex,0,0,15,15
1653612504514,CSE 249B,A00,090125,Kahng; Andrew Byun,12,0,20,8
1653612505047,CSE 250A,A00,090126,Berg-Kirkpatrick; Taylor D,0,0,0,0
1653612505569,CSE 252A,A00,090127,Ochoa; Benjamin Lawrence,0,0,0,0
1653612506102,CSE 258,A01,090129,McAuley; Julian John,0,0,0,0
1653612506624,CSE 258R,A01,090131,McAuley; Julian John,0,0,0,0
1653612507149,CSE 274,A00,090132,Ramamoorthi; Ravi,0,0,0,0
1653612507672,CSE 276A,A00,090133,Christensen; Henrik I,0,0,0,0
1653612508194,CSE 276C,A00,090134,Christensen; Henrik I,0,0,0,0
1653612508726,CSE 290,A00,090135,Bafna; Vineet,0,0,0,0
1653612508726,CSE 290,B00,090136,Ramamoorthi; Ravi,0,0,0,0
1653612508726,CSE 290,C00,090137,Li; Tzumao,7,0,10,3
1653612508726,CSE 290,D00,090138,Zhou; Yuan-Yuan,9,0,10,1
1653612508726,CSE 290,E00,090139,Christensen; Henrik I,8,0,10,2
1653612508726,CSE 290,F00,094053,Shalev; Aaron D,0,0,0,0
1653612509253,CSE 291,A00,090140,Munyaka; Imani N. S.,0,0,0,0
1653612509253,CSE 291,B00,094880,Yu; Qi,0,0,0,0
1653612509253,CSE 291,C00,090142,Pannuto; Patrick William,0,0,0,0
1653612509253,CSE 291,D00,094881,Zhang; Yiying,0,0,0,0
1653612509253,CSE 291,E00,095118,Su; Hao,0,0,0,0
1653612509780,CSE 293,001,094905,Bafna; Vineet,9999,0,9999,0
1653612509780,CSE 293,002,094906,Bellare; Mihir,9999,0,9999,0
1653612509780,CSE 293,003,094907,Berg-Kirkpatrick; Taylor D,9999,0,9999,0
1653612509780,CSE 293,004,094908,Christensen; Henrik I,9999,0,9999,0
1653612509780,CSE 293,005,094909,Cottrell; Garrison W,9999,0,9999,0
1653612509780,CSE 293,006,094910,Deutsch; Alin Bernard,9999,0,9999,0
1653612509780,CSE 293,007,094911,Esmaeilzadeh; Hadi,9999,0,9999,0
1653612509780,CSE 293,008,094912,Freund; Yoav,9999,0,9999,0
1653612509780,CSE 293,009,094913,Griswold; William G.,9999,0,9999,0
1653612509780,CSE 293,010,094914,Gymrek; Melissa Ann,9999,0,9999,0
1653612509780,CSE 293,011,094915,Heninger; Nadia A,9999,0,9999,0
1653612509780,CSE 293,012,094916,Impagliazzo; Russell,9999,0,9999,0
1653612509780,CSE 293,013,094917,Jhala; Ranjit,9999,0,9999,0
1653612509780,CSE 293,014,094918,Kahng; Andrew Byun,9999,0,9999,0
1653612509780,CSE 293,015,094919,Kane; Daniel Mertz,9999,0,9999,0
1653612509780,CSE 293,016,094920,Kriegman; David J,9999,0,9999,0
1653612509780,CSE 293,017,094921,Kumar; Arun Kumar,9999,0,9999,0
1653612509780,CSE 293,018,094922,Lerner; Sorin,9999,0,9999,0
1653612509780,CSE 293,019,094923,Lovett; Shachar,9999,0,9999,0
1653612509780,CSE 293,020,094924,McAuley; Julian John,9999,0,9999,0
1653612509780,CSE 293,021,094925,Micciancio; Daniele,9999,0,9999,0
1653612509780,CSE 293,022,094926,Orailoglu; Alex,9999,0,9999,0
1653612509780,CSE 293,023,094927,Paturi; Ramamohan,9999,0,9999,0
1653612509780,CSE 293,024,094928,Polikarpova; Nadezhda,9999,0,9999,0
1653612509780,CSE 293,025,094929,Politz; Joseph Gibbs,9999,0,9999,0
1653612509780,CSE 293,026,094930,Porter; George M,9999,0,9999,0
1653612509780,CSE 293,027,094931,Porter; Leonard Emerson,9999,0,9999,0
1653612509780,CSE 293,028,094932,Ramamoorthi; Ravi,9999,0,9999,0
1653612509780,CSE 293,029,094933,Sahoo; Debashis,9999,0,9999,0
1653612509780,CSE 293,030,094934,Saul; Lawrence,9999,0,9999,0
1653612509780,CSE 293,031,094935,Savage; Stefan,9999,0,9999,0
1653612509780,CSE 293,032,094936,Schulze; Jurgen P.,9999,0,9999,0
1653612509780,CSE 293,033,094937,Snoeren; Alex C.,9999,0,9999,0
1653612509780,CSE 293,034,094938,Shang; Jingbo,9999,0,9999,0
1653612509780,CSE 293,035,094939,Stefan; Deian,9999,0,9999,0
1653612509780,CSE 293,036,094940,Su; Hao,9999,0,9999,0
1653612509780,CSE 293,037,094941,Swanson; Steven James,9999,0,9999,0
1653612509780,CSE 293,038,094942,Tullsen; Dean Michael,9999,0,9999,0
1653612509780,CSE 293,039,094943,Voelker; Geoffrey M.,9999,0,9999,0
1653612509780,CSE 293,040,094944,Zhao; Jishen,9999,0,9999,0
1653612509780,CSE 293,041,094945,Zhou; Yuan-Yuan,9999,0,9999,0
1653612509780,CSE 293,042,094946,Gao; Sicun,9998,0,9999,1
1653612509780,CSE 293,043,094947,Weibel; Nadir,9999,0,9999,0
1653612509780,CSE 293,044,094948,Gupta; Rajesh K.,9999,0,9999,0
1653612510302,CSE 294,A00,090143,Porter; George M,9,0,10,1
1653612510825,DSE 200,A00,091799,Staff,50,0,50,0
1653612511348,DSE 203,A00,091800,Gupta; Amarnath,30,0,30,0
1653612511875,DSE 250,A00,091801,Deutsch; Alin Bernard,30,0,30,0
1653612512398,DSE 290,A00,091802,Altintas De Callaf; Ilkay,50,0,50,0
1653612512927,ECE 200,001,091003,Antipa; Nicholas A,9999,0,9999,0
1653612512927,ECE 200,002,091004,Atanasov; Nikolay A.,9999,0,9999,0
1653612512927,ECE 200,003,091005,Bharadia; Dinesh,9999,0,9999,0
1653612512927,ECE 200,004,091006,Cheng; Chung Kuan,9999,0,9999,0
1653612512927,ECE 200,005,091007,Cosman; Pamela C.,9999,0,9999,0
1653612512927,ECE 200,006,091008,Staff,9999,0,9999,0
1653612512927,ECE 200,007,091009,Dayeh; Shadi Ahmad,9999,0,9999,0
1653612512927,ECE 200,008,091010,Fainman; Yeshaiahu,9999,0,9999,0
1653612512927,ECE 200,009,091011,Ford; Joseph Earl,9999,0,9999,0
1653612512927,ECE 200,010,091012,Franceschetti; Massimo,9999,0,9999,0
1653612512927,ECE 200,011,091013,Fullerton; Eric E,9999,0,9999,0
1653612512927,ECE 200,012,091014,Galton; Ian A,9999,0,9999,0
1653612512927,ECE 200,013,091015,Gilja; Vikash,9999,0,9999,0
1653612512927,ECE 200,014,091016,Hall; Drew A.,9999,0,9999,0
1653612512927,ECE 200,015,091017,Hsueh; Tzu-Chien,9999,0,9999,0
1653612512927,ECE 200,016,091018,Javidi; Tara,9999,0,9999,0
1653612512927,ECE 200,017,091019,Kahng; Andrew Byun,9999,0,9999,0
1653612512927,ECE 200,018,091020,Kim; Young-Han,9999,0,9999,0
1653612512927,ECE 200,019,091021,Koushanfar; Farinaz,9999,0,9999,0
1653612512927,ECE 200,020,091022,Kuzum; Duygu,9999,0,9999,0
1653612512927,ECE 200,021,091023,Le; Hanh-Phuc,9999,0,9999,0
1653612512927,ECE 200,022,091024,Lin; Bill,9999,0,9999,0
1653612512927,ECE 200,023,091025,Liu; Zhaowei,9999,0,9999,0
1653612512927,ECE 200,024,091026,Lo; Yu-Hwa,9999,0,9999,0
1653612512927,ECE 200,025,091027,Lomakin; Vitaliy,9999,0,9999,0
1653612512927,ECE 200,026,091028,Mercier; Patrick Philip,9999,0,9999,0
1653612512927,ECE 200,027,091029,Meyer; Florian,9999,0,9999,0
1653612512927,ECE 200,028,091030,Milstein; Laurence B.,9999,0,9999,0
1653612512927,ECE 200,029,091031,Mir Arabbaygi; Siavash,9999,0,9999,0
1653612512927,ECE 200,030,091032,Mookherjea; Shayan,9999,0,9999,0
1653612512927,ECE 200,031,091033,Morris; Karcher William,9999,0,9999,0
1653612512927,ECE 200,032,091034,Ng; Tse Nga,9999,0,9999,0
1653612512927,ECE 200,033,091035,Nguyen; Truong Quang,9999,0,9999,0
1653612512927,ECE 200,034,091036,Nomura; Kenji,9999,0,9999,0
1653612512927,ECE 200,035,091037,Orlitsky; Alon,9999,0,9999,0
1653612512927,ECE 200,036,091038,Pal; Piya,9999,0,9999,0
1653612512927,ECE 200,037,091039,Papen; George C.,9999,0,9999,0
1653612512927,ECE 200,038,091040,Radic; Stojan,9999,0,9999,0
1653612512927,ECE 200,039,091041,Rao; Bhaskar D.,9999,0,9999,0
1653612512927,ECE 200,040,091042,Rao; Ramesh R,9999,0,9999,0
1653612512927,ECE 200,041,091043,Rebeiz; Gabriel,9999,0,9999,0
1653612512927,ECE 200,042,091044,Sanford; John R,9999,0,9999,0
1653612512927,ECE 200,043,091045,Siegel; Paul H.,9999,0,9999,0
1653612512927,ECE 200,044,091046,Sievenpiper; Daniel F.,9999,0,9999,0
1653612512927,ECE 200,045,091047,Sworder; David D.,9999,0,9999,0
1653612512927,ECE 200,046,091048,Taur; Yuan,9999,0,9999,0
1653612512927,ECE 200,047,091049,Touri; Behrouz,9999,0,9999,0
1653612512927,ECE 200,048,091050,Trivedi; Mohan M.,9999,0,9999,0
1653612512927,ECE 200,049,091051,Vardy; Alexander,9999,0,9999,0
1653612512927,ECE 200,050,091052,Vasconcelos; Nuno,9999,0,9999,0
1653612512927,ECE 200,051,091053,Wang; Xiaolong,9999,0,9999,0
1653612512927,ECE 200,052,091054,Xie; Pengtao,9999,0,9999,0
1653612512927,ECE 200,053,091055,Yip; Michael,9999,0,9999,0
1653612512927,ECE 200,054,091056,Zeger; Kenneth A.,9999,0,9999,0
1653612512927,ECE 200,055,091057,Zhang; Xinyu,9999,0,9999,0
1653612512927,ECE 200,056,091058,Turakhia; Yatish Girish,9999,0,9999,0
1653612512927,ECE 200,057,091059,Kang; Mingu,9999,0,9999,0
1653612512927,ECE 200,058,091060,Shi; Yuanyuan,9999,0,9999,0
1653612512927,ECE 200,059,091061,Wang; Edward Jay,9999,0,9999,0
1653612512927,ECE 200,060,091062,Zheng; Yang,9999,0,9999,0
1653612513450,ECE 201,A00,095526,Lo; Yu-Hwa,0,0,0,0
1653612513972,ECE 203,A00,091065,Mercier; Patrick Philip,0,0,0,0
1653612514496,ECE 207A,A00,091605,Liu; Thomas Tao-Ming,0,0,0,0
1653612515022,ECE 212AN,A00,091068,Nomura; Kenji,0,0,0,0
1653612515548,ECE 222A,A00,091069,Rebeiz; Gabriel,0,0,0,0
1653612516073,ECE 225A,A00,091070,Orlitsky; Alon,0,0,0,0
1653612516607,ECE 230A,A00,091071,Nomura; Kenji,0,0,0,0
1653612517130,ECE 236A,A00,091072,Dayeh; Shadi Ahmad,0,0,0,0
1653612517654,ECE 238A,A00,091073,Luo; Jian,0,0,0,0
1653612517654,ECE 238A,B00,091074,Luo; Jian,0,0,0,0
1653612518188,ECE 240A,A00,091075,Radic; Stojan,0,0,0,0
1653612518711,ECE 247A,A00,091592,Shi; Lingyan,0,0,0,0
1653612519236,ECE 250,A00,091076,Touri; Behrouz,0,0,0,0
1653612519763,ECE 251C,A00,091078,Nguyen; Truong Quang,0,0,0,0
1653612520297,ECE 253,A00,091079,Cosman; Pamela C.,0,0,0,0
1653612520826,ECE 255A,A00,091080,Orlitsky; Alon,0,0,0,0
1653612521350,ECE 257A,A00,091081,Zhang; Xinyu,0,0,0,0
1653612521872,ECE 260A,A01,091084,Eldon; John,0,0,0,0
1653612522398,ECE 264C,A00,091085,Galton; Ian A,0,0,0,0
1653612522922,ECE 265C,A00,094889,Presti; Calogero Davide,0,0,0,9
1653612523444,ECE 266,A01,091087,Hall; Drew A.,0,0,0,0
1653612524501,ECE 271A,A00,091090,Vasconcelos; Nuno,0,0,0,0
1653612525033,ECE 272B,A00,091091,Sworder; David D.,0,0,0,0
1653612525559,ECE 275A,A00,091092,Meyer; Florian,0,0,0,0
1653612526084,ECE 277,A00,091093,An; Cheolhong,0,0,0,0
1653612526610,ECE 283,A00,091094,Le; Hanh-Phuc,0,0,0,0
1653612527133,ECE 284,A00,091095,Kang; Mingu,0,0,0,0
1653612527133,ECE 284,B00,091096,Wang; Edward Jay,0,0,0,0
1653612527660,ECE 285,A00,094334,Touri; Behrouz,0,0,0,0
1653612528185,ECE 289,A00,091097,Whelan; David Arthur,0,0,0,0
1653612528714,MATH 200A,A00,087414,Salehi Golsefidy; Alireza,7,0,8,1
1653612529242,MATH 202A,A00,087415,Gill; Philip E.,2,0,8,6
1653612529765,MATH 203A,A00,087416,Oprea; Dragos N.,6,0,8,2
1653612530295,MATH 204A,A00,087417,Kedlaya; Kiran S.,6,0,8,2
1653612530818,MATH 205,A00,087418,Sorensen; Claus M,6,0,8,2
1653612531345,MATH 206A,A00,087419,Izadi; Elham,7,0,8,1
1653612531869,MATH 207A,A00,087420,Mohammadi; Amir,5,0,8,3
1653612532394,MATH 208,A00,087421,Staff,9,0,10,1
1653612532927,MATH 209,A00,087422,Staff,10,0,10,0
1653612533454,MATH 218,A00,087423,Staff,10,0,10,0
1653612533977,MATH 220A,A00,087424,Novak; Jonathan I,6,0,8,2
1653612534508,MATH 231A,A00,087425,Bejenaru; Ioan,3,0,8,5
1653612535033,MATH 240A,A00,087426,Ebenfelt; Peter F,5,0,8,3
1653612535563,MATH 243,A00,087427,Staff,9,0,10,1
1653612536089,MATH 248,A00,087429,Staff,10,0,10,0
1653612536621,MATH 250A,A00,087430,Spolaor; Luca,4,0,8,4
1653612537143,MATH 257A,A00,087431,Spolaor; Luca,7,0,8,1
1653612537670,MATH 258,A00,087432,Staff,9,0,10,1
1653612538194,MATH 264A,A00,087433,Warnke; Lutz Peter,5,0,8,3
1653612538723,MATH 268,A00,087434,Staff,15,0,15,0
1653612539255,MATH 269,A00,087435,Staff,14,0,15,1
1653612539778,MATH 270A,A00,087436,Nie; Jiawang,0,0,8,8
1653612540303,MATH 272A,A00,087437,Tian; Xiaochuan,0,0,8,8
1653612540832,MATH 274,A01,087439,Cheng; Li-Tien,9,0,10,1
1653612540832,MATH 274,A02,087440,Cheng; Li-Tien,10,0,10,0
1653612541360,MATH 278A,A00,087441,Staff,8,0,10,2
1653612541883,MATH 278B,A00,087442,Staff,8,0,10,2
1653612542406,MATH 278C,A00,087443,Staff,8,0,10,2
1653612542953,MATH 280A,A00,087444,Zheng; Tianyi,0,0,8,8
1653612543478,MATH 281A,A00,087445,Bradic; Jelena,0,0,8,9
1653612544004,MATH 282A,A00,087446,Zhang; Danna,0,0,8,8
1653612544527,MATH 283,A00,087447,Tesler; Glenn,0,0,0,16
1653612545064,MATH 286,B00,095535,Kemp; Todd Aahron,5,0,8,3
1653612545592,MATH 287D,B00,095536,Bradic; Jelena,5,0,8,3
1653612546117,MATH 288,A00,087450,Staff,14,0,15,1
1653612546117,MATH 288,B00,087451,Staff,15,0,15,0
1653612546117,MATH 288,C00,087452,Staff,15,0,15,0
1653612546641,MATH 290A,A00,087453,Xu; Zhouli,6,0,8,2
1653612547164,MATH 291A,A00,087454,Xu; Zhouli,7,0,8,1
1653612547686,MATH 292,A00,087455,Staff,10,0,10,0
1653612548208,MATH 295,A00,087456,Staff,50,0,50,0
1653612548732,MATH 297,001,087457,Staff,997,0,999,2
1653613108723,COGS 200,A01,087991,Staff,47,0,50,3
1653613109253,COGS 201,A01,094504,Rangel; Lara M,16,0,25,9
1653613109788,COGS 203,A00,087992,Coulson; Seana M,18,0,20,2
1653613110335,COGS 210A,001,087993,Greene; Deanna Jacquelyn,9998,0,9999,1
1653613110335,COGS 210A,002,087994,Saygin; Ayse P,9999,0,9999,0
1653613110335,COGS 210A,003,087995,Xia; Haijun,9999,0,9999,0
1653613110335,COGS 210A,004,087996,Nitz; Douglas A.,9999,0,9999,0
1653613110335,COGS 210A,005,087997,Hollan; James D.,9999,0,9999,0
1653613110335,COGS 210A,006,087998,Deak; Gedeon O.,9998,0,9999,1
1653613110335,COGS 210A,007,087999,Rossano; Federico,9999,0,9999,0
1653613110861,COGS 211A,A00,088000,Coulson; Seana M,9997,0,9999,2
1653613111384,COGS 229,A00,088002,Staff,22,0,25,3
1653613111906,COGS 260,B00,094231,Staff,17,0,20,3
1653613111906,COGS 260,A00,088004,Nitz; Douglas A.,9998,0,9999,1
1653613112432,CSE 202,A00,090110,Paturi; Ramamohan,0,0,0,0
1653613112432,CSE 202,B00,090111,Paturi; Ramamohan,0,0,0,0
1653613112963,CSE 207B,A00,090112,Heninger; Nadia A,0,0,0,0
1653613113487,CSE 208,A00,094858,Micciancio; Daniele,0,0,0,0
1653613114013,CSE 210,A00,090113,Powell; Thomas Allan,0,0,0,0
1653613114551,CSE 219,A00,090898,Staff,0,0,0,0
1653613115076,CSE 221,A00,090114,Zhou; Yuan-Yuan,0,0,0,0
1653613115597,CSE 229A,A00,090115,Porter; George M,0,0,0,0
1653613116123,CSE 229C,A00,090116,Savage; Stefan,0,0,0,0
1653613116645,CSE 230,A00,090117,Jhala; Ranjit,0,0,0,0
1653613117167,CSE 232,A00,090118,Papakonstantinou; Yannis,0,0,0,0
1653613117696,CSE 239A,A00,090121,Kumar; Arun Kumar,0,0,0,0
1653613118218,CSE 239B,A00,090122,Jhala; Ranjit,0,0,0,0
1653613118750,CSE 240A,A00,090123,Zhao; Jishen,0,0,189,189
1653613119275,CSE 243A,A00,090124,Orailoglu; Alex,0,0,15,15
1653613119798,CSE 249B,A00,090125,Kahng; Andrew Byun,12,0,20,8
1653613120323,CSE 250A,A00,090126,Berg-Kirkpatrick; Taylor D,0,0,0,0
1653613120845,CSE 252A,A00,090127,Ochoa; Benjamin Lawrence,0,0,0,0
1653613121367,CSE 258,A01,090129,McAuley; Julian John,0,0,0,0
1653613121889,CSE 258R,A01,090131,McAuley; Julian John,0,0,0,0
1653613122411,CSE 274,A00,090132,Ramamoorthi; Ravi,0,0,0,0
1653613122934,CSE 276A,A00,090133,Christensen; Henrik I,0,0,0,0
1653613123458,CSE 276C,A00,090134,Christensen; Henrik I,0,0,0,0
1653613123983,CSE 290,A00,090135,Bafna; Vineet,0,0,0,0
1653613123983,CSE 290,B00,090136,Ramamoorthi; Ravi,0,0,0,0
1653613123983,CSE 290,C00,090137,Li; Tzumao,7,0,10,3
1653613123983,CSE 290,D00,090138,Zhou; Yuan-Yuan,9,0,10,1
1653613123983,CSE 290,E00,090139,Christensen; Henrik I,8,0,10,2
1653613123983,CSE 290,F00,094053,Shalev; Aaron D,0,0,0,0
1653613124510,CSE 291,A00,090140,Munyaka; Imani N. S.,0,0,0,0
1653613124510,CSE 291,B00,094880,Yu; Qi,0,0,0,0
1653613124510,CSE 291,C00,090142,Pannuto; Patrick William,0,0,0,0
1653613124510,CSE 291,D00,094881,Zhang; Yiying,0,0,0,0
1653613124510,CSE 291,E00,095118,Su; Hao,0,0,0,0
1653613125043,CSE 293,001,094905,Bafna; Vineet,9999,0,9999,0
1653613125043,CSE 293,002,094906,Bellare; Mihir,9999,0,9999,0
1653613125043,CSE 293,003,094907,Berg-Kirkpatrick; Taylor D,9999,0,9999,0
1653613125043,CSE 293,004,094908,Christensen; Henrik I,9999,0,9999,0
1653613125043,CSE 293,005,094909,Cottrell; Garrison W,9999,0,9999,0
1653613125043,CSE 293,006,094910,Deutsch; Alin Bernard,9999,0,9999,0
1653613125043,CSE 293,007,094911,Esmaeilzadeh; Hadi,9999,0,9999,0
1653613125043,CSE 293,008,094912,Freund; Yoav,9999,0,9999,0
1653613125043,CSE 293,009,094913,Griswold; William G.,9999,0,9999,0
1653613125043,CSE 293,010,094914,Gymrek; Melissa Ann,9999,0,9999,0
1653613125043,CSE 293,011,094915,Heninger; Nadia A,9999,0,9999,0
1653613125043,CSE 293,012,094916,Impagliazzo; Russell,9999,0,9999,0
1653613125043,CSE 293,013,094917,Jhala; Ranjit,9999,0,9999,0
1653613125043,CSE 293,014,094918,Kahng; Andrew Byun,9999,0,9999,0
1653613125043,CSE 293,015,094919,Kane; Daniel Mertz,9999,0,9999,0
1653613125043,CSE 293,016,094920,Kriegman; David J,9999,0,9999,0
1653613125043,CSE 293,017,094921,Kumar; Arun Kumar,9999,0,9999,0
1653613125043,CSE 293,018,094922,Lerner; Sorin,9999,0,9999,0
1653613125043,CSE 293,019,094923,Lovett; Shachar,9999,0,9999,0
1653613125043,CSE 293,020,094924,McAuley; Julian John,9999,0,9999,0
1653613125043,CSE 293,021,094925,Micciancio; Daniele,9999,0,9999,0
1653613125043,CSE 293,022,094926,Orailoglu; Alex,9999,0,9999,0
1653613125043,CSE 293,023,094927,Paturi; Ramamohan,9999,0,9999,0
1653613125043,CSE 293,024,094928,Polikarpova; Nadezhda,9999,0,9999,0
1653613125043,CSE 293,025,094929,Politz; Joseph Gibbs,9999,0,9999,0
1653613125043,CSE 293,026,094930,Porter; George M,9999,0,9999,0
1653613125043,CSE 293,027,094931,Porter; Leonard Emerson,9999,0,9999,0
1653613125043,CSE 293,028,094932,Ramamoorthi; Ravi,9999,0,9999,0
1653613125043,CSE 293,029,094933,Sahoo; Debashis,9999,0,9999,0
1653613125043,CSE 293,030,094934,Saul; Lawrence,9999,0,9999,0
1653613125043,CSE 293,031,094935,Savage; Stefan,9999,0,9999,0
1653613125043,CSE 293,032,094936,Schulze; Jurgen P.,9999,0,9999,0
1653613125043,CSE 293,033,094937,Snoeren; Alex C.,9999,0,9999,0
1653613125043,CSE 293,034,094938,Shang; Jingbo,9999,0,9999,0
1653613125043,CSE 293,035,094939,Stefan; Deian,9999,0,9999,0
1653613125043,CSE 293,036,094940,Su; Hao,9999,0,9999,0
1653613125043,CSE 293,037,094941,Swanson; Steven James,9999,0,9999,0
1653613125043,CSE 293,038,094942,Tullsen; Dean Michael,9999,0,9999,0
1653613125043,CSE 293,039,094943,Voelker; Geoffrey M.,9999,0,9999,0
1653613125043,CSE 293,040,094944,Zhao; Jishen,9999,0,9999,0
1653613125043,CSE 293,041,094945,Zhou; Yuan-Yuan,9999,0,9999,0
1653613125043,CSE 293,042,094946,Gao; Sicun,9998,0,9999,1
1653613125043,CSE 293,043,094947,Weibel; Nadir,9999,0,9999,0
1653613125043,CSE 293,044,094948,Gupta; Rajesh K.,9999,0,9999,0
1653613125565,CSE 294,A00,090143,Porter; George M,9,0,10,1
1653613126089,DSE 200,A00,091799,Staff,50,0,50,0
1653613126629,DSE 203,A00,091800,Gupta; Amarnath,30,0,30,0
1653613127154,DSE 250,A00,091801,Deutsch; Alin Bernard,30,0,30,0
1653613127679,DSE 290,A00,091802,Altintas De Callaf; Ilkay,50,0,50,0
1653613128203,ECE 200,001,091003,Antipa; Nicholas A,9999,0,9999,0
1653613128203,ECE 200,002,091004,Atanasov; Nikolay A.,9999,0,9999,0
1653613128203,ECE 200,003,091005,Bharadia; Dinesh,9999,0,9999,0
1653613128203,ECE 200,004,091006,Cheng; Chung Kuan,9999,0,9999,0
1653613128203,ECE 200,005,091007,Cosman; Pamela C.,9999,0,9999,0
1653613128203,ECE 200,006,091008,Staff,9999,0,9999,0
1653613128203,ECE 200,007,091009,Dayeh; Shadi Ahmad,9999,0,9999,0
1653613128203,ECE 200,008,091010,Fainman; Yeshaiahu,9999,0,9999,0
1653613128203,ECE 200,009,091011,Ford; Joseph Earl,9999,0,9999,0
1653613128203,ECE 200,010,091012,Franceschetti; Massimo,9999,0,9999,0
1653613128203,ECE 200,011,091013,Fullerton; Eric E,9999,0,9999,0
1653613128203,ECE 200,012,091014,Galton; Ian A,9999,0,9999,0
1653613128203,ECE 200,013,091015,Gilja; Vikash,9999,0,9999,0
1653613128203,ECE 200,014,091016,Hall; Drew A.,9999,0,9999,0
1653613128203,ECE 200,015,091017,Hsueh; Tzu-Chien,9999,0,9999,0
1653613128203,ECE 200,016,091018,Javidi; Tara,9999,0,9999,0
1653613128203,ECE 200,017,091019,Kahng; Andrew Byun,9999,0,9999,0
1653613128203,ECE 200,018,091020,Kim; Young-Han,9999,0,9999,0
1653613128203,ECE 200,019,091021,Koushanfar; Farinaz,9999,0,9999,0
1653613128203,ECE 200,020,091022,Kuzum; Duygu,9999,0,9999,0
1653613128203,ECE 200,021,091023,Le; Hanh-Phuc,9999,0,9999,0
1653613128203,ECE 200,022,091024,Lin; Bill,9999,0,9999,0
1653613128203,ECE 200,023,091025,Liu; Zhaowei,9999,0,9999,0
1653613128203,ECE 200,024,091026,Lo; Yu-Hwa,9999,0,9999,0
1653613128203,ECE 200,025,091027,Lomakin; Vitaliy,9999,0,9999,0
1653613128203,ECE 200,026,091028,Mercier; Patrick Philip,9999,0,9999,0
1653613128203,ECE 200,027,091029,Meyer; Florian,9999,0,9999,0
1653613128203,ECE 200,028,091030,Milstein; Laurence B.,9999,0,9999,0
1653613128203,ECE 200,029,091031,Mir Arabbaygi; Siavash,9999,0,9999,0
1653613128203,ECE 200,030,091032,Mookherjea; Shayan,9999,0,9999,0
1653613128203,ECE 200,031,091033,Morris; Karcher William,9999,0,9999,0
1653613128203,ECE 200,032,091034,Ng; Tse Nga,9999,0,9999,0
1653613128203,ECE 200,033,091035,Nguyen; Truong Quang,9999,0,9999,0
1653613128203,ECE 200,034,091036,Nomura; Kenji,9999,0,9999,0
1653613128203,ECE 200,035,091037,Orlitsky; Alon,9999,0,9999,0
1653613128203,ECE 200,036,091038,Pal; Piya,9999,0,9999,0
1653613128203,ECE 200,037,091039,Papen; George C.,9999,0,9999,0
1653613128203,ECE 200,038,091040,Radic; Stojan,9999,0,9999,0
1653613128203,ECE 200,039,091041,Rao; Bhaskar D.,9999,0,9999,0
1653613128203,ECE 200,040,091042,Rao; Ramesh R,9999,0,9999,0
1653613128203,ECE 200,041,091043,Rebeiz; Gabriel,9999,0,9999,0
1653613128203,ECE 200,042,091044,Sanford; John R,9999,0,9999,0
1653613128203,ECE 200,043,091045,Siegel; Paul H.,9999,0,9999,0
1653613128203,ECE 200,044,091046,Sievenpiper; Daniel F.,9999,0,9999,0
1653613128203,ECE 200,045,091047,Sworder; David D.,9999,0,9999,0
1653613128203,ECE 200,046,091048,Taur; Yuan,9999,0,9999,0
1653613128203,ECE 200,047,091049,Touri; Behrouz,9999,0,9999,0
1653613128203,ECE 200,048,091050,Trivedi; Mohan M.,9999,0,9999,0
1653613128203,ECE 200,049,091051,Vardy; Alexander,9999,0,9999,0
1653613128203,ECE 200,050,091052,Vasconcelos; Nuno,9999,0,9999,0
1653613128203,ECE 200,051,091053,Wang; Xiaolong,9999,0,9999,0
1653613128203,ECE 200,052,091054,Xie; Pengtao,9999,0,9999,0
1653613128203,ECE 200,053,091055,Yip; Michael,9999,0,9999,0
1653613128203,ECE 200,054,091056,Zeger; Kenneth A.,9999,0,9999,0
1653613128203,ECE 200,055,091057,Zhang; Xinyu,9999,0,9999,0
1653613128203,ECE 200,056,091058,Turakhia; Yatish Girish,9999,0,9999,0
1653613128203,ECE 200,057,091059,Kang; Mingu,9999,0,9999,0
1653613128203,ECE 200,058,091060,Shi; Yuanyuan,9999,0,9999,0
1653613128203,ECE 200,059,091061,Wang; Edward Jay,9999,0,9999,0
1653613128203,ECE 200,060,091062,Zheng; Yang,9999,0,9999,0
1653613128730,ECE 201,A00,095526,Lo; Yu-Hwa,0,0,0,0
1653613129260,ECE 203,A00,091065,Mercier; Patrick Philip,0,0,0,0
1653613129783,ECE 207A,A00,091605,Liu; Thomas Tao-Ming,0,0,0,0
1653613130308,ECE 212AN,A00,091068,Nomura; Kenji,0,0,0,0
1653613130832,ECE 222A,A00,091069,Rebeiz; Gabriel,0,0,0,0
1653613131362,ECE 225A,A00,091070,Orlitsky; Alon,0,0,0,0
1653613131883,ECE 230A,A00,091071,Nomura; Kenji,0,0,0,0
1653613132409,ECE 236A,A00,091072,Dayeh; Shadi Ahmad,0,0,0,0
1653613132932,ECE 238A,A00,091073,Luo; Jian,0,0,0,0
1653613132932,ECE 238A,B00,091074,Luo; Jian,0,0,0,0
1653613133459,ECE 240A,A00,091075,Radic; Stojan,0,0,0,0
1653613133990,ECE 247A,A00,091592,Shi; Lingyan,0,0,0,0
1653613134530,ECE 250,A00,091076,Touri; Behrouz,0,0,0,0
1653613135069,ECE 251C,A00,091078,Nguyen; Truong Quang,0,0,0,0
1653613135593,ECE 253,A00,091079,Cosman; Pamela C.,0,0,0,0
1653613136119,ECE 255A,A00,091080,Orlitsky; Alon,0,0,0,0
1653613136642,ECE 257A,A00,091081,Zhang; Xinyu,0,0,0,0
1653613137164,ECE 260A,A01,091084,Eldon; John,0,0,0,0
1653613137685,ECE 264C,A00,091085,Galton; Ian A,0,0,0,0
1653613138211,ECE 265C,A00,094889,Presti; Calogero Davide,0,0,0,9
1653613138830,ECE 266,A01,091087,Hall; Drew A.,0,0,0,0
1653613139881,ECE 271A,A00,091090,Vasconcelos; Nuno,0,0,0,0
1653613140402,ECE 272B,A00,091091,Sworder; David D.,0,0,0,0
1653613140926,ECE 275A,A00,091092,Meyer; Florian,0,0,0,0
1653613141450,ECE 277,A00,091093,An; Cheolhong,0,0,0,0
1653613141975,ECE 283,A00,091094,Le; Hanh-Phuc,0,0,0,0
1653613142498,ECE 284,A00,091095,Kang; Mingu,0,0,0,0
1653613142498,ECE 284,B00,091096,Wang; Edward Jay,0,0,0,0
1653613143027,ECE 285,A00,094334,Touri; Behrouz,0,0,0,0
1653613143553,ECE 289,A00,091097,Whelan; David Arthur,0,0,0,0
1653613144079,MATH 200A,A00,087414,Salehi Golsefidy; Alireza,7,0,8,1
1653613144603,MATH 202A,A00,087415,Gill; Philip E.,2,0,8,6
1653613145131,MATH 203A,A00,087416,Oprea; Dragos N.,6,0,8,2
1653613145653,MATH 204A,A00,087417,Kedlaya; Kiran S.,6,0,8,2
1653613146179,MATH 205,A00,087418,Sorensen; Claus M,6,0,8,2
1653613146716,MATH 206A,A00,087419,Izadi; Elham,7,0,8,1
1653613147239,MATH 207A,A00,087420,Mohammadi; Amir,5,0,8,3
1653613147761,MATH 208,A00,087421,Staff,9,0,10,1
1653613148282,MATH 209,A00,087422,Staff,10,0,10,0
1653613148806,MATH 218,A00,087423,Staff,10,0,10,0
1653613149328,MATH 220A,A00,087424,Novak; Jonathan I,6,0,8,2
1653613149854,MATH 231A,A00,087425,Bejenaru; Ioan,3,0,8,5
1653613150376,MATH 240A,A00,087426,Ebenfelt; Peter F,5,0,8,3
1653613150899,MATH 243,A00,087427,Staff,9,0,10,1
1653613151424,MATH 248,A00,087429,Staff,10,0,10,0
1653613151950,MATH 250A,A00,087430,Spolaor; Luca,4,0,8,4
1653613152471,MATH 257A,A00,087431,Spolaor; Luca,7,0,8,1
1653613153005,MATH 258,A00,087432,Staff,9,0,10,1
1653613153530,MATH 264A,A00,087433,Warnke; Lutz Peter,5,0,8,3
1653613154051,MATH 268,A00,087434,Staff,15,0,15,0
1653613154576,MATH 269,A00,087435,Staff,14,0,15,1
1653613155099,MATH 270A,A00,087436,Nie; Jiawang,0,0,8,8
1653613155627,MATH 272A,A00,087437,Tian; Xiaochuan,0,0,8,8
1653613156151,MATH 274,A01,087439,Cheng; Li-Tien,9,0,10,1
1653613156151,MATH 274,A02,087440,Cheng; Li-Tien,10,0,10,0
1653613156675,MATH 278A,A00,087441,Staff,8,0,10,2
1653613157200,MATH 278B,A00,087442,Staff,8,0,10,2
1653613157722,MATH 278C,A00,087443,Staff,8,0,10,2
1653613158248,MATH 280A,A00,087444,Zheng; Tianyi,0,0,8,8
1653613158771,MATH 281A,A00,087445,Bradic; Jelena,0,0,8,9
1653613159307,MATH 282A,A00,087446,Zhang; Danna,0,0,8,8
1653613159838,MATH 283,A00,087447,Tesler; Glenn,0,0,0,16
1653613160365,MATH 286,B00,095535,Kemp; Todd Aahron,5,0,8,3
1653613160887,MATH 287D,B00,095536,Bradic; Jelena,5,0,8,3
1653613161410,MATH 288,A00,087450,Staff,14,0,15,1
1653613161410,MATH 288,B00,087451,Staff,15,0,15,0
1653613161410,MATH 288,C00,087452,Staff,15,0,15,0
1653613161937,MATH 290A,A00,087453,Xu; Zhouli,6,0,8,2
1653613162460,MATH 291A,A00,087454,Xu; Zhouli,7,0,8,1
1653613162983,MATH 292,A00,087455,Staff,10,0,10,0
1653613163507,MATH 295,A00,087456,Staff,50,0,50,0
1653613164039,MATH 297,001,087457,Staff,997,0,999,2
1653613724159,COGS 200,A01,087991,Staff,47,0,50,3
1653613724691,COGS 201,A01,094504,Rangel; Lara M,16,0,25,9
1653613725213,COGS 203,A00,087992,Coulson; Seana M,18,0,20,2
1653613725751,COGS 210A,001,087993,Greene; Deanna Jacquelyn,9998,0,9999,1
1653613725751,COGS 210A,002,087994,Saygin; Ayse P,9999,0,9999,0
1653613725751,COGS 210A,003,087995,Xia; Haijun,9999,0,9999,0
1653613725751,COGS 210A,004,087996,Nitz; Douglas A.,9999,0,9999,0
1653613725751,COGS 210A,005,087997,Hollan; James D.,9999,0,9999,0
1653613725751,COGS 210A,006,087998,Deak; Gedeon O.,9998,0,9999,1
1653613725751,COGS 210A,007,087999,Rossano; Federico,9999,0,9999,0
1653613726349,COGS 211A,A00,088000,Coulson; Seana M,9997,0,9999,2
1653613726872,COGS 229,A00,088002,Staff,22,0,25,3
1653613727399,COGS 260,B00,094231,Staff,17,0,20,3
1653613727399,COGS 260,A00,088004,Nitz; Douglas A.,9998,0,9999,1
1653613727925,CSE 202,A00,090110,Paturi; Ramamohan,0,0,0,0
1653613727925,CSE 202,B00,090111,Paturi; Ramamohan,0,0,0,0
1653613728449,CSE 207B,A00,090112,Heninger; Nadia A,0,0,0,0
1653613728970,CSE 208,A00,094858,Micciancio; Daniele,0,0,0,0
1653613729500,CSE 210,A00,090113,Powell; Thomas Allan,0,0,0,0
1653613730025,CSE 219,A00,090898,Staff,0,0,0,0
1653613730557,CSE 221,A00,090114,Zhou; Yuan-Yuan,0,0,0,0
1653613731086,CSE 229A,A00,090115,Porter; George M,0,0,0,0
1653613731611,CSE 229C,A00,090116,Savage; Stefan,0,0,0,0
1653613732139,CSE 230,A00,090117,Jhala; Ranjit,0,0,0,0
1653613732660,CSE 232,A00,090118,Papakonstantinou; Yannis,0,0,0,0
1653613733185,CSE 239A,A00,090121,Kumar; Arun Kumar,0,0,0,0
1653613733710,CSE 239B,A00,090122,Jhala; Ranjit,0,0,0,0
1653613734240,CSE 240A,A00,090123,Zhao; Jishen,0,0,189,189
1653613734761,CSE 243A,A00,090124,Orailoglu; Alex,0,0,15,15
1653613735287,CSE 249B,A00,090125,Kahng; Andrew Byun,12,0,20,8
1653613735811,CSE 250A,A00,090126,Berg-Kirkpatrick; Taylor D,0,0,0,0
1653613736333,CSE 252A,A00,090127,Ochoa; Benjamin Lawrence,0,0,0,0
1653613736868,CSE 258,A01,090129,McAuley; Julian John,0,0,0,0
1653613737390,CSE 258R,A01,090131,McAuley; Julian John,0,0,0,0
1653613737925,CSE 274,A00,090132,Ramamoorthi; Ravi,0,0,0,0
1653613738447,CSE 276A,A00,090133,Christensen; Henrik I,0,0,0,0
1653613738969,CSE 276C,A00,090134,Christensen; Henrik I,0,0,0,0
1653613739503,CSE 290,A00,090135,Bafna; Vineet,0,0,0,0
1653613739503,CSE 290,B00,090136,Ramamoorthi; Ravi,0,0,0,0
1653613739503,CSE 290,C00,090137,Li; Tzumao,7,0,10,3
1653613739503,CSE 290,D00,090138,Zhou; Yuan-Yuan,9,0,10,1
1653613739503,CSE 290,E00,090139,Christensen; Henrik I,8,0,10,2
1653613739503,CSE 290,F00,094053,Shalev; Aaron D,0,0,0,0
1653613740031,CSE 291,A00,090140,Munyaka; Imani N. S.,0,0,0,0
1653613740031,CSE 291,B00,094880,Yu; Qi,0,0,0,0
1653613740031,CSE 291,C00,090142,Pannuto; Patrick William,0,0,0,0
1653613740031,CSE 291,D00,094881,Zhang; Yiying,0,0,0,0
1653613740031,CSE 291,E00,095118,Su; Hao,0,0,0,0
1653613740557,CSE 293,001,094905,Bafna; Vineet,9999,0,9999,0
1653613740557,CSE 293,002,094906,Bellare; Mihir,9999,0,9999,0
1653613740557,CSE 293,003,094907,Berg-Kirkpatrick; Taylor D,9999,0,9999,0
1653613740557,CSE 293,004,094908,Christensen; Henrik I,9999,0,9999,0
1653613740557,CSE 293,005,094909,Cottrell; Garrison W,9999,0,9999,0
1653613740557,CSE 293,006,094910,Deutsch; Alin Bernard,9999,0,9999,0
1653613740557,CSE 293,007,094911,Esmaeilzadeh; Hadi,9999,0,9999,0
1653613740557,CSE 293,008,094912,Freund; Yoav,9999,0,9999,0
1653613740557,CSE 293,009,094913,Griswold; William G.,9999,0,9999,0
1653613740557,CSE 293,010,094914,Gymrek; Melissa Ann,9999,0,9999,0
1653613740557,CSE 293,011,094915,Heninger; Nadia A,9999,0,9999,0
1653613740557,CSE 293,012,094916,Impagliazzo; Russell,9999,0,9999,0
1653613740557,CSE 293,013,094917,Jhala; Ranjit,9999,0,9999,0
1653613740557,CSE 293,014,094918,Kahng; Andrew Byun,9999,0,9999,0
1653613740557,CSE 293,015,094919,Kane; Daniel Mertz,9999,0,9999,0
1653613740557,CSE 293,016,094920,Kriegman; David J,9999,0,9999,0
1653613740557,CSE 293,017,094921,Kumar; Arun Kumar,9999,0,9999,0
1653613740557,CSE 293,018,094922,Lerner; Sorin,9999,0,9999,0
1653613740557,CSE 293,019,094923,Lovett; Shachar,9999,0,9999,0
1653613740557,CSE 293,020,094924,McAuley; Julian John,9999,0,9999,0
1653613740557,CSE 293,021,094925,Micciancio; Daniele,9999,0,9999,0
1653613740557,CSE 293,022,094926,Orailoglu; Alex,9999,0,9999,0
1653613740557,CSE 293,023,094927,Paturi; Ramamohan,9999,0,9999,0
1653613740557,CSE 293,024,094928,Polikarpova; Nadezhda,9999,0,9999,0
1653613740557,CSE 293,025,094929,Politz; Joseph Gibbs,9999,0,9999,0
1653613740557,CSE 293,026,094930,Porter; George M,9999,0,9999,0
1653613740557,CSE 293,027,094931,Porter; Leonard Emerson,9999,0,9999,0
1653613740557,CSE 293,028,094932,Ramamoorthi; Ravi,9999,0,9999,0
1653613740557,CSE 293,029,094933,Sahoo; Debashis,9999,0,9999,0
1653613740557,CSE 293,030,094934,Saul; Lawrence,9999,0,9999,0
1653613740557,CSE 293,031,094935,Savage; Stefan,9999,0,9999,0
1653613740557,CSE 293,032,094936,Schulze; Jurgen P.,9999,0,9999,0
1653613740557,CSE 293,033,094937,Snoeren; Alex C.,9999,0,9999,0
1653613740557,CSE 293,034,094938,Shang; Jingbo,9999,0,9999,0
1653613740557,CSE 293,035,094939,Stefan; Deian,9999,0,9999,0
1653613740557,CSE 293,036,094940,Su; Hao,9999,0,9999,0
1653613740557,CSE 293,037,094941,Swanson; Steven James,9999,0,9999,0
1653613740557,CSE 293,038,094942,Tullsen; Dean Michael,9999,0,9999,0
1653613740557,CSE 293,039,094943,Voelker; Geoffrey M.,9999,0,9999,0
1653613740557,CSE 293,040,094944,Zhao; Jishen,9999,0,9999,0
1653613740557,CSE 293,041,094945,Zhou; Yuan-Yuan,9999,0,9999,0
1653613740557,CSE 293,042,094946,Gao; Sicun,9998,0,9999,1
1653613740557,CSE 293,043,094947,Weibel; Nadir,9999,0,9999,0
1653613740557,CSE 293,044,094948,Gupta; Rajesh K.,9999,0,9999,0
1653613741084,CSE 294,A00,090143,Porter; George M,9,0,10,1
1653613741606,DSE 200,A00,091799,Staff,50,0,50,0
1653613742135,DSE 203,A00,091800,Gupta; Amarnath,30,0,30,0
1653613742669,DSE 250,A00,091801,Deutsch; Alin Bernard,30,0,30,0
1653613743194,DSE 290,A00,091802,Altintas De Callaf; Ilkay,50,0,50,0
1653613743743,ECE 200,001,091003,Antipa; Nicholas A,9999,0,9999,0
1653613743743,ECE 200,002,091004,Atanasov; Nikolay A.,9999,0,9999,0
1653613743743,ECE 200,003,091005,Bharadia; Dinesh,9999,0,9999,0
1653613743743,ECE 200,004,091006,Cheng; Chung Kuan,9999,0,9999,0
1653613743743,ECE 200,005,091007,Cosman; Pamela C.,9999,0,9999,0
1653613743743,ECE 200,006,091008,Staff,9999,0,9999,0
1653613743743,ECE 200,007,091009,Dayeh; Shadi Ahmad,9999,0,9999,0
1653613743743,ECE 200,008,091010,Fainman; Yeshaiahu,9999,0,9999,0
1653613743743,ECE 200,009,091011,Ford; Joseph Earl,9999,0,9999,0
1653613743743,ECE 200,010,091012,Franceschetti; Massimo,9999,0,9999,0
1653613743743,ECE 200,011,091013,Fullerton; Eric E,9999,0,9999,0
1653613743743,ECE 200,012,091014,Galton; Ian A,9999,0,9999,0
1653613743743,ECE 200,013,091015,Gilja; Vikash,9999,0,9999,0
1653613743743,ECE 200,014,091016,Hall; Drew A.,9999,0,9999,0
1653613743743,ECE 200,015,091017,Hsueh; Tzu-Chien,9999,0,9999,0
1653613743743,ECE 200,016,091018,Javidi; Tara,9999,0,9999,0
1653613743743,ECE 200,017,091019,Kahng; Andrew Byun,9999,0,9999,0
1653613743743,ECE 200,018,091020,Kim; Young-Han,9999,0,9999,0
1653613743743,ECE 200,019,091021,Koushanfar; Farinaz,9999,0,9999,0
1653613743743,ECE 200,020,091022,Kuzum; Duygu,9999,0,9999,0
1653613743743,ECE 200,021,091023,Le; Hanh-Phuc,9999,0,9999,0
1653613743743,ECE 200,022,091024,Lin; Bill,9999,0,9999,0
1653613743743,ECE 200,023,091025,Liu; Zhaowei,9999,0,9999,0
1653613743743,ECE 200,024,091026,Lo; Yu-Hwa,9999,0,9999,0
1653613743743,ECE 200,025,091027,Lomakin; Vitaliy,9999,0,9999,0
1653613743743,ECE 200,026,091028,Mercier; Patrick Philip,9999,0,9999,0
1653613743743,ECE 200,027,091029,Meyer; Florian,9999,0,9999,0
1653613743743,ECE 200,028,091030,Milstein; Laurence B.,9999,0,9999,0
1653613743743,ECE 200,029,091031,Mir Arabbaygi; Siavash,9999,0,9999,0
1653613743743,ECE 200,030,091032,Mookherjea; Shayan,9999,0,9999,0
1653613743743,ECE 200,031,091033,Morris; Karcher William,9999,0,9999,0
1653613743743,ECE 200,032,091034,Ng; Tse Nga,9999,0,9999,0
1653613743743,ECE 200,033,091035,Nguyen; Truong Quang,9999,0,9999,0
1653613743743,ECE 200,034,091036,Nomura; Kenji,9999,0,9999,0
1653613743743,ECE 200,035,091037,Orlitsky; Alon,9999,0,9999,0
1653613743743,ECE 200,036,091038,Pal; Piya,9999,0,9999,0
1653613743743,ECE 200,037,091039,Papen; George C.,9999,0,9999,0
1653613743743,ECE 200,038,091040,Radic; Stojan,9999,0,9999,0
1653613743743,ECE 200,039,091041,Rao; Bhaskar D.,9999,0,9999,0
1653613743743,ECE 200,040,091042,Rao; Ramesh R,9999,0,9999,0
1653613743743,ECE 200,041,091043,Rebeiz; Gabriel,9999,0,9999,0
1653613743743,ECE 200,042,091044,Sanford; John R,9999,0,9999,0
1653613743743,ECE 200,043,091045,Siegel; Paul H.,9999,0,9999,0
1653613743743,ECE 200,044,091046,Sievenpiper; Daniel F.,9999,0,9999,0
1653613743743,ECE 200,045,091047,Sworder; David D.,9999,0,9999,0
1653613743743,ECE 200,046,091048,Taur; Yuan,9999,0,9999,0
1653613743743,ECE 200,047,091049,Touri; Behrouz,9999,0,9999,0
1653613743743,ECE 200,048,091050,Trivedi; Mohan M.,9999,0,9999,0
1653613743743,ECE 200,049,091051,Vardy; Alexander,9999,0,9999,0
1653613743743,ECE 200,050,091052,Vasconcelos; Nuno,9999,0,9999,0
1653613743743,ECE 200,051,091053,Wang; Xiaolong,9999,0,9999,0
1653613743743,ECE 200,052,091054,Xie; Pengtao,9999,0,9999,0
1653613743743,ECE 200,053,091055,Yip; Michael,9999,0,9999,0
1653613743743,ECE 200,054,091056,Zeger; Kenneth A.,9999,0,9999,0
1653613743743,ECE 200,055,091057,Zhang; Xinyu,9999,0,9999,0
1653613743743,ECE 200,056,091058,Turakhia; Yatish Girish,9999,0,9999,0
1653613743743,ECE 200,057,091059,Kang; Mingu,9999,0,9999,0
1653613743743,ECE 200,058,091060,Shi; Yuanyuan,9999,0,9999,0
1653613743743,ECE 200,059,091061,Wang; Edward Jay,9999,0,9999,0
1653613743743,ECE 200,060,091062,Zheng; Yang,9999,0,9999,0
1653613744271,ECE 201,A00,095526,Lo; Yu-Hwa,0,0,0,0
1653613744795,ECE 203,A00,091065,Mercier; Patrick Philip,0,0,0,0
1653613745318,ECE 207A,A00,091605,Liu; Thomas Tao-Ming,0,0,0,0
1653613745843,ECE 212AN,A00,091068,Nomura; Kenji,0,0,0,0
1653613746369,ECE 222A,A00,091069,Rebeiz; Gabriel,0,0,0,0
1653613746894,ECE 225A,A00,091070,Orlitsky; Alon,0,0,0,0
1653613747418,ECE 230A,A00,091071,Nomura; Kenji,0,0,0,0
1653613747944,ECE 236A,A00,091072,Dayeh; Shadi Ahmad,0,0,0,0
1653613748467,ECE 238A,A00,091073,Luo; Jian,0,0,0,0
1653613748467,ECE 238A,B00,091074,Luo; Jian,0,0,0,0
1653613748990,ECE 240A,A00,091075,Radic; Stojan,0,0,0,0
1653613749523,ECE 247A,A00,091592,Shi; Lingyan,0,0,0,0
1653613750047,ECE 250,A00,091076,Touri; Behrouz,0,0,0,0
1653613750572,ECE 251C,A00,091078,Nguyen; Truong Quang,0,0,0,0
1653613751097,ECE 253,A00,091079,Cosman; Pamela C.,0,0,0,0
1653613751626,ECE 255A,A00,091080,Orlitsky; Alon,0,0,0,0
1653613752146,ECE 257A,A00,091081,Zhang; Xinyu,0,0,0,0
1653613752670,ECE 260A,A01,091084,Eldon; John,0,0,0,0
1653613753192,ECE 264C,A00,091085,Galton; Ian A,0,0,0,0
1653613753721,ECE 265C,A00,094889,Presti; Calogero Davide,0,0,0,9
1653613754242,ECE 266,A01,091087,Hall; Drew A.,0,0,0,0
1653613755320,ECE 271A,A00,091090,Vasconcelos; Nuno,0,0,0,0
1653613755841,ECE 272B,A00,091091,Sworder; David D.,0,0,0,0
1653613756364,ECE 275A,A00,091092,Meyer; Florian,0,0,0,0
1653613756900,ECE 277,A00,091093,An; Cheolhong,0,0,0,0
1653613757425,ECE 283,A00,091094,Le; Hanh-Phuc,0,0,0,0
1653613757959,ECE 284,A00,091095,Kang; Mingu,0,0,0,0
1653613757959,ECE 284,B00,091096,Wang; Edward Jay,0,0,0,0
1653613758486,ECE 285,A00,094334,Touri; Behrouz,0,0,0,0
1653613759014,ECE 289,A00,091097,Whelan; David Arthur,0,0,0,0
1653613759540,MATH 200A,A00,087414,Salehi Golsefidy; Alireza,7,0,8,1
1653613760063,MATH 202A,A00,087415,Gill; Philip E.,2,0,8,6
1653613760588,MATH 203A,A00,087416,Oprea; Dragos N.,6,0,8,2
1653613761117,MATH 204A,A00,087417,Kedlaya; Kiran S.,6,0,8,2
1653613761640,MATH 205,A00,087418,Sorensen; Claus M,6,0,8,2
1653613762167,MATH 206A,A00,087419,Izadi; Elham,7,0,8,1
1653613762692,MATH 207A,A00,087420,Mohammadi; Amir,5,0,8,3
1653613763214,MATH 208,A00,087421,Staff,9,0,10,1
1653613763736,MATH 209,A00,087422,Staff,10,0,10,0
1653613764264,MATH 218,A00,087423,Staff,10,0,10,0
1653613764789,MATH 220A,A00,087424,Novak; Jonathan I,6,0,8,2
1653613765317,MATH 231A,A00,087425,Bejenaru; Ioan,3,0,8,5
1653613765838,MATH 240A,A00,087426,Ebenfelt; Peter F,5,0,8,3
1653613766363,MATH 243,A00,087427,Staff,9,0,10,1
1653613766885,MATH 248,A00,087429,Staff,10,0,10,0
1653613767411,MATH 250A,A00,087430,Spolaor; Luca,4,0,8,4
1653613767936,MATH 257A,A00,087431,Spolaor; Luca,7,0,8,1
1653613768461,MATH 258,A00,087432,Staff,9,0,10,1
1653613768986,MATH 264A,A00,087433,Warnke; Lutz Peter,5,0,8,3
1653613769508,MATH 268,A00,087434,Staff,15,0,15,0
1653613770030,MATH 269,A00,087435,Staff,14,0,15,1
1653613770553,MATH 270A,A00,087436,Nie; Jiawang,0,0,8,8
1653613771077,MATH 272A,A00,087437,Tian; Xiaochuan,0,0,8,8
1653613771600,MATH 274,A01,087439,Cheng; Li-Tien,9,0,10,1
1653613771600,MATH 274,A02,087440,Cheng; Li-Tien,10,0,10,0
1653613772125,MATH 278A,A00,087441,Staff,8,0,10,2
1653613772652,MATH 278B,A00,087442,Staff,8,0,10,2
1653613773181,MATH 278C,A00,087443,Staff,8,0,10,2
1653613773712,MATH 280A,A00,087444,Zheng; Tianyi,0,0,8,8
1653613774236,MATH 281A,A00,087445,Bradic; Jelena,0,0,8,9
1653613774758,MATH 282A,A00,087446,Zhang; Danna,0,0,8,8
1653613775287,MATH 283,A00,087447,Tesler; Glenn,0,0,0,16
1653613775820,MATH 286,B00,095535,Kemp; Todd Aahron,5,0,8,3
1653613776341,MATH 287D,B00,095536,Bradic; Jelena,5,0,8,3
1653613776867,MATH 288,A00,087450,Staff,14,0,15,1
1653613776867,MATH 288,B00,087451,Staff,15,0,15,0
1653613776867,MATH 288,C00,087452,Staff,15,0,15,0
1653613777394,MATH 290A,A00,087453,Xu; Zhouli,6,0,8,2
1653613777919,MATH 291A,A00,087454,Xu; Zhouli,7,0,8,1
1653613778456,MATH 292,A00,087455,Staff,10,0,10,0
1653613778986,MATH 295,A00,087456,Staff,50,0,50,0
1653613779588,MATH 297,001,087457,Staff,997,0,999,2
1653614339356,COGS 200,A01,087991,Staff,47,0,50,3
1653614339882,COGS 201,A01,094504,Rangel; Lara M,16,0,25,9
1653614340411,COGS 203,A00,087992,Coulson; Seana M,18,0,20,2
1653614340940,COGS 210A,001,087993,Greene; Deanna Jacquelyn,9998,0,9999,1
1653614340940,COGS 210A,002,087994,Saygin; Ayse P,9999,0,9999,0
1653614340940,COGS 210A,003,087995,Xia; Haijun,9999,0,9999,0
1653614340940,COGS 210A,004,087996,Nitz; Douglas A.,9999,0,9999,0
1653614340940,COGS 210A,005,087997,Hollan; James D.,9999,0,9999,0
1653614340940,COGS 210A,006,087998,Deak; Gedeon O.,9998,0,9999,1
1653614340940,COGS 210A,007,087999,Rossano; Federico,9999,0,9999,0
1653614341468,COGS 211A,A00,088000,Coulson; Seana M,9997,0,9999,2
1653614341991,COGS 229,A00,088002,Staff,22,0,25,3
1653614342516,COGS 260,B00,094231,Staff,17,0,20,3
1653614342516,COGS 260,A00,088004,Nitz; Douglas A.,9998,0,9999,1
1653614343043,CSE 202,A00,090110,Paturi; Ramamohan,0,0,0,0
1653614343043,CSE 202,B00,090111,Paturi; Ramamohan,0,0,0,0
1653614343566,CSE 207B,A00,090112,Heninger; Nadia A,0,0,0,0
1653614344097,CSE 208,A00,094858,Micciancio; Daniele,0,0,0,0
1653614344623,CSE 210,A00,090113,Powell; Thomas Allan,0,0,0,0
1653614345146,CSE 219,A00,090898,Staff,0,0,0,0
1653614345686,CSE 221,A00,090114,Zhou; Yuan-Yuan,0,0,0,0
1653614346208,CSE 229A,A00,090115,Porter; George M,0,0,0,0
1653614346731,CSE 229C,A00,090116,Savage; Stefan,0,0,0,0
1653614347254,CSE 230,A00,090117,Jhala; Ranjit,0,0,0,0
1653614347783,CSE 232,A00,090118,Papakonstantinou; Yannis,0,0,0,0
1653614348308,CSE 239A,A00,090121,Kumar; Arun Kumar,0,0,0,0
1653614348841,CSE 239B,A00,090122,Jhala; Ranjit,0,0,0,0
1653614349364,CSE 240A,A00,090123,Zhao; Jishen,0,0,189,189
1653614349886,CSE 243A,A00,090124,Orailoglu; Alex,0,0,15,15
1653614350408,CSE 249B,A00,090125,Kahng; Andrew Byun,12,0,20,8
1653614350934,CSE 250A,A00,090126,Berg-Kirkpatrick; Taylor D,0,0,0,0
1653614351459,CSE 252A,A00,090127,Ochoa; Benjamin Lawrence,0,0,0,0
1653614351981,CSE 258,A01,090129,McAuley; Julian John,0,0,0,0
1653614352508,CSE 258R,A01,090131,McAuley; Julian John,0,0,0,0
1653614353031,CSE 274,A00,090132,Ramamoorthi; Ravi,0,0,0,0
1653614353554,CSE 276A,A00,090133,Christensen; Henrik I,0,0,0,0
1653614354083,CSE 276C,A00,090134,Christensen; Henrik I,0,0,0,0
1653614354619,CSE 290,A00,090135,Bafna; Vineet,0,0,0,0
1653614354619,CSE 290,B00,090136,Ramamoorthi; Ravi,0,0,0,0
1653614354619,CSE 290,C00,090137,Li; Tzumao,7,0,10,3
1653614354619,CSE 290,D00,090138,Zhou; Yuan-Yuan,9,0,10,1
1653614354619,CSE 290,E00,090139,Christensen; Henrik I,8,0,10,2
1653614354619,CSE 290,F00,094053,Shalev; Aaron D,0,0,0,0
1653614355146,CSE 291,A00,090140,Munyaka; Imani N. S.,0,0,0,0
1653614355146,CSE 291,B00,094880,Yu; Qi,0,0,0,0
1653614355146,CSE 291,C00,090142,Pannuto; Patrick William,0,0,0,0
1653614355146,CSE 291,D00,094881,Zhang; Yiying,0,0,0,0
1653614355146,CSE 291,E00,095118,Su; Hao,0,0,0,0
1653614355690,CSE 293,001,094905,Bafna; Vineet,9999,0,9999,0
1653614355690,CSE 293,002,094906,Bellare; Mihir,9999,0,9999,0
1653614355690,CSE 293,003,094907,Berg-Kirkpatrick; Taylor D,9999,0,9999,0
1653614355690,CSE 293,004,094908,Christensen; Henrik I,9999,0,9999,0
1653614355690,CSE 293,005,094909,Cottrell; Garrison W,9999,0,9999,0
1653614355690,CSE 293,006,094910,Deutsch; Alin Bernard,9999,0,9999,0
1653614355690,CSE 293,007,094911,Esmaeilzadeh; Hadi,9999,0,9999,0
1653614355690,CSE 293,008,094912,Freund; Yoav,9999,0,9999,0
1653614355690,CSE 293,009,094913,Griswold; William G.,9999,0,9999,0
1653614355690,CSE 293,010,094914,Gymrek; Melissa Ann,9999,0,9999,0
1653614355690,CSE 293,011,094915,Heninger; Nadia A,9999,0,9999,0
1653614355690,CSE 293,012,094916,Impagliazzo; Russell,9999,0,9999,0
1653614355690,CSE 293,013,094917,Jhala; Ranjit,9999,0,9999,0
1653614355690,CSE 293,014,094918,Kahng; Andrew Byun,9999,0,9999,0
1653614355690,CSE 293,015,094919,Kane; Daniel Mertz,9999,0,9999,0
1653614355690,CSE 293,016,094920,Kriegman; David J,9999,0,9999,0
1653614355690,CSE 293,017,094921,Kumar; Arun Kumar,9999,0,9999,0
1653614355690,CSE 293,018,094922,Lerner; Sorin,9999,0,9999,0
1653614355690,CSE 293,019,094923,Lovett; Shachar,9999,0,9999,0
1653614355690,CSE 293,020,094924,McAuley; Julian John,9999,0,9999,0
1653614355690,CSE 293,021,094925,Micciancio; Daniele,9999,0,9999,0
1653614355690,CSE 293,022,094926,Orailoglu; Alex,9999,0,9999,0
1653614355690,CSE 293,023,094927,Paturi; Ramamohan,9999,0,9999,0
1653614355690,CSE 293,024,094928,Polikarpova; Nadezhda,9999,0,9999,0
1653614355690,CSE 293,025,094929,Politz; Joseph Gibbs,9999,0,9999,0
1653614355690,CSE 293,026,094930,Porter; George M,9999,0,9999,0
1653614355690,CSE 293,027,094931,Porter; Leonard Emerson,9999,0,9999,0
1653614355690,CSE 293,028,094932,Ramamoorthi; Ravi,9999,0,9999,0
1653614355690,CSE 293,029,094933,Sahoo; Debashis,9999,0,9999,0
1653614355690,CSE 293,030,094934,Saul; Lawrence,9999,0,9999,0
1653614355690,CSE 293,031,094935,Savage; Stefan,9999,0,9999,0
1653614355690,CSE 293,032,094936,Schulze; Jurgen P.,9999,0,9999,0
1653614355690,CSE 293,033,094937,Snoeren; Alex C.,9999,0,9999,0
1653614355690,CSE 293,034,094938,Shang; Jingbo,9999,0,9999,0
1653614355690,CSE 293,035,094939,Stefan; Deian,9999,0,9999,0
1653614355690,CSE 293,036,094940,Su; Hao,9999,0,9999,0
1653614355690,CSE 293,037,094941,Swanson; Steven James,9999,0,9999,0
1653614355690,CSE 293,038,094942,Tullsen; Dean Michael,9999,0,9999,0
1653614355690,CSE 293,039,094943,Voelker; Geoffrey M.,9999,0,9999,0
1653614355690,CSE 293,040,094944,Zhao; Jishen,9999,0,9999,0
1653614355690,CSE 293,041,094945,Zhou; Yuan-Yuan,9999,0,9999,0
1653614355690,CSE 293,042,094946,Gao; Sicun,9998,0,9999,1
1653614355690,CSE 293,043,094947,Weibel; Nadir,9999,0,9999,0
1653614355690,CSE 293,044,094948,Gupta; Rajesh K.,9999,0,9999,0
1653614356212,CSE 294,A00,090143,Porter; George M,9,0,10,1
1653614356739,DSE 200,A00,091799,Staff,50,0,50,0
1653614357261,DSE 203,A00,091800,Gupta; Amarnath,30,0,30,0
1653614357786,DSE 250,A00,091801,Deutsch; Alin Bernard,30,0,30,0
1653614358309,DSE 290,A00,091802,Altintas De Callaf; Ilkay,50,0,50,0
1653614358854,ECE 200,001,091003,Antipa; Nicholas A,9999,0,9999,0
1653614358854,ECE 200,002,091004,Atanasov; Nikolay A.,9999,0,9999,0
1653614358854,ECE 200,003,091005,Bharadia; Dinesh,9999,0,9999,0
1653614358854,ECE 200,004,091006,Cheng; Chung Kuan,9999,0,9999,0
1653614358854,ECE 200,005,091007,Cosman; Pamela C.,9999,0,9999,0
1653614358854,ECE 200,006,091008,Staff,9999,0,9999,0
1653614358854,ECE 200,007,091009,Dayeh; Shadi Ahmad,9999,0,9999,0
1653614358854,ECE 200,008,091010,Fainman; Yeshaiahu,9999,0,9999,0
1653614358854,ECE 200,009,091011,Ford; Joseph Earl,9999,0,9999,0
1653614358854,ECE 200,010,091012,Franceschetti; Massimo,9999,0,9999,0
1653614358854,ECE 200,011,091013,Fullerton; Eric E,9999,0,9999,0
1653614358854,ECE 200,012,091014,Galton; Ian A,9999,0,9999,0
1653614358854,ECE 200,013,091015,Gilja; Vikash,9999,0,9999,0
1653614358854,ECE 200,014,091016,Hall; Drew A.,9999,0,9999,0
1653614358854,ECE 200,015,091017,Hsueh; Tzu-Chien,9999,0,9999,0
1653614358854,ECE 200,016,091018,Javidi; Tara,9999,0,9999,0
1653614358854,ECE 200,017,091019,Kahng; Andrew Byun,9999,0,9999,0
1653614358854,ECE 200,018,091020,Kim; Young-Han,9999,0,9999,0
1653614358854,ECE 200,019,091021,Koushanfar; Farinaz,9999,0,9999,0
1653614358854,ECE 200,020,091022,Kuzum; Duygu,9999,0,9999,0
1653614358854,ECE 200,021,091023,Le; Hanh-Phuc,9999,0,9999,0
1653614358854,ECE 200,022,091024,Lin; Bill,9999,0,9999,0
1653614358854,ECE 200,023,091025,Liu; Zhaowei,9999,0,9999,0
1653614358854,ECE 200,024,091026,Lo; Yu-Hwa,9999,0,9999,0
1653614358854,ECE 200,025,091027,Lomakin; Vitaliy,9999,0,9999,0
1653614358854,ECE 200,026,091028,Mercier; Patrick Philip,9999,0,9999,0
1653614358854,ECE 200,027,091029,Meyer; Florian,9999,0,9999,0
1653614358854,ECE 200,028,091030,Milstein; Laurence B.,9999,0,9999,0
1653614358854,ECE 200,029,091031,Mir Arabbaygi; Siavash,9999,0,9999,0
1653614358854,ECE 200,030,091032,Mookherjea; Shayan,9999,0,9999,0
1653614358854,ECE 200,031,091033,Morris; Karcher William,9999,0,9999,0
1653614358854,ECE 200,032,091034,Ng; Tse Nga,9999,0,9999,0
1653614358854,ECE 200,033,091035,Nguyen; Truong Quang,9999,0,9999,0
1653614358854,ECE 200,034,091036,Nomura; Kenji,9999,0,9999,0
1653614358854,ECE 200,035,091037,Orlitsky; Alon,9999,0,9999,0
1653614358854,ECE 200,036,091038,Pal; Piya,9999,0,9999,0
1653614358854,ECE 200,037,091039,Papen; George C.,9999,0,9999,0
1653614358854,ECE 200,038,091040,Radic; Stojan,9999,0,9999,0
1653614358854,ECE 200,039,091041,Rao; Bhaskar D.,9999,0,9999,0
1653614358854,ECE 200,040,091042,Rao; Ramesh R,9999,0,9999,0
1653614358854,ECE 200,041,091043,Rebeiz; Gabriel,9999,0,9999,0
1653614358854,ECE 200,042,091044,Sanford; John R,9999,0,9999,0
1653614358854,ECE 200,043,091045,Siegel; Paul H.,9999,0,9999,0
1653614358854,ECE 200,044,091046,Sievenpiper; Daniel F.,9999,0,9999,0
1653614358854,ECE 200,045,091047,Sworder; David D.,9999,0,9999,0
1653614358854,ECE 200,046,091048,Taur; Yuan,9999,0,9999,0
1653614358854,ECE 200,047,091049,Touri; Behrouz,9999,0,9999,0
1653614358854,ECE 200,048,091050,Trivedi; Mohan M.,9999,0,9999,0
1653614358854,ECE 200,049,091051,Vardy; Alexander,9999,0,9999,0
1653614358854,ECE 200,050,091052,Vasconcelos; Nuno,9999,0,9999,0
1653614358854,ECE 200,051,091053,Wang; Xiaolong,9999,0,9999,0
1653614358854,ECE 200,052,091054,Xie; Pengtao,9999,0,9999,0
1653614358854,ECE 200,053,091055,Yip; Michael,9999,0,9999,0
1653614358854,ECE 200,054,091056,Zeger; Kenneth A.,9999,0,9999,0
1653614358854,ECE 200,055,091057,Zhang; Xinyu,9999,0,9999,0
1653614358854,ECE 200,056,091058,Turakhia; Yatish Girish,9999,0,9999,0
1653614358854,ECE 200,057,091059,Kang; Mingu,9999,0,9999,0
1653614358854,ECE 200,058,091060,Shi; Yuanyuan,9999,0,9999,0
1653614358854,ECE 200,059,091061,Wang; Edward Jay,9999,0,9999,0
1653614358854,ECE 200,060,091062,Zheng; Yang,9999,0,9999,0
1653614359380,ECE 201,A00,095526,Lo; Yu-Hwa,0,0,0,0
1653614359905,ECE 203,A00,091065,Mercier; Patrick Philip,0,0,0,0
1653614360437,ECE 207A,A00,091605,Liu; Thomas Tao-Ming,0,0,0,0
1653614360967,ECE 212AN,A00,091068,Nomura; Kenji,0,0,0,0
1653614361491,ECE 222A,A00,091069,Rebeiz; Gabriel,0,0,0,0
1653614362015,ECE 225A,A00,091070,Orlitsky; Alon,0,0,0,0
1653614362538,ECE 230A,A00,091071,Nomura; Kenji,0,0,0,0
1653614363065,ECE 236A,A00,091072,Dayeh; Shadi Ahmad,0,0,0,0
1653614363590,ECE 238A,A00,091073,Luo; Jian,0,0,0,0
1653614363590,ECE 238A,B00,091074,Luo; Jian,0,0,0,0
1653614364118,ECE 240A,A00,091075,Radic; Stojan,0,0,0,0
1653614364650,ECE 247A,A00,091592,Shi; Lingyan,0,0,0,0
1653614365175,ECE 250,A00,091076,Touri; Behrouz,0,0,0,0
1653614365706,ECE 251C,A00,091078,Nguyen; Truong Quang,0,0,0,0
1653614366229,ECE 253,A00,091079,Cosman; Pamela C.,0,0,0,0
1653614366849,ECE 255A,A00,091080,Orlitsky; Alon,0,0,0,0
1653614367370,ECE 257A,A00,091081,Zhang; Xinyu,0,0,0,0
1653614367894,ECE 260A,A01,091084,Eldon; John,0,0,0,0
1653614368426,ECE 264C,A00,091085,Galton; Ian A,0,0,0,0
1653614368948,ECE 265C,A00,094889,Presti; Calogero Davide,0,0,0,9
1653614369471,ECE 266,A01,091087,Hall; Drew A.,0,0,0,0
1653614370527,ECE 271A,A00,091090,Vasconcelos; Nuno,0,0,0,0
1653614371052,ECE 272B,A00,091091,Sworder; David D.,0,0,0,0
1653614371575,ECE 275A,A00,091092,Meyer; Florian,0,0,0,0
1653614372105,ECE 277,A00,091093,An; Cheolhong,0,0,0,0
1653614372627,ECE 283,A00,091094,Le; Hanh-Phuc,0,0,0,0
1653614373153,ECE 284,A00,091095,Kang; Mingu,0,0,0,0
1653614373153,ECE 284,B00,091096,Wang; Edward Jay,0,0,0,0
1653614373682,ECE 285,A00,094334,Touri; Behrouz,0,0,0,0
1653614374205,ECE 289,A00,091097,Whelan; David Arthur,0,0,0,0
1653614374728,MATH 200A,A00,087414,Salehi Golsefidy; Alireza,7,0,8,1
1653614375254,MATH 202A,A00,087415,Gill; Philip E.,2,0,8,6
1653614375785,MATH 203A,A00,087416,Oprea; Dragos N.,6,0,8,2
1653614376309,MATH 204A,A00,087417,Kedlaya; Kiran S.,6,0,8,2
1653614376839,MATH 205,A00,087418,Sorensen; Claus M,6,0,8,2
1653614377364,MATH 206A,A00,087419,Izadi; Elham,7,0,8,1
1653614377886,MATH 207A,A00,087420,Mohammadi; Amir,5,0,8,3
1653614378410,MATH 208,A00,087421,Staff,9,0,10,1
1653614378942,MATH 209,A00,087422,Staff,10,0,10,0
1653614379466,MATH 218,A00,087423,Staff,10,0,10,0
1653614379990,MATH 220A,A00,087424,Novak; Jonathan I,6,0,8,2
1653614380516,MATH 231A,A00,087425,Bejenaru; Ioan,3,0,8,5
1653614381039,MATH 240A,A00,087426,Ebenfelt; Peter F,5,0,8,3
1653614381572,MATH 243,A00,087427,Staff,9,0,10,1
1653614382095,MATH 248,A00,087429,Staff,10,0,10,0
1653614382621,MATH 250A,A00,087430,Spolaor; Luca,4,0,8,4
1653614383144,MATH 257A,A00,087431,Spolaor; Luca,7,0,8,1
1653614383673,MATH 258,A00,087432,Staff,9,0,10,1
1653614384197,MATH 264A,A00,087433,Warnke; Lutz Peter,5,0,8,3
1653614384721,MATH 268,A00,087434,Staff,15,0,15,0
1653614385246,MATH 269,A00,087435,Staff,14,0,15,1
1653614385768,MATH 270A,A00,087436,Nie; Jiawang,0,0,8,8
1653614386289,MATH 272A,A00,087437,Tian; Xiaochuan,0,0,8,8
1653614386820,MATH 274,A01,087439,Cheng; Li-Tien,9,0,10,1
1653614386820,MATH 274,A02,087440,Cheng; Li-Tien,10,0,10,0
1653614387343,MATH 278A,A00,087441,Staff,8,0,10,2
1653614387868,MATH 278B,A00,087442,Staff,8,0,10,2
1653614388392,MATH 278C,A00,087443,Staff,8,0,10,2
1653614388914,MATH 280A,A00,087444,Zheng; Tianyi,0,0,8,8
1653614389438,MATH 281A,A00,087445,Bradic; Jelena,0,0,8,9
1653614389961,MATH 282A,A00,087446,Zhang; Danna,0,0,8,8
1653614390484,MATH 283,A00,087447,Tesler; Glenn,0,0,0,16
1653614391007,MATH 286,B00,095535,Kemp; Todd Aahron,5,0,8,3
1653614391539,MATH 287D,B00,095536,Bradic; Jelena,5,0,8,3
1653614392070,MATH 288,A00,087450,Staff,14,0,15,1
1653614392070,MATH 288,B00,087451,Staff,15,0,15,0
1653614392070,MATH 288,C00,087452,Staff,15,0,15,0
1653614392597,MATH 290A,A00,087453,Xu; Zhouli,6,0,8,2
1653614393128,MATH 291A,A00,087454,Xu; Zhouli,7,0,8,1
1653614393650,MATH 292,A00,087455,Staff,10,0,10,0
1653614394171,MATH 295,A00,087456,Staff,50,0,50,0
1653614394697,MATH 297,001,087457,Staff,997,0,999,2
1653614953933,COGS 200,A01,087991,Staff,47,0,50,3
1653614954455,COGS 201,A01,094504,Rangel; Lara M,16,0,25,9
1653614954980,COGS 203,A00,087992,Coulson; Seana M,18,0,20,2
1653614955536,COGS 210A,001,087993,Greene; Deanna Jacquelyn,9998,0,9999,1
1653614955536,COGS 210A,002,087994,Saygin; Ayse P,9999,0,9999,0
1653614955536,COGS 210A,003,087995,Xia; Haijun,9999,0,9999,0
1653614955536,COGS 210A,004,087996,Nitz; Douglas A.,9999,0,9999,0
1653614955536,COGS 210A,005,087997,Hollan; James D.,9999,0,9999,0
1653614955536,COGS 210A,006,087998,Deak; Gedeon O.,9998,0,9999,1
1653614955536,COGS 210A,007,087999,Rossano; Federico,9999,0,9999,0
1653614956062,COGS 211A,A00,088000,Coulson; Seana M,9997,0,9999,2
1653614956586,COGS 229,A00,088002,Staff,22,0,25,3
1653614957116,COGS 260,B00,094231,Staff,17,0,20,3
1653614957116,COGS 260,A00,088004,Nitz; Douglas A.,9998,0,9999,1
1653614957638,CSE 202,A00,090110,Paturi; Ramamohan,0,0,0,0
1653614957638,CSE 202,B00,090111,Paturi; Ramamohan,0,0,0,0
1653614958162,CSE 207B,A00,090112,Heninger; Nadia A,0,0,0,0
1653614958684,CSE 208,A00,094858,Micciancio; Daniele,0,0,0,0
1653614959206,CSE 210,A00,090113,Powell; Thomas Allan,0,0,0,0
1653614959729,CSE 219,A00,090898,Staff,0,0,0,0
1653614960251,CSE 221,A00,090114,Zhou; Yuan-Yuan,0,0,0,0
1653614960773,CSE 229A,A00,090115,Porter; George M,0,0,0,0
1653614961300,CSE 229C,A00,090116,Savage; Stefan,0,0,0,0
1653614961824,CSE 230,A00,090117,Jhala; Ranjit,0,0,0,0
1653614962349,CSE 232,A00,090118,Papakonstantinou; Yannis,0,0,0,0
1653614962871,CSE 239A,A00,090121,Kumar; Arun Kumar,0,0,0,0
1653614963403,CSE 239B,A00,090122,Jhala; Ranjit,0,0,0,0
1653614963936,CSE 240A,A00,090123,Zhao; Jishen,0,0,189,189
1653614964462,CSE 243A,A00,090124,Orailoglu; Alex,0,0,15,15
1653614964990,CSE 249B,A00,090125,Kahng; Andrew Byun,12,0,20,8
1653614965519,CSE 250A,A00,090126,Berg-Kirkpatrick; Taylor D,0,0,0,0
1653614966044,CSE 252A,A00,090127,Ochoa; Benjamin Lawrence,0,0,0,0
1653614966570,CSE 258,A01,090129,McAuley; Julian John,0,0,0,0
1653614967095,CSE 258R,A01,090131,McAuley; Julian John,0,0,0,0
1653614967617,CSE 274,A00,090132,Ramamoorthi; Ravi,0,0,0,0
1653614968143,CSE 276A,A00,090133,Christensen; Henrik I,0,0,0,0
1653614968665,CSE 276C,A00,090134,Christensen; Henrik I,0,0,0,0
1653614969189,CSE 290,A00,090135,Bafna; Vineet,0,0,0,0
1653614969189,CSE 290,B00,090136,Ramamoorthi; Ravi,0,0,0,0
1653614969189,CSE 290,C00,090137,Li; Tzumao,7,0,10,3
1653614969189,CSE 290,D00,090138,Zhou; Yuan-Yuan,9,0,10,1
1653614969189,CSE 290,E00,090139,Christensen; Henrik I,8,0,10,2
1653614969189,CSE 290,F00,094053,Shalev; Aaron D,0,0,0,0
1653614969717,CSE 291,A00,090140,Munyaka; Imani N. S.,0,0,0,0
1653614969717,CSE 291,B00,094880,Yu; Qi,0,0,0,0
1653614969717,CSE 291,C00,090142,Pannuto; Patrick William,0,0,0,0
1653614969717,CSE 291,D00,094881,Zhang; Yiying,0,0,0,0
1653614969717,CSE 291,E00,095118,Su; Hao,0,0,0,0
1653614970249,CSE 293,001,094905,Bafna; Vineet,9999,0,9999,0
1653614970249,CSE 293,002,094906,Bellare; Mihir,9999,0,9999,0
1653614970249,CSE 293,003,094907,Berg-Kirkpatrick; Taylor D,9999,0,9999,0
1653614970249,CSE 293,004,094908,Christensen; Henrik I,9999,0,9999,0
1653614970249,CSE 293,005,094909,Cottrell; Garrison W,9999,0,9999,0
1653614970249,CSE 293,006,094910,Deutsch; Alin Bernard,9999,0,9999,0
1653614970249,CSE 293,007,094911,Esmaeilzadeh; Hadi,9999,0,9999,0
1653614970249,CSE 293,008,094912,Freund; Yoav,9999,0,9999,0
1653614970249,CSE 293,009,094913,Griswold; William G.,9999,0,9999,0
1653614970249,CSE 293,010,094914,Gymrek; Melissa Ann,9999,0,9999,0
1653614970249,CSE 293,011,094915,Heninger; Nadia A,9999,0,9999,0
1653614970249,CSE 293,012,094916,Impagliazzo; Russell,9999,0,9999,0
1653614970249,CSE 293,013,094917,Jhala; Ranjit,9999,0,9999,0
1653614970249,CSE 293,014,094918,Kahng; Andrew Byun,9999,0,9999,0
1653614970249,CSE 293,015,094919,Kane; Daniel Mertz,9999,0,9999,0
1653614970249,CSE 293,016,094920,Kriegman; David J,9999,0,9999,0
1653614970249,CSE 293,017,094921,Kumar; Arun Kumar,9999,0,9999,0
1653614970249,CSE 293,018,094922,Lerner; Sorin,9999,0,9999,0
1653614970249,CSE 293,019,094923,Lovett; Shachar,9999,0,9999,0
1653614970249,CSE 293,020,094924,McAuley; Julian John,9999,0,9999,0
1653614970249,CSE 293,021,094925,Micciancio; Daniele,9999,0,9999,0
1653614970249,CSE 293,022,094926,Orailoglu; Alex,9999,0,9999,0
1653614970249,CSE 293,023,094927,Paturi; Ramamohan,9999,0,9999,0
1653614970249,CSE 293,024,094928,Polikarpova; Nadezhda,9999,0,9999,0
1653614970249,CSE 293,025,094929,Politz; Joseph Gibbs,9999,0,9999,0
1653614970249,CSE 293,026,094930,Porter; George M,9999,0,9999,0
1653614970249,CSE 293,027,094931,Porter; Leonard Emerson,9999,0,9999,0
1653614970249,CSE 293,028,094932,Ramamoorthi; Ravi,9999,0,9999,0
1653614970249,CSE 293,029,094933,Sahoo; Debashis,9999,0,9999,0
1653614970249,CSE 293,030,094934,Saul; Lawrence,9999,0,9999,0
1653614970249,CSE 293,031,094935,Savage; Stefan,9999,0,9999,0
1653614970249,CSE 293,032,094936,Schulze; Jurgen P.,9999,0,9999,0
1653614970249,CSE 293,033,094937,Snoeren; Alex C.,9999,0,9999,0
1653614970249,CSE 293,034,094938,Shang; Jingbo,9999,0,9999,0
1653614970249,CSE 293,035,094939,Stefan; Deian,9999,0,9999,0
1653614970249,CSE 293,036,094940,Su; Hao,9999,0,9999,0
1653614970249,CSE 293,037,094941,Swanson; Steven James,9999,0,9999,0
1653614970249,CSE 293,038,094942,Tullsen; Dean Michael,9999,0,9999,0
1653614970249,CSE 293,039,094943,Voelker; Geoffrey M.,9999,0,9999,0
1653614970249,CSE 293,040,094944,Zhao; Jishen,9999,0,9999,0
1653614970249,CSE 293,041,094945,Zhou; Yuan-Yuan,9999,0,9999,0
1653614970249,CSE 293,042,094946,Gao; Sicun,9998,0,9999,1
1653614970249,CSE 293,043,094947,Weibel; Nadir,9999,0,9999,0
1653614970249,CSE 293,044,094948,Gupta; Rajesh K.,9999,0,9999,0
1653614970774,CSE 294,A00,090143,Porter; George M,9,0,10,1
1653614971299,DSE 200,A00,091799,Staff,50,0,50,0
1653614971824,DSE 203,A00,091800,Gupta; Amarnath,30,0,30,0
1653614972346,DSE 250,A00,091801,Deutsch; Alin Bernard,30,0,30,0
1653614972868,DSE 290,A00,091802,Altintas De Callaf; Ilkay,50,0,50,0
1653614973394,ECE 200,001,091003,Antipa; Nicholas A,9999,0,9999,0
1653614973394,ECE 200,002,091004,Atanasov; Nikolay A.,9999,0,9999,0
1653614973394,ECE 200,003,091005,Bharadia; Dinesh,9999,0,9999,0
1653614973394,ECE 200,004,091006,Cheng; Chung Kuan,9999,0,9999,0
1653614973394,ECE 200,005,091007,Cosman; Pamela C.,9999,0,9999,0
1653614973394,ECE 200,006,091008,Staff,9999,0,9999,0
1653614973394,ECE 200,007,091009,Dayeh; Shadi Ahmad,9999,0,9999,0
1653614973394,ECE 200,008,091010,Fainman; Yeshaiahu,9999,0,9999,0
1653614973394,ECE 200,009,091011,Ford; Joseph Earl,9999,0,9999,0
1653614973394,ECE 200,010,091012,Franceschetti; Massimo,9999,0,9999,0
1653614973394,ECE 200,011,091013,Fullerton; Eric E,9999,0,9999,0
1653614973394,ECE 200,012,091014,Galton; Ian A,9999,0,9999,0
1653614973394,ECE 200,013,091015,Gilja; Vikash,9999,0,9999,0
1653614973394,ECE 200,014,091016,Hall; Drew A.,9999,0,9999,0
1653614973394,ECE 200,015,091017,Hsueh; Tzu-Chien,9999,0,9999,0
1653614973394,ECE 200,016,091018,Javidi; Tara,9999,0,9999,0
1653614973394,ECE 200,017,091019,Kahng; Andrew Byun,9999,0,9999,0
1653614973394,ECE 200,018,091020,Kim; Young-Han,9999,0,9999,0
1653614973394,ECE 200,019,091021,Koushanfar; Farinaz,9999,0,9999,0
1653614973394,ECE 200,020,091022,Kuzum; Duygu,9999,0,9999,0
1653614973394,ECE 200,021,091023,Le; Hanh-Phuc,9999,0,9999,0
1653614973394,ECE 200,022,091024,Lin; Bill,9999,0,9999,0
1653614973394,ECE 200,023,091025,Liu; Zhaowei,9999,0,9999,0
1653614973394,ECE 200,024,091026,Lo; Yu-Hwa,9999,0,9999,0
1653614973394,ECE 200,025,091027,Lomakin; Vitaliy,9999,0,9999,0
1653614973394,ECE 200,026,091028,Mercier; Patrick Philip,9999,0,9999,0
1653614973394,ECE 200,027,091029,Meyer; Florian,9999,0,9999,0
1653614973394,ECE 200,028,091030,Milstein; Laurence B.,9999,0,9999,0
1653614973394,ECE 200,029,091031,Mir Arabbaygi; Siavash,9999,0,9999,0
1653614973394,ECE 200,030,091032,Mookherjea; Shayan,9999,0,9999,0
1653614973394,ECE 200,031,091033,Morris; Karcher William,9999,0,9999,0
1653614973394,ECE 200,032,091034,Ng; Tse Nga,9999,0,9999,0
1653614973394,ECE 200,033,091035,Nguyen; Truong Quang,9999,0,9999,0
1653614973394,ECE 200,034,091036,Nomura; Kenji,9999,0,9999,0
1653614973394,ECE 200,035,091037,Orlitsky; Alon,9999,0,9999,0
1653614973394,ECE 200,036,091038,Pal; Piya,9999,0,9999,0
1653614973394,ECE 200,037,091039,Papen; George C.,9999,0,9999,0
1653614973394,ECE 200,038,091040,Radic; Stojan,9999,0,9999,0
1653614973394,ECE 200,039,091041,Rao; Bhaskar D.,9999,0,9999,0
1653614973394,ECE 200,040,091042,Rao; Ramesh R,9999,0,9999,0
1653614973394,ECE 200,041,091043,Rebeiz; Gabriel,9999,0,9999,0
1653614973394,ECE 200,042,091044,Sanford; John R,9999,0,9999,0
1653614973394,ECE 200,043,091045,Siegel; Paul H.,9999,0,9999,0
1653614973394,ECE 200,044,091046,Sievenpiper; Daniel F.,9999,0,9999,0
1653614973394,ECE 200,045,091047,Sworder; David D.,9999,0,9999,0
1653614973394,ECE 200,046,091048,Taur; Yuan,9999,0,9999,0
1653614973394,ECE 200,047,091049,Touri; Behrouz,9999,0,9999,0
1653614973394,ECE 200,048,091050,Trivedi; Mohan M.,9999,0,9999,0
1653614973394,ECE 200,049,091051,Vardy; Alexander,9999,0,9999,0
1653614973394,ECE 200,050,091052,Vasconcelos; Nuno,9999,0,9999,0
1653614973394,ECE 200,051,091053,Wang; Xiaolong,9999,0,9999,0
1653614973394,ECE 200,052,091054,Xie; Pengtao,9999,0,9999,0
1653614973394,ECE 200,053,091055,Yip; Michael,9999,0,9999,0
1653614973394,ECE 200,054,091056,Zeger; Kenneth A.,9999,0,9999,0
1653614973394,ECE 200,055,091057,Zhang; Xinyu,9999,0,9999,0
1653614973394,ECE 200,056,091058,Turakhia; Yatish Girish,9999,0,9999,0
1653614973394,ECE 200,057,091059,Kang; Mingu,9999,0,9999,0
1653614973394,ECE 200,058,091060,Shi; Yuanyuan,9999,0,9999,0
1653614973394,ECE 200,059,091061,Wang; Edward Jay,9999,0,9999,0
1653614973394,ECE 200,060,091062,Zheng; Yang,9999,0,9999,0
1653614973916,ECE 201,A00,095526,Lo; Yu-Hwa,0,0,0,0
1653614974442,ECE 203,A00,091065,Mercier; Patrick Philip,0,0,0,0
1653614974978,ECE 207A,A00,091605,Liu; Thomas Tao-Ming,0,0,0,0
1653614975503,ECE 212AN,A00,091068,Nomura; Kenji,0,0,0,0
1653614976027,ECE 222A,A00,091069,Rebeiz; Gabriel,0,0,0,0
1653614976552,ECE 225A,A00,091070,Orlitsky; Alon,0,0,0,0
1653614977078,ECE 230A,A00,091071,Nomura; Kenji,0,0,0,0
1653614977620,ECE 236A,A00,091072,Dayeh; Shadi Ahmad,0,0,0,0
1653614978147,ECE 238A,A00,091073,Luo; Jian,0,0,0,0
1653614978147,ECE 238A,B00,091074,Luo; Jian,0,0,0,0
1653614978680,ECE 240A,A00,091075,Radic; Stojan,0,0,0,0
1653614979218,ECE 247A,A00,091592,Shi; Lingyan,0,0,0,0
1653614979741,ECE 250,A00,091076,Touri; Behrouz,0,0,0,0
1653614980268,ECE 251C,A00,091078,Nguyen; Truong Quang,0,0,0,0
1653614980792,ECE 253,A00,091079,Cosman; Pamela C.,0,0,0,0
1653614981323,ECE 255A,A00,091080,Orlitsky; Alon,0,0,0,0
1653614981848,ECE 257A,A00,091081,Zhang; Xinyu,0,0,0,0
1653614982373,ECE 260A,A01,091084,Eldon; John,0,0,0,0
1653614982896,ECE 264C,A00,091085,Galton; Ian A,0,0,0,0
1653614983420,ECE 265C,A00,094889,Presti; Calogero Davide,0,0,0,9
1653614983947,ECE 266,A01,091087,Hall; Drew A.,0,0,0,0
1653614984994,ECE 271A,A00,091090,Vasconcelos; Nuno,0,0,0,0
1653614985516,ECE 272B,A00,091091,Sworder; David D.,0,0,0,0
1653614986040,ECE 275A,A00,091092,Meyer; Florian,0,0,0,0
1653614986569,ECE 277,A00,091093,An; Cheolhong,0,0,0,0
1653614987099,ECE 283,A00,091094,Le; Hanh-Phuc,0,0,0,0
1653614987627,ECE 284,A00,091095,Kang; Mingu,0,0,0,0
1653614987627,ECE 284,B00,091096,Wang; Edward Jay,0,0,0,0
1653614988148,ECE 285,A00,094334,Touri; Behrouz,0,0,0,0
1653614988685,ECE 289,A00,091097,Whelan; David Arthur,0,0,0,0
1653614989215,MATH 200A,A00,087414,Salehi Golsefidy; Alireza,7,0,8,1
1653614989737,MATH 202A,A00,087415,Gill; Philip E.,2,0,8,6
1653614990263,MATH 203A,A00,087416,Oprea; Dragos N.,6,0,8,2
1653614990786,MATH 204A,A00,087417,Kedlaya; Kiran S.,6,0,8,2
1653614991321,MATH 205,A00,087418,Sorensen; Claus M,6,0,8,2
1653614991857,MATH 206A,A00,087419,Izadi; Elham,7,0,8,1
1653614992379,MATH 207A,A00,087420,Mohammadi; Amir,5,0,8,3
1653614992904,MATH 208,A00,087421,Staff,9,0,10,1
1653614993431,MATH 209,A00,087422,Staff,10,0,10,0
1653614993954,MATH 218,A00,087423,Staff,10,0,10,0
1653614994475,MATH 220A,A00,087424,Novak; Jonathan I,6,0,8,2
1653614995002,MATH 231A,A00,087425,Bejenaru; Ioan,3,0,8,5
1653614995525,MATH 240A,A00,087426,Ebenfelt; Peter F,5,0,8,3
1653614996048,MATH 243,A00,087427,Staff,9,0,10,1
1653614996574,MATH 248,A00,087429,Staff,10,0,10,0
1653614997099,MATH 250A,A00,087430,Spolaor; Luca,4,0,8,4
1653614997625,MATH 257A,A00,087431,Spolaor; Luca,7,0,8,1
1653614998150,MATH 258,A00,087432,Staff,9,0,10,1
1653614998673,MATH 264A,A00,087433,Warnke; Lutz Peter,5,0,8,3
1653614999196,MATH 268,A00,087434,Staff,15,0,15,0
1653614999719,MATH 269,A00,087435,Staff,14,0,15,1
1653615000241,MATH 270A,A00,087436,Nie; Jiawang,0,0,8,8
1653615000768,MATH 272A,A00,087437,Tian; Xiaochuan,0,0,8,8
1653615001294,MATH 274,A01,087439,Cheng; Li-Tien,9,0,10,1
1653615001294,MATH 274,A02,087440,Cheng; Li-Tien,10,0,10,0
1653615001818,MATH 278A,A00,087441,Staff,8,0,10,2
1653615002341,MATH 278B,A00,087442,Staff,8,0,10,2
1653615002867,MATH 278C,A00,087443,Staff,8,0,10,2
1653615003394,MATH 280A,A00,087444,Zheng; Tianyi,0,0,8,8
1653615003917,MATH 281A,A00,087445,Bradic; Jelena,0,0,8,9
1653615004445,MATH 282A,A00,087446,Zhang; Danna,0,0,8,8
1653615004971,MATH 283,A00,087447,Tesler; Glenn,0,0,0,16
1653615005501,MATH 286,B00,095535,Kemp; Todd Aahron,5,0,8,3
1653615006023,MATH 287D,B00,095536,Bradic; Jelena,5,0,8,3
1653615006627,MATH 288,A00,087450,Staff,14,0,15,1
1653615006627,MATH 288,B00,087451,Staff,15,0,15,0
1653615006627,MATH 288,C00,087452,Staff,15,0,15,0
1653615007157,MATH 290A,A00,087453,Xu; Zhouli,6,0,8,2
1653615007682,MATH 291A,A00,087454,Xu; Zhouli,7,0,8,1
1653615008204,MATH 292,A00,087455,Staff,10,0,10,0
1653615008726,MATH 295,A00,087456,Staff,50,0,50,0
1653615009251,MATH 297,001,087457,Staff,997,0,999,2
1653615568618,COGS 200,A01,087991,Staff,47,0,50,3
1653615569144,COGS 201,A01,094504,Rangel; Lara M,16,0,25,9
1653615569667,COGS 203,A00,087992,Coulson; Seana M,18,0,20,2
1653615570198,COGS 210A,001,087993,Greene; Deanna Jacquelyn,9998,0,9999,1
1653615570198,COGS 210A,002,087994,Saygin; Ayse P,9999,0,9999,0
1653615570198,COGS 210A,003,087995,Xia; Haijun,9999,0,9999,0
1653615570198,COGS 210A,004,087996,Nitz; Douglas A.,9999,0,9999,0
1653615570198,COGS 210A,005,087997,Hollan; James D.,9999,0,9999,0
1653615570198,COGS 210A,006,087998,Deak; Gedeon O.,9998,0,9999,1
1653615570198,COGS 210A,007,087999,Rossano; Federico,9999,0,9999,0
1653615570723,COGS 211A,A00,088000,Coulson; Seana M,9997,0,9999,2
1653615571248,COGS 229,A00,088002,Staff,22,0,25,3
1653615571774,COGS 260,B00,094231,Staff,17,0,20,3
1653615571774,COGS 260,A00,088004,Nitz; Douglas A.,9998,0,9999,1
1653615572302,CSE 202,A00,090110,Paturi; Ramamohan,0,0,0,0
1653615572302,CSE 202,B00,090111,Paturi; Ramamohan,0,0,0,0
1653615572827,CSE 207B,A00,090112,Heninger; Nadia A,0,0,0,0
1653615573350,CSE 208,A00,094858,Micciancio; Daniele,0,0,0,0
1653615573875,CSE 210,A00,090113,Powell; Thomas Allan,0,0,0,0
1653615574405,CSE 219,A00,090898,Staff,0,0,0,0
1653615574939,CSE 221,A00,090114,Zhou; Yuan-Yuan,0,0,0,0
1653615575462,CSE 229A,A00,090115,Porter; George M,0,0,0,0
1653615575985,CSE 229C,A00,090116,Savage; Stefan,0,0,0,0
1653615576511,CSE 230,A00,090117,Jhala; Ranjit,0,0,0,0
1653615577034,CSE 232,A00,090118,Papakonstantinou; Yannis,0,0,0,0
1653615577569,CSE 239A,A00,090121,Kumar; Arun Kumar,0,0,0,0
1653615578096,CSE 239B,A00,090122,Jhala; Ranjit,0,0,0,0
1653615578618,CSE 240A,A00,090123,Zhao; Jishen,0,0,189,189
1653615579151,CSE 243A,A00,090124,Orailoglu; Alex,0,0,15,15
1653615579681,CSE 249B,A00,090125,Kahng; Andrew Byun,12,0,20,8
1653615580207,CSE 250A,A00,090126,Berg-Kirkpatrick; Taylor D,0,0,0,0
1653615580729,CSE 252A,A00,090127,Ochoa; Benjamin Lawrence,0,0,0,0
1653615581261,CSE 258,A01,090129,McAuley; Julian John,0,0,0,0
1653615581788,CSE 258R,A01,090131,McAuley; Julian John,0,0,0,0
1653615582309,CSE 274,A00,090132,Ramamoorthi; Ravi,0,0,0,0
1653615582834,CSE 276A,A00,090133,Christensen; Henrik I,0,0,0,0
1653615583357,CSE 276C,A00,090134,Christensen; Henrik I,0,0,0,0
1653615583883,CSE 290,A00,090135,Bafna; Vineet,0,0,0,0
1653615583883,CSE 290,B00,090136,Ramamoorthi; Ravi,0,0,0,0
1653615583883,CSE 290,C00,090137,Li; Tzumao,7,0,10,3
1653615583883,CSE 290,D00,090138,Zhou; Yuan-Yuan,9,0,10,1
1653615583883,CSE 290,E00,090139,Christensen; Henrik I,8,0,10,2
1653615583883,CSE 290,F00,094053,Shalev; Aaron D,0,0,0,0
1653615584407,CSE 291,A00,090140,Munyaka; Imani N. S.,0,0,0,0
1653615584407,CSE 291,B00,094880,Yu; Qi,0,0,0,0
1653615584407,CSE 291,C00,090142,Pannuto; Patrick William,0,0,0,0
1653615584407,CSE 291,D00,094881,Zhang; Yiying,0,0,0,0
1653615584407,CSE 291,E00,095118,Su; Hao,0,0,0,0
1653615584939,CSE 293,001,094905,Bafna; Vineet,9999,0,9999,0
1653615584939,CSE 293,002,094906,Bellare; Mihir,9999,0,9999,0
1653615584939,CSE 293,003,094907,Berg-Kirkpatrick; Taylor D,9999,0,9999,0
1653615584939,CSE 293,004,094908,Christensen; Henrik I,9999,0,9999,0
1653615584939,CSE 293,005,094909,Cottrell; Garrison W,9999,0,9999,0
1653615584939,CSE 293,006,094910,Deutsch; Alin Bernard,9999,0,9999,0
1653615584939,CSE 293,007,094911,Esmaeilzadeh; Hadi,9999,0,9999,0
1653615584939,CSE 293,008,094912,Freund; Yoav,9999,0,9999,0
1653615584939,CSE 293,009,094913,Griswold; William G.,9999,0,9999,0
1653615584939,CSE 293,010,094914,Gymrek; Melissa Ann,9999,0,9999,0
1653615584939,CSE 293,011,094915,Heninger; Nadia A,9999,0,9999,0
1653615584939,CSE 293,012,094916,Impagliazzo; Russell,9999,0,9999,0
1653615584939,CSE 293,013,094917,Jhala; Ranjit,9999,0,9999,0
1653615584939,CSE 293,014,094918,Kahng; Andrew Byun,9999,0,9999,0
1653615584939,CSE 293,015,094919,Kane; Daniel Mertz,9999,0,9999,0
1653615584939,CSE 293,016,094920,Kriegman; David J,9999,0,9999,0
1653615584939,CSE 293,017,094921,Kumar; Arun Kumar,9999,0,9999,0
1653615584939,CSE 293,018,094922,Lerner; Sorin,9999,0,9999,0
1653615584939,CSE 293,019,094923,Lovett; Shachar,9999,0,9999,0
1653615584939,CSE 293,020,094924,McAuley; Julian John,9999,0,9999,0
1653615584939,CSE 293,021,094925,Micciancio; Daniele,9999,0,9999,0
1653615584939,CSE 293,022,094926,Orailoglu; Alex,9999,0,9999,0
1653615584939,CSE 293,023,094927,Paturi; Ramamohan,9999,0,9999,0
1653615584939,CSE 293,024,094928,Polikarpova; Nadezhda,9999,0,9999,0
1653615584939,CSE 293,025,094929,Politz; Joseph Gibbs,9999,0,9999,0
1653615584939,CSE 293,026,094930,Porter; George M,9999,0,9999,0
1653615584939,CSE 293,027,094931,Porter; Leonard Emerson,9999,0,9999,0
1653615584939,CSE 293,028,094932,Ramamoorthi; Ravi,9999,0,9999,0
1653615584939,CSE 293,029,094933,Sahoo; Debashis,9999,0,9999,0
1653615584939,CSE 293,030,094934,Saul; Lawrence,9999,0,9999,0
1653615584939,CSE 293,031,094935,Savage; Stefan,9999,0,9999,0
1653615584939,CSE 293,032,094936,Schulze; Jurgen P.,9999,0,9999,0
1653615584939,CSE 293,033,094937,Snoeren; Alex C.,9999,0,9999,0
1653615584939,CSE 293,034,094938,Shang; Jingbo,9999,0,9999,0
1653615584939,CSE 293,035,094939,Stefan; Deian,9999,0,9999,0
1653615584939,CSE 293,036,094940,Su; Hao,9999,0,9999,0
1653615584939,CSE 293,037,094941,Swanson; Steven James,9999,0,9999,0
1653615584939,CSE 293,038,094942,Tullsen; Dean Michael,9999,0,9999,0
1653615584939,CSE 293,039,094943,Voelker; Geoffrey M.,9999,0,9999,0
1653615584939,CSE 293,040,094944,Zhao; Jishen,9999,0,9999,0
1653615584939,CSE 293,041,094945,Zhou; Yuan-Yuan,9999,0,9999,0
1653615584939,CSE 293,042,094946,Gao; Sicun,9998,0,9999,1
1653615584939,CSE 293,043,094947,Weibel; Nadir,9999,0,9999,0
1653615584939,CSE 293,044,094948,Gupta; Rajesh K.,9999,0,9999,0
1653615585476,CSE 294,A00,090143,Porter; George M,9,0,10,1
1653615586003,DSE 200,A00,091799,Staff,50,0,50,0
1653615586526,DSE 203,A00,091800,Gupta; Amarnath,30,0,30,0
1653615587055,DSE 250,A00,091801,Deutsch; Alin Bernard,30,0,30,0
1653615587580,DSE 290,A00,091802,Altintas De Callaf; Ilkay,50,0,50,0
1653615588114,ECE 200,001,091003,Antipa; Nicholas A,9999,0,9999,0
1653615588114,ECE 200,002,091004,Atanasov; Nikolay A.,9999,0,9999,0
1653615588114,ECE 200,003,091005,Bharadia; Dinesh,9999,0,9999,0
1653615588114,ECE 200,004,091006,Cheng; Chung Kuan,9999,0,9999,0
1653615588114,ECE 200,005,091007,Cosman; Pamela C.,9999,0,9999,0
1653615588114,ECE 200,006,091008,Staff,9999,0,9999,0
1653615588114,ECE 200,007,091009,Dayeh; Shadi Ahmad,9999,0,9999,0
1653615588114,ECE 200,008,091010,Fainman; Yeshaiahu,9999,0,9999,0
1653615588114,ECE 200,009,091011,Ford; Joseph Earl,9999,0,9999,0
1653615588114,ECE 200,010,091012,Franceschetti; Massimo,9999,0,9999,0
1653615588114,ECE 200,011,091013,Fullerton; Eric E,9999,0,9999,0
1653615588114,ECE 200,012,091014,Galton; Ian A,9999,0,9999,0
1653615588114,ECE 200,013,091015,Gilja; Vikash,9999,0,9999,0
1653615588114,ECE 200,014,091016,Hall; Drew A.,9999,0,9999,0
1653615588114,ECE 200,015,091017,Hsueh; Tzu-Chien,9999,0,9999,0
1653615588114,ECE 200,016,091018,Javidi; Tara,9999,0,9999,0
1653615588114,ECE 200,017,091019,Kahng; Andrew Byun,9999,0,9999,0
1653615588114,ECE 200,018,091020,Kim; Young-Han,9999,0,9999,0
1653615588114,ECE 200,019,091021,Koushanfar; Farinaz,9999,0,9999,0
1653615588114,ECE 200,020,091022,Kuzum; Duygu,9999,0,9999,0
1653615588114,ECE 200,021,091023,Le; Hanh-Phuc,9999,0,9999,0
1653615588114,ECE 200,022,091024,Lin; Bill,9999,0,9999,0
1653615588114,ECE 200,023,091025,Liu; Zhaowei,9999,0,9999,0
1653615588114,ECE 200,024,091026,Lo; Yu-Hwa,9999,0,9999,0
1653615588114,ECE 200,025,091027,Lomakin; Vitaliy,9999,0,9999,0
1653615588114,ECE 200,026,091028,Mercier; Patrick Philip,9999,0,9999,0
1653615588114,ECE 200,027,091029,Meyer; Florian,9999,0,9999,0
1653615588114,ECE 200,028,091030,Milstein; Laurence B.,9999,0,9999,0
1653615588114,ECE 200,029,091031,Mir Arabbaygi; Siavash,9999,0,9999,0
1653615588114,ECE 200,030,091032,Mookherjea; Shayan,9999,0,9999,0
1653615588114,ECE 200,031,091033,Morris; Karcher William,9999,0,9999,0
1653615588114,ECE 200,032,091034,Ng; Tse Nga,9999,0,9999,0
1653615588114,ECE 200,033,091035,Nguyen; Truong Quang,9999,0,9999,0
1653615588114,ECE 200,034,091036,Nomura; Kenji,9999,0,9999,0
1653615588114,ECE 200,035,091037,Orlitsky; Alon,9999,0,9999,0
1653615588114,ECE 200,036,091038,Pal; Piya,9999,0,9999,0
1653615588114,ECE 200,037,091039,Papen; George C.,9999,0,9999,0
1653615588114,ECE 200,038,091040,Radic; Stojan,9999,0,9999,0
1653615588114,ECE 200,039,091041,Rao; Bhaskar D.,9999,0,9999,0
1653615588114,ECE 200,040,091042,Rao; Ramesh R,9999,0,9999,0
1653615588114,ECE 200,041,091043,Rebeiz; Gabriel,9999,0,9999,0
1653615588114,ECE 200,042,091044,Sanford; John R,9999,0,9999,0
1653615588114,ECE 200,043,091045,Siegel; Paul H.,9999,0,9999,0
1653615588114,ECE 200,044,091046,Sievenpiper; Daniel F.,9999,0,9999,0
1653615588114,ECE 200,045,091047,Sworder; David D.,9999,0,9999,0
1653615588114,ECE 200,046,091048,Taur; Yuan,9999,0,9999,0
1653615588114,ECE 200,047,091049,Touri; Behrouz,9999,0,9999,0
1653615588114,ECE 200,048,091050,Trivedi; Mohan M.,9999,0,9999,0
1653615588114,ECE 200,049,091051,Vardy; Alexander,9999,0,9999,0
1653615588114,ECE 200,050,091052,Vasconcelos; Nuno,9999,0,9999,0
1653615588114,ECE 200,051,091053,Wang; Xiaolong,9999,0,9999,0
1653615588114,ECE 200,052,091054,Xie; Pengtao,9999,0,9999,0
1653615588114,ECE 200,053,091055,Yip; Michael,9999,0,9999,0
1653615588114,ECE 200,054,091056,Zeger; Kenneth A.,9999,0,9999,0
1653615588114,ECE 200,055,091057,Zhang; Xinyu,9999,0,9999,0
1653615588114,ECE 200,056,091058,Turakhia; Yatish Girish,9999,0,9999,0
1653615588114,ECE 200,057,091059,Kang; Mingu,9999,0,9999,0
1653615588114,ECE 200,058,091060,Shi; Yuanyuan,9999,0,9999,0
1653615588114,ECE 200,059,091061,Wang; Edward Jay,9999,0,9999,0
1653615588114,ECE 200,060,091062,Zheng; Yang,9999,0,9999,0
1653615588637,ECE 201,A00,095526,Lo; Yu-Hwa,0,0,0,0
1653615589162,ECE 203,A00,091065,Mercier; Patrick Philip,0,0,0,0
1653615589693,ECE 207A,A00,091605,Liu; Thomas Tao-Ming,0,0,0,0
1653615590216,ECE 212AN,A00,091068,Nomura; Kenji,0,0,0,0
1653615590743,ECE 222A,A00,091069,Rebeiz; Gabriel,0,0,0,0
1653615591270,ECE 225A,A00,091070,Orlitsky; Alon,0,0,0,0
1653615591795,ECE 230A,A00,091071,Nomura; Kenji,0,0,0,0
1653615592318,ECE 236A,A00,091072,Dayeh; Shadi Ahmad,0,0,0,0
1653615592841,ECE 238A,A00,091073,Luo; Jian,0,0,0,0
1653615592841,ECE 238A,B00,091074,Luo; Jian,0,0,0,0
1653615593439,ECE 240A,A00,091075,Radic; Stojan,0,0,0,0
1653615593963,ECE 247A,A00,091592,Shi; Lingyan,0,0,0,0
1653615594489,ECE 250,A00,091076,Touri; Behrouz,0,0,0,0
1653615595012,ECE 251C,A00,091078,Nguyen; Truong Quang,0,0,0,0
1653615595535,ECE 253,A00,091079,Cosman; Pamela C.,0,0,0,0
1653615596059,ECE 255A,A00,091080,Orlitsky; Alon,0,0,0,0
1653615596588,ECE 257A,A00,091081,Zhang; Xinyu,0,0,0,0
1653615597120,ECE 260A,A01,091084,Eldon; John,0,0,0,0
1653615597655,ECE 264C,A00,091085,Galton; Ian A,0,0,0,0
1653615598178,ECE 265C,A00,094889,Presti; Calogero Davide,0,0,0,9
1653615598712,ECE 266,A01,091087,Hall; Drew A.,0,0,0,0
1653615599757,ECE 271A,A00,091090,Vasconcelos; Nuno,0,0,0,0
1653615600282,ECE 272B,A00,091091,Sworder; David D.,0,0,0,0
1653615600804,ECE 275A,A00,091092,Meyer; Florian,0,0,0,0
1653615601341,ECE 277,A00,091093,An; Cheolhong,0,0,0,0
1653615601866,ECE 283,A00,091094,Le; Hanh-Phuc,0,0,0,0
1653615602392,ECE 284,A00,091095,Kang; Mingu,0,0,0,0
1653615602392,ECE 284,B00,091096,Wang; Edward Jay,0,0,0,0
1653615602915,ECE 285,A00,094334,Touri; Behrouz,0,0,0,0
1653615603437,ECE 289,A00,091097,Whelan; David Arthur,0,0,0,0
1653615603960,MATH 200A,A00,087414,Salehi Golsefidy; Alireza,7,0,8,1
1653615604488,MATH 202A,A00,087415,Gill; Philip E.,2,0,8,6
1653615605012,MATH 203A,A00,087416,Oprea; Dragos N.,6,0,8,2
1653615605541,MATH 204A,A00,087417,Kedlaya; Kiran S.,6,0,8,2
1653615606064,MATH 205,A00,087418,Sorensen; Claus M,6,0,8,2
1653615606588,MATH 206A,A00,087419,Izadi; Elham,7,0,8,1
1653615607114,MATH 207A,A00,087420,Mohammadi; Amir,5,0,8,3
1653615607639,MATH 208,A00,087421,Staff,9,0,10,1
1653615608162,MATH 209,A00,087422,Staff,10,0,10,0
1653615608684,MATH 218,A00,087423,Staff,10,0,10,0
1653615609208,MATH 220A,A00,087424,Novak; Jonathan I,6,0,8,2
1653615609731,MATH 231A,A00,087425,Bejenaru; Ioan,3,0,8,5
1653615610261,MATH 240A,A00,087426,Ebenfelt; Peter F,5,0,8,3
1653615610783,MATH 243,A00,087427,Staff,9,0,10,1
1653615611306,MATH 248,A00,087429,Staff,10,0,10,0
1653615611836,MATH 250A,A00,087430,Spolaor; Luca,4,0,8,4
1653615612359,MATH 257A,A00,087431,Spolaor; Luca,7,0,8,1
1653615612891,MATH 258,A00,087432,Staff,9,0,10,1
1653615613422,MATH 264A,A00,087433,Warnke; Lutz Peter,5,0,8,3
1653615613947,MATH 268,A00,087434,Staff,15,0,15,0
1653615614479,MATH 269,A00,087435,Staff,14,0,15,1
1653615615003,MATH 270A,A00,087436,Nie; Jiawang,0,0,8,8
1653615615526,MATH 272A,A00,087437,Tian; Xiaochuan,0,0,8,8
1653615616062,MATH 274,A01,087439,Cheng; Li-Tien,9,0,10,1
1653615616062,MATH 274,A02,087440,Cheng; Li-Tien,10,0,10,0
1653615616585,MATH 278A,A00,087441,Staff,8,0,10,2
1653615617107,MATH 278B,A00,087442,Staff,8,0,10,2
1653615617632,MATH 278C,A00,087443,Staff,8,0,10,2
1653615618157,MATH 280A,A00,087444,Zheng; Tianyi,0,0,8,8
1653615618679,MATH 281A,A00,087445,Bradic; Jelena,0,0,8,9
1653615619203,MATH 282A,A00,087446,Zhang; Danna,0,0,8,8
1653615619736,MATH 283,A00,087447,Tesler; Glenn,0,0,0,16
1653615620267,MATH 286,B00,095535,Kemp; Todd Aahron,5,0,8,3
1653615620794,MATH 287D,B00,095536,Bradic; Jelena,5,0,8,3
1653615621330,MATH 288,A00,087450,Staff,14,0,15,1
1653615621330,MATH 288,B00,087451,Staff,15,0,15,0
1653615621330,MATH 288,C00,087452,Staff,15,0,15,0
1653615621853,MATH 290A,A00,087453,Xu; Zhouli,6,0,8,2
1653615622375,MATH 291A,A00,087454,Xu; Zhouli,7,0,8,1
1653615622897,MATH 292,A00,087455,Staff,10,0,10,0
1653615623418,MATH 295,A00,087456,Staff,50,0,50,0
1653615623940,MATH 297,001,087457,Staff,997,0,999,2
1653616183530,COGS 200,A01,087991,Staff,47,0,50,3
1653616184057,COGS 201,A01,094504,Rangel; Lara M,16,0,25,9
1653616184578,COGS 203,A00,087992,Coulson; Seana M,18,0,20,2
1653616185099,COGS 210A,001,087993,Greene; Deanna Jacquelyn,9998,0,9999,1
1653616185099,COGS 210A,002,087994,Saygin; Ayse P,9999,0,9999,0
1653616185099,COGS 210A,003,087995,Xia; Haijun,9999,0,9999,0
1653616185099,COGS 210A,004,087996,Nitz; Douglas A.,9999,0,9999,0
1653616185099,COGS 210A,005,087997,Hollan; James D.,9999,0,9999,0
1653616185099,COGS 210A,006,087998,Deak; Gedeon O.,9998,0,9999,1
1653616185099,COGS 210A,007,087999,Rossano; Federico,9999,0,9999,0
1653616185629,COGS 211A,A00,088000,Coulson; Seana M,9997,0,9999,2
1653616186154,COGS 229,A00,088002,Staff,22,0,25,3
1653616186676,COGS 260,B00,094231,Staff,17,0,20,3
1653616186676,COGS 260,A00,088004,Nitz; Douglas A.,9998,0,9999,1
1653616187202,CSE 202,A00,090110,Paturi; Ramamohan,0,0,0,0
1653616187202,CSE 202,B00,090111,Paturi; Ramamohan,0,0,0,0
1653616187725,CSE 207B,A00,090112,Heninger; Nadia A,0,0,0,0
1653616188250,CSE 208,A00,094858,Micciancio; Daniele,0,0,0,0
1653616188780,CSE 210,A00,090113,Powell; Thomas Allan,0,0,0,0
1653616189308,CSE 219,A00,090898,Staff,0,0,0,0
1653616189830,CSE 221,A00,090114,Zhou; Yuan-Yuan,0,0,0,0
1653616190353,CSE 229A,A00,090115,Porter; George M,0,0,0,0
1653616190875,CSE 229C,A00,090116,Savage; Stefan,0,0,0,0
1653616191419,CSE 230,A00,090117,Jhala; Ranjit,0,0,0,0
1653616191950,CSE 232,A00,090118,Papakonstantinou; Yannis,0,0,0,0
1653616192473,CSE 239A,A00,090121,Kumar; Arun Kumar,0,0,0,0
1653616192998,CSE 239B,A00,090122,Jhala; Ranjit,0,0,0,0
1653616193524,CSE 240A,A00,090123,Zhao; Jishen,0,0,189,189
1653616194054,CSE 243A,A00,090124,Orailoglu; Alex,0,0,15,15
1653616194578,CSE 249B,A00,090125,Kahng; Andrew Byun,12,0,20,8
1653616195103,CSE 250A,A00,090126,Berg-Kirkpatrick; Taylor D,0,0,0,0
1653616195628,CSE 252A,A00,090127,Ochoa; Benjamin Lawrence,0,0,0,0
1653616196155,CSE 258,A01,090129,McAuley; Julian John,0,0,0,0
1653616196677,CSE 258R,A01,090131,McAuley; Julian John,0,0,0,0
1653616197202,CSE 274,A00,090132,Ramamoorthi; Ravi,0,0,0,0
1653616197727,CSE 276A,A00,090133,Christensen; Henrik I,0,0,0,0
1653616198253,CSE 276C,A00,090134,Christensen; Henrik I,0,0,0,0
1653616198776,CSE 290,A00,090135,Bafna; Vineet,0,0,0,0
1653616198776,CSE 290,B00,090136,Ramamoorthi; Ravi,0,0,0,0
1653616198776,CSE 290,C00,090137,Li; Tzumao,7,0,10,3
1653616198776,CSE 290,D00,090138,Zhou; Yuan-Yuan,9,0,10,1
1653616198776,CSE 290,E00,090139,Christensen; Henrik I,8,0,10,2
1653616198776,CSE 290,F00,094053,Shalev; Aaron D,0,0,0,0
1653616199304,CSE 291,A00,090140,Munyaka; Imani N. S.,0,0,0,0
1653616199304,CSE 291,B00,094880,Yu; Qi,0,0,0,0
1653616199304,CSE 291,C00,090142,Pannuto; Patrick William,0,0,0,0
1653616199304,CSE 291,D00,094881,Zhang; Yiying,0,0,0,0
1653616199304,CSE 291,E00,095118,Su; Hao,0,0,0,0
1653616199829,CSE 293,001,094905,Bafna; Vineet,9999,0,9999,0
1653616199829,CSE 293,002,094906,Bellare; Mihir,9999,0,9999,0
1653616199829,CSE 293,003,094907,Berg-Kirkpatrick; Taylor D,9999,0,9999,0
1653616199829,CSE 293,004,094908,Christensen; Henrik I,9999,0,9999,0
1653616199829,CSE 293,005,094909,Cottrell; Garrison W,9999,0,9999,0
1653616199829,CSE 293,006,094910,Deutsch; Alin Bernard,9999,0,9999,0
1653616199829,CSE 293,007,094911,Esmaeilzadeh; Hadi,9999,0,9999,0
1653616199829,CSE 293,008,094912,Freund; Yoav,9999,0,9999,0
1653616199829,CSE 293,009,094913,Griswold; William G.,9999,0,9999,0
1653616199829,CSE 293,010,094914,Gymrek; Melissa Ann,9999,0,9999,0
1653616199829,CSE 293,011,094915,Heninger; Nadia A,9999,0,9999,0
1653616199829,CSE 293,012,094916,Impagliazzo; Russell,9999,0,9999,0
1653616199829,CSE 293,013,094917,Jhala; Ranjit,9999,0,9999,0
1653616199829,CSE 293,014,094918,Kahng; Andrew Byun,9999,0,9999,0
1653616199829,CSE 293,015,094919,Kane; Daniel Mertz,9999,0,9999,0
1653616199829,CSE 293,016,094920,Kriegman; David J,9999,0,9999,0
1653616199829,CSE 293,017,094921,Kumar; Arun Kumar,9999,0,9999,0
1653616199829,CSE 293,018,094922,Lerner; Sorin,9999,0,9999,0
1653616199829,CSE 293,019,094923,Lovett; Shachar,9999,0,9999,0
1653616199829,CSE 293,020,094924,McAuley; Julian John,9999,0,9999,0
1653616199829,CSE 293,021,094925,Micciancio; Daniele,9999,0,9999,0
1653616199829,CSE 293,022,094926,Orailoglu; Alex,9999,0,9999,0
1653616199829,CSE 293,023,094927,Paturi; Ramamohan,9999,0,9999,0
1653616199829,CSE 293,024,094928,Polikarpova; Nadezhda,9999,0,9999,0
1653616199829,CSE 293,025,094929,Politz; Joseph Gibbs,9999,0,9999,0
1653616199829,CSE 293,026,094930,Porter; George M,9999,0,9999,0
1653616199829,CSE 293,027,094931,Porter; Leonard Emerson,9999,0,9999,0
1653616199829,CSE 293,028,094932,Ramamoorthi; Ravi,9999,0,9999,0
1653616199829,CSE 293,029,094933,Sahoo; Debashis,9999,0,9999,0
1653616199829,CSE 293,030,094934,Saul; Lawrence,9999,0,9999,0
1653616199829,CSE 293,031,094935,Savage; Stefan,9999,0,9999,0
1653616199829,CSE 293,032,094936,Schulze; Jurgen P.,9999,0,9999,0
1653616199829,CSE 293,033,094937,Snoeren; Alex C.,9999,0,9999,0
1653616199829,CSE 293,034,094938,Shang; Jingbo,9999,0,9999,0
1653616199829,CSE 293,035,094939,Stefan; Deian,9999,0,9999,0
1653616199829,CSE 293,036,094940,Su; Hao,9999,0,9999,0
1653616199829,CSE 293,037,094941,Swanson; Steven James,9999,0,9999,0
1653616199829,CSE 293,038,094942,Tullsen; Dean Michael,9999,0,9999,0
1653616199829,CSE 293,039,094943,Voelker; Geoffrey M.,9999,0,9999,0
1653616199829,CSE 293,040,094944,Zhao; Jishen,9999,0,9999,0
1653616199829,CSE 293,041,094945,Zhou; Yuan-Yuan,9999,0,9999,0
1653616199829,CSE 293,042,094946,Gao; Sicun,9998,0,9999,1
1653616199829,CSE 293,043,094947,Weibel; Nadir,9999,0,9999,0
1653616199829,CSE 293,044,094948,Gupta; Rajesh K.,9999,0,9999,0
1653616200355,CSE 294,A00,090143,Porter; George M,9,0,10,1
1653616200877,DSE 200,A00,091799,Staff,50,0,50,0
1653616201400,DSE 203,A00,091800,Gupta; Amarnath,30,0,30,0
1653616201936,DSE 250,A00,091801,Deutsch; Alin Bernard,30,0,30,0
1653616202458,DSE 290,A00,091802,Altintas De Callaf; Ilkay,50,0,50,0
1653616202984,ECE 200,001,091003,Antipa; Nicholas A,9999,0,9999,0
1653616202984,ECE 200,002,091004,Atanasov; Nikolay A.,9999,0,9999,0
1653616202984,ECE 200,003,091005,Bharadia; Dinesh,9999,0,9999,0
1653616202984,ECE 200,004,091006,Cheng; Chung Kuan,9999,0,9999,0
1653616202984,ECE 200,005,091007,Cosman; Pamela C.,9999,0,9999,0
1653616202984,ECE 200,006,091008,Staff,9999,0,9999,0
1653616202984,ECE 200,007,091009,Dayeh; Shadi Ahmad,9999,0,9999,0
1653616202984,ECE 200,008,091010,Fainman; Yeshaiahu,9999,0,9999,0
1653616202984,ECE 200,009,091011,Ford; Joseph Earl,9999,0,9999,0
1653616202984,ECE 200,010,091012,Franceschetti; Massimo,9999,0,9999,0
1653616202984,ECE 200,011,091013,Fullerton; Eric E,9999,0,9999,0
1653616202984,ECE 200,012,091014,Galton; Ian A,9999,0,9999,0
1653616202984,ECE 200,013,091015,Gilja; Vikash,9999,0,9999,0
1653616202984,ECE 200,014,091016,Hall; Drew A.,9999,0,9999,0
1653616202984,ECE 200,015,091017,Hsueh; Tzu-Chien,9999,0,9999,0
1653616202984,ECE 200,016,091018,Javidi; Tara,9999,0,9999,0
1653616202984,ECE 200,017,091019,Kahng; Andrew Byun,9999,0,9999,0
1653616202984,ECE 200,018,091020,Kim; Young-Han,9999,0,9999,0
1653616202984,ECE 200,019,091021,Koushanfar; Farinaz,9999,0,9999,0
1653616202984,ECE 200,020,091022,Kuzum; Duygu,9999,0,9999,0
1653616202984,ECE 200,021,091023,Le; Hanh-Phuc,9999,0,9999,0
1653616202984,ECE 200,022,091024,Lin; Bill,9999,0,9999,0
1653616202984,ECE 200,023,091025,Liu; Zhaowei,9999,0,9999,0
1653616202984,ECE 200,024,091026,Lo; Yu-Hwa,9999,0,9999,0
1653616202984,ECE 200,025,091027,Lomakin; Vitaliy,9999,0,9999,0
1653616202984,ECE 200,026,091028,Mercier; Patrick Philip,9999,0,9999,0
1653616202984,ECE 200,027,091029,Meyer; Florian,9999,0,9999,0
1653616202984,ECE 200,028,091030,Milstein; Laurence B.,9999,0,9999,0
1653616202984,ECE 200,029,091031,Mir Arabbaygi; Siavash,9999,0,9999,0
1653616202984,ECE 200,030,091032,Mookherjea; Shayan,9999,0,9999,0
1653616202984,ECE 200,031,091033,Morris; Karcher William,9999,0,9999,0
1653616202984,ECE 200,032,091034,Ng; Tse Nga,9999,0,9999,0
1653616202984,ECE 200,033,091035,Nguyen; Truong Quang,9999,0,9999,0
1653616202984,ECE 200,034,091036,Nomura; Kenji,9999,0,9999,0
1653616202984,ECE 200,035,091037,Orlitsky; Alon,9999,0,9999,0
1653616202984,ECE 200,036,091038,Pal; Piya,9999,0,9999,0
1653616202984,ECE 200,037,091039,Papen; George C.,9999,0,9999,0
1653616202984,ECE 200,038,091040,Radic; Stojan,9999,0,9999,0
1653616202984,ECE 200,039,091041,Rao; Bhaskar D.,9999,0,9999,0
1653616202984,ECE 200,040,091042,Rao; Ramesh R,9999,0,9999,0
1653616202984,ECE 200,041,091043,Rebeiz; Gabriel,9999,0,9999,0
1653616202984,ECE 200,042,091044,Sanford; John R,9999,0,9999,0
1653616202984,ECE 200,043,091045,Siegel; Paul H.,9999,0,9999,0
1653616202984,ECE 200,044,091046,Sievenpiper; Daniel F.,9999,0,9999,0
1653616202984,ECE 200,045,091047,Sworder; David D.,9999,0,9999,0
1653616202984,ECE 200,046,091048,Taur; Yuan,9999,0,9999,0
1653616202984,ECE 200,047,091049,Touri; Behrouz,9999,0,9999,0
1653616202984,ECE 200,048,091050,Trivedi; Mohan M.,9999,0,9999,0
1653616202984,ECE 200,049,091051,Vardy; Alexander,9999,0,9999,0
1653616202984,ECE 200,050,091052,Vasconcelos; Nuno,9999,0,9999,0
1653616202984,ECE 200,051,091053,Wang; Xiaolong,9999,0,9999,0
1653616202984,ECE 200,052,091054,Xie; Pengtao,9999,0,9999,0
1653616202984,ECE 200,053,091055,Yip; Michael,9999,0,9999,0
1653616202984,ECE 200,054,091056,Zeger; Kenneth A.,9999,0,9999,0
1653616202984,ECE 200,055,091057,Zhang; Xinyu,9999,0,9999,0
1653616202984,ECE 200,056,091058,Turakhia; Yatish Girish,9999,0,9999,0
1653616202984,ECE 200,057,091059,Kang; Mingu,9999,0,9999,0
1653616202984,ECE 200,058,091060,Shi; Yuanyuan,9999,0,9999,0
1653616202984,ECE 200,059,091061,Wang; Edward Jay,9999,0,9999,0
1653616202984,ECE 200,060,091062,Zheng; Yang,9999,0,9999,0
1653616203509,ECE 201,A00,095526,Lo; Yu-Hwa,0,0,0,0
1653616204031,ECE 203,A00,091065,Mercier; Patrick Philip,0,0,0,0
1653616204557,ECE 207A,A00,091605,Liu; Thomas Tao-Ming,0,0,0,0
1653616205091,ECE 212AN,A00,091068,Nomura; Kenji,0,0,0,0
1653616205617,ECE 222A,A00,091069,Rebeiz; Gabriel,0,0,0,0
1653616206139,ECE 225A,A00,091070,Orlitsky; Alon,0,0,0,0
1653616206669,ECE 230A,A00,091071,Nomura; Kenji,0,0,0,0
1653616207195,ECE 236A,A00,091072,Dayeh; Shadi Ahmad,0,0,0,0
1653616207718,ECE 238A,A00,091073,Luo; Jian,0,0,0,0
1653616207718,ECE 238A,B00,091074,Luo; Jian,0,0,0,0
1653616208244,ECE 240A,A00,091075,Radic; Stojan,0,0,0,0
1653616208768,ECE 247A,A00,091592,Shi; Lingyan,0,0,0,0
1653616209293,ECE 250,A00,091076,Touri; Behrouz,0,0,0,0
1653616209829,ECE 251C,A00,091078,Nguyen; Truong Quang,0,0,0,0
1653616210358,ECE 253,A00,091079,Cosman; Pamela C.,0,0,0,0
1653616210882,ECE 255A,A00,091080,Orlitsky; Alon,0,0,0,0
1653616211405,ECE 257A,A00,091081,Zhang; Xinyu,0,0,0,0
1653616211938,ECE 260A,A01,091084,Eldon; John,0,0,0,0
1653616212462,ECE 264C,A00,091085,Galton; Ian A,0,0,0,0
1653616212988,ECE 265C,A00,094889,Presti; Calogero Davide,0,0,0,9
1653616213519,ECE 266,A01,091087,Hall; Drew A.,0,0,0,0
1653616214574,ECE 271A,A00,091090,Vasconcelos; Nuno,0,0,0,0
1653616215098,ECE 272B,A00,091091,Sworder; David D.,0,0,0,0
1653616215621,ECE 275A,A00,091092,Meyer; Florian,0,0,0,0
1653616216146,ECE 277,A00,091093,An; Cheolhong,0,0,0,0
1653616216668,ECE 283,A00,091094,Le; Hanh-Phuc,0,0,0,0
1653616217194,ECE 284,A00,091095,Kang; Mingu,0,0,0,0
1653616217194,ECE 284,B00,091096,Wang; Edward Jay,0,0,0,0
1653616217720,ECE 285,A00,094334,Touri; Behrouz,0,0,0,0
1653616218245,ECE 289,A00,091097,Whelan; David Arthur,0,0,0,0
1653616218768,MATH 200A,A00,087414,Salehi Golsefidy; Alireza,7,0,8,1
1653616219290,MATH 202A,A00,087415,Gill; Philip E.,2,0,8,6
1653616219813,MATH 203A,A00,087416,Oprea; Dragos N.,6,0,8,2
1653616220338,MATH 204A,A00,087417,Kedlaya; Kiran S.,6,0,8,2
1653616220864,MATH 205,A00,087418,Sorensen; Claus M,6,0,8,2
1653616221386,MATH 206A,A00,087419,Izadi; Elham,7,0,8,1
1653616221908,MATH 207A,A00,087420,Mohammadi; Amir,5,0,8,3
1653616222433,MATH 208,A00,087421,Staff,9,0,10,1
1653616222955,MATH 209,A00,087422,Staff,10,0,10,0
1653616223481,MATH 218,A00,087423,Staff,10,0,10,0
1653616224007,MATH 220A,A00,087424,Novak; Jonathan I,6,0,8,2
1653616224530,MATH 231A,A00,087425,Bejenaru; Ioan,3,0,8,5
1653616225055,MATH 240A,A00,087426,Ebenfelt; Peter F,5,0,8,3
1653616225577,MATH 243,A00,087427,Staff,9,0,10,1
1653616226099,MATH 248,A00,087429,Staff,10,0,10,0
1653616226622,MATH 250A,A00,087430,Spolaor; Luca,4,0,8,4
1653616227143,MATH 257A,A00,087431,Spolaor; Luca,7,0,8,1
1653616227666,MATH 258,A00,087432,Staff,9,0,10,1
1653616228191,MATH 264A,A00,087433,Warnke; Lutz Peter,5,0,8,3
1653616228721,MATH 268,A00,087434,Staff,15,0,15,0
1653616229254,MATH 269,A00,087435,Staff,14,0,15,1
1653616229784,MATH 270A,A00,087436,Nie; Jiawang,0,0,8,8
1653616230312,MATH 272A,A00,087437,Tian; Xiaochuan,0,0,8,8
1653616230838,MATH 274,A01,087439,Cheng; Li-Tien,9,0,10,1
1653616230838,MATH 274,A02,087440,Cheng; Li-Tien,10,0,10,0
1653616231368,MATH 278A,A00,087441,Staff,8,0,10,2
1653616231904,MATH 278B,A00,087442,Staff,8,0,10,2
1653616232435,MATH 278C,A00,087443,Staff,8,0,10,2
1653616232957,MATH 280A,A00,087444,Zheng; Tianyi,0,0,8,8
1653616233560,MATH 281A,A00,087445,Bradic; Jelena,0,0,8,9
1653616234086,MATH 282A,A00,087446,Zhang; Danna,0,0,8,8
1653616234610,MATH 283,A00,087447,Tesler; Glenn,0,0,0,16
1653616235132,MATH 286,B00,095535,Kemp; Todd Aahron,5,0,8,3
1653616235658,MATH 287D,B00,095536,Bradic; Jelena,5,0,8,3
1653616236189,MATH 288,A00,087450,Staff,14,0,15,1
1653616236189,MATH 288,B00,087451,Staff,15,0,15,0
1653616236189,MATH 288,C00,087452,Staff,15,0,15,0
1653616236715,MATH 290A,A00,087453,Xu; Zhouli,6,0,8,2
1653616237258,MATH 291A,A00,087454,Xu; Zhouli,7,0,8,1
1653616237796,MATH 292,A00,087455,Staff,10,0,10,0
1653616238320,MATH 295,A00,087456,Staff,50,0,50,0
1653616238844,MATH 297,001,087457,Staff,997,0,999,2
1653616798639,COGS 200,A01,087991,Staff,47,0,50,3
1653616799162,COGS 201,A01,094504,Rangel; Lara M,16,0,25,9
1653616799694,COGS 203,A00,087992,Coulson; Seana M,18,0,20,2
1653616800225,COGS 210A,001,087993,Greene; Deanna Jacquelyn,9998,0,9999,1
1653616800225,COGS 210A,002,087994,Saygin; Ayse P,9999,0,9999,0
1653616800225,COGS 210A,003,087995,Xia; Haijun,9999,0,9999,0
1653616800225,COGS 210A,004,087996,Nitz; Douglas A.,9999,0,9999,0
1653616800225,COGS 210A,005,087997,Hollan; James D.,9999,0,9999,0
1653616800225,COGS 210A,006,087998,Deak; Gedeon O.,9998,0,9999,1
1653616800225,COGS 210A,007,087999,Rossano; Federico,9999,0,9999,0
1653616800748,COGS 211A,A00,088000,Coulson; Seana M,9997,0,9999,2
1653616801274,COGS 229,A00,088002,Staff,22,0,25,3
1653616801796,COGS 260,B00,094231,Staff,17,0,20,3
1653616801796,COGS 260,A00,088004,Nitz; Douglas A.,9998,0,9999,1
1653616802320,CSE 202,A00,090110,Paturi; Ramamohan,0,0,0,0
1653616802320,CSE 202,B00,090111,Paturi; Ramamohan,0,0,0,0
1653616802843,CSE 207B,A00,090112,Heninger; Nadia A,0,0,0,0
1653616803365,CSE 208,A00,094858,Micciancio; Daniele,0,0,0,0
1653616803888,CSE 210,A00,090113,Powell; Thomas Allan,0,0,0,0
1653616804411,CSE 219,A00,090898,Staff,0,0,0,0
1653616804937,CSE 221,A00,090114,Zhou; Yuan-Yuan,0,0,0,0
1653616805462,CSE 229A,A00,090115,Porter; George M,0,0,0,0
1653616805990,CSE 229C,A00,090116,Savage; Stefan,0,0,0,0
1653616806515,CSE 230,A00,090117,Jhala; Ranjit,0,0,0,0
1653616807036,CSE 232,A00,090118,Papakonstantinou; Yannis,0,0,0,0
1653616807558,CSE 239A,A00,090121,Kumar; Arun Kumar,0,0,0,0
1653616808091,CSE 239B,A00,090122,Jhala; Ranjit,0,0,0,0
1653616808619,CSE 240A,A00,090123,Zhao; Jishen,0,0,189,189
1653616809144,CSE 243A,A00,090124,Orailoglu; Alex,0,0,15,15
1653616809666,CSE 249B,A00,090125,Kahng; Andrew Byun,12,0,20,8
1653616810188,CSE 250A,A00,090126,Berg-Kirkpatrick; Taylor D,0,0,0,0
1653616810709,CSE 252A,A00,090127,Ochoa; Benjamin Lawrence,0,0,0,0
1653616811235,CSE 258,A01,090129,McAuley; Julian John,0,0,0,0
1653616811761,CSE 258R,A01,090131,McAuley; Julian John,0,0,0,0
1653616812297,CSE 274,A00,090132,Ramamoorthi; Ravi,0,0,0,0
1653616812824,CSE 276A,A00,090133,Christensen; Henrik I,0,0,0,0
1653616813347,CSE 276C,A00,090134,Christensen; Henrik I,0,0,0,0
1653616813869,CSE 290,A00,090135,Bafna; Vineet,0,0,0,0
1653616813869,CSE 290,B00,090136,Ramamoorthi; Ravi,0,0,0,0
1653616813869,CSE 290,C00,090137,Li; Tzumao,7,0,10,3
1653616813869,CSE 290,D00,090138,Zhou; Yuan-Yuan,9,0,10,1
1653616813869,CSE 290,E00,090139,Christensen; Henrik I,8,0,10,2
1653616813869,CSE 290,F00,094053,Shalev; Aaron D,0,0,0,0
1653616814393,CSE 291,A00,090140,Munyaka; Imani N. S.,0,0,0,0
1653616814393,CSE 291,B00,094880,Yu; Qi,0,0,0,0
1653616814393,CSE 291,C00,090142,Pannuto; Patrick William,0,0,0,0
1653616814393,CSE 291,D00,094881,Zhang; Yiying,0,0,0,0
1653616814393,CSE 291,E00,095118,Su; Hao,0,0,0,0
1653616814925,CSE 293,001,094905,Bafna; Vineet,9999,0,9999,0
1653616814925,CSE 293,002,094906,Bellare; Mihir,9999,0,9999,0
1653616814925,CSE 293,003,094907,Berg-Kirkpatrick; Taylor D,9999,0,9999,0
1653616814925,CSE 293,004,094908,Christensen; Henrik I,9999,0,9999,0
1653616814925,CSE 293,005,094909,Cottrell; Garrison W,9999,0,9999,0
1653616814925,CSE 293,006,094910,Deutsch; Alin Bernard,9999,0,9999,0
1653616814925,CSE 293,007,094911,Esmaeilzadeh; Hadi,9999,0,9999,0
1653616814925,CSE 293,008,094912,Freund; Yoav,9999,0,9999,0
1653616814925,CSE 293,009,094913,Griswold; William G.,9999,0,9999,0
1653616814925,CSE 293,010,094914,Gymrek; Melissa Ann,9999,0,9999,0
1653616814925,CSE 293,011,094915,Heninger; Nadia A,9999,0,9999,0
1653616814925,CSE 293,012,094916,Impagliazzo; Russell,9999,0,9999,0
1653616814925,CSE 293,013,094917,Jhala; Ranjit,9999,0,9999,0
1653616814925,CSE 293,014,094918,Kahng; Andrew Byun,9999,0,9999,0
1653616814925,CSE 293,015,094919,Kane; Daniel Mertz,9999,0,9999,0
1653616814925,CSE 293,016,094920,Kriegman; David J,9999,0,9999,0
1653616814925,CSE 293,017,094921,Kumar; Arun Kumar,9999,0,9999,0
1653616814925,CSE 293,018,094922,Lerner; Sorin,9999,0,9999,0
1653616814925,CSE 293,019,094923,Lovett; Shachar,9999,0,9999,0
1653616814925,CSE 293,020,094924,McAuley; Julian John,9999,0,9999,0
1653616814925,CSE 293,021,094925,Micciancio; Daniele,9999,0,9999,0
1653616814925,CSE 293,022,094926,Orailoglu; Alex,9999,0,9999,0
1653616814925,CSE 293,023,094927,Paturi; Ramamohan,9999,0,9999,0
1653616814925,CSE 293,024,094928,Polikarpova; Nadezhda,9999,0,9999,0
1653616814925,CSE 293,025,094929,Politz; Joseph Gibbs,9999,0,9999,0
1653616814925,CSE 293,026,094930,Porter; George M,9999,0,9999,0
1653616814925,CSE 293,027,094931,Porter; Leonard Emerson,9999,0,9999,0
1653616814925,CSE 293,028,094932,Ramamoorthi; Ravi,9999,0,9999,0
1653616814925,CSE 293,029,094933,Sahoo; Debashis,9999,0,9999,0
1653616814925,CSE 293,030,094934,Saul; Lawrence,9999,0,9999,0
1653616814925,CSE 293,031,094935,Savage; Stefan,9999,0,9999,0
1653616814925,CSE 293,032,094936,Schulze; Jurgen P.,9999,0,9999,0
1653616814925,CSE 293,033,094937,Snoeren; Alex C.,9999,0,9999,0
1653616814925,CSE 293,034,094938,Shang; Jingbo,9999,0,9999,0
1653616814925,CSE 293,035,094939,Stefan; Deian,9999,0,9999,0
1653616814925,CSE 293,036,094940,Su; Hao,9999,0,9999,0
1653616814925,CSE 293,037,094941,Swanson; Steven James,9999,0,9999,0
1653616814925,CSE 293,038,094942,Tullsen; Dean Michael,9999,0,9999,0
1653616814925,CSE 293,039,094943,Voelker; Geoffrey M.,9999,0,9999,0
1653616814925,CSE 293,040,094944,Zhao; Jishen,9999,0,9999,0
1653616814925,CSE 293,041,094945,Zhou; Yuan-Yuan,9999,0,9999,0
1653616814925,CSE 293,042,094946,Gao; Sicun,9998,0,9999,1
1653616814925,CSE 293,043,094947,Weibel; Nadir,9999,0,9999,0
1653616814925,CSE 293,044,094948,Gupta; Rajesh K.,9999,0,9999,0
1653616815447,CSE 294,A00,090143,Porter; George M,9,0,10,1
1653616815971,DSE 200,A00,091799,Staff,50,0,50,0
1653616816506,DSE 203,A00,091800,Gupta; Amarnath,30,0,30,0
1653616817029,DSE 250,A00,091801,Deutsch; Alin Bernard,30,0,30,0
1653616817551,DSE 290,A00,091802,Altintas De Callaf; Ilkay,50,0,50,0
1653616818085,ECE 200,001,091003,Antipa; Nicholas A,9999,0,9999,0
1653616818085,ECE 200,002,091004,Atanasov; Nikolay A.,9999,0,9999,0
1653616818085,ECE 200,003,091005,Bharadia; Dinesh,9999,0,9999,0
1653616818085,ECE 200,004,091006,Cheng; Chung Kuan,9999,0,9999,0
1653616818085,ECE 200,005,091007,Cosman; Pamela C.,9999,0,9999,0
1653616818085,ECE 200,006,091008,Staff,9999,0,9999,0
1653616818085,ECE 200,007,091009,Dayeh; Shadi Ahmad,9999,0,9999,0
1653616818085,ECE 200,008,091010,Fainman; Yeshaiahu,9999,0,9999,0
1653616818085,ECE 200,009,091011,Ford; Joseph Earl,9999,0,9999,0
1653616818085,ECE 200,010,091012,Franceschetti; Massimo,9999,0,9999,0
1653616818085,ECE 200,011,091013,Fullerton; Eric E,9999,0,9999,0
1653616818085,ECE 200,012,091014,Galton; Ian A,9999,0,9999,0
1653616818085,ECE 200,013,091015,Gilja; Vikash,9999,0,9999,0
1653616818085,ECE 200,014,091016,Hall; Drew A.,9999,0,9999,0
1653616818085,ECE 200,015,091017,Hsueh; Tzu-Chien,9999,0,9999,0
1653616818085,ECE 200,016,091018,Javidi; Tara,9999,0,9999,0
1653616818085,ECE 200,017,091019,Kahng; Andrew Byun,9999,0,9999,0
1653616818085,ECE 200,018,091020,Kim; Young-Han,9999,0,9999,0
1653616818085,ECE 200,019,091021,Koushanfar; Farinaz,9999,0,9999,0
1653616818085,ECE 200,020,091022,Kuzum; Duygu,9999,0,9999,0
1653616818085,ECE 200,021,091023,Le; Hanh-Phuc,9999,0,9999,0
1653616818085,ECE 200,022,091024,Lin; Bill,9999,0,9999,0
1653616818085,ECE 200,023,091025,Liu; Zhaowei,9999,0,9999,0
1653616818085,ECE 200,024,091026,Lo; Yu-Hwa,9999,0,9999,0
1653616818085,ECE 200,025,091027,Lomakin; Vitaliy,9999,0,9999,0
1653616818085,ECE 200,026,091028,Mercier; Patrick Philip,9999,0,9999,0
1653616818085,ECE 200,027,091029,Meyer; Florian,9999,0,9999,0
1653616818085,ECE 200,028,091030,Milstein; Laurence B.,9999,0,9999,0
1653616818085,ECE 200,029,091031,Mir Arabbaygi; Siavash,9999,0,9999,0
1653616818085,ECE 200,030,091032,Mookherjea; Shayan,9999,0,9999,0
1653616818085,ECE 200,031,091033,Morris; Karcher William,9999,0,9999,0
1653616818085,ECE 200,032,091034,Ng; Tse Nga,9999,0,9999,0
1653616818085,ECE 200,033,091035,Nguyen; Truong Quang,9999,0,9999,0
1653616818085,ECE 200,034,091036,Nomura; Kenji,9999,0,9999,0
1653616818085,ECE 200,035,091037,Orlitsky; Alon,9999,0,9999,0
1653616818085,ECE 200,036,091038,Pal; Piya,9999,0,9999,0
1653616818085,ECE 200,037,091039,Papen; George C.,9999,0,9999,0
1653616818085,ECE 200,038,091040,Radic; Stojan,9999,0,9999,0
1653616818085,ECE 200,039,091041,Rao; Bhaskar D.,9999,0,9999,0
1653616818085,ECE 200,040,091042,Rao; Ramesh R,9999,0,9999,0
1653616818085,ECE 200,041,091043,Rebeiz; Gabriel,9999,0,9999,0
1653616818085,ECE 200,042,091044,Sanford; John R,9999,0,9999,0
1653616818085,ECE 200,043,091045,Siegel; Paul H.,9999,0,9999,0
1653616818085,ECE 200,044,091046,Sievenpiper; Daniel F.,9999,0,9999,0
1653616818085,ECE 200,045,091047,Sworder; David D.,9999,0,9999,0
1653616818085,ECE 200,046,091048,Taur; Yuan,9999,0,9999,0
1653616818085,ECE 200,047,091049,Touri; Behrouz,9999,0,9999,0
1653616818085,ECE 200,048,091050,Trivedi; Mohan M.,9999,0,9999,0
1653616818085,ECE 200,049,091051,Vardy; Alexander,9999,0,9999,0
1653616818085,ECE 200,050,091052,Vasconcelos; Nuno,9999,0,9999,0
1653616818085,ECE 200,051,091053,Wang; Xiaolong,9999,0,9999,0
1653616818085,ECE 200,052,091054,Xie; Pengtao,9999,0,9999,0
1653616818085,ECE 200,053,091055,Yip; Michael,9999,0,9999,0
1653616818085,ECE 200,054,091056,Zeger; Kenneth A.,9999,0,9999,0
1653616818085,ECE 200,055,091057,Zhang; Xinyu,9999,0,9999,0
1653616818085,ECE 200,056,091058,Turakhia; Yatish Girish,9999,0,9999,0
1653616818085,ECE 200,057,091059,Kang; Mingu,9999,0,9999,0
1653616818085,ECE 200,058,091060,Shi; Yuanyuan,9999,0,9999,0
1653616818085,ECE 200,059,091061,Wang; Edward Jay,9999,0,9999,0
1653616818085,ECE 200,060,091062,Zheng; Yang,9999,0,9999,0
1653616818613,ECE 201,A00,095526,Lo; Yu-Hwa,0,0,0,0
1653616819139,ECE 203,A00,091065,Mercier; Patrick Philip,0,0,0,0
1653616819668,ECE 207A,A00,091605,Liu; Thomas Tao-Ming,0,0,0,0
1653616820194,ECE 212AN,A00,091068,Nomura; Kenji,0,0,0,0
1653616820804,ECE 222A,A00,091069,Rebeiz; Gabriel,0,0,0,0
1653616821328,ECE 225A,A00,091070,Orlitsky; Alon,0,0,0,0
1653616821854,ECE 230A,A00,091071,Nomura; Kenji,0,0,0,0
1653616822377,ECE 236A,A00,091072,Dayeh; Shadi Ahmad,0,0,0,0
1653616822901,ECE 238A,A00,091073,Luo; Jian,0,0,0,0
1653616822901,ECE 238A,B00,091074,Luo; Jian,0,0,0,0
1653616823424,ECE 240A,A00,091075,Radic; Stojan,0,0,0,0
1653616823946,ECE 247A,A00,091592,Shi; Lingyan,0,0,0,0
1653616824472,ECE 250,A00,091076,Touri; Behrouz,0,0,0,0
1653616824995,ECE 251C,A00,091078,Nguyen; Truong Quang,0,0,0,0
1653616825517,ECE 253,A00,091079,Cosman; Pamela C.,0,0,0,0
1653616826042,ECE 255A,A00,091080,Orlitsky; Alon,0,0,0,0
1653616826570,ECE 257A,A00,091081,Zhang; Xinyu,0,0,0,0
1653616827092,ECE 260A,A01,091084,Eldon; John,0,0,0,0
1653616827618,ECE 264C,A00,091085,Galton; Ian A,0,0,0,0
1653616828141,ECE 265C,A00,094889,Presti; Calogero Davide,0,0,0,9
1653616828670,ECE 266,A01,091087,Hall; Drew A.,0,0,0,0
1653616829720,ECE 271A,A00,091090,Vasconcelos; Nuno,0,0,0,0
1653616830242,ECE 272B,A00,091091,Sworder; David D.,0,0,0,0
1653616830764,ECE 275A,A00,091092,Meyer; Florian,0,0,0,0
1653616831290,ECE 277,A00,091093,An; Cheolhong,0,0,0,0
1653616831815,ECE 283,A00,091094,Le; Hanh-Phuc,0,0,0,0
1653616832336,ECE 284,A00,091095,Kang; Mingu,0,0,0,0
1653616832336,ECE 284,B00,091096,Wang; Edward Jay,0,0,0,0
1653616832868,ECE 285,A00,094334,Touri; Behrouz,0,0,0,0
1653616833391,ECE 289,A00,091097,Whelan; David Arthur,0,0,0,0
1653616833917,MATH 200A,A00,087414,Salehi Golsefidy; Alireza,7,0,8,1
1653616834443,MATH 202A,A00,087415,Gill; Philip E.,2,0,8,6
1653616834970,MATH 203A,A00,087416,Oprea; Dragos N.,6,0,8,2
1653616835506,MATH 204A,A00,087417,Kedlaya; Kiran S.,6,0,8,2
1653616836031,MATH 205,A00,087418,Sorensen; Claus M,6,0,8,2
1653616836553,MATH 206A,A00,087419,Izadi; Elham,7,0,8,1
1653616837076,MATH 207A,A00,087420,Mohammadi; Amir,5,0,8,3
1653616837605,MATH 208,A00,087421,Staff,9,0,10,1
1653616838126,MATH 209,A00,087422,Staff,10,0,10,0
1653616838657,MATH 218,A00,087423,Staff,10,0,10,0
1653616839180,MATH 220A,A00,087424,Novak; Jonathan I,6,0,8,2
1653616839751,MATH 231A,A00,087425,Bejenaru; Ioan,3,0,8,5
1653616840276,MATH 240A,A00,087426,Ebenfelt; Peter F,5,0,8,3
1653616840799,MATH 243,A00,087427,Staff,9,0,10,1
1653616841326,MATH 248,A00,087429,Staff,10,0,10,0
1653616841847,MATH 250A,A00,087430,Spolaor; Luca,4,0,8,4
1653616842372,MATH 257A,A00,087431,Spolaor; Luca,7,0,8,1
1653616842895,MATH 258,A00,087432,Staff,9,0,10,1
1653616843424,MATH 264A,A00,087433,Warnke; Lutz Peter,5,0,8,3
1653616843949,MATH 268,A00,087434,Staff,15,0,15,0
1653616844477,MATH 269,A00,087435,Staff,14,0,15,1
1653616845014,MATH 270A,A00,087436,Nie; Jiawang,0,0,8,8
1653616845536,MATH 272A,A00,087437,Tian; Xiaochuan,0,0,8,8
1653616846060,MATH 274,A01,087439,Cheng; Li-Tien,9,0,10,1
1653616846060,MATH 274,A02,087440,Cheng; Li-Tien,10,0,10,0
1653616846583,MATH 278A,A00,087441,Staff,8,0,10,2
1653616847109,MATH 278B,A00,087442,Staff,8,0,10,2
1653616847634,MATH 278C,A00,087443,Staff,8,0,10,2
1653616848169,MATH 280A,A00,087444,Zheng; Tianyi,0,0,8,8
1653616848694,MATH 281A,A00,087445,Bradic; Jelena,0,0,8,9
1653616849219,MATH 282A,A00,087446,Zhang; Danna,0,0,8,8
1653616849745,MATH 283,A00,087447,Tesler; Glenn,0,0,0,16
1653616850270,MATH 286,B00,095535,Kemp; Todd Aahron,5,0,8,3
1653616850795,MATH 287D,B00,095536,Bradic; Jelena,5,0,8,3
1653616851317,MATH 288,A00,087450,Staff,14,0,15,1
1653616851317,MATH 288,B00,087451,Staff,15,0,15,0
1653616851317,MATH 288,C00,087452,Staff,15,0,15,0
1653616851845,MATH 290A,A00,087453,Xu; Zhouli,6,0,8,2
1653616852370,MATH 291A,A00,087454,Xu; Zhouli,7,0,8,1
1653616852898,MATH 292,A00,087455,Staff,10,0,10,0
1653616853426,MATH 295,A00,087456,Staff,50,0,50,0
1653616853952,MATH 297,001,087457,Staff,997,0,999,2
1653617414577,COGS 200,A01,087991,Staff,47,0,50,3
1653617415099,COGS 201,A01,094504,Rangel; Lara M,16,0,25,9
1653617415622,COGS 203,A00,087992,Coulson; Seana M,18,0,20,2
1653617416150,COGS 210A,001,087993,Greene; Deanna Jacquelyn,9998,0,9999,1
1653617416150,COGS 210A,002,087994,Saygin; Ayse P,9999,0,9999,0
1653617416150,COGS 210A,003,087995,Xia; Haijun,9999,0,9999,0
1653617416150,COGS 210A,004,087996,Nitz; Douglas A.,9999,0,9999,0
1653617416150,COGS 210A,005,087997,Hollan; James D.,9999,0,9999,0
1653617416150,COGS 210A,006,087998,Deak; Gedeon O.,9998,0,9999,1
1653617416150,COGS 210A,007,087999,Rossano; Federico,9999,0,9999,0
1653617416672,COGS 211A,A00,088000,Coulson; Seana M,9997,0,9999,2
1653617417198,COGS 229,A00,088002,Staff,22,0,25,3
1653617417723,COGS 260,B00,094231,Staff,17,0,20,3
1653617417723,COGS 260,A00,088004,Nitz; Douglas A.,9998,0,9999,1
1653617418246,CSE 202,A00,090110,Paturi; Ramamohan,0,0,0,0
1653617418246,CSE 202,B00,090111,Paturi; Ramamohan,0,0,0,0
1653617418781,CSE 207B,A00,090112,Heninger; Nadia A,0,0,0,0
1653617419316,CSE 208,A00,094858,Micciancio; Daniele,0,0,0,0
1653617419838,CSE 210,A00,090113,Powell; Thomas Allan,0,0,0,0
1653617420360,CSE 219,A00,090898,Staff,0,0,0,0
1653617420883,CSE 221,A00,090114,Zhou; Yuan-Yuan,0,0,0,0
1653617421404,CSE 229A,A00,090115,Porter; George M,0,0,0,0
1653617421931,CSE 229C,A00,090116,Savage; Stefan,0,0,0,0
1653617422454,CSE 230,A00,090117,Jhala; Ranjit,0,0,0,0
1653617422977,CSE 232,A00,090118,Papakonstantinou; Yannis,0,0,0,0
1653617423500,CSE 239A,A00,090121,Kumar; Arun Kumar,0,0,0,0
1653617424022,CSE 239B,A00,090122,Jhala; Ranjit,0,0,0,0
1653617424548,CSE 240A,A00,090123,Zhao; Jishen,0,0,189,189
1653617425071,CSE 243A,A00,090124,Orailoglu; Alex,0,0,15,15
1653617425598,CSE 249B,A00,090125,Kahng; Andrew Byun,12,0,20,8
1653617426124,CSE 250A,A00,090126,Berg-Kirkpatrick; Taylor D,0,0,0,0
1653617426647,CSE 252A,A00,090127,Ochoa; Benjamin Lawrence,0,0,0,0
1653617427172,CSE 258,A01,090129,McAuley; Julian John,0,0,0,0
1653617427701,CSE 258R,A01,090131,McAuley; Julian John,0,0,0,0
1653617428223,CSE 274,A00,090132,Ramamoorthi; Ravi,0,0,0,0
1653617428752,CSE 276A,A00,090133,Christensen; Henrik I,0,0,0,0
1653617429278,CSE 276C,A00,090134,Christensen; Henrik I,0,0,0,0
1653617429800,CSE 290,A00,090135,Bafna; Vineet,0,0,0,0
1653617429800,CSE 290,B00,090136,Ramamoorthi; Ravi,0,0,0,0
1653617429800,CSE 290,C00,090137,Li; Tzumao,7,0,10,3
1653617429800,CSE 290,D00,090138,Zhou; Yuan-Yuan,9,0,10,1
1653617429800,CSE 290,E00,090139,Christensen; Henrik I,8,0,10,2
1653617429800,CSE 290,F00,094053,Shalev; Aaron D,0,0,0,0
1653617430331,CSE 291,A00,090140,Munyaka; Imani N. S.,0,0,0,0
1653617430331,CSE 291,B00,094880,Yu; Qi,0,0,0,0
1653617430331,CSE 291,C00,090142,Pannuto; Patrick William,0,0,0,0
1653617430331,CSE 291,D00,094881,Zhang; Yiying,0,0,0,0
1653617430331,CSE 291,E00,095118,Su; Hao,0,0,0,0
1653617430865,CSE 293,001,094905,Bafna; Vineet,9999,0,9999,0
1653617430865,CSE 293,002,094906,Bellare; Mihir,9999,0,9999,0
1653617430865,CSE 293,003,094907,Berg-Kirkpatrick; Taylor D,9999,0,9999,0
1653617430865,CSE 293,004,094908,Christensen; Henrik I,9999,0,9999,0
1653617430865,CSE 293,005,094909,Cottrell; Garrison W,9999,0,9999,0
1653617430865,CSE 293,006,094910,Deutsch; Alin Bernard,9999,0,9999,0
1653617430865,CSE 293,007,094911,Esmaeilzadeh; Hadi,9999,0,9999,0
1653617430865,CSE 293,008,094912,Freund; Yoav,9999,0,9999,0
1653617430865,CSE 293,009,094913,Griswold; William G.,9999,0,9999,0
1653617430865,CSE 293,010,094914,Gymrek; Melissa Ann,9999,0,9999,0
1653617430865,CSE 293,011,094915,Heninger; Nadia A,9999,0,9999,0
1653617430865,CSE 293,012,094916,Impagliazzo; Russell,9999,0,9999,0
1653617430865,CSE 293,013,094917,Jhala; Ranjit,9999,0,9999,0
1653617430865,CSE 293,014,094918,Kahng; Andrew Byun,9999,0,9999,0
1653617430865,CSE 293,015,094919,Kane; Daniel Mertz,9999,0,9999,0
1653617430865,CSE 293,016,094920,Kriegman; David J,9999,0,9999,0
1653617430865,CSE 293,017,094921,Kumar; Arun Kumar,9999,0,9999,0
1653617430865,CSE 293,018,094922,Lerner; Sorin,9999,0,9999,0
1653617430865,CSE 293,019,094923,Lovett; Shachar,9999,0,9999,0
1653617430865,CSE 293,020,094924,McAuley; Julian John,9999,0,9999,0
1653617430865,CSE 293,021,094925,Micciancio; Daniele,9999,0,9999,0
1653617430865,CSE 293,022,094926,Orailoglu; Alex,9999,0,9999,0
1653617430865,CSE 293,023,094927,Paturi; Ramamohan,9999,0,9999,0
1653617430865,CSE 293,024,094928,Polikarpova; Nadezhda,9999,0,9999,0
1653617430865,CSE 293,025,094929,Politz; Joseph Gibbs,9999,0,9999,0
1653617430865,CSE 293,026,094930,Porter; George M,9999,0,9999,0
1653617430865,CSE 293,027,094931,Porter; Leonard Emerson,9999,0,9999,0
1653617430865,CSE 293,028,094932,Ramamoorthi; Ravi,9999,0,9999,0
1653617430865,CSE 293,029,094933,Sahoo; Debashis,9999,0,9999,0
1653617430865,CSE 293,030,094934,Saul; Lawrence,9999,0,9999,0
1653617430865,CSE 293,031,094935,Savage; Stefan,9999,0,9999,0
1653617430865,CSE 293,032,094936,Schulze; Jurgen P.,9999,0,9999,0
1653617430865,CSE 293,033,094937,Snoeren; Alex C.,9999,0,9999,0
1653617430865,CSE 293,034,094938,Shang; Jingbo,9999,0,9999,0
1653617430865,CSE 293,035,094939,Stefan; Deian,9999,0,9999,0
1653617430865,CSE 293,036,094940,Su; Hao,9999,0,9999,0
1653617430865,CSE 293,037,094941,Swanson; Steven James,9999,0,9999,0
1653617430865,CSE 293,038,094942,Tullsen; Dean Michael,9999,0,9999,0
1653617430865,CSE 293,039,094943,Voelker; Geoffrey M.,9999,0,9999,0
1653617430865,CSE 293,040,094944,Zhao; Jishen,9999,0,9999,0
1653617430865,CSE 293,041,094945,Zhou; Yuan-Yuan,9999,0,9999,0
1653617430865,CSE 293,042,094946,Gao; Sicun,9998,0,9999,1
1653617430865,CSE 293,043,094947,Weibel; Nadir,9999,0,9999,0
1653617430865,CSE 293,044,094948,Gupta; Rajesh K.,9999,0,9999,0
1653617431402,CSE 294,A00,090143,Porter; George M,9,0,10,1
1653617431930,DSE 200,A00,091799,Staff,50,0,50,0
1653617432455,DSE 203,A00,091800,Gupta; Amarnath,30,0,30,0
1653617432977,DSE 250,A00,091801,Deutsch; Alin Bernard,30,0,30,0
1653617433500,DSE 290,A00,091802,Altintas De Callaf; Ilkay,50,0,50,0
1653617434039,ECE 200,001,091003,Antipa; Nicholas A,9999,0,9999,0
1653617434039,ECE 200,002,091004,Atanasov; Nikolay A.,9999,0,9999,0
1653617434039,ECE 200,003,091005,Bharadia; Dinesh,9999,0,9999,0
1653617434039,ECE 200,004,091006,Cheng; Chung Kuan,9999,0,9999,0
1653617434039,ECE 200,005,091007,Cosman; Pamela C.,9999,0,9999,0
1653617434039,ECE 200,006,091008,Staff,9999,0,9999,0
1653617434039,ECE 200,007,091009,Dayeh; Shadi Ahmad,9999,0,9999,0
1653617434039,ECE 200,008,091010,Fainman; Yeshaiahu,9999,0,9999,0
1653617434039,ECE 200,009,091011,Ford; Joseph Earl,9999,0,9999,0
1653617434039,ECE 200,010,091012,Franceschetti; Massimo,9999,0,9999,0
1653617434039,ECE 200,011,091013,Fullerton; Eric E,9999,0,9999,0
1653617434039,ECE 200,012,091014,Galton; Ian A,9999,0,9999,0
1653617434039,ECE 200,013,091015,Gilja; Vikash,9999,0,9999,0
1653617434039,ECE 200,014,091016,Hall; Drew A.,9999,0,9999,0
1653617434039,ECE 200,015,091017,Hsueh; Tzu-Chien,9999,0,9999,0
1653617434039,ECE 200,016,091018,Javidi; Tara,9999,0,9999,0
1653617434039,ECE 200,017,091019,Kahng; Andrew Byun,9999,0,9999,0
1653617434039,ECE 200,018,091020,Kim; Young-Han,9999,0,9999,0
1653617434039,ECE 200,019,091021,Koushanfar; Farinaz,9999,0,9999,0
1653617434039,ECE 200,020,091022,Kuzum; Duygu,9999,0,9999,0
1653617434039,ECE 200,021,091023,Le; Hanh-Phuc,9999,0,9999,0
1653617434039,ECE 200,022,091024,Lin; Bill,9999,0,9999,0
1653617434039,ECE 200,023,091025,Liu; Zhaowei,9999,0,9999,0
1653617434039,ECE 200,024,091026,Lo; Yu-Hwa,9999,0,9999,0
1653617434039,ECE 200,025,091027,Lomakin; Vitaliy,9999,0,9999,0
1653617434039,ECE 200,026,091028,Mercier; Patrick Philip,9999,0,9999,0
1653617434039,ECE 200,027,091029,Meyer; Florian,9999,0,9999,0
1653617434039,ECE 200,028,091030,Milstein; Laurence B.,9999,0,9999,0
1653617434039,ECE 200,029,091031,Mir Arabbaygi; Siavash,9999,0,9999,0
1653617434039,ECE 200,030,091032,Mookherjea; Shayan,9999,0,9999,0
1653617434039,ECE 200,031,091033,Morris; Karcher William,9999,0,9999,0
1653617434039,ECE 200,032,091034,Ng; Tse Nga,9999,0,9999,0
1653617434039,ECE 200,033,091035,Nguyen; Truong Quang,9999,0,9999,0
1653617434039,ECE 200,034,091036,Nomura; Kenji,9999,0,9999,0
1653617434039,ECE 200,035,091037,Orlitsky; Alon,9999,0,9999,0
1653617434039,ECE 200,036,091038,Pal; Piya,9999,0,9999,0
1653617434039,ECE 200,037,091039,Papen; George C.,9999,0,9999,0
1653617434039,ECE 200,038,091040,Radic; Stojan,9999,0,9999,0
1653617434039,ECE 200,039,091041,Rao; Bhaskar D.,9999,0,9999,0
1653617434039,ECE 200,040,091042,Rao; Ramesh R,9999,0,9999,0
1653617434039,ECE 200,041,091043,Rebeiz; Gabriel,9999,0,9999,0
1653617434039,ECE 200,042,091044,Sanford; John R,9999,0,9999,0
1653617434039,ECE 200,043,091045,Siegel; Paul H.,9999,0,9999,0
1653617434039,ECE 200,044,091046,Sievenpiper; Daniel F.,9999,0,9999,0
1653617434039,ECE 200,045,091047,Sworder; David D.,9999,0,9999,0
1653617434039,ECE 200,046,091048,Taur; Yuan,9999,0,9999,0
1653617434039,ECE 200,047,091049,Touri; Behrouz,9999,0,9999,0
1653617434039,ECE 200,048,091050,Trivedi; Mohan M.,9999,0,9999,0
1653617434039,ECE 200,049,091051,Vardy; Alexander,9999,0,9999,0
1653617434039,ECE 200,050,091052,Vasconcelos; Nuno,9999,0,9999,0
1653617434039,ECE 200,051,091053,Wang; Xiaolong,9999,0,9999,0
1653617434039,ECE 200,052,091054,Xie; Pengtao,9999,0,9999,0
1653617434039,ECE 200,053,091055,Yip; Michael,9999,0,9999,0
1653617434039,ECE 200,054,091056,Zeger; Kenneth A.,9999,0,9999,0
1653617434039,ECE 200,055,091057,Zhang; Xinyu,9999,0,9999,0
1653617434039,ECE 200,056,091058,Turakhia; Yatish Girish,9999,0,9999,0
1653617434039,ECE 200,057,091059,Kang; Mingu,9999,0,9999,0
1653617434039,ECE 200,058,091060,Shi; Yuanyuan,9999,0,9999,0
1653617434039,ECE 200,059,091061,Wang; Edward Jay,9999,0,9999,0
1653617434039,ECE 200,060,091062,Zheng; Yang,9999,0,9999,0
1653617434571,ECE 201,A00,095526,Lo; Yu-Hwa,0,0,0,0
1653617435111,ECE 203,A00,091065,Mercier; Patrick Philip,0,0,0,0
1653617435638,ECE 207A,A00,091605,Liu; Thomas Tao-Ming,0,0,0,0
1653617436167,ECE 212AN,A00,091068,Nomura; Kenji,0,0,0,0
1653617436690,ECE 222A,A00,091069,Rebeiz; Gabriel,0,0,0,0
1653617437212,ECE 225A,A00,091070,Orlitsky; Alon,0,0,0,0
1653617437735,ECE 230A,A00,091071,Nomura; Kenji,0,0,0,0
1653617438259,ECE 236A,A00,091072,Dayeh; Shadi Ahmad,0,0,0,0
1653617438789,ECE 238A,A00,091073,Luo; Jian,0,0,0,0
1653617438789,ECE 238A,B00,091074,Luo; Jian,0,0,0,0
1653617439313,ECE 240A,A00,091075,Radic; Stojan,0,0,0,0
1653617439836,ECE 247A,A00,091592,Shi; Lingyan,0,0,0,0
1653617440359,ECE 250,A00,091076,Touri; Behrouz,0,0,0,0
1653617440893,ECE 251C,A00,091078,Nguyen; Truong Quang,0,0,0,0
1653617441419,ECE 253,A00,091079,Cosman; Pamela C.,0,0,0,0
1653617441945,ECE 255A,A00,091080,Orlitsky; Alon,0,0,0,0
1653617442471,ECE 257A,A00,091081,Zhang; Xinyu,0,0,0,0
1653617442998,ECE 260A,A01,091084,Eldon; John,0,0,0,0
1653617443524,ECE 264C,A00,091085,Galton; Ian A,0,0,0,0
1653617444047,ECE 265C,A00,094889,Presti; Calogero Davide,0,0,0,9
1653617444583,ECE 266,A01,091087,Hall; Drew A.,0,0,0,0
1653617445630,ECE 271A,A00,091090,Vasconcelos; Nuno,0,0,0,0
1653617446155,ECE 272B,A00,091091,Sworder; David D.,0,0,0,0
1653617446689,ECE 275A,A00,091092,Meyer; Florian,0,0,0,0
1653617447212,ECE 277,A00,091093,An; Cheolhong,0,0,0,0
1653617447738,ECE 283,A00,091094,Le; Hanh-Phuc,0,0,0,0
1653617448263,ECE 284,A00,091095,Kang; Mingu,0,0,0,0
1653617448263,ECE 284,B00,091096,Wang; Edward Jay,0,0,0,0
1653617448788,ECE 285,A00,094334,Touri; Behrouz,0,0,0,0
1653617449313,ECE 289,A00,091097,Whelan; David Arthur,0,0,0,0
1653617449842,MATH 200A,A00,087414,Salehi Golsefidy; Alireza,7,0,8,1
1653617450369,MATH 202A,A00,087415,Gill; Philip E.,2,0,8,6
1653617450902,MATH 203A,A00,087416,Oprea; Dragos N.,6,0,8,2
1653617451424,MATH 204A,A00,087417,Kedlaya; Kiran S.,6,0,8,2
1653617451948,MATH 205,A00,087418,Sorensen; Claus M,6,0,8,2
1653617452471,MATH 206A,A00,087419,Izadi; Elham,7,0,8,1
1653617453001,MATH 207A,A00,087420,Mohammadi; Amir,5,0,8,3
1653617453523,MATH 208,A00,087421,Staff,9,0,10,1
1653617454047,MATH 209,A00,087422,Staff,10,0,10,0
1653617454578,MATH 218,A00,087423,Staff,10,0,10,0
1653617455124,MATH 220A,A00,087424,Novak; Jonathan I,6,0,8,2
1653617455649,MATH 231A,A00,087425,Bejenaru; Ioan,3,0,8,5
1653617456175,MATH 240A,A00,087426,Ebenfelt; Peter F,5,0,8,3
1653617456698,MATH 243,A00,087427,Staff,9,0,10,1
1653617457222,MATH 248,A00,087429,Staff,10,0,10,0
1653617457748,MATH 250A,A00,087430,Spolaor; Luca,4,0,8,4
1653617458271,MATH 257A,A00,087431,Spolaor; Luca,7,0,8,1
1653617458797,MATH 258,A00,087432,Staff,9,0,10,1
1653617459320,MATH 264A,A00,087433,Warnke; Lutz Peter,5,0,8,3
1653617459856,MATH 268,A00,087434,Staff,15,0,15,0
1653617460381,MATH 269,A00,087435,Staff,14,0,15,1
1653617460917,MATH 270A,A00,087436,Nie; Jiawang,0,0,8,8
1653617461449,MATH 272A,A00,087437,Tian; Xiaochuan,0,0,8,8
1653617462046,MATH 274,A01,087439,Cheng; Li-Tien,9,0,10,1
1653617462046,MATH 274,A02,087440,Cheng; Li-Tien,10,0,10,0
1653617462571,MATH 278A,A00,087441,Staff,8,0,10,2
1653617463104,MATH 278B,A00,087442,Staff,8,0,10,2
1653617463629,MATH 278C,A00,087443,Staff,8,0,10,2
1653617464151,MATH 280A,A00,087444,Zheng; Tianyi,0,0,8,8
1653617464675,MATH 281A,A00,087445,Bradic; Jelena,0,0,8,9
1653617465200,MATH 282A,A00,087446,Zhang; Danna,0,0,8,8
1653617465724,MATH 283,A00,087447,Tesler; Glenn,0,0,0,16
1653617466249,MATH 286,B00,095535,Kemp; Todd Aahron,5,0,8,3
1653617466771,MATH 287D,B00,095536,Bradic; Jelena,5,0,8,3
1653617467296,MATH 288,A00,087450,Staff,14,0,15,1
1653617467296,MATH 288,B00,087451,Staff,15,0,15,0
1653617467296,MATH 288,C00,087452,Staff,15,0,15,0
1653617467818,MATH 290A,A00,087453,Xu; Zhouli,6,0,8,2
1653617468351,MATH 291A,A00,087454,Xu; Zhouli,7,0,8,1
1653617468876,MATH 292,A00,087455,Staff,10,0,10,0
1653617469407,MATH 295,A00,087456,Staff,50,0,50,0
1653617469933,MATH 297,001,087457,Staff,997,0,999,2
1653618040309,COGS 200,A01,087991,Staff,47,0,50,3
1653618040831,COGS 201,A01,094504,Rangel; Lara M,16,0,25,9
1653618041371,COGS 203,A00,087992,Coulson; Seana M,18,0,20,2
1653618041898,COGS 210A,001,087993,Greene; Deanna Jacquelyn,9998,0,9999,1
1653618041898,COGS 210A,002,087994,Saygin; Ayse P,9999,0,9999,0
1653618041898,COGS 210A,003,087995,Xia; Haijun,9999,0,9999,0
1653618041898,COGS 210A,004,087996,Nitz; Douglas A.,9999,0,9999,0
1653618041898,COGS 210A,005,087997,Hollan; James D.,9999,0,9999,0
1653618041898,COGS 210A,006,087998,Deak; Gedeon O.,9998,0,9999,1
1653618041898,COGS 210A,007,087999,Rossano; Federico,9999,0,9999,0
1653618042423,COGS 211A,A00,088000,Coulson; Seana M,9997,0,9999,2
1653618042946,COGS 229,A00,088002,Staff,22,0,25,3
1653618043469,COGS 260,B00,094231,Staff,17,0,20,3
1653618043469,COGS 260,A00,088004,Nitz; Douglas A.,9998,0,9999,1
1653618043992,CSE 202,A00,090110,Paturi; Ramamohan,0,0,0,0
1653618043992,CSE 202,B00,090111,Paturi; Ramamohan,0,0,0,0
1653618044516,CSE 207B,A00,090112,Heninger; Nadia A,0,0,0,0
1653618045038,CSE 208,A00,094858,Micciancio; Daniele,0,0,0,0
1653618045573,CSE 210,A00,090113,Powell; Thomas Allan,0,0,0,0
1653618046096,CSE 219,A00,090898,Staff,0,0,0,0
1653618046629,CSE 221,A00,090114,Zhou; Yuan-Yuan,0,0,0,0
1653618047151,CSE 229A,A00,090115,Porter; George M,0,0,0,0
1653618047673,CSE 229C,A00,090116,Savage; Stefan,0,0,0,0
1653618048196,CSE 230,A00,090117,Jhala; Ranjit,0,0,0,0
1653618048719,CSE 232,A00,090118,Papakonstantinou; Yannis,0,0,0,0
1653618049245,CSE 239A,A00,090121,Kumar; Arun Kumar,0,0,0,0
1653618049771,CSE 239B,A00,090122,Jhala; Ranjit,0,0,0,0
1653618050300,CSE 240A,A00,090123,Zhao; Jishen,0,0,189,189
1653618050826,CSE 243A,A00,090124,Orailoglu; Alex,0,0,15,15
1653618051361,CSE 249B,A00,090125,Kahng; Andrew Byun,12,0,20,8
1653618051887,CSE 250A,A00,090126,Berg-Kirkpatrick; Taylor D,0,0,0,0
1653618052410,CSE 252A,A00,090127,Ochoa; Benjamin Lawrence,0,0,0,0
1653618052952,CSE 258,A01,090129,McAuley; Julian John,0,0,0,0
1653618053479,CSE 258R,A01,090131,McAuley; Julian John,0,0,0,0
1653618054006,CSE 274,A00,090132,Ramamoorthi; Ravi,0,0,0,0
1653618054532,CSE 276A,A00,090133,Christensen; Henrik I,0,0,0,0
1653618055056,CSE 276C,A00,090134,Christensen; Henrik I,0,0,0,0
1653618055579,CSE 290,A00,090135,Bafna; Vineet,0,0,0,0
1653618055579,CSE 290,B00,090136,Ramamoorthi; Ravi,0,0,0,0
1653618055579,CSE 290,C00,090137,Li; Tzumao,7,0,10,3
1653618055579,CSE 290,D00,090138,Zhou; Yuan-Yuan,9,0,10,1
1653618055579,CSE 290,E00,090139,Christensen; Henrik I,8,0,10,2
1653618055579,CSE 290,F00,094053,Shalev; Aaron D,0,0,0,0
1653618056107,CSE 291,A00,090140,Munyaka; Imani N. S.,0,0,0,0
1653618056107,CSE 291,B00,094880,Yu; Qi,0,0,0,0
1653618056107,CSE 291,C00,090142,Pannuto; Patrick William,0,0,0,0
1653618056107,CSE 291,D00,094881,Zhang; Yiying,0,0,0,0
1653618056107,CSE 291,E00,095118,Su; Hao,0,0,0,0
1653618056633,CSE 293,001,094905,Bafna; Vineet,9999,0,9999,0
1653618056633,CSE 293,002,094906,Bellare; Mihir,9999,0,9999,0
1653618056633,CSE 293,003,094907,Berg-Kirkpatrick; Taylor D,9999,0,9999,0
1653618056633,CSE 293,004,094908,Christensen; Henrik I,9999,0,9999,0
1653618056633,CSE 293,005,094909,Cottrell; Garrison W,9999,0,9999,0
1653618056633,CSE 293,006,094910,Deutsch; Alin Bernard,9999,0,9999,0
1653618056633,CSE 293,007,094911,Esmaeilzadeh; Hadi,9999,0,9999,0
1653618056633,CSE 293,008,094912,Freund; Yoav,9999,0,9999,0
1653618056633,CSE 293,009,094913,Griswold; William G.,9999,0,9999,0
1653618056633,CSE 293,010,094914,Gymrek; Melissa Ann,9999,0,9999,0
1653618056633,CSE 293,011,094915,Heninger; Nadia A,9999,0,9999,0
1653618056633,CSE 293,012,094916,Impagliazzo; Russell,9999,0,9999,0
1653618056633,CSE 293,013,094917,Jhala; Ranjit,9999,0,9999,0
1653618056633,CSE 293,014,094918,Kahng; Andrew Byun,9999,0,9999,0
1653618056633,CSE 293,015,094919,Kane; Daniel Mertz,9999,0,9999,0
1653618056633,CSE 293,016,094920,Kriegman; David J,9999,0,9999,0
1653618056633,CSE 293,017,094921,Kumar; Arun Kumar,9999,0,9999,0
1653618056633,CSE 293,018,094922,Lerner; Sorin,9999,0,9999,0
1653618056633,CSE 293,019,094923,Lovett; Shachar,9999,0,9999,0
1653618056633,CSE 293,020,094924,McAuley; Julian John,9999,0,9999,0
1653618056633,CSE 293,021,094925,Micciancio; Daniele,9999,0,9999,0
1653618056633,CSE 293,022,094926,Orailoglu; Alex,9999,0,9999,0
1653618056633,CSE 293,023,094927,Paturi; Ramamohan,9999,0,9999,0
1653618056633,CSE 293,024,094928,Polikarpova; Nadezhda,9999,0,9999,0
1653618056633,CSE 293,025,094929,Politz; Joseph Gibbs,9999,0,9999,0
1653618056633,CSE 293,026,094930,Porter; George M,9999,0,9999,0
1653618056633,CSE 293,027,094931,Porter; Leonard Emerson,9999,0,9999,0
1653618056633,CSE 293,028,094932,Ramamoorthi; Ravi,9999,0,9999,0
1653618056633,CSE 293,029,094933,Sahoo; Debashis,9999,0,9999,0
1653618056633,CSE 293,030,094934,Saul; Lawrence,9999,0,9999,0
1653618056633,CSE 293,031,094935,Savage; Stefan,9999,0,9999,0
1653618056633,CSE 293,032,094936,Schulze; Jurgen P.,9999,0,9999,0
1653618056633,CSE 293,033,094937,Snoeren; Alex C.,9999,0,9999,0
1653618056633,CSE 293,034,094938,Shang; Jingbo,9999,0,9999,0
1653618056633,CSE 293,035,094939,Stefan; Deian,9999,0,9999,0
1653618056633,CSE 293,036,094940,Su; Hao,9999,0,9999,0
1653618056633,CSE 293,037,094941,Swanson; Steven James,9999,0,9999,0
1653618056633,CSE 293,038,094942,Tullsen; Dean Michael,9999,0,9999,0
1653618056633,CSE 293,039,094943,Voelker; Geoffrey M.,9999,0,9999,0
1653618056633,CSE 293,040,094944,Zhao; Jishen,9999,0,9999,0
1653618056633,CSE 293,041,094945,Zhou; Yuan-Yuan,9999,0,9999,0
1653618056633,CSE 293,042,094946,Gao; Sicun,9998,0,9999,1
1653618056633,CSE 293,043,094947,Weibel; Nadir,9999,0,9999,0
1653618056633,CSE 293,044,094948,Gupta; Rajesh K.,9999,0,9999,0
1653618057157,CSE 294,A00,090143,Porter; George M,9,0,10,1
1653618057683,DSE 200,A00,091799,Staff,50,0,50,0
1653618058211,DSE 203,A00,091800,Gupta; Amarnath,30,0,30,0
1653618058746,DSE 250,A00,091801,Deutsch; Alin Bernard,30,0,30,0
1653618059276,DSE 290,A00,091802,Altintas De Callaf; Ilkay,50,0,50,0
1653618059899,ECE 200,001,091003,Antipa; Nicholas A,9999,0,9999,0
1653618059899,ECE 200,002,091004,Atanasov; Nikolay A.,9999,0,9999,0
1653618059899,ECE 200,003,091005,Bharadia; Dinesh,9999,0,9999,0
1653618059899,ECE 200,004,091006,Cheng; Chung Kuan,9999,0,9999,0
1653618059899,ECE 200,005,091007,Cosman; Pamela C.,9999,0,9999,0
1653618059899,ECE 200,006,091008,Staff,9999,0,9999,0
1653618059899,ECE 200,007,091009,Dayeh; Shadi Ahmad,9999,0,9999,0
1653618059899,ECE 200,008,091010,Fainman; Yeshaiahu,9999,0,9999,0
1653618059899,ECE 200,009,091011,Ford; Joseph Earl,9999,0,9999,0
1653618059899,ECE 200,010,091012,Franceschetti; Massimo,9999,0,9999,0
1653618059899,ECE 200,011,091013,Fullerton; Eric E,9999,0,9999,0
1653618059899,ECE 200,012,091014,Galton; Ian A,9999,0,9999,0
1653618059899,ECE 200,013,091015,Gilja; Vikash,9999,0,9999,0
1653618059899,ECE 200,014,091016,Hall; Drew A.,9999,0,9999,0
1653618059899,ECE 200,015,091017,Hsueh; Tzu-Chien,9999,0,9999,0
1653618059899,ECE 200,016,091018,Javidi; Tara,9999,0,9999,0
1653618059899,ECE 200,017,091019,Kahng; Andrew Byun,9999,0,9999,0
1653618059899,ECE 200,018,091020,Kim; Young-Han,9999,0,9999,0
1653618059899,ECE 200,019,091021,Koushanfar; Farinaz,9999,0,9999,0
1653618059899,ECE 200,020,091022,Kuzum; Duygu,9999,0,9999,0
1653618059899,ECE 200,021,091023,Le; Hanh-Phuc,9999,0,9999,0
1653618059899,ECE 200,022,091024,Lin; Bill,9999,0,9999,0
1653618059899,ECE 200,023,091025,Liu; Zhaowei,9999,0,9999,0
1653618059899,ECE 200,024,091026,Lo; Yu-Hwa,9999,0,9999,0
1653618059899,ECE 200,025,091027,Lomakin; Vitaliy,9999,0,9999,0
1653618059899,ECE 200,026,091028,Mercier; Patrick Philip,9999,0,9999,0
1653618059899,ECE 200,027,091029,Meyer; Florian,9999,0,9999,0
1653618059899,ECE 200,028,091030,Milstein; Laurence B.,9999,0,9999,0
1653618059899,ECE 200,029,091031,Mir Arabbaygi; Siavash,9999,0,9999,0
1653618059899,ECE 200,030,091032,Mookherjea; Shayan,9999,0,9999,0
1653618059899,ECE 200,031,091033,Morris; Karcher William,9999,0,9999,0
1653618059899,ECE 200,032,091034,Ng; Tse Nga,9999,0,9999,0
1653618059899,ECE 200,033,091035,Nguyen; Truong Quang,9999,0,9999,0
1653618059899,ECE 200,034,091036,Nomura; Kenji,9999,0,9999,0
1653618059899,ECE 200,035,091037,Orlitsky; Alon,9999,0,9999,0
1653618059899,ECE 200,036,091038,Pal; Piya,9999,0,9999,0
1653618059899,ECE 200,037,091039,Papen; George C.,9999,0,9999,0
1653618059899,ECE 200,038,091040,Radic; Stojan,9999,0,9999,0
1653618059899,ECE 200,039,091041,Rao; Bhaskar D.,9999,0,9999,0
1653618059899,ECE 200,040,091042,Rao; Ramesh R,9999,0,9999,0
1653618059899,ECE 200,041,091043,Rebeiz; Gabriel,9999,0,9999,0
1653618059899,ECE 200,042,091044,Sanford; John R,9999,0,9999,0
1653618059899,ECE 200,043,091045,Siegel; Paul H.,9999,0,9999,0
1653618059899,ECE 200,044,091046,Sievenpiper; Daniel F.,9999,0,9999,0
1653618059899,ECE 200,045,091047,Sworder; David D.,9999,0,9999,0
1653618059899,ECE 200,046,091048,Taur; Yuan,9999,0,9999,0
1653618059899,ECE 200,047,091049,Touri; Behrouz,9999,0,9999,0
1653618059899,ECE 200,048,091050,Trivedi; Mohan M.,9999,0,9999,0
1653618059899,ECE 200,049,091051,Vardy; Alexander,9999,0,9999,0
1653618059899,ECE 200,050,091052,Vasconcelos; Nuno,9999,0,9999,0
1653618059899,ECE 200,051,091053,Wang; Xiaolong,9999,0,9999,0
1653618059899,ECE 200,052,091054,Xie; Pengtao,9999,0,9999,0
1653618059899,ECE 200,053,091055,Yip; Michael,9999,0,9999,0
1653618059899,ECE 200,054,091056,Zeger; Kenneth A.,9999,0,9999,0
1653618059899,ECE 200,055,091057,Zhang; Xinyu,9999,0,9999,0
1653618059899,ECE 200,056,091058,Turakhia; Yatish Girish,9999,0,9999,0
1653618059899,ECE 200,057,091059,Kang; Mingu,9999,0,9999,0
1653618059899,ECE 200,058,091060,Shi; Yuanyuan,9999,0,9999,0
1653618059899,ECE 200,059,091061,Wang; Edward Jay,9999,0,9999,0
1653618059899,ECE 200,060,091062,Zheng; Yang,9999,0,9999,0
1653618060421,ECE 201,A00,095526,Lo; Yu-Hwa,0,0,0,0
1653618060948,ECE 203,A00,091065,Mercier; Patrick Philip,0,0,0,0
1653618061476,ECE 207A,A00,091605,Liu; Thomas Tao-Ming,0,0,0,0
1653618061999,ECE 212AN,A00,091068,Nomura; Kenji,0,0,0,0
1653618062525,ECE 222A,A00,091069,Rebeiz; Gabriel,0,0,0,0
1653618063049,ECE 225A,A00,091070,Orlitsky; Alon,0,0,0,0
1653618063575,ECE 230A,A00,091071,Nomura; Kenji,0,0,0,0
1653618064102,ECE 236A,A00,091072,Dayeh; Shadi Ahmad,0,0,0,0
1653618064624,ECE 238A,A00,091073,Luo; Jian,0,0,0,0
1653618064624,ECE 238A,B00,091074,Luo; Jian,0,0,0,0
1653618065153,ECE 240A,A00,091075,Radic; Stojan,0,0,0,0
1653618065678,ECE 247A,A00,091592,Shi; Lingyan,0,0,0,0
1653618066204,ECE 250,A00,091076,Touri; Behrouz,0,0,0,0
1653618066728,ECE 251C,A00,091078,Nguyen; Truong Quang,0,0,0,0
1653618067251,ECE 253,A00,091079,Cosman; Pamela C.,0,0,0,0
1653618067774,ECE 255A,A00,091080,Orlitsky; Alon,0,0,0,0
1653618068297,ECE 257A,A00,091081,Zhang; Xinyu,0,0,0,0
1653618068821,ECE 260A,A01,091084,Eldon; John,0,0,0,0
1653618069346,ECE 264C,A00,091085,Galton; Ian A,0,0,0,0
1653618069877,ECE 265C,A00,094889,Presti; Calogero Davide,0,0,0,9
1653618070403,ECE 266,A01,091087,Hall; Drew A.,0,0,0,0
1653618071454,ECE 271A,A00,091090,Vasconcelos; Nuno,0,0,0,0
1653618071982,ECE 272B,A00,091091,Sworder; David D.,0,0,0,0
1653618072508,ECE 275A,A00,091092,Meyer; Florian,0,0,0,0
1653618073034,ECE 277,A00,091093,An; Cheolhong,0,0,0,0
1653618073557,ECE 283,A00,091094,Le; Hanh-Phuc,0,0,0,0
1653618074084,ECE 284,A00,091095,Kang; Mingu,0,0,0,0
1653618074084,ECE 284,B00,091096,Wang; Edward Jay,0,0,0,0
1653618074606,ECE 285,A00,094334,Touri; Behrouz,0,0,0,0
1653618075130,ECE 289,A00,091097,Whelan; David Arthur,0,0,0,0
1653618075655,MATH 200A,A00,087414,Salehi Golsefidy; Alireza,7,0,8,1
1653618076178,MATH 202A,A00,087415,Gill; Philip E.,2,0,8,6
1653618076701,MATH 203A,A00,087416,Oprea; Dragos N.,6,0,8,2
1653618077238,MATH 204A,A00,087417,Kedlaya; Kiran S.,6,0,8,2
1653618077761,MATH 205,A00,087418,Sorensen; Claus M,6,0,8,2
1653618078283,MATH 206A,A00,087419,Izadi; Elham,6,0,8,2
1653618078814,MATH 207A,A00,087420,Mohammadi; Amir,5,0,8,3
1653618079340,MATH 208,A00,087421,Staff,8,0,10,2
1653618079865,MATH 209,A00,087422,Staff,10,0,10,0
1653618080394,MATH 218,A00,087423,Staff,10,0,10,0
1653618080916,MATH 220A,A00,087424,Novak; Jonathan I,6,0,8,2
1653618081439,MATH 231A,A00,087425,Bejenaru; Ioan,3,0,8,5
1653618081960,MATH 240A,A00,087426,Ebenfelt; Peter F,5,0,8,3
1653618082480,MATH 243,A00,087427,Staff,9,0,10,1
1653618083003,MATH 248,A00,087429,Staff,10,0,10,0
1653618083525,MATH 250A,A00,087430,Spolaor; Luca,4,0,8,4
1653618084050,MATH 257A,A00,087431,Spolaor; Luca,7,0,8,1
1653618084573,MATH 258,A00,087432,Staff,9,0,10,1
1653618085101,MATH 264A,A00,087433,Warnke; Lutz Peter,5,0,8,3
1653618085624,MATH 268,A00,087434,Staff,15,0,15,0
1653618086147,MATH 269,A00,087435,Staff,14,0,15,1
1653618086673,MATH 270A,A00,087436,Nie; Jiawang,0,0,8,8
1653618087200,MATH 272A,A00,087437,Tian; Xiaochuan,0,0,8,8
1653618087734,MATH 274,A01,087439,Cheng; Li-Tien,9,0,10,1
1653618087734,MATH 274,A02,087440,Cheng; Li-Tien,10,0,10,0
1653618088257,MATH 278A,A00,087441,Staff,8,0,10,2
1653618088781,MATH 278B,A00,087442,Staff,8,0,10,2
1653618089303,MATH 278C,A00,087443,Staff,8,0,10,2
1653618089827,MATH 280A,A00,087444,Zheng; Tianyi,0,0,8,8
1653618090350,MATH 281A,A00,087445,Bradic; Jelena,0,0,8,9
1653618090885,MATH 282A,A00,087446,Zhang; Danna,0,0,8,8
1653618091409,MATH 283,A00,087447,Tesler; Glenn,0,0,0,16
1653618091935,MATH 286,B00,095535,Kemp; Todd Aahron,5,0,8,3
1653618092458,MATH 287D,B00,095536,Bradic; Jelena,5,0,8,3
1653618092984,MATH 288,A00,087450,Staff,14,0,15,1
1653618092984,MATH 288,B00,087451,Staff,15,0,15,0
1653618092984,MATH 288,C00,087452,Staff,15,0,15,0
1653618093516,MATH 290A,A00,087453,Xu; Zhouli,6,0,8,2
1653618094044,MATH 291A,A00,087454,Xu; Zhouli,7,0,8,1
1653618094573,MATH 292,A00,087455,Staff,10,0,10,0
1653618095097,MATH 295,A00,087456,Staff,50,0,50,0
1653618095624,MATH 297,001,087457,Staff,997,0,999,2
1653618655385,COGS 200,A01,087991,Staff,47,0,50,3
1653618655919,COGS 201,A01,094504,Rangel; Lara M,16,0,25,9
1653618656444,COGS 203,A00,087992,Coulson; Seana M,18,0,20,2
1653618656970,COGS 210A,001,087993,Greene; Deanna Jacquelyn,9998,0,9999,1
1653618656970,COGS 210A,002,087994,Saygin; Ayse P,9999,0,9999,0
1653618656970,COGS 210A,003,087995,Xia; Haijun,9999,0,9999,0
1653618656970,COGS 210A,004,087996,Nitz; Douglas A.,9999,0,9999,0
1653618656970,COGS 210A,005,087997,Hollan; James D.,9999,0,9999,0
1653618656970,COGS 210A,006,087998,Deak; Gedeon O.,9998,0,9999,1
1653618656970,COGS 210A,007,087999,Rossano; Federico,9999,0,9999,0
1653618657494,COGS 211A,A00,088000,Coulson; Seana M,9997,0,9999,2
1653618658019,COGS 229,A00,088002,Staff,22,0,25,3
1653618658553,COGS 260,B00,094231,Staff,17,0,20,3
1653618658553,COGS 260,A00,088004,Nitz; Douglas A.,9998,0,9999,1
1653618659078,CSE 202,A00,090110,Paturi; Ramamohan,0,0,0,0
1653618659078,CSE 202,B00,090111,Paturi; Ramamohan,0,0,0,0
1653618659603,CSE 207B,A00,090112,Heninger; Nadia A,0,0,0,0
1653618660126,CSE 208,A00,094858,Micciancio; Daniele,0,0,0,0
1653618660649,CSE 210,A00,090113,Powell; Thomas Allan,0,0,0,0
1653618661179,CSE 219,A00,090898,Staff,0,0,0,0
1653618661702,CSE 221,A00,090114,Zhou; Yuan-Yuan,0,0,0,0
1653618662225,CSE 229A,A00,090115,Porter; George M,0,0,0,0
1653618662749,CSE 229C,A00,090116,Savage; Stefan,0,0,0,0
1653618663276,CSE 230,A00,090117,Jhala; Ranjit,0,0,0,0
1653618663805,CSE 232,A00,090118,Papakonstantinou; Yannis,0,0,0,0
1653618664329,CSE 239A,A00,090121,Kumar; Arun Kumar,0,0,0,0
1653618664855,CSE 239B,A00,090122,Jhala; Ranjit,0,0,0,0
1653618665380,CSE 240A,A00,090123,Zhao; Jishen,0,0,189,189
1653618665908,CSE 243A,A00,090124,Orailoglu; Alex,0,0,15,15
1653618666430,CSE 249B,A00,090125,Kahng; Andrew Byun,12,0,20,8
1653618666955,CSE 250A,A00,090126,Berg-Kirkpatrick; Taylor D,0,0,0,0
1653618667480,CSE 252A,A00,090127,Ochoa; Benjamin Lawrence,0,0,0,0
1653618668003,CSE 258,A01,090129,McAuley; Julian John,0,0,0,0
1653618668525,CSE 258R,A01,090131,McAuley; Julian John,0,0,0,0
1653618669060,CSE 274,A00,090132,Ramamoorthi; Ravi,0,0,0,0
1653618669588,CSE 276A,A00,090133,Christensen; Henrik I,0,0,0,0
1653618670111,CSE 276C,A00,090134,Christensen; Henrik I,0,0,0,0
1653618670639,CSE 290,A00,090135,Bafna; Vineet,0,0,0,0
1653618670639,CSE 290,B00,090136,Ramamoorthi; Ravi,0,0,0,0
1653618670639,CSE 290,C00,090137,Li; Tzumao,7,0,10,3
1653618670639,CSE 290,D00,090138,Zhou; Yuan-Yuan,9,0,10,1
1653618670639,CSE 290,E00,090139,Christensen; Henrik I,8,0,10,2
1653618670639,CSE 290,F00,094053,Shalev; Aaron D,0,0,0,0
1653618671168,CSE 291,A00,090140,Munyaka; Imani N. S.,0,0,0,0
1653618671168,CSE 291,B00,094880,Yu; Qi,0,0,0,0
1653618671168,CSE 291,C00,090142,Pannuto; Patrick William,0,0,0,0
1653618671168,CSE 291,D00,094881,Zhang; Yiying,0,0,0,0
1653618671168,CSE 291,E00,095118,Su; Hao,0,0,0,0
1653618671708,CSE 293,001,094905,Bafna; Vineet,9999,0,9999,0
1653618671708,CSE 293,002,094906,Bellare; Mihir,9999,0,9999,0
1653618671708,CSE 293,003,094907,Berg-Kirkpatrick; Taylor D,9999,0,9999,0
1653618671708,CSE 293,004,094908,Christensen; Henrik I,9999,0,9999,0
1653618671708,CSE 293,005,094909,Cottrell; Garrison W,9999,0,9999,0
1653618671708,CSE 293,006,094910,Deutsch; Alin Bernard,9999,0,9999,0
1653618671708,CSE 293,007,094911,Esmaeilzadeh; Hadi,9999,0,9999,0
1653618671708,CSE 293,008,094912,Freund; Yoav,9999,0,9999,0
1653618671708,CSE 293,009,094913,Griswold; William G.,9999,0,9999,0
1653618671708,CSE 293,010,094914,Gymrek; Melissa Ann,9999,0,9999,0
1653618671708,CSE 293,011,094915,Heninger; Nadia A,9999,0,9999,0
1653618671708,CSE 293,012,094916,Impagliazzo; Russell,9999,0,9999,0
1653618671708,CSE 293,013,094917,Jhala; Ranjit,9999,0,9999,0
1653618671708,CSE 293,014,094918,Kahng; Andrew Byun,9999,0,9999,0
1653618671708,CSE 293,015,094919,Kane; Daniel Mertz,9999,0,9999,0
1653618671708,CSE 293,016,094920,Kriegman; David J,9999,0,9999,0
1653618671708,CSE 293,017,094921,Kumar; Arun Kumar,9999,0,9999,0
1653618671708,CSE 293,018,094922,Lerner; Sorin,9999,0,9999,0
1653618671708,CSE 293,019,094923,Lovett; Shachar,9999,0,9999,0
1653618671708,CSE 293,020,094924,McAuley; Julian John,9999,0,9999,0
1653618671708,CSE 293,021,094925,Micciancio; Daniele,9999,0,9999,0
1653618671708,CSE 293,022,094926,Orailoglu; Alex,9999,0,9999,0
1653618671708,CSE 293,023,094927,Paturi; Ramamohan,9999,0,9999,0
1653618671708,CSE 293,024,094928,Polikarpova; Nadezhda,9999,0,9999,0
1653618671708,CSE 293,025,094929,Politz; Joseph Gibbs,9999,0,9999,0
1653618671708,CSE 293,026,094930,Porter; George M,9999,0,9999,0
1653618671708,CSE 293,027,094931,Porter; Leonard Emerson,9999,0,9999,0
1653618671708,CSE 293,028,094932,Ramamoorthi; Ravi,9999,0,9999,0
1653618671708,CSE 293,029,094933,Sahoo; Debashis,9999,0,9999,0
1653618671708,CSE 293,030,094934,Saul; Lawrence,9999,0,9999,0
1653618671708,CSE 293,031,094935,Savage; Stefan,9999,0,9999,0
1653618671708,CSE 293,032,094936,Schulze; Jurgen P.,9999,0,9999,0
1653618671708,CSE 293,033,094937,Snoeren; Alex C.,9999,0,9999,0
1653618671708,CSE 293,034,094938,Shang; Jingbo,9999,0,9999,0
1653618671708,CSE 293,035,094939,Stefan; Deian,9999,0,9999,0
1653618671708,CSE 293,036,094940,Su; Hao,9999,0,9999,0
1653618671708,CSE 293,037,094941,Swanson; Steven James,9999,0,9999,0
1653618671708,CSE 293,038,094942,Tullsen; Dean Michael,9999,0,9999,0
1653618671708,CSE 293,039,094943,Voelker; Geoffrey M.,9999,0,9999,0
1653618671708,CSE 293,040,094944,Zhao; Jishen,9999,0,9999,0
1653618671708,CSE 293,041,094945,Zhou; Yuan-Yuan,9999,0,9999,0
1653618671708,CSE 293,042,094946,Gao; Sicun,9998,0,9999,1
1653618671708,CSE 293,043,094947,Weibel; Nadir,9999,0,9999,0
1653618671708,CSE 293,044,094948,Gupta; Rajesh K.,9999,0,9999,0
1653618672231,CSE 294,A00,090143,Porter; George M,9,0,10,1
1653618672758,DSE 200,A00,091799,Staff,50,0,50,0
1653618673284,DSE 203,A00,091800,Gupta; Amarnath,30,0,30,0
1653618673808,DSE 250,A00,091801,Deutsch; Alin Bernard,30,0,30,0
1653618674342,DSE 290,A00,091802,Altintas De Callaf; Ilkay,50,0,50,0
1653618674877,ECE 200,001,091003,Antipa; Nicholas A,9999,0,9999,0
1653618674877,ECE 200,002,091004,Atanasov; Nikolay A.,9999,0,9999,0
1653618674877,ECE 200,003,091005,Bharadia; Dinesh,9999,0,9999,0
1653618674877,ECE 200,004,091006,Cheng; Chung Kuan,9999,0,9999,0
1653618674877,ECE 200,005,091007,Cosman; Pamela C.,9999,0,9999,0
1653618674877,ECE 200,006,091008,Staff,9999,0,9999,0
1653618674877,ECE 200,007,091009,Dayeh; Shadi Ahmad,9999,0,9999,0
1653618674877,ECE 200,008,091010,Fainman; Yeshaiahu,9999,0,9999,0
1653618674877,ECE 200,009,091011,Ford; Joseph Earl,9999,0,9999,0
1653618674877,ECE 200,010,091012,Franceschetti; Massimo,9999,0,9999,0
1653618674877,ECE 200,011,091013,Fullerton; Eric E,9999,0,9999,0
1653618674877,ECE 200,012,091014,Galton; Ian A,9999,0,9999,0
1653618674877,ECE 200,013,091015,Gilja; Vikash,9999,0,9999,0
1653618674877,ECE 200,014,091016,Hall; Drew A.,9999,0,9999,0
1653618674877,ECE 200,015,091017,Hsueh; Tzu-Chien,9999,0,9999,0
1653618674877,ECE 200,016,091018,Javidi; Tara,9999,0,9999,0
1653618674877,ECE 200,017,091019,Kahng; Andrew Byun,9999,0,9999,0
1653618674877,ECE 200,018,091020,Kim; Young-Han,9999,0,9999,0
1653618674877,ECE 200,019,091021,Koushanfar; Farinaz,9999,0,9999,0
1653618674877,ECE 200,020,091022,Kuzum; Duygu,9999,0,9999,0
1653618674877,ECE 200,021,091023,Le; Hanh-Phuc,9999,0,9999,0
1653618674877,ECE 200,022,091024,Lin; Bill,9999,0,9999,0
1653618674877,ECE 200,023,091025,Liu; Zhaowei,9999,0,9999,0
1653618674877,ECE 200,024,091026,Lo; Yu-Hwa,9999,0,9999,0
1653618674877,ECE 200,025,091027,Lomakin; Vitaliy,9999,0,9999,0
1653618674877,ECE 200,026,091028,Mercier; Patrick Philip,9999,0,9999,0
1653618674877,ECE 200,027,091029,Meyer; Florian,9999,0,9999,0
1653618674877,ECE 200,028,091030,Milstein; Laurence B.,9999,0,9999,0
1653618674877,ECE 200,029,091031,Mir Arabbaygi; Siavash,9999,0,9999,0
1653618674877,ECE 200,030,091032,Mookherjea; Shayan,9999,0,9999,0
1653618674877,ECE 200,031,091033,Morris; Karcher William,9999,0,9999,0
1653618674877,ECE 200,032,091034,Ng; Tse Nga,9999,0,9999,0
1653618674877,ECE 200,033,091035,Nguyen; Truong Quang,9999,0,9999,0
1653618674877,ECE 200,034,091036,Nomura; Kenji,9999,0,9999,0
1653618674877,ECE 200,035,091037,Orlitsky; Alon,9999,0,9999,0
1653618674877,ECE 200,036,091038,Pal; Piya,9999,0,9999,0
1653618674877,ECE 200,037,091039,Papen; George C.,9999,0,9999,0
1653618674877,ECE 200,038,091040,Radic; Stojan,9999,0,9999,0
1653618674877,ECE 200,039,091041,Rao; Bhaskar D.,9999,0,9999,0
1653618674877,ECE 200,040,091042,Rao; Ramesh R,9999,0,9999,0
1653618674877,ECE 200,041,091043,Rebeiz; Gabriel,9999,0,9999,0
1653618674877,ECE 200,042,091044,Sanford; John R,9999,0,9999,0
1653618674877,ECE 200,043,091045,Siegel; Paul H.,9999,0,9999,0
1653618674877,ECE 200,044,091046,Sievenpiper; Daniel F.,9999,0,9999,0
1653618674877,ECE 200,045,091047,Sworder; David D.,9999,0,9999,0
1653618674877,ECE 200,046,091048,Taur; Yuan,9999,0,9999,0
1653618674877,ECE 200,047,091049,Touri; Behrouz,9999,0,9999,0
1653618674877,ECE 200,048,091050,Trivedi; Mohan M.,9999,0,9999,0
1653618674877,ECE 200,049,091051,Vardy; Alexander,9999,0,9999,0
1653618674877,ECE 200,050,091052,Vasconcelos; Nuno,9999,0,9999,0
1653618674877,ECE 200,051,091053,Wang; Xiaolong,9999,0,9999,0
1653618674877,ECE 200,052,091054,Xie; Pengtao,9999,0,9999,0
1653618674877,ECE 200,053,091055,Yip; Michael,9999,0,9999,0
1653618674877,ECE 200,054,091056,Zeger; Kenneth A.,9999,0,9999,0
1653618674877,ECE 200,055,091057,Zhang; Xinyu,9999,0,9999,0
1653618674877,ECE 200,056,091058,Turakhia; Yatish Girish,9999,0,9999,0
1653618674877,ECE 200,057,091059,Kang; Mingu,9999,0,9999,0
1653618674877,ECE 200,058,091060,Shi; Yuanyuan,9999,0,9999,0
1653618674877,ECE 200,059,091061,Wang; Edward Jay,9999,0,9999,0
1653618674877,ECE 200,060,091062,Zheng; Yang,9999,0,9999,0
1653618675405,ECE 201,A00,095526,Lo; Yu-Hwa,0,0,0,0
1653618675930,ECE 203,A00,091065,Mercier; Patrick Philip,0,0,0,0
1653618676455,ECE 207A,A00,091605,Liu; Thomas Tao-Ming,0,0,0,0
1653618676977,ECE 212AN,A00,091068,Nomura; Kenji,0,0,0,0
1653618677501,ECE 222A,A00,091069,Rebeiz; Gabriel,0,0,0,0
1653618678027,ECE 225A,A00,091070,Orlitsky; Alon,0,0,0,0
1653618678564,ECE 230A,A00,091071,Nomura; Kenji,0,0,0,0
1653618679088,ECE 236A,A00,091072,Dayeh; Shadi Ahmad,0,0,0,0
1653618679615,ECE 238A,A00,091073,Luo; Jian,0,0,0,0
1653618679615,ECE 238A,B00,091074,Luo; Jian,0,0,0,0
1653618680137,ECE 240A,A00,091075,Radic; Stojan,0,0,0,0
1653618680666,ECE 247A,A00,091592,Shi; Lingyan,0,0,0,0
1653618681188,ECE 250,A00,091076,Touri; Behrouz,0,0,0,0
1653618681710,ECE 251C,A00,091078,Nguyen; Truong Quang,0,0,0,0
1653618682232,ECE 253,A00,091079,Cosman; Pamela C.,0,0,0,0
1653618682761,ECE 255A,A00,091080,Orlitsky; Alon,0,0,0,0
1653618683288,ECE 257A,A00,091081,Zhang; Xinyu,0,0,0,0
1653618683812,ECE 260A,A01,091084,Eldon; John,0,0,0,0
1653618684335,ECE 264C,A00,091085,Galton; Ian A,0,0,0,0
1653618684859,ECE 265C,A00,094889,Presti; Calogero Davide,0,0,0,9
1653618685383,ECE 266,A01,091087,Hall; Drew A.,0,0,0,0
1653618686430,ECE 271A,A00,091090,Vasconcelos; Nuno,0,0,0,0
1653618686955,ECE 272B,A00,091091,Sworder; David D.,0,0,0,0
1653618687484,ECE 275A,A00,091092,Meyer; Florian,0,0,0,0
1653618688014,ECE 277,A00,091093,An; Cheolhong,0,0,0,0
1653618688537,ECE 283,A00,091094,Le; Hanh-Phuc,0,0,0,0
1653618689065,ECE 284,A00,091095,Kang; Mingu,0,0,0,0
1653618689065,ECE 284,B00,091096,Wang; Edward Jay,0,0,0,0
1653618689591,ECE 285,A00,094334,Touri; Behrouz,0,0,0,0
1653618690113,ECE 289,A00,091097,Whelan; David Arthur,0,0,0,0
1653618690637,MATH 200A,A00,087414,Salehi Golsefidy; Alireza,7,0,8,1
1653618691161,MATH 202A,A00,087415,Gill; Philip E.,2,0,8,6
1653618691686,MATH 203A,A00,087416,Oprea; Dragos N.,6,0,8,2
1653618692208,MATH 204A,A00,087417,Kedlaya; Kiran S.,6,0,8,2
1653618692731,MATH 205,A00,087418,Sorensen; Claus M,6,0,8,2
1653618693254,MATH 206A,A00,087419,Izadi; Elham,6,0,8,2
1653618693777,MATH 207A,A00,087420,Mohammadi; Amir,5,0,8,3
1653618694314,MATH 208,A00,087421,Staff,8,0,10,2
1653618694840,MATH 209,A00,087422,Staff,10,0,10,0
1653618695365,MATH 218,A00,087423,Staff,10,0,10,0
1653618695889,MATH 220A,A00,087424,Novak; Jonathan I,6,0,8,2
1653618696412,MATH 231A,A00,087425,Bejenaru; Ioan,3,0,8,5
1653618696935,MATH 240A,A00,087426,Ebenfelt; Peter F,5,0,8,3
1653618697471,MATH 243,A00,087427,Staff,9,0,10,1
1653618697994,MATH 248,A00,087429,Staff,10,0,10,0
1653618698518,MATH 250A,A00,087430,Spolaor; Luca,4,0,8,4
1653618699039,MATH 257A,A00,087431,Spolaor; Luca,7,0,8,1
1653618699574,MATH 258,A00,087432,Staff,9,0,10,1
1653618700195,MATH 264A,A00,087433,Warnke; Lutz Peter,5,0,8,3
1653618700721,MATH 268,A00,087434,Staff,15,0,15,0
1653618701247,MATH 269,A00,087435,Staff,14,0,15,1
1653618701773,MATH 270A,A00,087436,Nie; Jiawang,0,0,8,8
1653618702299,MATH 272A,A00,087437,Tian; Xiaochuan,0,0,8,8
1653618702825,MATH 274,A01,087439,Cheng; Li-Tien,9,0,10,1
1653618702825,MATH 274,A02,087440,Cheng; Li-Tien,10,0,10,0
1653618703351,MATH 278A,A00,087441,Staff,8,0,10,2
1653618703882,MATH 278B,A00,087442,Staff,8,0,10,2
1653618704412,MATH 278C,A00,087443,Staff,8,0,10,2
1653618704935,MATH 280A,A00,087444,Zheng; Tianyi,0,0,8,8
1653618705458,MATH 281A,A00,087445,Bradic; Jelena,0,0,8,9
1653618705982,MATH 282A,A00,087446,Zhang; Danna,0,0,8,8
1653618706506,MATH 283,A00,087447,Tesler; Glenn,0,0,0,16
1653618707029,MATH 286,B00,095535,Kemp; Todd Aahron,5,0,8,3
1653618707564,MATH 287D,B00,095536,Bradic; Jelena,5,0,8,3
1653618708087,MATH 288,A00,087450,Staff,14,0,15,1
1653618708087,MATH 288,B00,087451,Staff,15,0,15,0
1653618708087,MATH 288,C00,087452,Staff,15,0,15,0
1653618708609,MATH 290A,A00,087453,Xu; Zhouli,6,0,8,2
1653618709132,MATH 291A,A00,087454,Xu; Zhouli,7,0,8,1
1653618709655,MATH 292,A00,087455,Staff,10,0,10,0
1653618710177,MATH 295,A00,087456,Staff,50,0,50,0
1653618710706,MATH 297,001,087457,Staff,997,0,999,2
1653619269771,COGS 200,A01,087991,Staff,47,0,50,3
1653619270294,COGS 201,A01,094504,Rangel; Lara M,16,0,25,9
1653619270822,COGS 203,A00,087992,Coulson; Seana M,18,0,20,2
1653619271345,COGS 210A,001,087993,Greene; Deanna Jacquelyn,9998,0,9999,1
1653619271345,COGS 210A,002,087994,Saygin; Ayse P,9999,0,9999,0
1653619271345,COGS 210A,003,087995,Xia; Haijun,9999,0,9999,0
1653619271345,COGS 210A,004,087996,Nitz; Douglas A.,9999,0,9999,0
1653619271345,COGS 210A,005,087997,Hollan; James D.,9999,0,9999,0
1653619271345,COGS 210A,006,087998,Deak; Gedeon O.,9998,0,9999,1
1653619271345,COGS 210A,007,087999,Rossano; Federico,9999,0,9999,0
1653619271880,COGS 211A,A00,088000,Coulson; Seana M,9997,0,9999,2
1653619272405,COGS 229,A00,088002,Staff,22,0,25,3
1653619272927,COGS 260,B00,094231,Staff,17,0,20,3
1653619272927,COGS 260,A00,088004,Nitz; Douglas A.,9998,0,9999,1
1653619273452,CSE 202,A00,090110,Paturi; Ramamohan,0,0,0,0
1653619273452,CSE 202,B00,090111,Paturi; Ramamohan,0,0,0,0
1653619273979,CSE 207B,A00,090112,Heninger; Nadia A,0,0,0,0
1653619274501,CSE 208,A00,094858,Micciancio; Daniele,0,0,0,0
1653619275039,CSE 210,A00,090113,Powell; Thomas Allan,0,0,0,0
1653619275563,CSE 219,A00,090898,Staff,0,0,0,0
1653619276086,CSE 221,A00,090114,Zhou; Yuan-Yuan,0,0,0,0
1653619276611,CSE 229A,A00,090115,Porter; George M,0,0,0,0
1653619277136,CSE 229C,A00,090116,Savage; Stefan,0,0,0,0
1653619277658,CSE 230,A00,090117,Jhala; Ranjit,0,0,0,0
1653619278180,CSE 232,A00,090118,Papakonstantinou; Yannis,0,0,0,0
1653619278705,CSE 239A,A00,090121,Kumar; Arun Kumar,0,0,0,0
1653619279228,CSE 239B,A00,090122,Jhala; Ranjit,0,0,0,0
1653619279751,CSE 240A,A00,090123,Zhao; Jishen,0,0,189,189
1653619280274,CSE 243A,A00,090124,Orailoglu; Alex,0,0,15,15
1653619280796,CSE 249B,A00,090125,Kahng; Andrew Byun,12,0,20,8
1653619281322,CSE 250A,A00,090126,Berg-Kirkpatrick; Taylor D,0,0,0,0
1653619281848,CSE 252A,A00,090127,Ochoa; Benjamin Lawrence,0,0,0,0
1653619282374,CSE 258,A01,090129,McAuley; Julian John,0,0,0,0
1653619282899,CSE 258R,A01,090131,McAuley; Julian John,0,0,0,0
1653619283421,CSE 274,A00,090132,Ramamoorthi; Ravi,0,0,0,0
1653619283951,CSE 276A,A00,090133,Christensen; Henrik I,0,0,0,0
1653619284477,CSE 276C,A00,090134,Christensen; Henrik I,0,0,0,0
1653619285003,CSE 290,A00,090135,Bafna; Vineet,0,0,0,0
1653619285003,CSE 290,B00,090136,Ramamoorthi; Ravi,0,0,0,0
1653619285003,CSE 290,C00,090137,Li; Tzumao,7,0,10,3
1653619285003,CSE 290,D00,090138,Zhou; Yuan-Yuan,9,0,10,1
1653619285003,CSE 290,E00,090139,Christensen; Henrik I,8,0,10,2
1653619285003,CSE 290,F00,094053,Shalev; Aaron D,0,0,0,0
1653619285526,CSE 291,A00,090140,Munyaka; Imani N. S.,0,0,0,0
1653619285526,CSE 291,B00,094880,Yu; Qi,0,0,0,0
1653619285526,CSE 291,C00,090142,Pannuto; Patrick William,0,0,0,0
1653619285526,CSE 291,D00,094881,Zhang; Yiying,0,0,0,0
1653619285526,CSE 291,E00,095118,Su; Hao,0,0,0,0
1653619286086,CSE 293,001,094905,Bafna; Vineet,9999,0,9999,0
1653619286086,CSE 293,002,094906,Bellare; Mihir,9999,0,9999,0
1653619286086,CSE 293,003,094907,Berg-Kirkpatrick; Taylor D,9999,0,9999,0
1653619286086,CSE 293,004,094908,Christensen; Henrik I,9999,0,9999,0
1653619286086,CSE 293,005,094909,Cottrell; Garrison W,9999,0,9999,0
1653619286086,CSE 293,006,094910,Deutsch; Alin Bernard,9999,0,9999,0
1653619286086,CSE 293,007,094911,Esmaeilzadeh; Hadi,9999,0,9999,0
1653619286086,CSE 293,008,094912,Freund; Yoav,9999,0,9999,0
1653619286086,CSE 293,009,094913,Griswold; William G.,9999,0,9999,0
1653619286086,CSE 293,010,094914,Gymrek; Melissa Ann,9999,0,9999,0
1653619286086,CSE 293,011,094915,Heninger; Nadia A,9999,0,9999,0
1653619286086,CSE 293,012,094916,Impagliazzo; Russell,9999,0,9999,0
1653619286086,CSE 293,013,094917,Jhala; Ranjit,9999,0,9999,0
1653619286086,CSE 293,014,094918,Kahng; Andrew Byun,9999,0,9999,0
1653619286086,CSE 293,015,094919,Kane; Daniel Mertz,9999,0,9999,0
1653619286086,CSE 293,016,094920,Kriegman; David J,9999,0,9999,0
1653619286086,CSE 293,017,094921,Kumar; Arun Kumar,9999,0,9999,0
1653619286086,CSE 293,018,094922,Lerner; Sorin,9999,0,9999,0
1653619286086,CSE 293,019,094923,Lovett; Shachar,9999,0,9999,0
1653619286086,CSE 293,020,094924,McAuley; Julian John,9999,0,9999,0
1653619286086,CSE 293,021,094925,Micciancio; Daniele,9999,0,9999,0
1653619286086,CSE 293,022,094926,Orailoglu; Alex,9999,0,9999,0
1653619286086,CSE 293,023,094927,Paturi; Ramamohan,9999,0,9999,0
1653619286086,CSE 293,024,094928,Polikarpova; Nadezhda,9999,0,9999,0
1653619286086,CSE 293,025,094929,Politz; Joseph Gibbs,9999,0,9999,0
1653619286086,CSE 293,026,094930,Porter; George M,9999,0,9999,0
1653619286086,CSE 293,027,094931,Porter; Leonard Emerson,9999,0,9999,0
1653619286086,CSE 293,028,094932,Ramamoorthi; Ravi,9999,0,9999,0
1653619286086,CSE 293,029,094933,Sahoo; Debashis,9999,0,9999,0
1653619286086,CSE 293,030,094934,Saul; Lawrence,9999,0,9999,0
1653619286086,CSE 293,031,094935,Savage; Stefan,9999,0,9999,0
1653619286086,CSE 293,032,094936,Schulze; Jurgen P.,9999,0,9999,0
1653619286086,CSE 293,033,094937,Snoeren; Alex C.,9999,0,9999,0
1653619286086,CSE 293,034,094938,Shang; Jingbo,9999,0,9999,0
1653619286086,CSE 293,035,094939,Stefan; Deian,9999,0,9999,0
1653619286086,CSE 293,036,094940,Su; Hao,9999,0,9999,0
1653619286086,CSE 293,037,094941,Swanson; Steven James,9999,0,9999,0
1653619286086,CSE 293,038,094942,Tullsen; Dean Michael,9999,0,9999,0
1653619286086,CSE 293,039,094943,Voelker; Geoffrey M.,9999,0,9999,0
1653619286086,CSE 293,040,094944,Zhao; Jishen,9999,0,9999,0
1653619286086,CSE 293,041,094945,Zhou; Yuan-Yuan,9999,0,9999,0
1653619286086,CSE 293,042,094946,Gao; Sicun,9998,0,9999,1
1653619286086,CSE 293,043,094947,Weibel; Nadir,9999,0,9999,0
1653619286086,CSE 293,044,094948,Gupta; Rajesh K.,9999,0,9999,0
1653619286698,CSE 294,A00,090143,Porter; George M,9,0,10,1
1653619287223,DSE 200,A00,091799,Staff,50,0,50,0
1653619287749,DSE 203,A00,091800,Gupta; Amarnath,30,0,30,0
1653619288272,DSE 250,A00,091801,Deutsch; Alin Bernard,30,0,30,0
1653619288794,DSE 290,A00,091802,Altintas De Callaf; Ilkay,50,0,50,0
1653619289338,ECE 200,001,091003,Antipa; Nicholas A,9999,0,9999,0
1653619289338,ECE 200,002,091004,Atanasov; Nikolay A.,9999,0,9999,0
1653619289338,ECE 200,003,091005,Bharadia; Dinesh,9999,0,9999,0
1653619289338,ECE 200,004,091006,Cheng; Chung Kuan,9999,0,9999,0
1653619289338,ECE 200,005,091007,Cosman; Pamela C.,9999,0,9999,0
1653619289338,ECE 200,006,091008,Staff,9999,0,9999,0
1653619289338,ECE 200,007,091009,Dayeh; Shadi Ahmad,9999,0,9999,0
1653619289338,ECE 200,008,091010,Fainman; Yeshaiahu,9999,0,9999,0
1653619289338,ECE 200,009,091011,Ford; Joseph Earl,9999,0,9999,0
1653619289338,ECE 200,010,091012,Franceschetti; Massimo,9999,0,9999,0
1653619289338,ECE 200,011,091013,Fullerton; Eric E,9999,0,9999,0
1653619289338,ECE 200,012,091014,Galton; Ian A,9999,0,9999,0
1653619289338,ECE 200,013,091015,Gilja; Vikash,9999,0,9999,0
1653619289338,ECE 200,014,091016,Hall; Drew A.,9999,0,9999,0
1653619289338,ECE 200,015,091017,Hsueh; Tzu-Chien,9999,0,9999,0
1653619289338,ECE 200,016,091018,Javidi; Tara,9999,0,9999,0
1653619289338,ECE 200,017,091019,Kahng; Andrew Byun,9999,0,9999,0
1653619289338,ECE 200,018,091020,Kim; Young-Han,9999,0,9999,0
1653619289338,ECE 200,019,091021,Koushanfar; Farinaz,9999,0,9999,0
1653619289338,ECE 200,020,091022,Kuzum; Duygu,9999,0,9999,0
1653619289338,ECE 200,021,091023,Le; Hanh-Phuc,9999,0,9999,0
1653619289338,ECE 200,022,091024,Lin; Bill,9999,0,9999,0
1653619289338,ECE 200,023,091025,Liu; Zhaowei,9999,0,9999,0
1653619289338,ECE 200,024,091026,Lo; Yu-Hwa,9999,0,9999,0
1653619289338,ECE 200,025,091027,Lomakin; Vitaliy,9999,0,9999,0
1653619289338,ECE 200,026,091028,Mercier; Patrick Philip,9999,0,9999,0
1653619289338,ECE 200,027,091029,Meyer; Florian,9999,0,9999,0
1653619289338,ECE 200,028,091030,Milstein; Laurence B.,9999,0,9999,0
1653619289338,ECE 200,029,091031,Mir Arabbaygi; Siavash,9999,0,9999,0
1653619289338,ECE 200,030,091032,Mookherjea; Shayan,9999,0,9999,0
1653619289338,ECE 200,031,091033,Morris; Karcher William,9999,0,9999,0
1653619289338,ECE 200,032,091034,Ng; Tse Nga,9999,0,9999,0
1653619289338,ECE 200,033,091035,Nguyen; Truong Quang,9999,0,9999,0
1653619289338,ECE 200,034,091036,Nomura; Kenji,9999,0,9999,0
1653619289338,ECE 200,035,091037,Orlitsky; Alon,9999,0,9999,0
1653619289338,ECE 200,036,091038,Pal; Piya,9999,0,9999,0
1653619289338,ECE 200,037,091039,Papen; George C.,9999,0,9999,0
1653619289338,ECE 200,038,091040,Radic; Stojan,9999,0,9999,0
1653619289338,ECE 200,039,091041,Rao; Bhaskar D.,9999,0,9999,0
1653619289338,ECE 200,040,091042,Rao; Ramesh R,9999,0,9999,0
1653619289338,ECE 200,041,091043,Rebeiz; Gabriel,9999,0,9999,0
1653619289338,ECE 200,042,091044,Sanford; John R,9999,0,9999,0
1653619289338,ECE 200,043,091045,Siegel; Paul H.,9999,0,9999,0
1653619289338,ECE 200,044,091046,Sievenpiper; Daniel F.,9999,0,9999,0
1653619289338,ECE 200,045,091047,Sworder; David D.,9999,0,9999,0
1653619289338,ECE 200,046,091048,Taur; Yuan,9999,0,9999,0
1653619289338,ECE 200,047,091049,Touri; Behrouz,9999,0,9999,0
1653619289338,ECE 200,048,091050,Trivedi; Mohan M.,9999,0,9999,0
1653619289338,ECE 200,049,091051,Vardy; Alexander,9999,0,9999,0
1653619289338,ECE 200,050,091052,Vasconcelos; Nuno,9999,0,9999,0
1653619289338,ECE 200,051,091053,Wang; Xiaolong,9999,0,9999,0
1653619289338,ECE 200,052,091054,Xie; Pengtao,9999,0,9999,0
1653619289338,ECE 200,053,091055,Yip; Michael,9999,0,9999,0
1653619289338,ECE 200,054,091056,Zeger; Kenneth A.,9999,0,9999,0
1653619289338,ECE 200,055,091057,Zhang; Xinyu,9999,0,9999,0
1653619289338,ECE 200,056,091058,Turakhia; Yatish Girish,9999,0,9999,0
1653619289338,ECE 200,057,091059,Kang; Mingu,9999,0,9999,0
1653619289338,ECE 200,058,091060,Shi; Yuanyuan,9999,0,9999,0
1653619289338,ECE 200,059,091061,Wang; Edward Jay,9999,0,9999,0
1653619289338,ECE 200,060,091062,Zheng; Yang,9999,0,9999,0
1653619289868,ECE 201,A00,095526,Lo; Yu-Hwa,0,0,0,0
1653619290393,ECE 203,A00,091065,Mercier; Patrick Philip,0,0,0,0
1653619290921,ECE 207A,A00,091605,Liu; Thomas Tao-Ming,0,0,0,0
1653619291447,ECE 212AN,A00,091068,Nomura; Kenji,0,0,0,0
1653619291971,ECE 222A,A00,091069,Rebeiz; Gabriel,0,0,0,0
1653619292501,ECE 225A,A00,091070,Orlitsky; Alon,0,0,0,0
1653619293030,ECE 230A,A00,091071,Nomura; Kenji,0,0,0,0
1653619293557,ECE 236A,A00,091072,Dayeh; Shadi Ahmad,0,0,0,0
1653619294083,ECE 238A,A00,091073,Luo; Jian,0,0,0,0
1653619294083,ECE 238A,B00,091074,Luo; Jian,0,0,0,0
1653619294609,ECE 240A,A00,091075,Radic; Stojan,0,0,0,0
1653619295136,ECE 247A,A00,091592,Shi; Lingyan,0,0,0,0
1653619295659,ECE 250,A00,091076,Touri; Behrouz,0,0,0,0
1653619296181,ECE 251C,A00,091078,Nguyen; Truong Quang,0,0,0,0
1653619296707,ECE 253,A00,091079,Cosman; Pamela C.,0,0,0,0
1653619297229,ECE 255A,A00,091080,Orlitsky; Alon,0,0,0,0
1653619297755,ECE 257A,A00,091081,Zhang; Xinyu,0,0,0,0
1653619298283,ECE 260A,A01,091084,Eldon; John,0,0,0,0
1653619298811,ECE 264C,A00,091085,Galton; Ian A,0,0,0,0
1653619299339,ECE 265C,A00,094889,Presti; Calogero Davide,0,0,0,9
1653619299864,ECE 266,A01,091087,Hall; Drew A.,0,0,0,0
1653619300919,ECE 271A,A00,091090,Vasconcelos; Nuno,0,0,0,0
1653619301445,ECE 272B,A00,091091,Sworder; David D.,0,0,0,0
1653619301966,ECE 275A,A00,091092,Meyer; Florian,0,0,0,0
1653619302492,ECE 277,A00,091093,An; Cheolhong,0,0,0,0
1653619303017,ECE 283,A00,091094,Le; Hanh-Phuc,0,0,0,0
1653619303544,ECE 284,A00,091095,Kang; Mingu,0,0,0,0
1653619303544,ECE 284,B00,091096,Wang; Edward Jay,0,0,0,0
1653619304070,ECE 285,A00,094334,Touri; Behrouz,0,0,0,0
1653619304597,ECE 289,A00,091097,Whelan; David Arthur,0,0,0,0
1653619305133,MATH 200A,A00,087414,Salehi Golsefidy; Alireza,7,0,8,1
1653619305668,MATH 202A,A00,087415,Gill; Philip E.,2,0,8,6
1653619306191,MATH 203A,A00,087416,Oprea; Dragos N.,6,0,8,2
1653619306714,MATH 204A,A00,087417,Kedlaya; Kiran S.,6,0,8,2
1653619307240,MATH 205,A00,087418,Sorensen; Claus M,6,0,8,2
1653619307766,MATH 206A,A00,087419,Izadi; Elham,6,0,8,2
1653619308290,MATH 207A,A00,087420,Mohammadi; Amir,5,0,8,3
1653619308815,MATH 208,A00,087421,Staff,8,0,10,2
1653619309338,MATH 209,A00,087422,Staff,10,0,10,0
1653619309870,MATH 218,A00,087423,Staff,10,0,10,0
1653619310392,MATH 220A,A00,087424,Novak; Jonathan I,6,0,8,2
1653619310915,MATH 231A,A00,087425,Bejenaru; Ioan,3,0,8,5
1653619311440,MATH 240A,A00,087426,Ebenfelt; Peter F,5,0,8,3
1653619311964,MATH 243,A00,087427,Staff,9,0,10,1
1653619312492,MATH 248,A00,087429,Staff,10,0,10,0
1653619313019,MATH 250A,A00,087430,Spolaor; Luca,4,0,8,4
1653619313544,MATH 257A,A00,087431,Spolaor; Luca,7,0,8,1
1653619314066,MATH 258,A00,087432,Staff,9,0,10,1
1653619314589,MATH 264A,A00,087433,Warnke; Lutz Peter,5,0,8,3
1653619315114,MATH 268,A00,087434,Staff,15,0,15,0
1653619315638,MATH 269,A00,087435,Staff,14,0,15,1
1653619316161,MATH 270A,A00,087436,Nie; Jiawang,0,0,8,8
1653619316688,MATH 272A,A00,087437,Tian; Xiaochuan,0,0,8,8
1653619317209,MATH 274,A01,087439,Cheng; Li-Tien,9,0,10,1
1653619317209,MATH 274,A02,087440,Cheng; Li-Tien,10,0,10,0
1653619317733,MATH 278A,A00,087441,Staff,8,0,10,2
1653619318257,MATH 278B,A00,087442,Staff,8,0,10,2
1653619318779,MATH 278C,A00,087443,Staff,8,0,10,2
1653619319303,MATH 280A,A00,087444,Zheng; Tianyi,0,0,8,8
1653619319831,MATH 281A,A00,087445,Bradic; Jelena,0,0,8,9
1653619320365,MATH 282A,A00,087446,Zhang; Danna,0,0,8,8
1653619320889,MATH 283,A00,087447,Tesler; Glenn,0,0,0,16
1653619321413,MATH 286,B00,095535,Kemp; Todd Aahron,5,0,8,3
1653619321935,MATH 287D,B00,095536,Bradic; Jelena,5,0,8,3
1653619322461,MATH 288,A00,087450,Staff,14,0,15,1
1653619322461,MATH 288,B00,087451,Staff,15,0,15,0
1653619322461,MATH 288,C00,087452,Staff,15,0,15,0
1653619322986,MATH 290A,A00,087453,Xu; Zhouli,6,0,8,2
1653619323509,MATH 291A,A00,087454,Xu; Zhouli,7,0,8,1
1653619324040,MATH 292,A00,087455,Staff,10,0,10,0
1653619324564,MATH 295,A00,087456,Staff,50,0,50,0
1653619325089,MATH 297,001,087457,Staff,997,0,999,2
1653619884244,COGS 200,A01,087991,Staff,47,0,50,3
1653619884768,COGS 201,A01,094504,Rangel; Lara M,16,0,25,9
1653619885295,COGS 203,A00,087992,Coulson; Seana M,18,0,20,2
1653619885825,COGS 210A,001,087993,Greene; Deanna Jacquelyn,9998,0,9999,1
1653619885825,COGS 210A,002,087994,Saygin; Ayse P,9999,0,9999,0
1653619885825,COGS 210A,003,087995,Xia; Haijun,9999,0,9999,0
1653619885825,COGS 210A,004,087996,Nitz; Douglas A.,9999,0,9999,0
1653619885825,COGS 210A,005,087997,Hollan; James D.,9999,0,9999,0
1653619885825,COGS 210A,006,087998,Deak; Gedeon O.,9998,0,9999,1
1653619885825,COGS 210A,007,087999,Rossano; Federico,9999,0,9999,0
1653619886347,COGS 211A,A00,088000,Coulson; Seana M,9997,0,9999,2
1653619886870,COGS 229,A00,088002,Staff,22,0,25,3
1653619887393,COGS 260,B00,094231,Staff,17,0,20,3
1653619887393,COGS 260,A00,088004,Nitz; Douglas A.,9998,0,9999,1
1653619887919,CSE 202,A00,090110,Paturi; Ramamohan,0,0,0,0
1653619887919,CSE 202,B00,090111,Paturi; Ramamohan,0,0,0,0
1653619888441,CSE 207B,A00,090112,Heninger; Nadia A,0,0,0,0
1653619888963,CSE 208,A00,094858,Micciancio; Daniele,0,0,0,0
1653619889486,CSE 210,A00,090113,Powell; Thomas Allan,0,0,0,0
1653619890010,CSE 219,A00,090898,Staff,0,0,0,0
1653619890533,CSE 221,A00,090114,Zhou; Yuan-Yuan,0,0,0,0
1653619891061,CSE 229A,A00,090115,Porter; George M,0,0,0,0
1653619891586,CSE 229C,A00,090116,Savage; Stefan,0,0,0,0
1653619892116,CSE 230,A00,090117,Jhala; Ranjit,0,0,0,0
1653619892642,CSE 232,A00,090118,Papakonstantinou; Yannis,0,0,0,0
1653619893171,CSE 239A,A00,090121,Kumar; Arun Kumar,0,0,0,0
1653619893694,CSE 239B,A00,090122,Jhala; Ranjit,0,0,0,0
1653619894217,CSE 240A,A00,090123,Zhao; Jishen,0,0,189,189
1653619894744,CSE 243A,A00,090124,Orailoglu; Alex,0,0,15,15
1653619895267,CSE 249B,A00,090125,Kahng; Andrew Byun,12,0,20,8
1653619895791,CSE 250A,A00,090126,Berg-Kirkpatrick; Taylor D,0,0,0,0
1653619896315,CSE 252A,A00,090127,Ochoa; Benjamin Lawrence,0,0,0,0
1653619896837,CSE 258,A01,090129,McAuley; Julian John,0,0,0,0
1653619897366,CSE 258R,A01,090131,McAuley; Julian John,0,0,0,0
1653619897890,CSE 274,A00,090132,Ramamoorthi; Ravi,0,0,0,0
1653619898415,CSE 276A,A00,090133,Christensen; Henrik I,0,0,0,0
1653619898940,CSE 276C,A00,090134,Christensen; Henrik I,0,0,0,0
1653619899463,CSE 290,A00,090135,Bafna; Vineet,0,0,0,0
1653619899463,CSE 290,B00,090136,Ramamoorthi; Ravi,0,0,0,0
1653619899463,CSE 290,C00,090137,Li; Tzumao,7,0,10,3
1653619899463,CSE 290,D00,090138,Zhou; Yuan-Yuan,9,0,10,1
1653619899463,CSE 290,E00,090139,Christensen; Henrik I,8,0,10,2
1653619899463,CSE 290,F00,094053,Shalev; Aaron D,0,0,0,0
1653619899985,CSE 291,A00,090140,Munyaka; Imani N. S.,0,0,0,0
1653619899985,CSE 291,B00,094880,Yu; Qi,0,0,0,0
1653619899985,CSE 291,C00,090142,Pannuto; Patrick William,0,0,0,0
1653619899985,CSE 291,D00,094881,Zhang; Yiying,0,0,0,0
1653619899985,CSE 291,E00,095118,Su; Hao,0,0,0,0
1653619900513,CSE 293,001,094905,Bafna; Vineet,9999,0,9999,0
1653619900513,CSE 293,002,094906,Bellare; Mihir,9999,0,9999,0
1653619900513,CSE 293,003,094907,Berg-Kirkpatrick; Taylor D,9999,0,9999,0
1653619900513,CSE 293,004,094908,Christensen; Henrik I,9999,0,9999,0
1653619900513,CSE 293,005,094909,Cottrell; Garrison W,9999,0,9999,0
1653619900513,CSE 293,006,094910,Deutsch; Alin Bernard,9999,0,9999,0
1653619900513,CSE 293,007,094911,Esmaeilzadeh; Hadi,9999,0,9999,0
1653619900513,CSE 293,008,094912,Freund; Yoav,9999,0,9999,0
1653619900513,CSE 293,009,094913,Griswold; William G.,9999,0,9999,0
1653619900513,CSE 293,010,094914,Gymrek; Melissa Ann,9999,0,9999,0
1653619900513,CSE 293,011,094915,Heninger; Nadia A,9999,0,9999,0
1653619900513,CSE 293,012,094916,Impagliazzo; Russell,9999,0,9999,0
1653619900513,CSE 293,013,094917,Jhala; Ranjit,9999,0,9999,0
1653619900513,CSE 293,014,094918,Kahng; Andrew Byun,9999,0,9999,0
1653619900513,CSE 293,015,094919,Kane; Daniel Mertz,9999,0,9999,0
1653619900513,CSE 293,016,094920,Kriegman; David J,9999,0,9999,0
1653619900513,CSE 293,017,094921,Kumar; Arun Kumar,9999,0,9999,0
1653619900513,CSE 293,018,094922,Lerner; Sorin,9999,0,9999,0
1653619900513,CSE 293,019,094923,Lovett; Shachar,9999,0,9999,0
1653619900513,CSE 293,020,094924,McAuley; Julian John,9999,0,9999,0
1653619900513,CSE 293,021,094925,Micciancio; Daniele,9999,0,9999,0
1653619900513,CSE 293,022,094926,Orailoglu; Alex,9999,0,9999,0
1653619900513,CSE 293,023,094927,Paturi; Ramamohan,9999,0,9999,0
1653619900513,CSE 293,024,094928,Polikarpova; Nadezhda,9999,0,9999,0
1653619900513,CSE 293,025,094929,Politz; Joseph Gibbs,9999,0,9999,0
1653619900513,CSE 293,026,094930,Porter; George M,9999,0,9999,0
1653619900513,CSE 293,027,094931,Porter; Leonard Emerson,9999,0,9999,0
1653619900513,CSE 293,028,094932,Ramamoorthi; Ravi,9999,0,9999,0
1653619900513,CSE 293,029,094933,Sahoo; Debashis,9999,0,9999,0
1653619900513,CSE 293,030,094934,Saul; Lawrence,9999,0,9999,0
1653619900513,CSE 293,031,094935,Savage; Stefan,9999,0,9999,0
1653619900513,CSE 293,032,094936,Schulze; Jurgen P.,9999,0,9999,0
1653619900513,CSE 293,033,094937,Snoeren; Alex C.,9999,0,9999,0
1653619900513,CSE 293,034,094938,Shang; Jingbo,9999,0,9999,0
1653619900513,CSE 293,035,094939,Stefan; Deian,9999,0,9999,0
1653619900513,CSE 293,036,094940,Su; Hao,9999,0,9999,0
1653619900513,CSE 293,037,094941,Swanson; Steven James,9999,0,9999,0
1653619900513,CSE 293,038,094942,Tullsen; Dean Michael,9999,0,9999,0
1653619900513,CSE 293,039,094943,Voelker; Geoffrey M.,9999,0,9999,0
1653619900513,CSE 293,040,094944,Zhao; Jishen,9999,0,9999,0
1653619900513,CSE 293,041,094945,Zhou; Yuan-Yuan,9999,0,9999,0
1653619900513,CSE 293,042,094946,Gao; Sicun,9998,0,9999,1
1653619900513,CSE 293,043,094947,Weibel; Nadir,9999,0,9999,0
1653619900513,CSE 293,044,094948,Gupta; Rajesh K.,9999,0,9999,0
1653619901040,CSE 294,A00,090143,Porter; George M,9,0,10,1
1653619901568,DSE 200,A00,091799,Staff,50,0,50,0
1653619902093,DSE 203,A00,091800,Gupta; Amarnath,30,0,30,0
1653619902615,DSE 250,A00,091801,Deutsch; Alin Bernard,30,0,30,0
1653619903144,DSE 290,A00,091802,Altintas De Callaf; Ilkay,50,0,50,0
1653619903676,ECE 200,001,091003,Antipa; Nicholas A,9999,0,9999,0
1653619903676,ECE 200,002,091004,Atanasov; Nikolay A.,9999,0,9999,0
1653619903676,ECE 200,003,091005,Bharadia; Dinesh,9999,0,9999,0
1653619903676,ECE 200,004,091006,Cheng; Chung Kuan,9999,0,9999,0
1653619903676,ECE 200,005,091007,Cosman; Pamela C.,9999,0,9999,0
1653619903676,ECE 200,006,091008,Staff,9999,0,9999,0
1653619903676,ECE 200,007,091009,Dayeh; Shadi Ahmad,9999,0,9999,0
1653619903676,ECE 200,008,091010,Fainman; Yeshaiahu,9999,0,9999,0
1653619903676,ECE 200,009,091011,Ford; Joseph Earl,9999,0,9999,0
1653619903676,ECE 200,010,091012,Franceschetti; Massimo,9999,0,9999,0
1653619903676,ECE 200,011,091013,Fullerton; Eric E,9999,0,9999,0
1653619903676,ECE 200,012,091014,Galton; Ian A,9999,0,9999,0
1653619903676,ECE 200,013,091015,Gilja; Vikash,9999,0,9999,0
1653619903676,ECE 200,014,091016,Hall; Drew A.,9999,0,9999,0
1653619903676,ECE 200,015,091017,Hsueh; Tzu-Chien,9999,0,9999,0
1653619903676,ECE 200,016,091018,Javidi; Tara,9999,0,9999,0
1653619903676,ECE 200,017,091019,Kahng; Andrew Byun,9999,0,9999,0
1653619903676,ECE 200,018,091020,Kim; Young-Han,9999,0,9999,0
1653619903676,ECE 200,019,091021,Koushanfar; Farinaz,9999,0,9999,0
1653619903676,ECE 200,020,091022,Kuzum; Duygu,9999,0,9999,0
1653619903676,ECE 200,021,091023,Le; Hanh-Phuc,9999,0,9999,0
1653619903676,ECE 200,022,091024,Lin; Bill,9999,0,9999,0
1653619903676,ECE 200,023,091025,Liu; Zhaowei,9999,0,9999,0
1653619903676,ECE 200,024,091026,Lo; Yu-Hwa,9999,0,9999,0
1653619903676,ECE 200,025,091027,Lomakin; Vitaliy,9999,0,9999,0
1653619903676,ECE 200,026,091028,Mercier; Patrick Philip,9999,0,9999,0
1653619903676,ECE 200,027,091029,Meyer; Florian,9999,0,9999,0
1653619903676,ECE 200,028,091030,Milstein; Laurence B.,9999,0,9999,0
1653619903676,ECE 200,029,091031,Mir Arabbaygi; Siavash,9999,0,9999,0
1653619903676,ECE 200,030,091032,Mookherjea; Shayan,9999,0,9999,0
1653619903676,ECE 200,031,091033,Morris; Karcher William,9999,0,9999,0
1653619903676,ECE 200,032,091034,Ng; Tse Nga,9999,0,9999,0
1653619903676,ECE 200,033,091035,Nguyen; Truong Quang,9999,0,9999,0
1653619903676,ECE 200,034,091036,Nomura; Kenji,9999,0,9999,0
1653619903676,ECE 200,035,091037,Orlitsky; Alon,9999,0,9999,0
1653619903676,ECE 200,036,091038,Pal; Piya,9999,0,9999,0
1653619903676,ECE 200,037,091039,Papen; George C.,9999,0,9999,0
1653619903676,ECE 200,038,091040,Radic; Stojan,9999,0,9999,0
1653619903676,ECE 200,039,091041,Rao; Bhaskar D.,9999,0,9999,0
1653619903676,ECE 200,040,091042,Rao; Ramesh R,9999,0,9999,0
1653619903676,ECE 200,041,091043,Rebeiz; Gabriel,9999,0,9999,0
1653619903676,ECE 200,042,091044,Sanford; John R,9999,0,9999,0
1653619903676,ECE 200,043,091045,Siegel; Paul H.,9999,0,9999,0
1653619903676,ECE 200,044,091046,Sievenpiper; Daniel F.,9999,0,9999,0
1653619903676,ECE 200,045,091047,Sworder; David D.,9999,0,9999,0
1653619903676,ECE 200,046,091048,Taur; Yuan,9999,0,9999,0
1653619903676,ECE 200,047,091049,Touri; Behrouz,9999,0,9999,0
1653619903676,ECE 200,048,091050,Trivedi; Mohan M.,9999,0,9999,0
1653619903676,ECE 200,049,091051,Vardy; Alexander,9999,0,9999,0
1653619903676,ECE 200,050,091052,Vasconcelos; Nuno,9999,0,9999,0
1653619903676,ECE 200,051,091053,Wang; Xiaolong,9999,0,9999,0
1653619903676,ECE 200,052,091054,Xie; Pengtao,9999,0,9999,0
1653619903676,ECE 200,053,091055,Yip; Michael,9999,0,9999,0
1653619903676,ECE 200,054,091056,Zeger; Kenneth A.,9999,0,9999,0
1653619903676,ECE 200,055,091057,Zhang; Xinyu,9999,0,9999,0
1653619903676,ECE 200,056,091058,Turakhia; Yatish Girish,9999,0,9999,0
1653619903676,ECE 200,057,091059,Kang; Mingu,9999,0,9999,0
1653619903676,ECE 200,058,091060,Shi; Yuanyuan,9999,0,9999,0
1653619903676,ECE 200,059,091061,Wang; Edward Jay,9999,0,9999,0
1653619903676,ECE 200,060,091062,Zheng; Yang,9999,0,9999,0
1653619904213,ECE 201,A00,095526,Lo; Yu-Hwa,0,0,0,0
1653619904749,ECE 203,A00,091065,Mercier; Patrick Philip,0,0,0,0
1653619905275,ECE 207A,A00,091605,Liu; Thomas Tao-Ming,0,0,0,0
1653619905810,ECE 212AN,A00,091068,Nomura; Kenji,0,0,0,0
1653619906340,ECE 222A,A00,091069,Rebeiz; Gabriel,0,0,0,0
1653619906862,ECE 225A,A00,091070,Orlitsky; Alon,0,0,0,0
1653619907385,ECE 230A,A00,091071,Nomura; Kenji,0,0,0,0
1653619907910,ECE 236A,A00,091072,Dayeh; Shadi Ahmad,0,0,0,0
1653619908437,ECE 238A,A00,091073,Luo; Jian,0,0,0,0
1653619908437,ECE 238A,B00,091074,Luo; Jian,0,0,0,0
1653619908962,ECE 240A,A00,091075,Radic; Stojan,0,0,0,0
1653619909486,ECE 247A,A00,091592,Shi; Lingyan,0,0,0,0
1653619910009,ECE 250,A00,091076,Touri; Behrouz,0,0,0,0
1653619910531,ECE 251C,A00,091078,Nguyen; Truong Quang,0,0,0,0
1653619911053,ECE 253,A00,091079,Cosman; Pamela C.,0,0,0,0
1653619911583,ECE 255A,A00,091080,Orlitsky; Alon,0,0,0,0
1653619912109,ECE 257A,A00,091081,Zhang; Xinyu,0,0,0,0
1653619912630,ECE 260A,A01,091084,Eldon; John,0,0,0,0
1653619913153,ECE 264C,A00,091085,Galton; Ian A,0,0,0,0
1653619913678,ECE 265C,A00,094889,Presti; Calogero Davide,0,0,0,9
1653619914199,ECE 266,A01,091087,Hall; Drew A.,0,0,0,0
1653619915251,ECE 271A,A00,091090,Vasconcelos; Nuno,0,0,0,0
1653619915772,ECE 272B,A00,091091,Sworder; David D.,0,0,0,0
1653619916295,ECE 275A,A00,091092,Meyer; Florian,0,0,0,0
1653619916820,ECE 277,A00,091093,An; Cheolhong,0,0,0,0
1653619917345,ECE 283,A00,091094,Le; Hanh-Phuc,0,0,0,0
1653619917870,ECE 284,A00,091095,Kang; Mingu,0,0,0,0
1653619917870,ECE 284,B00,091096,Wang; Edward Jay,0,0,0,0
1653619918394,ECE 285,A00,094334,Touri; Behrouz,0,0,0,0
1653619918918,ECE 289,A00,091097,Whelan; David Arthur,0,0,0,0
1653619919441,MATH 200A,A00,087414,Salehi Golsefidy; Alireza,7,0,8,1
1653619919965,MATH 202A,A00,087415,Gill; Philip E.,2,0,8,6
1653619920504,MATH 203A,A00,087416,Oprea; Dragos N.,6,0,8,2
1653619921027,MATH 204A,A00,087417,Kedlaya; Kiran S.,6,0,8,2
1653619921557,MATH 205,A00,087418,Sorensen; Claus M,6,0,8,2
1653619922084,MATH 206A,A00,087419,Izadi; Elham,6,0,8,2
1653619922607,MATH 207A,A00,087420,Mohammadi; Amir,5,0,8,3
1653619923133,MATH 208,A00,087421,Staff,8,0,10,2
1653619923656,MATH 209,A00,087422,Staff,10,0,10,0
1653619924179,MATH 218,A00,087423,Staff,10,0,10,0
1653619924705,MATH 220A,A00,087424,Novak; Jonathan I,6,0,8,2
1653619925230,MATH 231A,A00,087425,Bejenaru; Ioan,3,0,8,5
1653619925756,MATH 240A,A00,087426,Ebenfelt; Peter F,5,0,8,3
1653619926359,MATH 243,A00,087427,Staff,9,0,10,1
1653619926881,MATH 248,A00,087429,Staff,10,0,10,0
1653619927403,MATH 250A,A00,087430,Spolaor; Luca,4,0,8,4
1653619927929,MATH 257A,A00,087431,Spolaor; Luca,7,0,8,1
1653619928454,MATH 258,A00,087432,Staff,9,0,10,1
1653619928978,MATH 264A,A00,087433,Warnke; Lutz Peter,5,0,8,3
1653619929511,MATH 268,A00,087434,Staff,15,0,15,0
1653619930036,MATH 269,A00,087435,Staff,14,0,15,1
1653619930569,MATH 270A,A00,087436,Nie; Jiawang,0,0,8,8
1653619931092,MATH 272A,A00,087437,Tian; Xiaochuan,0,0,8,8
1653619931618,MATH 274,A01,087439,Cheng; Li-Tien,9,0,10,1
1653619931618,MATH 274,A02,087440,Cheng; Li-Tien,10,0,10,0
1653619932139,MATH 278A,A00,087441,Staff,8,0,10,2
1653619932662,MATH 278B,A00,087442,Staff,8,0,10,2
1653619933188,MATH 278C,A00,087443,Staff,8,0,10,2
1653619933719,MATH 280A,A00,087444,Zheng; Tianyi,0,0,8,8
1653619934241,MATH 281A,A00,087445,Bradic; Jelena,0,0,8,9
1653619934765,MATH 282A,A00,087446,Zhang; Danna,0,0,8,8
1653619935290,MATH 283,A00,087447,Tesler; Glenn,0,0,0,16
1653619935818,MATH 286,B00,095535,Kemp; Todd Aahron,5,0,8,3
1653619936341,MATH 287D,B00,095536,Bradic; Jelena,5,0,8,3
1653619936868,MATH 288,A00,087450,Staff,14,0,15,1
1653619936868,MATH 288,B00,087451,Staff,15,0,15,0
1653619936868,MATH 288,C00,087452,Staff,15,0,15,0
1653619937394,MATH 290A,A00,087453,Xu; Zhouli,6,0,8,2
1653619937917,MATH 291A,A00,087454,Xu; Zhouli,7,0,8,1
1653619938440,MATH 292,A00,087455,Staff,10,0,10,0
1653619938966,MATH 295,A00,087456,Staff,50,0,50,0
1653619939489,MATH 297,001,087457,Staff,997,0,999,2
1653620498606,COGS 200,A01,087991,Staff,47,0,50,3
1653620499127,COGS 201,A01,094504,Rangel; Lara M,16,0,25,9
1653620499652,COGS 203,A00,087992,Coulson; Seana M,18,0,20,2
1653620500180,COGS 210A,001,087993,Greene; Deanna Jacquelyn,9998,0,9999,1
1653620500180,COGS 210A,002,087994,Saygin; Ayse P,9999,0,9999,0
1653620500180,COGS 210A,003,087995,Xia; Haijun,9999,0,9999,0
1653620500180,COGS 210A,004,087996,Nitz; Douglas A.,9999,0,9999,0
1653620500180,COGS 210A,005,087997,Hollan; James D.,9999,0,9999,0
1653620500180,COGS 210A,006,087998,Deak; Gedeon O.,9998,0,9999,1
1653620500180,COGS 210A,007,087999,Rossano; Federico,9999,0,9999,0
1653620500706,COGS 211A,A00,088000,Coulson; Seana M,9997,0,9999,2
1653620501238,COGS 229,A00,088002,Staff,22,0,25,3
1653620501761,COGS 260,B00,094231,Staff,17,0,20,3
1653620501761,COGS 260,A00,088004,Nitz; Douglas A.,9998,0,9999,1
1653620502284,CSE 202,A00,090110,Paturi; Ramamohan,0,0,0,0
1653620502284,CSE 202,B00,090111,Paturi; Ramamohan,0,0,0,0
1653620502818,CSE 207B,A00,090112,Heninger; Nadia A,0,0,0,0
1653620503342,CSE 208,A00,094858,Micciancio; Daniele,0,0,0,0
1653620503869,CSE 210,A00,090113,Powell; Thomas Allan,0,0,0,0
1653620504395,CSE 219,A00,090898,Staff,0,0,0,0
1653620504919,CSE 221,A00,090114,Zhou; Yuan-Yuan,0,0,0,0
1653620505444,CSE 229A,A00,090115,Porter; George M,0,0,0,0
1653620505965,CSE 229C,A00,090116,Savage; Stefan,0,0,0,0
1653620506495,CSE 230,A00,090117,Jhala; Ranjit,0,0,0,0
1653620507017,CSE 232,A00,090118,Papakonstantinou; Yannis,0,0,0,0
1653620507540,CSE 239A,A00,090121,Kumar; Arun Kumar,0,0,0,0
1653620508062,CSE 239B,A00,090122,Jhala; Ranjit,0,0,0,0
1653620508586,CSE 240A,A00,090123,Zhao; Jishen,0,0,189,189
1653620509110,CSE 243A,A00,090124,Orailoglu; Alex,0,0,15,15
1653620509633,CSE 249B,A00,090125,Kahng; Andrew Byun,12,0,20,8
1653620510165,CSE 250A,A00,090126,Berg-Kirkpatrick; Taylor D,0,0,0,0
1653620510688,CSE 252A,A00,090127,Ochoa; Benjamin Lawrence,0,0,0,0
1653620511208,CSE 258,A01,090129,McAuley; Julian John,0,0,0,0
1653620511735,CSE 258R,A01,090131,McAuley; Julian John,0,0,0,0
1653620512259,CSE 274,A00,090132,Ramamoorthi; Ravi,0,0,0,0
1653620512855,CSE 276A,A00,090133,Christensen; Henrik I,0,0,0,0
1653620513380,CSE 276C,A00,090134,Christensen; Henrik I,0,0,0,0
1653620513904,CSE 290,A00,090135,Bafna; Vineet,0,0,0,0
1653620513904,CSE 290,B00,090136,Ramamoorthi; Ravi,0,0,0,0
1653620513904,CSE 290,C00,090137,Li; Tzumao,7,0,10,3
1653620513904,CSE 290,D00,090138,Zhou; Yuan-Yuan,9,0,10,1
1653620513904,CSE 290,E00,090139,Christensen; Henrik I,8,0,10,2
1653620513904,CSE 290,F00,094053,Shalev; Aaron D,0,0,0,0
1653620514429,CSE 291,A00,090140,Munyaka; Imani N. S.,0,0,0,0
1653620514429,CSE 291,B00,094880,Yu; Qi,0,0,0,0
1653620514429,CSE 291,C00,090142,Pannuto; Patrick William,0,0,0,0
1653620514429,CSE 291,D00,094881,Zhang; Yiying,0,0,0,0
1653620514429,CSE 291,E00,095118,Su; Hao,0,0,0,0
1653620514964,CSE 293,001,094905,Bafna; Vineet,9999,0,9999,0
1653620514964,CSE 293,002,094906,Bellare; Mihir,9999,0,9999,0
1653620514964,CSE 293,003,094907,Berg-Kirkpatrick; Taylor D,9999,0,9999,0
1653620514964,CSE 293,004,094908,Christensen; Henrik I,9999,0,9999,0
1653620514964,CSE 293,005,094909,Cottrell; Garrison W,9999,0,9999,0
1653620514964,CSE 293,006,094910,Deutsch; Alin Bernard,9999,0,9999,0
1653620514964,CSE 293,007,094911,Esmaeilzadeh; Hadi,9999,0,9999,0
1653620514964,CSE 293,008,094912,Freund; Yoav,9999,0,9999,0
1653620514964,CSE 293,009,094913,Griswold; William G.,9999,0,9999,0
1653620514964,CSE 293,010,094914,Gymrek; Melissa Ann,9999,0,9999,0
1653620514964,CSE 293,011,094915,Heninger; Nadia A,9999,0,9999,0
1653620514964,CSE 293,012,094916,Impagliazzo; Russell,9999,0,9999,0
1653620514964,CSE 293,013,094917,Jhala; Ranjit,9999,0,9999,0
1653620514964,CSE 293,014,094918,Kahng; Andrew Byun,9999,0,9999,0
1653620514964,CSE 293,015,094919,Kane; Daniel Mertz,9999,0,9999,0
1653620514964,CSE 293,016,094920,Kriegman; David J,9999,0,9999,0
1653620514964,CSE 293,017,094921,Kumar; Arun Kumar,9999,0,9999,0
1653620514964,CSE 293,018,094922,Lerner; Sorin,9999,0,9999,0
1653620514964,CSE 293,019,094923,Lovett; Shachar,9999,0,9999,0
1653620514964,CSE 293,020,094924,McAuley; Julian John,9999,0,9999,0
1653620514964,CSE 293,021,094925,Micciancio; Daniele,9999,0,9999,0
1653620514964,CSE 293,022,094926,Orailoglu; Alex,9999,0,9999,0
1653620514964,CSE 293,023,094927,Paturi; Ramamohan,9999,0,9999,0
1653620514964,CSE 293,024,094928,Polikarpova; Nadezhda,9999,0,9999,0
1653620514964,CSE 293,025,094929,Politz; Joseph Gibbs,9999,0,9999,0
1653620514964,CSE 293,026,094930,Porter; George M,9999,0,9999,0
1653620514964,CSE 293,027,094931,Porter; Leonard Emerson,9999,0,9999,0
1653620514964,CSE 293,028,094932,Ramamoorthi; Ravi,9999,0,9999,0
1653620514964,CSE 293,029,094933,Sahoo; Debashis,9999,0,9999,0
1653620514964,CSE 293,030,094934,Saul; Lawrence,9999,0,9999,0
1653620514964,CSE 293,031,094935,Savage; Stefan,9999,0,9999,0
1653620514964,CSE 293,032,094936,Schulze; Jurgen P.,9999,0,9999,0
1653620514964,CSE 293,033,094937,Snoeren; Alex C.,9999,0,9999,0
1653620514964,CSE 293,034,094938,Shang; Jingbo,9999,0,9999,0
1653620514964,CSE 293,035,094939,Stefan; Deian,9999,0,9999,0
1653620514964,CSE 293,036,094940,Su; Hao,9999,0,9999,0
1653620514964,CSE 293,037,094941,Swanson; Steven James,9999,0,9999,0
1653620514964,CSE 293,038,094942,Tullsen; Dean Michael,9999,0,9999,0
1653620514964,CSE 293,039,094943,Voelker; Geoffrey M.,9999,0,9999,0
1653620514964,CSE 293,040,094944,Zhao; Jishen,9999,0,9999,0
1653620514964,CSE 293,041,094945,Zhou; Yuan-Yuan,9999,0,9999,0
1653620514964,CSE 293,042,094946,Gao; Sicun,9998,0,9999,1
1653620514964,CSE 293,043,094947,Weibel; Nadir,9999,0,9999,0
1653620514964,CSE 293,044,094948,Gupta; Rajesh K.,9999,0,9999,0
1653620515499,CSE 294,A00,090143,Porter; George M,9,0,10,1
1653620516022,DSE 200,A00,091799,Staff,50,0,50,0
1653620516544,DSE 203,A00,091800,Gupta; Amarnath,30,0,30,0
1653620517065,DSE 250,A00,091801,Deutsch; Alin Bernard,30,0,30,0
1653620517588,DSE 290,A00,091802,Altintas De Callaf; Ilkay,50,0,50,0
1653620518122,ECE 200,001,091003,Antipa; Nicholas A,9999,0,9999,0
1653620518122,ECE 200,002,091004,Atanasov; Nikolay A.,9999,0,9999,0
1653620518122,ECE 200,003,091005,Bharadia; Dinesh,9999,0,9999,0
1653620518122,ECE 200,004,091006,Cheng; Chung Kuan,9999,0,9999,0
1653620518122,ECE 200,005,091007,Cosman; Pamela C.,9999,0,9999,0
1653620518122,ECE 200,006,091008,Staff,9999,0,9999,0
1653620518122,ECE 200,007,091009,Dayeh; Shadi Ahmad,9999,0,9999,0
1653620518122,ECE 200,008,091010,Fainman; Yeshaiahu,9999,0,9999,0
1653620518122,ECE 200,009,091011,Ford; Joseph Earl,9999,0,9999,0
1653620518122,ECE 200,010,091012,Franceschetti; Massimo,9999,0,9999,0
1653620518122,ECE 200,011,091013,Fullerton; Eric E,9999,0,9999,0
1653620518122,ECE 200,012,091014,Galton; Ian A,9999,0,9999,0
1653620518122,ECE 200,013,091015,Gilja; Vikash,9999,0,9999,0
1653620518122,ECE 200,014,091016,Hall; Drew A.,9999,0,9999,0
1653620518122,ECE 200,015,091017,Hsueh; Tzu-Chien,9999,0,9999,0
1653620518122,ECE 200,016,091018,Javidi; Tara,9999,0,9999,0
1653620518122,ECE 200,017,091019,Kahng; Andrew Byun,9999,0,9999,0
1653620518122,ECE 200,018,091020,Kim; Young-Han,9999,0,9999,0
1653620518122,ECE 200,019,091021,Koushanfar; Farinaz,9999,0,9999,0
1653620518122,ECE 200,020,091022,Kuzum; Duygu,9999,0,9999,0
1653620518122,ECE 200,021,091023,Le; Hanh-Phuc,9999,0,9999,0
1653620518122,ECE 200,022,091024,Lin; Bill,9999,0,9999,0
1653620518122,ECE 200,023,091025,Liu; Zhaowei,9999,0,9999,0
1653620518122,ECE 200,024,091026,Lo; Yu-Hwa,9999,0,9999,0
1653620518122,ECE 200,025,091027,Lomakin; Vitaliy,9999,0,9999,0
1653620518122,ECE 200,026,091028,Mercier; Patrick Philip,9999,0,9999,0
1653620518122,ECE 200,027,091029,Meyer; Florian,9999,0,9999,0
1653620518122,ECE 200,028,091030,Milstein; Laurence B.,9999,0,9999,0
1653620518122,ECE 200,029,091031,Mir Arabbaygi; Siavash,9999,0,9999,0
1653620518122,ECE 200,030,091032,Mookherjea; Shayan,9999,0,9999,0
1653620518122,ECE 200,031,091033,Morris; Karcher William,9999,0,9999,0
1653620518122,ECE 200,032,091034,Ng; Tse Nga,9999,0,9999,0
1653620518122,ECE 200,033,091035,Nguyen; Truong Quang,9999,0,9999,0
1653620518122,ECE 200,034,091036,Nomura; Kenji,9999,0,9999,0
1653620518122,ECE 200,035,091037,Orlitsky; Alon,9999,0,9999,0
1653620518122,ECE 200,036,091038,Pal; Piya,9999,0,9999,0
1653620518122,ECE 200,037,091039,Papen; George C.,9999,0,9999,0
1653620518122,ECE 200,038,091040,Radic; Stojan,9999,0,9999,0
1653620518122,ECE 200,039,091041,Rao; Bhaskar D.,9999,0,9999,0
1653620518122,ECE 200,040,091042,Rao; Ramesh R,9999,0,9999,0
1653620518122,ECE 200,041,091043,Rebeiz; Gabriel,9999,0,9999,0
1653620518122,ECE 200,042,091044,Sanford; John R,9999,0,9999,0
1653620518122,ECE 200,043,091045,Siegel; Paul H.,9999,0,9999,0
1653620518122,ECE 200,044,091046,Sievenpiper; Daniel F.,9999,0,9999,0
1653620518122,ECE 200,045,091047,Sworder; David D.,9999,0,9999,0
1653620518122,ECE 200,046,091048,Taur; Yuan,9999,0,9999,0
1653620518122,ECE 200,047,091049,Touri; Behrouz,9999,0,9999,0
1653620518122,ECE 200,048,091050,Trivedi; Mohan M.,9999,0,9999,0
1653620518122,ECE 200,049,091051,Vardy; Alexander,9999,0,9999,0
1653620518122,ECE 200,050,091052,Vasconcelos; Nuno,9999,0,9999,0
1653620518122,ECE 200,051,091053,Wang; Xiaolong,9999,0,9999,0
1653620518122,ECE 200,052,091054,Xie; Pengtao,9999,0,9999,0
1653620518122,ECE 200,053,091055,Yip; Michael,9999,0,9999,0
1653620518122,ECE 200,054,091056,Zeger; Kenneth A.,9999,0,9999,0
1653620518122,ECE 200,055,091057,Zhang; Xinyu,9999,0,9999,0
1653620518122,ECE 200,056,091058,Turakhia; Yatish Girish,9999,0,9999,0
1653620518122,ECE 200,057,091059,Kang; Mingu,9999,0,9999,0
1653620518122,ECE 200,058,091060,Shi; Yuanyuan,9999,0,9999,0
1653620518122,ECE 200,059,091061,Wang; Edward Jay,9999,0,9999,0
1653620518122,ECE 200,060,091062,Zheng; Yang,9999,0,9999,0
1653620518645,ECE 201,A00,095526,Lo; Yu-Hwa,0,0,0,0
1653620519167,ECE 203,A00,091065,Mercier; Patrick Philip,0,0,0,0
1653620519690,ECE 207A,A00,091605,Liu; Thomas Tao-Ming,0,0,0,0
1653620520221,ECE 212AN,A00,091068,Nomura; Kenji,0,0,0,0
1653620520746,ECE 222A,A00,091069,Rebeiz; Gabriel,0,0,0,0
1653620521271,ECE 225A,A00,091070,Orlitsky; Alon,0,0,0,0
1653620521799,ECE 230A,A00,091071,Nomura; Kenji,0,0,0,0
1653620522325,ECE 236A,A00,091072,Dayeh; Shadi Ahmad,0,0,0,0
1653620522850,ECE 238A,A00,091073,Luo; Jian,0,0,0,0
1653620522850,ECE 238A,B00,091074,Luo; Jian,0,0,0,0
1653620523377,ECE 240A,A00,091075,Radic; Stojan,0,0,0,0
1653620523902,ECE 247A,A00,091592,Shi; Lingyan,0,0,0,0
1653620524427,ECE 250,A00,091076,Touri; Behrouz,0,0,0,0
1653620524952,ECE 251C,A00,091078,Nguyen; Truong Quang,0,0,0,0
1653620525484,ECE 253,A00,091079,Cosman; Pamela C.,0,0,0,0
1653620526007,ECE 255A,A00,091080,Orlitsky; Alon,0,0,0,0
1653620526532,ECE 257A,A00,091081,Zhang; Xinyu,0,0,0,0
1653620527059,ECE 260A,A01,091084,Eldon; John,0,0,0,0
1653620527591,ECE 264C,A00,091085,Galton; Ian A,0,0,0,0
1653620528113,ECE 265C,A00,094889,Presti; Calogero Davide,0,0,0,9
1653620528638,ECE 266,A01,091087,Hall; Drew A.,0,0,0,0
1653620529684,ECE 271A,A00,091090,Vasconcelos; Nuno,0,0,0,0
1653620530206,ECE 272B,A00,091091,Sworder; David D.,0,0,0,0
1653620530728,ECE 275A,A00,091092,Meyer; Florian,0,0,0,0
1653620531250,ECE 277,A00,091093,An; Cheolhong,0,0,0,0
1653620531773,ECE 283,A00,091094,Le; Hanh-Phuc,0,0,0,0
1653620532297,ECE 284,A00,091095,Kang; Mingu,0,0,0,0
1653620532297,ECE 284,B00,091096,Wang; Edward Jay,0,0,0,0
1653620532818,ECE 285,A00,094334,Touri; Behrouz,0,0,0,0
1653620533357,ECE 289,A00,091097,Whelan; David Arthur,0,0,0,0
1653620533881,MATH 200A,A00,087414,Salehi Golsefidy; Alireza,7,0,8,1
1653620534406,MATH 202A,A00,087415,Gill; Philip E.,2,0,8,6
1653620534934,MATH 203A,A00,087416,Oprea; Dragos N.,6,0,8,2
1653620535459,MATH 204A,A00,087417,Kedlaya; Kiran S.,6,0,8,2
1653620535981,MATH 205,A00,087418,Sorensen; Claus M,6,0,8,2
1653620536504,MATH 206A,A00,087419,Izadi; Elham,6,0,8,2
1653620537027,MATH 207A,A00,087420,Mohammadi; Amir,5,0,8,3
1653620537549,MATH 208,A00,087421,Staff,8,0,10,2
1653620538074,MATH 209,A00,087422,Staff,10,0,10,0
1653620538602,MATH 218,A00,087423,Staff,10,0,10,0
1653620539124,MATH 220A,A00,087424,Novak; Jonathan I,6,0,8,2
1653620539648,MATH 231A,A00,087425,Bejenaru; Ioan,3,0,8,5
1653620540172,MATH 240A,A00,087426,Ebenfelt; Peter F,5,0,8,3
1653620540694,MATH 243,A00,087427,Staff,9,0,10,1
1653620541218,MATH 248,A00,087429,Staff,10,0,10,0
1653620541750,MATH 250A,A00,087430,Spolaor; Luca,4,0,8,4
1653620542273,MATH 257A,A00,087431,Spolaor; Luca,7,0,8,1
1653620542797,MATH 258,A00,087432,Staff,9,0,10,1
1653620543325,MATH 264A,A00,087433,Warnke; Lutz Peter,5,0,8,3
1653620543847,MATH 268,A00,087434,Staff,15,0,15,0
1653620544370,MATH 269,A00,087435,Staff,14,0,15,1
1653620544892,MATH 270A,A00,087436,Nie; Jiawang,0,0,8,8
1653620545428,MATH 272A,A00,087437,Tian; Xiaochuan,0,0,8,8
1653620545951,MATH 274,A01,087439,Cheng; Li-Tien,9,0,10,1
1653620545951,MATH 274,A02,087440,Cheng; Li-Tien,10,0,10,0
1653620546476,MATH 278A,A00,087441,Staff,8,0,10,2
1653620546998,MATH 278B,A00,087442,Staff,8,0,10,2
1653620547520,MATH 278C,A00,087443,Staff,8,0,10,2
1653620548045,MATH 280A,A00,087444,Zheng; Tianyi,0,0,8,8
1653620548572,MATH 281A,A00,087445,Bradic; Jelena,0,0,8,9
1653620549095,MATH 282A,A00,087446,Zhang; Danna,0,0,8,8
1653620549616,MATH 283,A00,087447,Tesler; Glenn,0,0,0,16
1653620550137,MATH 286,B00,095535,Kemp; Todd Aahron,5,0,8,3
1653620550658,MATH 287D,B00,095536,Bradic; Jelena,5,0,8,3
1653620551182,MATH 288,A00,087450,Staff,14,0,15,1
1653620551182,MATH 288,B00,087451,Staff,15,0,15,0
1653620551182,MATH 288,C00,087452,Staff,15,0,15,0
1653620551704,MATH 290A,A00,087453,Xu; Zhouli,6,0,8,2
1653620552227,MATH 291A,A00,087454,Xu; Zhouli,7,0,8,1
1653620552749,MATH 292,A00,087455,Staff,10,0,10,0
1653620553273,MATH 295,A00,087456,Staff,50,0,50,0
1653620553802,MATH 297,001,087457,Staff,997,0,999,2
1653621113667,COGS 200,A01,087991,Staff,47,0,50,3
1653621114190,COGS 201,A01,094504,Rangel; Lara M,16,0,25,9
1653621114712,COGS 203,A00,087992,Coulson; Seana M,18,0,20,2
1653621115243,COGS 210A,001,087993,Greene; Deanna Jacquelyn,9998,0,9999,1
1653621115243,COGS 210A,002,087994,Saygin; Ayse P,9999,0,9999,0
1653621115243,COGS 210A,003,087995,Xia; Haijun,9999,0,9999,0
1653621115243,COGS 210A,004,087996,Nitz; Douglas A.,9999,0,9999,0
1653621115243,COGS 210A,005,087997,Hollan; James D.,9999,0,9999,0
1653621115243,COGS 210A,006,087998,Deak; Gedeon O.,9998,0,9999,1
1653621115243,COGS 210A,007,087999,Rossano; Federico,9999,0,9999,0
1653621115768,COGS 211A,A00,088000,Coulson; Seana M,9997,0,9999,2
1653621116300,COGS 229,A00,088002,Staff,22,0,25,3
1653621116829,COGS 260,B00,094231,Staff,17,0,20,3
1653621116829,COGS 260,A00,088004,Nitz; Douglas A.,9998,0,9999,1
1653621117351,CSE 202,A00,090110,Paturi; Ramamohan,0,0,0,0
1653621117351,CSE 202,B00,090111,Paturi; Ramamohan,0,0,0,0
1653621117875,CSE 207B,A00,090112,Heninger; Nadia A,0,0,0,0
1653621118397,CSE 208,A00,094858,Micciancio; Daniele,0,0,0,0
1653621118923,CSE 210,A00,090113,Powell; Thomas Allan,0,0,0,0
1653621119447,CSE 219,A00,090898,Staff,0,0,0,0
1653621119981,CSE 221,A00,090114,Zhou; Yuan-Yuan,0,0,0,0
1653621120506,CSE 229A,A00,090115,Porter; George M,0,0,0,0
1653621121029,CSE 229C,A00,090116,Savage; Stefan,0,0,0,0
1653621121555,CSE 230,A00,090117,Jhala; Ranjit,0,0,0,0
1653621122084,CSE 232,A00,090118,Papakonstantinou; Yannis,0,0,0,0
1653621122615,CSE 239A,A00,090121,Kumar; Arun Kumar,0,0,0,0
1653621123138,CSE 239B,A00,090122,Jhala; Ranjit,0,0,0,0
1653621123660,CSE 240A,A00,090123,Zhao; Jishen,0,0,189,189
1653621124191,CSE 243A,A00,090124,Orailoglu; Alex,0,0,15,15
1653621124713,CSE 249B,A00,090125,Kahng; Andrew Byun,12,0,20,8
1653621125238,CSE 250A,A00,090126,Berg-Kirkpatrick; Taylor D,0,0,0,0
1653621125764,CSE 252A,A00,090127,Ochoa; Benjamin Lawrence,0,0,0,0
1653621126290,CSE 258,A01,090129,McAuley; Julian John,0,0,0,0
1653621126813,CSE 258R,A01,090131,McAuley; Julian John,0,0,0,0
1653621127336,CSE 274,A00,090132,Ramamoorthi; Ravi,0,0,0,0
1653621127858,CSE 276A,A00,090133,Christensen; Henrik I,0,0,0,0
1653621128381,CSE 276C,A00,090134,Christensen; Henrik I,0,0,0,0
1653621128908,CSE 290,A00,090135,Bafna; Vineet,0,0,0,0
1653621128908,CSE 290,B00,090136,Ramamoorthi; Ravi,0,0,0,0
1653621128908,CSE 290,C00,090137,Li; Tzumao,7,0,10,3
1653621128908,CSE 290,D00,090138,Zhou; Yuan-Yuan,9,0,10,1
1653621128908,CSE 290,E00,090139,Christensen; Henrik I,8,0,10,2
1653621128908,CSE 290,F00,094053,Shalev; Aaron D,0,0,0,0
1653621129431,CSE 291,A00,090140,Munyaka; Imani N. S.,0,0,0,0
1653621129431,CSE 291,B00,094880,Yu; Qi,0,0,0,0
1653621129431,CSE 291,C00,090142,Pannuto; Patrick William,0,0,0,0
1653621129431,CSE 291,D00,094881,Zhang; Yiying,0,0,0,0
1653621129431,CSE 291,E00,095118,Su; Hao,0,0,0,0
1653621129958,CSE 293,001,094905,Bafna; Vineet,9999,0,9999,0
1653621129958,CSE 293,002,094906,Bellare; Mihir,9999,0,9999,0
1653621129958,CSE 293,003,094907,Berg-Kirkpatrick; Taylor D,9999,0,9999,0
1653621129958,CSE 293,004,094908,Christensen; Henrik I,9999,0,9999,0
1653621129958,CSE 293,005,094909,Cottrell; Garrison W,9999,0,9999,0
1653621129958,CSE 293,006,094910,Deutsch; Alin Bernard,9999,0,9999,0
1653621129958,CSE 293,007,094911,Esmaeilzadeh; Hadi,9999,0,9999,0
1653621129958,CSE 293,008,094912,Freund; Yoav,9999,0,9999,0
1653621129958,CSE 293,009,094913,Griswold; William G.,9999,0,9999,0
1653621129958,CSE 293,010,094914,Gymrek; Melissa Ann,9999,0,9999,0
1653621129958,CSE 293,011,094915,Heninger; Nadia A,9999,0,9999,0
1653621129958,CSE 293,012,094916,Impagliazzo; Russell,9999,0,9999,0
1653621129958,CSE 293,013,094917,Jhala; Ranjit,9999,0,9999,0
1653621129958,CSE 293,014,094918,Kahng; Andrew Byun,9999,0,9999,0
1653621129958,CSE 293,015,094919,Kane; Daniel Mertz,9999,0,9999,0
1653621129958,CSE 293,016,094920,Kriegman; David J,9999,0,9999,0
1653621129958,CSE 293,017,094921,Kumar; Arun Kumar,9999,0,9999,0
1653621129958,CSE 293,018,094922,Lerner; Sorin,9999,0,9999,0
1653621129958,CSE 293,019,094923,Lovett; Shachar,9999,0,9999,0
1653621129958,CSE 293,020,094924,McAuley; Julian John,9999,0,9999,0
1653621129958,CSE 293,021,094925,Micciancio; Daniele,9999,0,9999,0
1653621129958,CSE 293,022,094926,Orailoglu; Alex,9999,0,9999,0
1653621129958,CSE 293,023,094927,Paturi; Ramamohan,9999,0,9999,0
1653621129958,CSE 293,024,094928,Polikarpova; Nadezhda,9999,0,9999,0
1653621129958,CSE 293,025,094929,Politz; Joseph Gibbs,9999,0,9999,0
1653621129958,CSE 293,026,094930,Porter; George M,9999,0,9999,0
1653621129958,CSE 293,027,094931,Porter; Leonard Emerson,9999,0,9999,0
1653621129958,CSE 293,028,094932,Ramamoorthi; Ravi,9999,0,9999,0
1653621129958,CSE 293,029,094933,Sahoo; Debashis,9999,0,9999,0
1653621129958,CSE 293,030,094934,Saul; Lawrence,9999,0,9999,0
1653621129958,CSE 293,031,094935,Savage; Stefan,9999,0,9999,0
1653621129958,CSE 293,032,094936,Schulze; Jurgen P.,9999,0,9999,0
1653621129958,CSE 293,033,094937,Snoeren; Alex C.,9999,0,9999,0
1653621129958,CSE 293,034,094938,Shang; Jingbo,9999,0,9999,0
1653621129958,CSE 293,035,094939,Stefan; Deian,9999,0,9999,0
1653621129958,CSE 293,036,094940,Su; Hao,9999,0,9999,0
1653621129958,CSE 293,037,094941,Swanson; Steven James,9999,0,9999,0
1653621129958,CSE 293,038,094942,Tullsen; Dean Michael,9999,0,9999,0
1653621129958,CSE 293,039,094943,Voelker; Geoffrey M.,9999,0,9999,0
1653621129958,CSE 293,040,094944,Zhao; Jishen,9999,0,9999,0
1653621129958,CSE 293,041,094945,Zhou; Yuan-Yuan,9999,0,9999,0
1653621129958,CSE 293,042,094946,Gao; Sicun,9998,0,9999,1
1653621129958,CSE 293,043,094947,Weibel; Nadir,9999,0,9999,0
1653621129958,CSE 293,044,094948,Gupta; Rajesh K.,9999,0,9999,0
1653621130481,CSE 294,A00,090143,Porter; George M,9,0,10,1
1653621131003,DSE 200,A00,091799,Staff,50,0,50,0
1653621131542,DSE 203,A00,091800,Gupta; Amarnath,30,0,30,0
1653621132064,DSE 250,A00,091801,Deutsch; Alin Bernard,30,0,30,0
1653621132591,DSE 290,A00,091802,Altintas De Callaf; Ilkay,50,0,50,0
1653621133120,ECE 200,001,091003,Antipa; Nicholas A,9999,0,9999,0
1653621133120,ECE 200,002,091004,Atanasov; Nikolay A.,9999,0,9999,0
1653621133120,ECE 200,003,091005,Bharadia; Dinesh,9999,0,9999,0
1653621133120,ECE 200,004,091006,Cheng; Chung Kuan,9999,0,9999,0
1653621133120,ECE 200,005,091007,Cosman; Pamela C.,9999,0,9999,0
1653621133120,ECE 200,006,091008,Staff,9999,0,9999,0
1653621133120,ECE 200,007,091009,Dayeh; Shadi Ahmad,9999,0,9999,0
1653621133120,ECE 200,008,091010,Fainman; Yeshaiahu,9999,0,9999,0
1653621133120,ECE 200,009,091011,Ford; Joseph Earl,9999,0,9999,0
1653621133120,ECE 200,010,091012,Franceschetti; Massimo,9999,0,9999,0
1653621133120,ECE 200,011,091013,Fullerton; Eric E,9999,0,9999,0
1653621133120,ECE 200,012,091014,Galton; Ian A,9999,0,9999,0
1653621133120,ECE 200,013,091015,Gilja; Vikash,9999,0,9999,0
1653621133120,ECE 200,014,091016,Hall; Drew A.,9999,0,9999,0
1653621133120,ECE 200,015,091017,Hsueh; Tzu-Chien,9999,0,9999,0
1653621133120,ECE 200,016,091018,Javidi; Tara,9999,0,9999,0
1653621133120,ECE 200,017,091019,Kahng; Andrew Byun,9999,0,9999,0
1653621133120,ECE 200,018,091020,Kim; Young-Han,9999,0,9999,0
1653621133120,ECE 200,019,091021,Koushanfar; Farinaz,9999,0,9999,0
1653621133120,ECE 200,020,091022,Kuzum; Duygu,9999,0,9999,0
1653621133120,ECE 200,021,091023,Le; Hanh-Phuc,9999,0,9999,0
1653621133120,ECE 200,022,091024,Lin; Bill,9999,0,9999,0
1653621133120,ECE 200,023,091025,Liu; Zhaowei,9999,0,9999,0
1653621133120,ECE 200,024,091026,Lo; Yu-Hwa,9999,0,9999,0
1653621133120,ECE 200,025,091027,Lomakin; Vitaliy,9999,0,9999,0
1653621133120,ECE 200,026,091028,Mercier; Patrick Philip,9999,0,9999,0
1653621133120,ECE 200,027,091029,Meyer; Florian,9999,0,9999,0
1653621133120,ECE 200,028,091030,Milstein; Laurence B.,9999,0,9999,0
1653621133120,ECE 200,029,091031,Mir Arabbaygi; Siavash,9999,0,9999,0
1653621133120,ECE 200,030,091032,Mookherjea; Shayan,9999,0,9999,0
1653621133120,ECE 200,031,091033,Morris; Karcher William,9999,0,9999,0
1653621133120,ECE 200,032,091034,Ng; Tse Nga,9999,0,9999,0
1653621133120,ECE 200,033,091035,Nguyen; Truong Quang,9999,0,9999,0
1653621133120,ECE 200,034,091036,Nomura; Kenji,9999,0,9999,0
1653621133120,ECE 200,035,091037,Orlitsky; Alon,9999,0,9999,0
1653621133120,ECE 200,036,091038,Pal; Piya,9999,0,9999,0
1653621133120,ECE 200,037,091039,Papen; George C.,9999,0,9999,0
1653621133120,ECE 200,038,091040,Radic; Stojan,9999,0,9999,0
1653621133120,ECE 200,039,091041,Rao; Bhaskar D.,9999,0,9999,0
1653621133120,ECE 200,040,091042,Rao; Ramesh R,9999,0,9999,0
1653621133120,ECE 200,041,091043,Rebeiz; Gabriel,9999,0,9999,0
1653621133120,ECE 200,042,091044,Sanford; John R,9999,0,9999,0
1653621133120,ECE 200,043,091045,Siegel; Paul H.,9999,0,9999,0
1653621133120,ECE 200,044,091046,Sievenpiper; Daniel F.,9999,0,9999,0
1653621133120,ECE 200,045,091047,Sworder; David D.,9999,0,9999,0
1653621133120,ECE 200,046,091048,Taur; Yuan,9999,0,9999,0
1653621133120,ECE 200,047,091049,Touri; Behrouz,9999,0,9999,0
1653621133120,ECE 200,048,091050,Trivedi; Mohan M.,9999,0,9999,0
1653621133120,ECE 200,049,091051,Vardy; Alexander,9999,0,9999,0
1653621133120,ECE 200,050,091052,Vasconcelos; Nuno,9999,0,9999,0
1653621133120,ECE 200,051,091053,Wang; Xiaolong,9999,0,9999,0
1653621133120,ECE 200,052,091054,Xie; Pengtao,9999,0,9999,0
1653621133120,ECE 200,053,091055,Yip; Michael,9999,0,9999,0
1653621133120,ECE 200,054,091056,Zeger; Kenneth A.,9999,0,9999,0
1653621133120,ECE 200,055,091057,Zhang; Xinyu,9999,0,9999,0
1653621133120,ECE 200,056,091058,Turakhia; Yatish Girish,9999,0,9999,0
1653621133120,ECE 200,057,091059,Kang; Mingu,9999,0,9999,0
1653621133120,ECE 200,058,091060,Shi; Yuanyuan,9999,0,9999,0
1653621133120,ECE 200,059,091061,Wang; Edward Jay,9999,0,9999,0
1653621133120,ECE 200,060,091062,Zheng; Yang,9999,0,9999,0
1653621133643,ECE 201,A00,095526,Lo; Yu-Hwa,0,0,0,0
1653621134165,ECE 203,A00,091065,Mercier; Patrick Philip,0,0,0,0
1653621134687,ECE 207A,A00,091605,Liu; Thomas Tao-Ming,0,0,0,0
1653621135210,ECE 212AN,A00,091068,Nomura; Kenji,0,0,0,0
1653621135734,ECE 222A,A00,091069,Rebeiz; Gabriel,0,0,0,0
1653621136256,ECE 225A,A00,091070,Orlitsky; Alon,0,0,0,0
1653621136784,ECE 230A,A00,091071,Nomura; Kenji,0,0,0,0
1653621137309,ECE 236A,A00,091072,Dayeh; Shadi Ahmad,0,0,0,0
1653621137837,ECE 238A,A00,091073,Luo; Jian,0,0,0,0
1653621137837,ECE 238A,B00,091074,Luo; Jian,0,0,0,0
1653621138364,ECE 240A,A00,091075,Radic; Stojan,0,0,0,0
1653621138888,ECE 247A,A00,091592,Shi; Lingyan,0,0,0,0
1653621139411,ECE 250,A00,091076,Touri; Behrouz,0,0,0,0
1653621139939,ECE 251C,A00,091078,Nguyen; Truong Quang,0,0,0,0
1653621140461,ECE 253,A00,091079,Cosman; Pamela C.,0,0,0,0
1653621140988,ECE 255A,A00,091080,Orlitsky; Alon,0,0,0,0
1653621141509,ECE 257A,A00,091081,Zhang; Xinyu,0,0,0,0
1653621142040,ECE 260A,A01,091084,Eldon; John,0,0,0,0
1653621142561,ECE 264C,A00,091085,Galton; Ian A,0,0,0,0
1653621143085,ECE 265C,A00,094889,Presti; Calogero Davide,0,0,0,9
1653621143611,ECE 266,A01,091087,Hall; Drew A.,0,0,0,0
1653621144666,ECE 271A,A00,091090,Vasconcelos; Nuno,0,0,0,0
1653621145194,ECE 272B,A00,091091,Sworder; David D.,0,0,0,0
1653621145727,ECE 275A,A00,091092,Meyer; Florian,0,0,0,0
1653621146255,ECE 277,A00,091093,An; Cheolhong,0,0,0,0
1653621146778,ECE 283,A00,091094,Le; Hanh-Phuc,0,0,0,0
1653621147305,ECE 284,A00,091095,Kang; Mingu,0,0,0,0
1653621147305,ECE 284,B00,091096,Wang; Edward Jay,0,0,0,0
1653621147835,ECE 285,A00,094334,Touri; Behrouz,0,0,0,0
1653621148361,ECE 289,A00,091097,Whelan; David Arthur,0,0,0,0
1653621148886,MATH 200A,A00,087414,Salehi Golsefidy; Alireza,7,0,8,1
1653621149408,MATH 202A,A00,087415,Gill; Philip E.,2,0,8,6
1653621149933,MATH 203A,A00,087416,Oprea; Dragos N.,6,0,8,2
1653621150459,MATH 204A,A00,087417,Kedlaya; Kiran S.,6,0,8,2
1653621150981,MATH 205,A00,087418,Sorensen; Claus M,6,0,8,2
1653621151512,MATH 206A,A00,087419,Izadi; Elham,6,0,8,2
1653621152034,MATH 207A,A00,087420,Mohammadi; Amir,5,0,8,3
1653621152558,MATH 208,A00,087421,Staff,8,0,10,2
1653621153156,MATH 209,A00,087422,Staff,10,0,10,0
1653621153684,MATH 218,A00,087423,Staff,10,0,10,0
1653621154210,MATH 220A,A00,087424,Novak; Jonathan I,6,0,8,2
1653621154735,MATH 231A,A00,087425,Bejenaru; Ioan,3,0,8,5
1653621155257,MATH 240A,A00,087426,Ebenfelt; Peter F,5,0,8,3
1653621155781,MATH 243,A00,087427,Staff,9,0,10,1
1653621156305,MATH 248,A00,087429,Staff,10,0,10,0
1653621156838,MATH 250A,A00,087430,Spolaor; Luca,4,0,8,4
1653621157369,MATH 257A,A00,087431,Spolaor; Luca,7,0,8,1
1653621157892,MATH 258,A00,087432,Staff,9,0,10,1
1653621158415,MATH 264A,A00,087433,Warnke; Lutz Peter,5,0,8,3
1653621158939,MATH 268,A00,087434,Staff,15,0,15,0
1653621159472,MATH 269,A00,087435,Staff,14,0,15,1
1653621159997,MATH 270A,A00,087436,Nie; Jiawang,0,0,8,8
1653621160522,MATH 272A,A00,087437,Tian; Xiaochuan,0,0,8,8
1653621161047,MATH 274,A01,087439,Cheng; Li-Tien,9,0,10,1
1653621161047,MATH 274,A02,087440,Cheng; Li-Tien,10,0,10,0
1653621161569,MATH 278A,A00,087441,Staff,8,0,10,2
1653621162094,MATH 278B,A00,087442,Staff,8,0,10,2
1653621162619,MATH 278C,A00,087443,Staff,8,0,10,2
1653621163143,MATH 280A,A00,087444,Zheng; Tianyi,0,0,8,8
1653621163665,MATH 281A,A00,087445,Bradic; Jelena,0,0,8,9
1653621164189,MATH 282A,A00,087446,Zhang; Danna,0,0,8,8
1653621164714,MATH 283,A00,087447,Tesler; Glenn,0,0,0,16
1653621165240,MATH 286,B00,095535,Kemp; Todd Aahron,5,0,8,3
1653621165763,MATH 287D,B00,095536,Bradic; Jelena,5,0,8,3
1653621166288,MATH 288,A00,087450,Staff,14,0,15,1
1653621166288,MATH 288,B00,087451,Staff,15,0,15,0
1653621166288,MATH 288,C00,087452,Staff,15,0,15,0
1653621166811,MATH 290A,A00,087453,Xu; Zhouli,6,0,8,2
1653621167337,MATH 291A,A00,087454,Xu; Zhouli,7,0,8,1
1653621167865,MATH 292,A00,087455,Staff,10,0,10,0
1653621168390,MATH 295,A00,087456,Staff,50,0,50,0
1653621168913,MATH 297,001,087457,Staff,997,0,999,2
1653621728570,COGS 200,A01,087991,Staff,47,0,50,3
1653621729095,COGS 201,A01,094504,Rangel; Lara M,16,0,25,9
1653621729620,COGS 203,A00,087992,Coulson; Seana M,18,0,20,2
1653621730146,COGS 210A,001,087993,Greene; Deanna Jacquelyn,9998,0,9999,1
1653621730146,COGS 210A,002,087994,Saygin; Ayse P,9999,0,9999,0
1653621730146,COGS 210A,003,087995,Xia; Haijun,9999,0,9999,0
1653621730146,COGS 210A,004,087996,Nitz; Douglas A.,9999,0,9999,0
1653621730146,COGS 210A,005,087997,Hollan; James D.,9999,0,9999,0
1653621730146,COGS 210A,006,087998,Deak; Gedeon O.,9998,0,9999,1
1653621730146,COGS 210A,007,087999,Rossano; Federico,9999,0,9999,0
1653621730676,COGS 211A,A00,088000,Coulson; Seana M,9997,0,9999,2
1653621731199,COGS 229,A00,088002,Staff,22,0,25,3
1653621731722,COGS 260,B00,094231,Staff,17,0,20,3
1653621731722,COGS 260,A00,088004,Nitz; Douglas A.,9998,0,9999,1
1653621732253,CSE 202,A00,090110,Paturi; Ramamohan,0,0,0,0
1653621732253,CSE 202,B00,090111,Paturi; Ramamohan,0,0,0,0
1653621732775,CSE 207B,A00,090112,Heninger; Nadia A,0,0,0,0
1653621733299,CSE 208,A00,094858,Micciancio; Daniele,0,0,0,0
1653621733822,CSE 210,A00,090113,Powell; Thomas Allan,0,0,0,0
1653621734355,CSE 219,A00,090898,Staff,0,0,0,0
1653621734880,CSE 221,A00,090114,Zhou; Yuan-Yuan,0,0,0,0
1653621735403,CSE 229A,A00,090115,Porter; George M,0,0,0,0
1653621735932,CSE 229C,A00,090116,Savage; Stefan,0,0,0,0
1653621736465,CSE 230,A00,090117,Jhala; Ranjit,0,0,0,0
1653621736988,CSE 232,A00,090118,Papakonstantinou; Yannis,0,0,0,0
1653621737511,CSE 239A,A00,090121,Kumar; Arun Kumar,0,0,0,0
1653621738033,CSE 239B,A00,090122,Jhala; Ranjit,0,0,0,0
1653621738562,CSE 240A,A00,090123,Zhao; Jishen,0,0,189,189
1653621739091,CSE 243A,A00,090124,Orailoglu; Alex,0,0,15,15
1653621739615,CSE 249B,A00,090125,Kahng; Andrew Byun,12,0,20,8
1653621740226,CSE 250A,A00,090126,Berg-Kirkpatrick; Taylor D,0,0,0,0
1653621740753,CSE 252A,A00,090127,Ochoa; Benjamin Lawrence,0,0,0,0
1653621741276,CSE 258,A01,090129,McAuley; Julian John,0,0,0,0
1653621741799,CSE 258R,A01,090131,McAuley; Julian John,0,0,0,0
1653621742328,CSE 274,A00,090132,Ramamoorthi; Ravi,0,0,0,0
1653621742859,CSE 276A,A00,090133,Christensen; Henrik I,0,0,0,0
1653621743381,CSE 276C,A00,090134,Christensen; Henrik I,0,0,0,0
1653621743905,CSE 290,A00,090135,Bafna; Vineet,0,0,0,0
1653621743905,CSE 290,B00,090136,Ramamoorthi; Ravi,0,0,0,0
1653621743905,CSE 290,C00,090137,Li; Tzumao,7,0,10,3
1653621743905,CSE 290,D00,090138,Zhou; Yuan-Yuan,9,0,10,1
1653621743905,CSE 290,E00,090139,Christensen; Henrik I,8,0,10,2
1653621743905,CSE 290,F00,094053,Shalev; Aaron D,0,0,0,0
1653621744432,CSE 291,A00,090140,Munyaka; Imani N. S.,0,0,0,0
1653621744432,CSE 291,B00,094880,Yu; Qi,0,0,0,0
1653621744432,CSE 291,C00,090142,Pannuto; Patrick William,0,0,0,0
1653621744432,CSE 291,D00,094881,Zhang; Yiying,0,0,0,0
1653621744432,CSE 291,E00,095118,Su; Hao,0,0,0,0
1653621744959,CSE 293,001,094905,Bafna; Vineet,9999,0,9999,0
1653621744959,CSE 293,002,094906,Bellare; Mihir,9999,0,9999,0
1653621744959,CSE 293,003,094907,Berg-Kirkpatrick; Taylor D,9999,0,9999,0
1653621744959,CSE 293,004,094908,Christensen; Henrik I,9999,0,9999,0
1653621744959,CSE 293,005,094909,Cottrell; Garrison W,9999,0,9999,0
1653621744959,CSE 293,006,094910,Deutsch; Alin Bernard,9999,0,9999,0
1653621744959,CSE 293,007,094911,Esmaeilzadeh; Hadi,9999,0,9999,0
1653621744959,CSE 293,008,094912,Freund; Yoav,9999,0,9999,0
1653621744959,CSE 293,009,094913,Griswold; William G.,9999,0,9999,0
1653621744959,CSE 293,010,094914,Gymrek; Melissa Ann,9999,0,9999,0
1653621744959,CSE 293,011,094915,Heninger; Nadia A,9999,0,9999,0
1653621744959,CSE 293,012,094916,Impagliazzo; Russell,9999,0,9999,0
1653621744959,CSE 293,013,094917,Jhala; Ranjit,9999,0,9999,0
1653621744959,CSE 293,014,094918,Kahng; Andrew Byun,9999,0,9999,0
1653621744959,CSE 293,015,094919,Kane; Daniel Mertz,9999,0,9999,0
1653621744959,CSE 293,016,094920,Kriegman; David J,9999,0,9999,0
1653621744959,CSE 293,017,094921,Kumar; Arun Kumar,9999,0,9999,0
1653621744959,CSE 293,018,094922,Lerner; Sorin,9999,0,9999,0
1653621744959,CSE 293,019,094923,Lovett; Shachar,9999,0,9999,0
1653621744959,CSE 293,020,094924,McAuley; Julian John,9999,0,9999,0
1653621744959,CSE 293,021,094925,Micciancio; Daniele,9999,0,9999,0
1653621744959,CSE 293,022,094926,Orailoglu; Alex,9999,0,9999,0
1653621744959,CSE 293,023,094927,Paturi; Ramamohan,9999,0,9999,0
1653621744959,CSE 293,024,094928,Polikarpova; Nadezhda,9999,0,9999,0
1653621744959,CSE 293,025,094929,Politz; Joseph Gibbs,9999,0,9999,0
1653621744959,CSE 293,026,094930,Porter; George M,9999,0,9999,0
1653621744959,CSE 293,027,094931,Porter; Leonard Emerson,9999,0,9999,0
1653621744959,CSE 293,028,094932,Ramamoorthi; Ravi,9999,0,9999,0
1653621744959,CSE 293,029,094933,Sahoo; Debashis,9999,0,9999,0
1653621744959,CSE 293,030,094934,Saul; Lawrence,9999,0,9999,0
1653621744959,CSE 293,031,094935,Savage; Stefan,9999,0,9999,0
1653621744959,CSE 293,032,094936,Schulze; Jurgen P.,9999,0,9999,0
1653621744959,CSE 293,033,094937,Snoeren; Alex C.,9999,0,9999,0
1653621744959,CSE 293,034,094938,Shang; Jingbo,9999,0,9999,0
1653621744959,CSE 293,035,094939,Stefan; Deian,9999,0,9999,0
1653621744959,CSE 293,036,094940,Su; Hao,9999,0,9999,0
1653621744959,CSE 293,037,094941,Swanson; Steven James,9999,0,9999,0
1653621744959,CSE 293,038,094942,Tullsen; Dean Michael,9999,0,9999,0
1653621744959,CSE 293,039,094943,Voelker; Geoffrey M.,9999,0,9999,0
1653621744959,CSE 293,040,094944,Zhao; Jishen,9999,0,9999,0
1653621744959,CSE 293,041,094945,Zhou; Yuan-Yuan,9999,0,9999,0
1653621744959,CSE 293,042,094946,Gao; Sicun,9998,0,9999,1
1653621744959,CSE 293,043,094947,Weibel; Nadir,9999,0,9999,0
1653621744959,CSE 293,044,094948,Gupta; Rajesh K.,9999,0,9999,0
1653621745482,CSE 294,A00,090143,Porter; George M,9,0,10,1
1653621746007,DSE 200,A00,091799,Staff,50,0,50,0
1653621746533,DSE 203,A00,091800,Gupta; Amarnath,30,0,30,0
1653621747055,DSE 250,A00,091801,Deutsch; Alin Bernard,30,0,30,0
1653621747579,DSE 290,A00,091802,Altintas De Callaf; Ilkay,50,0,50,0
1653621748123,ECE 200,001,091003,Antipa; Nicholas A,9999,0,9999,0
1653621748123,ECE 200,002,091004,Atanasov; Nikolay A.,9999,0,9999,0
1653621748123,ECE 200,003,091005,Bharadia; Dinesh,9999,0,9999,0
1653621748123,ECE 200,004,091006,Cheng; Chung Kuan,9999,0,9999,0
1653621748123,ECE 200,005,091007,Cosman; Pamela C.,9999,0,9999,0
1653621748123,ECE 200,006,091008,Staff,9999,0,9999,0
1653621748123,ECE 200,007,091009,Dayeh; Shadi Ahmad,9999,0,9999,0
1653621748123,ECE 200,008,091010,Fainman; Yeshaiahu,9999,0,9999,0
1653621748123,ECE 200,009,091011,Ford; Joseph Earl,9999,0,9999,0
1653621748123,ECE 200,010,091012,Franceschetti; Massimo,9999,0,9999,0
1653621748123,ECE 200,011,091013,Fullerton; Eric E,9999,0,9999,0
1653621748123,ECE 200,012,091014,Galton; Ian A,9999,0,9999,0
1653621748123,ECE 200,013,091015,Gilja; Vikash,9999,0,9999,0
1653621748123,ECE 200,014,091016,Hall; Drew A.,9999,0,9999,0
1653621748123,ECE 200,015,091017,Hsueh; Tzu-Chien,9999,0,9999,0
1653621748123,ECE 200,016,091018,Javidi; Tara,9999,0,9999,0
1653621748123,ECE 200,017,091019,Kahng; Andrew Byun,9999,0,9999,0
1653621748123,ECE 200,018,091020,Kim; Young-Han,9999,0,9999,0
1653621748123,ECE 200,019,091021,Koushanfar; Farinaz,9999,0,9999,0
1653621748123,ECE 200,020,091022,Kuzum; Duygu,9999,0,9999,0
1653621748123,ECE 200,021,091023,Le; Hanh-Phuc,9999,0,9999,0
1653621748123,ECE 200,022,091024,Lin; Bill,9999,0,9999,0
1653621748123,ECE 200,023,091025,Liu; Zhaowei,9999,0,9999,0
1653621748123,ECE 200,024,091026,Lo; Yu-Hwa,9999,0,9999,0
1653621748123,ECE 200,025,091027,Lomakin; Vitaliy,9999,0,9999,0
1653621748123,ECE 200,026,091028,Mercier; Patrick Philip,9999,0,9999,0
1653621748123,ECE 200,027,091029,Meyer; Florian,9999,0,9999,0
1653621748123,ECE 200,028,091030,Milstein; Laurence B.,9999,0,9999,0
1653621748123,ECE 200,029,091031,Mir Arabbaygi; Siavash,9999,0,9999,0
1653621748123,ECE 200,030,091032,Mookherjea; Shayan,9999,0,9999,0
1653621748123,ECE 200,031,091033,Morris; Karcher William,9999,0,9999,0
1653621748123,ECE 200,032,091034,Ng; Tse Nga,9999,0,9999,0
1653621748123,ECE 200,033,091035,Nguyen; Truong Quang,9999,0,9999,0
1653621748123,ECE 200,034,091036,Nomura; Kenji,9999,0,9999,0
1653621748123,ECE 200,035,091037,Orlitsky; Alon,9999,0,9999,0
1653621748123,ECE 200,036,091038,Pal; Piya,9999,0,9999,0
1653621748123,ECE 200,037,091039,Papen; George C.,9999,0,9999,0
1653621748123,ECE 200,038,091040,Radic; Stojan,9999,0,9999,0
1653621748123,ECE 200,039,091041,Rao; Bhaskar D.,9999,0,9999,0
1653621748123,ECE 200,040,091042,Rao; Ramesh R,9999,0,9999,0
1653621748123,ECE 200,041,091043,Rebeiz; Gabriel,9999,0,9999,0
1653621748123,ECE 200,042,091044,Sanford; John R,9999,0,9999,0
1653621748123,ECE 200,043,091045,Siegel; Paul H.,9999,0,9999,0
1653621748123,ECE 200,044,091046,Sievenpiper; Daniel F.,9999,0,9999,0
1653621748123,ECE 200,045,091047,Sworder; David D.,9999,0,9999,0
1653621748123,ECE 200,046,091048,Taur; Yuan,9999,0,9999,0
1653621748123,ECE 200,047,091049,Touri; Behrouz,9999,0,9999,0
1653621748123,ECE 200,048,091050,Trivedi; Mohan M.,9999,0,9999,0
1653621748123,ECE 200,049,091051,Vardy; Alexander,9999,0,9999,0
1653621748123,ECE 200,050,091052,Vasconcelos; Nuno,9999,0,9999,0
1653621748123,ECE 200,051,091053,Wang; Xiaolong,9999,0,9999,0
1653621748123,ECE 200,052,091054,Xie; Pengtao,9999,0,9999,0
1653621748123,ECE 200,053,091055,Yip; Michael,9999,0,9999,0
1653621748123,ECE 200,054,091056,Zeger; Kenneth A.,9999,0,9999,0
1653621748123,ECE 200,055,091057,Zhang; Xinyu,9999,0,9999,0
1653621748123,ECE 200,056,091058,Turakhia; Yatish Girish,9999,0,9999,0
1653621748123,ECE 200,057,091059,Kang; Mingu,9999,0,9999,0
1653621748123,ECE 200,058,091060,Shi; Yuanyuan,9999,0,9999,0
1653621748123,ECE 200,059,091061,Wang; Edward Jay,9999,0,9999,0
1653621748123,ECE 200,060,091062,Zheng; Yang,9999,0,9999,0
1653621748647,ECE 201,A00,095526,Lo; Yu-Hwa,0,0,0,0
1653621749172,ECE 203,A00,091065,Mercier; Patrick Philip,0,0,0,0
1653621749699,ECE 207A,A00,091605,Liu; Thomas Tao-Ming,0,0,0,0
1653621750225,ECE 212AN,A00,091068,Nomura; Kenji,0,0,0,0
1653621750747,ECE 222A,A00,091069,Rebeiz; Gabriel,0,0,0,0
1653621751281,ECE 225A,A00,091070,Orlitsky; Alon,0,0,0,0
1653621751804,ECE 230A,A00,091071,Nomura; Kenji,0,0,0,0
1653621752326,ECE 236A,A00,091072,Dayeh; Shadi Ahmad,0,0,0,0
1653621752854,ECE 238A,A00,091073,Luo; Jian,0,0,0,0
1653621752854,ECE 238A,B00,091074,Luo; Jian,0,0,0,0
1653621753380,ECE 240A,A00,091075,Radic; Stojan,0,0,0,0
1653621753914,ECE 247A,A00,091592,Shi; Lingyan,0,0,0,0
1653621754437,ECE 250,A00,091076,Touri; Behrouz,0,0,0,0
1653621754959,ECE 251C,A00,091078,Nguyen; Truong Quang,0,0,0,0
1653621755482,ECE 253,A00,091079,Cosman; Pamela C.,0,0,0,0
1653621756004,ECE 255A,A00,091080,Orlitsky; Alon,0,0,0,0
1653621756531,ECE 257A,A00,091081,Zhang; Xinyu,0,0,0,0
1653621757057,ECE 260A,A01,091084,Eldon; John,0,0,0,0
1653621757582,ECE 264C,A00,091085,Galton; Ian A,0,0,0,0
1653621758104,ECE 265C,A00,094889,Presti; Calogero Davide,0,0,0,9
1653621758626,ECE 266,A01,091087,Hall; Drew A.,0,0,0,0
1653621759671,ECE 271A,A00,091090,Vasconcelos; Nuno,0,0,0,0
1653621760197,ECE 272B,A00,091091,Sworder; David D.,0,0,0,0
1653621760720,ECE 275A,A00,091092,Meyer; Florian,0,0,0,0
1653621761244,ECE 277,A00,091093,An; Cheolhong,0,0,0,0
1653621761768,ECE 283,A00,091094,Le; Hanh-Phuc,0,0,0,0
1653621762290,ECE 284,A00,091095,Kang; Mingu,0,0,0,0
1653621762290,ECE 284,B00,091096,Wang; Edward Jay,0,0,0,0
1653621762816,ECE 285,A00,094334,Touri; Behrouz,0,0,0,0
1653621763338,ECE 289,A00,091097,Whelan; David Arthur,0,0,0,0
1653621763870,MATH 200A,A00,087414,Salehi Golsefidy; Alireza,7,0,8,1
1653621764404,MATH 202A,A00,087415,Gill; Philip E.,2,0,8,6
1653621764930,MATH 203A,A00,087416,Oprea; Dragos N.,6,0,8,2
1653621765454,MATH 204A,A00,087417,Kedlaya; Kiran S.,6,0,8,2
1653621765977,MATH 205,A00,087418,Sorensen; Claus M,6,0,8,2
1653621766504,MATH 206A,A00,087419,Izadi; Elham,6,0,8,2
1653621767026,MATH 207A,A00,087420,Mohammadi; Amir,5,0,8,3
1653621767549,MATH 208,A00,087421,Staff,8,0,10,2
1653621768073,MATH 209,A00,087422,Staff,10,0,10,0
1653621768595,MATH 218,A00,087423,Staff,10,0,10,0
1653621769119,MATH 220A,A00,087424,Novak; Jonathan I,6,0,8,2
1653621769646,MATH 231A,A00,087425,Bejenaru; Ioan,3,0,8,5
1653621770169,MATH 240A,A00,087426,Ebenfelt; Peter F,5,0,8,3
1653621770706,MATH 243,A00,087427,Staff,9,0,10,1
1653621771233,MATH 248,A00,087429,Staff,10,0,10,0
1653621771761,MATH 250A,A00,087430,Spolaor; Luca,4,0,8,4
1653621772287,MATH 257A,A00,087431,Spolaor; Luca,7,0,8,1
1653621772810,MATH 258,A00,087432,Staff,9,0,10,1
1653621773341,MATH 264A,A00,087433,Warnke; Lutz Peter,5,0,8,3
1653621773875,MATH 268,A00,087434,Staff,15,0,15,0
1653621774402,MATH 269,A00,087435,Staff,14,0,15,1
1653621774927,MATH 270A,A00,087436,Nie; Jiawang,0,0,8,8
1653621775453,MATH 272A,A00,087437,Tian; Xiaochuan,0,0,8,8
1653621775976,MATH 274,A01,087439,Cheng; Li-Tien,9,0,10,1
1653621775976,MATH 274,A02,087440,Cheng; Li-Tien,10,0,10,0
1653621776509,MATH 278A,A00,087441,Staff,8,0,10,2
1653621777033,MATH 278B,A00,087442,Staff,8,0,10,2
1653621777559,MATH 278C,A00,087443,Staff,8,0,10,2
1653621778085,MATH 280A,A00,087444,Zheng; Tianyi,0,0,8,8
1653621778611,MATH 281A,A00,087445,Bradic; Jelena,0,0,8,9
1653621779134,MATH 282A,A00,087446,Zhang; Danna,0,0,8,8
1653621779658,MATH 283,A00,087447,Tesler; Glenn,0,0,0,16
1653621780180,MATH 286,B00,095535,Kemp; Todd Aahron,5,0,8,3
1653621780706,MATH 287D,B00,095536,Bradic; Jelena,5,0,8,3
1653621781230,MATH 288,A00,087450,Staff,14,0,15,1
1653621781230,MATH 288,B00,087451,Staff,15,0,15,0
1653621781230,MATH 288,C00,087452,Staff,15,0,15,0
1653621781763,MATH 290A,A00,087453,Xu; Zhouli,6,0,8,2
1653621782286,MATH 291A,A00,087454,Xu; Zhouli,7,0,8,1
1653621782814,MATH 292,A00,087455,Staff,10,0,10,0
1653621783337,MATH 295,A00,087456,Staff,50,0,50,0
1653621783862,MATH 297,001,087457,Staff,997,0,999,2
1653622343104,COGS 200,A01,087991,Staff,47,0,50,3
1653622343632,COGS 201,A01,094504,Rangel; Lara M,16,0,25,9
1653622344155,COGS 203,A00,087992,Coulson; Seana M,18,0,20,2
1653622344681,COGS 210A,001,087993,Greene; Deanna Jacquelyn,9998,0,9999,1
1653622344681,COGS 210A,002,087994,Saygin; Ayse P,9999,0,9999,0
1653622344681,COGS 210A,003,087995,Xia; Haijun,9999,0,9999,0
1653622344681,COGS 210A,004,087996,Nitz; Douglas A.,9999,0,9999,0
1653622344681,COGS 210A,005,087997,Hollan; James D.,9999,0,9999,0
1653622344681,COGS 210A,006,087998,Deak; Gedeon O.,9998,0,9999,1
1653622344681,COGS 210A,007,087999,Rossano; Federico,9999,0,9999,0
1653622345203,COGS 211A,A00,088000,Coulson; Seana M,9997,0,9999,2
1653622345726,COGS 229,A00,088002,Staff,22,0,25,3
1653622346262,COGS 260,B00,094231,Staff,17,0,20,3
1653622346262,COGS 260,A00,088004,Nitz; Douglas A.,9998,0,9999,1
1653622346791,CSE 202,A00,090110,Paturi; Ramamohan,0,0,0,0
1653622346791,CSE 202,B00,090111,Paturi; Ramamohan,0,0,0,0
1653622347314,CSE 207B,A00,090112,Heninger; Nadia A,0,0,0,0
1653622347837,CSE 208,A00,094858,Micciancio; Daniele,0,0,0,0
1653622348360,CSE 210,A00,090113,Powell; Thomas Allan,0,0,0,0
1653622348883,CSE 219,A00,090898,Staff,0,0,0,0
1653622349411,CSE 221,A00,090114,Zhou; Yuan-Yuan,0,0,0,0
1653622349933,CSE 229A,A00,090115,Porter; George M,0,0,0,0
1653622350455,CSE 229C,A00,090116,Savage; Stefan,0,0,0,0
1653622350994,CSE 230,A00,090117,Jhala; Ranjit,0,0,0,0
1653622351520,CSE 232,A00,090118,Papakonstantinou; Yannis,0,0,0,0
1653622352045,CSE 239A,A00,090121,Kumar; Arun Kumar,0,0,0,0
1653622352570,CSE 239B,A00,090122,Jhala; Ranjit,0,0,0,0
1653622353093,CSE 240A,A00,090123,Zhao; Jishen,0,0,189,189
1653622353619,CSE 243A,A00,090124,Orailoglu; Alex,0,0,15,15
1653622354149,CSE 249B,A00,090125,Kahng; Andrew Byun,12,0,20,8
1653622354673,CSE 250A,A00,090126,Berg-Kirkpatrick; Taylor D,0,0,0,0
1653622355196,CSE 252A,A00,090127,Ochoa; Benjamin Lawrence,0,0,0,0
1653622355719,CSE 258,A01,090129,McAuley; Julian John,0,0,0,0
1653622356242,CSE 258R,A01,090131,McAuley; Julian John,0,0,0,0
1653622356768,CSE 274,A00,090132,Ramamoorthi; Ravi,0,0,0,0
1653622357293,CSE 276A,A00,090133,Christensen; Henrik I,0,0,0,0
1653622357815,CSE 276C,A00,090134,Christensen; Henrik I,0,0,0,0
1653622358338,CSE 290,A00,090135,Bafna; Vineet,0,0,0,0
1653622358338,CSE 290,B00,090136,Ramamoorthi; Ravi,0,0,0,0
1653622358338,CSE 290,C00,090137,Li; Tzumao,7,0,10,3
1653622358338,CSE 290,D00,090138,Zhou; Yuan-Yuan,9,0,10,1
1653622358338,CSE 290,E00,090139,Christensen; Henrik I,8,0,10,2
1653622358338,CSE 290,F00,094053,Shalev; Aaron D,0,0,0,0
1653622358865,CSE 291,A00,090140,Munyaka; Imani N. S.,0,0,0,0
1653622358865,CSE 291,B00,094880,Yu; Qi,0,0,0,0
1653622358865,CSE 291,C00,090142,Pannuto; Patrick William,0,0,0,0
1653622358865,CSE 291,D00,094881,Zhang; Yiying,0,0,0,0
1653622358865,CSE 291,E00,095118,Su; Hao,0,0,0,0
1653622359400,CSE 293,001,094905,Bafna; Vineet,9999,0,9999,0
1653622359400,CSE 293,002,094906,Bellare; Mihir,9999,0,9999,0
1653622359400,CSE 293,003,094907,Berg-Kirkpatrick; Taylor D,9999,0,9999,0
1653622359400,CSE 293,004,094908,Christensen; Henrik I,9999,0,9999,0
1653622359400,CSE 293,005,094909,Cottrell; Garrison W,9999,0,9999,0
1653622359400,CSE 293,006,094910,Deutsch; Alin Bernard,9999,0,9999,0
1653622359400,CSE 293,007,094911,Esmaeilzadeh; Hadi,9999,0,9999,0
1653622359400,CSE 293,008,094912,Freund; Yoav,9999,0,9999,0
1653622359400,CSE 293,009,094913,Griswold; William G.,9999,0,9999,0
1653622359400,CSE 293,010,094914,Gymrek; Melissa Ann,9999,0,9999,0
1653622359400,CSE 293,011,094915,Heninger; Nadia A,9999,0,9999,0
1653622359400,CSE 293,012,094916,Impagliazzo; Russell,9999,0,9999,0
1653622359400,CSE 293,013,094917,Jhala; Ranjit,9999,0,9999,0
1653622359400,CSE 293,014,094918,Kahng; Andrew Byun,9999,0,9999,0
1653622359400,CSE 293,015,094919,Kane; Daniel Mertz,9999,0,9999,0
1653622359400,CSE 293,016,094920,Kriegman; David J,9999,0,9999,0
1653622359400,CSE 293,017,094921,Kumar; Arun Kumar,9999,0,9999,0
1653622359400,CSE 293,018,094922,Lerner; Sorin,9999,0,9999,0
1653622359400,CSE 293,019,094923,Lovett; Shachar,9999,0,9999,0
1653622359400,CSE 293,020,094924,McAuley; Julian John,9999,0,9999,0
1653622359400,CSE 293,021,094925,Micciancio; Daniele,9999,0,9999,0
1653622359400,CSE 293,022,094926,Orailoglu; Alex,9999,0,9999,0
1653622359400,CSE 293,023,094927,Paturi; Ramamohan,9999,0,9999,0
1653622359400,CSE 293,024,094928,Polikarpova; Nadezhda,9999,0,9999,0
1653622359400,CSE 293,025,094929,Politz; Joseph Gibbs,9999,0,9999,0
1653622359400,CSE 293,026,094930,Porter; George M,9999,0,9999,0
1653622359400,CSE 293,027,094931,Porter; Leonard Emerson,9999,0,9999,0
1653622359400,CSE 293,028,094932,Ramamoorthi; Ravi,9999,0,9999,0
1653622359400,CSE 293,029,094933,Sahoo; Debashis,9999,0,9999,0
1653622359400,CSE 293,030,094934,Saul; Lawrence,9999,0,9999,0
1653622359400,CSE 293,031,094935,Savage; Stefan,9999,0,9999,0
1653622359400,CSE 293,032,094936,Schulze; Jurgen P.,9999,0,9999,0
1653622359400,CSE 293,033,094937,Snoeren; Alex C.,9999,0,9999,0
1653622359400,CSE 293,034,094938,Shang; Jingbo,9999,0,9999,0
1653622359400,CSE 293,035,094939,Stefan; Deian,9999,0,9999,0
1653622359400,CSE 293,036,094940,Su; Hao,9999,0,9999,0
1653622359400,CSE 293,037,094941,Swanson; Steven James,9999,0,9999,0
1653622359400,CSE 293,038,094942,Tullsen; Dean Michael,9999,0,9999,0
1653622359400,CSE 293,039,094943,Voelker; Geoffrey M.,9999,0,9999,0
1653622359400,CSE 293,040,094944,Zhao; Jishen,9999,0,9999,0
1653622359400,CSE 293,041,094945,Zhou; Yuan-Yuan,9999,0,9999,0
1653622359400,CSE 293,042,094946,Gao; Sicun,9998,0,9999,1
1653622359400,CSE 293,043,094947,Weibel; Nadir,9999,0,9999,0
1653622359400,CSE 293,044,094948,Gupta; Rajesh K.,9999,0,9999,0
1653622359924,CSE 294,A00,090143,Porter; George M,9,0,10,1
1653622360448,DSE 200,A00,091799,Staff,50,0,50,0
1653622360971,DSE 203,A00,091800,Gupta; Amarnath,30,0,30,0
1653622361497,DSE 250,A00,091801,Deutsch; Alin Bernard,30,0,30,0
1653622362020,DSE 290,A00,091802,Altintas De Callaf; Ilkay,50,0,50,0
1653622362549,ECE 200,001,091003,Antipa; Nicholas A,9999,0,9999,0
1653622362549,ECE 200,002,091004,Atanasov; Nikolay A.,9999,0,9999,0
1653622362549,ECE 200,003,091005,Bharadia; Dinesh,9999,0,9999,0
1653622362549,ECE 200,004,091006,Cheng; Chung Kuan,9999,0,9999,0
1653622362549,ECE 200,005,091007,Cosman; Pamela C.,9999,0,9999,0
1653622362549,ECE 200,006,091008,Staff,9999,0,9999,0
1653622362549,ECE 200,007,091009,Dayeh; Shadi Ahmad,9999,0,9999,0
1653622362549,ECE 200,008,091010,Fainman; Yeshaiahu,9999,0,9999,0
1653622362549,ECE 200,009,091011,Ford; Joseph Earl,9999,0,9999,0
1653622362549,ECE 200,010,091012,Franceschetti; Massimo,9999,0,9999,0
1653622362549,ECE 200,011,091013,Fullerton; Eric E,9999,0,9999,0
1653622362549,ECE 200,012,091014,Galton; Ian A,9999,0,9999,0
1653622362549,ECE 200,013,091015,Gilja; Vikash,9999,0,9999,0
1653622362549,ECE 200,014,091016,Hall; Drew A.,9999,0,9999,0
1653622362549,ECE 200,015,091017,Hsueh; Tzu-Chien,9999,0,9999,0
1653622362549,ECE 200,016,091018,Javidi; Tara,9999,0,9999,0
1653622362549,ECE 200,017,091019,Kahng; Andrew Byun,9999,0,9999,0
1653622362549,ECE 200,018,091020,Kim; Young-Han,9999,0,9999,0
1653622362549,ECE 200,019,091021,Koushanfar; Farinaz,9999,0,9999,0
1653622362549,ECE 200,020,091022,Kuzum; Duygu,9999,0,9999,0
1653622362549,ECE 200,021,091023,Le; Hanh-Phuc,9999,0,9999,0
1653622362549,ECE 200,022,091024,Lin; Bill,9999,0,9999,0
1653622362549,ECE 200,023,091025,Liu; Zhaowei,9999,0,9999,0
1653622362549,ECE 200,024,091026,Lo; Yu-Hwa,9999,0,9999,0
1653622362549,ECE 200,025,091027,Lomakin; Vitaliy,9999,0,9999,0
1653622362549,ECE 200,026,091028,Mercier; Patrick Philip,9999,0,9999,0
1653622362549,ECE 200,027,091029,Meyer; Florian,9999,0,9999,0
1653622362549,ECE 200,028,091030,Milstein; Laurence B.,9999,0,9999,0
1653622362549,ECE 200,029,091031,Mir Arabbaygi; Siavash,9999,0,9999,0
1653622362549,ECE 200,030,091032,Mookherjea; Shayan,9999,0,9999,0
1653622362549,ECE 200,031,091033,Morris; Karcher William,9999,0,9999,0
1653622362549,ECE 200,032,091034,Ng; Tse Nga,9999,0,9999,0
1653622362549,ECE 200,033,091035,Nguyen; Truong Quang,9999,0,9999,0
1653622362549,ECE 200,034,091036,Nomura; Kenji,9999,0,9999,0
1653622362549,ECE 200,035,091037,Orlitsky; Alon,9999,0,9999,0
1653622362549,ECE 200,036,091038,Pal; Piya,9999,0,9999,0
1653622362549,ECE 200,037,091039,Papen; George C.,9999,0,9999,0
1653622362549,ECE 200,038,091040,Radic; Stojan,9999,0,9999,0
1653622362549,ECE 200,039,091041,Rao; Bhaskar D.,9999,0,9999,0
1653622362549,ECE 200,040,091042,Rao; Ramesh R,9999,0,9999,0
1653622362549,ECE 200,041,091043,Rebeiz; Gabriel,9999,0,9999,0
1653622362549,ECE 200,042,091044,Sanford; John R,9999,0,9999,0
1653622362549,ECE 200,043,091045,Siegel; Paul H.,9999,0,9999,0
1653622362549,ECE 200,044,091046,Sievenpiper; Daniel F.,9999,0,9999,0
1653622362549,ECE 200,045,091047,Sworder; David D.,9999,0,9999,0
1653622362549,ECE 200,046,091048,Taur; Yuan,9999,0,9999,0
1653622362549,ECE 200,047,091049,Touri; Behrouz,9999,0,9999,0
1653622362549,ECE 200,048,091050,Trivedi; Mohan M.,9999,0,9999,0
1653622362549,ECE 200,049,091051,Vardy; Alexander,9999,0,9999,0
1653622362549,ECE 200,050,091052,Vasconcelos; Nuno,9999,0,9999,0
1653622362549,ECE 200,051,091053,Wang; Xiaolong,9999,0,9999,0
1653622362549,ECE 200,052,091054,Xie; Pengtao,9999,0,9999,0
1653622362549,ECE 200,053,091055,Yip; Michael,9999,0,9999,0
1653622362549,ECE 200,054,091056,Zeger; Kenneth A.,9999,0,9999,0
1653622362549,ECE 200,055,091057,Zhang; Xinyu,9999,0,9999,0
1653622362549,ECE 200,056,091058,Turakhia; Yatish Girish,9999,0,9999,0
1653622362549,ECE 200,057,091059,Kang; Mingu,9999,0,9999,0
1653622362549,ECE 200,058,091060,Shi; Yuanyuan,9999,0,9999,0
1653622362549,ECE 200,059,091061,Wang; Edward Jay,9999,0,9999,0
1653622362549,ECE 200,060,091062,Zheng; Yang,9999,0,9999,0
1653622363077,ECE 201,A00,095526,Lo; Yu-Hwa,0,0,0,0
1653622363604,ECE 203,A00,091065,Mercier; Patrick Philip,0,0,0,0
1653622364139,ECE 207A,A00,091605,Liu; Thomas Tao-Ming,0,0,0,0
1653622364663,ECE 212AN,A00,091068,Nomura; Kenji,0,0,0,0
1653622365184,ECE 222A,A00,091069,Rebeiz; Gabriel,0,0,0,0
1653622365706,ECE 225A,A00,091070,Orlitsky; Alon,0,0,0,0
1653622366232,ECE 230A,A00,091071,Nomura; Kenji,0,0,0,0
1653622366758,ECE 236A,A00,091072,Dayeh; Shadi Ahmad,0,0,0,0
1653622367282,ECE 238A,A00,091073,Luo; Jian,0,0,0,0
1653622367282,ECE 238A,B00,091074,Luo; Jian,0,0,0,0
1653622367813,ECE 240A,A00,091075,Radic; Stojan,0,0,0,0
1653622368340,ECE 247A,A00,091592,Shi; Lingyan,0,0,0,0
1653622368866,ECE 250,A00,091076,Touri; Behrouz,0,0,0,0
1653622369392,ECE 251C,A00,091078,Nguyen; Truong Quang,0,0,0,0
1653622369916,ECE 253,A00,091079,Cosman; Pamela C.,0,0,0,0
1653622370441,ECE 255A,A00,091080,Orlitsky; Alon,0,0,0,0
1653622370966,ECE 257A,A00,091081,Zhang; Xinyu,0,0,0,0
1653622371491,ECE 260A,A01,091084,Eldon; John,0,0,0,0
1653622372014,ECE 264C,A00,091085,Galton; Ian A,0,0,0,0
1653622372537,ECE 265C,A00,094889,Presti; Calogero Davide,0,0,0,9
1653622373059,ECE 266,A01,091087,Hall; Drew A.,0,0,0,0
1653622374104,ECE 271A,A00,091090,Vasconcelos; Nuno,0,0,0,0
1653622374630,ECE 272B,A00,091091,Sworder; David D.,0,0,0,0
1653622375154,ECE 275A,A00,091092,Meyer; Florian,0,0,0,0
1653622375676,ECE 277,A00,091093,An; Cheolhong,0,0,0,0
1653622376200,ECE 283,A00,091094,Le; Hanh-Phuc,0,0,0,0
1653622376735,ECE 284,A00,091095,Kang; Mingu,0,0,0,0
1653622376735,ECE 284,B00,091096,Wang; Edward Jay,0,0,0,0
1653622377258,ECE 285,A00,094334,Touri; Behrouz,0,0,0,0
1653622377784,ECE 289,A00,091097,Whelan; David Arthur,0,0,0,0
1653622378306,MATH 200A,A00,087414,Salehi Golsefidy; Alireza,7,0,8,1
1653622378859,MATH 202A,A00,087415,Gill; Philip E.,2,0,8,6
1653622379388,MATH 203A,A00,087416,Oprea; Dragos N.,6,0,8,2
1653622379992,MATH 204A,A00,087417,Kedlaya; Kiran S.,6,0,8,2
1653622380517,MATH 205,A00,087418,Sorensen; Claus M,6,0,8,2
1653622381043,MATH 206A,A00,087419,Izadi; Elham,6,0,8,2
1653622381567,MATH 207A,A00,087420,Mohammadi; Amir,5,0,8,3
1653622382090,MATH 208,A00,087421,Staff,8,0,10,2
1653622382615,MATH 209,A00,087422,Staff,10,0,10,0
1653622383140,MATH 218,A00,087423,Staff,10,0,10,0
1653622383667,MATH 220A,A00,087424,Novak; Jonathan I,6,0,8,2
1653622384190,MATH 231A,A00,087425,Bejenaru; Ioan,3,0,8,5
1653622384712,MATH 240A,A00,087426,Ebenfelt; Peter F,5,0,8,3
1653622385242,MATH 243,A00,087427,Staff,9,0,10,1
1653622385764,MATH 248,A00,087429,Staff,10,0,10,0
1653622386290,MATH 250A,A00,087430,Spolaor; Luca,4,0,8,4
1653622386813,MATH 257A,A00,087431,Spolaor; Luca,7,0,8,1
1653622387337,MATH 258,A00,087432,Staff,9,0,10,1
1653622387860,MATH 264A,A00,087433,Warnke; Lutz Peter,5,0,8,3
1653622388383,MATH 268,A00,087434,Staff,15,0,15,0
1653622388905,MATH 269,A00,087435,Staff,14,0,15,1
1653622389429,MATH 270A,A00,087436,Nie; Jiawang,0,0,8,8
1653622389955,MATH 272A,A00,087437,Tian; Xiaochuan,0,0,8,8
1653622390478,MATH 274,A01,087439,Cheng; Li-Tien,9,0,10,1
1653622390478,MATH 274,A02,087440,Cheng; Li-Tien,10,0,10,0
1653622391003,MATH 278A,A00,087441,Staff,8,0,10,2
1653622391525,MATH 278B,A00,087442,Staff,8,0,10,2
1653622392060,MATH 278C,A00,087443,Staff,8,0,10,2
1653622392583,MATH 280A,A00,087444,Zheng; Tianyi,0,0,8,8
1653622393105,MATH 281A,A00,087445,Bradic; Jelena,0,0,8,9
1653622393629,MATH 282A,A00,087446,Zhang; Danna,0,0,8,8
1653622394154,MATH 283,A00,087447,Tesler; Glenn,0,0,0,16
1653622394680,MATH 286,B00,095535,Kemp; Todd Aahron,5,0,8,3
1653622395202,MATH 287D,B00,095536,Bradic; Jelena,5,0,8,3
1653622395725,MATH 288,A00,087450,Staff,14,0,15,1
1653622395725,MATH 288,B00,087451,Staff,15,0,15,0
1653622395725,MATH 288,C00,087452,Staff,15,0,15,0
1653622396251,MATH 290A,A00,087453,Xu; Zhouli,6,0,8,2
1653622396776,MATH 291A,A00,087454,Xu; Zhouli,7,0,8,1
1653622397303,MATH 292,A00,087455,Staff,10,0,10,0
1653622397829,MATH 295,A00,087456,Staff,50,0,50,0
1653622398350,MATH 297,001,087457,Staff,997,0,999,2
1653622957583,COGS 200,A01,087991,Staff,47,0,50,3
1653622958122,COGS 201,A01,094504,Rangel; Lara M,16,0,25,9
1653622958645,COGS 203,A00,087992,Coulson; Seana M,18,0,20,2
1653622959177,COGS 210A,001,087993,Greene; Deanna Jacquelyn,9998,0,9999,1
1653622959177,COGS 210A,002,087994,Saygin; Ayse P,9999,0,9999,0
1653622959177,COGS 210A,003,087995,Xia; Haijun,9999,0,9999,0
1653622959177,COGS 210A,004,087996,Nitz; Douglas A.,9999,0,9999,0
1653622959177,COGS 210A,005,087997,Hollan; James D.,9999,0,9999,0
1653622959177,COGS 210A,006,087998,Deak; Gedeon O.,9998,0,9999,1
1653622959177,COGS 210A,007,087999,Rossano; Federico,9999,0,9999,0
1653622959699,COGS 211A,A00,088000,Coulson; Seana M,9997,0,9999,2
1653622960225,COGS 229,A00,088002,Staff,22,0,25,3
1653622960758,COGS 260,B00,094231,Staff,17,0,20,3
1653622960758,COGS 260,A00,088004,Nitz; Douglas A.,9998,0,9999,1
1653622961284,CSE 202,A00,090110,Paturi; Ramamohan,0,0,0,0
1653622961284,CSE 202,B00,090111,Paturi; Ramamohan,0,0,0,0
1653622961806,CSE 207B,A00,090112,Heninger; Nadia A,0,0,0,0
1653622962332,CSE 208,A00,094858,Micciancio; Daniele,0,0,0,0
1653622962857,CSE 210,A00,090113,Powell; Thomas Allan,0,0,0,0
1653622963381,CSE 219,A00,090898,Staff,0,0,0,0
1653622963906,CSE 221,A00,090114,Zhou; Yuan-Yuan,0,0,0,0
1653622964428,CSE 229A,A00,090115,Porter; George M,0,0,0,0
1653622964952,CSE 229C,A00,090116,Savage; Stefan,0,0,0,0
1653622965478,CSE 230,A00,090117,Jhala; Ranjit,0,0,0,0
1653622966001,CSE 232,A00,090118,Papakonstantinou; Yannis,0,0,0,0
1653622966611,CSE 239A,A00,090121,Kumar; Arun Kumar,0,0,0,0
1653622967134,CSE 239B,A00,090122,Jhala; Ranjit,0,0,0,0
1653622967656,CSE 240A,A00,090123,Zhao; Jishen,0,0,189,189
1653622968185,CSE 243A,A00,090124,Orailoglu; Alex,0,0,15,15
1653622968712,CSE 249B,A00,090125,Kahng; Andrew Byun,12,0,20,8
1653622969235,CSE 250A,A00,090126,Berg-Kirkpatrick; Taylor D,0,0,0,0
1653622969766,CSE 252A,A00,090127,Ochoa; Benjamin Lawrence,0,0,0,0
1653622970290,CSE 258,A01,090129,McAuley; Julian John,0,0,0,0
1653622970816,CSE 258R,A01,090131,McAuley; Julian John,0,0,0,0
1653622971343,CSE 274,A00,090132,Ramamoorthi; Ravi,0,0,0,0
1653622971873,CSE 276A,A00,090133,Christensen; Henrik I,0,0,0,0
1653622972396,CSE 276C,A00,090134,Christensen; Henrik I,0,0,0,0
1653622972929,CSE 290,A00,090135,Bafna; Vineet,0,0,0,0
1653622972929,CSE 290,B00,090136,Ramamoorthi; Ravi,0,0,0,0
1653622972929,CSE 290,C00,090137,Li; Tzumao,7,0,10,3
1653622972929,CSE 290,D00,090138,Zhou; Yuan-Yuan,9,0,10,1
1653622972929,CSE 290,E00,090139,Christensen; Henrik I,8,0,10,2
1653622972929,CSE 290,F00,094053,Shalev; Aaron D,0,0,0,0
1653622973458,CSE 291,A00,090140,Munyaka; Imani N. S.,0,0,0,0
1653622973458,CSE 291,B00,094880,Yu; Qi,0,0,0,0
1653622973458,CSE 291,C00,090142,Pannuto; Patrick William,0,0,0,0
1653622973458,CSE 291,D00,094881,Zhang; Yiying,0,0,0,0
1653622973458,CSE 291,E00,095118,Su; Hao,0,0,0,0
1653622973993,CSE 293,001,094905,Bafna; Vineet,9999,0,9999,0
1653622973993,CSE 293,002,094906,Bellare; Mihir,9999,0,9999,0
1653622973993,CSE 293,003,094907,Berg-Kirkpatrick; Taylor D,9999,0,9999,0
1653622973993,CSE 293,004,094908,Christensen; Henrik I,9999,0,9999,0
1653622973993,CSE 293,005,094909,Cottrell; Garrison W,9999,0,9999,0
1653622973993,CSE 293,006,094910,Deutsch; Alin Bernard,9999,0,9999,0
1653622973993,CSE 293,007,094911,Esmaeilzadeh; Hadi,9999,0,9999,0
1653622973993,CSE 293,008,094912,Freund; Yoav,9999,0,9999,0
1653622973993,CSE 293,009,094913,Griswold; William G.,9999,0,9999,0
1653622973993,CSE 293,010,094914,Gymrek; Melissa Ann,9999,0,9999,0
1653622973993,CSE 293,011,094915,Heninger; Nadia A,9999,0,9999,0
1653622973993,CSE 293,012,094916,Impagliazzo; Russell,9999,0,9999,0
1653622973993,CSE 293,013,094917,Jhala; Ranjit,9999,0,9999,0
1653622973993,CSE 293,014,094918,Kahng; Andrew Byun,9999,0,9999,0
1653622973993,CSE 293,015,094919,Kane; Daniel Mertz,9999,0,9999,0
1653622973993,CSE 293,016,094920,Kriegman; David J,9999,0,9999,0
1653622973993,CSE 293,017,094921,Kumar; Arun Kumar,9999,0,9999,0
1653622973993,CSE 293,018,094922,Lerner; Sorin,9999,0,9999,0
1653622973993,CSE 293,019,094923,Lovett; Shachar,9999,0,9999,0
1653622973993,CSE 293,020,094924,McAuley; Julian John,9999,0,9999,0
1653622973993,CSE 293,021,094925,Micciancio; Daniele,9999,0,9999,0
1653622973993,CSE 293,022,094926,Orailoglu; Alex,9999,0,9999,0
1653622973993,CSE 293,023,094927,Paturi; Ramamohan,9999,0,9999,0
1653622973993,CSE 293,024,094928,Polikarpova; Nadezhda,9999,0,9999,0
1653622973993,CSE 293,025,094929,Politz; Joseph Gibbs,9999,0,9999,0
1653622973993,CSE 293,026,094930,Porter; George M,9999,0,9999,0
1653622973993,CSE 293,027,094931,Porter; Leonard Emerson,9999,0,9999,0
1653622973993,CSE 293,028,094932,Ramamoorthi; Ravi,9999,0,9999,0
1653622973993,CSE 293,029,094933,Sahoo; Debashis,9999,0,9999,0
1653622973993,CSE 293,030,094934,Saul; Lawrence,9999,0,9999,0
1653622973993,CSE 293,031,094935,Savage; Stefan,9999,0,9999,0
1653622973993,CSE 293,032,094936,Schulze; Jurgen P.,9999,0,9999,0
1653622973993,CSE 293,033,094937,Snoeren; Alex C.,9999,0,9999,0
1653622973993,CSE 293,034,094938,Shang; Jingbo,9999,0,9999,0
1653622973993,CSE 293,035,094939,Stefan; Deian,9999,0,9999,0
1653622973993,CSE 293,036,094940,Su; Hao,9999,0,9999,0
1653622973993,CSE 293,037,094941,Swanson; Steven James,9999,0,9999,0
1653622973993,CSE 293,038,094942,Tullsen; Dean Michael,9999,0,9999,0
1653622973993,CSE 293,039,094943,Voelker; Geoffrey M.,9999,0,9999,0
1653622973993,CSE 293,040,094944,Zhao; Jishen,9999,0,9999,0
1653622973993,CSE 293,041,094945,Zhou; Yuan-Yuan,9999,0,9999,0
1653622973993,CSE 293,042,094946,Gao; Sicun,9998,0,9999,1
1653622973993,CSE 293,043,094947,Weibel; Nadir,9999,0,9999,0
1653622973993,CSE 293,044,094948,Gupta; Rajesh K.,9999,0,9999,0
1653622974517,CSE 294,A00,090143,Porter; George M,9,0,10,1
1653622975041,DSE 200,A00,091799,Staff,50,0,50,0
1653622975564,DSE 203,A00,091800,Gupta; Amarnath,30,0,30,0
1653622976087,DSE 250,A00,091801,Deutsch; Alin Bernard,30,0,30,0
1653622976616,DSE 290,A00,091802,Altintas De Callaf; Ilkay,50,0,50,0
1653622977164,ECE 200,001,091003,Antipa; Nicholas A,9999,0,9999,0
1653622977164,ECE 200,002,091004,Atanasov; Nikolay A.,9999,0,9999,0
1653622977164,ECE 200,003,091005,Bharadia; Dinesh,9999,0,9999,0
1653622977164,ECE 200,004,091006,Cheng; Chung Kuan,9999,0,9999,0
1653622977164,ECE 200,005,091007,Cosman; Pamela C.,9999,0,9999,0
1653622977164,ECE 200,006,091008,Staff,9999,0,9999,0
1653622977164,ECE 200,007,091009,Dayeh; Shadi Ahmad,9999,0,9999,0
1653622977164,ECE 200,008,091010,Fainman; Yeshaiahu,9999,0,9999,0
1653622977164,ECE 200,009,091011,Ford; Joseph Earl,9999,0,9999,0
1653622977164,ECE 200,010,091012,Franceschetti; Massimo,9999,0,9999,0
1653622977164,ECE 200,011,091013,Fullerton; Eric E,9999,0,9999,0
1653622977164,ECE 200,012,091014,Galton; Ian A,9999,0,9999,0
1653622977164,ECE 200,013,091015,Gilja; Vikash,9999,0,9999,0
1653622977164,ECE 200,014,091016,Hall; Drew A.,9999,0,9999,0
1653622977164,ECE 200,015,091017,Hsueh; Tzu-Chien,9999,0,9999,0
1653622977164,ECE 200,016,091018,Javidi; Tara,9999,0,9999,0
1653622977164,ECE 200,017,091019,Kahng; Andrew Byun,9999,0,9999,0
1653622977164,ECE 200,018,091020,Kim; Young-Han,9999,0,9999,0
1653622977164,ECE 200,019,091021,Koushanfar; Farinaz,9999,0,9999,0
1653622977164,ECE 200,020,091022,Kuzum; Duygu,9999,0,9999,0
1653622977164,ECE 200,021,091023,Le; Hanh-Phuc,9999,0,9999,0
1653622977164,ECE 200,022,091024,Lin; Bill,9999,0,9999,0
1653622977164,ECE 200,023,091025,Liu; Zhaowei,9999,0,9999,0
1653622977164,ECE 200,024,091026,Lo; Yu-Hwa,9999,0,9999,0
1653622977164,ECE 200,025,091027,Lomakin; Vitaliy,9999,0,9999,0
1653622977164,ECE 200,026,091028,Mercier; Patrick Philip,9999,0,9999,0
1653622977164,ECE 200,027,091029,Meyer; Florian,9999,0,9999,0
1653622977164,ECE 200,028,091030,Milstein; Laurence B.,9999,0,9999,0
1653622977164,ECE 200,029,091031,Mir Arabbaygi; Siavash,9999,0,9999,0
1653622977164,ECE 200,030,091032,Mookherjea; Shayan,9999,0,9999,0
1653622977164,ECE 200,031,091033,Morris; Karcher William,9999,0,9999,0
1653622977164,ECE 200,032,091034,Ng; Tse Nga,9999,0,9999,0
1653622977164,ECE 200,033,091035,Nguyen; Truong Quang,9999,0,9999,0
1653622977164,ECE 200,034,091036,Nomura; Kenji,9999,0,9999,0
1653622977164,ECE 200,035,091037,Orlitsky; Alon,9999,0,9999,0
1653622977164,ECE 200,036,091038,Pal; Piya,9999,0,9999,0
1653622977164,ECE 200,037,091039,Papen; George C.,9999,0,9999,0
1653622977164,ECE 200,038,091040,Radic; Stojan,9999,0,9999,0
1653622977164,ECE 200,039,091041,Rao; Bhaskar D.,9999,0,9999,0
1653622977164,ECE 200,040,091042,Rao; Ramesh R,9999,0,9999,0
1653622977164,ECE 200,041,091043,Rebeiz; Gabriel,9999,0,9999,0
1653622977164,ECE 200,042,091044,Sanford; John R,9999,0,9999,0
1653622977164,ECE 200,043,091045,Siegel; Paul H.,9999,0,9999,0
1653622977164,ECE 200,044,091046,Sievenpiper; Daniel F.,9999,0,9999,0
1653622977164,ECE 200,045,091047,Sworder; David D.,9999,0,9999,0
1653622977164,ECE 200,046,091048,Taur; Yuan,9999,0,9999,0
1653622977164,ECE 200,047,091049,Touri; Behrouz,9999,0,9999,0
1653622977164,ECE 200,048,091050,Trivedi; Mohan M.,9999,0,9999,0
1653622977164,ECE 200,049,091051,Vardy; Alexander,9999,0,9999,0
1653622977164,ECE 200,050,091052,Vasconcelos; Nuno,9999,0,9999,0
1653622977164,ECE 200,051,091053,Wang; Xiaolong,9999,0,9999,0
1653622977164,ECE 200,052,091054,Xie; Pengtao,9999,0,9999,0
1653622977164,ECE 200,053,091055,Yip; Michael,9999,0,9999,0
1653622977164,ECE 200,054,091056,Zeger; Kenneth A.,9999,0,9999,0
1653622977164,ECE 200,055,091057,Zhang; Xinyu,9999,0,9999,0
1653622977164,ECE 200,056,091058,Turakhia; Yatish Girish,9999,0,9999,0
1653622977164,ECE 200,057,091059,Kang; Mingu,9999,0,9999,0
1653622977164,ECE 200,058,091060,Shi; Yuanyuan,9999,0,9999,0
1653622977164,ECE 200,059,091061,Wang; Edward Jay,9999,0,9999,0
1653622977164,ECE 200,060,091062,Zheng; Yang,9999,0,9999,0
1653622977689,ECE 201,A00,095526,Lo; Yu-Hwa,0,0,0,0
1653622978216,ECE 203,A00,091065,Mercier; Patrick Philip,0,0,0,0
1653622978742,ECE 207A,A00,091605,Liu; Thomas Tao-Ming,0,0,0,0
1653622979265,ECE 212AN,A00,091068,Nomura; Kenji,0,0,0,0
1653622979791,ECE 222A,A00,091069,Rebeiz; Gabriel,0,0,0,0
1653622980324,ECE 225A,A00,091070,Orlitsky; Alon,0,0,0,0
1653622980848,ECE 230A,A00,091071,Nomura; Kenji,0,0,0,0
1653622981373,ECE 236A,A00,091072,Dayeh; Shadi Ahmad,0,0,0,0
1653622981900,ECE 238A,A00,091073,Luo; Jian,0,0,0,0
1653622981900,ECE 238A,B00,091074,Luo; Jian,0,0,0,0
1653622982422,ECE 240A,A00,091075,Radic; Stojan,0,0,0,0
1653622982949,ECE 247A,A00,091592,Shi; Lingyan,0,0,0,0
1653622983477,ECE 250,A00,091076,Touri; Behrouz,0,0,0,0
1653622984000,ECE 251C,A00,091078,Nguyen; Truong Quang,0,0,0,0
1653622984526,ECE 253,A00,091079,Cosman; Pamela C.,0,0,0,0
1653622985054,ECE 255A,A00,091080,Orlitsky; Alon,0,0,0,0
1653622985581,ECE 257A,A00,091081,Zhang; Xinyu,0,0,0,0
1653622986109,ECE 260A,A01,091084,Eldon; John,0,0,0,0
1653622986632,ECE 264C,A00,091085,Galton; Ian A,0,0,0,0
1653622987161,ECE 265C,A00,094889,Presti; Calogero Davide,0,0,0,9
1653622987684,ECE 266,A01,091087,Hall; Drew A.,0,0,0,0
1653622988733,ECE 271A,A00,091090,Vasconcelos; Nuno,0,0,0,0
1653622989256,ECE 272B,A00,091091,Sworder; David D.,0,0,0,0
1653622989778,ECE 275A,A00,091092,Meyer; Florian,0,0,0,0
1653622990305,ECE 277,A00,091093,An; Cheolhong,0,0,0,0
1653622990827,ECE 283,A00,091094,Le; Hanh-Phuc,0,0,0,0
1653622991353,ECE 284,A00,091095,Kang; Mingu,0,0,0,0
1653622991353,ECE 284,B00,091096,Wang; Edward Jay,0,0,0,0
1653622991877,ECE 285,A00,094334,Touri; Behrouz,0,0,0,0
1653622992402,ECE 289,A00,091097,Whelan; David Arthur,0,0,0,0
1653622992935,MATH 200A,A00,087414,Salehi Golsefidy; Alireza,7,0,8,1
1653622993459,MATH 202A,A00,087415,Gill; Philip E.,2,0,8,6
1653622993982,MATH 203A,A00,087416,Oprea; Dragos N.,6,0,8,2
1653622994504,MATH 204A,A00,087417,Kedlaya; Kiran S.,6,0,8,2
1653622995042,MATH 205,A00,087418,Sorensen; Claus M,6,0,8,2
1653622995564,MATH 206A,A00,087419,Izadi; Elham,6,0,8,2
1653622996091,MATH 207A,A00,087420,Mohammadi; Amir,5,0,8,3
1653622996617,MATH 208,A00,087421,Staff,8,0,10,2
1653622997140,MATH 209,A00,087422,Staff,10,0,10,0
1653622997666,MATH 218,A00,087423,Staff,10,0,10,0
1653622998189,MATH 220A,A00,087424,Novak; Jonathan I,6,0,8,2
1653622998715,MATH 231A,A00,087425,Bejenaru; Ioan,3,0,8,5
1653622999239,MATH 240A,A00,087426,Ebenfelt; Peter F,5,0,8,3
1653622999768,MATH 243,A00,087427,Staff,9,0,10,1
1653623000297,MATH 248,A00,087429,Staff,10,0,10,0
1653623000826,MATH 250A,A00,087430,Spolaor; Luca,4,0,8,4
1653623001352,MATH 257A,A00,087431,Spolaor; Luca,7,0,8,1
1653623001875,MATH 258,A00,087432,Staff,9,0,10,1
1653623002401,MATH 264A,A00,087433,Warnke; Lutz Peter,5,0,8,3
1653623002923,MATH 268,A00,087434,Staff,15,0,15,0
1653623003447,MATH 269,A00,087435,Staff,14,0,15,1
1653623003980,MATH 270A,A00,087436,Nie; Jiawang,0,0,8,8
1653623004502,MATH 272A,A00,087437,Tian; Xiaochuan,0,0,8,8
1653623005028,MATH 274,A01,087439,Cheng; Li-Tien,9,0,10,1
1653623005028,MATH 274,A02,087440,Cheng; Li-Tien,10,0,10,0
1653623005560,MATH 278A,A00,087441,Staff,8,0,10,2
1653623006083,MATH 278B,A00,087442,Staff,8,0,10,2
1653623006605,MATH 278C,A00,087443,Staff,8,0,10,2
1653623007128,MATH 280A,A00,087444,Zheng; Tianyi,0,0,8,8
1653623007651,MATH 281A,A00,087445,Bradic; Jelena,0,0,8,9
1653623008173,MATH 282A,A00,087446,Zhang; Danna,0,0,8,8
1653623008700,MATH 283,A00,087447,Tesler; Glenn,0,0,0,16
1653623009223,MATH 286,B00,095535,Kemp; Todd Aahron,5,0,8,3
1653623009749,MATH 287D,B00,095536,Bradic; Jelena,5,0,8,3
1653623010286,MATH 288,A00,087450,Staff,14,0,15,1
1653623010286,MATH 288,B00,087451,Staff,15,0,15,0
1653623010286,MATH 288,C00,087452,Staff,15,0,15,0
1653623010809,MATH 290A,A00,087453,Xu; Zhouli,6,0,8,2
1653623011339,MATH 291A,A00,087454,Xu; Zhouli,7,0,8,1
1653623011874,MATH 292,A00,087455,Staff,10,0,10,0
1653623012400,MATH 295,A00,087456,Staff,50,0,50,0
1653623012933,MATH 297,001,087457,Staff,997,0,999,2
1653623572050,COGS 200,A01,087991,Staff,47,0,50,3
1653623572575,COGS 201,A01,094504,Rangel; Lara M,16,0,25,9
1653623573098,COGS 203,A00,087992,Coulson; Seana M,18,0,20,2
1653623573626,COGS 210A,001,087993,Greene; Deanna Jacquelyn,9998,0,9999,1
1653623573626,COGS 210A,002,087994,Saygin; Ayse P,9999,0,9999,0
1653623573626,COGS 210A,003,087995,Xia; Haijun,9999,0,9999,0
1653623573626,COGS 210A,004,087996,Nitz; Douglas A.,9999,0,9999,0
1653623573626,COGS 210A,005,087997,Hollan; James D.,9999,0,9999,0
1653623573626,COGS 210A,006,087998,Deak; Gedeon O.,9998,0,9999,1
1653623573626,COGS 210A,007,087999,Rossano; Federico,9999,0,9999,0
1653623574156,COGS 211A,A00,088000,Coulson; Seana M,9997,0,9999,2
1653623574683,COGS 229,A00,088002,Staff,22,0,25,3
1653623575208,COGS 260,B00,094231,Staff,17,0,20,3
1653623575208,COGS 260,A00,088004,Nitz; Douglas A.,9998,0,9999,1
1653623575733,CSE 202,A00,090110,Paturi; Ramamohan,0,0,0,0
1653623575733,CSE 202,B00,090111,Paturi; Ramamohan,0,0,0,0
1653623576255,CSE 207B,A00,090112,Heninger; Nadia A,0,0,0,0
1653623576778,CSE 208,A00,094858,Micciancio; Daniele,0,0,0,0
1653623577304,CSE 210,A00,090113,Powell; Thomas Allan,0,0,0,0
1653623577838,CSE 219,A00,090898,Staff,0,0,0,0
1653623578362,CSE 221,A00,090114,Zhou; Yuan-Yuan,0,0,0,0
1653623578886,CSE 229A,A00,090115,Porter; George M,0,0,0,0
1653623579411,CSE 229C,A00,090116,Savage; Stefan,0,0,0,0
1653623579939,CSE 230,A00,090117,Jhala; Ranjit,0,0,0,0
1653623580472,CSE 232,A00,090118,Papakonstantinou; Yannis,0,0,0,0
1653623580995,CSE 239A,A00,090121,Kumar; Arun Kumar,0,0,0,0
1653623581521,CSE 239B,A00,090122,Jhala; Ranjit,0,0,0,0
1653623582045,CSE 240A,A00,090123,Zhao; Jishen,0,0,189,189
1653623582570,CSE 243A,A00,090124,Orailoglu; Alex,0,0,15,15
1653623583095,CSE 249B,A00,090125,Kahng; Andrew Byun,12,0,20,8
1653623583624,CSE 250A,A00,090126,Berg-Kirkpatrick; Taylor D,0,0,0,0
1653623584146,CSE 252A,A00,090127,Ochoa; Benjamin Lawrence,0,0,0,0
1653623584677,CSE 258,A01,090129,McAuley; Julian John,0,0,0,0
1653623585203,CSE 258R,A01,090131,McAuley; Julian John,0,0,0,0
1653623585730,CSE 274,A00,090132,Ramamoorthi; Ravi,0,0,0,0
1653623586258,CSE 276A,A00,090133,Christensen; Henrik I,0,0,0,0
1653623586782,CSE 276C,A00,090134,Christensen; Henrik I,0,0,0,0
1653623587303,CSE 290,A00,090135,Bafna; Vineet,0,0,0,0
1653623587303,CSE 290,B00,090136,Ramamoorthi; Ravi,0,0,0,0
1653623587303,CSE 290,C00,090137,Li; Tzumao,7,0,10,3
1653623587303,CSE 290,D00,090138,Zhou; Yuan-Yuan,9,0,10,1
1653623587303,CSE 290,E00,090139,Christensen; Henrik I,8,0,10,2
1653623587303,CSE 290,F00,094053,Shalev; Aaron D,0,0,0,0
1653623587836,CSE 291,A00,090140,Munyaka; Imani N. S.,0,0,0,0
1653623587836,CSE 291,B00,094880,Yu; Qi,0,0,0,0
1653623587836,CSE 291,C00,090142,Pannuto; Patrick William,0,0,0,0
1653623587836,CSE 291,D00,094881,Zhang; Yiying,0,0,0,0
1653623587836,CSE 291,E00,095118,Su; Hao,0,0,0,0
1653623588389,CSE 293,001,094905,Bafna; Vineet,9999,0,9999,0
1653623588389,CSE 293,002,094906,Bellare; Mihir,9999,0,9999,0
1653623588389,CSE 293,003,094907,Berg-Kirkpatrick; Taylor D,9999,0,9999,0
1653623588389,CSE 293,004,094908,Christensen; Henrik I,9999,0,9999,0
1653623588389,CSE 293,005,094909,Cottrell; Garrison W,9999,0,9999,0
1653623588389,CSE 293,006,094910,Deutsch; Alin Bernard,9999,0,9999,0
1653623588389,CSE 293,007,094911,Esmaeilzadeh; Hadi,9999,0,9999,0
1653623588389,CSE 293,008,094912,Freund; Yoav,9999,0,9999,0
1653623588389,CSE 293,009,094913,Griswold; William G.,9999,0,9999,0
1653623588389,CSE 293,010,094914,Gymrek; Melissa Ann,9999,0,9999,0
1653623588389,CSE 293,011,094915,Heninger; Nadia A,9999,0,9999,0
1653623588389,CSE 293,012,094916,Impagliazzo; Russell,9999,0,9999,0
1653623588389,CSE 293,013,094917,Jhala; Ranjit,9999,0,9999,0
1653623588389,CSE 293,014,094918,Kahng; Andrew Byun,9999,0,9999,0
1653623588389,CSE 293,015,094919,Kane; Daniel Mertz,9999,0,9999,0
1653623588389,CSE 293,016,094920,Kriegman; David J,9999,0,9999,0
1653623588389,CSE 293,017,094921,Kumar; Arun Kumar,9999,0,9999,0
1653623588389,CSE 293,018,094922,Lerner; Sorin,9999,0,9999,0
1653623588389,CSE 293,019,094923,Lovett; Shachar,9999,0,9999,0
1653623588389,CSE 293,020,094924,McAuley; Julian John,9999,0,9999,0
1653623588389,CSE 293,021,094925,Micciancio; Daniele,9999,0,9999,0
1653623588389,CSE 293,022,094926,Orailoglu; Alex,9999,0,9999,0
1653623588389,CSE 293,023,094927,Paturi; Ramamohan,9999,0,9999,0
1653623588389,CSE 293,024,094928,Polikarpova; Nadezhda,9999,0,9999,0
1653623588389,CSE 293,025,094929,Politz; Joseph Gibbs,9999,0,9999,0
1653623588389,CSE 293,026,094930,Porter; George M,9999,0,9999,0
1653623588389,CSE 293,027,094931,Porter; Leonard Emerson,9999,0,9999,0
1653623588389,CSE 293,028,094932,Ramamoorthi; Ravi,9999,0,9999,0
1653623588389,CSE 293,029,094933,Sahoo; Debashis,9999,0,9999,0
1653623588389,CSE 293,030,094934,Saul; Lawrence,9999,0,9999,0
1653623588389,CSE 293,031,094935,Savage; Stefan,9999,0,9999,0
1653623588389,CSE 293,032,094936,Schulze; Jurgen P.,9999,0,9999,0
1653623588389,CSE 293,033,094937,Snoeren; Alex C.,9999,0,9999,0
1653623588389,CSE 293,034,094938,Shang; Jingbo,9999,0,9999,0
1653623588389,CSE 293,035,094939,Stefan; Deian,9999,0,9999,0
1653623588389,CSE 293,036,094940,Su; Hao,9999,0,9999,0
1653623588389,CSE 293,037,094941,Swanson; Steven James,9999,0,9999,0
1653623588389,CSE 293,038,094942,Tullsen; Dean Michael,9999,0,9999,0
1653623588389,CSE 293,039,094943,Voelker; Geoffrey M.,9999,0,9999,0
1653623588389,CSE 293,040,094944,Zhao; Jishen,9999,0,9999,0
1653623588389,CSE 293,041,094945,Zhou; Yuan-Yuan,9999,0,9999,0
1653623588389,CSE 293,042,094946,Gao; Sicun,9998,0,9999,1
1653623588389,CSE 293,043,094947,Weibel; Nadir,9999,0,9999,0
1653623588389,CSE 293,044,094948,Gupta; Rajesh K.,9999,0,9999,0
1653623588914,CSE 294,A00,090143,Porter; George M,9,0,10,1
1653623589440,DSE 200,A00,091799,Staff,50,0,50,0
1653623589962,DSE 203,A00,091800,Gupta; Amarnath,30,0,30,0
1653623590488,DSE 250,A00,091801,Deutsch; Alin Bernard,30,0,30,0
1653623591011,DSE 290,A00,091802,Altintas De Callaf; Ilkay,50,0,50,0
1653623591537,ECE 200,001,091003,Antipa; Nicholas A,9999,0,9999,0
1653623591537,ECE 200,002,091004,Atanasov; Nikolay A.,9999,0,9999,0
1653623591537,ECE 200,003,091005,Bharadia; Dinesh,9999,0,9999,0
1653623591537,ECE 200,004,091006,Cheng; Chung Kuan,9999,0,9999,0
1653623591537,ECE 200,005,091007,Cosman; Pamela C.,9999,0,9999,0
1653623591537,ECE 200,006,091008,Staff,9999,0,9999,0
1653623591537,ECE 200,007,091009,Dayeh; Shadi Ahmad,9999,0,9999,0
1653623591537,ECE 200,008,091010,Fainman; Yeshaiahu,9999,0,9999,0
1653623591537,ECE 200,009,091011,Ford; Joseph Earl,9999,0,9999,0
1653623591537,ECE 200,010,091012,Franceschetti; Massimo,9999,0,9999,0
1653623591537,ECE 200,011,091013,Fullerton; Eric E,9999,0,9999,0
1653623591537,ECE 200,012,091014,Galton; Ian A,9999,0,9999,0
1653623591537,ECE 200,013,091015,Gilja; Vikash,9999,0,9999,0
1653623591537,ECE 200,014,091016,Hall; Drew A.,9999,0,9999,0
1653623591537,ECE 200,015,091017,Hsueh; Tzu-Chien,9999,0,9999,0
1653623591537,ECE 200,016,091018,Javidi; Tara,9999,0,9999,0
1653623591537,ECE 200,017,091019,Kahng; Andrew Byun,9999,0,9999,0
1653623591537,ECE 200,018,091020,Kim; Young-Han,9999,0,9999,0
1653623591537,ECE 200,019,091021,Koushanfar; Farinaz,9999,0,9999,0
1653623591537,ECE 200,020,091022,Kuzum; Duygu,9999,0,9999,0
1653623591537,ECE 200,021,091023,Le; Hanh-Phuc,9999,0,9999,0
1653623591537,ECE 200,022,091024,Lin; Bill,9999,0,9999,0
1653623591537,ECE 200,023,091025,Liu; Zhaowei,9999,0,9999,0
1653623591537,ECE 200,024,091026,Lo; Yu-Hwa,9999,0,9999,0
1653623591537,ECE 200,025,091027,Lomakin; Vitaliy,9999,0,9999,0
1653623591537,ECE 200,026,091028,Mercier; Patrick Philip,9999,0,9999,0
1653623591537,ECE 200,027,091029,Meyer; Florian,9999,0,9999,0
1653623591537,ECE 200,028,091030,Milstein; Laurence B.,9999,0,9999,0
1653623591537,ECE 200,029,091031,Mir Arabbaygi; Siavash,9999,0,9999,0
1653623591537,ECE 200,030,091032,Mookherjea; Shayan,9999,0,9999,0
1653623591537,ECE 200,031,091033,Morris; Karcher William,9999,0,9999,0
1653623591537,ECE 200,032,091034,Ng; Tse Nga,9999,0,9999,0
1653623591537,ECE 200,033,091035,Nguyen; Truong Quang,9999,0,9999,0
1653623591537,ECE 200,034,091036,Nomura; Kenji,9999,0,9999,0
1653623591537,ECE 200,035,091037,Orlitsky; Alon,9999,0,9999,0
1653623591537,ECE 200,036,091038,Pal; Piya,9999,0,9999,0
1653623591537,ECE 200,037,091039,Papen; George C.,9999,0,9999,0
1653623591537,ECE 200,038,091040,Radic; Stojan,9999,0,9999,0
1653623591537,ECE 200,039,091041,Rao; Bhaskar D.,9999,0,9999,0
1653623591537,ECE 200,040,091042,Rao; Ramesh R,9999,0,9999,0
1653623591537,ECE 200,041,091043,Rebeiz; Gabriel,9999,0,9999,0
1653623591537,ECE 200,042,091044,Sanford; John R,9999,0,9999,0
1653623591537,ECE 200,043,091045,Siegel; Paul H.,9999,0,9999,0
1653623591537,ECE 200,044,091046,Sievenpiper; Daniel F.,9999,0,9999,0
1653623591537,ECE 200,045,091047,Sworder; David D.,9999,0,9999,0
1653623591537,ECE 200,046,091048,Taur; Yuan,9999,0,9999,0
1653623591537,ECE 200,047,091049,Touri; Behrouz,9999,0,9999,0
1653623591537,ECE 200,048,091050,Trivedi; Mohan M.,9999,0,9999,0
1653623591537,ECE 200,049,091051,Vardy; Alexander,9999,0,9999,0
1653623591537,ECE 200,050,091052,Vasconcelos; Nuno,9999,0,9999,0
1653623591537,ECE 200,051,091053,Wang; Xiaolong,9999,0,9999,0
1653623591537,ECE 200,052,091054,Xie; Pengtao,9999,0,9999,0
1653623591537,ECE 200,053,091055,Yip; Michael,9999,0,9999,0
1653623591537,ECE 200,054,091056,Zeger; Kenneth A.,9999,0,9999,0
1653623591537,ECE 200,055,091057,Zhang; Xinyu,9999,0,9999,0
1653623591537,ECE 200,056,091058,Turakhia; Yatish Girish,9999,0,9999,0
1653623591537,ECE 200,057,091059,Kang; Mingu,9999,0,9999,0
1653623591537,ECE 200,058,091060,Shi; Yuanyuan,9999,0,9999,0
1653623591537,ECE 200,059,091061,Wang; Edward Jay,9999,0,9999,0
1653623591537,ECE 200,060,091062,Zheng; Yang,9999,0,9999,0
1653623592060,ECE 201,A00,095526,Lo; Yu-Hwa,0,0,0,0
1653623592591,ECE 203,A00,091065,Mercier; Patrick Philip,0,0,0,0
1653623593120,ECE 207A,A00,091605,Liu; Thomas Tao-Ming,0,0,0,0
1653623593642,ECE 212AN,A00,091068,Nomura; Kenji,0,0,0,0
1653623594164,ECE 222A,A00,091069,Rebeiz; Gabriel,0,0,0,0
1653623594687,ECE 225A,A00,091070,Orlitsky; Alon,0,0,0,0
1653623595209,ECE 230A,A00,091071,Nomura; Kenji,0,0,0,0
1653623595731,ECE 236A,A00,091072,Dayeh; Shadi Ahmad,0,0,0,0
1653623596258,ECE 238A,A00,091073,Luo; Jian,0,0,0,0
1653623596258,ECE 238A,B00,091074,Luo; Jian,0,0,0,0
1653623596780,ECE 240A,A00,091075,Radic; Stojan,0,0,0,0
1653623597303,ECE 247A,A00,091592,Shi; Lingyan,0,0,0,0
1653623597828,ECE 250,A00,091076,Touri; Behrouz,0,0,0,0
1653623598350,ECE 251C,A00,091078,Nguyen; Truong Quang,0,0,0,0
1653623598876,ECE 253,A00,091079,Cosman; Pamela C.,0,0,0,0
1653623599402,ECE 255A,A00,091080,Orlitsky; Alon,0,0,0,0
1653623599925,ECE 257A,A00,091081,Zhang; Xinyu,0,0,0,0
1653623600451,ECE 260A,A01,091084,Eldon; John,0,0,0,0
1653623600974,ECE 264C,A00,091085,Galton; Ian A,0,0,0,0
1653623601496,ECE 265C,A00,094889,Presti; Calogero Davide,0,0,0,9
1653623602023,ECE 266,A01,091087,Hall; Drew A.,0,0,0,0
1653623603081,ECE 271A,A00,091090,Vasconcelos; Nuno,0,0,0,0
1653623603604,ECE 272B,A00,091091,Sworder; David D.,0,0,0,0
1653623604128,ECE 275A,A00,091092,Meyer; Florian,0,0,0,0
1653623604651,ECE 277,A00,091093,An; Cheolhong,0,0,0,0
1653623605174,ECE 283,A00,091094,Le; Hanh-Phuc,0,0,0,0
1653623605700,ECE 284,A00,091095,Kang; Mingu,0,0,0,0
1653623605700,ECE 284,B00,091096,Wang; Edward Jay,0,0,0,0
1653623606312,ECE 285,A00,094334,Touri; Behrouz,0,0,0,0
1653623606837,ECE 289,A00,091097,Whelan; David Arthur,0,0,0,0
1653623607361,MATH 200A,A00,087414,Salehi Golsefidy; Alireza,7,0,8,1
1653623607884,MATH 202A,A00,087415,Gill; Philip E.,2,0,8,6
1653623608408,MATH 203A,A00,087416,Oprea; Dragos N.,6,0,8,2
1653623608931,MATH 204A,A00,087417,Kedlaya; Kiran S.,6,0,8,2
1653623609456,MATH 205,A00,087418,Sorensen; Claus M,6,0,8,2
1653623609985,MATH 206A,A00,087419,Izadi; Elham,6,0,8,2
1653623610507,MATH 207A,A00,087420,Mohammadi; Amir,5,0,8,3
1653623611041,MATH 208,A00,087421,Staff,8,0,10,2
1653623611567,MATH 209,A00,087422,Staff,10,0,10,0
1653623612089,MATH 218,A00,087423,Staff,10,0,10,0
1653623612612,MATH 220A,A00,087424,Novak; Jonathan I,6,0,8,2
1653623613138,MATH 231A,A00,087425,Bejenaru; Ioan,3,0,8,5
1653623613664,MATH 240A,A00,087426,Ebenfelt; Peter F,5,0,8,3
1653623614188,MATH 243,A00,087427,Staff,9,0,10,1
1653623614710,MATH 248,A00,087429,Staff,10,0,10,0
1653623615236,MATH 250A,A00,087430,Spolaor; Luca,4,0,8,4
1653623615761,MATH 257A,A00,087431,Spolaor; Luca,7,0,8,1
1653623616283,MATH 258,A00,087432,Staff,9,0,10,1
1653623616806,MATH 264A,A00,087433,Warnke; Lutz Peter,5,0,8,3
1653623617328,MATH 268,A00,087434,Staff,15,0,15,0
1653623617851,MATH 269,A00,087435,Staff,14,0,15,1
1653623618372,MATH 270A,A00,087436,Nie; Jiawang,0,0,8,8
1653623618896,MATH 272A,A00,087437,Tian; Xiaochuan,0,0,8,8
1653623619423,MATH 274,A01,087439,Cheng; Li-Tien,9,0,10,1
1653623619423,MATH 274,A02,087440,Cheng; Li-Tien,10,0,10,0
1653623619948,MATH 278A,A00,087441,Staff,8,0,10,2
1653623620472,MATH 278B,A00,087442,Staff,8,0,10,2
1653623620998,MATH 278C,A00,087443,Staff,8,0,10,2
1653623621524,MATH 280A,A00,087444,Zheng; Tianyi,0,0,8,8
1653623622046,MATH 281A,A00,087445,Bradic; Jelena,0,0,8,9
1653623622569,MATH 282A,A00,087446,Zhang; Danna,0,0,8,8
1653623623092,MATH 283,A00,087447,Tesler; Glenn,0,0,0,16
1653623623619,MATH 286,B00,095535,Kemp; Todd Aahron,5,0,8,3
1653623624142,MATH 287D,B00,095536,Bradic; Jelena,5,0,8,3
1653623624671,MATH 288,A00,087450,Staff,14,0,15,1
1653623624671,MATH 288,B00,087451,Staff,15,0,15,0
1653623624671,MATH 288,C00,087452,Staff,15,0,15,0
1653623625198,MATH 290A,A00,087453,Xu; Zhouli,6,0,8,2
1653623625725,MATH 291A,A00,087454,Xu; Zhouli,7,0,8,1
1653623626255,MATH 292,A00,087455,Staff,10,0,10,0
1653623626779,MATH 295,A00,087456,Staff,50,0,50,0
1653623627311,MATH 297,001,087457,Staff,997,0,999,2
1653624196723,COGS 200,A01,087991,Staff,47,0,50,3
1653624197250,COGS 201,A01,094504,Rangel; Lara M,16,0,25,9
1653624197775,COGS 203,A00,087992,Coulson; Seana M,18,0,20,2
1653624198305,COGS 210A,001,087993,Greene; Deanna Jacquelyn,9998,0,9999,1
1653624198305,COGS 210A,002,087994,Saygin; Ayse P,9999,0,9999,0
1653624198305,COGS 210A,003,087995,Xia; Haijun,9999,0,9999,0
1653624198305,COGS 210A,004,087996,Nitz; Douglas A.,9999,0,9999,0
1653624198305,COGS 210A,005,087997,Hollan; James D.,9999,0,9999,0
1653624198305,COGS 210A,006,087998,Deak; Gedeon O.,9998,0,9999,1
1653624198305,COGS 210A,007,087999,Rossano; Federico,9999,0,9999,0
1653624198828,COGS 211A,A00,088000,Coulson; Seana M,9997,0,9999,2
1653624199352,COGS 229,A00,088002,Staff,22,0,25,3
1653624199875,COGS 260,B00,094231,Staff,17,0,20,3
1653624199875,COGS 260,A00,088004,Nitz; Douglas A.,9998,0,9999,1
1653624200405,CSE 202,A00,090110,Paturi; Ramamohan,0,0,0,0
1653624200405,CSE 202,B00,090111,Paturi; Ramamohan,0,0,0,0
1653624200926,CSE 207B,A00,090112,Heninger; Nadia A,0,0,0,0
1653624201447,CSE 208,A00,094858,Micciancio; Daniele,0,0,0,0
1653624201970,CSE 210,A00,090113,Powell; Thomas Allan,0,0,0,0
1653624202504,CSE 219,A00,090898,Staff,0,0,0,0
1653624203098,CSE 221,A00,090114,Zhou; Yuan-Yuan,0,0,0,0
1653624203637,CSE 229A,A00,090115,Porter; George M,0,0,0,0
1653624204158,CSE 229C,A00,090116,Savage; Stefan,0,0,0,0
1653624204686,CSE 230,A00,090117,Jhala; Ranjit,0,0,0,0
1653624205211,CSE 232,A00,090118,Papakonstantinou; Yannis,0,0,0,0
1653624205737,CSE 239A,A00,090121,Kumar; Arun Kumar,0,0,0,0
1653624206259,CSE 239B,A00,090122,Jhala; Ranjit,0,0,0,0
1653624206796,CSE 240A,A00,090123,Zhao; Jishen,0,0,189,189
1653624207317,CSE 243A,A00,090124,Orailoglu; Alex,0,0,15,15
1653624207841,CSE 249B,A00,090125,Kahng; Andrew Byun,12,0,20,8
1653624208390,CSE 250A,A00,090126,Berg-Kirkpatrick; Taylor D,0,0,0,0
1653624208917,CSE 252A,A00,090127,Ochoa; Benjamin Lawrence,0,0,0,0
1653624209440,CSE 258,A01,090129,McAuley; Julian John,0,0,0,0
1653624209962,CSE 258R,A01,090131,McAuley; Julian John,0,0,0,0
1653624210487,CSE 274,A00,090132,Ramamoorthi; Ravi,0,0,0,0
1653624211010,CSE 276A,A00,090133,Christensen; Henrik I,0,0,0,0
1653624211532,CSE 276C,A00,090134,Christensen; Henrik I,0,0,0,0
1653624212054,CSE 290,A00,090135,Bafna; Vineet,0,0,0,0
1653624212054,CSE 290,B00,090136,Ramamoorthi; Ravi,0,0,0,0
1653624212054,CSE 290,C00,090137,Li; Tzumao,7,0,10,3
1653624212054,CSE 290,D00,090138,Zhou; Yuan-Yuan,9,0,10,1
1653624212054,CSE 290,E00,090139,Christensen; Henrik I,8,0,10,2
1653624212054,CSE 290,F00,094053,Shalev; Aaron D,0,0,0,0
1653624212582,CSE 291,A00,090140,Munyaka; Imani N. S.,0,0,0,0
1653624212582,CSE 291,B00,094880,Yu; Qi,0,0,0,0
1653624212582,CSE 291,C00,090142,Pannuto; Patrick William,0,0,0,0
1653624212582,CSE 291,D00,094881,Zhang; Yiying,0,0,0,0
1653624212582,CSE 291,E00,095118,Su; Hao,0,0,0,0
1653624213126,CSE 293,001,094905,Bafna; Vineet,9999,0,9999,0
1653624213126,CSE 293,002,094906,Bellare; Mihir,9999,0,9999,0
1653624213126,CSE 293,003,094907,Berg-Kirkpatrick; Taylor D,9999,0,9999,0
1653624213126,CSE 293,004,094908,Christensen; Henrik I,9999,0,9999,0
1653624213126,CSE 293,005,094909,Cottrell; Garrison W,9999,0,9999,0
1653624213126,CSE 293,006,094910,Deutsch; Alin Bernard,9999,0,9999,0
1653624213126,CSE 293,007,094911,Esmaeilzadeh; Hadi,9999,0,9999,0
1653624213126,CSE 293,008,094912,Freund; Yoav,9999,0,9999,0
1653624213126,CSE 293,009,094913,Griswold; William G.,9999,0,9999,0
1653624213126,CSE 293,010,094914,Gymrek; Melissa Ann,9999,0,9999,0
1653624213126,CSE 293,011,094915,Heninger; Nadia A,9999,0,9999,0
1653624213126,CSE 293,012,094916,Impagliazzo; Russell,9999,0,9999,0
1653624213126,CSE 293,013,094917,Jhala; Ranjit,9999,0,9999,0
1653624213126,CSE 293,014,094918,Kahng; Andrew Byun,9999,0,9999,0
1653624213126,CSE 293,015,094919,Kane; Daniel Mertz,9999,0,9999,0
1653624213126,CSE 293,016,094920,Kriegman; David J,9999,0,9999,0
1653624213126,CSE 293,017,094921,Kumar; Arun Kumar,9999,0,9999,0
1653624213126,CSE 293,018,094922,Lerner; Sorin,9999,0,9999,0
1653624213126,CSE 293,019,094923,Lovett; Shachar,9999,0,9999,0
1653624213126,CSE 293,020,094924,McAuley; Julian John,9999,0,9999,0
1653624213126,CSE 293,021,094925,Micciancio; Daniele,9999,0,9999,0
1653624213126,CSE 293,022,094926,Orailoglu; Alex,9999,0,9999,0
1653624213126,CSE 293,023,094927,Paturi; Ramamohan,9999,0,9999,0
1653624213126,CSE 293,024,094928,Polikarpova; Nadezhda,9999,0,9999,0
1653624213126,CSE 293,025,094929,Politz; Joseph Gibbs,9999,0,9999,0
1653624213126,CSE 293,026,094930,Porter; George M,9999,0,9999,0
1653624213126,CSE 293,027,094931,Porter; Leonard Emerson,9999,0,9999,0
1653624213126,CSE 293,028,094932,Ramamoorthi; Ravi,9999,0,9999,0
1653624213126,CSE 293,029,094933,Sahoo; Debashis,9999,0,9999,0
1653624213126,CSE 293,030,094934,Saul; Lawrence,9999,0,9999,0
1653624213126,CSE 293,031,094935,Savage; Stefan,9999,0,9999,0
1653624213126,CSE 293,032,094936,Schulze; Jurgen P.,9999,0,9999,0
1653624213126,CSE 293,033,094937,Snoeren; Alex C.,9999,0,9999,0
1653624213126,CSE 293,034,094938,Shang; Jingbo,9999,0,9999,0
1653624213126,CSE 293,035,094939,Stefan; Deian,9999,0,9999,0
1653624213126,CSE 293,036,094940,Su; Hao,9999,0,9999,0
1653624213126,CSE 293,037,094941,Swanson; Steven James,9999,0,9999,0
1653624213126,CSE 293,038,094942,Tullsen; Dean Michael,9999,0,9999,0
1653624213126,CSE 293,039,094943,Voelker; Geoffrey M.,9999,0,9999,0
1653624213126,CSE 293,040,094944,Zhao; Jishen,9999,0,9999,0
1653624213126,CSE 293,041,094945,Zhou; Yuan-Yuan,9999,0,9999,0
1653624213126,CSE 293,042,094946,Gao; Sicun,9998,0,9999,1
1653624213126,CSE 293,043,094947,Weibel; Nadir,9999,0,9999,0
1653624213126,CSE 293,044,094948,Gupta; Rajesh K.,9999,0,9999,0
1653624213654,CSE 294,A00,090143,Porter; George M,9,0,10,1
1653624214176,DSE 200,A00,091799,Staff,50,0,50,0
1653624214702,DSE 203,A00,091800,Gupta; Amarnath,30,0,30,0
1653624215227,DSE 250,A00,091801,Deutsch; Alin Bernard,30,0,30,0
1653624215748,DSE 290,A00,091802,Altintas De Callaf; Ilkay,50,0,50,0
1653624216276,ECE 200,001,091003,Antipa; Nicholas A,9999,0,9999,0
1653624216276,ECE 200,002,091004,Atanasov; Nikolay A.,9999,0,9999,0
1653624216276,ECE 200,003,091005,Bharadia; Dinesh,9999,0,9999,0
1653624216276,ECE 200,004,091006,Cheng; Chung Kuan,9999,0,9999,0
1653624216276,ECE 200,005,091007,Cosman; Pamela C.,9999,0,9999,0
1653624216276,ECE 200,006,091008,Staff,9999,0,9999,0
1653624216276,ECE 200,007,091009,Dayeh; Shadi Ahmad,9999,0,9999,0
1653624216276,ECE 200,008,091010,Fainman; Yeshaiahu,9999,0,9999,0
1653624216276,ECE 200,009,091011,Ford; Joseph Earl,9999,0,9999,0
1653624216276,ECE 200,010,091012,Franceschetti; Massimo,9999,0,9999,0
1653624216276,ECE 200,011,091013,Fullerton; Eric E,9999,0,9999,0
1653624216276,ECE 200,012,091014,Galton; Ian A,9999,0,9999,0
1653624216276,ECE 200,013,091015,Gilja; Vikash,9999,0,9999,0
1653624216276,ECE 200,014,091016,Hall; Drew A.,9999,0,9999,0
1653624216276,ECE 200,015,091017,Hsueh; Tzu-Chien,9999,0,9999,0
1653624216276,ECE 200,016,091018,Javidi; Tara,9999,0,9999,0
1653624216276,ECE 200,017,091019,Kahng; Andrew Byun,9999,0,9999,0
1653624216276,ECE 200,018,091020,Kim; Young-Han,9999,0,9999,0
1653624216276,ECE 200,019,091021,Koushanfar; Farinaz,9999,0,9999,0
1653624216276,ECE 200,020,091022,Kuzum; Duygu,9999,0,9999,0
1653624216276,ECE 200,021,091023,Le; Hanh-Phuc,9999,0,9999,0
1653624216276,ECE 200,022,091024,Lin; Bill,9999,0,9999,0
1653624216276,ECE 200,023,091025,Liu; Zhaowei,9999,0,9999,0
1653624216276,ECE 200,024,091026,Lo; Yu-Hwa,9999,0,9999,0
1653624216276,ECE 200,025,091027,Lomakin; Vitaliy,9999,0,9999,0
1653624216276,ECE 200,026,091028,Mercier; Patrick Philip,9999,0,9999,0
1653624216276,ECE 200,027,091029,Meyer; Florian,9999,0,9999,0
1653624216276,ECE 200,028,091030,Milstein; Laurence B.,9999,0,9999,0
1653624216276,ECE 200,029,091031,Mir Arabbaygi; Siavash,9999,0,9999,0
1653624216276,ECE 200,030,091032,Mookherjea; Shayan,9999,0,9999,0
1653624216276,ECE 200,031,091033,Morris; Karcher William,9999,0,9999,0
1653624216276,ECE 200,032,091034,Ng; Tse Nga,9999,0,9999,0
1653624216276,ECE 200,033,091035,Nguyen; Truong Quang,9999,0,9999,0
1653624216276,ECE 200,034,091036,Nomura; Kenji,9999,0,9999,0
1653624216276,ECE 200,035,091037,Orlitsky; Alon,9999,0,9999,0
1653624216276,ECE 200,036,091038,Pal; Piya,9999,0,9999,0
1653624216276,ECE 200,037,091039,Papen; George C.,9999,0,9999,0
1653624216276,ECE 200,038,091040,Radic; Stojan,9999,0,9999,0
1653624216276,ECE 200,039,091041,Rao; Bhaskar D.,9999,0,9999,0
1653624216276,ECE 200,040,091042,Rao; Ramesh R,9999,0,9999,0
1653624216276,ECE 200,041,091043,Rebeiz; Gabriel,9999,0,9999,0
1653624216276,ECE 200,042,091044,Sanford; John R,9999,0,9999,0
1653624216276,ECE 200,043,091045,Siegel; Paul H.,9999,0,9999,0
1653624216276,ECE 200,044,091046,Sievenpiper; Daniel F.,9999,0,9999,0
1653624216276,ECE 200,045,091047,Sworder; David D.,9999,0,9999,0
1653624216276,ECE 200,046,091048,Taur; Yuan,9999,0,9999,0
1653624216276,ECE 200,047,091049,Touri; Behrouz,9999,0,9999,0
1653624216276,ECE 200,048,091050,Trivedi; Mohan M.,9999,0,9999,0
1653624216276,ECE 200,049,091051,Vardy; Alexander,9999,0,9999,0
1653624216276,ECE 200,050,091052,Vasconcelos; Nuno,9999,0,9999,0
1653624216276,ECE 200,051,091053,Wang; Xiaolong,9999,0,9999,0
1653624216276,ECE 200,052,091054,Xie; Pengtao,9999,0,9999,0
1653624216276,ECE 200,053,091055,Yip; Michael,9999,0,9999,0
1653624216276,ECE 200,054,091056,Zeger; Kenneth A.,9999,0,9999,0
1653624216276,ECE 200,055,091057,Zhang; Xinyu,9999,0,9999,0
1653624216276,ECE 200,056,091058,Turakhia; Yatish Girish,9999,0,9999,0
1653624216276,ECE 200,057,091059,Kang; Mingu,9999,0,9999,0
1653624216276,ECE 200,058,091060,Shi; Yuanyuan,9999,0,9999,0
1653624216276,ECE 200,059,091061,Wang; Edward Jay,9999,0,9999,0
1653624216276,ECE 200,060,091062,Zheng; Yang,9999,0,9999,0
1653624216799,ECE 201,A00,095526,Lo; Yu-Hwa,0,0,0,0
1653624217324,ECE 203,A00,091065,Mercier; Patrick Philip,0,0,0,0
1653624217846,ECE 207A,A00,091605,Liu; Thomas Tao-Ming,0,0,0,0
1653624218370,ECE 212AN,A00,091068,Nomura; Kenji,0,0,0,0
1653624218892,ECE 222A,A00,091069,Rebeiz; Gabriel,0,0,0,0
1653624219414,ECE 225A,A00,091070,Orlitsky; Alon,0,0,0,0
1653624219936,ECE 230A,A00,091071,Nomura; Kenji,0,0,0,0
1653624220463,ECE 236A,A00,091072,Dayeh; Shadi Ahmad,0,0,0,0
1653624220989,ECE 238A,A00,091073,Luo; Jian,0,0,0,0
1653624220989,ECE 238A,B00,091074,Luo; Jian,0,0,0,0
1653624221516,ECE 240A,A00,091075,Radic; Stojan,0,0,0,0
1653624222038,ECE 247A,A00,091592,Shi; Lingyan,0,0,0,0
1653624222560,ECE 250,A00,091076,Touri; Behrouz,0,0,0,0
1653624223084,ECE 251C,A00,091078,Nguyen; Truong Quang,0,0,0,0
1653624223606,ECE 253,A00,091079,Cosman; Pamela C.,0,0,0,0
1653624224132,ECE 255A,A00,091080,Orlitsky; Alon,0,0,0,0
1653624224657,ECE 257A,A00,091081,Zhang; Xinyu,0,0,0,0
1653624225179,ECE 260A,A01,091084,Eldon; John,0,0,0,0
1653624225708,ECE 264C,A00,091085,Galton; Ian A,0,0,0,0
1653624226229,ECE 265C,A00,094889,Presti; Calogero Davide,0,0,0,9
1653624226762,ECE 266,A01,091087,Hall; Drew A.,0,0,0,0
1653624227811,ECE 271A,A00,091090,Vasconcelos; Nuno,0,0,0,0
1653624228332,ECE 272B,A00,091091,Sworder; David D.,0,0,0,0
1653624228858,ECE 275A,A00,091092,Meyer; Florian,0,0,0,0
1653624229383,ECE 277,A00,091093,An; Cheolhong,0,0,0,0
1653624229973,ECE 283,A00,091094,Le; Hanh-Phuc,0,0,0,0
1653624230506,ECE 284,A00,091095,Kang; Mingu,0,0,0,0
1653624230506,ECE 284,B00,091096,Wang; Edward Jay,0,0,0,0
1653624231034,ECE 285,A00,094334,Touri; Behrouz,0,0,0,0
1653624231559,ECE 289,A00,091097,Whelan; David Arthur,0,0,0,0
1653624232107,MATH 200A,A00,087414,Salehi Golsefidy; Alireza,7,0,8,1
1653624232638,MATH 202A,A00,087415,Gill; Philip E.,2,0,8,6
1653624233163,MATH 203A,A00,087416,Oprea; Dragos N.,6,0,8,2
1653624233686,MATH 204A,A00,087417,Kedlaya; Kiran S.,6,0,8,2
1653624234208,MATH 205,A00,087418,Sorensen; Claus M,6,0,8,2
1653624234731,MATH 206A,A00,087419,Izadi; Elham,6,0,8,2
1653624235252,MATH 207A,A00,087420,Mohammadi; Amir,5,0,8,3
1653624235778,MATH 208,A00,087421,Staff,8,0,10,2
1653624236302,MATH 209,A00,087422,Staff,10,0,10,0
1653624236825,MATH 218,A00,087423,Staff,10,0,10,0
1653624237362,MATH 220A,A00,087424,Novak; Jonathan I,6,0,8,2
1653624237884,MATH 231A,A00,087425,Bejenaru; Ioan,3,0,8,5
1653624238406,MATH 240A,A00,087426,Ebenfelt; Peter F,5,0,8,3
1653624238933,MATH 243,A00,087427,Staff,9,0,10,1
1653624239455,MATH 248,A00,087429,Staff,10,0,10,0
1653624239982,MATH 250A,A00,087430,Spolaor; Luca,4,0,8,4
1653624240506,MATH 257A,A00,087431,Spolaor; Luca,7,0,8,1
1653624241031,MATH 258,A00,087432,Staff,9,0,10,1
1653624241557,MATH 264A,A00,087433,Warnke; Lutz Peter,5,0,8,3
1653624242080,MATH 268,A00,087434,Staff,15,0,15,0
1653624242605,MATH 269,A00,087435,Staff,14,0,15,1
1653624243131,MATH 270A,A00,087436,Nie; Jiawang,0,0,8,8
1653624243663,MATH 272A,A00,087437,Tian; Xiaochuan,0,0,8,8
1653624244187,MATH 274,A01,087439,Cheng; Li-Tien,9,0,10,1
1653624244187,MATH 274,A02,087440,Cheng; Li-Tien,10,0,10,0
1653624244709,MATH 278A,A00,087441,Staff,8,0,10,2
1653624245237,MATH 278B,A00,087442,Staff,8,0,10,2
1653624245760,MATH 278C,A00,087443,Staff,8,0,10,2
1653624246286,MATH 280A,A00,087444,Zheng; Tianyi,0,0,8,8
1653624246809,MATH 281A,A00,087445,Bradic; Jelena,0,0,8,9
1653624247336,MATH 282A,A00,087446,Zhang; Danna,0,0,8,8
1653624247859,MATH 283,A00,087447,Tesler; Glenn,0,0,0,16
1653624248382,MATH 286,B00,095535,Kemp; Todd Aahron,5,0,8,3
1653624248904,MATH 287D,B00,095536,Bradic; Jelena,5,0,8,3
1653624249425,MATH 288,A00,087450,Staff,14,0,15,1
1653624249425,MATH 288,B00,087451,Staff,15,0,15,0
1653624249425,MATH 288,C00,087452,Staff,15,0,15,0
1653624249960,MATH 290A,A00,087453,Xu; Zhouli,6,0,8,2
1653624250484,MATH 291A,A00,087454,Xu; Zhouli,7,0,8,1
1653624251007,MATH 292,A00,087455,Staff,10,0,10,0
1653624251539,MATH 295,A00,087456,Staff,50,0,50,0
1653624252061,MATH 297,001,087457,Staff,997,0,999,2
1653624811367,COGS 200,A01,087991,Staff,47,0,50,3
1653624811897,COGS 201,A01,094504,Rangel; Lara M,16,0,25,9
1653624812418,COGS 203,A00,087992,Coulson; Seana M,18,0,20,2
1653624812945,COGS 210A,001,087993,Greene; Deanna Jacquelyn,9998,0,9999,1
1653624812945,COGS 210A,002,087994,Saygin; Ayse P,9999,0,9999,0
1653624812945,COGS 210A,003,087995,Xia; Haijun,9999,0,9999,0
1653624812945,COGS 210A,004,087996,Nitz; Douglas A.,9999,0,9999,0
1653624812945,COGS 210A,005,087997,Hollan; James D.,9999,0,9999,0
1653624812945,COGS 210A,006,087998,Deak; Gedeon O.,9998,0,9999,1
1653624812945,COGS 210A,007,087999,Rossano; Federico,9999,0,9999,0
1653624813467,COGS 211A,A00,088000,Coulson; Seana M,9997,0,9999,2
1653624813991,COGS 229,A00,088002,Staff,22,0,25,3
1653624814517,COGS 260,B00,094231,Staff,17,0,20,3
1653624814517,COGS 260,A00,088004,Nitz; Douglas A.,9998,0,9999,1
1653624815043,CSE 202,A00,090110,Paturi; Ramamohan,0,0,0,0
1653624815043,CSE 202,B00,090111,Paturi; Ramamohan,0,0,0,0
1653624815566,CSE 207B,A00,090112,Heninger; Nadia A,0,0,0,0
1653624816090,CSE 208,A00,094858,Micciancio; Daniele,0,0,0,0
1653624816613,CSE 210,A00,090113,Powell; Thomas Allan,0,0,0,0
1653624817135,CSE 219,A00,090898,Staff,0,0,0,0
1653624817661,CSE 221,A00,090114,Zhou; Yuan-Yuan,0,0,0,0
1653624818184,CSE 229A,A00,090115,Porter; George M,0,0,0,0
1653624818706,CSE 229C,A00,090116,Savage; Stefan,0,0,0,0
1653624819230,CSE 230,A00,090117,Jhala; Ranjit,0,0,0,0
1653624819752,CSE 232,A00,090118,Papakonstantinou; Yannis,0,0,0,0
1653624820275,CSE 239A,A00,090121,Kumar; Arun Kumar,0,0,0,0
1653624820798,CSE 239B,A00,090122,Jhala; Ranjit,0,0,0,0
1653624821324,CSE 240A,A00,090123,Zhao; Jishen,0,0,189,189
1653624821850,CSE 243A,A00,090124,Orailoglu; Alex,0,0,15,15
1653624822382,CSE 249B,A00,090125,Kahng; Andrew Byun,12,0,20,8
1653624822905,CSE 250A,A00,090126,Berg-Kirkpatrick; Taylor D,0,0,0,0
1653624823450,CSE 252A,A00,090127,Ochoa; Benjamin Lawrence,0,0,0,0
1653624823972,CSE 258,A01,090129,McAuley; Julian John,0,0,0,0
1653624824505,CSE 258R,A01,090131,McAuley; Julian John,0,0,0,0
1653624825031,CSE 274,A00,090132,Ramamoorthi; Ravi,0,0,0,0
1653624825555,CSE 276A,A00,090133,Christensen; Henrik I,0,0,0,0
1653624826077,CSE 276C,A00,090134,Christensen; Henrik I,0,0,0,0
1653624826612,CSE 290,A00,090135,Bafna; Vineet,0,0,0,0
1653624826612,CSE 290,B00,090136,Ramamoorthi; Ravi,0,0,0,0
1653624826612,CSE 290,C00,090137,Li; Tzumao,7,0,10,3
1653624826612,CSE 290,D00,090138,Zhou; Yuan-Yuan,9,0,10,1
1653624826612,CSE 290,E00,090139,Christensen; Henrik I,8,0,10,2
1653624826612,CSE 290,F00,094053,Shalev; Aaron D,0,0,0,0
1653624827144,CSE 291,A00,090140,Munyaka; Imani N. S.,0,0,0,0
1653624827144,CSE 291,B00,094880,Yu; Qi,0,0,0,0
1653624827144,CSE 291,C00,090142,Pannuto; Patrick William,0,0,0,0
1653624827144,CSE 291,D00,094881,Zhang; Yiying,0,0,0,0
1653624827144,CSE 291,E00,095118,Su; Hao,0,0,0,0
1653624827668,CSE 293,001,094905,Bafna; Vineet,9999,0,9999,0
1653624827668,CSE 293,002,094906,Bellare; Mihir,9999,0,9999,0
1653624827668,CSE 293,003,094907,Berg-Kirkpatrick; Taylor D,9999,0,9999,0
1653624827668,CSE 293,004,094908,Christensen; Henrik I,9999,0,9999,0
1653624827668,CSE 293,005,094909,Cottrell; Garrison W,9999,0,9999,0
1653624827668,CSE 293,006,094910,Deutsch; Alin Bernard,9999,0,9999,0
1653624827668,CSE 293,007,094911,Esmaeilzadeh; Hadi,9999,0,9999,0
1653624827668,CSE 293,008,094912,Freund; Yoav,9999,0,9999,0
1653624827668,CSE 293,009,094913,Griswold; William G.,9999,0,9999,0
1653624827668,CSE 293,010,094914,Gymrek; Melissa Ann,9999,0,9999,0
1653624827668,CSE 293,011,094915,Heninger; Nadia A,9999,0,9999,0
1653624827668,CSE 293,012,094916,Impagliazzo; Russell,9999,0,9999,0
1653624827668,CSE 293,013,094917,Jhala; Ranjit,9999,0,9999,0
1653624827668,CSE 293,014,094918,Kahng; Andrew Byun,9999,0,9999,0
1653624827668,CSE 293,015,094919,Kane; Daniel Mertz,9999,0,9999,0
1653624827668,CSE 293,016,094920,Kriegman; David J,9999,0,9999,0
1653624827668,CSE 293,017,094921,Kumar; Arun Kumar,9999,0,9999,0
1653624827668,CSE 293,018,094922,Lerner; Sorin,9999,0,9999,0
1653624827668,CSE 293,019,094923,Lovett; Shachar,9999,0,9999,0
1653624827668,CSE 293,020,094924,McAuley; Julian John,9999,0,9999,0
1653624827668,CSE 293,021,094925,Micciancio; Daniele,9999,0,9999,0
1653624827668,CSE 293,022,094926,Orailoglu; Alex,9999,0,9999,0
1653624827668,CSE 293,023,094927,Paturi; Ramamohan,9999,0,9999,0
1653624827668,CSE 293,024,094928,Polikarpova; Nadezhda,9999,0,9999,0
1653624827668,CSE 293,025,094929,Politz; Joseph Gibbs,9999,0,9999,0
1653624827668,CSE 293,026,094930,Porter; George M,9999,0,9999,0
1653624827668,CSE 293,027,094931,Porter; Leonard Emerson,9999,0,9999,0
1653624827668,CSE 293,028,094932,Ramamoorthi; Ravi,9999,0,9999,0
1653624827668,CSE 293,029,094933,Sahoo; Debashis,9999,0,9999,0
1653624827668,CSE 293,030,094934,Saul; Lawrence,9999,0,9999,0
1653624827668,CSE 293,031,094935,Savage; Stefan,9999,0,9999,0
1653624827668,CSE 293,032,094936,Schulze; Jurgen P.,9999,0,9999,0
1653624827668,CSE 293,033,094937,Snoeren; Alex C.,9999,0,9999,0
1653624827668,CSE 293,034,094938,Shang; Jingbo,9999,0,9999,0
1653624827668,CSE 293,035,094939,Stefan; Deian,9999,0,9999,0
1653624827668,CSE 293,036,094940,Su; Hao,9999,0,9999,0
1653624827668,CSE 293,037,094941,Swanson; Steven James,9999,0,9999,0
1653624827668,CSE 293,038,094942,Tullsen; Dean Michael,9999,0,9999,0
1653624827668,CSE 293,039,094943,Voelker; Geoffrey M.,9999,0,9999,0
1653624827668,CSE 293,040,094944,Zhao; Jishen,9999,0,9999,0
1653624827668,CSE 293,041,094945,Zhou; Yuan-Yuan,9999,0,9999,0
1653624827668,CSE 293,042,094946,Gao; Sicun,9998,0,9999,1
1653624827668,CSE 293,043,094947,Weibel; Nadir,9999,0,9999,0
1653624827668,CSE 293,044,094948,Gupta; Rajesh K.,9999,0,9999,0
1653624828190,CSE 294,A00,090143,Porter; George M,9,0,10,1
1653624828712,DSE 200,A00,091799,Staff,50,0,50,0
1653624829237,DSE 203,A00,091800,Gupta; Amarnath,30,0,30,0
1653624829764,DSE 250,A00,091801,Deutsch; Alin Bernard,30,0,30,0
1653624830290,DSE 290,A00,091802,Altintas De Callaf; Ilkay,50,0,50,0
1653624830816,ECE 200,001,091003,Antipa; Nicholas A,9999,0,9999,0
1653624830816,ECE 200,002,091004,Atanasov; Nikolay A.,9999,0,9999,0
1653624830816,ECE 200,003,091005,Bharadia; Dinesh,9999,0,9999,0
1653624830816,ECE 200,004,091006,Cheng; Chung Kuan,9999,0,9999,0
1653624830816,ECE 200,005,091007,Cosman; Pamela C.,9999,0,9999,0
1653624830816,ECE 200,006,091008,Staff,9999,0,9999,0
1653624830816,ECE 200,007,091009,Dayeh; Shadi Ahmad,9999,0,9999,0
1653624830816,ECE 200,008,091010,Fainman; Yeshaiahu,9999,0,9999,0
1653624830816,ECE 200,009,091011,Ford; Joseph Earl,9999,0,9999,0
1653624830816,ECE 200,010,091012,Franceschetti; Massimo,9999,0,9999,0
1653624830816,ECE 200,011,091013,Fullerton; Eric E,9999,0,9999,0
1653624830816,ECE 200,012,091014,Galton; Ian A,9999,0,9999,0
1653624830816,ECE 200,013,091015,Gilja; Vikash,9999,0,9999,0
1653624830816,ECE 200,014,091016,Hall; Drew A.,9999,0,9999,0
1653624830816,ECE 200,015,091017,Hsueh; Tzu-Chien,9999,0,9999,0
1653624830816,ECE 200,016,091018,Javidi; Tara,9999,0,9999,0
1653624830816,ECE 200,017,091019,Kahng; Andrew Byun,9999,0,9999,0
1653624830816,ECE 200,018,091020,Kim; Young-Han,9999,0,9999,0
1653624830816,ECE 200,019,091021,Koushanfar; Farinaz,9999,0,9999,0
1653624830816,ECE 200,020,091022,Kuzum; Duygu,9999,0,9999,0
1653624830816,ECE 200,021,091023,Le; Hanh-Phuc,9999,0,9999,0
1653624830816,ECE 200,022,091024,Lin; Bill,9999,0,9999,0
1653624830816,ECE 200,023,091025,Liu; Zhaowei,9999,0,9999,0
1653624830816,ECE 200,024,091026,Lo; Yu-Hwa,9999,0,9999,0
1653624830816,ECE 200,025,091027,Lomakin; Vitaliy,9999,0,9999,0
1653624830816,ECE 200,026,091028,Mercier; Patrick Philip,9999,0,9999,0
1653624830816,ECE 200,027,091029,Meyer; Florian,9999,0,9999,0
1653624830816,ECE 200,028,091030,Milstein; Laurence B.,9999,0,9999,0
1653624830816,ECE 200,029,091031,Mir Arabbaygi; Siavash,9999,0,9999,0
1653624830816,ECE 200,030,091032,Mookherjea; Shayan,9999,0,9999,0
1653624830816,ECE 200,031,091033,Morris; Karcher William,9999,0,9999,0
1653624830816,ECE 200,032,091034,Ng; Tse Nga,9999,0,9999,0
1653624830816,ECE 200,033,091035,Nguyen; Truong Quang,9999,0,9999,0
1653624830816,ECE 200,034,091036,Nomura; Kenji,9999,0,9999,0
1653624830816,ECE 200,035,091037,Orlitsky; Alon,9999,0,9999,0
1653624830816,ECE 200,036,091038,Pal; Piya,9999,0,9999,0
1653624830816,ECE 200,037,091039,Papen; George C.,9999,0,9999,0
1653624830816,ECE 200,038,091040,Radic; Stojan,9999,0,9999,0
1653624830816,ECE 200,039,091041,Rao; Bhaskar D.,9999,0,9999,0
1653624830816,ECE 200,040,091042,Rao; Ramesh R,9999,0,9999,0
1653624830816,ECE 200,041,091043,Rebeiz; Gabriel,9999,0,9999,0
1653624830816,ECE 200,042,091044,Sanford; John R,9999,0,9999,0
1653624830816,ECE 200,043,091045,Siegel; Paul H.,9999,0,9999,0
1653624830816,ECE 200,044,091046,Sievenpiper; Daniel F.,9999,0,9999,0
1653624830816,ECE 200,045,091047,Sworder; David D.,9999,0,9999,0
1653624830816,ECE 200,046,091048,Taur; Yuan,9999,0,9999,0
1653624830816,ECE 200,047,091049,Touri; Behrouz,9999,0,9999,0
1653624830816,ECE 200,048,091050,Trivedi; Mohan M.,9999,0,9999,0
1653624830816,ECE 200,049,091051,Vardy; Alexander,9999,0,9999,0
1653624830816,ECE 200,050,091052,Vasconcelos; Nuno,9999,0,9999,0
1653624830816,ECE 200,051,091053,Wang; Xiaolong,9999,0,9999,0
1653624830816,ECE 200,052,091054,Xie; Pengtao,9999,0,9999,0
1653624830816,ECE 200,053,091055,Yip; Michael,9999,0,9999,0
1653624830816,ECE 200,054,091056,Zeger; Kenneth A.,9999,0,9999,0
1653624830816,ECE 200,055,091057,Zhang; Xinyu,9999,0,9999,0
1653624830816,ECE 200,056,091058,Turakhia; Yatish Girish,9999,0,9999,0
1653624830816,ECE 200,057,091059,Kang; Mingu,9999,0,9999,0
1653624830816,ECE 200,058,091060,Shi; Yuanyuan,9999,0,9999,0
1653624830816,ECE 200,059,091061,Wang; Edward Jay,9999,0,9999,0
1653624830816,ECE 200,060,091062,Zheng; Yang,9999,0,9999,0
1653624831351,ECE 201,A00,095526,Lo; Yu-Hwa,0,0,0,0
1653624831876,ECE 203,A00,091065,Mercier; Patrick Philip,0,0,0,0
1653624832403,ECE 207A,A00,091605,Liu; Thomas Tao-Ming,0,0,0,0
1653624832928,ECE 212AN,A00,091068,Nomura; Kenji,0,0,0,0
1653624833455,ECE 222A,A00,091069,Rebeiz; Gabriel,0,0,0,0
1653624833978,ECE 225A,A00,091070,Orlitsky; Alon,0,0,0,0
1653624834501,ECE 230A,A00,091071,Nomura; Kenji,0,0,0,0
1653624835022,ECE 236A,A00,091072,Dayeh; Shadi Ahmad,0,0,0,0
1653624835550,ECE 238A,A00,091073,Luo; Jian,0,0,0,0
1653624835550,ECE 238A,B00,091074,Luo; Jian,0,0,0,0
1653624836073,ECE 240A,A00,091075,Radic; Stojan,0,0,0,0
1653624836595,ECE 247A,A00,091592,Shi; Lingyan,0,0,0,0
1653624837116,ECE 250,A00,091076,Touri; Behrouz,0,0,0,0
1653624837649,ECE 251C,A00,091078,Nguyen; Truong Quang,0,0,0,0
1653624838172,ECE 253,A00,091079,Cosman; Pamela C.,0,0,0,0
1653624838694,ECE 255A,A00,091080,Orlitsky; Alon,0,0,0,0
1653624839225,ECE 257A,A00,091081,Zhang; Xinyu,0,0,0,0
1653624839754,ECE 260A,A01,091084,Eldon; John,0,0,0,0
1653624840293,ECE 264C,A00,091085,Galton; Ian A,0,0,0,0
1653624840821,ECE 265C,A00,094889,Presti; Calogero Davide,0,0,0,9
1653624841348,ECE 266,A01,091087,Hall; Drew A.,0,0,0,0
1653624842395,ECE 271A,A00,091090,Vasconcelos; Nuno,0,0,0,0
1653624843011,ECE 272B,A00,091091,Sworder; David D.,0,0,0,0
1653624843540,ECE 275A,A00,091092,Meyer; Florian,0,0,0,0
1653624844063,ECE 277,A00,091093,An; Cheolhong,0,0,0,0
1653624844591,ECE 283,A00,091094,Le; Hanh-Phuc,0,0,0,0
1653624845113,ECE 284,A00,091095,Kang; Mingu,0,0,0,0
1653624845113,ECE 284,B00,091096,Wang; Edward Jay,0,0,0,0
1653624845640,ECE 285,A00,094334,Touri; Behrouz,0,0,0,0
1653624846166,ECE 289,A00,091097,Whelan; David Arthur,0,0,0,0
1653624846687,MATH 200A,A00,087414,Salehi Golsefidy; Alireza,7,0,8,1
1653624847210,MATH 202A,A00,087415,Gill; Philip E.,2,0,8,6
1653624847736,MATH 203A,A00,087416,Oprea; Dragos N.,6,0,8,2
1653624848258,MATH 204A,A00,087417,Kedlaya; Kiran S.,6,0,8,2
1653624848780,MATH 205,A00,087418,Sorensen; Claus M,6,0,8,2
1653624849301,MATH 206A,A00,087419,Izadi; Elham,6,0,8,2
1653624849824,MATH 207A,A00,087420,Mohammadi; Amir,5,0,8,3
1653624850353,MATH 208,A00,087421,Staff,8,0,10,2
1653624850878,MATH 209,A00,087422,Staff,10,0,10,0
1653624851404,MATH 218,A00,087423,Staff,10,0,10,0
1653624851928,MATH 220A,A00,087424,Novak; Jonathan I,6,0,8,2
1653624852451,MATH 231A,A00,087425,Bejenaru; Ioan,3,0,8,5
1653624852978,MATH 240A,A00,087426,Ebenfelt; Peter F,5,0,8,3
1653624853503,MATH 243,A00,087427,Staff,9,0,10,1
1653624854025,MATH 248,A00,087429,Staff,10,0,10,0
1653624854556,MATH 250A,A00,087430,Spolaor; Luca,4,0,8,4
1653624855078,MATH 257A,A00,087431,Spolaor; Luca,7,0,8,1
1653624855602,MATH 258,A00,087432,Staff,9,0,10,1
1653624856125,MATH 264A,A00,087433,Warnke; Lutz Peter,5,0,8,3
1653624856652,MATH 268,A00,087434,Staff,15,0,15,0
1653624857175,MATH 269,A00,087435,Staff,14,0,15,1
1653624857705,MATH 270A,A00,087436,Nie; Jiawang,0,0,8,8
1653624858228,MATH 272A,A00,087437,Tian; Xiaochuan,0,0,8,8
1653624858768,MATH 274,A01,087439,Cheng; Li-Tien,9,0,10,1
1653624858768,MATH 274,A02,087440,Cheng; Li-Tien,10,0,10,0
1653624859306,MATH 278A,A00,087441,Staff,8,0,10,2
1653624859828,MATH 278B,A00,087442,Staff,8,0,10,2
1653624860351,MATH 278C,A00,087443,Staff,8,0,10,2
1653624860873,MATH 280A,A00,087444,Zheng; Tianyi,0,0,8,8
1653624861401,MATH 281A,A00,087445,Bradic; Jelena,0,0,8,9
1653624861929,MATH 282A,A00,087446,Zhang; Danna,0,0,8,8
1653624862455,MATH 283,A00,087447,Tesler; Glenn,0,0,0,16
1653624862985,MATH 286,B00,095535,Kemp; Todd Aahron,5,0,8,3
1653624863513,MATH 287D,B00,095536,Bradic; Jelena,5,0,8,3
1653624864036,MATH 288,A00,087450,Staff,14,0,15,1
1653624864036,MATH 288,B00,087451,Staff,15,0,15,0
1653624864036,MATH 288,C00,087452,Staff,15,0,15,0
1653624864562,MATH 290A,A00,087453,Xu; Zhouli,6,0,8,2
1653624865088,MATH 291A,A00,087454,Xu; Zhouli,7,0,8,1
1653624865612,MATH 292,A00,087455,Staff,10,0,10,0
1653624866139,MATH 295,A00,087456,Staff,50,0,50,0
1653624866670,MATH 297,001,087457,Staff,997,0,999,2
1653625426204,COGS 200,A01,087991,Staff,47,0,50,3
1653625426728,COGS 201,A01,094504,Rangel; Lara M,16,0,25,9
1653625427253,COGS 203,A00,087992,Coulson; Seana M,18,0,20,2
1653625427779,COGS 210A,001,087993,Greene; Deanna Jacquelyn,9998,0,9999,1
1653625427779,COGS 210A,002,087994,Saygin; Ayse P,9999,0,9999,0
1653625427779,COGS 210A,003,087995,Xia; Haijun,9999,0,9999,0
1653625427779,COGS 210A,004,087996,Nitz; Douglas A.,9999,0,9999,0
1653625427779,COGS 210A,005,087997,Hollan; James D.,9999,0,9999,0
1653625427779,COGS 210A,006,087998,Deak; Gedeon O.,9998,0,9999,1
1653625427779,COGS 210A,007,087999,Rossano; Federico,9999,0,9999,0
1653625428313,COGS 211A,A00,088000,Coulson; Seana M,9997,0,9999,2
1653625428846,COGS 229,A00,088002,Staff,22,0,25,3
1653625429369,COGS 260,B00,094231,Staff,17,0,20,3
1653625429369,COGS 260,A00,088004,Nitz; Douglas A.,9998,0,9999,1
1653625429970,CSE 202,A00,090110,Paturi; Ramamohan,0,0,0,0
1653625429970,CSE 202,B00,090111,Paturi; Ramamohan,0,0,0,0
1653625430532,CSE 207B,A00,090112,Heninger; Nadia A,0,0,0,0
1653625431059,CSE 208,A00,094858,Micciancio; Daniele,0,0,0,0
1653625431586,CSE 210,A00,090113,Powell; Thomas Allan,0,0,0,0
1653625432115,CSE 219,A00,090898,Staff,0,0,0,0
1653625432639,CSE 221,A00,090114,Zhou; Yuan-Yuan,0,0,0,0
1653625433171,CSE 229A,A00,090115,Porter; George M,0,0,0,0
1653625433695,CSE 229C,A00,090116,Savage; Stefan,0,0,0,0
1653625434217,CSE 230,A00,090117,Jhala; Ranjit,0,0,0,0
1653625434743,CSE 232,A00,090118,Papakonstantinou; Yannis,0,0,0,0
1653625435267,CSE 239A,A00,090121,Kumar; Arun Kumar,0,0,0,0
1653625435790,CSE 239B,A00,090122,Jhala; Ranjit,0,0,0,0
1653625436314,CSE 240A,A00,090123,Zhao; Jishen,0,0,189,189
1653625436840,CSE 243A,A00,090124,Orailoglu; Alex,0,0,15,15
1653625437366,CSE 249B,A00,090125,Kahng; Andrew Byun,12,0,20,8
1653625437890,CSE 250A,A00,090126,Berg-Kirkpatrick; Taylor D,0,0,0,0
1653625438418,CSE 252A,A00,090127,Ochoa; Benjamin Lawrence,0,0,0,0
1653625438941,CSE 258,A01,090129,McAuley; Julian John,0,0,0,0
1653625439472,CSE 258R,A01,090131,McAuley; Julian John,0,0,0,0
1653625439995,CSE 274,A00,090132,Ramamoorthi; Ravi,0,0,0,0
1653625440518,CSE 276A,A00,090133,Christensen; Henrik I,0,0,0,0
1653625441055,CSE 276C,A00,090134,Christensen; Henrik I,0,0,0,0
1653625441580,CSE 290,A00,090135,Bafna; Vineet,0,0,0,0
1653625441580,CSE 290,B00,090136,Ramamoorthi; Ravi,0,0,0,0
1653625441580,CSE 290,C00,090137,Li; Tzumao,7,0,10,3
1653625441580,CSE 290,D00,090138,Zhou; Yuan-Yuan,9,0,10,1
1653625441580,CSE 290,E00,090139,Christensen; Henrik I,8,0,10,2
1653625441580,CSE 290,F00,094053,Shalev; Aaron D,0,0,0,0
1653625442104,CSE 291,A00,090140,Munyaka; Imani N. S.,0,0,0,0
1653625442104,CSE 291,B00,094880,Yu; Qi,0,0,0,0
1653625442104,CSE 291,C00,090142,Pannuto; Patrick William,0,0,0,0
1653625442104,CSE 291,D00,094881,Zhang; Yiying,0,0,0,0
1653625442104,CSE 291,E00,095118,Su; Hao,0,0,0,0
1653625442629,CSE 293,001,094905,Bafna; Vineet,9999,0,9999,0
1653625442629,CSE 293,002,094906,Bellare; Mihir,9999,0,9999,0
1653625442629,CSE 293,003,094907,Berg-Kirkpatrick; Taylor D,9999,0,9999,0
1653625442629,CSE 293,004,094908,Christensen; Henrik I,9999,0,9999,0
1653625442629,CSE 293,005,094909,Cottrell; Garrison W,9999,0,9999,0
1653625442629,CSE 293,006,094910,Deutsch; Alin Bernard,9999,0,9999,0
1653625442629,CSE 293,007,094911,Esmaeilzadeh; Hadi,9999,0,9999,0
1653625442629,CSE 293,008,094912,Freund; Yoav,9999,0,9999,0
1653625442629,CSE 293,009,094913,Griswold; William G.,9999,0,9999,0
1653625442629,CSE 293,010,094914,Gymrek; Melissa Ann,9999,0,9999,0
1653625442629,CSE 293,011,094915,Heninger; Nadia A,9999,0,9999,0
1653625442629,CSE 293,012,094916,Impagliazzo; Russell,9999,0,9999,0
1653625442629,CSE 293,013,094917,Jhala; Ranjit,9999,0,9999,0
1653625442629,CSE 293,014,094918,Kahng; Andrew Byun,9999,0,9999,0
1653625442629,CSE 293,015,094919,Kane; Daniel Mertz,9999,0,9999,0
1653625442629,CSE 293,016,094920,Kriegman; David J,9999,0,9999,0
1653625442629,CSE 293,017,094921,Kumar; Arun Kumar,9999,0,9999,0
1653625442629,CSE 293,018,094922,Lerner; Sorin,9999,0,9999,0
1653625442629,CSE 293,019,094923,Lovett; Shachar,9999,0,9999,0
1653625442629,CSE 293,020,094924,McAuley; Julian John,9999,0,9999,0
1653625442629,CSE 293,021,094925,Micciancio; Daniele,9999,0,9999,0
1653625442629,CSE 293,022,094926,Orailoglu; Alex,9999,0,9999,0
1653625442629,CSE 293,023,094927,Paturi; Ramamohan,9999,0,9999,0
1653625442629,CSE 293,024,094928,Polikarpova; Nadezhda,9999,0,9999,0
1653625442629,CSE 293,025,094929,Politz; Joseph Gibbs,9999,0,9999,0
1653625442629,CSE 293,026,094930,Porter; George M,9999,0,9999,0
1653625442629,CSE 293,027,094931,Porter; Leonard Emerson,9999,0,9999,0
1653625442629,CSE 293,028,094932,Ramamoorthi; Ravi,9999,0,9999,0
1653625442629,CSE 293,029,094933,Sahoo; Debashis,9999,0,9999,0
1653625442629,CSE 293,030,094934,Saul; Lawrence,9999,0,9999,0
1653625442629,CSE 293,031,094935,Savage; Stefan,9999,0,9999,0
1653625442629,CSE 293,032,094936,Schulze; Jurgen P.,9999,0,9999,0
1653625442629,CSE 293,033,094937,Snoeren; Alex C.,9999,0,9999,0
1653625442629,CSE 293,034,094938,Shang; Jingbo,9999,0,9999,0
1653625442629,CSE 293,035,094939,Stefan; Deian,9999,0,9999,0
1653625442629,CSE 293,036,094940,Su; Hao,9999,0,9999,0
1653625442629,CSE 293,037,094941,Swanson; Steven James,9999,0,9999,0
1653625442629,CSE 293,038,094942,Tullsen; Dean Michael,9999,0,9999,0
1653625442629,CSE 293,039,094943,Voelker; Geoffrey M.,9999,0,9999,0
1653625442629,CSE 293,040,094944,Zhao; Jishen,9999,0,9999,0
1653625442629,CSE 293,041,094945,Zhou; Yuan-Yuan,9999,0,9999,0
1653625442629,CSE 293,042,094946,Gao; Sicun,9998,0,9999,1
1653625442629,CSE 293,043,094947,Weibel; Nadir,9999,0,9999,0
1653625442629,CSE 293,044,094948,Gupta; Rajesh K.,9999,0,9999,0
1653625443154,CSE 294,A00,090143,Porter; George M,9,0,10,1
1653625443677,DSE 200,A00,091799,Staff,50,0,50,0
1653625444202,DSE 203,A00,091800,Gupta; Amarnath,30,0,30,0
1653625444730,DSE 250,A00,091801,Deutsch; Alin Bernard,30,0,30,0
1653625445260,DSE 290,A00,091802,Altintas De Callaf; Ilkay,50,0,50,0
1653625445808,ECE 200,001,091003,Antipa; Nicholas A,9999,0,9999,0
1653625445808,ECE 200,002,091004,Atanasov; Nikolay A.,9999,0,9999,0
1653625445808,ECE 200,003,091005,Bharadia; Dinesh,9999,0,9999,0
1653625445808,ECE 200,004,091006,Cheng; Chung Kuan,9999,0,9999,0
1653625445808,ECE 200,005,091007,Cosman; Pamela C.,9999,0,9999,0
1653625445808,ECE 200,006,091008,Staff,9999,0,9999,0
1653625445808,ECE 200,007,091009,Dayeh; Shadi Ahmad,9999,0,9999,0
1653625445808,ECE 200,008,091010,Fainman; Yeshaiahu,9999,0,9999,0
1653625445808,ECE 200,009,091011,Ford; Joseph Earl,9999,0,9999,0
1653625445808,ECE 200,010,091012,Franceschetti; Massimo,9999,0,9999,0
1653625445808,ECE 200,011,091013,Fullerton; Eric E,9999,0,9999,0
1653625445808,ECE 200,012,091014,Galton; Ian A,9999,0,9999,0
1653625445808,ECE 200,013,091015,Gilja; Vikash,9999,0,9999,0
1653625445808,ECE 200,014,091016,Hall; Drew A.,9999,0,9999,0
1653625445808,ECE 200,015,091017,Hsueh; Tzu-Chien,9999,0,9999,0
1653625445808,ECE 200,016,091018,Javidi; Tara,9999,0,9999,0
1653625445808,ECE 200,017,091019,Kahng; Andrew Byun,9999,0,9999,0
1653625445808,ECE 200,018,091020,Kim; Young-Han,9999,0,9999,0
1653625445808,ECE 200,019,091021,Koushanfar; Farinaz,9999,0,9999,0
1653625445808,ECE 200,020,091022,Kuzum; Duygu,9999,0,9999,0
1653625445808,ECE 200,021,091023,Le; Hanh-Phuc,9999,0,9999,0
1653625445808,ECE 200,022,091024,Lin; Bill,9999,0,9999,0
1653625445808,ECE 200,023,091025,Liu; Zhaowei,9999,0,9999,0
1653625445808,ECE 200,024,091026,Lo; Yu-Hwa,9999,0,9999,0
1653625445808,ECE 200,025,091027,Lomakin; Vitaliy,9999,0,9999,0
1653625445808,ECE 200,026,091028,Mercier; Patrick Philip,9999,0,9999,0
1653625445808,ECE 200,027,091029,Meyer; Florian,9999,0,9999,0
1653625445808,ECE 200,028,091030,Milstein; Laurence B.,9999,0,9999,0
1653625445808,ECE 200,029,091031,Mir Arabbaygi; Siavash,9999,0,9999,0
1653625445808,ECE 200,030,091032,Mookherjea; Shayan,9999,0,9999,0
1653625445808,ECE 200,031,091033,Morris; Karcher William,9999,0,9999,0
1653625445808,ECE 200,032,091034,Ng; Tse Nga,9999,0,9999,0
1653625445808,ECE 200,033,091035,Nguyen; Truong Quang,9999,0,9999,0
1653625445808,ECE 200,034,091036,Nomura; Kenji,9999,0,9999,0
1653625445808,ECE 200,035,091037,Orlitsky; Alon,9999,0,9999,0
1653625445808,ECE 200,036,091038,Pal; Piya,9999,0,9999,0
1653625445808,ECE 200,037,091039,Papen; George C.,9999,0,9999,0
1653625445808,ECE 200,038,091040,Radic; Stojan,9999,0,9999,0
1653625445808,ECE 200,039,091041,Rao; Bhaskar D.,9999,0,9999,0
1653625445808,ECE 200,040,091042,Rao; Ramesh R,9999,0,9999,0
1653625445808,ECE 200,041,091043,Rebeiz; Gabriel,9999,0,9999,0
1653625445808,ECE 200,042,091044,Sanford; John R,9999,0,9999,0
1653625445808,ECE 200,043,091045,Siegel; Paul H.,9999,0,9999,0
1653625445808,ECE 200,044,091046,Sievenpiper; Daniel F.,9999,0,9999,0
1653625445808,ECE 200,045,091047,Sworder; David D.,9999,0,9999,0
1653625445808,ECE 200,046,091048,Taur; Yuan,9999,0,9999,0
1653625445808,ECE 200,047,091049,Touri; Behrouz,9999,0,9999,0
1653625445808,ECE 200,048,091050,Trivedi; Mohan M.,9999,0,9999,0
1653625445808,ECE 200,049,091051,Vardy; Alexander,9999,0,9999,0
1653625445808,ECE 200,050,091052,Vasconcelos; Nuno,9999,0,9999,0
1653625445808,ECE 200,051,091053,Wang; Xiaolong,9999,0,9999,0
1653625445808,ECE 200,052,091054,Xie; Pengtao,9999,0,9999,0
1653625445808,ECE 200,053,091055,Yip; Michael,9999,0,9999,0
1653625445808,ECE 200,054,091056,Zeger; Kenneth A.,9999,0,9999,0
1653625445808,ECE 200,055,091057,Zhang; Xinyu,9999,0,9999,0
1653625445808,ECE 200,056,091058,Turakhia; Yatish Girish,9999,0,9999,0
1653625445808,ECE 200,057,091059,Kang; Mingu,9999,0,9999,0
1653625445808,ECE 200,058,091060,Shi; Yuanyuan,9999,0,9999,0
1653625445808,ECE 200,059,091061,Wang; Edward Jay,9999,0,9999,0
1653625445808,ECE 200,060,091062,Zheng; Yang,9999,0,9999,0
1653625446331,ECE 201,A00,095526,Lo; Yu-Hwa,0,0,0,0
1653625446859,ECE 203,A00,091065,Mercier; Patrick Philip,0,0,0,0
1653625447382,ECE 207A,A00,091605,Liu; Thomas Tao-Ming,0,0,0,0
1653625447909,ECE 212AN,A00,091068,Nomura; Kenji,0,0,0,0
1653625448433,ECE 222A,A00,091069,Rebeiz; Gabriel,0,0,0,0
1653625448959,ECE 225A,A00,091070,Orlitsky; Alon,0,0,0,0
1653625449487,ECE 230A,A00,091071,Nomura; Kenji,0,0,0,0
1653625450014,ECE 236A,A00,091072,Dayeh; Shadi Ahmad,0,0,0,0
1653625450540,ECE 238A,A00,091073,Luo; Jian,0,0,0,0
1653625450540,ECE 238A,B00,091074,Luo; Jian,0,0,0,0
1653625451065,ECE 240A,A00,091075,Radic; Stojan,0,0,0,0
1653625451590,ECE 247A,A00,091592,Shi; Lingyan,0,0,0,0
1653625452116,ECE 250,A00,091076,Touri; Behrouz,0,0,0,0
1653625452640,ECE 251C,A00,091078,Nguyen; Truong Quang,0,0,0,0
1653625453167,ECE 253,A00,091079,Cosman; Pamela C.,0,0,0,0
1653625453691,ECE 255A,A00,091080,Orlitsky; Alon,0,0,0,0
1653625454216,ECE 257A,A00,091081,Zhang; Xinyu,0,0,0,0
1653625454743,ECE 260A,A01,091084,Eldon; John,0,0,0,0
1653625455273,ECE 264C,A00,091085,Galton; Ian A,0,0,0,0
1653625455796,ECE 265C,A00,094889,Presti; Calogero Davide,0,0,0,9
1653625456321,ECE 266,A01,091087,Hall; Drew A.,0,0,0,0
1653625457368,ECE 271A,A00,091090,Vasconcelos; Nuno,0,0,0,0
1653625457895,ECE 272B,A00,091091,Sworder; David D.,0,0,0,0
1653625458420,ECE 275A,A00,091092,Meyer; Florian,0,0,0,0
1653625458946,ECE 277,A00,091093,An; Cheolhong,0,0,0,0
1653625459478,ECE 283,A00,091094,Le; Hanh-Phuc,0,0,0,0
1653625460004,ECE 284,A00,091095,Kang; Mingu,0,0,0,0
1653625460004,ECE 284,B00,091096,Wang; Edward Jay,0,0,0,0
1653625460535,ECE 285,A00,094334,Touri; Behrouz,0,0,0,0
1653625461062,ECE 289,A00,091097,Whelan; David Arthur,0,0,0,0
1653625461588,MATH 200A,A00,087414,Salehi Golsefidy; Alireza,7,0,8,1
1653625462111,MATH 202A,A00,087415,Gill; Philip E.,2,0,8,6
1653625462639,MATH 203A,A00,087416,Oprea; Dragos N.,6,0,8,2
1653625463161,MATH 204A,A00,087417,Kedlaya; Kiran S.,6,0,8,2
1653625463688,MATH 205,A00,087418,Sorensen; Claus M,6,0,8,2
1653625464213,MATH 206A,A00,087419,Izadi; Elham,6,0,8,2
1653625464740,MATH 207A,A00,087420,Mohammadi; Amir,5,0,8,3
1653625465265,MATH 208,A00,087421,Staff,8,0,10,2
1653625465788,MATH 209,A00,087422,Staff,10,0,10,0
1653625466312,MATH 218,A00,087423,Staff,10,0,10,0
1653625466846,MATH 220A,A00,087424,Novak; Jonathan I,6,0,8,2
1653625467369,MATH 231A,A00,087425,Bejenaru; Ioan,3,0,8,5
1653625467892,MATH 240A,A00,087426,Ebenfelt; Peter F,5,0,8,3
1653625468415,MATH 243,A00,087427,Staff,9,0,10,1
1653625468940,MATH 248,A00,087429,Staff,10,0,10,0
1653625469464,MATH 250A,A00,087430,Spolaor; Luca,4,0,8,4
1653625469986,MATH 257A,A00,087431,Spolaor; Luca,7,0,8,1
1653625470509,MATH 258,A00,087432,Staff,9,0,10,1
1653625471037,MATH 264A,A00,087433,Warnke; Lutz Peter,5,0,8,3
1653625471564,MATH 268,A00,087434,Staff,15,0,15,0
1653625472087,MATH 269,A00,087435,Staff,14,0,15,1
1653625472610,MATH 270A,A00,087436,Nie; Jiawang,0,0,8,8
1653625473148,MATH 272A,A00,087437,Tian; Xiaochuan,0,0,8,8
1653625473681,MATH 274,A01,087439,Cheng; Li-Tien,9,0,10,1
1653625473681,MATH 274,A02,087440,Cheng; Li-Tien,10,0,10,0
1653625474203,MATH 278A,A00,087441,Staff,8,0,10,2
1653625474727,MATH 278B,A00,087442,Staff,8,0,10,2
1653625475250,MATH 278C,A00,087443,Staff,8,0,10,2
1653625475774,MATH 280A,A00,087444,Zheng; Tianyi,0,0,8,8
1653625476296,MATH 281A,A00,087445,Bradic; Jelena,0,0,8,9
1653625476826,MATH 282A,A00,087446,Zhang; Danna,0,0,8,8
1653625477353,MATH 283,A00,087447,Tesler; Glenn,0,0,0,16
1653625477875,MATH 286,B00,095535,Kemp; Todd Aahron,5,0,8,3
1653625478403,MATH 287D,B00,095536,Bradic; Jelena,5,0,8,3
1653625478932,MATH 288,A00,087450,Staff,14,0,15,1
1653625478932,MATH 288,B00,087451,Staff,15,0,15,0
1653625478932,MATH 288,C00,087452,Staff,15,0,15,0
1653625479457,MATH 290A,A00,087453,Xu; Zhouli,6,0,8,2
1653625479980,MATH 291A,A00,087454,Xu; Zhouli,7,0,8,1
1653625480510,MATH 292,A00,087455,Staff,10,0,10,0
1653625481033,MATH 295,A00,087456,Staff,50,0,50,0
1653625481558,MATH 297,001,087457,Staff,997,0,999,2
1653626040543,COGS 200,A01,087991,Staff,47,0,50,3
1653626041069,COGS 201,A01,094504,Rangel; Lara M,16,0,25,9
1653626041592,COGS 203,A00,087992,Coulson; Seana M,18,0,20,2
1653626042114,COGS 210A,001,087993,Greene; Deanna Jacquelyn,9998,0,9999,1
1653626042114,COGS 210A,002,087994,Saygin; Ayse P,9999,0,9999,0
1653626042114,COGS 210A,003,087995,Xia; Haijun,9999,0,9999,0
1653626042114,COGS 210A,004,087996,Nitz; Douglas A.,9999,0,9999,0
1653626042114,COGS 210A,005,087997,Hollan; James D.,9999,0,9999,0
1653626042114,COGS 210A,006,087998,Deak; Gedeon O.,9998,0,9999,1
1653626042114,COGS 210A,007,087999,Rossano; Federico,9999,0,9999,0
1653626042645,COGS 211A,A00,088000,Coulson; Seana M,9997,0,9999,2
1653626043169,COGS 229,A00,088002,Staff,22,0,25,3
1653626043691,COGS 260,B00,094231,Staff,17,0,20,3
1653626043691,COGS 260,A00,088004,Nitz; Douglas A.,9998,0,9999,1
1653626044218,CSE 202,A00,090110,Paturi; Ramamohan,0,0,0,0
1653626044218,CSE 202,B00,090111,Paturi; Ramamohan,0,0,0,0
1653626044743,CSE 207B,A00,090112,Heninger; Nadia A,0,0,0,0
1653626045277,CSE 208,A00,094858,Micciancio; Daniele,0,0,0,0
1653626045801,CSE 210,A00,090113,Powell; Thomas Allan,0,0,0,0
1653626046324,CSE 219,A00,090898,Staff,0,0,0,0
1653626046847,CSE 221,A00,090114,Zhou; Yuan-Yuan,0,0,0,0
1653626047375,CSE 229A,A00,090115,Porter; George M,0,0,0,0
1653626047899,CSE 229C,A00,090116,Savage; Stefan,0,0,0,0
1653626048431,CSE 230,A00,090117,Jhala; Ranjit,0,0,0,0
1653626048953,CSE 232,A00,090118,Papakonstantinou; Yannis,0,0,0,0
1653626049484,CSE 239A,A00,090121,Kumar; Arun Kumar,0,0,0,0
1653626050017,CSE 239B,A00,090122,Jhala; Ranjit,0,0,0,0
1653626050542,CSE 240A,A00,090123,Zhao; Jishen,0,0,189,189
1653626051067,CSE 243A,A00,090124,Orailoglu; Alex,0,0,15,15
1653626051590,CSE 249B,A00,090125,Kahng; Andrew Byun,12,0,20,8
1653626052112,CSE 250A,A00,090126,Berg-Kirkpatrick; Taylor D,0,0,0,0
1653626052635,CSE 252A,A00,090127,Ochoa; Benjamin Lawrence,0,0,0,0
1653626053161,CSE 258,A01,090129,McAuley; Julian John,0,0,0,0
1653626053686,CSE 258R,A01,090131,McAuley; Julian John,0,0,0,0
1653626054211,CSE 274,A00,090132,Ramamoorthi; Ravi,0,0,0,0
1653626054739,CSE 276A,A00,090133,Christensen; Henrik I,0,0,0,0
1653626055262,CSE 276C,A00,090134,Christensen; Henrik I,0,0,0,0
1653626055787,CSE 290,A00,090135,Bafna; Vineet,0,0,0,0
1653626055787,CSE 290,B00,090136,Ramamoorthi; Ravi,0,0,0,0
1653626055787,CSE 290,C00,090137,Li; Tzumao,7,0,10,3
1653626055787,CSE 290,D00,090138,Zhou; Yuan-Yuan,9,0,10,1
1653626055787,CSE 290,E00,090139,Christensen; Henrik I,8,0,10,2
1653626055787,CSE 290,F00,094053,Shalev; Aaron D,0,0,0,0
1653626056314,CSE 291,A00,090140,Munyaka; Imani N. S.,0,0,0,0
1653626056314,CSE 291,B00,094880,Yu; Qi,0,0,0,0
1653626056314,CSE 291,C00,090142,Pannuto; Patrick William,0,0,0,0
1653626056314,CSE 291,D00,094881,Zhang; Yiying,0,0,0,0
1653626056314,CSE 291,E00,095118,Su; Hao,0,0,0,0
1653626056845,CSE 293,001,094905,Bafna; Vineet,9999,0,9999,0
1653626056845,CSE 293,002,094906,Bellare; Mihir,9999,0,9999,0
1653626056845,CSE 293,003,094907,Berg-Kirkpatrick; Taylor D,9999,0,9999,0
1653626056845,CSE 293,004,094908,Christensen; Henrik I,9999,0,9999,0
1653626056845,CSE 293,005,094909,Cottrell; Garrison W,9999,0,9999,0
1653626056845,CSE 293,006,094910,Deutsch; Alin Bernard,9999,0,9999,0
1653626056845,CSE 293,007,094911,Esmaeilzadeh; Hadi,9999,0,9999,0
1653626056845,CSE 293,008,094912,Freund; Yoav,9999,0,9999,0
1653626056845,CSE 293,009,094913,Griswold; William G.,9999,0,9999,0
1653626056845,CSE 293,010,094914,Gymrek; Melissa Ann,9999,0,9999,0
1653626056845,CSE 293,011,094915,Heninger; Nadia A,9999,0,9999,0
1653626056845,CSE 293,012,094916,Impagliazzo; Russell,9999,0,9999,0
1653626056845,CSE 293,013,094917,Jhala; Ranjit,9999,0,9999,0
1653626056845,CSE 293,014,094918,Kahng; Andrew Byun,9999,0,9999,0
1653626056845,CSE 293,015,094919,Kane; Daniel Mertz,9999,0,9999,0
1653626056845,CSE 293,016,094920,Kriegman; David J,9999,0,9999,0
1653626056845,CSE 293,017,094921,Kumar; Arun Kumar,9999,0,9999,0
1653626056845,CSE 293,018,094922,Lerner; Sorin,9999,0,9999,0
1653626056845,CSE 293,019,094923,Lovett; Shachar,9999,0,9999,0
1653626056845,CSE 293,020,094924,McAuley; Julian John,9999,0,9999,0
1653626056845,CSE 293,021,094925,Micciancio; Daniele,9999,0,9999,0
1653626056845,CSE 293,022,094926,Orailoglu; Alex,9999,0,9999,0
1653626056845,CSE 293,023,094927,Paturi; Ramamohan,9999,0,9999,0
1653626056845,CSE 293,024,094928,Polikarpova; Nadezhda,9999,0,9999,0
1653626056845,CSE 293,025,094929,Politz; Joseph Gibbs,9999,0,9999,0
1653626056845,CSE 293,026,094930,Porter; George M,9999,0,9999,0
1653626056845,CSE 293,027,094931,Porter; Leonard Emerson,9999,0,9999,0
1653626056845,CSE 293,028,094932,Ramamoorthi; Ravi,9999,0,9999,0
1653626056845,CSE 293,029,094933,Sahoo; Debashis,9999,0,9999,0
1653626056845,CSE 293,030,094934,Saul; Lawrence,9999,0,9999,0
1653626056845,CSE 293,031,094935,Savage; Stefan,9999,0,9999,0
1653626056845,CSE 293,032,094936,Schulze; Jurgen P.,9999,0,9999,0
1653626056845,CSE 293,033,094937,Snoeren; Alex C.,9999,0,9999,0
1653626056845,CSE 293,034,094938,Shang; Jingbo,9999,0,9999,0
1653626056845,CSE 293,035,094939,Stefan; Deian,9999,0,9999,0
1653626056845,CSE 293,036,094940,Su; Hao,9999,0,9999,0
1653626056845,CSE 293,037,094941,Swanson; Steven James,9999,0,9999,0
1653626056845,CSE 293,038,094942,Tullsen; Dean Michael,9999,0,9999,0
1653626056845,CSE 293,039,094943,Voelker; Geoffrey M.,9999,0,9999,0
1653626056845,CSE 293,040,094944,Zhao; Jishen,9999,0,9999,0
1653626056845,CSE 293,041,094945,Zhou; Yuan-Yuan,9999,0,9999,0
1653626056845,CSE 293,042,094946,Gao; Sicun,9998,0,9999,1
1653626056845,CSE 293,043,094947,Weibel; Nadir,9999,0,9999,0
1653626056845,CSE 293,044,094948,Gupta; Rajesh K.,9999,0,9999,0
1653626057370,CSE 294,A00,090143,Porter; George M,9,0,10,1
1653626057893,DSE 200,A00,091799,Staff,50,0,50,0
1653626058416,DSE 203,A00,091800,Gupta; Amarnath,30,0,30,0
1653626058942,DSE 250,A00,091801,Deutsch; Alin Bernard,30,0,30,0
1653626059464,DSE 290,A00,091802,Altintas De Callaf; Ilkay,50,0,50,0
1653626059990,ECE 200,001,091003,Antipa; Nicholas A,9999,0,9999,0
1653626059990,ECE 200,002,091004,Atanasov; Nikolay A.,9999,0,9999,0
1653626059990,ECE 200,003,091005,Bharadia; Dinesh,9999,0,9999,0
1653626059990,ECE 200,004,091006,Cheng; Chung Kuan,9999,0,9999,0
1653626059990,ECE 200,005,091007,Cosman; Pamela C.,9999,0,9999,0
1653626059990,ECE 200,006,091008,Staff,9999,0,9999,0
1653626059990,ECE 200,007,091009,Dayeh; Shadi Ahmad,9999,0,9999,0
1653626059990,ECE 200,008,091010,Fainman; Yeshaiahu,9999,0,9999,0
1653626059990,ECE 200,009,091011,Ford; Joseph Earl,9999,0,9999,0
1653626059990,ECE 200,010,091012,Franceschetti; Massimo,9999,0,9999,0
1653626059990,ECE 200,011,091013,Fullerton; Eric E,9999,0,9999,0
1653626059990,ECE 200,012,091014,Galton; Ian A,9999,0,9999,0
1653626059990,ECE 200,013,091015,Gilja; Vikash,9999,0,9999,0
1653626059990,ECE 200,014,091016,Hall; Drew A.,9999,0,9999,0
1653626059990,ECE 200,015,091017,Hsueh; Tzu-Chien,9999,0,9999,0
1653626059990,ECE 200,016,091018,Javidi; Tara,9999,0,9999,0
1653626059990,ECE 200,017,091019,Kahng; Andrew Byun,9999,0,9999,0
1653626059990,ECE 200,018,091020,Kim; Young-Han,9999,0,9999,0
1653626059990,ECE 200,019,091021,Koushanfar; Farinaz,9999,0,9999,0
1653626059990,ECE 200,020,091022,Kuzum; Duygu,9999,0,9999,0
1653626059990,ECE 200,021,091023,Le; Hanh-Phuc,9999,0,9999,0
1653626059990,ECE 200,022,091024,Lin; Bill,9999,0,9999,0
1653626059990,ECE 200,023,091025,Liu; Zhaowei,9999,0,9999,0
1653626059990,ECE 200,024,091026,Lo; Yu-Hwa,9999,0,9999,0
1653626059990,ECE 200,025,091027,Lomakin; Vitaliy,9999,0,9999,0
1653626059990,ECE 200,026,091028,Mercier; Patrick Philip,9999,0,9999,0
1653626059990,ECE 200,027,091029,Meyer; Florian,9999,0,9999,0
1653626059990,ECE 200,028,091030,Milstein; Laurence B.,9999,0,9999,0
1653626059990,ECE 200,029,091031,Mir Arabbaygi; Siavash,9999,0,9999,0
1653626059990,ECE 200,030,091032,Mookherjea; Shayan,9999,0,9999,0
1653626059990,ECE 200,031,091033,Morris; Karcher William,9999,0,9999,0
1653626059990,ECE 200,032,091034,Ng; Tse Nga,9999,0,9999,0
1653626059990,ECE 200,033,091035,Nguyen; Truong Quang,9999,0,9999,0
1653626059990,ECE 200,034,091036,Nomura; Kenji,9999,0,9999,0
1653626059990,ECE 200,035,091037,Orlitsky; Alon,9999,0,9999,0
1653626059990,ECE 200,036,091038,Pal; Piya,9999,0,9999,0
1653626059990,ECE 200,037,091039,Papen; George C.,9999,0,9999,0
1653626059990,ECE 200,038,091040,Radic; Stojan,9999,0,9999,0
1653626059990,ECE 200,039,091041,Rao; Bhaskar D.,9999,0,9999,0
1653626059990,ECE 200,040,091042,Rao; Ramesh R,9999,0,9999,0
1653626059990,ECE 200,041,091043,Rebeiz; Gabriel,9999,0,9999,0
1653626059990,ECE 200,042,091044,Sanford; John R,9999,0,9999,0
1653626059990,ECE 200,043,091045,Siegel; Paul H.,9999,0,9999,0
1653626059990,ECE 200,044,091046,Sievenpiper; Daniel F.,9999,0,9999,0
1653626059990,ECE 200,045,091047,Sworder; David D.,9999,0,9999,0
1653626059990,ECE 200,046,091048,Taur; Yuan,9999,0,9999,0
1653626059990,ECE 200,047,091049,Touri; Behrouz,9999,0,9999,0
1653626059990,ECE 200,048,091050,Trivedi; Mohan M.,9999,0,9999,0
1653626059990,ECE 200,049,091051,Vardy; Alexander,9999,0,9999,0
1653626059990,ECE 200,050,091052,Vasconcelos; Nuno,9999,0,9999,0
1653626059990,ECE 200,051,091053,Wang; Xiaolong,9999,0,9999,0
1653626059990,ECE 200,052,091054,Xie; Pengtao,9999,0,9999,0
1653626059990,ECE 200,053,091055,Yip; Michael,9999,0,9999,0
1653626059990,ECE 200,054,091056,Zeger; Kenneth A.,9999,0,9999,0
1653626059990,ECE 200,055,091057,Zhang; Xinyu,9999,0,9999,0
1653626059990,ECE 200,056,091058,Turakhia; Yatish Girish,9999,0,9999,0
1653626059990,ECE 200,057,091059,Kang; Mingu,9999,0,9999,0
1653626059990,ECE 200,058,091060,Shi; Yuanyuan,9999,0,9999,0
1653626059990,ECE 200,059,091061,Wang; Edward Jay,9999,0,9999,0
1653626059990,ECE 200,060,091062,Zheng; Yang,9999,0,9999,0
1653626060517,ECE 201,A00,095526,Lo; Yu-Hwa,0,0,0,0
1653626061042,ECE 203,A00,091065,Mercier; Patrick Philip,0,0,0,0
1653626061567,ECE 207A,A00,091605,Liu; Thomas Tao-Ming,0,0,0,0
1653626062093,ECE 212AN,A00,091068,Nomura; Kenji,0,0,0,0
1653626062616,ECE 222A,A00,091069,Rebeiz; Gabriel,0,0,0,0
1653626063143,ECE 225A,A00,091070,Orlitsky; Alon,0,0,0,0
1653626063669,ECE 230A,A00,091071,Nomura; Kenji,0,0,0,0
1653626064201,ECE 236A,A00,091072,Dayeh; Shadi Ahmad,0,0,0,0
1653626064729,ECE 238A,A00,091073,Luo; Jian,0,0,0,0
1653626064729,ECE 238A,B00,091074,Luo; Jian,0,0,0,0
1653626065257,ECE 240A,A00,091075,Radic; Stojan,0,0,0,0
1653626065779,ECE 247A,A00,091592,Shi; Lingyan,0,0,0,0
1653626066304,ECE 250,A00,091076,Touri; Behrouz,0,0,0,0
1653626066828,ECE 251C,A00,091078,Nguyen; Truong Quang,0,0,0,0
1653626067350,ECE 253,A00,091079,Cosman; Pamela C.,0,0,0,0
1653626067871,ECE 255A,A00,091080,Orlitsky; Alon,0,0,0,0
1653626068395,ECE 257A,A00,091081,Zhang; Xinyu,0,0,0,0
1653626068919,ECE 260A,A01,091084,Eldon; John,0,0,0,0
1653626069513,ECE 264C,A00,091085,Galton; Ian A,0,0,0,0
1653626070035,ECE 265C,A00,094889,Presti; Calogero Davide,0,0,0,9
1653626070561,ECE 266,A01,091087,Hall; Drew A.,0,0,0,0
1653626071607,ECE 271A,A00,091090,Vasconcelos; Nuno,0,0,0,0
1653626072130,ECE 272B,A00,091091,Sworder; David D.,0,0,0,0
1653626072653,ECE 275A,A00,091092,Meyer; Florian,0,0,0,0
1653626073175,ECE 277,A00,091093,An; Cheolhong,0,0,0,0
1653626073700,ECE 283,A00,091094,Le; Hanh-Phuc,0,0,0,0
1653626074226,ECE 284,A00,091095,Kang; Mingu,0,0,0,0
1653626074226,ECE 284,B00,091096,Wang; Edward Jay,0,0,0,0
1653626074752,ECE 285,A00,094334,Touri; Behrouz,0,0,0,0
1653626075278,ECE 289,A00,091097,Whelan; David Arthur,0,0,0,0
1653626075806,MATH 200A,A00,087414,Salehi Golsefidy; Alireza,7,0,8,1
1653626076328,MATH 202A,A00,087415,Gill; Philip E.,2,0,8,6
1653626076855,MATH 203A,A00,087416,Oprea; Dragos N.,6,0,8,2
1653626077377,MATH 204A,A00,087417,Kedlaya; Kiran S.,6,0,8,2
1653626077902,MATH 205,A00,087418,Sorensen; Claus M,6,0,8,2
1653626078427,MATH 206A,A00,087419,Izadi; Elham,6,0,8,2
1653626078956,MATH 207A,A00,087420,Mohammadi; Amir,5,0,8,3
1653626079481,MATH 208,A00,087421,Staff,8,0,10,2
1653626080003,MATH 209,A00,087422,Staff,10,0,10,0
1653626080526,MATH 218,A00,087423,Staff,10,0,10,0
1653626081050,MATH 220A,A00,087424,Novak; Jonathan I,6,0,8,2
1653626081575,MATH 231A,A00,087425,Bejenaru; Ioan,3,0,8,5
1653626082098,MATH 240A,A00,087426,Ebenfelt; Peter F,5,0,8,3
1653626082632,MATH 243,A00,087427,Staff,9,0,10,1
1653626083155,MATH 248,A00,087429,Staff,10,0,10,0
1653626083680,MATH 250A,A00,087430,Spolaor; Luca,4,0,8,4
1653626084202,MATH 257A,A00,087431,Spolaor; Luca,7,0,8,1
1653626084725,MATH 258,A00,087432,Staff,9,0,10,1
1653626085251,MATH 264A,A00,087433,Warnke; Lutz Peter,5,0,8,3
1653626085774,MATH 268,A00,087434,Staff,15,0,15,0
1653626086297,MATH 269,A00,087435,Staff,14,0,15,1
1653626086823,MATH 270A,A00,087436,Nie; Jiawang,0,0,8,8
1653626087346,MATH 272A,A00,087437,Tian; Xiaochuan,0,0,8,8
1653626087872,MATH 274,A01,087439,Cheng; Li-Tien,9,0,10,1
1653626087872,MATH 274,A02,087440,Cheng; Li-Tien,10,0,10,0
1653626088398,MATH 278A,A00,087441,Staff,8,0,10,2
1653626088921,MATH 278B,A00,087442,Staff,8,0,10,2
1653626089444,MATH 278C,A00,087443,Staff,8,0,10,2
1653626089970,MATH 280A,A00,087444,Zheng; Tianyi,0,0,8,8
1653626090494,MATH 281A,A00,087445,Bradic; Jelena,0,0,8,9
1653626091024,MATH 282A,A00,087446,Zhang; Danna,0,0,8,8
1653626091552,MATH 283,A00,087447,Tesler; Glenn,0,0,0,16
1653626092083,MATH 286,B00,095535,Kemp; Todd Aahron,5,0,8,3
1653626092604,MATH 287D,B00,095536,Bradic; Jelena,5,0,8,3
1653626093130,MATH 288,A00,087450,Staff,14,0,15,1
1653626093130,MATH 288,B00,087451,Staff,15,0,15,0
1653626093130,MATH 288,C00,087452,Staff,15,0,15,0
1653626093654,MATH 290A,A00,087453,Xu; Zhouli,6,0,8,2
1653626094179,MATH 291A,A00,087454,Xu; Zhouli,7,0,8,1
1653626094703,MATH 292,A00,087455,Staff,10,0,10,0
1653626095229,MATH 295,A00,087456,Staff,50,0,50,0
1653626095753,MATH 297,001,087457,Staff,997,0,999,2
1653626654881,COGS 200,A01,087991,Staff,47,0,50,3
1653626655403,COGS 201,A01,094504,Rangel; Lara M,16,0,25,9
1653626656021,COGS 203,A00,087992,Coulson; Seana M,18,0,20,2
1653626656544,COGS 210A,001,087993,Greene; Deanna Jacquelyn,9998,0,9999,1
1653626656544,COGS 210A,002,087994,Saygin; Ayse P,9999,0,9999,0
1653626656544,COGS 210A,003,087995,Xia; Haijun,9999,0,9999,0
1653626656544,COGS 210A,004,087996,Nitz; Douglas A.,9999,0,9999,0
1653626656544,COGS 210A,005,087997,Hollan; James D.,9999,0,9999,0
1653626656544,COGS 210A,006,087998,Deak; Gedeon O.,9998,0,9999,1
1653626656544,COGS 210A,007,087999,Rossano; Federico,9999,0,9999,0
1653626657069,COGS 211A,A00,088000,Coulson; Seana M,9997,0,9999,2
1653626657591,COGS 229,A00,088002,Staff,22,0,25,3
1653626658115,COGS 260,B00,094231,Staff,17,0,20,3
1653626658115,COGS 260,A00,088004,Nitz; Douglas A.,9998,0,9999,1
1653626658647,CSE 202,A00,090110,Paturi; Ramamohan,0,0,0,0
1653626658647,CSE 202,B00,090111,Paturi; Ramamohan,0,0,0,0
1653626659169,CSE 207B,A00,090112,Heninger; Nadia A,0,0,0,0
1653626659695,CSE 208,A00,094858,Micciancio; Daniele,0,0,0,0
1653626660218,CSE 210,A00,090113,Powell; Thomas Allan,0,0,0,0
1653626660741,CSE 219,A00,090898,Staff,0,0,0,0
1653626661264,CSE 221,A00,090114,Zhou; Yuan-Yuan,0,0,0,0
1653626661789,CSE 229A,A00,090115,Porter; George M,0,0,0,0
1653626662315,CSE 229C,A00,090116,Savage; Stefan,0,0,0,0
1653626662844,CSE 230,A00,090117,Jhala; Ranjit,0,0,0,0
1653626663367,CSE 232,A00,090118,Papakonstantinou; Yannis,0,0,0,0
1653626663893,CSE 239A,A00,090121,Kumar; Arun Kumar,0,0,0,0
1653626664415,CSE 239B,A00,090122,Jhala; Ranjit,0,0,0,0
1653626664947,CSE 240A,A00,090123,Zhao; Jishen,0,0,189,189
1653626665469,CSE 243A,A00,090124,Orailoglu; Alex,0,0,15,15
1653626665995,CSE 249B,A00,090125,Kahng; Andrew Byun,12,0,20,8
1653626666519,CSE 250A,A00,090126,Berg-Kirkpatrick; Taylor D,0,0,0,0
1653626667041,CSE 252A,A00,090127,Ochoa; Benjamin Lawrence,0,0,0,0
1653626667568,CSE 258,A01,090129,McAuley; Julian John,0,0,0,0
1653626668100,CSE 258R,A01,090131,McAuley; Julian John,0,0,0,0
1653626668622,CSE 274,A00,090132,Ramamoorthi; Ravi,0,0,0,0
1653626669146,CSE 276A,A00,090133,Christensen; Henrik I,0,0,0,0
1653626669671,CSE 276C,A00,090134,Christensen; Henrik I,0,0,0,0
1653626670192,CSE 290,A00,090135,Bafna; Vineet,0,0,0,0
1653626670192,CSE 290,B00,090136,Ramamoorthi; Ravi,0,0,0,0
1653626670192,CSE 290,C00,090137,Li; Tzumao,7,0,10,3
1653626670192,CSE 290,D00,090138,Zhou; Yuan-Yuan,9,0,10,1
1653626670192,CSE 290,E00,090139,Christensen; Henrik I,8,0,10,2
1653626670192,CSE 290,F00,094053,Shalev; Aaron D,0,0,0,0
1653626670721,CSE 291,A00,090140,Munyaka; Imani N. S.,0,0,0,0
1653626670721,CSE 291,B00,094880,Yu; Qi,0,0,0,0
1653626670721,CSE 291,C00,090142,Pannuto; Patrick William,0,0,0,0
1653626670721,CSE 291,D00,094881,Zhang; Yiying,0,0,0,0
1653626670721,CSE 291,E00,095118,Su; Hao,0,0,0,0
1653626671246,CSE 293,001,094905,Bafna; Vineet,9999,0,9999,0
1653626671246,CSE 293,002,094906,Bellare; Mihir,9999,0,9999,0
1653626671246,CSE 293,003,094907,Berg-Kirkpatrick; Taylor D,9999,0,9999,0
1653626671246,CSE 293,004,094908,Christensen; Henrik I,9999,0,9999,0
1653626671246,CSE 293,005,094909,Cottrell; Garrison W,9999,0,9999,0
1653626671246,CSE 293,006,094910,Deutsch; Alin Bernard,9999,0,9999,0
1653626671246,CSE 293,007,094911,Esmaeilzadeh; Hadi,9999,0,9999,0
1653626671246,CSE 293,008,094912,Freund; Yoav,9999,0,9999,0
1653626671246,CSE 293,009,094913,Griswold; William G.,9999,0,9999,0
1653626671246,CSE 293,010,094914,Gymrek; Melissa Ann,9999,0,9999,0
1653626671246,CSE 293,011,094915,Heninger; Nadia A,9999,0,9999,0
1653626671246,CSE 293,012,094916,Impagliazzo; Russell,9999,0,9999,0
1653626671246,CSE 293,013,094917,Jhala; Ranjit,9999,0,9999,0
1653626671246,CSE 293,014,094918,Kahng; Andrew Byun,9999,0,9999,0
1653626671246,CSE 293,015,094919,Kane; Daniel Mertz,9999,0,9999,0
1653626671246,CSE 293,016,094920,Kriegman; David J,9999,0,9999,0
1653626671246,CSE 293,017,094921,Kumar; Arun Kumar,9999,0,9999,0
1653626671246,CSE 293,018,094922,Lerner; Sorin,9999,0,9999,0
1653626671246,CSE 293,019,094923,Lovett; Shachar,9999,0,9999,0
1653626671246,CSE 293,020,094924,McAuley; Julian John,9999,0,9999,0
1653626671246,CSE 293,021,094925,Micciancio; Daniele,9999,0,9999,0
1653626671246,CSE 293,022,094926,Orailoglu; Alex,9999,0,9999,0
1653626671246,CSE 293,023,094927,Paturi; Ramamohan,9999,0,9999,0
1653626671246,CSE 293,024,094928,Polikarpova; Nadezhda,9999,0,9999,0
1653626671246,CSE 293,025,094929,Politz; Joseph Gibbs,9999,0,9999,0
1653626671246,CSE 293,026,094930,Porter; George M,9999,0,9999,0
1653626671246,CSE 293,027,094931,Porter; Leonard Emerson,9999,0,9999,0
1653626671246,CSE 293,028,094932,Ramamoorthi; Ravi,9999,0,9999,0
1653626671246,CSE 293,029,094933,Sahoo; Debashis,9999,0,9999,0
1653626671246,CSE 293,030,094934,Saul; Lawrence,9999,0,9999,0
1653626671246,CSE 293,031,094935,Savage; Stefan,9999,0,9999,0
1653626671246,CSE 293,032,094936,Schulze; Jurgen P.,9999,0,9999,0
1653626671246,CSE 293,033,094937,Snoeren; Alex C.,9999,0,9999,0
1653626671246,CSE 293,034,094938,Shang; Jingbo,9999,0,9999,0
1653626671246,CSE 293,035,094939,Stefan; Deian,9999,0,9999,0
1653626671246,CSE 293,036,094940,Su; Hao,9999,0,9999,0
1653626671246,CSE 293,037,094941,Swanson; Steven James,9999,0,9999,0
1653626671246,CSE 293,038,094942,Tullsen; Dean Michael,9999,0,9999,0
1653626671246,CSE 293,039,094943,Voelker; Geoffrey M.,9999,0,9999,0
1653626671246,CSE 293,040,094944,Zhao; Jishen,9999,0,9999,0
1653626671246,CSE 293,041,094945,Zhou; Yuan-Yuan,9999,0,9999,0
1653626671246,CSE 293,042,094946,Gao; Sicun,9998,0,9999,1
1653626671246,CSE 293,043,094947,Weibel; Nadir,9999,0,9999,0
1653626671246,CSE 293,044,094948,Gupta; Rajesh K.,9999,0,9999,0
1653626671770,CSE 294,A00,090143,Porter; George M,9,0,10,1
1653626672298,DSE 200,A00,091799,Staff,50,0,50,0
1653626672825,DSE 203,A00,091800,Gupta; Amarnath,30,0,30,0
1653626673347,DSE 250,A00,091801,Deutsch; Alin Bernard,30,0,30,0
1653626673870,DSE 290,A00,091802,Altintas De Callaf; Ilkay,50,0,50,0
1653626674431,ECE 200,001,091003,Antipa; Nicholas A,9999,0,9999,0
1653626674431,ECE 200,002,091004,Atanasov; Nikolay A.,9999,0,9999,0
1653626674431,ECE 200,003,091005,Bharadia; Dinesh,9999,0,9999,0
1653626674431,ECE 200,004,091006,Cheng; Chung Kuan,9999,0,9999,0
1653626674431,ECE 200,005,091007,Cosman; Pamela C.,9999,0,9999,0
1653626674431,ECE 200,006,091008,Staff,9999,0,9999,0
1653626674431,ECE 200,007,091009,Dayeh; Shadi Ahmad,9999,0,9999,0
1653626674431,ECE 200,008,091010,Fainman; Yeshaiahu,9999,0,9999,0
1653626674431,ECE 200,009,091011,Ford; Joseph Earl,9999,0,9999,0
1653626674431,ECE 200,010,091012,Franceschetti; Massimo,9999,0,9999,0
1653626674431,ECE 200,011,091013,Fullerton; Eric E,9999,0,9999,0
1653626674431,ECE 200,012,091014,Galton; Ian A,9999,0,9999,0
1653626674431,ECE 200,013,091015,Gilja; Vikash,9999,0,9999,0
1653626674431,ECE 200,014,091016,Hall; Drew A.,9999,0,9999,0
1653626674431,ECE 200,015,091017,Hsueh; Tzu-Chien,9999,0,9999,0
1653626674431,ECE 200,016,091018,Javidi; Tara,9999,0,9999,0
1653626674431,ECE 200,017,091019,Kahng; Andrew Byun,9999,0,9999,0
1653626674431,ECE 200,018,091020,Kim; Young-Han,9999,0,9999,0
1653626674431,ECE 200,019,091021,Koushanfar; Farinaz,9999,0,9999,0
1653626674431,ECE 200,020,091022,Kuzum; Duygu,9999,0,9999,0
1653626674431,ECE 200,021,091023,Le; Hanh-Phuc,9999,0,9999,0
1653626674431,ECE 200,022,091024,Lin; Bill,9999,0,9999,0
1653626674431,ECE 200,023,091025,Liu; Zhaowei,9999,0,9999,0
1653626674431,ECE 200,024,091026,Lo; Yu-Hwa,9999,0,9999,0
1653626674431,ECE 200,025,091027,Lomakin; Vitaliy,9999,0,9999,0
1653626674431,ECE 200,026,091028,Mercier; Patrick Philip,9999,0,9999,0
1653626674431,ECE 200,027,091029,Meyer; Florian,9999,0,9999,0
1653626674431,ECE 200,028,091030,Milstein; Laurence B.,9999,0,9999,0
1653626674431,ECE 200,029,091031,Mir Arabbaygi; Siavash,9999,0,9999,0
1653626674431,ECE 200,030,091032,Mookherjea; Shayan,9999,0,9999,0
1653626674431,ECE 200,031,091033,Morris; Karcher William,9999,0,9999,0
1653626674431,ECE 200,032,091034,Ng; Tse Nga,9999,0,9999,0
1653626674431,ECE 200,033,091035,Nguyen; Truong Quang,9999,0,9999,0
1653626674431,ECE 200,034,091036,Nomura; Kenji,9999,0,9999,0
1653626674431,ECE 200,035,091037,Orlitsky; Alon,9999,0,9999,0
1653626674431,ECE 200,036,091038,Pal; Piya,9999,0,9999,0
1653626674431,ECE 200,037,091039,Papen; George C.,9999,0,9999,0
1653626674431,ECE 200,038,091040,Radic; Stojan,9999,0,9999,0
1653626674431,ECE 200,039,091041,Rao; Bhaskar D.,9999,0,9999,0
1653626674431,ECE 200,040,091042,Rao; Ramesh R,9999,0,9999,0
1653626674431,ECE 200,041,091043,Rebeiz; Gabriel,9999,0,9999,0
1653626674431,ECE 200,042,091044,Sanford; John R,9999,0,9999,0
1653626674431,ECE 200,043,091045,Siegel; Paul H.,9999,0,9999,0
1653626674431,ECE 200,044,091046,Sievenpiper; Daniel F.,9999,0,9999,0
1653626674431,ECE 200,045,091047,Sworder; David D.,9999,0,9999,0
1653626674431,ECE 200,046,091048,Taur; Yuan,9999,0,9999,0
1653626674431,ECE 200,047,091049,Touri; Behrouz,9999,0,9999,0
1653626674431,ECE 200,048,091050,Trivedi; Mohan M.,9999,0,9999,0
1653626674431,ECE 200,049,091051,Vardy; Alexander,9999,0,9999,0
1653626674431,ECE 200,050,091052,Vasconcelos; Nuno,9999,0,9999,0
1653626674431,ECE 200,051,091053,Wang; Xiaolong,9999,0,9999,0
1653626674431,ECE 200,052,091054,Xie; Pengtao,9999,0,9999,0
1653626674431,ECE 200,053,091055,Yip; Michael,9999,0,9999,0
1653626674431,ECE 200,054,091056,Zeger; Kenneth A.,9999,0,9999,0
1653626674431,ECE 200,055,091057,Zhang; Xinyu,9999,0,9999,0
1653626674431,ECE 200,056,091058,Turakhia; Yatish Girish,9999,0,9999,0
1653626674431,ECE 200,057,091059,Kang; Mingu,9999,0,9999,0
1653626674431,ECE 200,058,091060,Shi; Yuanyuan,9999,0,9999,0
1653626674431,ECE 200,059,091061,Wang; Edward Jay,9999,0,9999,0
1653626674431,ECE 200,060,091062,Zheng; Yang,9999,0,9999,0
1653626674954,ECE 201,A00,095526,Lo; Yu-Hwa,0,0,0,0
1653626675476,ECE 203,A00,091065,Mercier; Patrick Philip,0,0,0,0
1653626675998,ECE 207A,A00,091605,Liu; Thomas Tao-Ming,0,0,0,0
1653626676521,ECE 212AN,A00,091068,Nomura; Kenji,0,0,0,0
1653626677044,ECE 222A,A00,091069,Rebeiz; Gabriel,0,0,0,0
1653626677566,ECE 225A,A00,091070,Orlitsky; Alon,0,0,0,0
1653626678089,ECE 230A,A00,091071,Nomura; Kenji,0,0,0,0
1653626678615,ECE 236A,A00,091072,Dayeh; Shadi Ahmad,0,0,0,0
1653626679137,ECE 238A,A00,091073,Luo; Jian,0,0,0,0
1653626679137,ECE 238A,B00,091074,Luo; Jian,0,0,0,0
1653626679660,ECE 240A,A00,091075,Radic; Stojan,0,0,0,0
1653626680188,ECE 247A,A00,091592,Shi; Lingyan,0,0,0,0
1653626680711,ECE 250,A00,091076,Touri; Behrouz,0,0,0,0
1653626681237,ECE 251C,A00,091078,Nguyen; Truong Quang,0,0,0,0
1653626681763,ECE 253,A00,091079,Cosman; Pamela C.,0,0,0,0
1653626682286,ECE 255A,A00,091080,Orlitsky; Alon,0,0,0,0
1653626682814,ECE 257A,A00,091081,Zhang; Xinyu,0,0,0,0
1653626683340,ECE 260A,A01,091084,Eldon; John,0,0,0,0
1653626683865,ECE 264C,A00,091085,Galton; Ian A,0,0,0,0
1653626684390,ECE 265C,A00,094889,Presti; Calogero Davide,0,0,0,9
1653626684911,ECE 266,A01,091087,Hall; Drew A.,0,0,0,0
1653626685966,ECE 271A,A00,091090,Vasconcelos; Nuno,0,0,0,0
1653626686495,ECE 272B,A00,091091,Sworder; David D.,0,0,0,0
1653626687018,ECE 275A,A00,091092,Meyer; Florian,0,0,0,0
1653626687551,ECE 277,A00,091093,An; Cheolhong,0,0,0,0
1653626688075,ECE 283,A00,091094,Le; Hanh-Phuc,0,0,0,0
1653626688597,ECE 284,A00,091095,Kang; Mingu,0,0,0,0
1653626688597,ECE 284,B00,091096,Wang; Edward Jay,0,0,0,0
1653626689121,ECE 285,A00,094334,Touri; Behrouz,0,0,0,0
1653626689645,ECE 289,A00,091097,Whelan; David Arthur,0,0,0,0
1653626690170,MATH 200A,A00,087414,Salehi Golsefidy; Alireza,7,0,8,1
1653626690724,MATH 202A,A00,087415,Gill; Philip E.,2,0,8,6
1653626691257,MATH 203A,A00,087416,Oprea; Dragos N.,6,0,8,2
1653626691783,MATH 204A,A00,087417,Kedlaya; Kiran S.,6,0,8,2
1653626692305,MATH 205,A00,087418,Sorensen; Claus M,6,0,8,2
1653626692832,MATH 206A,A00,087419,Izadi; Elham,6,0,8,2
1653626693357,MATH 207A,A00,087420,Mohammadi; Amir,5,0,8,3
1653626693882,MATH 208,A00,087421,Staff,8,0,10,2
1653626694405,MATH 209,A00,087422,Staff,10,0,10,0
1653626694931,MATH 218,A00,087423,Staff,10,0,10,0
1653626695457,MATH 220A,A00,087424,Novak; Jonathan I,6,0,8,2
1653626695985,MATH 231A,A00,087425,Bejenaru; Ioan,3,0,8,5
1653626696509,MATH 240A,A00,087426,Ebenfelt; Peter F,5,0,8,3
1653626697032,MATH 243,A00,087427,Staff,9,0,10,1
1653626697554,MATH 248,A00,087429,Staff,10,0,10,0
1653626698077,MATH 250A,A00,087430,Spolaor; Luca,4,0,8,4
1653626698601,MATH 257A,A00,087431,Spolaor; Luca,7,0,8,1
1653626699125,MATH 258,A00,087432,Staff,9,0,10,1
1653626699650,MATH 264A,A00,087433,Warnke; Lutz Peter,5,0,8,3
1653626700175,MATH 268,A00,087434,Staff,15,0,15,0
1653626700698,MATH 269,A00,087435,Staff,14,0,15,1
1653626701226,MATH 270A,A00,087436,Nie; Jiawang,0,0,8,8
1653626701752,MATH 272A,A00,087437,Tian; Xiaochuan,0,0,8,8
1653626702287,MATH 274,A01,087439,Cheng; Li-Tien,9,0,10,1
1653626702287,MATH 274,A02,087440,Cheng; Li-Tien,10,0,10,0
1653626702835,MATH 278A,A00,087441,Staff,8,0,10,2
1653626703360,MATH 278B,A00,087442,Staff,8,0,10,2
1653626703884,MATH 278C,A00,087443,Staff,8,0,10,2
1653626704407,MATH 280A,A00,087444,Zheng; Tianyi,0,0,8,8
1653626704937,MATH 281A,A00,087445,Bradic; Jelena,0,0,8,9
1653626705458,MATH 282A,A00,087446,Zhang; Danna,0,0,8,8
1653626705981,MATH 283,A00,087447,Tesler; Glenn,0,0,0,16
1653626706514,MATH 286,B00,095535,Kemp; Todd Aahron,5,0,8,3
1653626707041,MATH 287D,B00,095536,Bradic; Jelena,5,0,8,3
1653626707562,MATH 288,A00,087450,Staff,14,0,15,1
1653626707562,MATH 288,B00,087451,Staff,15,0,15,0
1653626707562,MATH 288,C00,087452,Staff,15,0,15,0
1653626708088,MATH 290A,A00,087453,Xu; Zhouli,6,0,8,2
1653626708614,MATH 291A,A00,087454,Xu; Zhouli,7,0,8,1
1653626709211,MATH 292,A00,087455,Staff,10,0,10,0
1653626709740,MATH 295,A00,087456,Staff,50,0,50,0
1653626710262,MATH 297,001,087457,Staff,997,0,999,2
1653627269268,COGS 200,A01,087991,Staff,47,0,50,3
1653627269793,COGS 201,A01,094504,Rangel; Lara M,16,0,25,9
1653627270314,COGS 203,A00,087992,Coulson; Seana M,18,0,20,2
1653627270836,COGS 210A,001,087993,Greene; Deanna Jacquelyn,9998,0,9999,1
1653627270836,COGS 210A,002,087994,Saygin; Ayse P,9999,0,9999,0
1653627270836,COGS 210A,003,087995,Xia; Haijun,9999,0,9999,0
1653627270836,COGS 210A,004,087996,Nitz; Douglas A.,9999,0,9999,0
1653627270836,COGS 210A,005,087997,Hollan; James D.,9999,0,9999,0
1653627270836,COGS 210A,006,087998,Deak; Gedeon O.,9998,0,9999,1
1653627270836,COGS 210A,007,087999,Rossano; Federico,9999,0,9999,0
1653627271361,COGS 211A,A00,088000,Coulson; Seana M,9997,0,9999,2
1653627271898,COGS 229,A00,088002,Staff,22,0,25,3
1653627272421,COGS 260,B00,094231,Staff,17,0,20,3
1653627272421,COGS 260,A00,088004,Nitz; Douglas A.,9998,0,9999,1
1653627272948,CSE 202,A00,090110,Paturi; Ramamohan,0,0,0,0
1653627272948,CSE 202,B00,090111,Paturi; Ramamohan,0,0,0,0
1653627273470,CSE 207B,A00,090112,Heninger; Nadia A,0,0,0,0
1653627273998,CSE 208,A00,094858,Micciancio; Daniele,0,0,0,0
1653627274522,CSE 210,A00,090113,Powell; Thomas Allan,0,0,0,0
1653627275044,CSE 219,A00,090898,Staff,0,0,0,0
1653627275572,CSE 221,A00,090114,Zhou; Yuan-Yuan,0,0,0,0
1653627276098,CSE 229A,A00,090115,Porter; George M,0,0,0,0
1653627276618,CSE 229C,A00,090116,Savage; Stefan,0,0,0,0
1653627277141,CSE 230,A00,090117,Jhala; Ranjit,0,0,0,0
1653627277664,CSE 232,A00,090118,Papakonstantinou; Yannis,0,0,0,0
1653627278186,CSE 239A,A00,090121,Kumar; Arun Kumar,0,0,0,0
1653627278708,CSE 239B,A00,090122,Jhala; Ranjit,0,0,0,0
1653627279229,CSE 240A,A00,090123,Zhao; Jishen,0,0,189,189
1653627279754,CSE 243A,A00,090124,Orailoglu; Alex,0,0,15,15
1653627280281,CSE 249B,A00,090125,Kahng; Andrew Byun,12,0,20,8
1653627280806,CSE 250A,A00,090126,Berg-Kirkpatrick; Taylor D,0,0,0,0
1653627281330,CSE 252A,A00,090127,Ochoa; Benjamin Lawrence,0,0,0,0
1653627281853,CSE 258,A01,090129,McAuley; Julian John,0,0,0,0
1653627282378,CSE 258R,A01,090131,McAuley; Julian John,0,0,0,0
1653627282904,CSE 274,A00,090132,Ramamoorthi; Ravi,0,0,0,0
1653627283427,CSE 276A,A00,090133,Christensen; Henrik I,0,0,0,0
1653627283949,CSE 276C,A00,090134,Christensen; Henrik I,0,0,0,0
1653627284472,CSE 290,A00,090135,Bafna; Vineet,0,0,0,0
1653627284472,CSE 290,B00,090136,Ramamoorthi; Ravi,0,0,0,0
1653627284472,CSE 290,C00,090137,Li; Tzumao,7,0,10,3
1653627284472,CSE 290,D00,090138,Zhou; Yuan-Yuan,9,0,10,1
1653627284472,CSE 290,E00,090139,Christensen; Henrik I,8,0,10,2
1653627284472,CSE 290,F00,094053,Shalev; Aaron D,0,0,0,0
1653627285007,CSE 291,A00,090140,Munyaka; Imani N. S.,0,0,0,0
1653627285007,CSE 291,B00,094880,Yu; Qi,0,0,0,0
1653627285007,CSE 291,C00,090142,Pannuto; Patrick William,0,0,0,0
1653627285007,CSE 291,D00,094881,Zhang; Yiying,0,0,0,0
1653627285007,CSE 291,E00,095118,Su; Hao,0,0,0,0
1653627285550,CSE 293,001,094905,Bafna; Vineet,9999,0,9999,0
1653627285550,CSE 293,002,094906,Bellare; Mihir,9999,0,9999,0
1653627285550,CSE 293,003,094907,Berg-Kirkpatrick; Taylor D,9999,0,9999,0
1653627285550,CSE 293,004,094908,Christensen; Henrik I,9999,0,9999,0
1653627285550,CSE 293,005,094909,Cottrell; Garrison W,9999,0,9999,0
1653627285550,CSE 293,006,094910,Deutsch; Alin Bernard,9999,0,9999,0
1653627285550,CSE 293,007,094911,Esmaeilzadeh; Hadi,9999,0,9999,0
1653627285550,CSE 293,008,094912,Freund; Yoav,9999,0,9999,0
1653627285550,CSE 293,009,094913,Griswold; William G.,9999,0,9999,0
1653627285550,CSE 293,010,094914,Gymrek; Melissa Ann,9999,0,9999,0
1653627285550,CSE 293,011,094915,Heninger; Nadia A,9999,0,9999,0
1653627285550,CSE 293,012,094916,Impagliazzo; Russell,9999,0,9999,0
1653627285550,CSE 293,013,094917,Jhala; Ranjit,9999,0,9999,0
1653627285550,CSE 293,014,094918,Kahng; Andrew Byun,9999,0,9999,0
1653627285550,CSE 293,015,094919,Kane; Daniel Mertz,9999,0,9999,0
1653627285550,CSE 293,016,094920,Kriegman; David J,9999,0,9999,0
1653627285550,CSE 293,017,094921,Kumar; Arun Kumar,9999,0,9999,0
1653627285550,CSE 293,018,094922,Lerner; Sorin,9999,0,9999,0
1653627285550,CSE 293,019,094923,Lovett; Shachar,9999,0,9999,0
1653627285550,CSE 293,020,094924,McAuley; Julian John,9999,0,9999,0
1653627285550,CSE 293,021,094925,Micciancio; Daniele,9999,0,9999,0
1653627285550,CSE 293,022,094926,Orailoglu; Alex,9999,0,9999,0
1653627285550,CSE 293,023,094927,Paturi; Ramamohan,9999,0,9999,0
1653627285550,CSE 293,024,094928,Polikarpova; Nadezhda,9999,0,9999,0
1653627285550,CSE 293,025,094929,Politz; Joseph Gibbs,9999,0,9999,0
1653627285550,CSE 293,026,094930,Porter; George M,9999,0,9999,0
1653627285550,CSE 293,027,094931,Porter; Leonard Emerson,9999,0,9999,0
1653627285550,CSE 293,028,094932,Ramamoorthi; Ravi,9999,0,9999,0
1653627285550,CSE 293,029,094933,Sahoo; Debashis,9999,0,9999,0
1653627285550,CSE 293,030,094934,Saul; Lawrence,9999,0,9999,0
1653627285550,CSE 293,031,094935,Savage; Stefan,9999,0,9999,0
1653627285550,CSE 293,032,094936,Schulze; Jurgen P.,9999,0,9999,0
1653627285550,CSE 293,033,094937,Snoeren; Alex C.,9999,0,9999,0
1653627285550,CSE 293,034,094938,Shang; Jingbo,9999,0,9999,0
1653627285550,CSE 293,035,094939,Stefan; Deian,9999,0,9999,0
1653627285550,CSE 293,036,094940,Su; Hao,9999,0,9999,0
1653627285550,CSE 293,037,094941,Swanson; Steven James,9999,0,9999,0
1653627285550,CSE 293,038,094942,Tullsen; Dean Michael,9999,0,9999,0
1653627285550,CSE 293,039,094943,Voelker; Geoffrey M.,9999,0,9999,0
1653627285550,CSE 293,040,094944,Zhao; Jishen,9999,0,9999,0
1653627285550,CSE 293,041,094945,Zhou; Yuan-Yuan,9999,0,9999,0
1653627285550,CSE 293,042,094946,Gao; Sicun,9998,0,9999,1
1653627285550,CSE 293,043,094947,Weibel; Nadir,9999,0,9999,0
1653627285550,CSE 293,044,094948,Gupta; Rajesh K.,9999,0,9999,0
1653627286074,CSE 294,A00,090143,Porter; George M,9,0,10,1
1653627286596,DSE 200,A00,091799,Staff,50,0,50,0
1653627287121,DSE 203,A00,091800,Gupta; Amarnath,30,0,30,0
1653627287645,DSE 250,A00,091801,Deutsch; Alin Bernard,30,0,30,0
1653627288174,DSE 290,A00,091802,Altintas De Callaf; Ilkay,50,0,50,0
1653627288702,ECE 200,001,091003,Antipa; Nicholas A,9999,0,9999,0
1653627288702,ECE 200,002,091004,Atanasov; Nikolay A.,9999,0,9999,0
1653627288702,ECE 200,003,091005,Bharadia; Dinesh,9999,0,9999,0
1653627288702,ECE 200,004,091006,Cheng; Chung Kuan,9999,0,9999,0
1653627288702,ECE 200,005,091007,Cosman; Pamela C.,9999,0,9999,0
1653627288702,ECE 200,006,091008,Staff,9999,0,9999,0
1653627288702,ECE 200,007,091009,Dayeh; Shadi Ahmad,9999,0,9999,0
1653627288702,ECE 200,008,091010,Fainman; Yeshaiahu,9999,0,9999,0
1653627288702,ECE 200,009,091011,Ford; Joseph Earl,9999,0,9999,0
1653627288702,ECE 200,010,091012,Franceschetti; Massimo,9999,0,9999,0
1653627288702,ECE 200,011,091013,Fullerton; Eric E,9999,0,9999,0
1653627288702,ECE 200,012,091014,Galton; Ian A,9999,0,9999,0
1653627288702,ECE 200,013,091015,Gilja; Vikash,9999,0,9999,0
1653627288702,ECE 200,014,091016,Hall; Drew A.,9999,0,9999,0
1653627288702,ECE 200,015,091017,Hsueh; Tzu-Chien,9999,0,9999,0
1653627288702,ECE 200,016,091018,Javidi; Tara,9999,0,9999,0
1653627288702,ECE 200,017,091019,Kahng; Andrew Byun,9999,0,9999,0
1653627288702,ECE 200,018,091020,Kim; Young-Han,9999,0,9999,0
1653627288702,ECE 200,019,091021,Koushanfar; Farinaz,9999,0,9999,0
1653627288702,ECE 200,020,091022,Kuzum; Duygu,9999,0,9999,0
1653627288702,ECE 200,021,091023,Le; Hanh-Phuc,9999,0,9999,0
1653627288702,ECE 200,022,091024,Lin; Bill,9999,0,9999,0
1653627288702,ECE 200,023,091025,Liu; Zhaowei,9999,0,9999,0
1653627288702,ECE 200,024,091026,Lo; Yu-Hwa,9999,0,9999,0
1653627288702,ECE 200,025,091027,Lomakin; Vitaliy,9999,0,9999,0
1653627288702,ECE 200,026,091028,Mercier; Patrick Philip,9999,0,9999,0
1653627288702,ECE 200,027,091029,Meyer; Florian,9999,0,9999,0
1653627288702,ECE 200,028,091030,Milstein; Laurence B.,9999,0,9999,0
1653627288702,ECE 200,029,091031,Mir Arabbaygi; Siavash,9999,0,9999,0
1653627288702,ECE 200,030,091032,Mookherjea; Shayan,9999,0,9999,0
1653627288702,ECE 200,031,091033,Morris; Karcher William,9999,0,9999,0
1653627288702,ECE 200,032,091034,Ng; Tse Nga,9999,0,9999,0
1653627288702,ECE 200,033,091035,Nguyen; Truong Quang,9999,0,9999,0
1653627288702,ECE 200,034,091036,Nomura; Kenji,9999,0,9999,0
1653627288702,ECE 200,035,091037,Orlitsky; Alon,9999,0,9999,0
1653627288702,ECE 200,036,091038,Pal; Piya,9999,0,9999,0
1653627288702,ECE 200,037,091039,Papen; George C.,9999,0,9999,0
1653627288702,ECE 200,038,091040,Radic; Stojan,9999,0,9999,0
1653627288702,ECE 200,039,091041,Rao; Bhaskar D.,9999,0,9999,0
1653627288702,ECE 200,040,091042,Rao; Ramesh R,9999,0,9999,0
1653627288702,ECE 200,041,091043,Rebeiz; Gabriel,9999,0,9999,0
1653627288702,ECE 200,042,091044,Sanford; John R,9999,0,9999,0
1653627288702,ECE 200,043,091045,Siegel; Paul H.,9999,0,9999,0
1653627288702,ECE 200,044,091046,Sievenpiper; Daniel F.,9999,0,9999,0
1653627288702,ECE 200,045,091047,Sworder; David D.,9999,0,9999,0
1653627288702,ECE 200,046,091048,Taur; Yuan,9999,0,9999,0
1653627288702,ECE 200,047,091049,Touri; Behrouz,9999,0,9999,0
1653627288702,ECE 200,048,091050,Trivedi; Mohan M.,9999,0,9999,0
1653627288702,ECE 200,049,091051,Vardy; Alexander,9999,0,9999,0
1653627288702,ECE 200,050,091052,Vasconcelos; Nuno,9999,0,9999,0
1653627288702,ECE 200,051,091053,Wang; Xiaolong,9999,0,9999,0
1653627288702,ECE 200,052,091054,Xie; Pengtao,9999,0,9999,0
1653627288702,ECE 200,053,091055,Yip; Michael,9999,0,9999,0
1653627288702,ECE 200,054,091056,Zeger; Kenneth A.,9999,0,9999,0
1653627288702,ECE 200,055,091057,Zhang; Xinyu,9999,0,9999,0
1653627288702,ECE 200,056,091058,Turakhia; Yatish Girish,9999,0,9999,0
1653627288702,ECE 200,057,091059,Kang; Mingu,9999,0,9999,0
1653627288702,ECE 200,058,091060,Shi; Yuanyuan,9999,0,9999,0
1653627288702,ECE 200,059,091061,Wang; Edward Jay,9999,0,9999,0
1653627288702,ECE 200,060,091062,Zheng; Yang,9999,0,9999,0
1653627289244,ECE 201,A00,095526,Lo; Yu-Hwa,0,0,0,0
1653627289771,ECE 203,A00,091065,Mercier; Patrick Philip,0,0,0,0
1653627290294,ECE 207A,A00,091605,Liu; Thomas Tao-Ming,0,0,0,0
1653627290820,ECE 212AN,A00,091068,Nomura; Kenji,0,0,0,0
1653627291342,ECE 222A,A00,091069,Rebeiz; Gabriel,0,0,0,0
1653627291864,ECE 225A,A00,091070,Orlitsky; Alon,0,0,0,0
1653627292387,ECE 230A,A00,091071,Nomura; Kenji,0,0,0,0
1653627292913,ECE 236A,A00,091072,Dayeh; Shadi Ahmad,0,0,0,0
1653627293435,ECE 238A,A00,091073,Luo; Jian,0,0,0,0
1653627293435,ECE 238A,B00,091074,Luo; Jian,0,0,0,0
1653627293960,ECE 240A,A00,091075,Radic; Stojan,0,0,0,0
1653627294485,ECE 247A,A00,091592,Shi; Lingyan,0,0,0,0
1653627295017,ECE 250,A00,091076,Touri; Behrouz,0,0,0,0
1653627295643,ECE 251C,A00,091078,Nguyen; Truong Quang,0,0,0,0
1653627296166,ECE 253,A00,091079,Cosman; Pamela C.,0,0,0,0
1653627296697,ECE 255A,A00,091080,Orlitsky; Alon,0,0,0,0
1653627297218,ECE 257A,A00,091081,Zhang; Xinyu,0,0,0,0
1653627297745,ECE 260A,A01,091084,Eldon; John,0,0,0,0
1653627298276,ECE 264C,A00,091085,Galton; Ian A,0,0,0,0
1653627298799,ECE 265C,A00,094889,Presti; Calogero Davide,0,0,0,9
1653627299321,ECE 266,A01,091087,Hall; Drew A.,0,0,0,0
1653627300371,ECE 271A,A00,091090,Vasconcelos; Nuno,0,0,0,0
1653627300896,ECE 272B,A00,091091,Sworder; David D.,0,0,0,0
1653627301425,ECE 275A,A00,091092,Meyer; Florian,0,0,0,0
1653627301949,ECE 277,A00,091093,An; Cheolhong,0,0,0,0
1653627302472,ECE 283,A00,091094,Le; Hanh-Phuc,0,0,0,0
1653627302999,ECE 284,A00,091095,Kang; Mingu,0,0,0,0
1653627302999,ECE 284,B00,091096,Wang; Edward Jay,0,0,0,0
1653627303525,ECE 285,A00,094334,Touri; Behrouz,0,0,0,0
1653627304050,ECE 289,A00,091097,Whelan; David Arthur,0,0,0,0
1653627304576,MATH 200A,A00,087414,Salehi Golsefidy; Alireza,7,0,8,1
1653627305100,MATH 202A,A00,087415,Gill; Philip E.,2,0,8,6
1653627305622,MATH 203A,A00,087416,Oprea; Dragos N.,6,0,8,2
1653627306145,MATH 204A,A00,087417,Kedlaya; Kiran S.,6,0,8,2
1653627306667,MATH 205,A00,087418,Sorensen; Claus M,6,0,8,2
1653627307194,MATH 206A,A00,087419,Izadi; Elham,6,0,8,2
1653627307719,MATH 207A,A00,087420,Mohammadi; Amir,5,0,8,3
1653627308244,MATH 208,A00,087421,Staff,8,0,10,2
1653627308768,MATH 209,A00,087422,Staff,10,0,10,0
1653627309293,MATH 218,A00,087423,Staff,10,0,10,0
1653627309819,MATH 220A,A00,087424,Novak; Jonathan I,6,0,8,2
1653627310342,MATH 231A,A00,087425,Bejenaru; Ioan,3,0,8,5
1653627310875,MATH 240A,A00,087426,Ebenfelt; Peter F,5,0,8,3
1653627311397,MATH 243,A00,087427,Staff,9,0,10,1
1653627311919,MATH 248,A00,087429,Staff,10,0,10,0
1653627312446,MATH 250A,A00,087430,Spolaor; Luca,4,0,8,4
1653627312973,MATH 257A,A00,087431,Spolaor; Luca,7,0,8,1
1653627313504,MATH 258,A00,087432,Staff,9,0,10,1
1653627314029,MATH 264A,A00,087433,Warnke; Lutz Peter,5,0,8,3
1653627314554,MATH 268,A00,087434,Staff,15,0,15,0
1653627315088,MATH 269,A00,087435,Staff,14,0,15,1
1653627315611,MATH 270A,A00,087436,Nie; Jiawang,0,0,8,8
1653627316134,MATH 272A,A00,087437,Tian; Xiaochuan,0,0,8,8
1653627316658,MATH 274,A01,087439,Cheng; Li-Tien,9,0,10,1
1653627316658,MATH 274,A02,087440,Cheng; Li-Tien,10,0,10,0
1653627317184,MATH 278A,A00,087441,Staff,8,0,10,2
1653627317708,MATH 278B,A00,087442,Staff,8,0,10,2
1653627318230,MATH 278C,A00,087443,Staff,8,0,10,2
1653627318752,MATH 280A,A00,087444,Zheng; Tianyi,0,0,8,8
1653627319275,MATH 281A,A00,087445,Bradic; Jelena,0,0,8,9
1653627319797,MATH 282A,A00,087446,Zhang; Danna,0,0,8,8
1653627320319,MATH 283,A00,087447,Tesler; Glenn,0,0,0,16
1653627320844,MATH 286,B00,095535,Kemp; Todd Aahron,5,0,8,3
1653627321365,MATH 287D,B00,095536,Bradic; Jelena,5,0,8,3
1653627321894,MATH 288,A00,087450,Staff,14,0,15,1
1653627321894,MATH 288,B00,087451,Staff,15,0,15,0
1653627321894,MATH 288,C00,087452,Staff,15,0,15,0
1653627322423,MATH 290A,A00,087453,Xu; Zhouli,6,0,8,2
1653627322951,MATH 291A,A00,087454,Xu; Zhouli,7,0,8,1
1653627323473,MATH 292,A00,087455,Staff,10,0,10,0
1653627323994,MATH 295,A00,087456,Staff,50,0,50,0
1653627324519,MATH 297,001,087457,Staff,997,0,999,2
1653627893854,COGS 200,A01,087991,Staff,47,0,50,3
1653627894384,COGS 201,A01,094504,Rangel; Lara M,16,0,25,9
1653627894906,COGS 203,A00,087992,Coulson; Seana M,18,0,20,2
1653627895430,COGS 210A,001,087993,Greene; Deanna Jacquelyn,9998,0,9999,1
1653627895430,COGS 210A,002,087994,Saygin; Ayse P,9999,0,9999,0
1653627895430,COGS 210A,003,087995,Xia; Haijun,9999,0,9999,0
1653627895430,COGS 210A,004,087996,Nitz; Douglas A.,9999,0,9999,0
1653627895430,COGS 210A,005,087997,Hollan; James D.,9999,0,9999,0
1653627895430,COGS 210A,006,087998,Deak; Gedeon O.,9998,0,9999,1
1653627895430,COGS 210A,007,087999,Rossano; Federico,9999,0,9999,0
1653627895954,COGS 211A,A00,088000,Coulson; Seana M,9997,0,9999,2
1653627896479,COGS 229,A00,088002,Staff,22,0,25,3
1653627897006,COGS 260,B00,094231,Staff,17,0,20,3
1653627897006,COGS 260,A00,088004,Nitz; Douglas A.,9998,0,9999,1
1653627897529,CSE 202,A00,090110,Paturi; Ramamohan,0,0,0,0
1653627897529,CSE 202,B00,090111,Paturi; Ramamohan,0,0,0,0
1653627898053,CSE 207B,A00,090112,Heninger; Nadia A,0,0,0,0
1653627898575,CSE 208,A00,094858,Micciancio; Daniele,0,0,0,0
1653627899101,CSE 210,A00,090113,Powell; Thomas Allan,0,0,0,0
1653627899625,CSE 219,A00,090898,Staff,0,0,0,0
1653627900146,CSE 221,A00,090114,Zhou; Yuan-Yuan,0,0,0,0
1653627900669,CSE 229A,A00,090115,Porter; George M,0,0,0,0
1653627901192,CSE 229C,A00,090116,Savage; Stefan,0,0,0,0
1653627901717,CSE 230,A00,090117,Jhala; Ranjit,0,0,0,0
1653627902242,CSE 232,A00,090118,Papakonstantinou; Yannis,0,0,0,0
1653627902765,CSE 239A,A00,090121,Kumar; Arun Kumar,0,0,0,0
1653627903287,CSE 239B,A00,090122,Jhala; Ranjit,0,0,0,0
1653627903809,CSE 240A,A00,090123,Zhao; Jishen,0,0,189,189
1653627904333,CSE 243A,A00,090124,Orailoglu; Alex,0,0,15,15
1653627904857,CSE 249B,A00,090125,Kahng; Andrew Byun,12,0,20,8
1653627905382,CSE 250A,A00,090126,Berg-Kirkpatrick; Taylor D,0,0,0,0
1653627905905,CSE 252A,A00,090127,Ochoa; Benjamin Lawrence,0,0,0,0
1653627906431,CSE 258,A01,090129,McAuley; Julian John,0,0,0,0
1653627906957,CSE 258R,A01,090131,McAuley; Julian John,0,0,0,0
1653627907485,CSE 274,A00,090132,Ramamoorthi; Ravi,0,0,0,0
1653627908025,CSE 276A,A00,090133,Christensen; Henrik I,0,0,0,0
1653627908548,CSE 276C,A00,090134,Christensen; Henrik I,0,0,0,0
1653627909081,CSE 290,A00,090135,Bafna; Vineet,0,0,0,0
1653627909081,CSE 290,B00,090136,Ramamoorthi; Ravi,0,0,0,0
1653627909081,CSE 290,C00,090137,Li; Tzumao,7,0,10,3
1653627909081,CSE 290,D00,090138,Zhou; Yuan-Yuan,9,0,10,1
1653627909081,CSE 290,E00,090139,Christensen; Henrik I,8,0,10,2
1653627909081,CSE 290,F00,094053,Shalev; Aaron D,0,0,0,0
1653627909607,CSE 291,A00,090140,Munyaka; Imani N. S.,0,0,0,0
1653627909607,CSE 291,B00,094880,Yu; Qi,0,0,0,0
1653627909607,CSE 291,C00,090142,Pannuto; Patrick William,0,0,0,0
1653627909607,CSE 291,D00,094881,Zhang; Yiying,0,0,0,0
1653627909607,CSE 291,E00,095118,Su; Hao,0,0,0,0
1653627910142,CSE 293,001,094905,Bafna; Vineet,9999,0,9999,0
1653627910142,CSE 293,002,094906,Bellare; Mihir,9999,0,9999,0
1653627910142,CSE 293,003,094907,Berg-Kirkpatrick; Taylor D,9999,0,9999,0
1653627910142,CSE 293,004,094908,Christensen; Henrik I,9999,0,9999,0
1653627910142,CSE 293,005,094909,Cottrell; Garrison W,9999,0,9999,0
1653627910142,CSE 293,006,094910,Deutsch; Alin Bernard,9999,0,9999,0
1653627910142,CSE 293,007,094911,Esmaeilzadeh; Hadi,9999,0,9999,0
1653627910142,CSE 293,008,094912,Freund; Yoav,9999,0,9999,0
1653627910142,CSE 293,009,094913,Griswold; William G.,9999,0,9999,0
1653627910142,CSE 293,010,094914,Gymrek; Melissa Ann,9999,0,9999,0
1653627910142,CSE 293,011,094915,Heninger; Nadia A,9999,0,9999,0
1653627910142,CSE 293,012,094916,Impagliazzo; Russell,9999,0,9999,0
1653627910142,CSE 293,013,094917,Jhala; Ranjit,9999,0,9999,0
1653627910142,CSE 293,014,094918,Kahng; Andrew Byun,9999,0,9999,0
1653627910142,CSE 293,015,094919,Kane; Daniel Mertz,9999,0,9999,0
1653627910142,CSE 293,016,094920,Kriegman; David J,9999,0,9999,0
1653627910142,CSE 293,017,094921,Kumar; Arun Kumar,9999,0,9999,0
1653627910142,CSE 293,018,094922,Lerner; Sorin,9999,0,9999,0
1653627910142,CSE 293,019,094923,Lovett; Shachar,9999,0,9999,0
1653627910142,CSE 293,020,094924,McAuley; Julian John,9999,0,9999,0
1653627910142,CSE 293,021,094925,Micciancio; Daniele,9999,0,9999,0
1653627910142,CSE 293,022,094926,Orailoglu; Alex,9999,0,9999,0
1653627910142,CSE 293,023,094927,Paturi; Ramamohan,9999,0,9999,0
1653627910142,CSE 293,024,094928,Polikarpova; Nadezhda,9999,0,9999,0
1653627910142,CSE 293,025,094929,Politz; Joseph Gibbs,9999,0,9999,0
1653627910142,CSE 293,026,094930,Porter; George M,9999,0,9999,0
1653627910142,CSE 293,027,094931,Porter; Leonard Emerson,9999,0,9999,0
1653627910142,CSE 293,028,094932,Ramamoorthi; Ravi,9999,0,9999,0
1653627910142,CSE 293,029,094933,Sahoo; Debashis,9999,0,9999,0
1653627910142,CSE 293,030,094934,Saul; Lawrence,9999,0,9999,0
1653627910142,CSE 293,031,094935,Savage; Stefan,9999,0,9999,0
1653627910142,CSE 293,032,094936,Schulze; Jurgen P.,9999,0,9999,0
1653627910142,CSE 293,033,094937,Snoeren; Alex C.,9999,0,9999,0
1653627910142,CSE 293,034,094938,Shang; Jingbo,9999,0,9999,0
1653627910142,CSE 293,035,094939,Stefan; Deian,9999,0,9999,0
1653627910142,CSE 293,036,094940,Su; Hao,9999,0,9999,0
1653627910142,CSE 293,037,094941,Swanson; Steven James,9999,0,9999,0
1653627910142,CSE 293,038,094942,Tullsen; Dean Michael,9999,0,9999,0
1653627910142,CSE 293,039,094943,Voelker; Geoffrey M.,9999,0,9999,0
1653627910142,CSE 293,040,094944,Zhao; Jishen,9999,0,9999,0
1653627910142,CSE 293,041,094945,Zhou; Yuan-Yuan,9999,0,9999,0
1653627910142,CSE 293,042,094946,Gao; Sicun,9998,0,9999,1
1653627910142,CSE 293,043,094947,Weibel; Nadir,9999,0,9999,0
1653627910142,CSE 293,044,094948,Gupta; Rajesh K.,9999,0,9999,0
1653627910667,CSE 294,A00,090143,Porter; George M,9,0,10,1
1653627911190,DSE 200,A00,091799,Staff,50,0,50,0
1653627911716,DSE 203,A00,091800,Gupta; Amarnath,30,0,30,0
1653627912238,DSE 250,A00,091801,Deutsch; Alin Bernard,30,0,30,0
1653627912761,DSE 290,A00,091802,Altintas De Callaf; Ilkay,50,0,50,0
1653627913300,ECE 200,001,091003,Antipa; Nicholas A,9999,0,9999,0
1653627913300,ECE 200,002,091004,Atanasov; Nikolay A.,9999,0,9999,0
1653627913300,ECE 200,003,091005,Bharadia; Dinesh,9999,0,9999,0
1653627913300,ECE 200,004,091006,Cheng; Chung Kuan,9999,0,9999,0
1653627913300,ECE 200,005,091007,Cosman; Pamela C.,9999,0,9999,0
1653627913300,ECE 200,006,091008,Staff,9999,0,9999,0
1653627913300,ECE 200,007,091009,Dayeh; Shadi Ahmad,9999,0,9999,0
1653627913300,ECE 200,008,091010,Fainman; Yeshaiahu,9999,0,9999,0
1653627913300,ECE 200,009,091011,Ford; Joseph Earl,9999,0,9999,0
1653627913300,ECE 200,010,091012,Franceschetti; Massimo,9999,0,9999,0
1653627913300,ECE 200,011,091013,Fullerton; Eric E,9999,0,9999,0
1653627913300,ECE 200,012,091014,Galton; Ian A,9999,0,9999,0
1653627913300,ECE 200,013,091015,Gilja; Vikash,9999,0,9999,0
1653627913300,ECE 200,014,091016,Hall; Drew A.,9999,0,9999,0
1653627913300,ECE 200,015,091017,Hsueh; Tzu-Chien,9999,0,9999,0
1653627913300,ECE 200,016,091018,Javidi; Tara,9999,0,9999,0
1653627913300,ECE 200,017,091019,Kahng; Andrew Byun,9999,0,9999,0
1653627913300,ECE 200,018,091020,Kim; Young-Han,9999,0,9999,0
1653627913300,ECE 200,019,091021,Koushanfar; Farinaz,9999,0,9999,0
1653627913300,ECE 200,020,091022,Kuzum; Duygu,9999,0,9999,0
1653627913300,ECE 200,021,091023,Le; Hanh-Phuc,9999,0,9999,0
1653627913300,ECE 200,022,091024,Lin; Bill,9999,0,9999,0
1653627913300,ECE 200,023,091025,Liu; Zhaowei,9999,0,9999,0
1653627913300,ECE 200,024,091026,Lo; Yu-Hwa,9999,0,9999,0
1653627913300,ECE 200,025,091027,Lomakin; Vitaliy,9999,0,9999,0
1653627913300,ECE 200,026,091028,Mercier; Patrick Philip,9999,0,9999,0
1653627913300,ECE 200,027,091029,Meyer; Florian,9999,0,9999,0
1653627913300,ECE 200,028,091030,Milstein; Laurence B.,9999,0,9999,0
1653627913300,ECE 200,029,091031,Mir Arabbaygi; Siavash,9999,0,9999,0
1653627913300,ECE 200,030,091032,Mookherjea; Shayan,9999,0,9999,0
1653627913300,ECE 200,031,091033,Morris; Karcher William,9999,0,9999,0
1653627913300,ECE 200,032,091034,Ng; Tse Nga,9999,0,9999,0
1653627913300,ECE 200,033,091035,Nguyen; Truong Quang,9999,0,9999,0
1653627913300,ECE 200,034,091036,Nomura; Kenji,9999,0,9999,0
1653627913300,ECE 200,035,091037,Orlitsky; Alon,9999,0,9999,0
1653627913300,ECE 200,036,091038,Pal; Piya,9999,0,9999,0
1653627913300,ECE 200,037,091039,Papen; George C.,9999,0,9999,0
1653627913300,ECE 200,038,091040,Radic; Stojan,9999,0,9999,0
1653627913300,ECE 200,039,091041,Rao; Bhaskar D.,9999,0,9999,0
1653627913300,ECE 200,040,091042,Rao; Ramesh R,9999,0,9999,0
1653627913300,ECE 200,041,091043,Rebeiz; Gabriel,9999,0,9999,0
1653627913300,ECE 200,042,091044,Sanford; John R,9999,0,9999,0
1653627913300,ECE 200,043,091045,Siegel; Paul H.,9999,0,9999,0
1653627913300,ECE 200,044,091046,Sievenpiper; Daniel F.,9999,0,9999,0
1653627913300,ECE 200,045,091047,Sworder; David D.,9999,0,9999,0
1653627913300,ECE 200,046,091048,Taur; Yuan,9999,0,9999,0
1653627913300,ECE 200,047,091049,Touri; Behrouz,9999,0,9999,0
1653627913300,ECE 200,048,091050,Trivedi; Mohan M.,9999,0,9999,0
1653627913300,ECE 200,049,091051,Vardy; Alexander,9999,0,9999,0
1653627913300,ECE 200,050,091052,Vasconcelos; Nuno,9999,0,9999,0
1653627913300,ECE 200,051,091053,Wang; Xiaolong,9999,0,9999,0
1653627913300,ECE 200,052,091054,Xie; Pengtao,9999,0,9999,0
1653627913300,ECE 200,053,091055,Yip; Michael,9999,0,9999,0
1653627913300,ECE 200,054,091056,Zeger; Kenneth A.,9999,0,9999,0
1653627913300,ECE 200,055,091057,Zhang; Xinyu,9999,0,9999,0
1653627913300,ECE 200,056,091058,Turakhia; Yatish Girish,9999,0,9999,0
1653627913300,ECE 200,057,091059,Kang; Mingu,9999,0,9999,0
1653627913300,ECE 200,058,091060,Shi; Yuanyuan,9999,0,9999,0
1653627913300,ECE 200,059,091061,Wang; Edward Jay,9999,0,9999,0
1653627913300,ECE 200,060,091062,Zheng; Yang,9999,0,9999,0
1653627913823,ECE 201,A00,095526,Lo; Yu-Hwa,0,0,0,0
1653627914347,ECE 203,A00,091065,Mercier; Patrick Philip,0,0,0,0
1653627914870,ECE 207A,A00,091605,Liu; Thomas Tao-Ming,0,0,0,0
1653627915393,ECE 212AN,A00,091068,Nomura; Kenji,0,0,0,0
1653627915916,ECE 222A,A00,091069,Rebeiz; Gabriel,0,0,0,0
1653627916438,ECE 225A,A00,091070,Orlitsky; Alon,0,0,0,0
1653627916962,ECE 230A,A00,091071,Nomura; Kenji,0,0,0,0
1653627917494,ECE 236A,A00,091072,Dayeh; Shadi Ahmad,0,0,0,0
1653627918018,ECE 238A,A00,091073,Luo; Jian,0,0,0,0
1653627918018,ECE 238A,B00,091074,Luo; Jian,0,0,0,0
1653627918543,ECE 240A,A00,091075,Radic; Stojan,0,0,0,0
1653627919067,ECE 247A,A00,091592,Shi; Lingyan,0,0,0,0
1653627919590,ECE 250,A00,091076,Touri; Behrouz,0,0,0,0
1653627920112,ECE 251C,A00,091078,Nguyen; Truong Quang,0,0,0,0
1653627920645,ECE 253,A00,091079,Cosman; Pamela C.,0,0,0,0
1653627921166,ECE 255A,A00,091080,Orlitsky; Alon,0,0,0,0
1653627921693,ECE 257A,A00,091081,Zhang; Xinyu,0,0,0,0
1653627922216,ECE 260A,A01,091084,Eldon; John,0,0,0,0
1653627922739,ECE 264C,A00,091085,Galton; Ian A,0,0,0,0
1653627923265,ECE 265C,A00,094889,Presti; Calogero Davide,0,0,0,9
1653627923788,ECE 266,A01,091087,Hall; Drew A.,0,0,0,0
1653627924836,ECE 271A,A00,091090,Vasconcelos; Nuno,0,0,0,0
1653627925362,ECE 272B,A00,091091,Sworder; David D.,0,0,0,0
1653627925914,ECE 275A,A00,091092,Meyer; Florian,0,0,0,0
1653627926438,ECE 277,A00,091093,An; Cheolhong,0,0,0,0
1653627926964,ECE 283,A00,091094,Le; Hanh-Phuc,0,0,0,0
1653627927487,ECE 284,A00,091095,Kang; Mingu,0,0,0,0
1653627927487,ECE 284,B00,091096,Wang; Edward Jay,0,0,0,0
1653627928013,ECE 285,A00,094334,Touri; Behrouz,0,0,0,0
1653627928541,ECE 289,A00,091097,Whelan; David Arthur,0,0,0,0
1653627929063,MATH 200A,A00,087414,Salehi Golsefidy; Alireza,7,0,8,1
1653627929590,MATH 202A,A00,087415,Gill; Philip E.,2,0,8,6
1653627930114,MATH 203A,A00,087416,Oprea; Dragos N.,6,0,8,2
1653627930638,MATH 204A,A00,087417,Kedlaya; Kiran S.,6,0,8,2
1653627931162,MATH 205,A00,087418,Sorensen; Claus M,6,0,8,2
1653627931687,MATH 206A,A00,087419,Izadi; Elham,6,0,8,2
1653627932212,MATH 207A,A00,087420,Mohammadi; Amir,5,0,8,3
1653627932736,MATH 208,A00,087421,Staff,8,0,10,2
1653627933261,MATH 209,A00,087422,Staff,10,0,10,0
1653627933783,MATH 218,A00,087423,Staff,10,0,10,0
1653627934306,MATH 220A,A00,087424,Novak; Jonathan I,6,0,8,2
1653627934829,MATH 231A,A00,087425,Bejenaru; Ioan,3,0,8,5
1653627935351,MATH 240A,A00,087426,Ebenfelt; Peter F,5,0,8,3
1653627935876,MATH 243,A00,087427,Staff,9,0,10,1
1653627936402,MATH 248,A00,087429,Staff,10,0,10,0
1653627936927,MATH 250A,A00,087430,Spolaor; Luca,4,0,8,4
1653627937450,MATH 257A,A00,087431,Spolaor; Luca,7,0,8,1
1653627937973,MATH 258,A00,087432,Staff,9,0,10,1
1653627938499,MATH 264A,A00,087433,Warnke; Lutz Peter,5,0,8,3
1653627939022,MATH 268,A00,087434,Staff,15,0,15,0
1653627939545,MATH 269,A00,087435,Staff,14,0,15,1
1653627940072,MATH 270A,A00,087436,Nie; Jiawang,0,0,8,8
1653627940598,MATH 272A,A00,087437,Tian; Xiaochuan,0,0,8,8
1653627941130,MATH 274,A01,087439,Cheng; Li-Tien,9,0,10,1
1653627941130,MATH 274,A02,087440,Cheng; Li-Tien,10,0,10,0
1653627941660,MATH 278A,A00,087441,Staff,8,0,10,2
1653627942187,MATH 278B,A00,087442,Staff,8,0,10,2
1653627942713,MATH 278C,A00,087443,Staff,8,0,10,2
1653627943237,MATH 280A,A00,087444,Zheng; Tianyi,0,0,8,8
1653627943774,MATH 281A,A00,087445,Bradic; Jelena,0,0,8,9
1653627944296,MATH 282A,A00,087446,Zhang; Danna,0,0,8,8
1653627944821,MATH 283,A00,087447,Tesler; Glenn,0,0,0,16
1653627945452,MATH 286,B00,095535,Kemp; Todd Aahron,5,0,8,3
1653627945975,MATH 287D,B00,095536,Bradic; Jelena,5,0,8,3
1653627946501,MATH 288,A00,087450,Staff,14,0,15,1
1653627946501,MATH 288,B00,087451,Staff,15,0,15,0
1653627946501,MATH 288,C00,087452,Staff,15,0,15,0
1653627947024,MATH 290A,A00,087453,Xu; Zhouli,6,0,8,2
1653627947548,MATH 291A,A00,087454,Xu; Zhouli,7,0,8,1
1653627948073,MATH 292,A00,087455,Staff,10,0,10,0
1653627948598,MATH 295,A00,087456,Staff,50,0,50,0
1653627949122,MATH 297,001,087457,Staff,997,0,999,2
1653628508293,COGS 200,A01,087991,Staff,47,0,50,3
1653628508823,COGS 201,A01,094504,Rangel; Lara M,16,0,25,9
1653628509348,COGS 203,A00,087992,Coulson; Seana M,18,0,20,2
1653628509872,COGS 210A,001,087993,Greene; Deanna Jacquelyn,9998,0,9999,1
1653628509872,COGS 210A,002,087994,Saygin; Ayse P,9999,0,9999,0
1653628509872,COGS 210A,003,087995,Xia; Haijun,9999,0,9999,0
1653628509872,COGS 210A,004,087996,Nitz; Douglas A.,9999,0,9999,0
1653628509872,COGS 210A,005,087997,Hollan; James D.,9999,0,9999,0
1653628509872,COGS 210A,006,087998,Deak; Gedeon O.,9998,0,9999,1
1653628509872,COGS 210A,007,087999,Rossano; Federico,9999,0,9999,0
1653628510408,COGS 211A,A00,088000,Coulson; Seana M,9997,0,9999,2
1653628510933,COGS 229,A00,088002,Staff,22,0,25,3
1653628511456,COGS 260,B00,094231,Staff,17,0,20,3
1653628511456,COGS 260,A00,088004,Nitz; Douglas A.,9998,0,9999,1
1653628511978,CSE 202,A00,090110,Paturi; Ramamohan,0,0,0,0
1653628511978,CSE 202,B00,090111,Paturi; Ramamohan,0,0,0,0
1653628512502,CSE 207B,A00,090112,Heninger; Nadia A,0,0,0,0
1653628513025,CSE 208,A00,094858,Micciancio; Daniele,0,0,0,0
1653628513549,CSE 210,A00,090113,Powell; Thomas Allan,0,0,0,0
1653628514077,CSE 219,A00,090898,Staff,0,0,0,0
1653628514601,CSE 221,A00,090114,Zhou; Yuan-Yuan,0,0,0,0
1653628515124,CSE 229A,A00,090115,Porter; George M,0,0,0,0
1653628515647,CSE 229C,A00,090116,Savage; Stefan,0,0,0,0
1653628516169,CSE 230,A00,090117,Jhala; Ranjit,0,0,0,0
1653628516695,CSE 232,A00,090118,Papakonstantinou; Yannis,0,0,0,0
1653628517220,CSE 239A,A00,090121,Kumar; Arun Kumar,0,0,0,0
1653628517742,CSE 239B,A00,090122,Jhala; Ranjit,0,0,0,0
1653628518264,CSE 240A,A00,090123,Zhao; Jishen,0,0,189,189
1653628518788,CSE 243A,A00,090124,Orailoglu; Alex,0,0,15,15
1653628519318,CSE 249B,A00,090125,Kahng; Andrew Byun,12,0,20,8
1653628519844,CSE 250A,A00,090126,Berg-Kirkpatrick; Taylor D,0,0,0,0
1653628520366,CSE 252A,A00,090127,Ochoa; Benjamin Lawrence,0,0,0,0
1653628520913,CSE 258,A01,090129,McAuley; Julian John,0,0,0,0
1653628521436,CSE 258R,A01,090131,McAuley; Julian John,0,0,0,0
1653628521960,CSE 274,A00,090132,Ramamoorthi; Ravi,0,0,0,0
1653628522484,CSE 276A,A00,090133,Christensen; Henrik I,0,0,0,0
1653628523008,CSE 276C,A00,090134,Christensen; Henrik I,0,0,0,0
1653628523542,CSE 290,A00,090135,Bafna; Vineet,0,0,0,0
1653628523542,CSE 290,B00,090136,Ramamoorthi; Ravi,0,0,0,0
1653628523542,CSE 290,C00,090137,Li; Tzumao,7,0,10,3
1653628523542,CSE 290,D00,090138,Zhou; Yuan-Yuan,9,0,10,1
1653628523542,CSE 290,E00,090139,Christensen; Henrik I,8,0,10,2
1653628523542,CSE 290,F00,094053,Shalev; Aaron D,0,0,0,0
1653628524069,CSE 291,A00,090140,Munyaka; Imani N. S.,0,0,0,0
1653628524069,CSE 291,B00,094880,Yu; Qi,0,0,0,0
1653628524069,CSE 291,C00,090142,Pannuto; Patrick William,0,0,0,0
1653628524069,CSE 291,D00,094881,Zhang; Yiying,0,0,0,0
1653628524069,CSE 291,E00,095118,Su; Hao,0,0,0,0
1653628524596,CSE 293,001,094905,Bafna; Vineet,9999,0,9999,0
1653628524596,CSE 293,002,094906,Bellare; Mihir,9999,0,9999,0
1653628524596,CSE 293,003,094907,Berg-Kirkpatrick; Taylor D,9999,0,9999,0
1653628524596,CSE 293,004,094908,Christensen; Henrik I,9999,0,9999,0
1653628524596,CSE 293,005,094909,Cottrell; Garrison W,9999,0,9999,0
1653628524596,CSE 293,006,094910,Deutsch; Alin Bernard,9999,0,9999,0
1653628524596,CSE 293,007,094911,Esmaeilzadeh; Hadi,9999,0,9999,0
1653628524596,CSE 293,008,094912,Freund; Yoav,9999,0,9999,0
1653628524596,CSE 293,009,094913,Griswold; William G.,9999,0,9999,0
1653628524596,CSE 293,010,094914,Gymrek; Melissa Ann,9999,0,9999,0
1653628524596,CSE 293,011,094915,Heninger; Nadia A,9999,0,9999,0
1653628524596,CSE 293,012,094916,Impagliazzo; Russell,9999,0,9999,0
1653628524596,CSE 293,013,094917,Jhala; Ranjit,9999,0,9999,0
1653628524596,CSE 293,014,094918,Kahng; Andrew Byun,9999,0,9999,0
1653628524596,CSE 293,015,094919,Kane; Daniel Mertz,9999,0,9999,0
1653628524596,CSE 293,016,094920,Kriegman; David J,9999,0,9999,0
1653628524596,CSE 293,017,094921,Kumar; Arun Kumar,9999,0,9999,0
1653628524596,CSE 293,018,094922,Lerner; Sorin,9999,0,9999,0
1653628524596,CSE 293,019,094923,Lovett; Shachar,9999,0,9999,0
1653628524596,CSE 293,020,094924,McAuley; Julian John,9999,0,9999,0
1653628524596,CSE 293,021,094925,Micciancio; Daniele,9999,0,9999,0
1653628524596,CSE 293,022,094926,Orailoglu; Alex,9999,0,9999,0
1653628524596,CSE 293,023,094927,Paturi; Ramamohan,9999,0,9999,0
1653628524596,CSE 293,024,094928,Polikarpova; Nadezhda,9999,0,9999,0
1653628524596,CSE 293,025,094929,Politz; Joseph Gibbs,9999,0,9999,0
1653628524596,CSE 293,026,094930,Porter; George M,9999,0,9999,0
1653628524596,CSE 293,027,094931,Porter; Leonard Emerson,9999,0,9999,0
1653628524596,CSE 293,028,094932,Ramamoorthi; Ravi,9999,0,9999,0
1653628524596,CSE 293,029,094933,Sahoo; Debashis,9999,0,9999,0
1653628524596,CSE 293,030,094934,Saul; Lawrence,9999,0,9999,0
1653628524596,CSE 293,031,094935,Savage; Stefan,9999,0,9999,0
1653628524596,CSE 293,032,094936,Schulze; Jurgen P.,9999,0,9999,0
1653628524596,CSE 293,033,094937,Snoeren; Alex C.,9999,0,9999,0
1653628524596,CSE 293,034,094938,Shang; Jingbo,9999,0,9999,0
1653628524596,CSE 293,035,094939,Stefan; Deian,9999,0,9999,0
1653628524596,CSE 293,036,094940,Su; Hao,9999,0,9999,0
1653628524596,CSE 293,037,094941,Swanson; Steven James,9999,0,9999,0
1653628524596,CSE 293,038,094942,Tullsen; Dean Michael,9999,0,9999,0
1653628524596,CSE 293,039,094943,Voelker; Geoffrey M.,9999,0,9999,0
1653628524596,CSE 293,040,094944,Zhao; Jishen,9999,0,9999,0
1653628524596,CSE 293,041,094945,Zhou; Yuan-Yuan,9999,0,9999,0
1653628524596,CSE 293,042,094946,Gao; Sicun,9998,0,9999,1
1653628524596,CSE 293,043,094947,Weibel; Nadir,9999,0,9999,0
1653628524596,CSE 293,044,094948,Gupta; Rajesh K.,9999,0,9999,0
1653628525118,CSE 294,A00,090143,Porter; George M,9,0,10,1
1653628525644,DSE 200,A00,091799,Staff,50,0,50,0
1653628526175,DSE 203,A00,091800,Gupta; Amarnath,30,0,30,0
1653628526697,DSE 250,A00,091801,Deutsch; Alin Bernard,30,0,30,0
1653628527228,DSE 290,A00,091802,Altintas De Callaf; Ilkay,50,0,50,0
1653628527780,ECE 200,001,091003,Antipa; Nicholas A,9999,0,9999,0
1653628527780,ECE 200,002,091004,Atanasov; Nikolay A.,9999,0,9999,0
1653628527780,ECE 200,003,091005,Bharadia; Dinesh,9999,0,9999,0
1653628527780,ECE 200,004,091006,Cheng; Chung Kuan,9999,0,9999,0
1653628527780,ECE 200,005,091007,Cosman; Pamela C.,9999,0,9999,0
1653628527780,ECE 200,006,091008,Staff,9999,0,9999,0
1653628527780,ECE 200,007,091009,Dayeh; Shadi Ahmad,9999,0,9999,0
1653628527780,ECE 200,008,091010,Fainman; Yeshaiahu,9999,0,9999,0
1653628527780,ECE 200,009,091011,Ford; Joseph Earl,9999,0,9999,0
1653628527780,ECE 200,010,091012,Franceschetti; Massimo,9999,0,9999,0
1653628527780,ECE 200,011,091013,Fullerton; Eric E,9999,0,9999,0
1653628527780,ECE 200,012,091014,Galton; Ian A,9999,0,9999,0
1653628527780,ECE 200,013,091015,Gilja; Vikash,9999,0,9999,0
1653628527780,ECE 200,014,091016,Hall; Drew A.,9999,0,9999,0
1653628527780,ECE 200,015,091017,Hsueh; Tzu-Chien,9999,0,9999,0
1653628527780,ECE 200,016,091018,Javidi; Tara,9999,0,9999,0
1653628527780,ECE 200,017,091019,Kahng; Andrew Byun,9999,0,9999,0
1653628527780,ECE 200,018,091020,Kim; Young-Han,9999,0,9999,0
1653628527780,ECE 200,019,091021,Koushanfar; Farinaz,9999,0,9999,0
1653628527780,ECE 200,020,091022,Kuzum; Duygu,9999,0,9999,0
1653628527780,ECE 200,021,091023,Le; Hanh-Phuc,9999,0,9999,0
1653628527780,ECE 200,022,091024,Lin; Bill,9999,0,9999,0
1653628527780,ECE 200,023,091025,Liu; Zhaowei,9999,0,9999,0
1653628527780,ECE 200,024,091026,Lo; Yu-Hwa,9999,0,9999,0
1653628527780,ECE 200,025,091027,Lomakin; Vitaliy,9999,0,9999,0
1653628527780,ECE 200,026,091028,Mercier; Patrick Philip,9999,0,9999,0
1653628527780,ECE 200,027,091029,Meyer; Florian,9999,0,9999,0
1653628527780,ECE 200,028,091030,Milstein; Laurence B.,9999,0,9999,0
1653628527780,ECE 200,029,091031,Mir Arabbaygi; Siavash,9999,0,9999,0
1653628527780,ECE 200,030,091032,Mookherjea; Shayan,9999,0,9999,0
1653628527780,ECE 200,031,091033,Morris; Karcher William,9999,0,9999,0
1653628527780,ECE 200,032,091034,Ng; Tse Nga,9999,0,9999,0
1653628527780,ECE 200,033,091035,Nguyen; Truong Quang,9999,0,9999,0
1653628527780,ECE 200,034,091036,Nomura; Kenji,9999,0,9999,0
1653628527780,ECE 200,035,091037,Orlitsky; Alon,9999,0,9999,0
1653628527780,ECE 200,036,091038,Pal; Piya,9999,0,9999,0
1653628527780,ECE 200,037,091039,Papen; George C.,9999,0,9999,0
1653628527780,ECE 200,038,091040,Radic; Stojan,9999,0,9999,0
1653628527780,ECE 200,039,091041,Rao; Bhaskar D.,9999,0,9999,0
1653628527780,ECE 200,040,091042,Rao; Ramesh R,9999,0,9999,0
1653628527780,ECE 200,041,091043,Rebeiz; Gabriel,9999,0,9999,0
1653628527780,ECE 200,042,091044,Sanford; John R,9999,0,9999,0
1653628527780,ECE 200,043,091045,Siegel; Paul H.,9999,0,9999,0
1653628527780,ECE 200,044,091046,Sievenpiper; Daniel F.,9999,0,9999,0
1653628527780,ECE 200,045,091047,Sworder; David D.,9999,0,9999,0
1653628527780,ECE 200,046,091048,Taur; Yuan,9999,0,9999,0
1653628527780,ECE 200,047,091049,Touri; Behrouz,9999,0,9999,0
1653628527780,ECE 200,048,091050,Trivedi; Mohan M.,9999,0,9999,0
1653628527780,ECE 200,049,091051,Vardy; Alexander,9999,0,9999,0
1653628527780,ECE 200,050,091052,Vasconcelos; Nuno,9999,0,9999,0
1653628527780,ECE 200,051,091053,Wang; Xiaolong,9999,0,9999,0
1653628527780,ECE 200,052,091054,Xie; Pengtao,9999,0,9999,0
1653628527780,ECE 200,053,091055,Yip; Michael,9999,0,9999,0
1653628527780,ECE 200,054,091056,Zeger; Kenneth A.,9999,0,9999,0
1653628527780,ECE 200,055,091057,Zhang; Xinyu,9999,0,9999,0
1653628527780,ECE 200,056,091058,Turakhia; Yatish Girish,9999,0,9999,0
1653628527780,ECE 200,057,091059,Kang; Mingu,9999,0,9999,0
1653628527780,ECE 200,058,091060,Shi; Yuanyuan,9999,0,9999,0
1653628527780,ECE 200,059,091061,Wang; Edward Jay,9999,0,9999,0
1653628527780,ECE 200,060,091062,Zheng; Yang,9999,0,9999,0
1653628528302,ECE 201,A00,095526,Lo; Yu-Hwa,0,0,0,0
1653628528825,ECE 203,A00,091065,Mercier; Patrick Philip,0,0,0,0
1653628529355,ECE 207A,A00,091605,Liu; Thomas Tao-Ming,0,0,0,0
1653628529878,ECE 212AN,A00,091068,Nomura; Kenji,0,0,0,0
1653628530403,ECE 222A,A00,091069,Rebeiz; Gabriel,0,0,0,0
1653628530926,ECE 225A,A00,091070,Orlitsky; Alon,0,0,0,0
1653628531449,ECE 230A,A00,091071,Nomura; Kenji,0,0,0,0
1653628532049,ECE 236A,A00,091072,Dayeh; Shadi Ahmad,0,0,0,0
1653628532573,ECE 238A,A00,091073,Luo; Jian,0,0,0,0
1653628532573,ECE 238A,B00,091074,Luo; Jian,0,0,0,0
1653628533096,ECE 240A,A00,091075,Radic; Stojan,0,0,0,0
1653628533623,ECE 247A,A00,091592,Shi; Lingyan,0,0,0,0
1653628534147,ECE 250,A00,091076,Touri; Behrouz,0,0,0,0
1653628534669,ECE 251C,A00,091078,Nguyen; Truong Quang,0,0,0,0
1653628535193,ECE 253,A00,091079,Cosman; Pamela C.,0,0,0,0
1653628535720,ECE 255A,A00,091080,Orlitsky; Alon,0,0,0,0
1653628536243,ECE 257A,A00,091081,Zhang; Xinyu,0,0,0,0
1653628536770,ECE 260A,A01,091084,Eldon; John,0,0,0,0
1653628537309,ECE 264C,A00,091085,Galton; Ian A,0,0,0,0
1653628537833,ECE 265C,A00,094889,Presti; Calogero Davide,0,0,0,9
1653628538377,ECE 266,A01,091087,Hall; Drew A.,0,0,0,0
1653628539445,ECE 271A,A00,091090,Vasconcelos; Nuno,0,0,0,0
1653628539968,ECE 272B,A00,091091,Sworder; David D.,0,0,0,0
1653628540492,ECE 275A,A00,091092,Meyer; Florian,0,0,0,0
1653628541014,ECE 277,A00,091093,An; Cheolhong,0,0,0,0
1653628541541,ECE 283,A00,091094,Le; Hanh-Phuc,0,0,0,0
1653628542065,ECE 284,A00,091095,Kang; Mingu,0,0,0,0
1653628542065,ECE 284,B00,091096,Wang; Edward Jay,0,0,0,0
1653628542588,ECE 285,A00,094334,Touri; Behrouz,0,0,0,0
1653628543113,ECE 289,A00,091097,Whelan; David Arthur,0,0,0,0
1653628543647,MATH 200A,A00,087414,Salehi Golsefidy; Alireza,7,0,8,1
1653628544174,MATH 202A,A00,087415,Gill; Philip E.,2,0,8,6
1653628544696,MATH 203A,A00,087416,Oprea; Dragos N.,6,0,8,2
1653628545227,MATH 204A,A00,087417,Kedlaya; Kiran S.,6,0,8,2
1653628545764,MATH 205,A00,087418,Sorensen; Claus M,6,0,8,2
1653628546291,MATH 206A,A00,087419,Izadi; Elham,6,0,8,2
1653628546814,MATH 207A,A00,087420,Mohammadi; Amir,5,0,8,3
1653628547342,MATH 208,A00,087421,Staff,8,0,10,2
1653628547864,MATH 209,A00,087422,Staff,10,0,10,0
1653628548390,MATH 218,A00,087423,Staff,10,0,10,0
1653628548922,MATH 220A,A00,087424,Novak; Jonathan I,6,0,8,2
1653628549449,MATH 231A,A00,087425,Bejenaru; Ioan,3,0,8,5
1653628549976,MATH 240A,A00,087426,Ebenfelt; Peter F,5,0,8,3
1653628550505,MATH 243,A00,087427,Staff,9,0,10,1
1653628551027,MATH 248,A00,087429,Staff,10,0,10,0
1653628551550,MATH 250A,A00,087430,Spolaor; Luca,4,0,8,4
1653628552077,MATH 257A,A00,087431,Spolaor; Luca,7,0,8,1
1653628552601,MATH 258,A00,087432,Staff,9,0,10,1
1653628553125,MATH 264A,A00,087433,Warnke; Lutz Peter,5,0,8,3
1653628553648,MATH 268,A00,087434,Staff,15,0,15,0
1653628554173,MATH 269,A00,087435,Staff,14,0,15,1
1653628554697,MATH 270A,A00,087436,Nie; Jiawang,0,0,8,8
1653628555221,MATH 272A,A00,087437,Tian; Xiaochuan,0,0,8,8
1653628555750,MATH 274,A01,087439,Cheng; Li-Tien,9,0,10,1
1653628555750,MATH 274,A02,087440,Cheng; Li-Tien,10,0,10,0
1653628556273,MATH 278A,A00,087441,Staff,8,0,10,2
1653628556796,MATH 278B,A00,087442,Staff,8,0,10,2
1653628557318,MATH 278C,A00,087443,Staff,8,0,10,2
1653628557840,MATH 280A,A00,087444,Zheng; Tianyi,0,0,8,8
1653628558361,MATH 281A,A00,087445,Bradic; Jelena,0,0,8,9
1653628558889,MATH 282A,A00,087446,Zhang; Danna,0,0,8,8
1653628559412,MATH 283,A00,087447,Tesler; Glenn,0,0,0,16
1653628559938,MATH 286,B00,095535,Kemp; Todd Aahron,5,0,8,3
1653628560465,MATH 287D,B00,095536,Bradic; Jelena,5,0,8,3
1653628560988,MATH 288,A00,087450,Staff,14,0,15,1
1653628560988,MATH 288,B00,087451,Staff,15,0,15,0
1653628560988,MATH 288,C00,087452,Staff,15,0,15,0
1653628561512,MATH 290A,A00,087453,Xu; Zhouli,6,0,8,2
1653628562035,MATH 291A,A00,087454,Xu; Zhouli,7,0,8,1
1653628562561,MATH 292,A00,087455,Staff,10,0,10,0
1653628563088,MATH 295,A00,087456,Staff,50,0,50,0
1653628563614,MATH 297,001,087457,Staff,997,0,999,2
1653629123560,COGS 200,A01,087991,Staff,47,0,50,3
1653629124090,COGS 201,A01,094504,Rangel; Lara M,16,0,25,9
1653629124613,COGS 203,A00,087992,Coulson; Seana M,18,0,20,2
1653629125137,COGS 210A,001,087993,Greene; Deanna Jacquelyn,9998,0,9999,1
1653629125137,COGS 210A,002,087994,Saygin; Ayse P,9999,0,9999,0
1653629125137,COGS 210A,003,087995,Xia; Haijun,9999,0,9999,0
1653629125137,COGS 210A,004,087996,Nitz; Douglas A.,9999,0,9999,0
1653629125137,COGS 210A,005,087997,Hollan; James D.,9999,0,9999,0
1653629125137,COGS 210A,006,087998,Deak; Gedeon O.,9998,0,9999,1
1653629125137,COGS 210A,007,087999,Rossano; Federico,9999,0,9999,0
1653629125660,COGS 211A,A00,088000,Coulson; Seana M,9997,0,9999,2
1653629126187,COGS 229,A00,088002,Staff,22,0,25,3
1653629126716,COGS 260,B00,094231,Staff,17,0,20,3
1653629126716,COGS 260,A00,088004,Nitz; Douglas A.,9998,0,9999,1
1653629127242,CSE 202,A00,090110,Paturi; Ramamohan,0,0,0,0
1653629127242,CSE 202,B00,090111,Paturi; Ramamohan,0,0,0,0
1653629127765,CSE 207B,A00,090112,Heninger; Nadia A,0,0,0,0
1653629128296,CSE 208,A00,094858,Micciancio; Daniele,0,0,0,0
1653629128822,CSE 210,A00,090113,Powell; Thomas Allan,0,0,0,0
1653629129345,CSE 219,A00,090898,Staff,0,0,0,0
1653629129867,CSE 221,A00,090114,Zhou; Yuan-Yuan,0,0,0,0
1653629130397,CSE 229A,A00,090115,Porter; George M,0,0,0,0
1653629130920,CSE 229C,A00,090116,Savage; Stefan,0,0,0,0
1653629131452,CSE 230,A00,090117,Jhala; Ranjit,0,0,0,0
1653629131978,CSE 232,A00,090118,Papakonstantinou; Yannis,0,0,0,0
1653629132504,CSE 239A,A00,090121,Kumar; Arun Kumar,0,0,0,0
1653629133031,CSE 239B,A00,090122,Jhala; Ranjit,0,0,0,0
1653629133554,CSE 240A,A00,090123,Zhao; Jishen,0,0,189,189
1653629134080,CSE 243A,A00,090124,Orailoglu; Alex,0,0,15,15
1653629134605,CSE 249B,A00,090125,Kahng; Andrew Byun,12,0,20,8
1653629135129,CSE 250A,A00,090126,Berg-Kirkpatrick; Taylor D,0,0,0,0
1653629135658,CSE 252A,A00,090127,Ochoa; Benjamin Lawrence,0,0,0,0
1653629136183,CSE 258,A01,090129,McAuley; Julian John,0,0,0,0
1653629136708,CSE 258R,A01,090131,McAuley; Julian John,0,0,0,0
1653629137235,CSE 274,A00,090132,Ramamoorthi; Ravi,0,0,0,0
1653629137759,CSE 276A,A00,090133,Christensen; Henrik I,0,0,0,0
1653629138288,CSE 276C,A00,090134,Christensen; Henrik I,0,0,0,0
1653629138825,CSE 290,A00,090135,Bafna; Vineet,0,0,0,0
1653629138825,CSE 290,B00,090136,Ramamoorthi; Ravi,0,0,0,0
1653629138825,CSE 290,C00,090137,Li; Tzumao,7,0,10,3
1653629138825,CSE 290,D00,090138,Zhou; Yuan-Yuan,9,0,10,1
1653629138825,CSE 290,E00,090139,Christensen; Henrik I,8,0,10,2
1653629138825,CSE 290,F00,094053,Shalev; Aaron D,0,0,0,0
1653629139358,CSE 291,A00,090140,Munyaka; Imani N. S.,0,0,0,0
1653629139358,CSE 291,B00,094880,Yu; Qi,0,0,0,0
1653629139358,CSE 291,C00,090142,Pannuto; Patrick William,0,0,0,0
1653629139358,CSE 291,D00,094881,Zhang; Yiying,0,0,0,0
1653629139358,CSE 291,E00,095118,Su; Hao,0,0,0,0
1653629139884,CSE 293,001,094905,Bafna; Vineet,9999,0,9999,0
1653629139884,CSE 293,002,094906,Bellare; Mihir,9999,0,9999,0
1653629139884,CSE 293,003,094907,Berg-Kirkpatrick; Taylor D,9999,0,9999,0
1653629139884,CSE 293,004,094908,Christensen; Henrik I,9999,0,9999,0
1653629139884,CSE 293,005,094909,Cottrell; Garrison W,9999,0,9999,0
1653629139884,CSE 293,006,094910,Deutsch; Alin Bernard,9999,0,9999,0
1653629139884,CSE 293,007,094911,Esmaeilzadeh; Hadi,9999,0,9999,0
1653629139884,CSE 293,008,094912,Freund; Yoav,9999,0,9999,0
1653629139884,CSE 293,009,094913,Griswold; William G.,9999,0,9999,0
1653629139884,CSE 293,010,094914,Gymrek; Melissa Ann,9999,0,9999,0
1653629139884,CSE 293,011,094915,Heninger; Nadia A,9999,0,9999,0
1653629139884,CSE 293,012,094916,Impagliazzo; Russell,9999,0,9999,0
1653629139884,CSE 293,013,094917,Jhala; Ranjit,9999,0,9999,0
1653629139884,CSE 293,014,094918,Kahng; Andrew Byun,9999,0,9999,0
1653629139884,CSE 293,015,094919,Kane; Daniel Mertz,9999,0,9999,0
1653629139884,CSE 293,016,094920,Kriegman; David J,9999,0,9999,0
1653629139884,CSE 293,017,094921,Kumar; Arun Kumar,9999,0,9999,0
1653629139884,CSE 293,018,094922,Lerner; Sorin,9999,0,9999,0
1653629139884,CSE 293,019,094923,Lovett; Shachar,9999,0,9999,0
1653629139884,CSE 293,020,094924,McAuley; Julian John,9999,0,9999,0
1653629139884,CSE 293,021,094925,Micciancio; Daniele,9999,0,9999,0
1653629139884,CSE 293,022,094926,Orailoglu; Alex,9999,0,9999,0
1653629139884,CSE 293,023,094927,Paturi; Ramamohan,9999,0,9999,0
1653629139884,CSE 293,024,094928,Polikarpova; Nadezhda,9999,0,9999,0
1653629139884,CSE 293,025,094929,Politz; Joseph Gibbs,9999,0,9999,0
1653629139884,CSE 293,026,094930,Porter; George M,9999,0,9999,0
1653629139884,CSE 293,027,094931,Porter; Leonard Emerson,9999,0,9999,0
1653629139884,CSE 293,028,094932,Ramamoorthi; Ravi,9999,0,9999,0
1653629139884,CSE 293,029,094933,Sahoo; Debashis,9999,0,9999,0
1653629139884,CSE 293,030,094934,Saul; Lawrence,9999,0,9999,0
1653629139884,CSE 293,031,094935,Savage; Stefan,9999,0,9999,0
1653629139884,CSE 293,032,094936,Schulze; Jurgen P.,9999,0,9999,0
1653629139884,CSE 293,033,094937,Snoeren; Alex C.,9999,0,9999,0
1653629139884,CSE 293,034,094938,Shang; Jingbo,9999,0,9999,0
1653629139884,CSE 293,035,094939,Stefan; Deian,9999,0,9999,0
1653629139884,CSE 293,036,094940,Su; Hao,9999,0,9999,0
1653629139884,CSE 293,037,094941,Swanson; Steven James,9999,0,9999,0
1653629139884,CSE 293,038,094942,Tullsen; Dean Michael,9999,0,9999,0
1653629139884,CSE 293,039,094943,Voelker; Geoffrey M.,9999,0,9999,0
1653629139884,CSE 293,040,094944,Zhao; Jishen,9999,0,9999,0
1653629139884,CSE 293,041,094945,Zhou; Yuan-Yuan,9999,0,9999,0
1653629139884,CSE 293,042,094946,Gao; Sicun,9998,0,9999,1
1653629139884,CSE 293,043,094947,Weibel; Nadir,9999,0,9999,0
1653629139884,CSE 293,044,094948,Gupta; Rajesh K.,9999,0,9999,0
1653629140408,CSE 294,A00,090143,Porter; George M,9,0,10,1
1653629140933,DSE 200,A00,091799,Staff,50,0,50,0
1653629141458,DSE 203,A00,091800,Gupta; Amarnath,30,0,30,0
1653629141983,DSE 250,A00,091801,Deutsch; Alin Bernard,30,0,30,0
1653629142510,DSE 290,A00,091802,Altintas De Callaf; Ilkay,50,0,50,0
1653629143044,ECE 200,001,091003,Antipa; Nicholas A,9999,0,9999,0
1653629143044,ECE 200,002,091004,Atanasov; Nikolay A.,9999,0,9999,0
1653629143044,ECE 200,003,091005,Bharadia; Dinesh,9999,0,9999,0
1653629143044,ECE 200,004,091006,Cheng; Chung Kuan,9999,0,9999,0
1653629143044,ECE 200,005,091007,Cosman; Pamela C.,9999,0,9999,0
1653629143044,ECE 200,006,091008,Staff,9999,0,9999,0
1653629143044,ECE 200,007,091009,Dayeh; Shadi Ahmad,9999,0,9999,0
1653629143044,ECE 200,008,091010,Fainman; Yeshaiahu,9999,0,9999,0
1653629143044,ECE 200,009,091011,Ford; Joseph Earl,9999,0,9999,0
1653629143044,ECE 200,010,091012,Franceschetti; Massimo,9999,0,9999,0
1653629143044,ECE 200,011,091013,Fullerton; Eric E,9999,0,9999,0
1653629143044,ECE 200,012,091014,Galton; Ian A,9999,0,9999,0
1653629143044,ECE 200,013,091015,Gilja; Vikash,9999,0,9999,0
1653629143044,ECE 200,014,091016,Hall; Drew A.,9999,0,9999,0
1653629143044,ECE 200,015,091017,Hsueh; Tzu-Chien,9999,0,9999,0
1653629143044,ECE 200,016,091018,Javidi; Tara,9999,0,9999,0
1653629143044,ECE 200,017,091019,Kahng; Andrew Byun,9999,0,9999,0
1653629143044,ECE 200,018,091020,Kim; Young-Han,9999,0,9999,0
1653629143044,ECE 200,019,091021,Koushanfar; Farinaz,9999,0,9999,0
1653629143044,ECE 200,020,091022,Kuzum; Duygu,9999,0,9999,0
1653629143044,ECE 200,021,091023,Le; Hanh-Phuc,9999,0,9999,0
1653629143044,ECE 200,022,091024,Lin; Bill,9999,0,9999,0
1653629143044,ECE 200,023,091025,Liu; Zhaowei,9999,0,9999,0
1653629143044,ECE 200,024,091026,Lo; Yu-Hwa,9999,0,9999,0
1653629143044,ECE 200,025,091027,Lomakin; Vitaliy,9999,0,9999,0
1653629143044,ECE 200,026,091028,Mercier; Patrick Philip,9999,0,9999,0
1653629143044,ECE 200,027,091029,Meyer; Florian,9999,0,9999,0
1653629143044,ECE 200,028,091030,Milstein; Laurence B.,9999,0,9999,0
1653629143044,ECE 200,029,091031,Mir Arabbaygi; Siavash,9999,0,9999,0
1653629143044,ECE 200,030,091032,Mookherjea; Shayan,9999,0,9999,0
1653629143044,ECE 200,031,091033,Morris; Karcher William,9999,0,9999,0
1653629143044,ECE 200,032,091034,Ng; Tse Nga,9999,0,9999,0
1653629143044,ECE 200,033,091035,Nguyen; Truong Quang,9999,0,9999,0
1653629143044,ECE 200,034,091036,Nomura; Kenji,9999,0,9999,0
1653629143044,ECE 200,035,091037,Orlitsky; Alon,9999,0,9999,0
1653629143044,ECE 200,036,091038,Pal; Piya,9999,0,9999,0
1653629143044,ECE 200,037,091039,Papen; George C.,9999,0,9999,0
1653629143044,ECE 200,038,091040,Radic; Stojan,9999,0,9999,0
1653629143044,ECE 200,039,091041,Rao; Bhaskar D.,9999,0,9999,0
1653629143044,ECE 200,040,091042,Rao; Ramesh R,9999,0,9999,0
1653629143044,ECE 200,041,091043,Rebeiz; Gabriel,9999,0,9999,0
1653629143044,ECE 200,042,091044,Sanford; John R,9999,0,9999,0
1653629143044,ECE 200,043,091045,Siegel; Paul H.,9999,0,9999,0
1653629143044,ECE 200,044,091046,Sievenpiper; Daniel F.,9999,0,9999,0
1653629143044,ECE 200,045,091047,Sworder; David D.,9999,0,9999,0
1653629143044,ECE 200,046,091048,Taur; Yuan,9999,0,9999,0
1653629143044,ECE 200,047,091049,Touri; Behrouz,9999,0,9999,0
1653629143044,ECE 200,048,091050,Trivedi; Mohan M.,9999,0,9999,0
1653629143044,ECE 200,049,091051,Vardy; Alexander,9999,0,9999,0
1653629143044,ECE 200,050,091052,Vasconcelos; Nuno,9999,0,9999,0
1653629143044,ECE 200,051,091053,Wang; Xiaolong,9999,0,9999,0
1653629143044,ECE 200,052,091054,Xie; Pengtao,9999,0,9999,0
1653629143044,ECE 200,053,091055,Yip; Michael,9999,0,9999,0
1653629143044,ECE 200,054,091056,Zeger; Kenneth A.,9999,0,9999,0
1653629143044,ECE 200,055,091057,Zhang; Xinyu,9999,0,9999,0
1653629143044,ECE 200,056,091058,Turakhia; Yatish Girish,9999,0,9999,0
1653629143044,ECE 200,057,091059,Kang; Mingu,9999,0,9999,0
1653629143044,ECE 200,058,091060,Shi; Yuanyuan,9999,0,9999,0
1653629143044,ECE 200,059,091061,Wang; Edward Jay,9999,0,9999,0
1653629143044,ECE 200,060,091062,Zheng; Yang,9999,0,9999,0
1653629143573,ECE 201,A00,095526,Lo; Yu-Hwa,0,0,0,0
1653629144098,ECE 203,A00,091065,Mercier; Patrick Philip,0,0,0,0
1653629144620,ECE 207A,A00,091605,Liu; Thomas Tao-Ming,0,0,0,0
1653629145147,ECE 212AN,A00,091068,Nomura; Kenji,0,0,0,0
1653629145672,ECE 222A,A00,091069,Rebeiz; Gabriel,0,0,0,0
1653629146213,ECE 225A,A00,091070,Orlitsky; Alon,0,0,0,0
1653629146738,ECE 230A,A00,091071,Nomura; Kenji,0,0,0,0
1653629147263,ECE 236A,A00,091072,Dayeh; Shadi Ahmad,0,0,0,0
1653629147786,ECE 238A,A00,091073,Luo; Jian,0,0,0,0
1653629147786,ECE 238A,B00,091074,Luo; Jian,0,0,0,0
1653629148314,ECE 240A,A00,091075,Radic; Stojan,0,0,0,0
1653629148837,ECE 247A,A00,091592,Shi; Lingyan,0,0,0,0
1653629149363,ECE 250,A00,091076,Touri; Behrouz,0,0,0,0
1653629149889,ECE 251C,A00,091078,Nguyen; Truong Quang,0,0,0,0
1653629150412,ECE 253,A00,091079,Cosman; Pamela C.,0,0,0,0
1653629150936,ECE 255A,A00,091080,Orlitsky; Alon,0,0,0,0
1653629151458,ECE 257A,A00,091081,Zhang; Xinyu,0,0,0,0
1653629151991,ECE 260A,A01,091084,Eldon; John,0,0,0,0
1653629152517,ECE 264C,A00,091085,Galton; Ian A,0,0,0,0
1653629153040,ECE 265C,A00,094889,Presti; Calogero Davide,0,0,0,9
1653629153575,ECE 266,A01,091087,Hall; Drew A.,0,0,0,0
1653629154627,ECE 271A,A00,091090,Vasconcelos; Nuno,0,0,0,0
1653629155157,ECE 272B,A00,091091,Sworder; David D.,0,0,0,0
1653629155691,ECE 275A,A00,091092,Meyer; Florian,0,0,0,0
1653629156214,ECE 277,A00,091093,An; Cheolhong,0,0,0,0
1653629156740,ECE 283,A00,091094,Le; Hanh-Phuc,0,0,0,0
1653629157267,ECE 284,A00,091095,Kang; Mingu,0,0,0,0
1653629157267,ECE 284,B00,091096,Wang; Edward Jay,0,0,0,0
1653629157789,ECE 285,A00,094334,Touri; Behrouz,0,0,0,0
1653629158314,ECE 289,A00,091097,Whelan; David Arthur,0,0,0,0
1653629158843,MATH 200A,A00,087414,Salehi Golsefidy; Alireza,7,0,8,1
1653629159369,MATH 202A,A00,087415,Gill; Philip E.,2,0,8,6
1653629159895,MATH 203A,A00,087416,Oprea; Dragos N.,6,0,8,2
1653629160420,MATH 204A,A00,087417,Kedlaya; Kiran S.,6,0,8,2
1653629160949,MATH 205,A00,087418,Sorensen; Claus M,6,0,8,2
1653629161475,MATH 206A,A00,087419,Izadi; Elham,6,0,8,2
1653629161997,MATH 207A,A00,087420,Mohammadi; Amir,5,0,8,3
1653629162521,MATH 208,A00,087421,Staff,8,0,10,2
1653629163045,MATH 209,A00,087422,Staff,10,0,10,0
1653629163576,MATH 218,A00,087423,Staff,10,0,10,0
1653629164099,MATH 220A,A00,087424,Novak; Jonathan I,6,0,8,2
1653629164625,MATH 231A,A00,087425,Bejenaru; Ioan,3,0,8,5
1653629165148,MATH 240A,A00,087426,Ebenfelt; Peter F,5,0,8,3
1653629165670,MATH 243,A00,087427,Staff,9,0,10,1
1653629166195,MATH 248,A00,087429,Staff,10,0,10,0
1653629166729,MATH 250A,A00,087430,Spolaor; Luca,4,0,8,4
1653629167250,MATH 257A,A00,087431,Spolaor; Luca,7,0,8,1
1653629167772,MATH 258,A00,087432,Staff,9,0,10,1
1653629168297,MATH 264A,A00,087433,Warnke; Lutz Peter,5,0,8,3
1653629168820,MATH 268,A00,087434,Staff,15,0,15,0
1653629169342,MATH 269,A00,087435,Staff,14,0,15,1
1653629169867,MATH 270A,A00,087436,Nie; Jiawang,0,0,8,8
1653629170390,MATH 272A,A00,087437,Tian; Xiaochuan,0,0,8,8
1653629170917,MATH 274,A01,087439,Cheng; Li-Tien,9,0,10,1
1653629170917,MATH 274,A02,087440,Cheng; Li-Tien,10,0,10,0
1653629171442,MATH 278A,A00,087441,Staff,8,0,10,2
1653629171965,MATH 278B,A00,087442,Staff,8,0,10,2
1653629172578,MATH 278C,A00,087443,Staff,8,0,10,2
1653629173103,MATH 280A,A00,087444,Zheng; Tianyi,0,0,8,8
1653629173629,MATH 281A,A00,087445,Bradic; Jelena,0,0,8,9
1653629174156,MATH 282A,A00,087446,Zhang; Danna,0,0,8,8
1653629174679,MATH 283,A00,087447,Tesler; Glenn,0,0,0,16
1653629175203,MATH 286,B00,095535,Kemp; Todd Aahron,5,0,8,3
1653629175730,MATH 287D,B00,095536,Bradic; Jelena,5,0,8,3
1653629176255,MATH 288,A00,087450,Staff,14,0,15,1
1653629176255,MATH 288,B00,087451,Staff,15,0,15,0
1653629176255,MATH 288,C00,087452,Staff,15,0,15,0
1653629176786,MATH 290A,A00,087453,Xu; Zhouli,6,0,8,2
1653629177312,MATH 291A,A00,087454,Xu; Zhouli,7,0,8,1
1653629177834,MATH 292,A00,087455,Staff,10,0,10,0
1653629178357,MATH 295,A00,087456,Staff,50,0,50,0
1653629178879,MATH 297,001,087457,Staff,997,0,999,2
1653629738064,COGS 200,A01,087991,Staff,47,0,50,3
1653629738589,COGS 201,A01,094504,Rangel; Lara M,16,0,25,9
1653629739115,COGS 203,A00,087992,Coulson; Seana M,18,0,20,2
1653629739643,COGS 210A,001,087993,Greene; Deanna Jacquelyn,9998,0,9999,1
1653629739643,COGS 210A,002,087994,Saygin; Ayse P,9999,0,9999,0
1653629739643,COGS 210A,003,087995,Xia; Haijun,9999,0,9999,0
1653629739643,COGS 210A,004,087996,Nitz; Douglas A.,9999,0,9999,0
1653629739643,COGS 210A,005,087997,Hollan; James D.,9999,0,9999,0
1653629739643,COGS 210A,006,087998,Deak; Gedeon O.,9998,0,9999,1
1653629739643,COGS 210A,007,087999,Rossano; Federico,9999,0,9999,0
1653629740169,COGS 211A,A00,088000,Coulson; Seana M,9997,0,9999,2
1653629740694,COGS 229,A00,088002,Staff,22,0,25,3
1653629741220,COGS 260,B00,094231,Staff,17,0,20,3
1653629741220,COGS 260,A00,088004,Nitz; Douglas A.,9998,0,9999,1
1653629741751,CSE 202,A00,090110,Paturi; Ramamohan,0,0,0,0
1653629741751,CSE 202,B00,090111,Paturi; Ramamohan,0,0,0,0
1653629742276,CSE 207B,A00,090112,Heninger; Nadia A,0,0,0,0
1653629742805,CSE 208,A00,094858,Micciancio; Daniele,0,0,0,0
1653629743328,CSE 210,A00,090113,Powell; Thomas Allan,0,0,0,0
1653629743854,CSE 219,A00,090898,Staff,0,0,0,0
1653629744378,CSE 221,A00,090114,Zhou; Yuan-Yuan,0,0,0,0
1653629744901,CSE 229A,A00,090115,Porter; George M,0,0,0,0
1653629745424,CSE 229C,A00,090116,Savage; Stefan,0,0,0,0
1653629745956,CSE 230,A00,090117,Jhala; Ranjit,0,0,0,0
1653629746481,CSE 232,A00,090118,Papakonstantinou; Yannis,0,0,0,0
1653629747005,CSE 239A,A00,090121,Kumar; Arun Kumar,0,0,0,0
1653629747531,CSE 239B,A00,090122,Jhala; Ranjit,0,0,0,0
1653629748053,CSE 240A,A00,090123,Zhao; Jishen,0,0,189,189
1653629748579,CSE 243A,A00,090124,Orailoglu; Alex,0,0,15,15
1653629749107,CSE 249B,A00,090125,Kahng; Andrew Byun,12,0,20,8
1653629749630,CSE 250A,A00,090126,Berg-Kirkpatrick; Taylor D,0,0,0,0
1653629750156,CSE 252A,A00,090127,Ochoa; Benjamin Lawrence,0,0,0,0
1653629750679,CSE 258,A01,090129,McAuley; Julian John,0,0,0,0
1653629751205,CSE 258R,A01,090131,McAuley; Julian John,0,0,0,0
1653629751735,CSE 274,A00,090132,Ramamoorthi; Ravi,0,0,0,0
1653629752258,CSE 276A,A00,090133,Christensen; Henrik I,0,0,0,0
1653629752785,CSE 276C,A00,090134,Christensen; Henrik I,0,0,0,0
1653629753307,CSE 290,A00,090135,Bafna; Vineet,0,0,0,0
1653629753307,CSE 290,B00,090136,Ramamoorthi; Ravi,0,0,0,0
1653629753307,CSE 290,C00,090137,Li; Tzumao,7,0,10,3
1653629753307,CSE 290,D00,090138,Zhou; Yuan-Yuan,9,0,10,1
1653629753307,CSE 290,E00,090139,Christensen; Henrik I,8,0,10,2
1653629753307,CSE 290,F00,094053,Shalev; Aaron D,0,0,0,0
1653629753838,CSE 291,A00,090140,Munyaka; Imani N. S.,0,0,0,0
1653629753838,CSE 291,B00,094880,Yu; Qi,0,0,0,0
1653629753838,CSE 291,C00,090142,Pannuto; Patrick William,0,0,0,0
1653629753838,CSE 291,D00,094881,Zhang; Yiying,0,0,0,0
1653629753838,CSE 291,E00,095118,Su; Hao,0,0,0,0
1653629754375,CSE 293,001,094905,Bafna; Vineet,9999,0,9999,0
1653629754375,CSE 293,002,094906,Bellare; Mihir,9999,0,9999,0
1653629754375,CSE 293,003,094907,Berg-Kirkpatrick; Taylor D,9999,0,9999,0
1653629754375,CSE 293,004,094908,Christensen; Henrik I,9999,0,9999,0
1653629754375,CSE 293,005,094909,Cottrell; Garrison W,9999,0,9999,0
1653629754375,CSE 293,006,094910,Deutsch; Alin Bernard,9999,0,9999,0
1653629754375,CSE 293,007,094911,Esmaeilzadeh; Hadi,9999,0,9999,0
1653629754375,CSE 293,008,094912,Freund; Yoav,9999,0,9999,0
1653629754375,CSE 293,009,094913,Griswold; William G.,9999,0,9999,0
1653629754375,CSE 293,010,094914,Gymrek; Melissa Ann,9999,0,9999,0
1653629754375,CSE 293,011,094915,Heninger; Nadia A,9999,0,9999,0
1653629754375,CSE 293,012,094916,Impagliazzo; Russell,9999,0,9999,0
1653629754375,CSE 293,013,094917,Jhala; Ranjit,9999,0,9999,0
1653629754375,CSE 293,014,094918,Kahng; Andrew Byun,9999,0,9999,0
1653629754375,CSE 293,015,094919,Kane; Daniel Mertz,9999,0,9999,0
1653629754375,CSE 293,016,094920,Kriegman; David J,9999,0,9999,0
1653629754375,CSE 293,017,094921,Kumar; Arun Kumar,9999,0,9999,0
1653629754375,CSE 293,018,094922,Lerner; Sorin,9999,0,9999,0
1653629754375,CSE 293,019,094923,Lovett; Shachar,9999,0,9999,0
1653629754375,CSE 293,020,094924,McAuley; Julian John,9999,0,9999,0
1653629754375,CSE 293,021,094925,Micciancio; Daniele,9999,0,9999,0
1653629754375,CSE 293,022,094926,Orailoglu; Alex,9999,0,9999,0
1653629754375,CSE 293,023,094927,Paturi; Ramamohan,9999,0,9999,0
1653629754375,CSE 293,024,094928,Polikarpova; Nadezhda,9999,0,9999,0
1653629754375,CSE 293,025,094929,Politz; Joseph Gibbs,9999,0,9999,0
1653629754375,CSE 293,026,094930,Porter; George M,9999,0,9999,0
1653629754375,CSE 293,027,094931,Porter; Leonard Emerson,9999,0,9999,0
1653629754375,CSE 293,028,094932,Ramamoorthi; Ravi,9999,0,9999,0
1653629754375,CSE 293,029,094933,Sahoo; Debashis,9999,0,9999,0
1653629754375,CSE 293,030,094934,Saul; Lawrence,9999,0,9999,0
1653629754375,CSE 293,031,094935,Savage; Stefan,9999,0,9999,0
1653629754375,CSE 293,032,094936,Schulze; Jurgen P.,9999,0,9999,0
1653629754375,CSE 293,033,094937,Snoeren; Alex C.,9999,0,9999,0
1653629754375,CSE 293,034,094938,Shang; Jingbo,9999,0,9999,0
1653629754375,CSE 293,035,094939,Stefan; Deian,9999,0,9999,0
1653629754375,CSE 293,036,094940,Su; Hao,9999,0,9999,0
1653629754375,CSE 293,037,094941,Swanson; Steven James,9999,0,9999,0
1653629754375,CSE 293,038,094942,Tullsen; Dean Michael,9999,0,9999,0
1653629754375,CSE 293,039,094943,Voelker; Geoffrey M.,9999,0,9999,0
1653629754375,CSE 293,040,094944,Zhao; Jishen,9999,0,9999,0
1653629754375,CSE 293,041,094945,Zhou; Yuan-Yuan,9999,0,9999,0
1653629754375,CSE 293,042,094946,Gao; Sicun,9998,0,9999,1
1653629754375,CSE 293,043,094947,Weibel; Nadir,9999,0,9999,0
1653629754375,CSE 293,044,094948,Gupta; Rajesh K.,9999,0,9999,0
1653629754900,CSE 294,A00,090143,Porter; George M,9,0,10,1
1653629755423,DSE 200,A00,091799,Staff,50,0,50,0
1653629755948,DSE 203,A00,091800,Gupta; Amarnath,30,0,30,0
1653629756483,DSE 250,A00,091801,Deutsch; Alin Bernard,30,0,30,0
1653629757006,DSE 290,A00,091802,Altintas De Callaf; Ilkay,50,0,50,0
1653629757551,ECE 200,001,091003,Antipa; Nicholas A,9999,0,9999,0
1653629757551,ECE 200,002,091004,Atanasov; Nikolay A.,9999,0,9999,0
1653629757551,ECE 200,003,091005,Bharadia; Dinesh,9999,0,9999,0
1653629757551,ECE 200,004,091006,Cheng; Chung Kuan,9999,0,9999,0
1653629757551,ECE 200,005,091007,Cosman; Pamela C.,9999,0,9999,0
1653629757551,ECE 200,006,091008,Staff,9999,0,9999,0
1653629757551,ECE 200,007,091009,Dayeh; Shadi Ahmad,9999,0,9999,0
1653629757551,ECE 200,008,091010,Fainman; Yeshaiahu,9999,0,9999,0
1653629757551,ECE 200,009,091011,Ford; Joseph Earl,9999,0,9999,0
1653629757551,ECE 200,010,091012,Franceschetti; Massimo,9999,0,9999,0
1653629757551,ECE 200,011,091013,Fullerton; Eric E,9999,0,9999,0
1653629757551,ECE 200,012,091014,Galton; Ian A,9999,0,9999,0
1653629757551,ECE 200,013,091015,Gilja; Vikash,9999,0,9999,0
1653629757551,ECE 200,014,091016,Hall; Drew A.,9999,0,9999,0
1653629757551,ECE 200,015,091017,Hsueh; Tzu-Chien,9999,0,9999,0
1653629757551,ECE 200,016,091018,Javidi; Tara,9999,0,9999,0
1653629757551,ECE 200,017,091019,Kahng; Andrew Byun,9999,0,9999,0
1653629757551,ECE 200,018,091020,Kim; Young-Han,9999,0,9999,0
1653629757551,ECE 200,019,091021,Koushanfar; Farinaz,9999,0,9999,0
1653629757551,ECE 200,020,091022,Kuzum; Duygu,9999,0,9999,0
1653629757551,ECE 200,021,091023,Le; Hanh-Phuc,9999,0,9999,0
1653629757551,ECE 200,022,091024,Lin; Bill,9999,0,9999,0
1653629757551,ECE 200,023,091025,Liu; Zhaowei,9999,0,9999,0
1653629757551,ECE 200,024,091026,Lo; Yu-Hwa,9999,0,9999,0
1653629757551,ECE 200,025,091027,Lomakin; Vitaliy,9999,0,9999,0
1653629757551,ECE 200,026,091028,Mercier; Patrick Philip,9999,0,9999,0
1653629757551,ECE 200,027,091029,Meyer; Florian,9999,0,9999,0
1653629757551,ECE 200,028,091030,Milstein; Laurence B.,9999,0,9999,0
1653629757551,ECE 200,029,091031,Mir Arabbaygi; Siavash,9999,0,9999,0
1653629757551,ECE 200,030,091032,Mookherjea; Shayan,9999,0,9999,0
1653629757551,ECE 200,031,091033,Morris; Karcher William,9999,0,9999,0
1653629757551,ECE 200,032,091034,Ng; Tse Nga,9999,0,9999,0
1653629757551,ECE 200,033,091035,Nguyen; Truong Quang,9999,0,9999,0
1653629757551,ECE 200,034,091036,Nomura; Kenji,9999,0,9999,0
1653629757551,ECE 200,035,091037,Orlitsky; Alon,9999,0,9999,0
1653629757551,ECE 200,036,091038,Pal; Piya,9999,0,9999,0
1653629757551,ECE 200,037,091039,Papen; George C.,9999,0,9999,0
1653629757551,ECE 200,038,091040,Radic; Stojan,9999,0,9999,0
1653629757551,ECE 200,039,091041,Rao; Bhaskar D.,9999,0,9999,0
1653629757551,ECE 200,040,091042,Rao; Ramesh R,9999,0,9999,0
1653629757551,ECE 200,041,091043,Rebeiz; Gabriel,9999,0,9999,0
1653629757551,ECE 200,042,091044,Sanford; John R,9999,0,9999,0
1653629757551,ECE 200,043,091045,Siegel; Paul H.,9999,0,9999,0
1653629757551,ECE 200,044,091046,Sievenpiper; Daniel F.,9999,0,9999,0
1653629757551,ECE 200,045,091047,Sworder; David D.,9999,0,9999,0
1653629757551,ECE 200,046,091048,Taur; Yuan,9999,0,9999,0
1653629757551,ECE 200,047,091049,Touri; Behrouz,9999,0,9999,0
1653629757551,ECE 200,048,091050,Trivedi; Mohan M.,9999,0,9999,0
1653629757551,ECE 200,049,091051,Vardy; Alexander,9999,0,9999,0
1653629757551,ECE 200,050,091052,Vasconcelos; Nuno,9999,0,9999,0
1653629757551,ECE 200,051,091053,Wang; Xiaolong,9999,0,9999,0
1653629757551,ECE 200,052,091054,Xie; Pengtao,9999,0,9999,0
1653629757551,ECE 200,053,091055,Yip; Michael,9999,0,9999,0
1653629757551,ECE 200,054,091056,Zeger; Kenneth A.,9999,0,9999,0
1653629757551,ECE 200,055,091057,Zhang; Xinyu,9999,0,9999,0
1653629757551,ECE 200,056,091058,Turakhia; Yatish Girish,9999,0,9999,0
1653629757551,ECE 200,057,091059,Kang; Mingu,9999,0,9999,0
1653629757551,ECE 200,058,091060,Shi; Yuanyuan,9999,0,9999,0
1653629757551,ECE 200,059,091061,Wang; Edward Jay,9999,0,9999,0
1653629757551,ECE 200,060,091062,Zheng; Yang,9999,0,9999,0
1653629758078,ECE 201,A00,095526,Lo; Yu-Hwa,0,0,0,0
1653629758602,ECE 203,A00,091065,Mercier; Patrick Philip,0,0,0,0
1653629759196,ECE 207A,A00,091605,Liu; Thomas Tao-Ming,0,0,0,0
1653629759719,ECE 212AN,A00,091068,Nomura; Kenji,0,0,0,0
1653629760255,ECE 222A,A00,091069,Rebeiz; Gabriel,0,0,0,0
1653629760777,ECE 225A,A00,091070,Orlitsky; Alon,0,0,0,0
1653629761300,ECE 230A,A00,091071,Nomura; Kenji,0,0,0,0
1653629761824,ECE 236A,A00,091072,Dayeh; Shadi Ahmad,0,0,0,0
1653629762347,ECE 238A,A00,091073,Luo; Jian,0,0,0,0
1653629762347,ECE 238A,B00,091074,Luo; Jian,0,0,0,0
1653629762875,ECE 240A,A00,091075,Radic; Stojan,0,0,0,0
1653629763399,ECE 247A,A00,091592,Shi; Lingyan,0,0,0,0
1653629763924,ECE 250,A00,091076,Touri; Behrouz,0,0,0,0
1653629764481,ECE 251C,A00,091078,Nguyen; Truong Quang,0,0,0,0
1653629765004,ECE 253,A00,091079,Cosman; Pamela C.,0,0,0,0
1653629765529,ECE 255A,A00,091080,Orlitsky; Alon,0,0,0,0
1653629766055,ECE 257A,A00,091081,Zhang; Xinyu,0,0,0,0
1653629766587,ECE 260A,A01,091084,Eldon; John,0,0,0,0
1653629767114,ECE 264C,A00,091085,Galton; Ian A,0,0,0,0
1653629767639,ECE 265C,A00,094889,Presti; Calogero Davide,0,0,0,9
1653629768163,ECE 266,A01,091087,Hall; Drew A.,0,0,0,0
1653629769214,ECE 271A,A00,091090,Vasconcelos; Nuno,0,0,0,0
1653629769743,ECE 272B,A00,091091,Sworder; David D.,0,0,0,0
1653629770265,ECE 275A,A00,091092,Meyer; Florian,0,0,0,0
1653629770799,ECE 277,A00,091093,An; Cheolhong,0,0,0,0
1653629771325,ECE 283,A00,091094,Le; Hanh-Phuc,0,0,0,0
1653629771848,ECE 284,A00,091095,Kang; Mingu,0,0,0,0
1653629771848,ECE 284,B00,091096,Wang; Edward Jay,0,0,0,0
1653629772369,ECE 285,A00,094334,Touri; Behrouz,0,0,0,0
1653629772892,ECE 289,A00,091097,Whelan; David Arthur,0,0,0,0
1653629773415,MATH 200A,A00,087414,Salehi Golsefidy; Alireza,7,0,8,1
1653629773938,MATH 202A,A00,087415,Gill; Philip E.,2,0,8,6
1653629774465,MATH 203A,A00,087416,Oprea; Dragos N.,6,0,8,2
1653629774995,MATH 204A,A00,087417,Kedlaya; Kiran S.,6,0,8,2
1653629775521,MATH 205,A00,087418,Sorensen; Claus M,6,0,8,2
1653629776047,MATH 206A,A00,087419,Izadi; Elham,6,0,8,2
1653629776570,MATH 207A,A00,087420,Mohammadi; Amir,5,0,8,3
1653629777103,MATH 208,A00,087421,Staff,8,0,10,2
1653629777625,MATH 209,A00,087422,Staff,10,0,10,0
1653629778158,MATH 218,A00,087423,Staff,10,0,10,0
1653629778690,MATH 220A,A00,087424,Novak; Jonathan I,6,0,8,2
1653629779215,MATH 231A,A00,087425,Bejenaru; Ioan,3,0,8,5
1653629779753,MATH 240A,A00,087426,Ebenfelt; Peter F,5,0,8,3
1653629780281,MATH 243,A00,087427,Staff,9,0,10,1
1653629780803,MATH 248,A00,087429,Staff,10,0,10,0
1653629781329,MATH 250A,A00,087430,Spolaor; Luca,4,0,8,4
1653629781852,MATH 257A,A00,087431,Spolaor; Luca,7,0,8,1
1653629782377,MATH 258,A00,087432,Staff,9,0,10,1
1653629782901,MATH 264A,A00,087433,Warnke; Lutz Peter,5,0,8,3
1653629783435,MATH 268,A00,087434,Staff,15,0,15,0
1653629783961,MATH 269,A00,087435,Staff,14,0,15,1
1653629784485,MATH 270A,A00,087436,Nie; Jiawang,0,0,8,8
1653629785008,MATH 272A,A00,087437,Tian; Xiaochuan,0,0,8,8
1653629785530,MATH 274,A01,087439,Cheng; Li-Tien,9,0,10,1
1653629785530,MATH 274,A02,087440,Cheng; Li-Tien,10,0,10,0
1653629786052,MATH 278A,A00,087441,Staff,8,0,10,2
1653629786578,MATH 278B,A00,087442,Staff,8,0,10,2
1653629787100,MATH 278C,A00,087443,Staff,8,0,10,2
1653629787626,MATH 280A,A00,087444,Zheng; Tianyi,0,0,8,8
1653629788148,MATH 281A,A00,087445,Bradic; Jelena,0,0,8,9
1653629788670,MATH 282A,A00,087446,Zhang; Danna,0,0,8,8
1653629789193,MATH 283,A00,087447,Tesler; Glenn,0,0,0,16
1653629789720,MATH 286,B00,095535,Kemp; Todd Aahron,5,0,8,3
1653629790243,MATH 287D,B00,095536,Bradic; Jelena,5,0,8,3
1653629790768,MATH 288,A00,087450,Staff,14,0,15,1
1653629790768,MATH 288,B00,087451,Staff,15,0,15,0
1653629790768,MATH 288,C00,087452,Staff,15,0,15,0
1653629791291,MATH 290A,A00,087453,Xu; Zhouli,6,0,8,2
1653629791813,MATH 291A,A00,087454,Xu; Zhouli,7,0,8,1
1653629792347,MATH 292,A00,087455,Staff,10,0,10,0
1653629792875,MATH 295,A00,087456,Staff,50,0,50,0
1653629793405,MATH 297,001,087457,Staff,997,0,999,2
1653630352903,COGS 200,A01,087991,Staff,47,0,50,3
1653630353428,COGS 201,A01,094504,Rangel; Lara M,16,0,25,9
1653630353954,COGS 203,A00,087992,Coulson; Seana M,18,0,20,2
1653630354477,COGS 210A,001,087993,Greene; Deanna Jacquelyn,9998,0,9999,1
1653630354477,COGS 210A,002,087994,Saygin; Ayse P,9999,0,9999,0
1653630354477,COGS 210A,003,087995,Xia; Haijun,9999,0,9999,0
1653630354477,COGS 210A,004,087996,Nitz; Douglas A.,9999,0,9999,0
1653630354477,COGS 210A,005,087997,Hollan; James D.,9999,0,9999,0
1653630354477,COGS 210A,006,087998,Deak; Gedeon O.,9998,0,9999,1
1653630354477,COGS 210A,007,087999,Rossano; Federico,9999,0,9999,0
1653630355003,COGS 211A,A00,088000,Coulson; Seana M,9997,0,9999,2
1653630355526,COGS 229,A00,088002,Staff,22,0,25,3
1653630356052,COGS 260,B00,094231,Staff,17,0,20,3
1653630356052,COGS 260,A00,088004,Nitz; Douglas A.,9998,0,9999,1
1653630356579,CSE 202,A00,090110,Paturi; Ramamohan,0,0,0,0
1653630356579,CSE 202,B00,090111,Paturi; Ramamohan,0,0,0,0
1653630357102,CSE 207B,A00,090112,Heninger; Nadia A,0,0,0,0
1653630357629,CSE 208,A00,094858,Micciancio; Daniele,0,0,0,0
1653630358154,CSE 210,A00,090113,Powell; Thomas Allan,0,0,0,0
1653630358680,CSE 219,A00,090898,Staff,0,0,0,0
1653630359206,CSE 221,A00,090114,Zhou; Yuan-Yuan,0,0,0,0
1653630359729,CSE 229A,A00,090115,Porter; George M,0,0,0,0
1653630360250,CSE 229C,A00,090116,Savage; Stefan,0,0,0,0
1653630360773,CSE 230,A00,090117,Jhala; Ranjit,0,0,0,0
1653630361295,CSE 232,A00,090118,Papakonstantinou; Yannis,0,0,0,0
1653630361818,CSE 239A,A00,090121,Kumar; Arun Kumar,0,0,0,0
1653630362342,CSE 239B,A00,090122,Jhala; Ranjit,0,0,0,0
1653630362871,CSE 240A,A00,090123,Zhao; Jishen,0,0,189,189
1653630363401,CSE 243A,A00,090124,Orailoglu; Alex,0,0,15,15
1653630363926,CSE 249B,A00,090125,Kahng; Andrew Byun,12,0,20,8
1653630364452,CSE 250A,A00,090126,Berg-Kirkpatrick; Taylor D,0,0,0,0
1653630364974,CSE 252A,A00,090127,Ochoa; Benjamin Lawrence,0,0,0,0
1653630365510,CSE 258,A01,090129,McAuley; Julian John,0,0,0,0
1653630366036,CSE 258R,A01,090131,McAuley; Julian John,0,0,0,0
1653630366562,CSE 274,A00,090132,Ramamoorthi; Ravi,0,0,0,0
1653630367109,CSE 276A,A00,090133,Christensen; Henrik I,0,0,0,0
1653630367632,CSE 276C,A00,090134,Christensen; Henrik I,0,0,0,0
1653630368156,CSE 290,A00,090135,Bafna; Vineet,0,0,0,0
1653630368156,CSE 290,B00,090136,Ramamoorthi; Ravi,0,0,0,0
1653630368156,CSE 290,C00,090137,Li; Tzumao,7,0,10,3
1653630368156,CSE 290,D00,090138,Zhou; Yuan-Yuan,9,0,10,1
1653630368156,CSE 290,E00,090139,Christensen; Henrik I,8,0,10,2
1653630368156,CSE 290,F00,094053,Shalev; Aaron D,0,0,0,0
1653630368680,CSE 291,A00,090140,Munyaka; Imani N. S.,0,0,0,0
1653630368680,CSE 291,B00,094880,Yu; Qi,0,0,0,0
1653630368680,CSE 291,C00,090142,Pannuto; Patrick William,0,0,0,0
1653630368680,CSE 291,D00,094881,Zhang; Yiying,0,0,0,0
1653630368680,CSE 291,E00,095118,Su; Hao,0,0,0,0
1653630369205,CSE 293,001,094905,Bafna; Vineet,9999,0,9999,0
1653630369205,CSE 293,002,094906,Bellare; Mihir,9999,0,9999,0
1653630369205,CSE 293,003,094907,Berg-Kirkpatrick; Taylor D,9999,0,9999,0
1653630369205,CSE 293,004,094908,Christensen; Henrik I,9999,0,9999,0
1653630369205,CSE 293,005,094909,Cottrell; Garrison W,9999,0,9999,0
1653630369205,CSE 293,006,094910,Deutsch; Alin Bernard,9999,0,9999,0
1653630369205,CSE 293,007,094911,Esmaeilzadeh; Hadi,9999,0,9999,0
1653630369205,CSE 293,008,094912,Freund; Yoav,9999,0,9999,0
1653630369205,CSE 293,009,094913,Griswold; William G.,9999,0,9999,0
1653630369205,CSE 293,010,094914,Gymrek; Melissa Ann,9999,0,9999,0
1653630369205,CSE 293,011,094915,Heninger; Nadia A,9999,0,9999,0
1653630369205,CSE 293,012,094916,Impagliazzo; Russell,9999,0,9999,0
1653630369205,CSE 293,013,094917,Jhala; Ranjit,9999,0,9999,0
1653630369205,CSE 293,014,094918,Kahng; Andrew Byun,9999,0,9999,0
1653630369205,CSE 293,015,094919,Kane; Daniel Mertz,9999,0,9999,0
1653630369205,CSE 293,016,094920,Kriegman; David J,9999,0,9999,0
1653630369205,CSE 293,017,094921,Kumar; Arun Kumar,9999,0,9999,0
1653630369205,CSE 293,018,094922,Lerner; Sorin,9999,0,9999,0
1653630369205,CSE 293,019,094923,Lovett; Shachar,9999,0,9999,0
1653630369205,CSE 293,020,094924,McAuley; Julian John,9999,0,9999,0
1653630369205,CSE 293,021,094925,Micciancio; Daniele,9999,0,9999,0
1653630369205,CSE 293,022,094926,Orailoglu; Alex,9999,0,9999,0
1653630369205,CSE 293,023,094927,Paturi; Ramamohan,9999,0,9999,0
1653630369205,CSE 293,024,094928,Polikarpova; Nadezhda,9999,0,9999,0
1653630369205,CSE 293,025,094929,Politz; Joseph Gibbs,9999,0,9999,0
1653630369205,CSE 293,026,094930,Porter; George M,9999,0,9999,0
1653630369205,CSE 293,027,094931,Porter; Leonard Emerson,9999,0,9999,0
1653630369205,CSE 293,028,094932,Ramamoorthi; Ravi,9999,0,9999,0
1653630369205,CSE 293,029,094933,Sahoo; Debashis,9999,0,9999,0
1653630369205,CSE 293,030,094934,Saul; Lawrence,9999,0,9999,0
1653630369205,CSE 293,031,094935,Savage; Stefan,9999,0,9999,0
1653630369205,CSE 293,032,094936,Schulze; Jurgen P.,9999,0,9999,0
1653630369205,CSE 293,033,094937,Snoeren; Alex C.,9999,0,9999,0
1653630369205,CSE 293,034,094938,Shang; Jingbo,9999,0,9999,0
1653630369205,CSE 293,035,094939,Stefan; Deian,9999,0,9999,0
1653630369205,CSE 293,036,094940,Su; Hao,9999,0,9999,0
1653630369205,CSE 293,037,094941,Swanson; Steven James,9999,0,9999,0
1653630369205,CSE 293,038,094942,Tullsen; Dean Michael,9999,0,9999,0
1653630369205,CSE 293,039,094943,Voelker; Geoffrey M.,9999,0,9999,0
1653630369205,CSE 293,040,094944,Zhao; Jishen,9999,0,9999,0
1653630369205,CSE 293,041,094945,Zhou; Yuan-Yuan,9999,0,9999,0
1653630369205,CSE 293,042,094946,Gao; Sicun,9998,0,9999,1
1653630369205,CSE 293,043,094947,Weibel; Nadir,9999,0,9999,0
1653630369205,CSE 293,044,094948,Gupta; Rajesh K.,9999,0,9999,0
1653630369726,CSE 294,A00,090143,Porter; George M,9,0,10,1
1653630370256,DSE 200,A00,091799,Staff,50,0,50,0
1653630370781,DSE 203,A00,091800,Gupta; Amarnath,30,0,30,0
1653630371303,DSE 250,A00,091801,Deutsch; Alin Bernard,30,0,30,0
1653630371830,DSE 290,A00,091802,Altintas De Callaf; Ilkay,50,0,50,0
1653630372355,ECE 200,001,091003,Antipa; Nicholas A,9999,0,9999,0
1653630372355,ECE 200,002,091004,Atanasov; Nikolay A.,9999,0,9999,0
1653630372355,ECE 200,003,091005,Bharadia; Dinesh,9999,0,9999,0
1653630372355,ECE 200,004,091006,Cheng; Chung Kuan,9999,0,9999,0
1653630372355,ECE 200,005,091007,Cosman; Pamela C.,9999,0,9999,0
1653630372355,ECE 200,006,091008,Staff,9999,0,9999,0
1653630372355,ECE 200,007,091009,Dayeh; Shadi Ahmad,9999,0,9999,0
1653630372355,ECE 200,008,091010,Fainman; Yeshaiahu,9999,0,9999,0
1653630372355,ECE 200,009,091011,Ford; Joseph Earl,9999,0,9999,0
1653630372355,ECE 200,010,091012,Franceschetti; Massimo,9999,0,9999,0
1653630372355,ECE 200,011,091013,Fullerton; Eric E,9999,0,9999,0
1653630372355,ECE 200,012,091014,Galton; Ian A,9999,0,9999,0
1653630372355,ECE 200,013,091015,Gilja; Vikash,9999,0,9999,0
1653630372355,ECE 200,014,091016,Hall; Drew A.,9999,0,9999,0
1653630372355,ECE 200,015,091017,Hsueh; Tzu-Chien,9999,0,9999,0
1653630372355,ECE 200,016,091018,Javidi; Tara,9999,0,9999,0
1653630372355,ECE 200,017,091019,Kahng; Andrew Byun,9999,0,9999,0
1653630372355,ECE 200,018,091020,Kim; Young-Han,9999,0,9999,0
1653630372355,ECE 200,019,091021,Koushanfar; Farinaz,9999,0,9999,0
1653630372355,ECE 200,020,091022,Kuzum; Duygu,9999,0,9999,0
1653630372355,ECE 200,021,091023,Le; Hanh-Phuc,9999,0,9999,0
1653630372355,ECE 200,022,091024,Lin; Bill,9999,0,9999,0
1653630372355,ECE 200,023,091025,Liu; Zhaowei,9999,0,9999,0
1653630372355,ECE 200,024,091026,Lo; Yu-Hwa,9999,0,9999,0
1653630372355,ECE 200,025,091027,Lomakin; Vitaliy,9999,0,9999,0
1653630372355,ECE 200,026,091028,Mercier; Patrick Philip,9999,0,9999,0
1653630372355,ECE 200,027,091029,Meyer; Florian,9999,0,9999,0
1653630372355,ECE 200,028,091030,Milstein; Laurence B.,9999,0,9999,0
1653630372355,ECE 200,029,091031,Mir Arabbaygi; Siavash,9999,0,9999,0
1653630372355,ECE 200,030,091032,Mookherjea; Shayan,9999,0,9999,0
1653630372355,ECE 200,031,091033,Morris; Karcher William,9999,0,9999,0
1653630372355,ECE 200,032,091034,Ng; Tse Nga,9999,0,9999,0
1653630372355,ECE 200,033,091035,Nguyen; Truong Quang,9999,0,9999,0
1653630372355,ECE 200,034,091036,Nomura; Kenji,9999,0,9999,0
1653630372355,ECE 200,035,091037,Orlitsky; Alon,9999,0,9999,0
1653630372355,ECE 200,036,091038,Pal; Piya,9999,0,9999,0
1653630372355,ECE 200,037,091039,Papen; George C.,9999,0,9999,0
1653630372355,ECE 200,038,091040,Radic; Stojan,9999,0,9999,0
1653630372355,ECE 200,039,091041,Rao; Bhaskar D.,9999,0,9999,0
1653630372355,ECE 200,040,091042,Rao; Ramesh R,9999,0,9999,0
1653630372355,ECE 200,041,091043,Rebeiz; Gabriel,9999,0,9999,0
1653630372355,ECE 200,042,091044,Sanford; John R,9999,0,9999,0
1653630372355,ECE 200,043,091045,Siegel; Paul H.,9999,0,9999,0
1653630372355,ECE 200,044,091046,Sievenpiper; Daniel F.,9999,0,9999,0
1653630372355,ECE 200,045,091047,Sworder; David D.,9999,0,9999,0
1653630372355,ECE 200,046,091048,Taur; Yuan,9999,0,9999,0
1653630372355,ECE 200,047,091049,Touri; Behrouz,9999,0,9999,0
1653630372355,ECE 200,048,091050,Trivedi; Mohan M.,9999,0,9999,0
1653630372355,ECE 200,049,091051,Vardy; Alexander,9999,0,9999,0
1653630372355,ECE 200,050,091052,Vasconcelos; Nuno,9999,0,9999,0
1653630372355,ECE 200,051,091053,Wang; Xiaolong,9999,0,9999,0
1653630372355,ECE 200,052,091054,Xie; Pengtao,9999,0,9999,0
1653630372355,ECE 200,053,091055,Yip; Michael,9999,0,9999,0
1653630372355,ECE 200,054,091056,Zeger; Kenneth A.,9999,0,9999,0
1653630372355,ECE 200,055,091057,Zhang; Xinyu,9999,0,9999,0
1653630372355,ECE 200,056,091058,Turakhia; Yatish Girish,9999,0,9999,0
1653630372355,ECE 200,057,091059,Kang; Mingu,9999,0,9999,0
1653630372355,ECE 200,058,091060,Shi; Yuanyuan,9999,0,9999,0
1653630372355,ECE 200,059,091061,Wang; Edward Jay,9999,0,9999,0
1653630372355,ECE 200,060,091062,Zheng; Yang,9999,0,9999,0
1653630372878,ECE 201,A00,095526,Lo; Yu-Hwa,0,0,0,0
1653630373403,ECE 203,A00,091065,Mercier; Patrick Philip,0,0,0,0
1653630373929,ECE 207A,A00,091605,Liu; Thomas Tao-Ming,0,0,0,0
1653630374451,ECE 212AN,A00,091068,Nomura; Kenji,0,0,0,0
1653630374972,ECE 222A,A00,091069,Rebeiz; Gabriel,0,0,0,0
1653630375508,ECE 225A,A00,091070,Orlitsky; Alon,0,0,0,0
1653630376032,ECE 230A,A00,091071,Nomura; Kenji,0,0,0,0
1653630376560,ECE 236A,A00,091072,Dayeh; Shadi Ahmad,0,0,0,0
1653630377089,ECE 238A,A00,091073,Luo; Jian,0,0,0,0
1653630377089,ECE 238A,B00,091074,Luo; Jian,0,0,0,0
1653630377622,ECE 240A,A00,091075,Radic; Stojan,0,0,0,0
1653630378146,ECE 247A,A00,091592,Shi; Lingyan,0,0,0,0
1653630378671,ECE 250,A00,091076,Touri; Behrouz,0,0,0,0
1653630379196,ECE 251C,A00,091078,Nguyen; Truong Quang,0,0,0,0
1653630379730,ECE 253,A00,091079,Cosman; Pamela C.,0,0,0,0
1653630380252,ECE 255A,A00,091080,Orlitsky; Alon,0,0,0,0
1653630380779,ECE 257A,A00,091081,Zhang; Xinyu,0,0,0,0
1653630381304,ECE 260A,A01,091084,Eldon; John,0,0,0,0
1653630381826,ECE 264C,A00,091085,Galton; Ian A,0,0,0,0
1653630382352,ECE 265C,A00,094889,Presti; Calogero Davide,0,0,0,9
1653630382875,ECE 266,A01,091087,Hall; Drew A.,0,0,0,0
1653630383931,ECE 271A,A00,091090,Vasconcelos; Nuno,0,0,0,0
1653630384453,ECE 272B,A00,091091,Sworder; David D.,0,0,0,0
1653630384978,ECE 275A,A00,091092,Meyer; Florian,0,0,0,0
1653630385506,ECE 277,A00,091093,An; Cheolhong,0,0,0,0
1653630386029,ECE 283,A00,091094,Le; Hanh-Phuc,0,0,0,0
1653630386552,ECE 284,A00,091095,Kang; Mingu,0,0,0,0
1653630386552,ECE 284,B00,091096,Wang; Edward Jay,0,0,0,0
1653630387076,ECE 285,A00,094334,Touri; Behrouz,0,0,0,0
1653630387602,ECE 289,A00,091097,Whelan; David Arthur,0,0,0,0
1653630388124,MATH 200A,A00,087414,Salehi Golsefidy; Alireza,7,0,8,1
1653630388656,MATH 202A,A00,087415,Gill; Philip E.,2,0,8,6
1653630389179,MATH 203A,A00,087416,Oprea; Dragos N.,6,0,8,2
1653630389705,MATH 204A,A00,087417,Kedlaya; Kiran S.,6,0,8,2
1653630390229,MATH 205,A00,087418,Sorensen; Claus M,6,0,8,2
1653630390753,MATH 206A,A00,087419,Izadi; Elham,6,0,8,2
1653630391279,MATH 207A,A00,087420,Mohammadi; Amir,5,0,8,3
1653630391802,MATH 208,A00,087421,Staff,8,0,10,2
1653630392330,MATH 209,A00,087422,Staff,10,0,10,0
1653630392856,MATH 218,A00,087423,Staff,10,0,10,0
1653630393378,MATH 220A,A00,087424,Novak; Jonathan I,6,0,8,2
1653630393902,MATH 231A,A00,087425,Bejenaru; Ioan,3,0,8,5
1653630394435,MATH 240A,A00,087426,Ebenfelt; Peter F,5,0,8,3
1653630394962,MATH 243,A00,087427,Staff,9,0,10,1
1653630395506,MATH 248,A00,087429,Staff,10,0,10,0
1653630396033,MATH 250A,A00,087430,Spolaor; Luca,4,0,8,4
1653630396556,MATH 257A,A00,087431,Spolaor; Luca,7,0,8,1
1653630397086,MATH 258,A00,087432,Staff,9,0,10,1
1653630397608,MATH 264A,A00,087433,Warnke; Lutz Peter,5,0,8,3
1653630398136,MATH 268,A00,087434,Staff,15,0,15,0
1653630398663,MATH 269,A00,087435,Staff,14,0,15,1
1653630399275,MATH 270A,A00,087436,Nie; Jiawang,0,0,8,8
1653630399801,MATH 272A,A00,087437,Tian; Xiaochuan,0,0,8,8
1653630400328,MATH 274,A01,087439,Cheng; Li-Tien,9,0,10,1
1653630400328,MATH 274,A02,087440,Cheng; Li-Tien,10,0,10,0
1653630400852,MATH 278A,A00,087441,Staff,8,0,10,2
1653630401374,MATH 278B,A00,087442,Staff,8,0,10,2
1653630401904,MATH 278C,A00,087443,Staff,8,0,10,2
1653630402427,MATH 280A,A00,087444,Zheng; Tianyi,0,0,8,8
1653630402957,MATH 281A,A00,087445,Bradic; Jelena,0,0,8,9
1653630403506,MATH 282A,A00,087446,Zhang; Danna,0,0,8,8
1653630404028,MATH 283,A00,087447,Tesler; Glenn,0,0,0,16
1653630404553,MATH 286,B00,095535,Kemp; Todd Aahron,5,0,8,3
1653630405077,MATH 287D,B00,095536,Bradic; Jelena,5,0,8,3
1653630405602,MATH 288,A00,087450,Staff,14,0,15,1
1653630405602,MATH 288,B00,087451,Staff,15,0,15,0
1653630405602,MATH 288,C00,087452,Staff,15,0,15,0
1653630406128,MATH 290A,A00,087453,Xu; Zhouli,6,0,8,2
1653630406651,MATH 291A,A00,087454,Xu; Zhouli,7,0,8,1
1653630407175,MATH 292,A00,087455,Staff,10,0,10,0
1653630407697,MATH 295,A00,087456,Staff,50,0,50,0
1653630408219,MATH 297,001,087457,Staff,997,0,999,2
1653630967472,COGS 200,A01,087991,Staff,47,0,50,3
1653630967996,COGS 201,A01,094504,Rangel; Lara M,16,0,25,9
1653630968523,COGS 203,A00,087992,Coulson; Seana M,18,0,20,2
1653630969048,COGS 210A,001,087993,Greene; Deanna Jacquelyn,9998,0,9999,1
1653630969048,COGS 210A,002,087994,Saygin; Ayse P,9999,0,9999,0
1653630969048,COGS 210A,003,087995,Xia; Haijun,9999,0,9999,0
1653630969048,COGS 210A,004,087996,Nitz; Douglas A.,9999,0,9999,0
1653630969048,COGS 210A,005,087997,Hollan; James D.,9999,0,9999,0
1653630969048,COGS 210A,006,087998,Deak; Gedeon O.,9998,0,9999,1
1653630969048,COGS 210A,007,087999,Rossano; Federico,9999,0,9999,0
1653630969572,COGS 211A,A00,088000,Coulson; Seana M,9997,0,9999,2
1653630970095,COGS 229,A00,088002,Staff,22,0,25,3
1653630970620,COGS 260,B00,094231,Staff,17,0,20,3
1653630970620,COGS 260,A00,088004,Nitz; Douglas A.,9998,0,9999,1
1653630971148,CSE 202,A00,090110,Paturi; Ramamohan,0,0,0,0
1653630971148,CSE 202,B00,090111,Paturi; Ramamohan,0,0,0,0
1653630971675,CSE 207B,A00,090112,Heninger; Nadia A,0,0,0,0
1653630972199,CSE 208,A00,094858,Micciancio; Daniele,0,0,0,0
1653630972724,CSE 210,A00,090113,Powell; Thomas Allan,0,0,0,0
1653630973252,CSE 219,A00,090898,Staff,0,0,0,0
1653630973775,CSE 221,A00,090114,Zhou; Yuan-Yuan,0,0,0,0
1653630974301,CSE 229A,A00,090115,Porter; George M,0,0,0,0
1653630974824,CSE 229C,A00,090116,Savage; Stefan,0,0,0,0
1653630975350,CSE 230,A00,090117,Jhala; Ranjit,0,0,0,0
1653630975876,CSE 232,A00,090118,Papakonstantinou; Yannis,0,0,0,0
1653630976401,CSE 239A,A00,090121,Kumar; Arun Kumar,0,0,0,0
1653630976926,CSE 239B,A00,090122,Jhala; Ranjit,0,0,0,0
1653630977449,CSE 240A,A00,090123,Zhao; Jishen,0,0,189,189
1653630977971,CSE 243A,A00,090124,Orailoglu; Alex,0,0,15,15
1653630978495,CSE 249B,A00,090125,Kahng; Andrew Byun,12,0,20,8
1653630979018,CSE 250A,A00,090126,Berg-Kirkpatrick; Taylor D,0,0,0,0
1653630979541,CSE 252A,A00,090127,Ochoa; Benjamin Lawrence,0,0,0,0
1653630980064,CSE 258,A01,090129,McAuley; Julian John,0,0,0,0
1653630980589,CSE 258R,A01,090131,McAuley; Julian John,0,0,0,0
1653630981112,CSE 274,A00,090132,Ramamoorthi; Ravi,0,0,0,0
1653630981634,CSE 276A,A00,090133,Christensen; Henrik I,0,0,0,0
1653630982157,CSE 276C,A00,090134,Christensen; Henrik I,0,0,0,0
1653630982683,CSE 290,A00,090135,Bafna; Vineet,0,0,0,0
1653630982683,CSE 290,B00,090136,Ramamoorthi; Ravi,0,0,0,0
1653630982683,CSE 290,C00,090137,Li; Tzumao,7,0,10,3
1653630982683,CSE 290,D00,090138,Zhou; Yuan-Yuan,9,0,10,1
1653630982683,CSE 290,E00,090139,Christensen; Henrik I,8,0,10,2
1653630982683,CSE 290,F00,094053,Shalev; Aaron D,0,0,0,0
1653630983206,CSE 291,A00,090140,Munyaka; Imani N. S.,0,0,0,0
1653630983206,CSE 291,B00,094880,Yu; Qi,0,0,0,0
1653630983206,CSE 291,C00,090142,Pannuto; Patrick William,0,0,0,0
1653630983206,CSE 291,D00,094881,Zhang; Yiying,0,0,0,0
1653630983206,CSE 291,E00,095118,Su; Hao,0,0,0,0
1653630983730,CSE 293,001,094905,Bafna; Vineet,9999,0,9999,0
1653630983730,CSE 293,002,094906,Bellare; Mihir,9999,0,9999,0
1653630983730,CSE 293,003,094907,Berg-Kirkpatrick; Taylor D,9999,0,9999,0
1653630983730,CSE 293,004,094908,Christensen; Henrik I,9999,0,9999,0
1653630983730,CSE 293,005,094909,Cottrell; Garrison W,9999,0,9999,0
1653630983730,CSE 293,006,094910,Deutsch; Alin Bernard,9999,0,9999,0
1653630983730,CSE 293,007,094911,Esmaeilzadeh; Hadi,9999,0,9999,0
1653630983730,CSE 293,008,094912,Freund; Yoav,9999,0,9999,0
1653630983730,CSE 293,009,094913,Griswold; William G.,9999,0,9999,0
1653630983730,CSE 293,010,094914,Gymrek; Melissa Ann,9999,0,9999,0
1653630983730,CSE 293,011,094915,Heninger; Nadia A,9999,0,9999,0
1653630983730,CSE 293,012,094916,Impagliazzo; Russell,9999,0,9999,0
1653630983730,CSE 293,013,094917,Jhala; Ranjit,9999,0,9999,0
1653630983730,CSE 293,014,094918,Kahng; Andrew Byun,9999,0,9999,0
1653630983730,CSE 293,015,094919,Kane; Daniel Mertz,9999,0,9999,0
1653630983730,CSE 293,016,094920,Kriegman; David J,9999,0,9999,0
1653630983730,CSE 293,017,094921,Kumar; Arun Kumar,9999,0,9999,0
1653630983730,CSE 293,018,094922,Lerner; Sorin,9999,0,9999,0
1653630983730,CSE 293,019,094923,Lovett; Shachar,9999,0,9999,0
1653630983730,CSE 293,020,094924,McAuley; Julian John,9999,0,9999,0
1653630983730,CSE 293,021,094925,Micciancio; Daniele,9999,0,9999,0
1653630983730,CSE 293,022,094926,Orailoglu; Alex,9999,0,9999,0
1653630983730,CSE 293,023,094927,Paturi; Ramamohan,9999,0,9999,0
1653630983730,CSE 293,024,094928,Polikarpova; Nadezhda,9999,0,9999,0
1653630983730,CSE 293,025,094929,Politz; Joseph Gibbs,9999,0,9999,0
1653630983730,CSE 293,026,094930,Porter; George M,9999,0,9999,0
1653630983730,CSE 293,027,094931,Porter; Leonard Emerson,9999,0,9999,0
1653630983730,CSE 293,028,094932,Ramamoorthi; Ravi,9999,0,9999,0
1653630983730,CSE 293,029,094933,Sahoo; Debashis,9999,0,9999,0
1653630983730,CSE 293,030,094934,Saul; Lawrence,9999,0,9999,0
1653630983730,CSE 293,031,094935,Savage; Stefan,9999,0,9999,0
1653630983730,CSE 293,032,094936,Schulze; Jurgen P.,9999,0,9999,0
1653630983730,CSE 293,033,094937,Snoeren; Alex C.,9999,0,9999,0
1653630983730,CSE 293,034,094938,Shang; Jingbo,9999,0,9999,0
1653630983730,CSE 293,035,094939,Stefan; Deian,9999,0,9999,0
1653630983730,CSE 293,036,094940,Su; Hao,9999,0,9999,0
1653630983730,CSE 293,037,094941,Swanson; Steven James,9999,0,9999,0
1653630983730,CSE 293,038,094942,Tullsen; Dean Michael,9999,0,9999,0
1653630983730,CSE 293,039,094943,Voelker; Geoffrey M.,9999,0,9999,0
1653630983730,CSE 293,040,094944,Zhao; Jishen,9999,0,9999,0
1653630983730,CSE 293,041,094945,Zhou; Yuan-Yuan,9999,0,9999,0
1653630983730,CSE 293,042,094946,Gao; Sicun,9998,0,9999,1
1653630983730,CSE 293,043,094947,Weibel; Nadir,9999,0,9999,0
1653630983730,CSE 293,044,094948,Gupta; Rajesh K.,9999,0,9999,0
1653630984254,CSE 294,A00,090143,Porter; George M,9,0,10,1
1653630984788,DSE 200,A00,091799,Staff,50,0,50,0
1653630985314,DSE 203,A00,091800,Gupta; Amarnath,30,0,30,0
1653630985911,DSE 250,A00,091801,Deutsch; Alin Bernard,30,0,30,0
1653630986442,DSE 290,A00,091802,Altintas De Callaf; Ilkay,50,0,50,0
1653630987002,ECE 200,001,091003,Antipa; Nicholas A,9999,0,9999,0
1653630987002,ECE 200,002,091004,Atanasov; Nikolay A.,9999,0,9999,0
1653630987002,ECE 200,003,091005,Bharadia; Dinesh,9999,0,9999,0
1653630987002,ECE 200,004,091006,Cheng; Chung Kuan,9999,0,9999,0
1653630987002,ECE 200,005,091007,Cosman; Pamela C.,9999,0,9999,0
1653630987002,ECE 200,006,091008,Staff,9999,0,9999,0
1653630987002,ECE 200,007,091009,Dayeh; Shadi Ahmad,9999,0,9999,0
1653630987002,ECE 200,008,091010,Fainman; Yeshaiahu,9999,0,9999,0
1653630987002,ECE 200,009,091011,Ford; Joseph Earl,9999,0,9999,0
1653630987002,ECE 200,010,091012,Franceschetti; Massimo,9999,0,9999,0
1653630987002,ECE 200,011,091013,Fullerton; Eric E,9999,0,9999,0
1653630987002,ECE 200,012,091014,Galton; Ian A,9999,0,9999,0
1653630987002,ECE 200,013,091015,Gilja; Vikash,9999,0,9999,0
1653630987002,ECE 200,014,091016,Hall; Drew A.,9999,0,9999,0
1653630987002,ECE 200,015,091017,Hsueh; Tzu-Chien,9999,0,9999,0
1653630987002,ECE 200,016,091018,Javidi; Tara,9999,0,9999,0
1653630987002,ECE 200,017,091019,Kahng; Andrew Byun,9999,0,9999,0
1653630987002,ECE 200,018,091020,Kim; Young-Han,9999,0,9999,0
1653630987002,ECE 200,019,091021,Koushanfar; Farinaz,9999,0,9999,0
1653630987002,ECE 200,020,091022,Kuzum; Duygu,9999,0,9999,0
1653630987002,ECE 200,021,091023,Le; Hanh-Phuc,9999,0,9999,0
1653630987002,ECE 200,022,091024,Lin; Bill,9999,0,9999,0
1653630987002,ECE 200,023,091025,Liu; Zhaowei,9999,0,9999,0
1653630987002,ECE 200,024,091026,Lo; Yu-Hwa,9999,0,9999,0
1653630987002,ECE 200,025,091027,Lomakin; Vitaliy,9999,0,9999,0
1653630987002,ECE 200,026,091028,Mercier; Patrick Philip,9999,0,9999,0
1653630987002,ECE 200,027,091029,Meyer; Florian,9999,0,9999,0
1653630987002,ECE 200,028,091030,Milstein; Laurence B.,9999,0,9999,0
1653630987002,ECE 200,029,091031,Mir Arabbaygi; Siavash,9999,0,9999,0
1653630987002,ECE 200,030,091032,Mookherjea; Shayan,9999,0,9999,0
1653630987002,ECE 200,031,091033,Morris; Karcher William,9999,0,9999,0
1653630987002,ECE 200,032,091034,Ng; Tse Nga,9999,0,9999,0
1653630987002,ECE 200,033,091035,Nguyen; Truong Quang,9999,0,9999,0
1653630987002,ECE 200,034,091036,Nomura; Kenji,9999,0,9999,0
1653630987002,ECE 200,035,091037,Orlitsky; Alon,9999,0,9999,0
1653630987002,ECE 200,036,091038,Pal; Piya,9999,0,9999,0
1653630987002,ECE 200,037,091039,Papen; George C.,9999,0,9999,0
1653630987002,ECE 200,038,091040,Radic; Stojan,9999,0,9999,0
1653630987002,ECE 200,039,091041,Rao; Bhaskar D.,9999,0,9999,0
1653630987002,ECE 200,040,091042,Rao; Ramesh R,9999,0,9999,0
1653630987002,ECE 200,041,091043,Rebeiz; Gabriel,9999,0,9999,0
1653630987002,ECE 200,042,091044,Sanford; John R,9999,0,9999,0
1653630987002,ECE 200,043,091045,Siegel; Paul H.,9999,0,9999,0
1653630987002,ECE 200,044,091046,Sievenpiper; Daniel F.,9999,0,9999,0
1653630987002,ECE 200,045,091047,Sworder; David D.,9999,0,9999,0
1653630987002,ECE 200,046,091048,Taur; Yuan,9999,0,9999,0
1653630987002,ECE 200,047,091049,Touri; Behrouz,9999,0,9999,0
1653630987002,ECE 200,048,091050,Trivedi; Mohan M.,9999,0,9999,0
1653630987002,ECE 200,049,091051,Vardy; Alexander,9999,0,9999,0
1653630987002,ECE 200,050,091052,Vasconcelos; Nuno,9999,0,9999,0
1653630987002,ECE 200,051,091053,Wang; Xiaolong,9999,0,9999,0
1653630987002,ECE 200,052,091054,Xie; Pengtao,9999,0,9999,0
1653630987002,ECE 200,053,091055,Yip; Michael,9999,0,9999,0
1653630987002,ECE 200,054,091056,Zeger; Kenneth A.,9999,0,9999,0
1653630987002,ECE 200,055,091057,Zhang; Xinyu,9999,0,9999,0
1653630987002,ECE 200,056,091058,Turakhia; Yatish Girish,9999,0,9999,0
1653630987002,ECE 200,057,091059,Kang; Mingu,9999,0,9999,0
1653630987002,ECE 200,058,091060,Shi; Yuanyuan,9999,0,9999,0
1653630987002,ECE 200,059,091061,Wang; Edward Jay,9999,0,9999,0
1653630987002,ECE 200,060,091062,Zheng; Yang,9999,0,9999,0
1653630987525,ECE 201,A00,095526,Lo; Yu-Hwa,0,0,0,0
1653630988052,ECE 203,A00,091065,Mercier; Patrick Philip,0,0,0,0
1653630988576,ECE 207A,A00,091605,Liu; Thomas Tao-Ming,0,0,0,0
1653630989099,ECE 212AN,A00,091068,Nomura; Kenji,0,0,0,0
1653630989622,ECE 222A,A00,091069,Rebeiz; Gabriel,0,0,0,0
1653630990148,ECE 225A,A00,091070,Orlitsky; Alon,0,0,0,0
1653630990685,ECE 230A,A00,091071,Nomura; Kenji,0,0,0,0
1653630991212,ECE 236A,A00,091072,Dayeh; Shadi Ahmad,0,0,0,0
1653630991735,ECE 238A,A00,091073,Luo; Jian,0,0,0,0
1653630991735,ECE 238A,B00,091074,Luo; Jian,0,0,0,0
1653630992261,ECE 240A,A00,091075,Radic; Stojan,0,0,0,0
1653630992784,ECE 247A,A00,091592,Shi; Lingyan,0,0,0,0
1653630993318,ECE 250,A00,091076,Touri; Behrouz,0,0,0,0
1653630993850,ECE 251C,A00,091078,Nguyen; Truong Quang,0,0,0,0
1653630994373,ECE 253,A00,091079,Cosman; Pamela C.,0,0,0,0
1653630994898,ECE 255A,A00,091080,Orlitsky; Alon,0,0,0,0
1653630995425,ECE 257A,A00,091081,Zhang; Xinyu,0,0,0,0
1653630995952,ECE 260A,A01,091084,Eldon; John,0,0,0,0
1653630996474,ECE 264C,A00,091085,Galton; Ian A,0,0,0,0
1653630996997,ECE 265C,A00,094889,Presti; Calogero Davide,0,0,0,9
1653630997521,ECE 266,A01,091087,Hall; Drew A.,0,0,0,0
1653630998572,ECE 271A,A00,091090,Vasconcelos; Nuno,0,0,0,0
1653630999097,ECE 272B,A00,091091,Sworder; David D.,0,0,0,0
1653630999623,ECE 275A,A00,091092,Meyer; Florian,0,0,0,0
1653631000146,ECE 277,A00,091093,An; Cheolhong,0,0,0,0
1653631000668,ECE 283,A00,091094,Le; Hanh-Phuc,0,0,0,0
1653631001195,ECE 284,A00,091095,Kang; Mingu,0,0,0,0
1653631001195,ECE 284,B00,091096,Wang; Edward Jay,0,0,0,0
1653631001718,ECE 285,A00,094334,Touri; Behrouz,0,0,0,0
1653631002240,ECE 289,A00,091097,Whelan; David Arthur,0,0,0,0
1653631002763,MATH 200A,A00,087414,Salehi Golsefidy; Alireza,7,0,8,1
1653631003285,MATH 202A,A00,087415,Gill; Philip E.,2,0,8,6
1653631003806,MATH 203A,A00,087416,Oprea; Dragos N.,6,0,8,2
1653631004331,MATH 204A,A00,087417,Kedlaya; Kiran S.,6,0,8,2
1653631004855,MATH 205,A00,087418,Sorensen; Claus M,6,0,8,2
1653631005382,MATH 206A,A00,087419,Izadi; Elham,6,0,8,2
1653631005905,MATH 207A,A00,087420,Mohammadi; Amir,5,0,8,3
1653631006434,MATH 208,A00,087421,Staff,8,0,10,2
1653631006958,MATH 209,A00,087422,Staff,10,0,10,0
1653631007480,MATH 218,A00,087423,Staff,10,0,10,0
1653631008005,MATH 220A,A00,087424,Novak; Jonathan I,6,0,8,2
1653631008528,MATH 231A,A00,087425,Bejenaru; Ioan,3,0,8,5
1653631009054,MATH 240A,A00,087426,Ebenfelt; Peter F,5,0,8,3
1653631009576,MATH 243,A00,087427,Staff,9,0,10,1
1653631010107,MATH 248,A00,087429,Staff,10,0,10,0
1653631010633,MATH 250A,A00,087430,Spolaor; Luca,4,0,8,4
1653631011155,MATH 257A,A00,087431,Spolaor; Luca,7,0,8,1
1653631011677,MATH 258,A00,087432,Staff,9,0,10,1
1653631012200,MATH 264A,A00,087433,Warnke; Lutz Peter,5,0,8,3
1653631012722,MATH 268,A00,087434,Staff,15,0,15,0
1653631013245,MATH 269,A00,087435,Staff,14,0,15,1
1653631013767,MATH 270A,A00,087436,Nie; Jiawang,0,0,8,8
1653631014294,MATH 272A,A00,087437,Tian; Xiaochuan,0,0,8,8
1653631014818,MATH 274,A01,087439,Cheng; Li-Tien,9,0,10,1
1653631014818,MATH 274,A02,087440,Cheng; Li-Tien,10,0,10,0
1653631015342,MATH 278A,A00,087441,Staff,8,0,10,2
1653631015868,MATH 278B,A00,087442,Staff,8,0,10,2
1653631016391,MATH 278C,A00,087443,Staff,8,0,10,2
1653631016921,MATH 280A,A00,087444,Zheng; Tianyi,0,0,8,8
1653631017443,MATH 281A,A00,087445,Bradic; Jelena,0,0,8,9
1653631017969,MATH 282A,A00,087446,Zhang; Danna,0,0,8,8
1653631018492,MATH 283,A00,087447,Tesler; Glenn,0,0,0,16
1653631019014,MATH 286,B00,095535,Kemp; Todd Aahron,5,0,8,3
1653631019539,MATH 287D,B00,095536,Bradic; Jelena,5,0,8,3
1653631020062,MATH 288,A00,087450,Staff,14,0,15,1
1653631020062,MATH 288,B00,087451,Staff,15,0,15,0
1653631020062,MATH 288,C00,087452,Staff,15,0,15,0
1653631020591,MATH 290A,A00,087453,Xu; Zhouli,6,0,8,2
1653631021117,MATH 291A,A00,087454,Xu; Zhouli,7,0,8,1
1653631021640,MATH 292,A00,087455,Staff,10,0,10,0
1653631022177,MATH 295,A00,087456,Staff,50,0,50,0
1653631022707,MATH 297,001,087457,Staff,997,0,999,2
1653631581886,COGS 200,A01,087991,Staff,47,0,50,3
1653631582412,COGS 201,A01,094504,Rangel; Lara M,16,0,25,9
1653631582939,COGS 203,A00,087992,Coulson; Seana M,18,0,20,2
1653631583469,COGS 210A,001,087993,Greene; Deanna Jacquelyn,9998,0,9999,1
1653631583469,COGS 210A,002,087994,Saygin; Ayse P,9999,0,9999,0
1653631583469,COGS 210A,003,087995,Xia; Haijun,9999,0,9999,0
1653631583469,COGS 210A,004,087996,Nitz; Douglas A.,9999,0,9999,0
1653631583469,COGS 210A,005,087997,Hollan; James D.,9999,0,9999,0
1653631583469,COGS 210A,006,087998,Deak; Gedeon O.,9998,0,9999,1
1653631583469,COGS 210A,007,087999,Rossano; Federico,9999,0,9999,0
1653631583992,COGS 211A,A00,088000,Coulson; Seana M,9997,0,9999,2
1653631584522,COGS 229,A00,088002,Staff,22,0,25,3
1653631585048,COGS 260,B00,094231,Staff,17,0,20,3
1653631585048,COGS 260,A00,088004,Nitz; Douglas A.,9998,0,9999,1
1653631585581,CSE 202,A00,090110,Paturi; Ramamohan,0,0,0,0
1653631585581,CSE 202,B00,090111,Paturi; Ramamohan,0,0,0,0
1653631586110,CSE 207B,A00,090112,Heninger; Nadia A,0,0,0,0
1653631586639,CSE 208,A00,094858,Micciancio; Daniele,0,0,0,0
1653631587163,CSE 210,A00,090113,Powell; Thomas Allan,0,0,0,0
1653631587686,CSE 219,A00,090898,Staff,0,0,0,0
1653631588220,CSE 221,A00,090114,Zhou; Yuan-Yuan,0,0,0,0
1653631588759,CSE 229A,A00,090115,Porter; George M,0,0,0,0
1653631589282,CSE 229C,A00,090116,Savage; Stefan,0,0,0,0
1653631589806,CSE 230,A00,090117,Jhala; Ranjit,0,0,0,0
1653631590342,CSE 232,A00,090118,Papakonstantinou; Yannis,0,0,0,0
1653631590866,CSE 239A,A00,090121,Kumar; Arun Kumar,0,0,0,0
1653631591390,CSE 239B,A00,090122,Jhala; Ranjit,0,0,0,0
1653631591913,CSE 240A,A00,090123,Zhao; Jishen,0,0,189,189
1653631592437,CSE 243A,A00,090124,Orailoglu; Alex,0,0,15,15
1653631592967,CSE 249B,A00,090125,Kahng; Andrew Byun,12,0,20,8
1653631593493,CSE 250A,A00,090126,Berg-Kirkpatrick; Taylor D,0,0,0,0
1653631594016,CSE 252A,A00,090127,Ochoa; Benjamin Lawrence,0,0,0,0
1653631594540,CSE 258,A01,090129,McAuley; Julian John,0,0,0,0
1653631595063,CSE 258R,A01,090131,McAuley; Julian John,0,0,0,0
1653631595591,CSE 274,A00,090132,Ramamoorthi; Ravi,0,0,0,0
1653631596127,CSE 276A,A00,090133,Christensen; Henrik I,0,0,0,0
1653631596651,CSE 276C,A00,090134,Christensen; Henrik I,0,0,0,0
1653631597175,CSE 290,A00,090135,Bafna; Vineet,0,0,0,0
1653631597175,CSE 290,B00,090136,Ramamoorthi; Ravi,0,0,0,0
1653631597175,CSE 290,C00,090137,Li; Tzumao,7,0,10,3
1653631597175,CSE 290,D00,090138,Zhou; Yuan-Yuan,9,0,10,1
1653631597175,CSE 290,E00,090139,Christensen; Henrik I,8,0,10,2
1653631597175,CSE 290,F00,094053,Shalev; Aaron D,0,0,0,0
1653631597707,CSE 291,A00,090140,Munyaka; Imani N. S.,0,0,0,0
1653631597707,CSE 291,B00,094880,Yu; Qi,0,0,0,0
1653631597707,CSE 291,C00,090142,Pannuto; Patrick William,0,0,0,0
1653631597707,CSE 291,D00,094881,Zhang; Yiying,0,0,0,0
1653631597707,CSE 291,E00,095118,Su; Hao,0,0,0,0
1653631598253,CSE 293,001,094905,Bafna; Vineet,9999,0,9999,0
1653631598253,CSE 293,002,094906,Bellare; Mihir,9999,0,9999,0
1653631598253,CSE 293,003,094907,Berg-Kirkpatrick; Taylor D,9999,0,9999,0
1653631598253,CSE 293,004,094908,Christensen; Henrik I,9999,0,9999,0
1653631598253,CSE 293,005,094909,Cottrell; Garrison W,9999,0,9999,0
1653631598253,CSE 293,006,094910,Deutsch; Alin Bernard,9999,0,9999,0
1653631598253,CSE 293,007,094911,Esmaeilzadeh; Hadi,9999,0,9999,0
1653631598253,CSE 293,008,094912,Freund; Yoav,9999,0,9999,0
1653631598253,CSE 293,009,094913,Griswold; William G.,9999,0,9999,0
1653631598253,CSE 293,010,094914,Gymrek; Melissa Ann,9999,0,9999,0
1653631598253,CSE 293,011,094915,Heninger; Nadia A,9999,0,9999,0
1653631598253,CSE 293,012,094916,Impagliazzo; Russell,9999,0,9999,0
1653631598253,CSE 293,013,094917,Jhala; Ranjit,9999,0,9999,0
1653631598253,CSE 293,014,094918,Kahng; Andrew Byun,9999,0,9999,0
1653631598253,CSE 293,015,094919,Kane; Daniel Mertz,9999,0,9999,0
1653631598253,CSE 293,016,094920,Kriegman; David J,9999,0,9999,0
1653631598253,CSE 293,017,094921,Kumar; Arun Kumar,9999,0,9999,0
1653631598253,CSE 293,018,094922,Lerner; Sorin,9999,0,9999,0
1653631598253,CSE 293,019,094923,Lovett; Shachar,9999,0,9999,0
1653631598253,CSE 293,020,094924,McAuley; Julian John,9999,0,9999,0
1653631598253,CSE 293,021,094925,Micciancio; Daniele,9999,0,9999,0
1653631598253,CSE 293,022,094926,Orailoglu; Alex,9999,0,9999,0
1653631598253,CSE 293,023,094927,Paturi; Ramamohan,9999,0,9999,0
1653631598253,CSE 293,024,094928,Polikarpova; Nadezhda,9999,0,9999,0
1653631598253,CSE 293,025,094929,Politz; Joseph Gibbs,9999,0,9999,0
1653631598253,CSE 293,026,094930,Porter; George M,9999,0,9999,0
1653631598253,CSE 293,027,094931,Porter; Leonard Emerson,9999,0,9999,0
1653631598253,CSE 293,028,094932,Ramamoorthi; Ravi,9999,0,9999,0
1653631598253,CSE 293,029,094933,Sahoo; Debashis,9999,0,9999,0
1653631598253,CSE 293,030,094934,Saul; Lawrence,9999,0,9999,0
1653631598253,CSE 293,031,094935,Savage; Stefan,9999,0,9999,0
1653631598253,CSE 293,032,094936,Schulze; Jurgen P.,9999,0,9999,0
1653631598253,CSE 293,033,094937,Snoeren; Alex C.,9999,0,9999,0
1653631598253,CSE 293,034,094938,Shang; Jingbo,9999,0,9999,0
1653631598253,CSE 293,035,094939,Stefan; Deian,9999,0,9999,0
1653631598253,CSE 293,036,094940,Su; Hao,9999,0,9999,0
1653631598253,CSE 293,037,094941,Swanson; Steven James,9999,0,9999,0
1653631598253,CSE 293,038,094942,Tullsen; Dean Michael,9999,0,9999,0
1653631598253,CSE 293,039,094943,Voelker; Geoffrey M.,9999,0,9999,0
1653631598253,CSE 293,040,094944,Zhao; Jishen,9999,0,9999,0
1653631598253,CSE 293,041,094945,Zhou; Yuan-Yuan,9999,0,9999,0
1653631598253,CSE 293,042,094946,Gao; Sicun,9998,0,9999,1
1653631598253,CSE 293,043,094947,Weibel; Nadir,9999,0,9999,0
1653631598253,CSE 293,044,094948,Gupta; Rajesh K.,9999,0,9999,0
1653631598776,CSE 294,A00,090143,Porter; George M,9,0,10,1
1653631599298,DSE 200,A00,091799,Staff,50,0,50,0
1653631599821,DSE 203,A00,091800,Gupta; Amarnath,30,0,30,0
1653631600342,DSE 250,A00,091801,Deutsch; Alin Bernard,30,0,30,0
1653631600866,DSE 290,A00,091802,Altintas De Callaf; Ilkay,50,0,50,0
1653631601398,ECE 200,001,091003,Antipa; Nicholas A,9999,0,9999,0
1653631601398,ECE 200,002,091004,Atanasov; Nikolay A.,9999,0,9999,0
1653631601398,ECE 200,003,091005,Bharadia; Dinesh,9999,0,9999,0
1653631601398,ECE 200,004,091006,Cheng; Chung Kuan,9999,0,9999,0
1653631601398,ECE 200,005,091007,Cosman; Pamela C.,9999,0,9999,0
1653631601398,ECE 200,006,091008,Staff,9999,0,9999,0
1653631601398,ECE 200,007,091009,Dayeh; Shadi Ahmad,9999,0,9999,0
1653631601398,ECE 200,008,091010,Fainman; Yeshaiahu,9999,0,9999,0
1653631601398,ECE 200,009,091011,Ford; Joseph Earl,9999,0,9999,0
1653631601398,ECE 200,010,091012,Franceschetti; Massimo,9999,0,9999,0
1653631601398,ECE 200,011,091013,Fullerton; Eric E,9999,0,9999,0
1653631601398,ECE 200,012,091014,Galton; Ian A,9999,0,9999,0
1653631601398,ECE 200,013,091015,Gilja; Vikash,9999,0,9999,0
1653631601398,ECE 200,014,091016,Hall; Drew A.,9999,0,9999,0
1653631601398,ECE 200,015,091017,Hsueh; Tzu-Chien,9999,0,9999,0
1653631601398,ECE 200,016,091018,Javidi; Tara,9999,0,9999,0
1653631601398,ECE 200,017,091019,Kahng; Andrew Byun,9999,0,9999,0
1653631601398,ECE 200,018,091020,Kim; Young-Han,9999,0,9999,0
1653631601398,ECE 200,019,091021,Koushanfar; Farinaz,9999,0,9999,0
1653631601398,ECE 200,020,091022,Kuzum; Duygu,9999,0,9999,0
1653631601398,ECE 200,021,091023,Le; Hanh-Phuc,9999,0,9999,0
1653631601398,ECE 200,022,091024,Lin; Bill,9999,0,9999,0
1653631601398,ECE 200,023,091025,Liu; Zhaowei,9999,0,9999,0
1653631601398,ECE 200,024,091026,Lo; Yu-Hwa,9999,0,9999,0
1653631601398,ECE 200,025,091027,Lomakin; Vitaliy,9999,0,9999,0
1653631601398,ECE 200,026,091028,Mercier; Patrick Philip,9999,0,9999,0
1653631601398,ECE 200,027,091029,Meyer; Florian,9999,0,9999,0
1653631601398,ECE 200,028,091030,Milstein; Laurence B.,9999,0,9999,0
1653631601398,ECE 200,029,091031,Mir Arabbaygi; Siavash,9999,0,9999,0
1653631601398,ECE 200,030,091032,Mookherjea; Shayan,9999,0,9999,0
1653631601398,ECE 200,031,091033,Morris; Karcher William,9999,0,9999,0
1653631601398,ECE 200,032,091034,Ng; Tse Nga,9999,0,9999,0
1653631601398,ECE 200,033,091035,Nguyen; Truong Quang,9999,0,9999,0
1653631601398,ECE 200,034,091036,Nomura; Kenji,9999,0,9999,0
1653631601398,ECE 200,035,091037,Orlitsky; Alon,9999,0,9999,0
1653631601398,ECE 200,036,091038,Pal; Piya,9999,0,9999,0
1653631601398,ECE 200,037,091039,Papen; George C.,9999,0,9999,0
1653631601398,ECE 200,038,091040,Radic; Stojan,9999,0,9999,0
1653631601398,ECE 200,039,091041,Rao; Bhaskar D.,9999,0,9999,0
1653631601398,ECE 200,040,091042,Rao; Ramesh R,9999,0,9999,0
1653631601398,ECE 200,041,091043,Rebeiz; Gabriel,9999,0,9999,0
1653631601398,ECE 200,042,091044,Sanford; John R,9999,0,9999,0
1653631601398,ECE 200,043,091045,Siegel; Paul H.,9999,0,9999,0
1653631601398,ECE 200,044,091046,Sievenpiper; Daniel F.,9999,0,9999,0
1653631601398,ECE 200,045,091047,Sworder; David D.,9999,0,9999,0
1653631601398,ECE 200,046,091048,Taur; Yuan,9999,0,9999,0
1653631601398,ECE 200,047,091049,Touri; Behrouz,9999,0,9999,0
1653631601398,ECE 200,048,091050,Trivedi; Mohan M.,9999,0,9999,0
1653631601398,ECE 200,049,091051,Vardy; Alexander,9999,0,9999,0
1653631601398,ECE 200,050,091052,Vasconcelos; Nuno,9999,0,9999,0
1653631601398,ECE 200,051,091053,Wang; Xiaolong,9999,0,9999,0
1653631601398,ECE 200,052,091054,Xie; Pengtao,9999,0,9999,0
1653631601398,ECE 200,053,091055,Yip; Michael,9999,0,9999,0
1653631601398,ECE 200,054,091056,Zeger; Kenneth A.,9999,0,9999,0
1653631601398,ECE 200,055,091057,Zhang; Xinyu,9999,0,9999,0
1653631601398,ECE 200,056,091058,Turakhia; Yatish Girish,9999,0,9999,0
1653631601398,ECE 200,057,091059,Kang; Mingu,9999,0,9999,0
1653631601398,ECE 200,058,091060,Shi; Yuanyuan,9999,0,9999,0
1653631601398,ECE 200,059,091061,Wang; Edward Jay,9999,0,9999,0
1653631601398,ECE 200,060,091062,Zheng; Yang,9999,0,9999,0
1653631601921,ECE 201,A00,095526,Lo; Yu-Hwa,0,0,0,0
1653631602444,ECE 203,A00,091065,Mercier; Patrick Philip,0,0,0,0
1653631602968,ECE 207A,A00,091605,Liu; Thomas Tao-Ming,0,0,0,0
1653631603490,ECE 212AN,A00,091068,Nomura; Kenji,0,0,0,0
1653631604020,ECE 222A,A00,091069,Rebeiz; Gabriel,0,0,0,0
1653631604543,ECE 225A,A00,091070,Orlitsky; Alon,0,0,0,0
1653631605068,ECE 230A,A00,091071,Nomura; Kenji,0,0,0,0
1653631605597,ECE 236A,A00,091072,Dayeh; Shadi Ahmad,0,0,0,0
1653631606124,ECE 238A,A00,091073,Luo; Jian,0,0,0,0
1653631606124,ECE 238A,B00,091074,Luo; Jian,0,0,0,0
1653631606646,ECE 240A,A00,091075,Radic; Stojan,0,0,0,0
1653631607169,ECE 247A,A00,091592,Shi; Lingyan,0,0,0,0
1653631607692,ECE 250,A00,091076,Touri; Behrouz,0,0,0,0
1653631608215,ECE 251C,A00,091078,Nguyen; Truong Quang,0,0,0,0
1653631608740,ECE 253,A00,091079,Cosman; Pamela C.,0,0,0,0
1653631609276,ECE 255A,A00,091080,Orlitsky; Alon,0,0,0,0
1653631609801,ECE 257A,A00,091081,Zhang; Xinyu,0,0,0,0
1653631610327,ECE 260A,A01,091084,Eldon; John,0,0,0,0
1653631610852,ECE 264C,A00,091085,Galton; Ian A,0,0,0,0
1653631611374,ECE 265C,A00,094889,Presti; Calogero Davide,0,0,0,9
1653631611898,ECE 266,A01,091087,Hall; Drew A.,0,0,0,0
1653631612950,ECE 271A,A00,091090,Vasconcelos; Nuno,0,0,0,0
1653631613480,ECE 272B,A00,091091,Sworder; David D.,0,0,0,0
1653631614003,ECE 275A,A00,091092,Meyer; Florian,0,0,0,0
1653631614532,ECE 277,A00,091093,An; Cheolhong,0,0,0,0
1653631615057,ECE 283,A00,091094,Le; Hanh-Phuc,0,0,0,0
1653631615581,ECE 284,A00,091095,Kang; Mingu,0,0,0,0
1653631615581,ECE 284,B00,091096,Wang; Edward Jay,0,0,0,0
1653631616122,ECE 285,A00,094334,Touri; Behrouz,0,0,0,0
1653631616646,ECE 289,A00,091097,Whelan; David Arthur,0,0,0,0
1653631617169,MATH 200A,A00,087414,Salehi Golsefidy; Alireza,7,0,8,1
1653631617698,MATH 202A,A00,087415,Gill; Philip E.,2,0,8,6
1653631618221,MATH 203A,A00,087416,Oprea; Dragos N.,6,0,8,2
1653631618743,MATH 204A,A00,087417,Kedlaya; Kiran S.,6,0,8,2
1653631619268,MATH 205,A00,087418,Sorensen; Claus M,6,0,8,2
1653631619794,MATH 206A,A00,087419,Izadi; Elham,6,0,8,2
1653631620330,MATH 207A,A00,087420,Mohammadi; Amir,5,0,8,3
1653631620854,MATH 208,A00,087421,Staff,8,0,10,2
1653631621380,MATH 209,A00,087422,Staff,10,0,10,0
1653631621903,MATH 218,A00,087423,Staff,10,0,10,0
1653631622429,MATH 220A,A00,087424,Novak; Jonathan I,6,0,8,2
1653631622953,MATH 231A,A00,087425,Bejenaru; Ioan,3,0,8,5
1653631623476,MATH 240A,A00,087426,Ebenfelt; Peter F,5,0,8,3
1653631623998,MATH 243,A00,087427,Staff,9,0,10,1
1653631624520,MATH 248,A00,087429,Staff,10,0,10,0
1653631625044,MATH 250A,A00,087430,Spolaor; Luca,4,0,8,4
1653631625649,MATH 257A,A00,087431,Spolaor; Luca,7,0,8,1
1653631626175,MATH 258,A00,087432,Staff,9,0,10,1
1653631626705,MATH 264A,A00,087433,Warnke; Lutz Peter,5,0,8,3
1653631627231,MATH 268,A00,087434,Staff,15,0,15,0
1653631627753,MATH 269,A00,087435,Staff,14,0,15,1
1653631628277,MATH 270A,A00,087436,Nie; Jiawang,0,0,8,8
1653631628809,MATH 272A,A00,087437,Tian; Xiaochuan,0,0,8,8
1653631629336,MATH 274,A01,087439,Cheng; Li-Tien,9,0,10,1
1653631629336,MATH 274,A02,087440,Cheng; Li-Tien,10,0,10,0
1653631629862,MATH 278A,A00,087441,Staff,8,0,10,2
1653631630385,MATH 278B,A00,087442,Staff,8,0,10,2
1653631630911,MATH 278C,A00,087443,Staff,8,0,10,2
1653631631433,MATH 280A,A00,087444,Zheng; Tianyi,0,0,8,8
1653631631971,MATH 281A,A00,087445,Bradic; Jelena,0,0,8,9
1653631632498,MATH 282A,A00,087446,Zhang; Danna,0,0,8,8
1653631633027,MATH 283,A00,087447,Tesler; Glenn,0,0,0,16
1653631633556,MATH 286,B00,095535,Kemp; Todd Aahron,5,0,8,3
1653631634095,MATH 287D,B00,095536,Bradic; Jelena,5,0,8,3
1653631634633,MATH 288,A00,087450,Staff,14,0,15,1
1653631634633,MATH 288,B00,087451,Staff,15,0,15,0
1653631634633,MATH 288,C00,087452,Staff,15,0,15,0
1653631635166,MATH 290A,A00,087453,Xu; Zhouli,6,0,8,2
1653631635693,MATH 291A,A00,087454,Xu; Zhouli,7,0,8,1
1653631636218,MATH 292,A00,087455,Staff,10,0,10,0
1653631636741,MATH 295,A00,087456,Staff,50,0,50,0
1653631637263,MATH 297,001,087457,Staff,997,0,999,2
1653632196722,COGS 200,A01,087991,Staff,47,0,50,3
1653632197255,COGS 201,A01,094504,Rangel; Lara M,16,0,25,9
1653632197779,COGS 203,A00,087992,Coulson; Seana M,18,0,20,2
1653632198305,COGS 210A,001,087993,Greene; Deanna Jacquelyn,9998,0,9999,1
1653632198305,COGS 210A,002,087994,Saygin; Ayse P,9999,0,9999,0
1653632198305,COGS 210A,003,087995,Xia; Haijun,9999,0,9999,0
1653632198305,COGS 210A,004,087996,Nitz; Douglas A.,9999,0,9999,0
1653632198305,COGS 210A,005,087997,Hollan; James D.,9999,0,9999,0
1653632198305,COGS 210A,006,087998,Deak; Gedeon O.,9998,0,9999,1
1653632198305,COGS 210A,007,087999,Rossano; Federico,9999,0,9999,0
1653632198828,COGS 211A,A00,088000,Coulson; Seana M,9997,0,9999,2
1653632199352,COGS 229,A00,088002,Staff,22,0,25,3
1653632199878,COGS 260,B00,094231,Staff,17,0,20,3
1653632199878,COGS 260,A00,088004,Nitz; Douglas A.,9998,0,9999,1
1653632200406,CSE 202,A00,090110,Paturi; Ramamohan,0,0,0,0
1653632200406,CSE 202,B00,090111,Paturi; Ramamohan,0,0,0,0
1653632200928,CSE 207B,A00,090112,Heninger; Nadia A,0,0,0,0
1653632201450,CSE 208,A00,094858,Micciancio; Daniele,0,0,0,0
1653632201975,CSE 210,A00,090113,Powell; Thomas Allan,0,0,0,0
1653632202501,CSE 219,A00,090898,Staff,0,0,0,0
1653632203025,CSE 221,A00,090114,Zhou; Yuan-Yuan,0,0,0,0
1653632203548,CSE 229A,A00,090115,Porter; George M,0,0,0,0
1653632204074,CSE 229C,A00,090116,Savage; Stefan,0,0,0,0
1653632204599,CSE 230,A00,090117,Jhala; Ranjit,0,0,0,0
1653632205122,CSE 232,A00,090118,Papakonstantinou; Yannis,0,0,0,0
1653632205645,CSE 239A,A00,090121,Kumar; Arun Kumar,0,0,0,0
1653632206171,CSE 239B,A00,090122,Jhala; Ranjit,0,0,0,0
1653632206695,CSE 240A,A00,090123,Zhao; Jishen,0,0,189,189
1653632207218,CSE 243A,A00,090124,Orailoglu; Alex,0,0,15,15
1653632207740,CSE 249B,A00,090125,Kahng; Andrew Byun,12,0,20,8
1653632208266,CSE 250A,A00,090126,Berg-Kirkpatrick; Taylor D,0,0,0,0
1653632208788,CSE 252A,A00,090127,Ochoa; Benjamin Lawrence,0,0,0,0
1653632209318,CSE 258,A01,090129,McAuley; Julian John,0,0,0,0
1653632209844,CSE 258R,A01,090131,McAuley; Julian John,0,0,0,0
1653632210366,CSE 274,A00,090132,Ramamoorthi; Ravi,0,0,0,0
1653632210892,CSE 276A,A00,090133,Christensen; Henrik I,0,0,0,0
1653632211415,CSE 276C,A00,090134,Christensen; Henrik I,0,0,0,0
1653632211944,CSE 290,A00,090135,Bafna; Vineet,0,0,0,0
1653632211944,CSE 290,B00,090136,Ramamoorthi; Ravi,0,0,0,0
1653632211944,CSE 290,C00,090137,Li; Tzumao,7,0,10,3
1653632211944,CSE 290,D00,090138,Zhou; Yuan-Yuan,9,0,10,1
1653632211944,CSE 290,E00,090139,Christensen; Henrik I,8,0,10,2
1653632211944,CSE 290,F00,094053,Shalev; Aaron D,0,0,0,0
1653632212564,CSE 291,A00,090140,Munyaka; Imani N. S.,0,0,0,0
1653632212564,CSE 291,B00,094880,Yu; Qi,0,0,0,0
1653632212564,CSE 291,C00,090142,Pannuto; Patrick William,0,0,0,0
1653632212564,CSE 291,D00,094881,Zhang; Yiying,0,0,0,0
1653632212564,CSE 291,E00,095118,Su; Hao,0,0,0,0
1653632213112,CSE 293,001,094905,Bafna; Vineet,9999,0,9999,0
1653632213112,CSE 293,002,094906,Bellare; Mihir,9999,0,9999,0
1653632213112,CSE 293,003,094907,Berg-Kirkpatrick; Taylor D,9999,0,9999,0
1653632213112,CSE 293,004,094908,Christensen; Henrik I,9999,0,9999,0
1653632213112,CSE 293,005,094909,Cottrell; Garrison W,9999,0,9999,0
1653632213112,CSE 293,006,094910,Deutsch; Alin Bernard,9999,0,9999,0
1653632213112,CSE 293,007,094911,Esmaeilzadeh; Hadi,9999,0,9999,0
1653632213112,CSE 293,008,094912,Freund; Yoav,9999,0,9999,0
1653632213112,CSE 293,009,094913,Griswold; William G.,9999,0,9999,0
1653632213112,CSE 293,010,094914,Gymrek; Melissa Ann,9999,0,9999,0
1653632213112,CSE 293,011,094915,Heninger; Nadia A,9999,0,9999,0
1653632213112,CSE 293,012,094916,Impagliazzo; Russell,9999,0,9999,0
1653632213112,CSE 293,013,094917,Jhala; Ranjit,9999,0,9999,0
1653632213112,CSE 293,014,094918,Kahng; Andrew Byun,9999,0,9999,0
1653632213112,CSE 293,015,094919,Kane; Daniel Mertz,9999,0,9999,0
1653632213112,CSE 293,016,094920,Kriegman; David J,9999,0,9999,0
1653632213112,CSE 293,017,094921,Kumar; Arun Kumar,9999,0,9999,0
1653632213112,CSE 293,018,094922,Lerner; Sorin,9999,0,9999,0
1653632213112,CSE 293,019,094923,Lovett; Shachar,9999,0,9999,0
1653632213112,CSE 293,020,094924,McAuley; Julian John,9999,0,9999,0
1653632213112,CSE 293,021,094925,Micciancio; Daniele,9999,0,9999,0
1653632213112,CSE 293,022,094926,Orailoglu; Alex,9999,0,9999,0
1653632213112,CSE 293,023,094927,Paturi; Ramamohan,9999,0,9999,0
1653632213112,CSE 293,024,094928,Polikarpova; Nadezhda,9999,0,9999,0
1653632213112,CSE 293,025,094929,Politz; Joseph Gibbs,9999,0,9999,0
1653632213112,CSE 293,026,094930,Porter; George M,9999,0,9999,0
1653632213112,CSE 293,027,094931,Porter; Leonard Emerson,9999,0,9999,0
1653632213112,CSE 293,028,094932,Ramamoorthi; Ravi,9999,0,9999,0
1653632213112,CSE 293,029,094933,Sahoo; Debashis,9999,0,9999,0
1653632213112,CSE 293,030,094934,Saul; Lawrence,9999,0,9999,0
1653632213112,CSE 293,031,094935,Savage; Stefan,9999,0,9999,0
1653632213112,CSE 293,032,094936,Schulze; Jurgen P.,9999,0,9999,0
1653632213112,CSE 293,033,094937,Snoeren; Alex C.,9999,0,9999,0
1653632213112,CSE 293,034,094938,Shang; Jingbo,9999,0,9999,0
1653632213112,CSE 293,035,094939,Stefan; Deian,9999,0,9999,0
1653632213112,CSE 293,036,094940,Su; Hao,9999,0,9999,0
1653632213112,CSE 293,037,094941,Swanson; Steven James,9999,0,9999,0
1653632213112,CSE 293,038,094942,Tullsen; Dean Michael,9999,0,9999,0
1653632213112,CSE 293,039,094943,Voelker; Geoffrey M.,9999,0,9999,0
1653632213112,CSE 293,040,094944,Zhao; Jishen,9999,0,9999,0
1653632213112,CSE 293,041,094945,Zhou; Yuan-Yuan,9999,0,9999,0
1653632213112,CSE 293,042,094946,Gao; Sicun,9998,0,9999,1
1653632213112,CSE 293,043,094947,Weibel; Nadir,9999,0,9999,0
1653632213112,CSE 293,044,094948,Gupta; Rajesh K.,9999,0,9999,0
1653632213634,CSE 294,A00,090143,Porter; George M,9,0,10,1
1653632214157,DSE 200,A00,091799,Staff,50,0,50,0
1653632214684,DSE 203,A00,091800,Gupta; Amarnath,30,0,30,0
1653632215207,DSE 250,A00,091801,Deutsch; Alin Bernard,30,0,30,0
1653632215732,DSE 290,A00,091802,Altintas De Callaf; Ilkay,50,0,50,0
1653632216267,ECE 200,001,091003,Antipa; Nicholas A,9999,0,9999,0
1653632216267,ECE 200,002,091004,Atanasov; Nikolay A.,9999,0,9999,0
1653632216267,ECE 200,003,091005,Bharadia; Dinesh,9999,0,9999,0
1653632216267,ECE 200,004,091006,Cheng; Chung Kuan,9999,0,9999,0
1653632216267,ECE 200,005,091007,Cosman; Pamela C.,9999,0,9999,0
1653632216267,ECE 200,006,091008,Staff,9999,0,9999,0
1653632216267,ECE 200,007,091009,Dayeh; Shadi Ahmad,9999,0,9999,0
1653632216267,ECE 200,008,091010,Fainman; Yeshaiahu,9999,0,9999,0
1653632216267,ECE 200,009,091011,Ford; Joseph Earl,9999,0,9999,0
1653632216267,ECE 200,010,091012,Franceschetti; Massimo,9999,0,9999,0
1653632216267,ECE 200,011,091013,Fullerton; Eric E,9999,0,9999,0
1653632216267,ECE 200,012,091014,Galton; Ian A,9999,0,9999,0
1653632216267,ECE 200,013,091015,Gilja; Vikash,9999,0,9999,0
1653632216267,ECE 200,014,091016,Hall; Drew A.,9999,0,9999,0
1653632216267,ECE 200,015,091017,Hsueh; Tzu-Chien,9999,0,9999,0
1653632216267,ECE 200,016,091018,Javidi; Tara,9999,0,9999,0
1653632216267,ECE 200,017,091019,Kahng; Andrew Byun,9999,0,9999,0
1653632216267,ECE 200,018,091020,Kim; Young-Han,9999,0,9999,0
1653632216267,ECE 200,019,091021,Koushanfar; Farinaz,9999,0,9999,0
1653632216267,ECE 200,020,091022,Kuzum; Duygu,9999,0,9999,0
1653632216267,ECE 200,021,091023,Le; Hanh-Phuc,9999,0,9999,0
1653632216267,ECE 200,022,091024,Lin; Bill,9999,0,9999,0
1653632216267,ECE 200,023,091025,Liu; Zhaowei,9999,0,9999,0
1653632216267,ECE 200,024,091026,Lo; Yu-Hwa,9999,0,9999,0
1653632216267,ECE 200,025,091027,Lomakin; Vitaliy,9999,0,9999,0
1653632216267,ECE 200,026,091028,Mercier; Patrick Philip,9999,0,9999,0
1653632216267,ECE 200,027,091029,Meyer; Florian,9999,0,9999,0
1653632216267,ECE 200,028,091030,Milstein; Laurence B.,9999,0,9999,0
1653632216267,ECE 200,029,091031,Mir Arabbaygi; Siavash,9999,0,9999,0
1653632216267,ECE 200,030,091032,Mookherjea; Shayan,9999,0,9999,0
1653632216267,ECE 200,031,091033,Morris; Karcher William,9999,0,9999,0
1653632216267,ECE 200,032,091034,Ng; Tse Nga,9999,0,9999,0
1653632216267,ECE 200,033,091035,Nguyen; Truong Quang,9999,0,9999,0
1653632216267,ECE 200,034,091036,Nomura; Kenji,9999,0,9999,0
1653632216267,ECE 200,035,091037,Orlitsky; Alon,9999,0,9999,0
1653632216267,ECE 200,036,091038,Pal; Piya,9999,0,9999,0
1653632216267,ECE 200,037,091039,Papen; George C.,9999,0,9999,0
1653632216267,ECE 200,038,091040,Radic; Stojan,9999,0,9999,0
1653632216267,ECE 200,039,091041,Rao; Bhaskar D.,9999,0,9999,0
1653632216267,ECE 200,040,091042,Rao; Ramesh R,9999,0,9999,0
1653632216267,ECE 200,041,091043,Rebeiz; Gabriel,9999,0,9999,0
1653632216267,ECE 200,042,091044,Sanford; John R,9999,0,9999,0
1653632216267,ECE 200,043,091045,Siegel; Paul H.,9999,0,9999,0
1653632216267,ECE 200,044,091046,Sievenpiper; Daniel F.,9999,0,9999,0
1653632216267,ECE 200,045,091047,Sworder; David D.,9999,0,9999,0
1653632216267,ECE 200,046,091048,Taur; Yuan,9999,0,9999,0
1653632216267,ECE 200,047,091049,Touri; Behrouz,9999,0,9999,0
1653632216267,ECE 200,048,091050,Trivedi; Mohan M.,9999,0,9999,0
1653632216267,ECE 200,049,091051,Vardy; Alexander,9999,0,9999,0
1653632216267,ECE 200,050,091052,Vasconcelos; Nuno,9999,0,9999,0
1653632216267,ECE 200,051,091053,Wang; Xiaolong,9999,0,9999,0
1653632216267,ECE 200,052,091054,Xie; Pengtao,9999,0,9999,0
1653632216267,ECE 200,053,091055,Yip; Michael,9999,0,9999,0
1653632216267,ECE 200,054,091056,Zeger; Kenneth A.,9999,0,9999,0
1653632216267,ECE 200,055,091057,Zhang; Xinyu,9999,0,9999,0
1653632216267,ECE 200,056,091058,Turakhia; Yatish Girish,9999,0,9999,0
1653632216267,ECE 200,057,091059,Kang; Mingu,9999,0,9999,0
1653632216267,ECE 200,058,091060,Shi; Yuanyuan,9999,0,9999,0
1653632216267,ECE 200,059,091061,Wang; Edward Jay,9999,0,9999,0
1653632216267,ECE 200,060,091062,Zheng; Yang,9999,0,9999,0
1653632216803,ECE 201,A00,095526,Lo; Yu-Hwa,0,0,0,0
1653632217324,ECE 203,A00,091065,Mercier; Patrick Philip,0,0,0,0
1653632217851,ECE 207A,A00,091605,Liu; Thomas Tao-Ming,0,0,0,0
1653632218375,ECE 212AN,A00,091068,Nomura; Kenji,0,0,0,0
1653632218898,ECE 222A,A00,091069,Rebeiz; Gabriel,0,0,0,0
1653632219421,ECE 225A,A00,091070,Orlitsky; Alon,0,0,0,0
1653632219948,ECE 230A,A00,091071,Nomura; Kenji,0,0,0,0
1653632220479,ECE 236A,A00,091072,Dayeh; Shadi Ahmad,0,0,0,0
1653632221006,ECE 238A,A00,091073,Luo; Jian,0,0,0,0
1653632221006,ECE 238A,B00,091074,Luo; Jian,0,0,0,0
1653632221532,ECE 240A,A00,091075,Radic; Stojan,0,0,0,0
1653632222059,ECE 247A,A00,091592,Shi; Lingyan,0,0,0,0
1653632222582,ECE 250,A00,091076,Touri; Behrouz,0,0,0,0
1653632223103,ECE 251C,A00,091078,Nguyen; Truong Quang,0,0,0,0
1653632223626,ECE 253,A00,091079,Cosman; Pamela C.,0,0,0,0
1653632224148,ECE 255A,A00,091080,Orlitsky; Alon,0,0,0,0
1653632224682,ECE 257A,A00,091081,Zhang; Xinyu,0,0,0,0
1653632225205,ECE 260A,A01,091084,Eldon; John,0,0,0,0
1653632225731,ECE 264C,A00,091085,Galton; Ian A,0,0,0,0
1653632226263,ECE 265C,A00,094889,Presti; Calogero Davide,0,0,0,9
1653632226800,ECE 266,A01,091087,Hall; Drew A.,0,0,0,0
1653632227848,ECE 271A,A00,091090,Vasconcelos; Nuno,0,0,0,0
1653632228374,ECE 272B,A00,091091,Sworder; David D.,0,0,0,0
1653632228896,ECE 275A,A00,091092,Meyer; Florian,0,0,0,0
1653632229419,ECE 277,A00,091093,An; Cheolhong,0,0,0,0
1653632229942,ECE 283,A00,091094,Le; Hanh-Phuc,0,0,0,0
1653632230480,ECE 284,A00,091095,Kang; Mingu,0,0,0,0
1653632230480,ECE 284,B00,091096,Wang; Edward Jay,0,0,0,0
1653632231002,ECE 285,A00,094334,Touri; Behrouz,0,0,0,0
1653632231525,ECE 289,A00,091097,Whelan; David Arthur,0,0,0,0
1653632232048,MATH 200A,A00,087414,Salehi Golsefidy; Alireza,7,0,8,1
1653632232571,MATH 202A,A00,087415,Gill; Philip E.,2,0,8,6
1653632233099,MATH 203A,A00,087416,Oprea; Dragos N.,6,0,8,2
1653632233622,MATH 204A,A00,087417,Kedlaya; Kiran S.,6,0,8,2
1653632234148,MATH 205,A00,087418,Sorensen; Claus M,6,0,8,2
1653632234671,MATH 206A,A00,087419,Izadi; Elham,6,0,8,2
1653632235192,MATH 207A,A00,087420,Mohammadi; Amir,5,0,8,3
1653632235715,MATH 208,A00,087421,Staff,8,0,10,2
1653632236244,MATH 209,A00,087422,Staff,10,0,10,0
1653632236768,MATH 218,A00,087423,Staff,10,0,10,0
1653632237295,MATH 220A,A00,087424,Novak; Jonathan I,6,0,8,2
1653632237817,MATH 231A,A00,087425,Bejenaru; Ioan,3,0,8,5
1653632238344,MATH 240A,A00,087426,Ebenfelt; Peter F,5,0,8,3
1653632238867,MATH 243,A00,087427,Staff,9,0,10,1
1653632239392,MATH 248,A00,087429,Staff,10,0,10,0
1653632239914,MATH 250A,A00,087430,Spolaor; Luca,4,0,8,4
1653632240438,MATH 257A,A00,087431,Spolaor; Luca,7,0,8,1
1653632240962,MATH 258,A00,087432,Staff,9,0,10,1
1653632241484,MATH 264A,A00,087433,Warnke; Lutz Peter,5,0,8,3
1653632242014,MATH 268,A00,087434,Staff,15,0,15,0
1653632242537,MATH 269,A00,087435,Staff,14,0,15,1
1653632243060,MATH 270A,A00,087436,Nie; Jiawang,0,0,8,8
1653632243583,MATH 272A,A00,087437,Tian; Xiaochuan,0,0,8,8
1653632244106,MATH 274,A01,087439,Cheng; Li-Tien,9,0,10,1
1653632244106,MATH 274,A02,087440,Cheng; Li-Tien,10,0,10,0
1653632244631,MATH 278A,A00,087441,Staff,8,0,10,2
1653632245152,MATH 278B,A00,087442,Staff,8,0,10,2
1653632245674,MATH 278C,A00,087443,Staff,8,0,10,2
1653632246213,MATH 280A,A00,087444,Zheng; Tianyi,0,0,8,8
1653632246739,MATH 281A,A00,087445,Bradic; Jelena,0,0,8,9
1653632247263,MATH 282A,A00,087446,Zhang; Danna,0,0,8,8
1653632247787,MATH 283,A00,087447,Tesler; Glenn,0,0,0,16
1653632248310,MATH 286,B00,095535,Kemp; Todd Aahron,5,0,8,3
1653632248846,MATH 287D,B00,095536,Bradic; Jelena,5,0,8,3
1653632249371,MATH 288,A00,087450,Staff,14,0,15,1
1653632249371,MATH 288,B00,087451,Staff,15,0,15,0
1653632249371,MATH 288,C00,087452,Staff,15,0,15,0
1653632249893,MATH 290A,A00,087453,Xu; Zhouli,6,0,8,2
1653632250416,MATH 291A,A00,087454,Xu; Zhouli,7,0,8,1
1653632250944,MATH 292,A00,087455,Staff,10,0,10,0
1653632251470,MATH 295,A00,087456,Staff,50,0,50,0
1653632251993,MATH 297,001,087457,Staff,997,0,999,2
1653632811941,COGS 200,A01,087991,Staff,47,0,50,3
1653632812470,COGS 201,A01,094504,Rangel; Lara M,16,0,25,9
1653632812993,COGS 203,A00,087992,Coulson; Seana M,18,0,20,2
1653632813527,COGS 210A,001,087993,Greene; Deanna Jacquelyn,9998,0,9999,1
1653632813527,COGS 210A,002,087994,Saygin; Ayse P,9999,0,9999,0
1653632813527,COGS 210A,003,087995,Xia; Haijun,9999,0,9999,0
1653632813527,COGS 210A,004,087996,Nitz; Douglas A.,9999,0,9999,0
1653632813527,COGS 210A,005,087997,Hollan; James D.,9999,0,9999,0
1653632813527,COGS 210A,006,087998,Deak; Gedeon O.,9998,0,9999,1
1653632813527,COGS 210A,007,087999,Rossano; Federico,9999,0,9999,0
1653632814052,COGS 211A,A00,088000,Coulson; Seana M,9997,0,9999,2
1653632814594,COGS 229,A00,088002,Staff,22,0,25,3
1653632815126,COGS 260,B00,094231,Staff,17,0,20,3
1653632815126,COGS 260,A00,088004,Nitz; Douglas A.,9998,0,9999,1
1653632815658,CSE 202,A00,090110,Paturi; Ramamohan,0,0,0,0
1653632815658,CSE 202,B00,090111,Paturi; Ramamohan,0,0,0,0
1653632816183,CSE 207B,A00,090112,Heninger; Nadia A,0,0,0,0
1653632816710,CSE 208,A00,094858,Micciancio; Daniele,0,0,0,0
1653632817238,CSE 210,A00,090113,Powell; Thomas Allan,0,0,0,0
1653632817761,CSE 219,A00,090898,Staff,0,0,0,0
1653632818288,CSE 221,A00,090114,Zhou; Yuan-Yuan,0,0,0,0
1653632818811,CSE 229A,A00,090115,Porter; George M,0,0,0,0
1653632819337,CSE 229C,A00,090116,Savage; Stefan,0,0,0,0
1653632819861,CSE 230,A00,090117,Jhala; Ranjit,0,0,0,0
1653632820383,CSE 232,A00,090118,Papakonstantinou; Yannis,0,0,0,0
1653632820908,CSE 239A,A00,090121,Kumar; Arun Kumar,0,0,0,0
1653632821433,CSE 239B,A00,090122,Jhala; Ranjit,0,0,0,0
1653632821965,CSE 240A,A00,090123,Zhao; Jishen,0,0,189,189
1653632822488,CSE 243A,A00,090124,Orailoglu; Alex,0,0,15,15
1653632823011,CSE 249B,A00,090125,Kahng; Andrew Byun,12,0,20,8
1653632823535,CSE 250A,A00,090126,Berg-Kirkpatrick; Taylor D,0,0,0,0
1653632824060,CSE 252A,A00,090127,Ochoa; Benjamin Lawrence,0,0,0,0
1653632824585,CSE 258,A01,090129,McAuley; Julian John,0,0,0,0
1653632825108,CSE 258R,A01,090131,McAuley; Julian John,0,0,0,0
1653632825631,CSE 274,A00,090132,Ramamoorthi; Ravi,0,0,0,0
1653632826158,CSE 276A,A00,090133,Christensen; Henrik I,0,0,0,0
1653632826685,CSE 276C,A00,090134,Christensen; Henrik I,0,0,0,0
1653632827211,CSE 290,A00,090135,Bafna; Vineet,0,0,0,0
1653632827211,CSE 290,B00,090136,Ramamoorthi; Ravi,0,0,0,0
1653632827211,CSE 290,C00,090137,Li; Tzumao,7,0,10,3
1653632827211,CSE 290,D00,090138,Zhou; Yuan-Yuan,9,0,10,1
1653632827211,CSE 290,E00,090139,Christensen; Henrik I,8,0,10,2
1653632827211,CSE 290,F00,094053,Shalev; Aaron D,0,0,0,0
1653632827741,CSE 291,A00,090140,Munyaka; Imani N. S.,0,0,0,0
1653632827741,CSE 291,B00,094880,Yu; Qi,0,0,0,0
1653632827741,CSE 291,C00,090142,Pannuto; Patrick William,0,0,0,0
1653632827741,CSE 291,D00,094881,Zhang; Yiying,0,0,0,0
1653632827741,CSE 291,E00,095118,Su; Hao,0,0,0,0
1653632828279,CSE 293,001,094905,Bafna; Vineet,9999,0,9999,0
1653632828279,CSE 293,002,094906,Bellare; Mihir,9999,0,9999,0
1653632828279,CSE 293,003,094907,Berg-Kirkpatrick; Taylor D,9999,0,9999,0
1653632828279,CSE 293,004,094908,Christensen; Henrik I,9999,0,9999,0
1653632828279,CSE 293,005,094909,Cottrell; Garrison W,9999,0,9999,0
1653632828279,CSE 293,006,094910,Deutsch; Alin Bernard,9999,0,9999,0
1653632828279,CSE 293,007,094911,Esmaeilzadeh; Hadi,9999,0,9999,0
1653632828279,CSE 293,008,094912,Freund; Yoav,9999,0,9999,0
1653632828279,CSE 293,009,094913,Griswold; William G.,9999,0,9999,0
1653632828279,CSE 293,010,094914,Gymrek; Melissa Ann,9999,0,9999,0
1653632828279,CSE 293,011,094915,Heninger; Nadia A,9999,0,9999,0
1653632828279,CSE 293,012,094916,Impagliazzo; Russell,9999,0,9999,0
1653632828279,CSE 293,013,094917,Jhala; Ranjit,9999,0,9999,0
1653632828279,CSE 293,014,094918,Kahng; Andrew Byun,9999,0,9999,0
1653632828279,CSE 293,015,094919,Kane; Daniel Mertz,9999,0,9999,0
1653632828279,CSE 293,016,094920,Kriegman; David J,9999,0,9999,0
1653632828279,CSE 293,017,094921,Kumar; Arun Kumar,9999,0,9999,0
1653632828279,CSE 293,018,094922,Lerner; Sorin,9999,0,9999,0
1653632828279,CSE 293,019,094923,Lovett; Shachar,9999,0,9999,0
1653632828279,CSE 293,020,094924,McAuley; Julian John,9999,0,9999,0
1653632828279,CSE 293,021,094925,Micciancio; Daniele,9999,0,9999,0
1653632828279,CSE 293,022,094926,Orailoglu; Alex,9999,0,9999,0
1653632828279,CSE 293,023,094927,Paturi; Ramamohan,9999,0,9999,0
1653632828279,CSE 293,024,094928,Polikarpova; Nadezhda,9999,0,9999,0
1653632828279,CSE 293,025,094929,Politz; Joseph Gibbs,9999,0,9999,0
1653632828279,CSE 293,026,094930,Porter; George M,9999,0,9999,0
1653632828279,CSE 293,027,094931,Porter; Leonard Emerson,9999,0,9999,0
1653632828279,CSE 293,028,094932,Ramamoorthi; Ravi,9999,0,9999,0
1653632828279,CSE 293,029,094933,Sahoo; Debashis,9999,0,9999,0
1653632828279,CSE 293,030,094934,Saul; Lawrence,9999,0,9999,0
1653632828279,CSE 293,031,094935,Savage; Stefan,9999,0,9999,0
1653632828279,CSE 293,032,094936,Schulze; Jurgen P.,9999,0,9999,0
1653632828279,CSE 293,033,094937,Snoeren; Alex C.,9999,0,9999,0
1653632828279,CSE 293,034,094938,Shang; Jingbo,9999,0,9999,0
1653632828279,CSE 293,035,094939,Stefan; Deian,9999,0,9999,0
1653632828279,CSE 293,036,094940,Su; Hao,9999,0,9999,0
1653632828279,CSE 293,037,094941,Swanson; Steven James,9999,0,9999,0
1653632828279,CSE 293,038,094942,Tullsen; Dean Michael,9999,0,9999,0
1653632828279,CSE 293,039,094943,Voelker; Geoffrey M.,9999,0,9999,0
1653632828279,CSE 293,040,094944,Zhao; Jishen,9999,0,9999,0
1653632828279,CSE 293,041,094945,Zhou; Yuan-Yuan,9999,0,9999,0
1653632828279,CSE 293,042,094946,Gao; Sicun,9998,0,9999,1
1653632828279,CSE 293,043,094947,Weibel; Nadir,9999,0,9999,0
1653632828279,CSE 293,044,094948,Gupta; Rajesh K.,9999,0,9999,0
1653632828804,CSE 294,A00,090143,Porter; George M,9,0,10,1
1653632829327,DSE 200,A00,091799,Staff,50,0,50,0
1653632829850,DSE 203,A00,091800,Gupta; Amarnath,30,0,30,0
1653632830373,DSE 250,A00,091801,Deutsch; Alin Bernard,30,0,30,0
1653632830900,DSE 290,A00,091802,Altintas De Callaf; Ilkay,50,0,50,0
1653632831441,ECE 200,001,091003,Antipa; Nicholas A,9999,0,9999,0
1653632831441,ECE 200,002,091004,Atanasov; Nikolay A.,9999,0,9999,0
1653632831441,ECE 200,003,091005,Bharadia; Dinesh,9999,0,9999,0
1653632831441,ECE 200,004,091006,Cheng; Chung Kuan,9999,0,9999,0
1653632831441,ECE 200,005,091007,Cosman; Pamela C.,9999,0,9999,0
1653632831441,ECE 200,006,091008,Staff,9999,0,9999,0
1653632831441,ECE 200,007,091009,Dayeh; Shadi Ahmad,9999,0,9999,0
1653632831441,ECE 200,008,091010,Fainman; Yeshaiahu,9999,0,9999,0
1653632831441,ECE 200,009,091011,Ford; Joseph Earl,9999,0,9999,0
1653632831441,ECE 200,010,091012,Franceschetti; Massimo,9999,0,9999,0
1653632831441,ECE 200,011,091013,Fullerton; Eric E,9999,0,9999,0
1653632831441,ECE 200,012,091014,Galton; Ian A,9999,0,9999,0
1653632831441,ECE 200,013,091015,Gilja; Vikash,9999,0,9999,0
1653632831441,ECE 200,014,091016,Hall; Drew A.,9999,0,9999,0
1653632831441,ECE 200,015,091017,Hsueh; Tzu-Chien,9999,0,9999,0
1653632831441,ECE 200,016,091018,Javidi; Tara,9999,0,9999,0
1653632831441,ECE 200,017,091019,Kahng; Andrew Byun,9999,0,9999,0
1653632831441,ECE 200,018,091020,Kim; Young-Han,9999,0,9999,0
1653632831441,ECE 200,019,091021,Koushanfar; Farinaz,9999,0,9999,0
1653632831441,ECE 200,020,091022,Kuzum; Duygu,9999,0,9999,0
1653632831441,ECE 200,021,091023,Le; Hanh-Phuc,9999,0,9999,0
1653632831441,ECE 200,022,091024,Lin; Bill,9999,0,9999,0
1653632831441,ECE 200,023,091025,Liu; Zhaowei,9999,0,9999,0
1653632831441,ECE 200,024,091026,Lo; Yu-Hwa,9999,0,9999,0
1653632831441,ECE 200,025,091027,Lomakin; Vitaliy,9999,0,9999,0
1653632831441,ECE 200,026,091028,Mercier; Patrick Philip,9999,0,9999,0
1653632831441,ECE 200,027,091029,Meyer; Florian,9999,0,9999,0
1653632831441,ECE 200,028,091030,Milstein; Laurence B.,9999,0,9999,0
1653632831441,ECE 200,029,091031,Mir Arabbaygi; Siavash,9999,0,9999,0
1653632831441,ECE 200,030,091032,Mookherjea; Shayan,9999,0,9999,0
1653632831441,ECE 200,031,091033,Morris; Karcher William,9999,0,9999,0
1653632831441,ECE 200,032,091034,Ng; Tse Nga,9999,0,9999,0
1653632831441,ECE 200,033,091035,Nguyen; Truong Quang,9999,0,9999,0
1653632831441,ECE 200,034,091036,Nomura; Kenji,9999,0,9999,0
1653632831441,ECE 200,035,091037,Orlitsky; Alon,9999,0,9999,0
1653632831441,ECE 200,036,091038,Pal; Piya,9999,0,9999,0
1653632831441,ECE 200,037,091039,Papen; George C.,9999,0,9999,0
1653632831441,ECE 200,038,091040,Radic; Stojan,9999,0,9999,0
1653632831441,ECE 200,039,091041,Rao; Bhaskar D.,9999,0,9999,0
1653632831441,ECE 200,040,091042,Rao; Ramesh R,9999,0,9999,0
1653632831441,ECE 200,041,091043,Rebeiz; Gabriel,9999,0,9999,0
1653632831441,ECE 200,042,091044,Sanford; John R,9999,0,9999,0
1653632831441,ECE 200,043,091045,Siegel; Paul H.,9999,0,9999,0
1653632831441,ECE 200,044,091046,Sievenpiper; Daniel F.,9999,0,9999,0
1653632831441,ECE 200,045,091047,Sworder; David D.,9999,0,9999,0
1653632831441,ECE 200,046,091048,Taur; Yuan,9999,0,9999,0
1653632831441,ECE 200,047,091049,Touri; Behrouz,9999,0,9999,0
1653632831441,ECE 200,048,091050,Trivedi; Mohan M.,9999,0,9999,0
1653632831441,ECE 200,049,091051,Vardy; Alexander,9999,0,9999,0
1653632831441,ECE 200,050,091052,Vasconcelos; Nuno,9999,0,9999,0
1653632831441,ECE 200,051,091053,Wang; Xiaolong,9999,0,9999,0
1653632831441,ECE 200,052,091054,Xie; Pengtao,9999,0,9999,0
1653632831441,ECE 200,053,091055,Yip; Michael,9999,0,9999,0
1653632831441,ECE 200,054,091056,Zeger; Kenneth A.,9999,0,9999,0
1653632831441,ECE 200,055,091057,Zhang; Xinyu,9999,0,9999,0
1653632831441,ECE 200,056,091058,Turakhia; Yatish Girish,9999,0,9999,0
1653632831441,ECE 200,057,091059,Kang; Mingu,9999,0,9999,0
1653632831441,ECE 200,058,091060,Shi; Yuanyuan,9999,0,9999,0
1653632831441,ECE 200,059,091061,Wang; Edward Jay,9999,0,9999,0
1653632831441,ECE 200,060,091062,Zheng; Yang,9999,0,9999,0
1653632831963,ECE 201,A00,095526,Lo; Yu-Hwa,0,0,0,0
1653632832493,ECE 203,A00,091065,Mercier; Patrick Philip,0,0,0,0
1653632833017,ECE 207A,A00,091605,Liu; Thomas Tao-Ming,0,0,0,0
1653632833543,ECE 212AN,A00,091068,Nomura; Kenji,0,0,0,0
1653632834075,ECE 222A,A00,091069,Rebeiz; Gabriel,0,0,0,0
1653632834599,ECE 225A,A00,091070,Orlitsky; Alon,0,0,0,0
1653632835124,ECE 230A,A00,091071,Nomura; Kenji,0,0,0,0
1653632835651,ECE 236A,A00,091072,Dayeh; Shadi Ahmad,0,0,0,0
1653632836175,ECE 238A,A00,091073,Luo; Jian,0,0,0,0
1653632836175,ECE 238A,B00,091074,Luo; Jian,0,0,0,0
1653632836701,ECE 240A,A00,091075,Radic; Stojan,0,0,0,0
1653632837225,ECE 247A,A00,091592,Shi; Lingyan,0,0,0,0
1653632837751,ECE 250,A00,091076,Touri; Behrouz,0,0,0,0
1653632838274,ECE 251C,A00,091078,Nguyen; Truong Quang,0,0,0,0
1653632838803,ECE 253,A00,091079,Cosman; Pamela C.,0,0,0,0
1653632839327,ECE 255A,A00,091080,Orlitsky; Alon,0,0,0,0
1653632839851,ECE 257A,A00,091081,Zhang; Xinyu,0,0,0,0
1653632840373,ECE 260A,A01,091084,Eldon; John,0,0,0,0
1653632840899,ECE 264C,A00,091085,Galton; Ian A,0,0,0,0
1653632841425,ECE 265C,A00,094889,Presti; Calogero Davide,0,0,0,9
1653632841962,ECE 266,A01,091087,Hall; Drew A.,0,0,0,0
1653632843013,ECE 271A,A00,091090,Vasconcelos; Nuno,0,0,0,0
1653632843546,ECE 272B,A00,091091,Sworder; David D.,0,0,0,0
1653632844074,ECE 275A,A00,091092,Meyer; Florian,0,0,0,0
1653632844598,ECE 277,A00,091093,An; Cheolhong,0,0,0,0
1653632845124,ECE 283,A00,091094,Le; Hanh-Phuc,0,0,0,0
1653632845651,ECE 284,A00,091095,Kang; Mingu,0,0,0,0
1653632845651,ECE 284,B00,091096,Wang; Edward Jay,0,0,0,0
1653632846178,ECE 285,A00,094334,Touri; Behrouz,0,0,0,0
1653632846701,ECE 289,A00,091097,Whelan; David Arthur,0,0,0,0
1653632847228,MATH 200A,A00,087414,Salehi Golsefidy; Alireza,7,0,8,1
1653632847755,MATH 202A,A00,087415,Gill; Philip E.,2,0,8,6
1653632848281,MATH 203A,A00,087416,Oprea; Dragos N.,6,0,8,2
1653632848810,MATH 204A,A00,087417,Kedlaya; Kiran S.,6,0,8,2
1653632849333,MATH 205,A00,087418,Sorensen; Claus M,6,0,8,2
1653632849856,MATH 206A,A00,087419,Izadi; Elham,6,0,8,2
1653632850391,MATH 207A,A00,087420,Mohammadi; Amir,5,0,8,3
1653632850921,MATH 208,A00,087421,Staff,8,0,10,2
1653632851446,MATH 209,A00,087422,Staff,10,0,10,0
1653632851970,MATH 218,A00,087423,Staff,10,0,10,0
1653632852497,MATH 220A,A00,087424,Novak; Jonathan I,6,0,8,2
1653632853106,MATH 231A,A00,087425,Bejenaru; Ioan,3,0,8,5
1653632853630,MATH 240A,A00,087426,Ebenfelt; Peter F,5,0,8,3
1653632854153,MATH 243,A00,087427,Staff,9,0,10,1
1653632854678,MATH 248,A00,087429,Staff,10,0,10,0
1653632855205,MATH 250A,A00,087430,Spolaor; Luca,4,0,8,4
1653632855730,MATH 257A,A00,087431,Spolaor; Luca,7,0,8,1
1653632856254,MATH 258,A00,087432,Staff,9,0,10,1
1653632856778,MATH 264A,A00,087433,Warnke; Lutz Peter,5,0,8,3
1653632857307,MATH 268,A00,087434,Staff,15,0,15,0
1653632857830,MATH 269,A00,087435,Staff,14,0,15,1
1653632858355,MATH 270A,A00,087436,Nie; Jiawang,0,0,8,8
1653632858878,MATH 272A,A00,087437,Tian; Xiaochuan,0,0,8,8
1653632859402,MATH 274,A01,087439,Cheng; Li-Tien,9,0,10,1
1653632859402,MATH 274,A02,087440,Cheng; Li-Tien,10,0,10,0
1653632859925,MATH 278A,A00,087441,Staff,8,0,10,2
1653632860447,MATH 278B,A00,087442,Staff,8,0,10,2
1653632860972,MATH 278C,A00,087443,Staff,8,0,10,2
1653632861496,MATH 280A,A00,087444,Zheng; Tianyi,0,0,8,8
1653632862019,MATH 281A,A00,087445,Bradic; Jelena,0,0,8,9
1653632862545,MATH 282A,A00,087446,Zhang; Danna,0,0,8,8
1653632863068,MATH 283,A00,087447,Tesler; Glenn,0,0,0,16
1653632863595,MATH 286,B00,095535,Kemp; Todd Aahron,5,0,8,3
1653632864122,MATH 287D,B00,095536,Bradic; Jelena,5,0,8,3
1653632864648,MATH 288,A00,087450,Staff,14,0,15,1
1653632864648,MATH 288,B00,087451,Staff,15,0,15,0
1653632864648,MATH 288,C00,087452,Staff,15,0,15,0
1653632865177,MATH 290A,A00,087453,Xu; Zhouli,6,0,8,2
1653632865700,MATH 291A,A00,087454,Xu; Zhouli,7,0,8,1
1653632866222,MATH 292,A00,087455,Staff,10,0,10,0
1653632866747,MATH 295,A00,087456,Staff,50,0,50,0
1653632867273,MATH 297,001,087457,Staff,997,0,999,2
1653633427290,COGS 200,A01,087991,Staff,47,0,50,3
1653633427817,COGS 201,A01,094504,Rangel; Lara M,16,0,25,9
1653633428340,COGS 203,A00,087992,Coulson; Seana M,18,0,20,2
1653633428869,COGS 210A,001,087993,Greene; Deanna Jacquelyn,9998,0,9999,1
1653633428869,COGS 210A,002,087994,Saygin; Ayse P,9999,0,9999,0
1653633428869,COGS 210A,003,087995,Xia; Haijun,9999,0,9999,0
1653633428869,COGS 210A,004,087996,Nitz; Douglas A.,9999,0,9999,0
1653633428869,COGS 210A,005,087997,Hollan; James D.,9999,0,9999,0
1653633428869,COGS 210A,006,087998,Deak; Gedeon O.,9998,0,9999,1
1653633428869,COGS 210A,007,087999,Rossano; Federico,9999,0,9999,0
1653633429393,COGS 211A,A00,088000,Coulson; Seana M,9997,0,9999,2
1653633429922,COGS 229,A00,088002,Staff,22,0,25,3
1653633430446,COGS 260,B00,094231,Staff,17,0,20,3
1653633430446,COGS 260,A00,088004,Nitz; Douglas A.,9998,0,9999,1
1653633430969,CSE 202,A00,090110,Paturi; Ramamohan,0,0,0,0
1653633430969,CSE 202,B00,090111,Paturi; Ramamohan,0,0,0,0
1653633431493,CSE 207B,A00,090112,Heninger; Nadia A,0,0,0,0
1653633432019,CSE 208,A00,094858,Micciancio; Daniele,0,0,0,0
1653633432543,CSE 210,A00,090113,Powell; Thomas Allan,0,0,0,0
1653633433068,CSE 219,A00,090898,Staff,0,0,0,0
1653633433606,CSE 221,A00,090114,Zhou; Yuan-Yuan,0,0,0,0
1653633434137,CSE 229A,A00,090115,Porter; George M,0,0,0,0
1653633434664,CSE 229C,A00,090116,Savage; Stefan,0,0,0,0
1653633435190,CSE 230,A00,090117,Jhala; Ranjit,0,0,0,0
1653633435713,CSE 232,A00,090118,Papakonstantinou; Yannis,0,0,0,0
1653633436235,CSE 239A,A00,090121,Kumar; Arun Kumar,0,0,0,0
1653633436764,CSE 239B,A00,090122,Jhala; Ranjit,0,0,0,0
1653633437288,CSE 240A,A00,090123,Zhao; Jishen,0,0,189,189
1653633437816,CSE 243A,A00,090124,Orailoglu; Alex,0,0,15,15
1653633438337,CSE 249B,A00,090125,Kahng; Andrew Byun,12,0,20,8
1653633438861,CSE 250A,A00,090126,Berg-Kirkpatrick; Taylor D,0,0,0,0
1653633439387,CSE 252A,A00,090127,Ochoa; Benjamin Lawrence,0,0,0,0
1653633439919,CSE 258,A01,090129,McAuley; Julian John,0,0,0,0
1653633440558,CSE 258R,A01,090131,McAuley; Julian John,0,0,0,0
1653633441092,CSE 274,A00,090132,Ramamoorthi; Ravi,0,0,0,0
1653633441617,CSE 276A,A00,090133,Christensen; Henrik I,0,0,0,0
1653633442140,CSE 276C,A00,090134,Christensen; Henrik I,0,0,0,0
1653633442663,CSE 290,A00,090135,Bafna; Vineet,0,0,0,0
1653633442663,CSE 290,B00,090136,Ramamoorthi; Ravi,0,0,0,0
1653633442663,CSE 290,C00,090137,Li; Tzumao,7,0,10,3
1653633442663,CSE 290,D00,090138,Zhou; Yuan-Yuan,9,0,10,1
1653633442663,CSE 290,E00,090139,Christensen; Henrik I,8,0,10,2
1653633442663,CSE 290,F00,094053,Shalev; Aaron D,0,0,0,0
1653633443187,CSE 291,A00,090140,Munyaka; Imani N. S.,0,0,0,0
1653633443187,CSE 291,B00,094880,Yu; Qi,0,0,0,0
1653633443187,CSE 291,C00,090142,Pannuto; Patrick William,0,0,0,0
1653633443187,CSE 291,D00,094881,Zhang; Yiying,0,0,0,0
1653633443187,CSE 291,E00,095118,Su; Hao,0,0,0,0
1653633443724,CSE 293,001,094905,Bafna; Vineet,9999,0,9999,0
1653633443724,CSE 293,002,094906,Bellare; Mihir,9999,0,9999,0
1653633443724,CSE 293,003,094907,Berg-Kirkpatrick; Taylor D,9999,0,9999,0
1653633443724,CSE 293,004,094908,Christensen; Henrik I,9999,0,9999,0
1653633443724,CSE 293,005,094909,Cottrell; Garrison W,9999,0,9999,0
1653633443724,CSE 293,006,094910,Deutsch; Alin Bernard,9999,0,9999,0
1653633443724,CSE 293,007,094911,Esmaeilzadeh; Hadi,9999,0,9999,0
1653633443724,CSE 293,008,094912,Freund; Yoav,9999,0,9999,0
1653633443724,CSE 293,009,094913,Griswold; William G.,9999,0,9999,0
1653633443724,CSE 293,010,094914,Gymrek; Melissa Ann,9999,0,9999,0
1653633443724,CSE 293,011,094915,Heninger; Nadia A,9999,0,9999,0
1653633443724,CSE 293,012,094916,Impagliazzo; Russell,9999,0,9999,0
1653633443724,CSE 293,013,094917,Jhala; Ranjit,9999,0,9999,0
1653633443724,CSE 293,014,094918,Kahng; Andrew Byun,9999,0,9999,0
1653633443724,CSE 293,015,094919,Kane; Daniel Mertz,9999,0,9999,0
1653633443724,CSE 293,016,094920,Kriegman; David J,9999,0,9999,0
1653633443724,CSE 293,017,094921,Kumar; Arun Kumar,9999,0,9999,0
1653633443724,CSE 293,018,094922,Lerner; Sorin,9999,0,9999,0
1653633443724,CSE 293,019,094923,Lovett; Shachar,9999,0,9999,0
1653633443724,CSE 293,020,094924,McAuley; Julian John,9999,0,9999,0
1653633443724,CSE 293,021,094925,Micciancio; Daniele,9999,0,9999,0
1653633443724,CSE 293,022,094926,Orailoglu; Alex,9999,0,9999,0
1653633443724,CSE 293,023,094927,Paturi; Ramamohan,9999,0,9999,0
1653633443724,CSE 293,024,094928,Polikarpova; Nadezhda,9999,0,9999,0
1653633443724,CSE 293,025,094929,Politz; Joseph Gibbs,9999,0,9999,0
1653633443724,CSE 293,026,094930,Porter; George M,9999,0,9999,0
1653633443724,CSE 293,027,094931,Porter; Leonard Emerson,9999,0,9999,0
1653633443724,CSE 293,028,094932,Ramamoorthi; Ravi,9999,0,9999,0
1653633443724,CSE 293,029,094933,Sahoo; Debashis,9999,0,9999,0
1653633443724,CSE 293,030,094934,Saul; Lawrence,9999,0,9999,0
1653633443724,CSE 293,031,094935,Savage; Stefan,9999,0,9999,0
1653633443724,CSE 293,032,094936,Schulze; Jurgen P.,9999,0,9999,0
1653633443724,CSE 293,033,094937,Snoeren; Alex C.,9999,0,9999,0
1653633443724,CSE 293,034,094938,Shang; Jingbo,9999,0,9999,0
1653633443724,CSE 293,035,094939,Stefan; Deian,9999,0,9999,0
1653633443724,CSE 293,036,094940,Su; Hao,9999,0,9999,0
1653633443724,CSE 293,037,094941,Swanson; Steven James,9999,0,9999,0
1653633443724,CSE 293,038,094942,Tullsen; Dean Michael,9999,0,9999,0
1653633443724,CSE 293,039,094943,Voelker; Geoffrey M.,9999,0,9999,0
1653633443724,CSE 293,040,094944,Zhao; Jishen,9999,0,9999,0
1653633443724,CSE 293,041,094945,Zhou; Yuan-Yuan,9999,0,9999,0
1653633443724,CSE 293,042,094946,Gao; Sicun,9998,0,9999,1
1653633443724,CSE 293,043,094947,Weibel; Nadir,9999,0,9999,0
1653633443724,CSE 293,044,094948,Gupta; Rajesh K.,9999,0,9999,0
1653633444246,CSE 294,A00,090143,Porter; George M,9,0,10,1
1653633444773,DSE 200,A00,091799,Staff,50,0,50,0
1653633445299,DSE 203,A00,091800,Gupta; Amarnath,30,0,30,0
1653633445834,DSE 250,A00,091801,Deutsch; Alin Bernard,30,0,30,0
1653633446359,DSE 290,A00,091802,Altintas De Callaf; Ilkay,50,0,50,0
1653633446899,ECE 200,001,091003,Antipa; Nicholas A,9999,0,9999,0
1653633446899,ECE 200,002,091004,Atanasov; Nikolay A.,9999,0,9999,0
1653633446899,ECE 200,003,091005,Bharadia; Dinesh,9999,0,9999,0
1653633446899,ECE 200,004,091006,Cheng; Chung Kuan,9999,0,9999,0
1653633446899,ECE 200,005,091007,Cosman; Pamela C.,9999,0,9999,0
1653633446899,ECE 200,006,091008,Staff,9999,0,9999,0
1653633446899,ECE 200,007,091009,Dayeh; Shadi Ahmad,9999,0,9999,0
1653633446899,ECE 200,008,091010,Fainman; Yeshaiahu,9999,0,9999,0
1653633446899,ECE 200,009,091011,Ford; Joseph Earl,9999,0,9999,0
1653633446899,ECE 200,010,091012,Franceschetti; Massimo,9999,0,9999,0
1653633446899,ECE 200,011,091013,Fullerton; Eric E,9999,0,9999,0
1653633446899,ECE 200,012,091014,Galton; Ian A,9999,0,9999,0
1653633446899,ECE 200,013,091015,Gilja; Vikash,9999,0,9999,0
1653633446899,ECE 200,014,091016,Hall; Drew A.,9999,0,9999,0
1653633446899,ECE 200,015,091017,Hsueh; Tzu-Chien,9999,0,9999,0
1653633446899,ECE 200,016,091018,Javidi; Tara,9999,0,9999,0
1653633446899,ECE 200,017,091019,Kahng; Andrew Byun,9999,0,9999,0
1653633446899,ECE 200,018,091020,Kim; Young-Han,9999,0,9999,0
1653633446899,ECE 200,019,091021,Koushanfar; Farinaz,9999,0,9999,0
1653633446899,ECE 200,020,091022,Kuzum; Duygu,9999,0,9999,0
1653633446899,ECE 200,021,091023,Le; Hanh-Phuc,9999,0,9999,0
1653633446899,ECE 200,022,091024,Lin; Bill,9999,0,9999,0
1653633446899,ECE 200,023,091025,Liu; Zhaowei,9999,0,9999,0
1653633446899,ECE 200,024,091026,Lo; Yu-Hwa,9999,0,9999,0
1653633446899,ECE 200,025,091027,Lomakin; Vitaliy,9999,0,9999,0
1653633446899,ECE 200,026,091028,Mercier; Patrick Philip,9999,0,9999,0
1653633446899,ECE 200,027,091029,Meyer; Florian,9999,0,9999,0
1653633446899,ECE 200,028,091030,Milstein; Laurence B.,9999,0,9999,0
1653633446899,ECE 200,029,091031,Mir Arabbaygi; Siavash,9999,0,9999,0
1653633446899,ECE 200,030,091032,Mookherjea; Shayan,9999,0,9999,0
1653633446899,ECE 200,031,091033,Morris; Karcher William,9999,0,9999,0
1653633446899,ECE 200,032,091034,Ng; Tse Nga,9999,0,9999,0
1653633446899,ECE 200,033,091035,Nguyen; Truong Quang,9999,0,9999,0
1653633446899,ECE 200,034,091036,Nomura; Kenji,9999,0,9999,0
1653633446899,ECE 200,035,091037,Orlitsky; Alon,9999,0,9999,0
1653633446899,ECE 200,036,091038,Pal; Piya,9999,0,9999,0
1653633446899,ECE 200,037,091039,Papen; George C.,9999,0,9999,0
1653633446899,ECE 200,038,091040,Radic; Stojan,9999,0,9999,0
1653633446899,ECE 200,039,091041,Rao; Bhaskar D.,9999,0,9999,0
1653633446899,ECE 200,040,091042,Rao; Ramesh R,9999,0,9999,0
1653633446899,ECE 200,041,091043,Rebeiz; Gabriel,9999,0,9999,0
1653633446899,ECE 200,042,091044,Sanford; John R,9999,0,9999,0
1653633446899,ECE 200,043,091045,Siegel; Paul H.,9999,0,9999,0
1653633446899,ECE 200,044,091046,Sievenpiper; Daniel F.,9999,0,9999,0
1653633446899,ECE 200,045,091047,Sworder; David D.,9999,0,9999,0
1653633446899,ECE 200,046,091048,Taur; Yuan,9999,0,9999,0
1653633446899,ECE 200,047,091049,Touri; Behrouz,9999,0,9999,0
1653633446899,ECE 200,048,091050,Trivedi; Mohan M.,9999,0,9999,0
1653633446899,ECE 200,049,091051,Vardy; Alexander,9999,0,9999,0
1653633446899,ECE 200,050,091052,Vasconcelos; Nuno,9999,0,9999,0
1653633446899,ECE 200,051,091053,Wang; Xiaolong,9999,0,9999,0
1653633446899,ECE 200,052,091054,Xie; Pengtao,9999,0,9999,0
1653633446899,ECE 200,053,091055,Yip; Michael,9999,0,9999,0
1653633446899,ECE 200,054,091056,Zeger; Kenneth A.,9999,0,9999,0
1653633446899,ECE 200,055,091057,Zhang; Xinyu,9999,0,9999,0
1653633446899,ECE 200,056,091058,Turakhia; Yatish Girish,9999,0,9999,0
1653633446899,ECE 200,057,091059,Kang; Mingu,9999,0,9999,0
1653633446899,ECE 200,058,091060,Shi; Yuanyuan,9999,0,9999,0
1653633446899,ECE 200,059,091061,Wang; Edward Jay,9999,0,9999,0
1653633446899,ECE 200,060,091062,Zheng; Yang,9999,0,9999,0
1653633447426,ECE 201,A00,095526,Lo; Yu-Hwa,0,0,0,0
1653633447949,ECE 203,A00,091065,Mercier; Patrick Philip,0,0,0,0
1653633448476,ECE 207A,A00,091605,Liu; Thomas Tao-Ming,0,0,0,0
1653633449002,ECE 212AN,A00,091068,Nomura; Kenji,0,0,0,0
1653633449524,ECE 222A,A00,091069,Rebeiz; Gabriel,0,0,0,0
1653633450045,ECE 225A,A00,091070,Orlitsky; Alon,0,0,0,0
1653633450568,ECE 230A,A00,091071,Nomura; Kenji,0,0,0,0
1653633451091,ECE 236A,A00,091072,Dayeh; Shadi Ahmad,0,0,0,0
1653633451627,ECE 238A,A00,091073,Luo; Jian,0,0,0,0
1653633451627,ECE 238A,B00,091074,Luo; Jian,0,0,0,0
1653633452158,ECE 240A,A00,091075,Radic; Stojan,0,0,0,0
1653633452682,ECE 247A,A00,091592,Shi; Lingyan,0,0,0,0
1653633453209,ECE 250,A00,091076,Touri; Behrouz,0,0,0,0
1653633453734,ECE 251C,A00,091078,Nguyen; Truong Quang,0,0,0,0
1653633454260,ECE 253,A00,091079,Cosman; Pamela C.,0,0,0,0
1653633454787,ECE 255A,A00,091080,Orlitsky; Alon,0,0,0,0
1653633455311,ECE 257A,A00,091081,Zhang; Xinyu,0,0,0,0
1653633455834,ECE 260A,A01,091084,Eldon; John,0,0,0,0
1653633456357,ECE 264C,A00,091085,Galton; Ian A,0,0,0,0
1653633456894,ECE 265C,A00,094889,Presti; Calogero Davide,0,0,0,9
1653633457432,ECE 266,A01,091087,Hall; Drew A.,0,0,0,0
1653633458494,ECE 271A,A00,091090,Vasconcelos; Nuno,0,0,0,0
1653633459017,ECE 272B,A00,091091,Sworder; David D.,0,0,0,0
1653633459545,ECE 275A,A00,091092,Meyer; Florian,0,0,0,0
1653633460071,ECE 277,A00,091093,An; Cheolhong,0,0,0,0
1653633460594,ECE 283,A00,091094,Le; Hanh-Phuc,0,0,0,0
1653633461123,ECE 284,A00,091095,Kang; Mingu,0,0,0,0
1653633461123,ECE 284,B00,091096,Wang; Edward Jay,0,0,0,0
1653633461645,ECE 285,A00,094334,Touri; Behrouz,0,0,0,0
1653633462169,ECE 289,A00,091097,Whelan; David Arthur,0,0,0,0
1653633462695,MATH 200A,A00,087414,Salehi Golsefidy; Alireza,7,0,8,1
1653633463220,MATH 202A,A00,087415,Gill; Philip E.,2,0,8,6
1653633463743,MATH 203A,A00,087416,Oprea; Dragos N.,6,0,8,2
1653633464269,MATH 204A,A00,087417,Kedlaya; Kiran S.,6,0,8,2
1653633464795,MATH 205,A00,087418,Sorensen; Claus M,6,0,8,2
1653633465317,MATH 206A,A00,087419,Izadi; Elham,6,0,8,2
1653633465846,MATH 207A,A00,087420,Mohammadi; Amir,5,0,8,3
1653633466369,MATH 208,A00,087421,Staff,8,0,10,2
1653633466892,MATH 209,A00,087422,Staff,10,0,10,0
1653633467414,MATH 218,A00,087423,Staff,10,0,10,0
1653633467938,MATH 220A,A00,087424,Novak; Jonathan I,6,0,8,2
1653633468464,MATH 231A,A00,087425,Bejenaru; Ioan,3,0,8,5
1653633468987,MATH 240A,A00,087426,Ebenfelt; Peter F,5,0,8,3
1653633469510,MATH 243,A00,087427,Staff,9,0,10,1
1653633470033,MATH 248,A00,087429,Staff,10,0,10,0
1653633470556,MATH 250A,A00,087430,Spolaor; Luca,4,0,8,4
1653633471079,MATH 257A,A00,087431,Spolaor; Luca,7,0,8,1
1653633471603,MATH 258,A00,087432,Staff,9,0,10,1
1653633472129,MATH 264A,A00,087433,Warnke; Lutz Peter,5,0,8,3
1653633472654,MATH 268,A00,087434,Staff,15,0,15,0
1653633473189,MATH 269,A00,087435,Staff,14,0,15,1
1653633473712,MATH 270A,A00,087436,Nie; Jiawang,0,0,8,8
1653633474255,MATH 272A,A00,087437,Tian; Xiaochuan,0,0,8,8
1653633474779,MATH 274,A01,087439,Cheng; Li-Tien,9,0,10,1
1653633474779,MATH 274,A02,087440,Cheng; Li-Tien,10,0,10,0
1653633475301,MATH 278A,A00,087441,Staff,8,0,10,2
1653633475823,MATH 278B,A00,087442,Staff,8,0,10,2
1653633476345,MATH 278C,A00,087443,Staff,8,0,10,2
1653633476873,MATH 280A,A00,087444,Zheng; Tianyi,0,0,8,8
1653633477395,MATH 281A,A00,087445,Bradic; Jelena,0,0,8,9
1653633477919,MATH 282A,A00,087446,Zhang; Danna,0,0,8,8
1653633478443,MATH 283,A00,087447,Tesler; Glenn,0,0,0,16
1653633478965,MATH 286,B00,095535,Kemp; Todd Aahron,5,0,8,3
1653633479498,MATH 287D,B00,095536,Bradic; Jelena,5,0,8,3
1653633480021,MATH 288,A00,087450,Staff,14,0,15,1
1653633480021,MATH 288,B00,087451,Staff,15,0,15,0
1653633480021,MATH 288,C00,087452,Staff,15,0,15,0
1653633480545,MATH 290A,A00,087453,Xu; Zhouli,6,0,8,2
1653633481070,MATH 291A,A00,087454,Xu; Zhouli,7,0,8,1
1653633481592,MATH 292,A00,087455,Staff,10,0,10,0
1653633482115,MATH 295,A00,087456,Staff,50,0,50,0
1653633482637,MATH 297,001,087457,Staff,997,0,999,2
1653634053197,COGS 200,A01,087991,Staff,47,0,50,3
1653634053730,COGS 201,A01,094504,Rangel; Lara M,16,0,25,9
1653634054254,COGS 203,A00,087992,Coulson; Seana M,18,0,20,2
1653634054781,COGS 210A,001,087993,Greene; Deanna Jacquelyn,9998,0,9999,1
1653634054781,COGS 210A,002,087994,Saygin; Ayse P,9999,0,9999,0
1653634054781,COGS 210A,003,087995,Xia; Haijun,9999,0,9999,0
1653634054781,COGS 210A,004,087996,Nitz; Douglas A.,9999,0,9999,0
1653634054781,COGS 210A,005,087997,Hollan; James D.,9999,0,9999,0
1653634054781,COGS 210A,006,087998,Deak; Gedeon O.,9998,0,9999,1
1653634054781,COGS 210A,007,087999,Rossano; Federico,9999,0,9999,0
1653634055306,COGS 211A,A00,088000,Coulson; Seana M,9997,0,9999,2
1653634055829,COGS 229,A00,088002,Staff,22,0,25,3
1653634056353,COGS 260,B00,094231,Staff,17,0,20,3
1653634056353,COGS 260,A00,088004,Nitz; Douglas A.,9998,0,9999,1
1653634056876,CSE 202,A00,090110,Paturi; Ramamohan,0,0,0,0
1653634056876,CSE 202,B00,090111,Paturi; Ramamohan,0,0,0,0
1653634057398,CSE 207B,A00,090112,Heninger; Nadia A,0,0,0,0
1653634057920,CSE 208,A00,094858,Micciancio; Daniele,0,0,0,0
1653634058446,CSE 210,A00,090113,Powell; Thomas Allan,0,0,0,0
1653634058983,CSE 219,A00,090898,Staff,0,0,0,0
1653634059528,CSE 221,A00,090114,Zhou; Yuan-Yuan,0,0,0,0
1653634060064,CSE 229A,A00,090115,Porter; George M,0,0,0,0
1653634060591,CSE 229C,A00,090116,Savage; Stefan,0,0,0,0
1653634061115,CSE 230,A00,090117,Jhala; Ranjit,0,0,0,0
1653634061638,CSE 232,A00,090118,Papakonstantinou; Yannis,0,0,0,0
1653634062169,CSE 239A,A00,090121,Kumar; Arun Kumar,0,0,0,0
1653634062705,CSE 239B,A00,090122,Jhala; Ranjit,0,0,0,0
1653634063230,CSE 240A,A00,090123,Zhao; Jishen,0,0,189,189
1653634063761,CSE 243A,A00,090124,Orailoglu; Alex,0,0,15,15
1653634064284,CSE 249B,A00,090125,Kahng; Andrew Byun,12,0,20,8
1653634064807,CSE 250A,A00,090126,Berg-Kirkpatrick; Taylor D,0,0,0,0
1653634065329,CSE 252A,A00,090127,Ochoa; Benjamin Lawrence,0,0,0,0
1653634065855,CSE 258,A01,090129,McAuley; Julian John,0,0,0,0
1653634066377,CSE 258R,A01,090131,McAuley; Julian John,0,0,0,0
1653634066903,CSE 274,A00,090132,Ramamoorthi; Ravi,0,0,0,0
1653634067430,CSE 276A,A00,090133,Christensen; Henrik I,0,0,0,0
1653634067953,CSE 276C,A00,090134,Christensen; Henrik I,0,0,0,0
1653634068479,CSE 290,A00,090135,Bafna; Vineet,0,0,0,0
1653634068479,CSE 290,B00,090136,Ramamoorthi; Ravi,0,0,0,0
1653634068479,CSE 290,C00,090137,Li; Tzumao,7,0,10,3
1653634068479,CSE 290,D00,090138,Zhou; Yuan-Yuan,9,0,10,1
1653634068479,CSE 290,E00,090139,Christensen; Henrik I,8,0,10,2
1653634068479,CSE 290,F00,094053,Shalev; Aaron D,0,0,0,0
1653634069003,CSE 291,A00,090140,Munyaka; Imani N. S.,0,0,0,0
1653634069003,CSE 291,B00,094880,Yu; Qi,0,0,0,0
1653634069003,CSE 291,C00,090142,Pannuto; Patrick William,0,0,0,0
1653634069003,CSE 291,D00,094881,Zhang; Yiying,0,0,0,0
1653634069003,CSE 291,E00,095118,Su; Hao,0,0,0,0
1653634069538,CSE 293,001,094905,Bafna; Vineet,9999,0,9999,0
1653634069538,CSE 293,002,094906,Bellare; Mihir,9999,0,9999,0
1653634069538,CSE 293,003,094907,Berg-Kirkpatrick; Taylor D,9999,0,9999,0
1653634069538,CSE 293,004,094908,Christensen; Henrik I,9999,0,9999,0
1653634069538,CSE 293,005,094909,Cottrell; Garrison W,9999,0,9999,0
1653634069538,CSE 293,006,094910,Deutsch; Alin Bernard,9999,0,9999,0
1653634069538,CSE 293,007,094911,Esmaeilzadeh; Hadi,9999,0,9999,0
1653634069538,CSE 293,008,094912,Freund; Yoav,9999,0,9999,0
1653634069538,CSE 293,009,094913,Griswold; William G.,9999,0,9999,0
1653634069538,CSE 293,010,094914,Gymrek; Melissa Ann,9999,0,9999,0
1653634069538,CSE 293,011,094915,Heninger; Nadia A,9999,0,9999,0
1653634069538,CSE 293,012,094916,Impagliazzo; Russell,9999,0,9999,0
1653634069538,CSE 293,013,094917,Jhala; Ranjit,9999,0,9999,0
1653634069538,CSE 293,014,094918,Kahng; Andrew Byun,9999,0,9999,0
1653634069538,CSE 293,015,094919,Kane; Daniel Mertz,9999,0,9999,0
1653634069538,CSE 293,016,094920,Kriegman; David J,9999,0,9999,0
1653634069538,CSE 293,017,094921,Kumar; Arun Kumar,9999,0,9999,0
1653634069538,CSE 293,018,094922,Lerner; Sorin,9999,0,9999,0
1653634069538,CSE 293,019,094923,Lovett; Shachar,9999,0,9999,0
1653634069538,CSE 293,020,094924,McAuley; Julian John,9999,0,9999,0
1653634069538,CSE 293,021,094925,Micciancio; Daniele,9999,0,9999,0
1653634069538,CSE 293,022,094926,Orailoglu; Alex,9999,0,9999,0
1653634069538,CSE 293,023,094927,Paturi; Ramamohan,9999,0,9999,0
1653634069538,CSE 293,024,094928,Polikarpova; Nadezhda,9999,0,9999,0
1653634069538,CSE 293,025,094929,Politz; Joseph Gibbs,9999,0,9999,0
1653634069538,CSE 293,026,094930,Porter; George M,9999,0,9999,0
1653634069538,CSE 293,027,094931,Porter; Leonard Emerson,9999,0,9999,0
1653634069538,CSE 293,028,094932,Ramamoorthi; Ravi,9999,0,9999,0
1653634069538,CSE 293,029,094933,Sahoo; Debashis,9999,0,9999,0
1653634069538,CSE 293,030,094934,Saul; Lawrence,9999,0,9999,0
1653634069538,CSE 293,031,094935,Savage; Stefan,9999,0,9999,0
1653634069538,CSE 293,032,094936,Schulze; Jurgen P.,9999,0,9999,0
1653634069538,CSE 293,033,094937,Snoeren; Alex C.,9999,0,9999,0
1653634069538,CSE 293,034,094938,Shang; Jingbo,9999,0,9999,0
1653634069538,CSE 293,035,094939,Stefan; Deian,9999,0,9999,0
1653634069538,CSE 293,036,094940,Su; Hao,9999,0,9999,0
1653634069538,CSE 293,037,094941,Swanson; Steven James,9999,0,9999,0
1653634069538,CSE 293,038,094942,Tullsen; Dean Michael,9999,0,9999,0
1653634069538,CSE 293,039,094943,Voelker; Geoffrey M.,9999,0,9999,0
1653634069538,CSE 293,040,094944,Zhao; Jishen,9999,0,9999,0
1653634069538,CSE 293,041,094945,Zhou; Yuan-Yuan,9999,0,9999,0
1653634069538,CSE 293,042,094946,Gao; Sicun,9998,0,9999,1
1653634069538,CSE 293,043,094947,Weibel; Nadir,9999,0,9999,0
1653634069538,CSE 293,044,094948,Gupta; Rajesh K.,9999,0,9999,0
1653634070065,CSE 294,A00,090143,Porter; George M,9,0,10,1
1653634070589,DSE 200,A00,091799,Staff,50,0,50,0
1653634071114,DSE 203,A00,091800,Gupta; Amarnath,30,0,30,0
1653634071639,DSE 250,A00,091801,Deutsch; Alin Bernard,30,0,30,0
1653634072161,DSE 290,A00,091802,Altintas De Callaf; Ilkay,50,0,50,0
1653634072701,ECE 200,001,091003,Antipa; Nicholas A,9999,0,9999,0
1653634072701,ECE 200,002,091004,Atanasov; Nikolay A.,9999,0,9999,0
1653634072701,ECE 200,003,091005,Bharadia; Dinesh,9999,0,9999,0
1653634072701,ECE 200,004,091006,Cheng; Chung Kuan,9999,0,9999,0
1653634072701,ECE 200,005,091007,Cosman; Pamela C.,9999,0,9999,0
1653634072701,ECE 200,006,091008,Staff,9999,0,9999,0
1653634072701,ECE 200,007,091009,Dayeh; Shadi Ahmad,9999,0,9999,0
1653634072701,ECE 200,008,091010,Fainman; Yeshaiahu,9999,0,9999,0
1653634072701,ECE 200,009,091011,Ford; Joseph Earl,9999,0,9999,0
1653634072701,ECE 200,010,091012,Franceschetti; Massimo,9999,0,9999,0
1653634072701,ECE 200,011,091013,Fullerton; Eric E,9999,0,9999,0
1653634072701,ECE 200,012,091014,Galton; Ian A,9999,0,9999,0
1653634072701,ECE 200,013,091015,Gilja; Vikash,9999,0,9999,0
1653634072701,ECE 200,014,091016,Hall; Drew A.,9999,0,9999,0
1653634072701,ECE 200,015,091017,Hsueh; Tzu-Chien,9999,0,9999,0
1653634072701,ECE 200,016,091018,Javidi; Tara,9999,0,9999,0
1653634072701,ECE 200,017,091019,Kahng; Andrew Byun,9999,0,9999,0
1653634072701,ECE 200,018,091020,Kim; Young-Han,9999,0,9999,0
1653634072701,ECE 200,019,091021,Koushanfar; Farinaz,9999,0,9999,0
1653634072701,ECE 200,020,091022,Kuzum; Duygu,9999,0,9999,0
1653634072701,ECE 200,021,091023,Le; Hanh-Phuc,9999,0,9999,0
1653634072701,ECE 200,022,091024,Lin; Bill,9999,0,9999,0
1653634072701,ECE 200,023,091025,Liu; Zhaowei,9999,0,9999,0
1653634072701,ECE 200,024,091026,Lo; Yu-Hwa,9999,0,9999,0
1653634072701,ECE 200,025,091027,Lomakin; Vitaliy,9999,0,9999,0
1653634072701,ECE 200,026,091028,Mercier; Patrick Philip,9999,0,9999,0
1653634072701,ECE 200,027,091029,Meyer; Florian,9999,0,9999,0
1653634072701,ECE 200,028,091030,Milstein; Laurence B.,9999,0,9999,0
1653634072701,ECE 200,029,091031,Mir Arabbaygi; Siavash,9999,0,9999,0
1653634072701,ECE 200,030,091032,Mookherjea; Shayan,9999,0,9999,0
1653634072701,ECE 200,031,091033,Morris; Karcher William,9999,0,9999,0
1653634072701,ECE 200,032,091034,Ng; Tse Nga,9999,0,9999,0
1653634072701,ECE 200,033,091035,Nguyen; Truong Quang,9999,0,9999,0
1653634072701,ECE 200,034,091036,Nomura; Kenji,9999,0,9999,0
1653634072701,ECE 200,035,091037,Orlitsky; Alon,9999,0,9999,0
1653634072701,ECE 200,036,091038,Pal; Piya,9999,0,9999,0
1653634072701,ECE 200,037,091039,Papen; George C.,9999,0,9999,0
1653634072701,ECE 200,038,091040,Radic; Stojan,9999,0,9999,0
1653634072701,ECE 200,039,091041,Rao; Bhaskar D.,9999,0,9999,0
1653634072701,ECE 200,040,091042,Rao; Ramesh R,9999,0,9999,0
1653634072701,ECE 200,041,091043,Rebeiz; Gabriel,9999,0,9999,0
1653634072701,ECE 200,042,091044,Sanford; John R,9999,0,9999,0
1653634072701,ECE 200,043,091045,Siegel; Paul H.,9999,0,9999,0
1653634072701,ECE 200,044,091046,Sievenpiper; Daniel F.,9999,0,9999,0
1653634072701,ECE 200,045,091047,Sworder; David D.,9999,0,9999,0
1653634072701,ECE 200,046,091048,Taur; Yuan,9999,0,9999,0
1653634072701,ECE 200,047,091049,Touri; Behrouz,9999,0,9999,0
1653634072701,ECE 200,048,091050,Trivedi; Mohan M.,9999,0,9999,0
1653634072701,ECE 200,049,091051,Vardy; Alexander,9999,0,9999,0
1653634072701,ECE 200,050,091052,Vasconcelos; Nuno,9999,0,9999,0
1653634072701,ECE 200,051,091053,Wang; Xiaolong,9999,0,9999,0
1653634072701,ECE 200,052,091054,Xie; Pengtao,9999,0,9999,0
1653634072701,ECE 200,053,091055,Yip; Michael,9999,0,9999,0
1653634072701,ECE 200,054,091056,Zeger; Kenneth A.,9999,0,9999,0
1653634072701,ECE 200,055,091057,Zhang; Xinyu,9999,0,9999,0
1653634072701,ECE 200,056,091058,Turakhia; Yatish Girish,9999,0,9999,0
1653634072701,ECE 200,057,091059,Kang; Mingu,9999,0,9999,0
1653634072701,ECE 200,058,091060,Shi; Yuanyuan,9999,0,9999,0
1653634072701,ECE 200,059,091061,Wang; Edward Jay,9999,0,9999,0
1653634072701,ECE 200,060,091062,Zheng; Yang,9999,0,9999,0
1653634073229,ECE 201,A00,095526,Lo; Yu-Hwa,0,0,0,0
1653634073753,ECE 203,A00,091065,Mercier; Patrick Philip,0,0,0,0
1653634074275,ECE 207A,A00,091605,Liu; Thomas Tao-Ming,0,0,0,0
1653634074801,ECE 212AN,A00,091068,Nomura; Kenji,0,0,0,0
1653634075324,ECE 222A,A00,091069,Rebeiz; Gabriel,0,0,0,0
1653634075846,ECE 225A,A00,091070,Orlitsky; Alon,0,0,0,0
1653634076379,ECE 230A,A00,091071,Nomura; Kenji,0,0,0,0
1653634076911,ECE 236A,A00,091072,Dayeh; Shadi Ahmad,0,0,0,0
1653634077444,ECE 238A,A00,091073,Luo; Jian,0,0,0,0
1653634077444,ECE 238A,B00,091074,Luo; Jian,0,0,0,0
1653634077968,ECE 240A,A00,091075,Radic; Stojan,0,0,0,0
1653634078493,ECE 247A,A00,091592,Shi; Lingyan,0,0,0,0
1653634079016,ECE 250,A00,091076,Touri; Behrouz,0,0,0,0
1653634079539,ECE 251C,A00,091078,Nguyen; Truong Quang,0,0,0,0
1653634080066,ECE 253,A00,091079,Cosman; Pamela C.,0,0,0,0
1653634080590,ECE 255A,A00,091080,Orlitsky; Alon,0,0,0,0
1653634081114,ECE 257A,A00,091081,Zhang; Xinyu,0,0,0,0
1653634081647,ECE 260A,A01,091084,Eldon; John,0,0,0,0
1653634082181,ECE 264C,A00,091085,Galton; Ian A,0,0,0,0
1653634082704,ECE 265C,A00,094889,Presti; Calogero Davide,0,0,0,9
1653634083227,ECE 266,A01,091087,Hall; Drew A.,0,0,0,0
1653634084279,ECE 271A,A00,091090,Vasconcelos; Nuno,0,0,0,0
1653634084804,ECE 272B,A00,091091,Sworder; David D.,0,0,0,0
1653634085327,ECE 275A,A00,091092,Meyer; Florian,0,0,0,0
1653634085849,ECE 277,A00,091093,An; Cheolhong,0,0,0,0
1653634086372,ECE 283,A00,091094,Le; Hanh-Phuc,0,0,0,0
1653634086895,ECE 284,A00,091095,Kang; Mingu,0,0,0,0
1653634086895,ECE 284,B00,091096,Wang; Edward Jay,0,0,0,0
1653634087420,ECE 285,A00,094334,Touri; Behrouz,0,0,0,0
1653634087946,ECE 289,A00,091097,Whelan; David Arthur,0,0,0,0
1653634088472,MATH 200A,A00,087414,Salehi Golsefidy; Alireza,7,0,8,1
1653634089005,MATH 202A,A00,087415,Gill; Philip E.,2,0,8,6
1653634089532,MATH 203A,A00,087416,Oprea; Dragos N.,6,0,8,2
1653634090055,MATH 204A,A00,087417,Kedlaya; Kiran S.,6,0,8,2
1653634090580,MATH 205,A00,087418,Sorensen; Claus M,6,0,8,2
1653634091103,MATH 206A,A00,087419,Izadi; Elham,6,0,8,2
1653634091716,MATH 207A,A00,087420,Mohammadi; Amir,5,0,8,3
1653634092238,MATH 208,A00,087421,Staff,8,0,10,2
1653634092760,MATH 209,A00,087422,Staff,10,0,10,0
1653634093294,MATH 218,A00,087423,Staff,10,0,10,0
1653634093817,MATH 220A,A00,087424,Novak; Jonathan I,6,0,8,2
1653634094340,MATH 231A,A00,087425,Bejenaru; Ioan,3,0,8,5
1653634094863,MATH 240A,A00,087426,Ebenfelt; Peter F,5,0,8,3
1653634095390,MATH 243,A00,087427,Staff,9,0,10,1
1653634095913,MATH 248,A00,087429,Staff,10,0,10,0
1653634096436,MATH 250A,A00,087430,Spolaor; Luca,4,0,8,4
1653634096967,MATH 257A,A00,087431,Spolaor; Luca,7,0,8,1
1653634097497,MATH 258,A00,087432,Staff,9,0,10,1
1653634098021,MATH 264A,A00,087433,Warnke; Lutz Peter,5,0,8,3
1653634098544,MATH 268,A00,087434,Staff,15,0,15,0
1653634099074,MATH 269,A00,087435,Staff,14,0,15,1
1653634099597,MATH 270A,A00,087436,Nie; Jiawang,0,0,8,8
1653634100135,MATH 272A,A00,087437,Tian; Xiaochuan,0,0,8,8
1653634100658,MATH 274,A01,087439,Cheng; Li-Tien,9,0,10,1
1653634100658,MATH 274,A02,087440,Cheng; Li-Tien,10,0,10,0
1653634101186,MATH 278A,A00,087441,Staff,8,0,10,2
1653634101709,MATH 278B,A00,087442,Staff,8,0,10,2
1653634102232,MATH 278C,A00,087443,Staff,8,0,10,2
1653634102754,MATH 280A,A00,087444,Zheng; Tianyi,0,0,8,8
1653634103282,MATH 281A,A00,087445,Bradic; Jelena,0,0,8,9
1653634103808,MATH 282A,A00,087446,Zhang; Danna,0,0,8,8
1653634104330,MATH 283,A00,087447,Tesler; Glenn,0,0,0,16
1653634104857,MATH 286,B00,095535,Kemp; Todd Aahron,5,0,8,3
1653634105380,MATH 287D,B00,095536,Bradic; Jelena,5,0,8,3
1653634105913,MATH 288,A00,087450,Staff,14,0,15,1
1653634105913,MATH 288,B00,087451,Staff,15,0,15,0
1653634105913,MATH 288,C00,087452,Staff,15,0,15,0
1653634106438,MATH 290A,A00,087453,Xu; Zhouli,6,0,8,2
1653634106965,MATH 291A,A00,087454,Xu; Zhouli,7,0,8,1
1653634107489,MATH 292,A00,087455,Staff,10,0,10,0
1653634108014,MATH 295,A00,087456,Staff,50,0,50,0
1653634108537,MATH 297,001,087457,Staff,997,0,999,2
1653634667755,COGS 200,A01,087991,Staff,47,0,50,3
1653634668286,COGS 201,A01,094504,Rangel; Lara M,16,0,25,9
1653634668808,COGS 203,A00,087992,Coulson; Seana M,18,0,20,2
1653634669335,COGS 210A,001,087993,Greene; Deanna Jacquelyn,9998,0,9999,1
1653634669335,COGS 210A,002,087994,Saygin; Ayse P,9999,0,9999,0
1653634669335,COGS 210A,003,087995,Xia; Haijun,9999,0,9999,0
1653634669335,COGS 210A,004,087996,Nitz; Douglas A.,9999,0,9999,0
1653634669335,COGS 210A,005,087997,Hollan; James D.,9999,0,9999,0
1653634669335,COGS 210A,006,087998,Deak; Gedeon O.,9998,0,9999,1
1653634669335,COGS 210A,007,087999,Rossano; Federico,9999,0,9999,0
1653634669858,COGS 211A,A00,088000,Coulson; Seana M,9997,0,9999,2
1653634670382,COGS 229,A00,088002,Staff,22,0,25,3
1653634670912,COGS 260,B00,094231,Staff,17,0,20,3
1653634670912,COGS 260,A00,088004,Nitz; Douglas A.,9998,0,9999,1
1653634671435,CSE 202,A00,090110,Paturi; Ramamohan,0,0,0,0
1653634671435,CSE 202,B00,090111,Paturi; Ramamohan,0,0,0,0
1653634671965,CSE 207B,A00,090112,Heninger; Nadia A,0,0,0,0
1653634672491,CSE 208,A00,094858,Micciancio; Daniele,0,0,0,0
1653634673014,CSE 210,A00,090113,Powell; Thomas Allan,0,0,0,0
1653634673536,CSE 219,A00,090898,Staff,0,0,0,0
1653634674072,CSE 221,A00,090114,Zhou; Yuan-Yuan,0,0,0,0
1653634674605,CSE 229A,A00,090115,Porter; George M,0,0,0,0
1653634675146,CSE 229C,A00,090116,Savage; Stefan,0,0,0,0
1653634675669,CSE 230,A00,090117,Jhala; Ranjit,0,0,0,0
1653634676196,CSE 232,A00,090118,Papakonstantinou; Yannis,0,0,0,0
1653634676718,CSE 239A,A00,090121,Kumar; Arun Kumar,0,0,0,0
1653634677244,CSE 239B,A00,090122,Jhala; Ranjit,0,0,0,0
1653634677786,CSE 240A,A00,090123,Zhao; Jishen,0,0,189,189
1653634678394,CSE 243A,A00,090124,Orailoglu; Alex,0,0,15,15
1653634678919,CSE 249B,A00,090125,Kahng; Andrew Byun,12,0,20,8
1653634679446,CSE 250A,A00,090126,Berg-Kirkpatrick; Taylor D,0,0,0,0
1653634679971,CSE 252A,A00,090127,Ochoa; Benjamin Lawrence,0,0,0,0
1653634680495,CSE 258,A01,090129,McAuley; Julian John,0,0,0,0
1653634681020,CSE 258R,A01,090131,McAuley; Julian John,0,0,0,0
1653634681547,CSE 274,A00,090132,Ramamoorthi; Ravi,0,0,0,0
1653634682070,CSE 276A,A00,090133,Christensen; Henrik I,0,0,0,0
1653634682598,CSE 276C,A00,090134,Christensen; Henrik I,0,0,0,0
1653634683119,CSE 290,A00,090135,Bafna; Vineet,0,0,0,0
1653634683119,CSE 290,B00,090136,Ramamoorthi; Ravi,0,0,0,0
1653634683119,CSE 290,C00,090137,Li; Tzumao,7,0,10,3
1653634683119,CSE 290,D00,090138,Zhou; Yuan-Yuan,9,0,10,1
1653634683119,CSE 290,E00,090139,Christensen; Henrik I,8,0,10,2
1653634683119,CSE 290,F00,094053,Shalev; Aaron D,0,0,0,0
1653634683648,CSE 291,A00,090140,Munyaka; Imani N. S.,0,0,0,0
1653634683648,CSE 291,B00,094880,Yu; Qi,0,0,0,0
1653634683648,CSE 291,C00,090142,Pannuto; Patrick William,0,0,0,0
1653634683648,CSE 291,D00,094881,Zhang; Yiying,0,0,0,0
1653634683648,CSE 291,E00,095118,Su; Hao,0,0,0,0
1653634684175,CSE 293,001,094905,Bafna; Vineet,9999,0,9999,0
1653634684175,CSE 293,002,094906,Bellare; Mihir,9999,0,9999,0
1653634684175,CSE 293,003,094907,Berg-Kirkpatrick; Taylor D,9999,0,9999,0
1653634684175,CSE 293,004,094908,Christensen; Henrik I,9999,0,9999,0
1653634684175,CSE 293,005,094909,Cottrell; Garrison W,9999,0,9999,0
1653634684175,CSE 293,006,094910,Deutsch; Alin Bernard,9999,0,9999,0
1653634684175,CSE 293,007,094911,Esmaeilzadeh; Hadi,9999,0,9999,0
1653634684175,CSE 293,008,094912,Freund; Yoav,9999,0,9999,0
1653634684175,CSE 293,009,094913,Griswold; William G.,9999,0,9999,0
1653634684175,CSE 293,010,094914,Gymrek; Melissa Ann,9999,0,9999,0
1653634684175,CSE 293,011,094915,Heninger; Nadia A,9999,0,9999,0
1653634684175,CSE 293,012,094916,Impagliazzo; Russell,9999,0,9999,0
1653634684175,CSE 293,013,094917,Jhala; Ranjit,9999,0,9999,0
1653634684175,CSE 293,014,094918,Kahng; Andrew Byun,9999,0,9999,0
1653634684175,CSE 293,015,094919,Kane; Daniel Mertz,9999,0,9999,0
1653634684175,CSE 293,016,094920,Kriegman; David J,9999,0,9999,0
1653634684175,CSE 293,017,094921,Kumar; Arun Kumar,9999,0,9999,0
1653634684175,CSE 293,018,094922,Lerner; Sorin,9999,0,9999,0
1653634684175,CSE 293,019,094923,Lovett; Shachar,9999,0,9999,0
1653634684175,CSE 293,020,094924,McAuley; Julian John,9999,0,9999,0
1653634684175,CSE 293,021,094925,Micciancio; Daniele,9999,0,9999,0
1653634684175,CSE 293,022,094926,Orailoglu; Alex,9999,0,9999,0
1653634684175,CSE 293,023,094927,Paturi; Ramamohan,9999,0,9999,0
1653634684175,CSE 293,024,094928,Polikarpova; Nadezhda,9999,0,9999,0
1653634684175,CSE 293,025,094929,Politz; Joseph Gibbs,9999,0,9999,0
1653634684175,CSE 293,026,094930,Porter; George M,9999,0,9999,0
1653634684175,CSE 293,027,094931,Porter; Leonard Emerson,9999,0,9999,0
1653634684175,CSE 293,028,094932,Ramamoorthi; Ravi,9999,0,9999,0
1653634684175,CSE 293,029,094933,Sahoo; Debashis,9999,0,9999,0
1653634684175,CSE 293,030,094934,Saul; Lawrence,9999,0,9999,0
1653634684175,CSE 293,031,094935,Savage; Stefan,9999,0,9999,0
1653634684175,CSE 293,032,094936,Schulze; Jurgen P.,9999,0,9999,0
1653634684175,CSE 293,033,094937,Snoeren; Alex C.,9999,0,9999,0
1653634684175,CSE 293,034,094938,Shang; Jingbo,9999,0,9999,0
1653634684175,CSE 293,035,094939,Stefan; Deian,9999,0,9999,0
1653634684175,CSE 293,036,094940,Su; Hao,9999,0,9999,0
1653634684175,CSE 293,037,094941,Swanson; Steven James,9999,0,9999,0
1653634684175,CSE 293,038,094942,Tullsen; Dean Michael,9999,0,9999,0
1653634684175,CSE 293,039,094943,Voelker; Geoffrey M.,9999,0,9999,0
1653634684175,CSE 293,040,094944,Zhao; Jishen,9999,0,9999,0
1653634684175,CSE 293,041,094945,Zhou; Yuan-Yuan,9999,0,9999,0
1653634684175,CSE 293,042,094946,Gao; Sicun,9998,0,9999,1
1653634684175,CSE 293,043,094947,Weibel; Nadir,9999,0,9999,0
1653634684175,CSE 293,044,094948,Gupta; Rajesh K.,9999,0,9999,0
1653634684696,CSE 294,A00,090143,Porter; George M,9,0,10,1
1653634685218,DSE 200,A00,091799,Staff,50,0,50,0
1653634685752,DSE 203,A00,091800,Gupta; Amarnath,30,0,30,0
1653634686274,DSE 250,A00,091801,Deutsch; Alin Bernard,30,0,30,0
1653634686797,DSE 290,A00,091802,Altintas De Callaf; Ilkay,50,0,50,0
1653634687323,ECE 200,001,091003,Antipa; Nicholas A,9999,0,9999,0
1653634687323,ECE 200,002,091004,Atanasov; Nikolay A.,9999,0,9999,0
1653634687323,ECE 200,003,091005,Bharadia; Dinesh,9999,0,9999,0
1653634687323,ECE 200,004,091006,Cheng; Chung Kuan,9999,0,9999,0
1653634687323,ECE 200,005,091007,Cosman; Pamela C.,9999,0,9999,0
1653634687323,ECE 200,006,091008,Staff,9999,0,9999,0
1653634687323,ECE 200,007,091009,Dayeh; Shadi Ahmad,9999,0,9999,0
1653634687323,ECE 200,008,091010,Fainman; Yeshaiahu,9999,0,9999,0
1653634687323,ECE 200,009,091011,Ford; Joseph Earl,9999,0,9999,0
1653634687323,ECE 200,010,091012,Franceschetti; Massimo,9999,0,9999,0
1653634687323,ECE 200,011,091013,Fullerton; Eric E,9999,0,9999,0
1653634687323,ECE 200,012,091014,Galton; Ian A,9999,0,9999,0
1653634687323,ECE 200,013,091015,Gilja; Vikash,9999,0,9999,0
1653634687323,ECE 200,014,091016,Hall; Drew A.,9999,0,9999,0
1653634687323,ECE 200,015,091017,Hsueh; Tzu-Chien,9999,0,9999,0
1653634687323,ECE 200,016,091018,Javidi; Tara,9999,0,9999,0
1653634687323,ECE 200,017,091019,Kahng; Andrew Byun,9999,0,9999,0
1653634687323,ECE 200,018,091020,Kim; Young-Han,9999,0,9999,0
1653634687323,ECE 200,019,091021,Koushanfar; Farinaz,9999,0,9999,0
1653634687323,ECE 200,020,091022,Kuzum; Duygu,9999,0,9999,0
1653634687323,ECE 200,021,091023,Le; Hanh-Phuc,9999,0,9999,0
1653634687323,ECE 200,022,091024,Lin; Bill,9999,0,9999,0
1653634687323,ECE 200,023,091025,Liu; Zhaowei,9999,0,9999,0
1653634687323,ECE 200,024,091026,Lo; Yu-Hwa,9999,0,9999,0
1653634687323,ECE 200,025,091027,Lomakin; Vitaliy,9999,0,9999,0
1653634687323,ECE 200,026,091028,Mercier; Patrick Philip,9999,0,9999,0
1653634687323,ECE 200,027,091029,Meyer; Florian,9999,0,9999,0
1653634687323,ECE 200,028,091030,Milstein; Laurence B.,9999,0,9999,0
1653634687323,ECE 200,029,091031,Mir Arabbaygi; Siavash,9999,0,9999,0
1653634687323,ECE 200,030,091032,Mookherjea; Shayan,9999,0,9999,0
1653634687323,ECE 200,031,091033,Morris; Karcher William,9999,0,9999,0
1653634687323,ECE 200,032,091034,Ng; Tse Nga,9999,0,9999,0
1653634687323,ECE 200,033,091035,Nguyen; Truong Quang,9999,0,9999,0
1653634687323,ECE 200,034,091036,Nomura; Kenji,9999,0,9999,0
1653634687323,ECE 200,035,091037,Orlitsky; Alon,9999,0,9999,0
1653634687323,ECE 200,036,091038,Pal; Piya,9999,0,9999,0
1653634687323,ECE 200,037,091039,Papen; George C.,9999,0,9999,0
1653634687323,ECE 200,038,091040,Radic; Stojan,9999,0,9999,0
1653634687323,ECE 200,039,091041,Rao; Bhaskar D.,9999,0,9999,0
1653634687323,ECE 200,040,091042,Rao; Ramesh R,9999,0,9999,0
1653634687323,ECE 200,041,091043,Rebeiz; Gabriel,9999,0,9999,0
1653634687323,ECE 200,042,091044,Sanford; John R,9999,0,9999,0
1653634687323,ECE 200,043,091045,Siegel; Paul H.,9999,0,9999,0
1653634687323,ECE 200,044,091046,Sievenpiper; Daniel F.,9999,0,9999,0
1653634687323,ECE 200,045,091047,Sworder; David D.,9999,0,9999,0
1653634687323,ECE 200,046,091048,Taur; Yuan,9999,0,9999,0
1653634687323,ECE 200,047,091049,Touri; Behrouz,9999,0,9999,0
1653634687323,ECE 200,048,091050,Trivedi; Mohan M.,9999,0,9999,0
1653634687323,ECE 200,049,091051,Vardy; Alexander,9999,0,9999,0
1653634687323,ECE 200,050,091052,Vasconcelos; Nuno,9999,0,9999,0
1653634687323,ECE 200,051,091053,Wang; Xiaolong,9999,0,9999,0
1653634687323,ECE 200,052,091054,Xie; Pengtao,9999,0,9999,0
1653634687323,ECE 200,053,091055,Yip; Michael,9999,0,9999,0
1653634687323,ECE 200,054,091056,Zeger; Kenneth A.,9999,0,9999,0
1653634687323,ECE 200,055,091057,Zhang; Xinyu,9999,0,9999,0
1653634687323,ECE 200,056,091058,Turakhia; Yatish Girish,9999,0,9999,0
1653634687323,ECE 200,057,091059,Kang; Mingu,9999,0,9999,0
1653634687323,ECE 200,058,091060,Shi; Yuanyuan,9999,0,9999,0
1653634687323,ECE 200,059,091061,Wang; Edward Jay,9999,0,9999,0
1653634687323,ECE 200,060,091062,Zheng; Yang,9999,0,9999,0
1653634687850,ECE 201,A00,095526,Lo; Yu-Hwa,0,0,0,0
1653634688375,ECE 203,A00,091065,Mercier; Patrick Philip,0,0,0,0
1653634688899,ECE 207A,A00,091605,Liu; Thomas Tao-Ming,0,0,0,0
1653634689423,ECE 212AN,A00,091068,Nomura; Kenji,0,0,0,0
1653634689946,ECE 222A,A00,091069,Rebeiz; Gabriel,0,0,0,0
1653634690472,ECE 225A,A00,091070,Orlitsky; Alon,0,0,0,0
1653634690996,ECE 230A,A00,091071,Nomura; Kenji,0,0,0,0
1653634691517,ECE 236A,A00,091072,Dayeh; Shadi Ahmad,0,0,0,0
1653634692040,ECE 238A,A00,091073,Luo; Jian,0,0,0,0
1653634692040,ECE 238A,B00,091074,Luo; Jian,0,0,0,0
1653634692564,ECE 240A,A00,091075,Radic; Stojan,0,0,0,0
1653634693091,ECE 247A,A00,091592,Shi; Lingyan,0,0,0,0
1653634693621,ECE 250,A00,091076,Touri; Behrouz,0,0,0,0
1653634694147,ECE 251C,A00,091078,Nguyen; Truong Quang,0,0,0,0
1653634694684,ECE 253,A00,091079,Cosman; Pamela C.,0,0,0,0
1653634695206,ECE 255A,A00,091080,Orlitsky; Alon,0,0,0,0
1653634695732,ECE 257A,A00,091081,Zhang; Xinyu,0,0,0,0
1653634696255,ECE 260A,A01,091084,Eldon; John,0,0,0,0
1653634696778,ECE 264C,A00,091085,Galton; Ian A,0,0,0,0
1653634697305,ECE 265C,A00,094889,Presti; Calogero Davide,0,0,0,9
1653634697835,ECE 266,A01,091087,Hall; Drew A.,0,0,0,0
1653634698879,ECE 271A,A00,091090,Vasconcelos; Nuno,0,0,0,0
1653634699403,ECE 272B,A00,091091,Sworder; David D.,0,0,0,0
1653634699935,ECE 275A,A00,091092,Meyer; Florian,0,0,0,0
1653634700458,ECE 277,A00,091093,An; Cheolhong,0,0,0,0
1653634700982,ECE 283,A00,091094,Le; Hanh-Phuc,0,0,0,0
1653634701506,ECE 284,A00,091095,Kang; Mingu,0,0,0,0
1653634701506,ECE 284,B00,091096,Wang; Edward Jay,0,0,0,0
1653634702032,ECE 285,A00,094334,Touri; Behrouz,0,0,0,0
1653634702558,ECE 289,A00,091097,Whelan; David Arthur,0,0,0,0
1653634703081,MATH 200A,A00,087414,Salehi Golsefidy; Alireza,7,0,8,1
1653634703614,MATH 202A,A00,087415,Gill; Philip E.,2,0,8,6
1653634704140,MATH 203A,A00,087416,Oprea; Dragos N.,6,0,8,2
1653634704672,MATH 204A,A00,087417,Kedlaya; Kiran S.,6,0,8,2
1653634705198,MATH 205,A00,087418,Sorensen; Claus M,6,0,8,2
1653634705724,MATH 206A,A00,087419,Izadi; Elham,6,0,8,2
1653634706249,MATH 207A,A00,087420,Mohammadi; Amir,5,0,8,3
1653634706771,MATH 208,A00,087421,Staff,8,0,10,2
1653634707294,MATH 209,A00,087422,Staff,10,0,10,0
1653634707819,MATH 218,A00,087423,Staff,10,0,10,0
1653634708345,MATH 220A,A00,087424,Novak; Jonathan I,6,0,8,2
1653634708887,MATH 231A,A00,087425,Bejenaru; Ioan,3,0,8,5
1653634709412,MATH 240A,A00,087426,Ebenfelt; Peter F,5,0,8,3
1653634709935,MATH 243,A00,087427,Staff,9,0,10,1
1653634710459,MATH 248,A00,087429,Staff,10,0,10,0
1653634710980,MATH 250A,A00,087430,Spolaor; Luca,4,0,8,4
1653634711503,MATH 257A,A00,087431,Spolaor; Luca,7,0,8,1
1653634712025,MATH 258,A00,087432,Staff,9,0,10,1
1653634712547,MATH 264A,A00,087433,Warnke; Lutz Peter,5,0,8,3
1653634713069,MATH 268,A00,087434,Staff,15,0,15,0
1653634713594,MATH 269,A00,087435,Staff,14,0,15,1
1653634714116,MATH 270A,A00,087436,Nie; Jiawang,0,0,8,8
1653634714638,MATH 272A,A00,087437,Tian; Xiaochuan,0,0,8,8
1653634715164,MATH 274,A01,087439,Cheng; Li-Tien,9,0,10,1
1653634715164,MATH 274,A02,087440,Cheng; Li-Tien,10,0,10,0
1653634715687,MATH 278A,A00,087441,Staff,8,0,10,2
1653634716210,MATH 278B,A00,087442,Staff,8,0,10,2
1653634716732,MATH 278C,A00,087443,Staff,8,0,10,2
1653634717258,MATH 280A,A00,087444,Zheng; Tianyi,0,0,8,8
1653634717782,MATH 281A,A00,087445,Bradic; Jelena,0,0,8,9
1653634718305,MATH 282A,A00,087446,Zhang; Danna,0,0,8,8
1653634718832,MATH 283,A00,087447,Tesler; Glenn,0,0,0,16
1653634719358,MATH 286,B00,095535,Kemp; Todd Aahron,5,0,8,3
1653634719885,MATH 287D,B00,095536,Bradic; Jelena,5,0,8,3
1653634720412,MATH 288,A00,087450,Staff,14,0,15,1
1653634720412,MATH 288,B00,087451,Staff,15,0,15,0
1653634720412,MATH 288,C00,087452,Staff,15,0,15,0
1653634720940,MATH 290A,A00,087453,Xu; Zhouli,6,0,8,2
1653634721461,MATH 291A,A00,087454,Xu; Zhouli,7,0,8,1
1653634721984,MATH 292,A00,087455,Staff,10,0,10,0
1653634722507,MATH 295,A00,087456,Staff,50,0,50,0
1653634723028,MATH 297,001,087457,Staff,997,0,999,2
1653635282873,COGS 200,A01,087991,Staff,47,0,50,3
1653635283400,COGS 201,A01,094504,Rangel; Lara M,16,0,25,9
1653635283927,COGS 203,A00,087992,Coulson; Seana M,18,0,20,2
1653635284455,COGS 210A,001,087993,Greene; Deanna Jacquelyn,9998,0,9999,1
1653635284455,COGS 210A,002,087994,Saygin; Ayse P,9999,0,9999,0
1653635284455,COGS 210A,003,087995,Xia; Haijun,9999,0,9999,0
1653635284455,COGS 210A,004,087996,Nitz; Douglas A.,9999,0,9999,0
1653635284455,COGS 210A,005,087997,Hollan; James D.,9999,0,9999,0
1653635284455,COGS 210A,006,087998,Deak; Gedeon O.,9998,0,9999,1
1653635284455,COGS 210A,007,087999,Rossano; Federico,9999,0,9999,0
1653635284982,COGS 211A,A00,088000,Coulson; Seana M,9997,0,9999,2
1653635285507,COGS 229,A00,088002,Staff,22,0,25,3
1653635286035,COGS 260,B00,094231,Staff,17,0,20,3
1653635286035,COGS 260,A00,088004,Nitz; Douglas A.,9998,0,9999,1
1653635286559,CSE 202,A00,090110,Paturi; Ramamohan,0,0,0,0
1653635286559,CSE 202,B00,090111,Paturi; Ramamohan,0,0,0,0
1653635287087,CSE 207B,A00,090112,Heninger; Nadia A,0,0,0,0
1653635287611,CSE 208,A00,094858,Micciancio; Daniele,0,0,0,0
1653635288137,CSE 210,A00,090113,Powell; Thomas Allan,0,0,0,0
1653635288664,CSE 219,A00,090898,Staff,0,0,0,0
1653635289186,CSE 221,A00,090114,Zhou; Yuan-Yuan,0,0,0,0
1653635289712,CSE 229A,A00,090115,Porter; George M,0,0,0,0
1653635290252,CSE 229C,A00,090116,Savage; Stefan,0,0,0,0
1653635290776,CSE 230,A00,090117,Jhala; Ranjit,0,0,0,0
1653635291301,CSE 232,A00,090118,Papakonstantinou; Yannis,0,0,0,0
1653635291830,CSE 239A,A00,090121,Kumar; Arun Kumar,0,0,0,0
1653635292353,CSE 239B,A00,090122,Jhala; Ranjit,0,0,0,0
1653635292876,CSE 240A,A00,090123,Zhao; Jishen,0,0,189,189
1653635293400,CSE 243A,A00,090124,Orailoglu; Alex,0,0,15,15
1653635293923,CSE 249B,A00,090125,Kahng; Andrew Byun,12,0,20,8
1653635294446,CSE 250A,A00,090126,Berg-Kirkpatrick; Taylor D,0,0,0,0
1653635294973,CSE 252A,A00,090127,Ochoa; Benjamin Lawrence,0,0,0,0
1653635295502,CSE 258,A01,090129,McAuley; Julian John,0,0,0,0
1653635296030,CSE 258R,A01,090131,McAuley; Julian John,0,0,0,0
1653635296566,CSE 274,A00,090132,Ramamoorthi; Ravi,0,0,0,0
1653635297089,CSE 276A,A00,090133,Christensen; Henrik I,0,0,0,0
1653635297612,CSE 276C,A00,090134,Christensen; Henrik I,0,0,0,0
1653635298134,CSE 290,A00,090135,Bafna; Vineet,0,0,0,0
1653635298134,CSE 290,B00,090136,Ramamoorthi; Ravi,0,0,0,0
1653635298134,CSE 290,C00,090137,Li; Tzumao,7,0,10,3
1653635298134,CSE 290,D00,090138,Zhou; Yuan-Yuan,9,0,10,1
1653635298134,CSE 290,E00,090139,Christensen; Henrik I,8,0,10,2
1653635298134,CSE 290,F00,094053,Shalev; Aaron D,0,0,0,0
1653635298669,CSE 291,A00,090140,Munyaka; Imani N. S.,0,0,0,0
1653635298669,CSE 291,B00,094880,Yu; Qi,0,0,0,0
1653635298669,CSE 291,C00,090142,Pannuto; Patrick William,0,0,0,0
1653635298669,CSE 291,D00,094881,Zhang; Yiying,0,0,0,0
1653635298669,CSE 291,E00,095118,Su; Hao,0,0,0,0
1653635299195,CSE 293,001,094905,Bafna; Vineet,9999,0,9999,0
1653635299195,CSE 293,002,094906,Bellare; Mihir,9999,0,9999,0
1653635299195,CSE 293,003,094907,Berg-Kirkpatrick; Taylor D,9999,0,9999,0
1653635299195,CSE 293,004,094908,Christensen; Henrik I,9999,0,9999,0
1653635299195,CSE 293,005,094909,Cottrell; Garrison W,9999,0,9999,0
1653635299195,CSE 293,006,094910,Deutsch; Alin Bernard,9999,0,9999,0
1653635299195,CSE 293,007,094911,Esmaeilzadeh; Hadi,9999,0,9999,0
1653635299195,CSE 293,008,094912,Freund; Yoav,9999,0,9999,0
1653635299195,CSE 293,009,094913,Griswold; William G.,9999,0,9999,0
1653635299195,CSE 293,010,094914,Gymrek; Melissa Ann,9999,0,9999,0
1653635299195,CSE 293,011,094915,Heninger; Nadia A,9999,0,9999,0
1653635299195,CSE 293,012,094916,Impagliazzo; Russell,9999,0,9999,0
1653635299195,CSE 293,013,094917,Jhala; Ranjit,9999,0,9999,0
1653635299195,CSE 293,014,094918,Kahng; Andrew Byun,9999,0,9999,0
1653635299195,CSE 293,015,094919,Kane; Daniel Mertz,9999,0,9999,0
1653635299195,CSE 293,016,094920,Kriegman; David J,9999,0,9999,0
1653635299195,CSE 293,017,094921,Kumar; Arun Kumar,9999,0,9999,0
1653635299195,CSE 293,018,094922,Lerner; Sorin,9999,0,9999,0
1653635299195,CSE 293,019,094923,Lovett; Shachar,9999,0,9999,0
1653635299195,CSE 293,020,094924,McAuley; Julian John,9999,0,9999,0
1653635299195,CSE 293,021,094925,Micciancio; Daniele,9999,0,9999,0
1653635299195,CSE 293,022,094926,Orailoglu; Alex,9999,0,9999,0
1653635299195,CSE 293,023,094927,Paturi; Ramamohan,9999,0,9999,0
1653635299195,CSE 293,024,094928,Polikarpova; Nadezhda,9999,0,9999,0
1653635299195,CSE 293,025,094929,Politz; Joseph Gibbs,9999,0,9999,0
1653635299195,CSE 293,026,094930,Porter; George M,9999,0,9999,0
1653635299195,CSE 293,027,094931,Porter; Leonard Emerson,9999,0,9999,0
1653635299195,CSE 293,028,094932,Ramamoorthi; Ravi,9999,0,9999,0
1653635299195,CSE 293,029,094933,Sahoo; Debashis,9999,0,9999,0
1653635299195,CSE 293,030,094934,Saul; Lawrence,9999,0,9999,0
1653635299195,CSE 293,031,094935,Savage; Stefan,9999,0,9999,0
1653635299195,CSE 293,032,094936,Schulze; Jurgen P.,9999,0,9999,0
1653635299195,CSE 293,033,094937,Snoeren; Alex C.,9999,0,9999,0
1653635299195,CSE 293,034,094938,Shang; Jingbo,9999,0,9999,0
1653635299195,CSE 293,035,094939,Stefan; Deian,9999,0,9999,0
1653635299195,CSE 293,036,094940,Su; Hao,9999,0,9999,0
1653635299195,CSE 293,037,094941,Swanson; Steven James,9999,0,9999,0
1653635299195,CSE 293,038,094942,Tullsen; Dean Michael,9999,0,9999,0
1653635299195,CSE 293,039,094943,Voelker; Geoffrey M.,9999,0,9999,0
1653635299195,CSE 293,040,094944,Zhao; Jishen,9999,0,9999,0
1653635299195,CSE 293,041,094945,Zhou; Yuan-Yuan,9999,0,9999,0
1653635299195,CSE 293,042,094946,Gao; Sicun,9998,0,9999,1
1653635299195,CSE 293,043,094947,Weibel; Nadir,9999,0,9999,0
1653635299195,CSE 293,044,094948,Gupta; Rajesh K.,9999,0,9999,0
1653635299720,CSE 294,A00,090143,Porter; George M,9,0,10,1
1653635300255,DSE 200,A00,091799,Staff,50,0,50,0
1653635300782,DSE 203,A00,091800,Gupta; Amarnath,30,0,30,0
1653635301304,DSE 250,A00,091801,Deutsch; Alin Bernard,30,0,30,0
1653635301827,DSE 290,A00,091802,Altintas De Callaf; Ilkay,50,0,50,0
1653635302358,ECE 200,001,091003,Antipa; Nicholas A,9999,0,9999,0
1653635302358,ECE 200,002,091004,Atanasov; Nikolay A.,9999,0,9999,0
1653635302358,ECE 200,003,091005,Bharadia; Dinesh,9999,0,9999,0
1653635302358,ECE 200,004,091006,Cheng; Chung Kuan,9999,0,9999,0
1653635302358,ECE 200,005,091007,Cosman; Pamela C.,9999,0,9999,0
1653635302358,ECE 200,006,091008,Staff,9999,0,9999,0
1653635302358,ECE 200,007,091009,Dayeh; Shadi Ahmad,9999,0,9999,0
1653635302358,ECE 200,008,091010,Fainman; Yeshaiahu,9999,0,9999,0
1653635302358,ECE 200,009,091011,Ford; Joseph Earl,9999,0,9999,0
1653635302358,ECE 200,010,091012,Franceschetti; Massimo,9999,0,9999,0
1653635302358,ECE 200,011,091013,Fullerton; Eric E,9999,0,9999,0
1653635302358,ECE 200,012,091014,Galton; Ian A,9999,0,9999,0
1653635302358,ECE 200,013,091015,Gilja; Vikash,9999,0,9999,0
1653635302358,ECE 200,014,091016,Hall; Drew A.,9999,0,9999,0
1653635302358,ECE 200,015,091017,Hsueh; Tzu-Chien,9999,0,9999,0
1653635302358,ECE 200,016,091018,Javidi; Tara,9999,0,9999,0
1653635302358,ECE 200,017,091019,Kahng; Andrew Byun,9999,0,9999,0
1653635302358,ECE 200,018,091020,Kim; Young-Han,9999,0,9999,0
1653635302358,ECE 200,019,091021,Koushanfar; Farinaz,9999,0,9999,0
1653635302358,ECE 200,020,091022,Kuzum; Duygu,9999,0,9999,0
1653635302358,ECE 200,021,091023,Le; Hanh-Phuc,9999,0,9999,0
1653635302358,ECE 200,022,091024,Lin; Bill,9999,0,9999,0
1653635302358,ECE 200,023,091025,Liu; Zhaowei,9999,0,9999,0
1653635302358,ECE 200,024,091026,Lo; Yu-Hwa,9999,0,9999,0
1653635302358,ECE 200,025,091027,Lomakin; Vitaliy,9999,0,9999,0
1653635302358,ECE 200,026,091028,Mercier; Patrick Philip,9999,0,9999,0
1653635302358,ECE 200,027,091029,Meyer; Florian,9999,0,9999,0
1653635302358,ECE 200,028,091030,Milstein; Laurence B.,9999,0,9999,0
1653635302358,ECE 200,029,091031,Mir Arabbaygi; Siavash,9999,0,9999,0
1653635302358,ECE 200,030,091032,Mookherjea; Shayan,9999,0,9999,0
1653635302358,ECE 200,031,091033,Morris; Karcher William,9999,0,9999,0
1653635302358,ECE 200,032,091034,Ng; Tse Nga,9999,0,9999,0
1653635302358,ECE 200,033,091035,Nguyen; Truong Quang,9999,0,9999,0
1653635302358,ECE 200,034,091036,Nomura; Kenji,9999,0,9999,0
1653635302358,ECE 200,035,091037,Orlitsky; Alon,9999,0,9999,0
1653635302358,ECE 200,036,091038,Pal; Piya,9999,0,9999,0
1653635302358,ECE 200,037,091039,Papen; George C.,9999,0,9999,0
1653635302358,ECE 200,038,091040,Radic; Stojan,9999,0,9999,0
1653635302358,ECE 200,039,091041,Rao; Bhaskar D.,9999,0,9999,0
1653635302358,ECE 200,040,091042,Rao; Ramesh R,9999,0,9999,0
1653635302358,ECE 200,041,091043,Rebeiz; Gabriel,9999,0,9999,0
1653635302358,ECE 200,042,091044,Sanford; John R,9999,0,9999,0
1653635302358,ECE 200,043,091045,Siegel; Paul H.,9999,0,9999,0
1653635302358,ECE 200,044,091046,Sievenpiper; Daniel F.,9999,0,9999,0
1653635302358,ECE 200,045,091047,Sworder; David D.,9999,0,9999,0
1653635302358,ECE 200,046,091048,Taur; Yuan,9999,0,9999,0
1653635302358,ECE 200,047,091049,Touri; Behrouz,9999,0,9999,0
1653635302358,ECE 200,048,091050,Trivedi; Mohan M.,9999,0,9999,0
1653635302358,ECE 200,049,091051,Vardy; Alexander,9999,0,9999,0
1653635302358,ECE 200,050,091052,Vasconcelos; Nuno,9999,0,9999,0
1653635302358,ECE 200,051,091053,Wang; Xiaolong,9999,0,9999,0
1653635302358,ECE 200,052,091054,Xie; Pengtao,9999,0,9999,0
1653635302358,ECE 200,053,091055,Yip; Michael,9999,0,9999,0
1653635302358,ECE 200,054,091056,Zeger; Kenneth A.,9999,0,9999,0
1653635302358,ECE 200,055,091057,Zhang; Xinyu,9999,0,9999,0
1653635302358,ECE 200,056,091058,Turakhia; Yatish Girish,9999,0,9999,0
1653635302358,ECE 200,057,091059,Kang; Mingu,9999,0,9999,0
1653635302358,ECE 200,058,091060,Shi; Yuanyuan,9999,0,9999,0
1653635302358,ECE 200,059,091061,Wang; Edward Jay,9999,0,9999,0
1653635302358,ECE 200,060,091062,Zheng; Yang,9999,0,9999,0
1653635302885,ECE 201,A00,095526,Lo; Yu-Hwa,0,0,0,0
1653635303413,ECE 203,A00,091065,Mercier; Patrick Philip,0,0,0,0
1653635303940,ECE 207A,A00,091605,Liu; Thomas Tao-Ming,0,0,0,0
1653635304463,ECE 212AN,A00,091068,Nomura; Kenji,0,0,0,0
1653635304988,ECE 222A,A00,091069,Rebeiz; Gabriel,0,0,0,0
1653635305512,ECE 225A,A00,091070,Orlitsky; Alon,0,0,0,0
1653635306041,ECE 230A,A00,091071,Nomura; Kenji,0,0,0,0
1653635306565,ECE 236A,A00,091072,Dayeh; Shadi Ahmad,0,0,0,0
1653635307096,ECE 238A,A00,091073,Luo; Jian,0,0,0,0
1653635307096,ECE 238A,B00,091074,Luo; Jian,0,0,0,0
1653635307620,ECE 240A,A00,091075,Radic; Stojan,0,0,0,0
1653635308144,ECE 247A,A00,091592,Shi; Lingyan,0,0,0,0
1653635308667,ECE 250,A00,091076,Touri; Behrouz,0,0,0,0
1653635309194,ECE 251C,A00,091078,Nguyen; Truong Quang,0,0,0,0
1653635309723,ECE 253,A00,091079,Cosman; Pamela C.,0,0,0,0
1653635310246,ECE 255A,A00,091080,Orlitsky; Alon,0,0,0,0
1653635310773,ECE 257A,A00,091081,Zhang; Xinyu,0,0,0,0
1653635311303,ECE 260A,A01,091084,Eldon; John,0,0,0,0
1653635311829,ECE 264C,A00,091085,Galton; Ian A,0,0,0,0
1653635312352,ECE 265C,A00,094889,Presti; Calogero Davide,0,0,0,9
1653635312881,ECE 266,A01,091087,Hall; Drew A.,0,0,0,0
1653635313931,ECE 271A,A00,091090,Vasconcelos; Nuno,0,0,0,0
1653635314458,ECE 272B,A00,091091,Sworder; David D.,0,0,0,0
1653635314985,ECE 275A,A00,091092,Meyer; Florian,0,0,0,0
1653635315508,ECE 277,A00,091093,An; Cheolhong,0,0,0,0
1653635316041,ECE 283,A00,091094,Le; Hanh-Phuc,0,0,0,0
1653635316566,ECE 284,A00,091095,Kang; Mingu,0,0,0,0
1653635316566,ECE 284,B00,091096,Wang; Edward Jay,0,0,0,0
1653635317090,ECE 285,A00,094334,Touri; Behrouz,0,0,0,0
1653635317619,ECE 289,A00,091097,Whelan; David Arthur,0,0,0,0
1653635318144,MATH 200A,A00,087414,Salehi Golsefidy; Alireza,7,0,8,1
1653635318749,MATH 202A,A00,087415,Gill; Philip E.,2,0,8,6
1653635319272,MATH 203A,A00,087416,Oprea; Dragos N.,6,0,8,2
1653635319795,MATH 204A,A00,087417,Kedlaya; Kiran S.,6,0,8,2
1653635320320,MATH 205,A00,087418,Sorensen; Claus M,6,0,8,2
1653635320847,MATH 206A,A00,087419,Izadi; Elham,6,0,8,2
1653635321370,MATH 207A,A00,087420,Mohammadi; Amir,5,0,8,3
1653635321894,MATH 208,A00,087421,Staff,8,0,10,2
1653635322419,MATH 209,A00,087422,Staff,10,0,10,0
1653635322942,MATH 218,A00,087423,Staff,10,0,10,0
1653635323471,MATH 220A,A00,087424,Novak; Jonathan I,6,0,8,2
1653635324005,MATH 231A,A00,087425,Bejenaru; Ioan,3,0,8,5
1653635324531,MATH 240A,A00,087426,Ebenfelt; Peter F,5,0,8,3
1653635325055,MATH 243,A00,087427,Staff,9,0,10,1
1653635325584,MATH 248,A00,087429,Staff,10,0,10,0
1653635326112,MATH 250A,A00,087430,Spolaor; Luca,4,0,8,4
1653635326643,MATH 257A,A00,087431,Spolaor; Luca,7,0,8,1
1653635327165,MATH 258,A00,087432,Staff,9,0,10,1
1653635327690,MATH 264A,A00,087433,Warnke; Lutz Peter,5,0,8,3
1653635328212,MATH 268,A00,087434,Staff,15,0,15,0
1653635328735,MATH 269,A00,087435,Staff,14,0,15,1
1653635329259,MATH 270A,A00,087436,Nie; Jiawang,0,0,8,8
1653635329784,MATH 272A,A00,087437,Tian; Xiaochuan,0,0,8,8
1653635330309,MATH 274,A01,087439,Cheng; Li-Tien,9,0,10,1
1653635330309,MATH 274,A02,087440,Cheng; Li-Tien,10,0,10,0
1653635330835,MATH 278A,A00,087441,Staff,8,0,10,2
1653635331360,MATH 278B,A00,087442,Staff,8,0,10,2
1653635331883,MATH 278C,A00,087443,Staff,8,0,10,2
1653635332406,MATH 280A,A00,087444,Zheng; Tianyi,0,0,8,8
1653635332935,MATH 281A,A00,087445,Bradic; Jelena,0,0,8,9
1653635333459,MATH 282A,A00,087446,Zhang; Danna,0,0,8,8
1653635333985,MATH 283,A00,087447,Tesler; Glenn,0,0,0,16
1653635334513,MATH 286,B00,095535,Kemp; Todd Aahron,5,0,8,3
1653635335041,MATH 287D,B00,095536,Bradic; Jelena,5,0,8,3
1653635335565,MATH 288,A00,087450,Staff,14,0,15,1
1653635335565,MATH 288,B00,087451,Staff,15,0,15,0
1653635335565,MATH 288,C00,087452,Staff,15,0,15,0
1653635336088,MATH 290A,A00,087453,Xu; Zhouli,6,0,8,2
1653635336613,MATH 291A,A00,087454,Xu; Zhouli,7,0,8,1
1653635337139,MATH 292,A00,087455,Staff,10,0,10,0
1653635337669,MATH 295,A00,087456,Staff,50,0,50,0
1653635338192,MATH 297,001,087457,Staff,997,0,999,2
1653635900163,COGS 200,A01,087991,Staff,47,0,50,3
1653635900693,COGS 201,A01,094504,Rangel; Lara M,16,0,25,9
1653635901217,COGS 203,A00,087992,Coulson; Seana M,18,0,20,2
1653635901745,COGS 210A,001,087993,Greene; Deanna Jacquelyn,9998,0,9999,1
1653635901745,COGS 210A,002,087994,Saygin; Ayse P,9999,0,9999,0
1653635901745,COGS 210A,003,087995,Xia; Haijun,9999,0,9999,0
1653635901745,COGS 210A,004,087996,Nitz; Douglas A.,9999,0,9999,0
1653635901745,COGS 210A,005,087997,Hollan; James D.,9999,0,9999,0
1653635901745,COGS 210A,006,087998,Deak; Gedeon O.,9998,0,9999,1
1653635901745,COGS 210A,007,087999,Rossano; Federico,9999,0,9999,0
1653635902269,COGS 211A,A00,088000,Coulson; Seana M,9997,0,9999,2
1653635902793,COGS 229,A00,088002,Staff,22,0,25,3
1653635903317,COGS 260,B00,094231,Staff,17,0,20,3
1653635903317,COGS 260,A00,088004,Nitz; Douglas A.,9998,0,9999,1
1653635903849,CSE 202,A00,090110,Paturi; Ramamohan,0,0,0,0
1653635903849,CSE 202,B00,090111,Paturi; Ramamohan,0,0,0,0
1653635904377,CSE 207B,A00,090112,Heninger; Nadia A,0,0,0,0
1653635904909,CSE 208,A00,094858,Micciancio; Daniele,0,0,0,0
1653635905434,CSE 210,A00,090113,Powell; Thomas Allan,0,0,0,0
1653635905959,CSE 219,A00,090898,Staff,0,0,0,0
1653635906482,CSE 221,A00,090114,Zhou; Yuan-Yuan,0,0,0,0
1653635907007,CSE 229A,A00,090115,Porter; George M,0,0,0,0
1653635907533,CSE 229C,A00,090116,Savage; Stefan,0,0,0,0
1653635908130,CSE 230,A00,090117,Jhala; Ranjit,0,0,0,0
1653635908660,CSE 232,A00,090118,Papakonstantinou; Yannis,0,0,0,0
1653635909187,CSE 239A,A00,090121,Kumar; Arun Kumar,0,0,0,0
1653635909713,CSE 239B,A00,090122,Jhala; Ranjit,0,0,0,0
1653635910241,CSE 240A,A00,090123,Zhao; Jishen,0,0,189,189
1653635910765,CSE 243A,A00,090124,Orailoglu; Alex,0,0,15,15
1653635911290,CSE 249B,A00,090125,Kahng; Andrew Byun,12,0,20,8
1653635911823,CSE 250A,A00,090126,Berg-Kirkpatrick; Taylor D,0,0,0,0
1653635912352,CSE 252A,A00,090127,Ochoa; Benjamin Lawrence,0,0,0,0
1653635912876,CSE 258,A01,090129,McAuley; Julian John,0,0,0,0
1653635913406,CSE 258R,A01,090131,McAuley; Julian John,0,0,0,0
1653635913929,CSE 274,A00,090132,Ramamoorthi; Ravi,0,0,0,0
1653635914452,CSE 276A,A00,090133,Christensen; Henrik I,0,0,0,0
1653635914980,CSE 276C,A00,090134,Christensen; Henrik I,0,0,0,0
1653635915506,CSE 290,A00,090135,Bafna; Vineet,0,0,0,0
1653635915506,CSE 290,B00,090136,Ramamoorthi; Ravi,0,0,0,0
1653635915506,CSE 290,C00,090137,Li; Tzumao,7,0,10,3
1653635915506,CSE 290,D00,090138,Zhou; Yuan-Yuan,9,0,10,1
1653635915506,CSE 290,E00,090139,Christensen; Henrik I,8,0,10,2
1653635915506,CSE 290,F00,094053,Shalev; Aaron D,0,0,0,0
1653635916049,CSE 291,A00,090140,Munyaka; Imani N. S.,0,0,0,0
1653635916049,CSE 291,B00,094880,Yu; Qi,0,0,0,0
1653635916049,CSE 291,C00,090142,Pannuto; Patrick William,0,0,0,0
1653635916049,CSE 291,D00,094881,Zhang; Yiying,0,0,0,0
1653635916049,CSE 291,E00,095118,Su; Hao,0,0,0,0
1653635916603,CSE 293,001,094905,Bafna; Vineet,9999,0,9999,0
1653635916603,CSE 293,002,094906,Bellare; Mihir,9999,0,9999,0
1653635916603,CSE 293,003,094907,Berg-Kirkpatrick; Taylor D,9999,0,9999,0
1653635916603,CSE 293,004,094908,Christensen; Henrik I,9999,0,9999,0
1653635916603,CSE 293,005,094909,Cottrell; Garrison W,9999,0,9999,0
1653635916603,CSE 293,006,094910,Deutsch; Alin Bernard,9999,0,9999,0
1653635916603,CSE 293,007,094911,Esmaeilzadeh; Hadi,9999,0,9999,0
1653635916603,CSE 293,008,094912,Freund; Yoav,9999,0,9999,0
1653635916603,CSE 293,009,094913,Griswold; William G.,9999,0,9999,0
1653635916603,CSE 293,010,094914,Gymrek; Melissa Ann,9999,0,9999,0
1653635916603,CSE 293,011,094915,Heninger; Nadia A,9999,0,9999,0
1653635916603,CSE 293,012,094916,Impagliazzo; Russell,9999,0,9999,0
1653635916603,CSE 293,013,094917,Jhala; Ranjit,9999,0,9999,0
1653635916603,CSE 293,014,094918,Kahng; Andrew Byun,9999,0,9999,0
1653635916603,CSE 293,015,094919,Kane; Daniel Mertz,9999,0,9999,0
1653635916603,CSE 293,016,094920,Kriegman; David J,9999,0,9999,0
1653635916603,CSE 293,017,094921,Kumar; Arun Kumar,9999,0,9999,0
1653635916603,CSE 293,018,094922,Lerner; Sorin,9999,0,9999,0
1653635916603,CSE 293,019,094923,Lovett; Shachar,9999,0,9999,0
1653635916603,CSE 293,020,094924,McAuley; Julian John,9999,0,9999,0
1653635916603,CSE 293,021,094925,Micciancio; Daniele,9999,0,9999,0
1653635916603,CSE 293,022,094926,Orailoglu; Alex,9999,0,9999,0
1653635916603,CSE 293,023,094927,Paturi; Ramamohan,9999,0,9999,0
1653635916603,CSE 293,024,094928,Polikarpova; Nadezhda,9999,0,9999,0
1653635916603,CSE 293,025,094929,Politz; Joseph Gibbs,9999,0,9999,0
1653635916603,CSE 293,026,094930,Porter; George M,9999,0,9999,0
1653635916603,CSE 293,027,094931,Porter; Leonard Emerson,9999,0,9999,0
1653635916603,CSE 293,028,094932,Ramamoorthi; Ravi,9999,0,9999,0
1653635916603,CSE 293,029,094933,Sahoo; Debashis,9999,0,9999,0
1653635916603,CSE 293,030,094934,Saul; Lawrence,9999,0,9999,0
1653635916603,CSE 293,031,094935,Savage; Stefan,9999,0,9999,0
1653635916603,CSE 293,032,094936,Schulze; Jurgen P.,9999,0,9999,0
1653635916603,CSE 293,033,094937,Snoeren; Alex C.,9999,0,9999,0
1653635916603,CSE 293,034,094938,Shang; Jingbo,9999,0,9999,0
1653635916603,CSE 293,035,094939,Stefan; Deian,9999,0,9999,0
1653635916603,CSE 293,036,094940,Su; Hao,9999,0,9999,0
1653635916603,CSE 293,037,094941,Swanson; Steven James,9999,0,9999,0
1653635916603,CSE 293,038,094942,Tullsen; Dean Michael,9999,0,9999,0
1653635916603,CSE 293,039,094943,Voelker; Geoffrey M.,9999,0,9999,0
1653635916603,CSE 293,040,094944,Zhao; Jishen,9999,0,9999,0
1653635916603,CSE 293,041,094945,Zhou; Yuan-Yuan,9999,0,9999,0
1653635916603,CSE 293,042,094946,Gao; Sicun,9998,0,9999,1
1653635916603,CSE 293,043,094947,Weibel; Nadir,9999,0,9999,0
1653635916603,CSE 293,044,094948,Gupta; Rajesh K.,9999,0,9999,0
1653635917129,CSE 294,A00,090143,Porter; George M,9,0,10,1
1653635917653,DSE 200,A00,091799,Staff,50,0,50,0
1653635918177,DSE 203,A00,091800,Gupta; Amarnath,30,0,30,0
1653635918699,DSE 250,A00,091801,Deutsch; Alin Bernard,30,0,30,0
1653635919226,DSE 290,A00,091802,Altintas De Callaf; Ilkay,50,0,50,0
1653635919822,ECE 200,001,091003,Antipa; Nicholas A,9999,0,9999,0
1653635919822,ECE 200,002,091004,Atanasov; Nikolay A.,9999,0,9999,0
1653635919822,ECE 200,003,091005,Bharadia; Dinesh,9999,0,9999,0
1653635919822,ECE 200,004,091006,Cheng; Chung Kuan,9999,0,9999,0
1653635919822,ECE 200,005,091007,Cosman; Pamela C.,9999,0,9999,0
1653635919822,ECE 200,006,091008,Staff,9999,0,9999,0
1653635919822,ECE 200,007,091009,Dayeh; Shadi Ahmad,9999,0,9999,0
1653635919822,ECE 200,008,091010,Fainman; Yeshaiahu,9999,0,9999,0
1653635919822,ECE 200,009,091011,Ford; Joseph Earl,9999,0,9999,0
1653635919822,ECE 200,010,091012,Franceschetti; Massimo,9999,0,9999,0
1653635919822,ECE 200,011,091013,Fullerton; Eric E,9999,0,9999,0
1653635919822,ECE 200,012,091014,Galton; Ian A,9999,0,9999,0
1653635919822,ECE 200,013,091015,Gilja; Vikash,9999,0,9999,0
1653635919822,ECE 200,014,091016,Hall; Drew A.,9999,0,9999,0
1653635919822,ECE 200,015,091017,Hsueh; Tzu-Chien,9999,0,9999,0
1653635919822,ECE 200,016,091018,Javidi; Tara,9999,0,9999,0
1653635919822,ECE 200,017,091019,Kahng; Andrew Byun,9999,0,9999,0
1653635919822,ECE 200,018,091020,Kim; Young-Han,9999,0,9999,0
1653635919822,ECE 200,019,091021,Koushanfar; Farinaz,9999,0,9999,0
1653635919822,ECE 200,020,091022,Kuzum; Duygu,9999,0,9999,0
1653635919822,ECE 200,021,091023,Le; Hanh-Phuc,9999,0,9999,0
1653635919822,ECE 200,022,091024,Lin; Bill,9999,0,9999,0
1653635919822,ECE 200,023,091025,Liu; Zhaowei,9999,0,9999,0
1653635919822,ECE 200,024,091026,Lo; Yu-Hwa,9999,0,9999,0
1653635919822,ECE 200,025,091027,Lomakin; Vitaliy,9999,0,9999,0
1653635919822,ECE 200,026,091028,Mercier; Patrick Philip,9999,0,9999,0
1653635919822,ECE 200,027,091029,Meyer; Florian,9999,0,9999,0
1653635919822,ECE 200,028,091030,Milstein; Laurence B.,9999,0,9999,0
1653635919822,ECE 200,029,091031,Mir Arabbaygi; Siavash,9999,0,9999,0
1653635919822,ECE 200,030,091032,Mookherjea; Shayan,9999,0,9999,0
1653635919822,ECE 200,031,091033,Morris; Karcher William,9999,0,9999,0
1653635919822,ECE 200,032,091034,Ng; Tse Nga,9999,0,9999,0
1653635919822,ECE 200,033,091035,Nguyen; Truong Quang,9999,0,9999,0
1653635919822,ECE 200,034,091036,Nomura; Kenji,9999,0,9999,0
1653635919822,ECE 200,035,091037,Orlitsky; Alon,9999,0,9999,0
1653635919822,ECE 200,036,091038,Pal; Piya,9999,0,9999,0
1653635919822,ECE 200,037,091039,Papen; George C.,9999,0,9999,0
1653635919822,ECE 200,038,091040,Radic; Stojan,9999,0,9999,0
1653635919822,ECE 200,039,091041,Rao; Bhaskar D.,9999,0,9999,0
1653635919822,ECE 200,040,091042,Rao; Ramesh R,9999,0,9999,0
1653635919822,ECE 200,041,091043,Rebeiz; Gabriel,9999,0,9999,0
1653635919822,ECE 200,042,091044,Sanford; John R,9999,0,9999,0
1653635919822,ECE 200,043,091045,Siegel; Paul H.,9999,0,9999,0
1653635919822,ECE 200,044,091046,Sievenpiper; Daniel F.,9999,0,9999,0
1653635919822,ECE 200,045,091047,Sworder; David D.,9999,0,9999,0
1653635919822,ECE 200,046,091048,Taur; Yuan,9999,0,9999,0
1653635919822,ECE 200,047,091049,Touri; Behrouz,9999,0,9999,0
1653635919822,ECE 200,048,091050,Trivedi; Mohan M.,9999,0,9999,0
1653635919822,ECE 200,049,091051,Vardy; Alexander,9999,0,9999,0
1653635919822,ECE 200,050,091052,Vasconcelos; Nuno,9999,0,9999,0
1653635919822,ECE 200,051,091053,Wang; Xiaolong,9999,0,9999,0
1653635919822,ECE 200,052,091054,Xie; Pengtao,9999,0,9999,0
1653635919822,ECE 200,053,091055,Yip; Michael,9999,0,9999,0
1653635919822,ECE 200,054,091056,Zeger; Kenneth A.,9999,0,9999,0
1653635919822,ECE 200,055,091057,Zhang; Xinyu,9999,0,9999,0
1653635919822,ECE 200,056,091058,Turakhia; Yatish Girish,9999,0,9999,0
1653635919822,ECE 200,057,091059,Kang; Mingu,9999,0,9999,0
1653635919822,ECE 200,058,091060,Shi; Yuanyuan,9999,0,9999,0
1653635919822,ECE 200,059,091061,Wang; Edward Jay,9999,0,9999,0
1653635919822,ECE 200,060,091062,Zheng; Yang,9999,0,9999,0
1653635920348,ECE 201,A00,095526,Lo; Yu-Hwa,0,0,0,0
1653635920870,ECE 203,A00,091065,Mercier; Patrick Philip,0,0,0,0
1653635921396,ECE 207A,A00,091605,Liu; Thomas Tao-Ming,0,0,0,0
1653635921921,ECE 212AN,A00,091068,Nomura; Kenji,0,0,0,0
1653635922446,ECE 222A,A00,091069,Rebeiz; Gabriel,0,0,0,0
1653635922982,ECE 225A,A00,091070,Orlitsky; Alon,0,0,0,0
1653635923510,ECE 230A,A00,091071,Nomura; Kenji,0,0,0,0
1653635924041,ECE 236A,A00,091072,Dayeh; Shadi Ahmad,0,0,0,0
1653635924564,ECE 238A,A00,091073,Luo; Jian,0,0,0,0
1653635924564,ECE 238A,B00,091074,Luo; Jian,0,0,0,0
1653635925088,ECE 240A,A00,091075,Radic; Stojan,0,0,0,0
1653635925617,ECE 247A,A00,091592,Shi; Lingyan,0,0,0,0
1653635926142,ECE 250,A00,091076,Touri; Behrouz,0,0,0,0
1653635926670,ECE 251C,A00,091078,Nguyen; Truong Quang,0,0,0,0
1653635927193,ECE 253,A00,091079,Cosman; Pamela C.,0,0,0,0
1653635927717,ECE 255A,A00,091080,Orlitsky; Alon,0,0,0,0
1653635928239,ECE 257A,A00,091081,Zhang; Xinyu,0,0,0,0
1653635928762,ECE 260A,A01,091084,Eldon; John,0,0,0,0
1653635929290,ECE 264C,A00,091085,Galton; Ian A,0,0,0,0
1653635929822,ECE 265C,A00,094889,Presti; Calogero Davide,0,0,0,9
1653635930347,ECE 266,A01,091087,Hall; Drew A.,0,0,0,0
1653635931399,ECE 271A,A00,091090,Vasconcelos; Nuno,0,0,0,0
1653635931928,ECE 272B,A00,091091,Sworder; David D.,0,0,0,0
1653635932452,ECE 275A,A00,091092,Meyer; Florian,0,0,0,0
1653635932976,ECE 277,A00,091093,An; Cheolhong,0,0,0,0
1653635933514,ECE 283,A00,091094,Le; Hanh-Phuc,0,0,0,0
1653635934041,ECE 284,A00,091095,Kang; Mingu,0,0,0,0
1653635934041,ECE 284,B00,091096,Wang; Edward Jay,0,0,0,0
1653635934566,ECE 285,A00,094334,Touri; Behrouz,0,0,0,0
1653635935091,ECE 289,A00,091097,Whelan; David Arthur,0,0,0,0
1653635935619,MATH 200A,A00,087414,Salehi Golsefidy; Alireza,7,0,8,1
1653635936152,MATH 202A,A00,087415,Gill; Philip E.,2,0,8,6
1653635936677,MATH 203A,A00,087416,Oprea; Dragos N.,6,0,8,2
1653635937201,MATH 204A,A00,087417,Kedlaya; Kiran S.,6,0,8,2
1653635937725,MATH 205,A00,087418,Sorensen; Claus M,6,0,8,2
1653635938261,MATH 206A,A00,087419,Izadi; Elham,6,0,8,2
1653635938784,MATH 207A,A00,087420,Mohammadi; Amir,5,0,8,3
1653635939315,MATH 208,A00,087421,Staff,8,0,10,2
1653635939837,MATH 209,A00,087422,Staff,10,0,10,0
1653635940361,MATH 218,A00,087423,Staff,10,0,10,0
1653635940898,MATH 220A,A00,087424,Novak; Jonathan I,6,0,8,2
1653635941427,MATH 231A,A00,087425,Bejenaru; Ioan,3,0,8,5
1653635941955,MATH 240A,A00,087426,Ebenfelt; Peter F,5,0,8,3
1653635942477,MATH 243,A00,087427,Staff,9,0,10,1
1653635943000,MATH 248,A00,087429,Staff,10,0,10,0
1653635943529,MATH 250A,A00,087430,Spolaor; Luca,4,0,8,4
1653635944056,MATH 257A,A00,087431,Spolaor; Luca,7,0,8,1
1653635944588,MATH 258,A00,087432,Staff,9,0,10,1
1653635945112,MATH 264A,A00,087433,Warnke; Lutz Peter,5,0,8,3
1653635945639,MATH 268,A00,087434,Staff,15,0,15,0
1653635946174,MATH 269,A00,087435,Staff,14,0,15,1
1653635946702,MATH 270A,A00,087436,Nie; Jiawang,0,0,8,8
1653635947226,MATH 272A,A00,087437,Tian; Xiaochuan,0,0,8,8
1653635947751,MATH 274,A01,087439,Cheng; Li-Tien,9,0,10,1
1653635947751,MATH 274,A02,087440,Cheng; Li-Tien,10,0,10,0
1653635948274,MATH 278A,A00,087441,Staff,8,0,10,2
1653635948798,MATH 278B,A00,087442,Staff,8,0,10,2
1653635949322,MATH 278C,A00,087443,Staff,8,0,10,2
1653635949861,MATH 280A,A00,087444,Zheng; Tianyi,0,0,8,8
1653635950384,MATH 281A,A00,087445,Bradic; Jelena,0,0,8,9
1653635950908,MATH 282A,A00,087446,Zhang; Danna,0,0,8,8
1653635951432,MATH 283,A00,087447,Tesler; Glenn,0,0,0,16
1653635951957,MATH 286,B00,095535,Kemp; Todd Aahron,5,0,8,3
1653635952490,MATH 287D,B00,095536,Bradic; Jelena,5,0,8,3
1653635953018,MATH 288,A00,087450,Staff,14,0,15,1
1653635953018,MATH 288,B00,087451,Staff,15,0,15,0
1653635953018,MATH 288,C00,087452,Staff,15,0,15,0
1653635953542,MATH 290A,A00,087453,Xu; Zhouli,6,0,8,2
1653635954073,MATH 291A,A00,087454,Xu; Zhouli,7,0,8,1
1653635954605,MATH 292,A00,087455,Staff,10,0,10,0
1653635955131,MATH 295,A00,087456,Staff,50,0,50,0
1653635955654,MATH 297,001,087457,Staff,997,0,999,2
1653636516411,COGS 200,A01,087991,Staff,47,0,50,3
1653636516942,COGS 201,A01,094504,Rangel; Lara M,16,0,25,9
1653636517466,COGS 203,A00,087992,Coulson; Seana M,18,0,20,2
1653636517990,COGS 210A,001,087993,Greene; Deanna Jacquelyn,9998,0,9999,1
1653636517990,COGS 210A,002,087994,Saygin; Ayse P,9999,0,9999,0
1653636517990,COGS 210A,003,087995,Xia; Haijun,9999,0,9999,0
1653636517990,COGS 210A,004,087996,Nitz; Douglas A.,9999,0,9999,0
1653636517990,COGS 210A,005,087997,Hollan; James D.,9999,0,9999,0
1653636517990,COGS 210A,006,087998,Deak; Gedeon O.,9998,0,9999,1
1653636517990,COGS 210A,007,087999,Rossano; Federico,9999,0,9999,0
1653636518512,COGS 211A,A00,088000,Coulson; Seana M,9997,0,9999,2
1653636519044,COGS 229,A00,088002,Staff,22,0,25,3
1653636519584,COGS 260,B00,094231,Staff,17,0,20,3
1653636519584,COGS 260,A00,088004,Nitz; Douglas A.,9998,0,9999,1
1653636520110,CSE 202,A00,090110,Paturi; Ramamohan,0,0,0,0
1653636520110,CSE 202,B00,090111,Paturi; Ramamohan,0,0,0,0
1653636520634,CSE 207B,A00,090112,Heninger; Nadia A,0,0,0,0
1653636521155,CSE 208,A00,094858,Micciancio; Daniele,0,0,0,0
1653636521679,CSE 210,A00,090113,Powell; Thomas Allan,0,0,0,0
1653636522205,CSE 219,A00,090898,Staff,0,0,0,0
1653636522731,CSE 221,A00,090114,Zhou; Yuan-Yuan,0,0,0,0
1653636523254,CSE 229A,A00,090115,Porter; George M,0,0,0,0
1653636523779,CSE 229C,A00,090116,Savage; Stefan,0,0,0,0
1653636524312,CSE 230,A00,090117,Jhala; Ranjit,0,0,0,0
1653636524848,CSE 232,A00,090118,Papakonstantinou; Yannis,0,0,0,0
1653636525375,CSE 239A,A00,090121,Kumar; Arun Kumar,0,0,0,0
1653636525897,CSE 239B,A00,090122,Jhala; Ranjit,0,0,0,0
1653636526426,CSE 240A,A00,090123,Zhao; Jishen,0,0,189,189
1653636526949,CSE 243A,A00,090124,Orailoglu; Alex,0,0,15,15
1653636527475,CSE 249B,A00,090125,Kahng; Andrew Byun,12,0,20,8
1653636528015,CSE 250A,A00,090126,Berg-Kirkpatrick; Taylor D,0,0,0,0
1653636528543,CSE 252A,A00,090127,Ochoa; Benjamin Lawrence,0,0,0,0
1653636529070,CSE 258,A01,090129,McAuley; Julian John,0,0,0,0
1653636529596,CSE 258R,A01,090131,McAuley; Julian John,0,0,0,0
1653636530120,CSE 274,A00,090132,Ramamoorthi; Ravi,0,0,0,0
1653636530644,CSE 276A,A00,090133,Christensen; Henrik I,0,0,0,0
1653636531169,CSE 276C,A00,090134,Christensen; Henrik I,0,0,0,0
1653636531694,CSE 290,A00,090135,Bafna; Vineet,0,0,0,0
1653636531694,CSE 290,B00,090136,Ramamoorthi; Ravi,0,0,0,0
1653636531694,CSE 290,C00,090137,Li; Tzumao,7,0,10,3
1653636531694,CSE 290,D00,090138,Zhou; Yuan-Yuan,9,0,10,1
1653636531694,CSE 290,E00,090139,Christensen; Henrik I,8,0,10,2
1653636531694,CSE 290,F00,094053,Shalev; Aaron D,0,0,0,0
1653636532220,CSE 291,A00,090140,Munyaka; Imani N. S.,0,0,0,0
1653636532220,CSE 291,B00,094880,Yu; Qi,0,0,0,0
1653636532220,CSE 291,C00,090142,Pannuto; Patrick William,0,0,0,0
1653636532220,CSE 291,D00,094881,Zhang; Yiying,0,0,0,0
1653636532220,CSE 291,E00,095118,Su; Hao,0,0,0,0
1653636532752,CSE 293,001,094905,Bafna; Vineet,9999,0,9999,0
1653636532752,CSE 293,002,094906,Bellare; Mihir,9999,0,9999,0
1653636532752,CSE 293,003,094907,Berg-Kirkpatrick; Taylor D,9999,0,9999,0
1653636532752,CSE 293,004,094908,Christensen; Henrik I,9999,0,9999,0
1653636532752,CSE 293,005,094909,Cottrell; Garrison W,9999,0,9999,0
1653636532752,CSE 293,006,094910,Deutsch; Alin Bernard,9999,0,9999,0
1653636532752,CSE 293,007,094911,Esmaeilzadeh; Hadi,9999,0,9999,0
1653636532752,CSE 293,008,094912,Freund; Yoav,9999,0,9999,0
1653636532752,CSE 293,009,094913,Griswold; William G.,9999,0,9999,0
1653636532752,CSE 293,010,094914,Gymrek; Melissa Ann,9999,0,9999,0
1653636532752,CSE 293,011,094915,Heninger; Nadia A,9999,0,9999,0
1653636532752,CSE 293,012,094916,Impagliazzo; Russell,9999,0,9999,0
1653636532752,CSE 293,013,094917,Jhala; Ranjit,9999,0,9999,0
1653636532752,CSE 293,014,094918,Kahng; Andrew Byun,9999,0,9999,0
1653636532752,CSE 293,015,094919,Kane; Daniel Mertz,9999,0,9999,0
1653636532752,CSE 293,016,094920,Kriegman; David J,9999,0,9999,0
1653636532752,CSE 293,017,094921,Kumar; Arun Kumar,9999,0,9999,0
1653636532752,CSE 293,018,094922,Lerner; Sorin,9999,0,9999,0
1653636532752,CSE 293,019,094923,Lovett; Shachar,9999,0,9999,0
1653636532752,CSE 293,020,094924,McAuley; Julian John,9999,0,9999,0
1653636532752,CSE 293,021,094925,Micciancio; Daniele,9999,0,9999,0
1653636532752,CSE 293,022,094926,Orailoglu; Alex,9999,0,9999,0
1653636532752,CSE 293,023,094927,Paturi; Ramamohan,9999,0,9999,0
1653636532752,CSE 293,024,094928,Polikarpova; Nadezhda,9999,0,9999,0
1653636532752,CSE 293,025,094929,Politz; Joseph Gibbs,9999,0,9999,0
1653636532752,CSE 293,026,094930,Porter; George M,9999,0,9999,0
1653636532752,CSE 293,027,094931,Porter; Leonard Emerson,9999,0,9999,0
1653636532752,CSE 293,028,094932,Ramamoorthi; Ravi,9999,0,9999,0
1653636532752,CSE 293,029,094933,Sahoo; Debashis,9999,0,9999,0
1653636532752,CSE 293,030,094934,Saul; Lawrence,9999,0,9999,0
1653636532752,CSE 293,031,094935,Savage; Stefan,9999,0,9999,0
1653636532752,CSE 293,032,094936,Schulze; Jurgen P.,9999,0,9999,0
1653636532752,CSE 293,033,094937,Snoeren; Alex C.,9999,0,9999,0
1653636532752,CSE 293,034,094938,Shang; Jingbo,9999,0,9999,0
1653636532752,CSE 293,035,094939,Stefan; Deian,9999,0,9999,0
1653636532752,CSE 293,036,094940,Su; Hao,9999,0,9999,0
1653636532752,CSE 293,037,094941,Swanson; Steven James,9999,0,9999,0
1653636532752,CSE 293,038,094942,Tullsen; Dean Michael,9999,0,9999,0
1653636532752,CSE 293,039,094943,Voelker; Geoffrey M.,9999,0,9999,0
1653636532752,CSE 293,040,094944,Zhao; Jishen,9999,0,9999,0
1653636532752,CSE 293,041,094945,Zhou; Yuan-Yuan,9999,0,9999,0
1653636532752,CSE 293,042,094946,Gao; Sicun,9998,0,9999,1
1653636532752,CSE 293,043,094947,Weibel; Nadir,9999,0,9999,0
1653636532752,CSE 293,044,094948,Gupta; Rajesh K.,9999,0,9999,0
1653636533275,CSE 294,A00,090143,Porter; George M,9,0,10,1
1653636533799,DSE 200,A00,091799,Staff,50,0,50,0
1653636534331,DSE 203,A00,091800,Gupta; Amarnath,30,0,30,0
1653636534861,DSE 250,A00,091801,Deutsch; Alin Bernard,30,0,30,0
1653636535388,DSE 290,A00,091802,Altintas De Callaf; Ilkay,50,0,50,0
1653636535965,ECE 200,001,091003,Antipa; Nicholas A,9999,0,9999,0
1653636535965,ECE 200,002,091004,Atanasov; Nikolay A.,9999,0,9999,0
1653636535965,ECE 200,003,091005,Bharadia; Dinesh,9999,0,9999,0
1653636535965,ECE 200,004,091006,Cheng; Chung Kuan,9999,0,9999,0
1653636535965,ECE 200,005,091007,Cosman; Pamela C.,9999,0,9999,0
1653636535965,ECE 200,006,091008,Staff,9999,0,9999,0
1653636535965,ECE 200,007,091009,Dayeh; Shadi Ahmad,9999,0,9999,0
1653636535965,ECE 200,008,091010,Fainman; Yeshaiahu,9999,0,9999,0
1653636535965,ECE 200,009,091011,Ford; Joseph Earl,9999,0,9999,0
1653636535965,ECE 200,010,091012,Franceschetti; Massimo,9999,0,9999,0
1653636535965,ECE 200,011,091013,Fullerton; Eric E,9999,0,9999,0
1653636535965,ECE 200,012,091014,Galton; Ian A,9999,0,9999,0
1653636535965,ECE 200,013,091015,Gilja; Vikash,9999,0,9999,0
1653636535965,ECE 200,014,091016,Hall; Drew A.,9999,0,9999,0
1653636535965,ECE 200,015,091017,Hsueh; Tzu-Chien,9999,0,9999,0
1653636535965,ECE 200,016,091018,Javidi; Tara,9999,0,9999,0
1653636535965,ECE 200,017,091019,Kahng; Andrew Byun,9999,0,9999,0
1653636535965,ECE 200,018,091020,Kim; Young-Han,9999,0,9999,0
1653636535965,ECE 200,019,091021,Koushanfar; Farinaz,9999,0,9999,0
1653636535965,ECE 200,020,091022,Kuzum; Duygu,9999,0,9999,0
1653636535965,ECE 200,021,091023,Le; Hanh-Phuc,9999,0,9999,0
1653636535965,ECE 200,022,091024,Lin; Bill,9999,0,9999,0
1653636535965,ECE 200,023,091025,Liu; Zhaowei,9999,0,9999,0
1653636535965,ECE 200,024,091026,Lo; Yu-Hwa,9999,0,9999,0
1653636535965,ECE 200,025,091027,Lomakin; Vitaliy,9999,0,9999,0
1653636535965,ECE 200,026,091028,Mercier; Patrick Philip,9999,0,9999,0
1653636535965,ECE 200,027,091029,Meyer; Florian,9999,0,9999,0
1653636535965,ECE 200,028,091030,Milstein; Laurence B.,9999,0,9999,0
1653636535965,ECE 200,029,091031,Mir Arabbaygi; Siavash,9999,0,9999,0
1653636535965,ECE 200,030,091032,Mookherjea; Shayan,9999,0,9999,0
1653636535965,ECE 200,031,091033,Morris; Karcher William,9999,0,9999,0
1653636535965,ECE 200,032,091034,Ng; Tse Nga,9999,0,9999,0
1653636535965,ECE 200,033,091035,Nguyen; Truong Quang,9999,0,9999,0
1653636535965,ECE 200,034,091036,Nomura; Kenji,9999,0,9999,0
1653636535965,ECE 200,035,091037,Orlitsky; Alon,9999,0,9999,0
1653636535965,ECE 200,036,091038,Pal; Piya,9999,0,9999,0
1653636535965,ECE 200,037,091039,Papen; George C.,9999,0,9999,0
1653636535965,ECE 200,038,091040,Radic; Stojan,9999,0,9999,0
1653636535965,ECE 200,039,091041,Rao; Bhaskar D.,9999,0,9999,0
1653636535965,ECE 200,040,091042,Rao; Ramesh R,9999,0,9999,0
1653636535965,ECE 200,041,091043,Rebeiz; Gabriel,9999,0,9999,0
1653636535965,ECE 200,042,091044,Sanford; John R,9999,0,9999,0
1653636535965,ECE 200,043,091045,Siegel; Paul H.,9999,0,9999,0
1653636535965,ECE 200,044,091046,Sievenpiper; Daniel F.,9999,0,9999,0
1653636535965,ECE 200,045,091047,Sworder; David D.,9999,0,9999,0
1653636535965,ECE 200,046,091048,Taur; Yuan,9999,0,9999,0
1653636535965,ECE 200,047,091049,Touri; Behrouz,9999,0,9999,0
1653636535965,ECE 200,048,091050,Trivedi; Mohan M.,9999,0,9999,0
1653636535965,ECE 200,049,091051,Vardy; Alexander,9999,0,9999,0
1653636535965,ECE 200,050,091052,Vasconcelos; Nuno,9999,0,9999,0
1653636535965,ECE 200,051,091053,Wang; Xiaolong,9999,0,9999,0
1653636535965,ECE 200,052,091054,Xie; Pengtao,9999,0,9999,0
1653636535965,ECE 200,053,091055,Yip; Michael,9999,0,9999,0
1653636535965,ECE 200,054,091056,Zeger; Kenneth A.,9999,0,9999,0
1653636535965,ECE 200,055,091057,Zhang; Xinyu,9999,0,9999,0
1653636535965,ECE 200,056,091058,Turakhia; Yatish Girish,9999,0,9999,0
1653636535965,ECE 200,057,091059,Kang; Mingu,9999,0,9999,0
1653636535965,ECE 200,058,091060,Shi; Yuanyuan,9999,0,9999,0
1653636535965,ECE 200,059,091061,Wang; Edward Jay,9999,0,9999,0
1653636535965,ECE 200,060,091062,Zheng; Yang,9999,0,9999,0
1653636536496,ECE 201,A00,095526,Lo; Yu-Hwa,0,0,0,0
1653636537022,ECE 203,A00,091065,Mercier; Patrick Philip,0,0,0,0
1653636537549,ECE 207A,A00,091605,Liu; Thomas Tao-Ming,0,0,0,0
1653636538075,ECE 212AN,A00,091068,Nomura; Kenji,0,0,0,0
1653636538599,ECE 222A,A00,091069,Rebeiz; Gabriel,0,0,0,0
1653636539126,ECE 225A,A00,091070,Orlitsky; Alon,0,0,0,0
1653636539651,ECE 230A,A00,091071,Nomura; Kenji,0,0,0,0
1653636540176,ECE 236A,A00,091072,Dayeh; Shadi Ahmad,0,0,0,0
1653636540704,ECE 238A,A00,091073,Luo; Jian,0,0,0,0
1653636540704,ECE 238A,B00,091074,Luo; Jian,0,0,0,0
1653636541240,ECE 240A,A00,091075,Radic; Stojan,0,0,0,0
1653636541764,ECE 247A,A00,091592,Shi; Lingyan,0,0,0,0
1653636542300,ECE 250,A00,091076,Touri; Behrouz,0,0,0,0
1653636542827,ECE 251C,A00,091078,Nguyen; Truong Quang,0,0,0,0
1653636543361,ECE 253,A00,091079,Cosman; Pamela C.,0,0,0,0
1653636543887,ECE 255A,A00,091080,Orlitsky; Alon,0,0,0,0
1653636544411,ECE 257A,A00,091081,Zhang; Xinyu,0,0,0,0
1653636544934,ECE 260A,A01,091084,Eldon; John,0,0,0,0
1653636545471,ECE 264C,A00,091085,Galton; Ian A,0,0,0,0
1653636545994,ECE 265C,A00,094889,Presti; Calogero Davide,0,0,0,9
1653636546522,ECE 266,A01,091087,Hall; Drew A.,0,0,0,0
1653636547581,ECE 271A,A00,091090,Vasconcelos; Nuno,0,0,0,0
1653636548114,ECE 272B,A00,091091,Sworder; David D.,0,0,0,0
1653636548648,ECE 275A,A00,091092,Meyer; Florian,0,0,0,0
1653636549234,ECE 277,A00,091093,An; Cheolhong,0,0,0,0
1653636549833,ECE 283,A00,091094,Le; Hanh-Phuc,0,0,0,0
1653636550361,ECE 284,A00,091095,Kang; Mingu,0,0,0,0
1653636550361,ECE 284,B00,091096,Wang; Edward Jay,0,0,0,0
1653636550882,ECE 285,A00,094334,Touri; Behrouz,0,0,0,0
1653636551416,ECE 289,A00,091097,Whelan; David Arthur,0,0,0,0
1653636551940,MATH 200A,A00,087414,Salehi Golsefidy; Alireza,7,0,8,1
1653636552465,MATH 202A,A00,087415,Gill; Philip E.,2,0,8,6
1653636552989,MATH 203A,A00,087416,Oprea; Dragos N.,6,0,8,2
1653636553513,MATH 204A,A00,087417,Kedlaya; Kiran S.,6,0,8,2
1653636554038,MATH 205,A00,087418,Sorensen; Claus M,6,0,8,2
1653636554561,MATH 206A,A00,087419,Izadi; Elham,6,0,8,2
1653636555088,MATH 207A,A00,087420,Mohammadi; Amir,5,0,8,3
1653636555613,MATH 208,A00,087421,Staff,8,0,10,2
1653636556136,MATH 209,A00,087422,Staff,10,0,10,0
1653636556657,MATH 218,A00,087423,Staff,10,0,10,0
1653636557186,MATH 220A,A00,087424,Novak; Jonathan I,6,0,8,2
1653636557715,MATH 231A,A00,087425,Bejenaru; Ioan,3,0,8,5
1653636558237,MATH 240A,A00,087426,Ebenfelt; Peter F,5,0,8,3
1653636558767,MATH 243,A00,087427,Staff,9,0,10,1
1653636559301,MATH 248,A00,087429,Staff,10,0,10,0
1653636559825,MATH 250A,A00,087430,Spolaor; Luca,4,0,8,4
1653636560354,MATH 257A,A00,087431,Spolaor; Luca,7,0,8,1
1653636560881,MATH 258,A00,087432,Staff,9,0,10,1
1653636561406,MATH 264A,A00,087433,Warnke; Lutz Peter,5,0,8,3
1653636561930,MATH 268,A00,087434,Staff,15,0,15,0
1653636562453,MATH 269,A00,087435,Staff,14,0,15,1
1653636562975,MATH 270A,A00,087436,Nie; Jiawang,0,0,8,8
1653636563500,MATH 272A,A00,087437,Tian; Xiaochuan,0,0,8,8
1653636564026,MATH 274,A01,087439,Cheng; Li-Tien,9,0,10,1
1653636564026,MATH 274,A02,087440,Cheng; Li-Tien,10,0,10,0
1653636564576,MATH 278A,A00,087441,Staff,8,0,10,2
1653636565098,MATH 278B,A00,087442,Staff,8,0,10,2
1653636565621,MATH 278C,A00,087443,Staff,8,0,10,2
1653636566160,MATH 280A,A00,087444,Zheng; Tianyi,0,0,8,8
1653636566681,MATH 281A,A00,087445,Bradic; Jelena,0,0,8,9
1653636567207,MATH 282A,A00,087446,Zhang; Danna,0,0,8,8
1653636567743,MATH 283,A00,087447,Tesler; Glenn,0,0,0,16
1653636568266,MATH 286,B00,095535,Kemp; Todd Aahron,5,0,8,3
1653636568797,MATH 287D,B00,095536,Bradic; Jelena,5,0,8,3
1653636569323,MATH 288,A00,087450,Staff,14,0,15,1
1653636569323,MATH 288,B00,087451,Staff,15,0,15,0
1653636569323,MATH 288,C00,087452,Staff,15,0,15,0
1653636569849,MATH 290A,A00,087453,Xu; Zhouli,6,0,8,2
1653636570395,MATH 291A,A00,087454,Xu; Zhouli,7,0,8,1
1653636570922,MATH 292,A00,087455,Staff,10,0,10,0
1653636571449,MATH 295,A00,087456,Staff,50,0,50,0
1653636571973,MATH 297,001,087457,Staff,997,0,999,2
1653637133136,COGS 200,A01,087991,Staff,47,0,50,3
1653637133660,COGS 201,A01,094504,Rangel; Lara M,16,0,25,9
1653637134185,COGS 203,A00,087992,Coulson; Seana M,18,0,20,2
1653637134713,COGS 210A,001,087993,Greene; Deanna Jacquelyn,9998,0,9999,1
1653637134713,COGS 210A,002,087994,Saygin; Ayse P,9999,0,9999,0
1653637134713,COGS 210A,003,087995,Xia; Haijun,9999,0,9999,0
1653637134713,COGS 210A,004,087996,Nitz; Douglas A.,9999,0,9999,0
1653637134713,COGS 210A,005,087997,Hollan; James D.,9999,0,9999,0
1653637134713,COGS 210A,006,087998,Deak; Gedeon O.,9998,0,9999,1
1653637134713,COGS 210A,007,087999,Rossano; Federico,9999,0,9999,0
1653637135237,COGS 211A,A00,088000,Coulson; Seana M,9997,0,9999,2
1653637135761,COGS 229,A00,088002,Staff,22,0,25,3
1653637136296,COGS 260,B00,094231,Staff,17,0,20,3
1653637136296,COGS 260,A00,088004,Nitz; Douglas A.,9998,0,9999,1
1653637136827,CSE 202,A00,090110,Paturi; Ramamohan,0,0,0,0
1653637136827,CSE 202,B00,090111,Paturi; Ramamohan,0,0,0,0
1653637137357,CSE 207B,A00,090112,Heninger; Nadia A,0,0,0,0
1653637137886,CSE 208,A00,094858,Micciancio; Daniele,0,0,0,0
1653637138508,CSE 210,A00,090113,Powell; Thomas Allan,0,0,0,0
1653637139033,CSE 219,A00,090898,Staff,0,0,0,0
1653637139563,CSE 221,A00,090114,Zhou; Yuan-Yuan,0,0,0,0
1653637140092,CSE 229A,A00,090115,Porter; George M,0,0,0,0
1653637140615,CSE 229C,A00,090116,Savage; Stefan,0,0,0,0
1653637141140,CSE 230,A00,090117,Jhala; Ranjit,0,0,0,0
1653637141665,CSE 232,A00,090118,Papakonstantinou; Yannis,0,0,0,0
1653637142190,CSE 239A,A00,090121,Kumar; Arun Kumar,0,0,0,0
1653637142729,CSE 239B,A00,090122,Jhala; Ranjit,0,0,0,0
1653637143255,CSE 240A,A00,090123,Zhao; Jishen,0,0,189,189
1653637143779,CSE 243A,A00,090124,Orailoglu; Alex,0,0,15,15
1653637144305,CSE 249B,A00,090125,Kahng; Andrew Byun,12,0,20,8
1653637144830,CSE 250A,A00,090126,Berg-Kirkpatrick; Taylor D,0,0,0,0
1653637145358,CSE 252A,A00,090127,Ochoa; Benjamin Lawrence,0,0,0,0
1653637145887,CSE 258,A01,090129,McAuley; Julian John,0,0,0,0
1653637146414,CSE 258R,A01,090131,McAuley; Julian John,0,0,0,0
1653637146939,CSE 274,A00,090132,Ramamoorthi; Ravi,0,0,0,0
1653637147466,CSE 276A,A00,090133,Christensen; Henrik I,0,0,0,0
1653637147990,CSE 276C,A00,090134,Christensen; Henrik I,0,0,0,0
1653637148516,CSE 290,A00,090135,Bafna; Vineet,0,0,0,0
1653637148516,CSE 290,B00,090136,Ramamoorthi; Ravi,0,0,0,0
1653637148516,CSE 290,C00,090137,Li; Tzumao,7,0,10,3
1653637148516,CSE 290,D00,090138,Zhou; Yuan-Yuan,9,0,10,1
1653637148516,CSE 290,E00,090139,Christensen; Henrik I,8,0,10,2
1653637148516,CSE 290,F00,094053,Shalev; Aaron D,0,0,0,0
1653637149045,CSE 291,A00,090140,Munyaka; Imani N. S.,0,0,0,0
1653637149045,CSE 291,B00,094880,Yu; Qi,0,0,0,0
1653637149045,CSE 291,C00,090142,Pannuto; Patrick William,0,0,0,0
1653637149045,CSE 291,D00,094881,Zhang; Yiying,0,0,0,0
1653637149045,CSE 291,E00,095118,Su; Hao,0,0,0,0
1653637149586,CSE 293,001,094905,Bafna; Vineet,9999,0,9999,0
1653637149586,CSE 293,002,094906,Bellare; Mihir,9999,0,9999,0
1653637149586,CSE 293,003,094907,Berg-Kirkpatrick; Taylor D,9999,0,9999,0
1653637149586,CSE 293,004,094908,Christensen; Henrik I,9999,0,9999,0
1653637149586,CSE 293,005,094909,Cottrell; Garrison W,9999,0,9999,0
1653637149586,CSE 293,006,094910,Deutsch; Alin Bernard,9999,0,9999,0
1653637149586,CSE 293,007,094911,Esmaeilzadeh; Hadi,9999,0,9999,0
1653637149586,CSE 293,008,094912,Freund; Yoav,9999,0,9999,0
1653637149586,CSE 293,009,094913,Griswold; William G.,9999,0,9999,0
1653637149586,CSE 293,010,094914,Gymrek; Melissa Ann,9999,0,9999,0
1653637149586,CSE 293,011,094915,Heninger; Nadia A,9999,0,9999,0
1653637149586,CSE 293,012,094916,Impagliazzo; Russell,9999,0,9999,0
1653637149586,CSE 293,013,094917,Jhala; Ranjit,9999,0,9999,0
1653637149586,CSE 293,014,094918,Kahng; Andrew Byun,9999,0,9999,0
1653637149586,CSE 293,015,094919,Kane; Daniel Mertz,9999,0,9999,0
1653637149586,CSE 293,016,094920,Kriegman; David J,9999,0,9999,0
1653637149586,CSE 293,017,094921,Kumar; Arun Kumar,9999,0,9999,0
1653637149586,CSE 293,018,094922,Lerner; Sorin,9999,0,9999,0
1653637149586,CSE 293,019,094923,Lovett; Shachar,9999,0,9999,0
1653637149586,CSE 293,020,094924,McAuley; Julian John,9999,0,9999,0
1653637149586,CSE 293,021,094925,Micciancio; Daniele,9999,0,9999,0
1653637149586,CSE 293,022,094926,Orailoglu; Alex,9999,0,9999,0
1653637149586,CSE 293,023,094927,Paturi; Ramamohan,9999,0,9999,0
1653637149586,CSE 293,024,094928,Polikarpova; Nadezhda,9999,0,9999,0
1653637149586,CSE 293,025,094929,Politz; Joseph Gibbs,9999,0,9999,0
1653637149586,CSE 293,026,094930,Porter; George M,9999,0,9999,0
1653637149586,CSE 293,027,094931,Porter; Leonard Emerson,9999,0,9999,0
1653637149586,CSE 293,028,094932,Ramamoorthi; Ravi,9999,0,9999,0
1653637149586,CSE 293,029,094933,Sahoo; Debashis,9999,0,9999,0
1653637149586,CSE 293,030,094934,Saul; Lawrence,9999,0,9999,0
1653637149586,CSE 293,031,094935,Savage; Stefan,9999,0,9999,0
1653637149586,CSE 293,032,094936,Schulze; Jurgen P.,9999,0,9999,0
1653637149586,CSE 293,033,094937,Snoeren; Alex C.,9999,0,9999,0
1653637149586,CSE 293,034,094938,Shang; Jingbo,9999,0,9999,0
1653637149586,CSE 293,035,094939,Stefan; Deian,9999,0,9999,0
1653637149586,CSE 293,036,094940,Su; Hao,9999,0,9999,0
1653637149586,CSE 293,037,094941,Swanson; Steven James,9999,0,9999,0
1653637149586,CSE 293,038,094942,Tullsen; Dean Michael,9999,0,9999,0
1653637149586,CSE 293,039,094943,Voelker; Geoffrey M.,9999,0,9999,0
1653637149586,CSE 293,040,094944,Zhao; Jishen,9999,0,9999,0
1653637149586,CSE 293,041,094945,Zhou; Yuan-Yuan,9999,0,9999,0
1653637149586,CSE 293,042,094946,Gao; Sicun,9998,0,9999,1
1653637149586,CSE 293,043,094947,Weibel; Nadir,9999,0,9999,0
1653637149586,CSE 293,044,094948,Gupta; Rajesh K.,9999,0,9999,0
1653637150110,CSE 294,A00,090143,Porter; George M,9,0,10,1
1653637150634,DSE 200,A00,091799,Staff,50,0,50,0
1653637151158,DSE 203,A00,091800,Gupta; Amarnath,30,0,30,0
1653637151686,DSE 250,A00,091801,Deutsch; Alin Bernard,30,0,30,0
1653637152208,DSE 290,A00,091802,Altintas De Callaf; Ilkay,50,0,50,0
1653637152786,ECE 200,001,091003,Antipa; Nicholas A,9999,0,9999,0
1653637152786,ECE 200,002,091004,Atanasov; Nikolay A.,9999,0,9999,0
1653637152786,ECE 200,003,091005,Bharadia; Dinesh,9999,0,9999,0
1653637152786,ECE 200,004,091006,Cheng; Chung Kuan,9999,0,9999,0
1653637152786,ECE 200,005,091007,Cosman; Pamela C.,9999,0,9999,0
1653637152786,ECE 200,006,091008,Staff,9999,0,9999,0
1653637152786,ECE 200,007,091009,Dayeh; Shadi Ahmad,9999,0,9999,0
1653637152786,ECE 200,008,091010,Fainman; Yeshaiahu,9999,0,9999,0
1653637152786,ECE 200,009,091011,Ford; Joseph Earl,9999,0,9999,0
1653637152786,ECE 200,010,091012,Franceschetti; Massimo,9999,0,9999,0
1653637152786,ECE 200,011,091013,Fullerton; Eric E,9999,0,9999,0
1653637152786,ECE 200,012,091014,Galton; Ian A,9999,0,9999,0
1653637152786,ECE 200,013,091015,Gilja; Vikash,9999,0,9999,0
1653637152786,ECE 200,014,091016,Hall; Drew A.,9999,0,9999,0
1653637152786,ECE 200,015,091017,Hsueh; Tzu-Chien,9999,0,9999,0
1653637152786,ECE 200,016,091018,Javidi; Tara,9999,0,9999,0
1653637152786,ECE 200,017,091019,Kahng; Andrew Byun,9999,0,9999,0
1653637152786,ECE 200,018,091020,Kim; Young-Han,9999,0,9999,0
1653637152786,ECE 200,019,091021,Koushanfar; Farinaz,9999,0,9999,0
1653637152786,ECE 200,020,091022,Kuzum; Duygu,9999,0,9999,0
1653637152786,ECE 200,021,091023,Le; Hanh-Phuc,9999,0,9999,0
1653637152786,ECE 200,022,091024,Lin; Bill,9999,0,9999,0
1653637152786,ECE 200,023,091025,Liu; Zhaowei,9999,0,9999,0
1653637152786,ECE 200,024,091026,Lo; Yu-Hwa,9999,0,9999,0
1653637152786,ECE 200,025,091027,Lomakin; Vitaliy,9999,0,9999,0
1653637152786,ECE 200,026,091028,Mercier; Patrick Philip,9999,0,9999,0
1653637152786,ECE 200,027,091029,Meyer; Florian,9999,0,9999,0
1653637152786,ECE 200,028,091030,Milstein; Laurence B.,9999,0,9999,0
1653637152786,ECE 200,029,091031,Mir Arabbaygi; Siavash,9999,0,9999,0
1653637152786,ECE 200,030,091032,Mookherjea; Shayan,9999,0,9999,0
1653637152786,ECE 200,031,091033,Morris; Karcher William,9999,0,9999,0
1653637152786,ECE 200,032,091034,Ng; Tse Nga,9999,0,9999,0
1653637152786,ECE 200,033,091035,Nguyen; Truong Quang,9999,0,9999,0
1653637152786,ECE 200,034,091036,Nomura; Kenji,9999,0,9999,0
1653637152786,ECE 200,035,091037,Orlitsky; Alon,9999,0,9999,0
1653637152786,ECE 200,036,091038,Pal; Piya,9999,0,9999,0
1653637152786,ECE 200,037,091039,Papen; George C.,9999,0,9999,0
1653637152786,ECE 200,038,091040,Radic; Stojan,9999,0,9999,0
1653637152786,ECE 200,039,091041,Rao; Bhaskar D.,9999,0,9999,0
1653637152786,ECE 200,040,091042,Rao; Ramesh R,9999,0,9999,0
1653637152786,ECE 200,041,091043,Rebeiz; Gabriel,9999,0,9999,0
1653637152786,ECE 200,042,091044,Sanford; John R,9999,0,9999,0
1653637152786,ECE 200,043,091045,Siegel; Paul H.,9999,0,9999,0
1653637152786,ECE 200,044,091046,Sievenpiper; Daniel F.,9999,0,9999,0
1653637152786,ECE 200,045,091047,Sworder; David D.,9999,0,9999,0
1653637152786,ECE 200,046,091048,Taur; Yuan,9999,0,9999,0
1653637152786,ECE 200,047,091049,Touri; Behrouz,9999,0,9999,0
1653637152786,ECE 200,048,091050,Trivedi; Mohan M.,9999,0,9999,0
1653637152786,ECE 200,049,091051,Vardy; Alexander,9999,0,9999,0
1653637152786,ECE 200,050,091052,Vasconcelos; Nuno,9999,0,9999,0
1653637152786,ECE 200,051,091053,Wang; Xiaolong,9999,0,9999,0
1653637152786,ECE 200,052,091054,Xie; Pengtao,9999,0,9999,0
1653637152786,ECE 200,053,091055,Yip; Michael,9999,0,9999,0
1653637152786,ECE 200,054,091056,Zeger; Kenneth A.,9999,0,9999,0
1653637152786,ECE 200,055,091057,Zhang; Xinyu,9999,0,9999,0
1653637152786,ECE 200,056,091058,Turakhia; Yatish Girish,9999,0,9999,0
1653637152786,ECE 200,057,091059,Kang; Mingu,9999,0,9999,0
1653637152786,ECE 200,058,091060,Shi; Yuanyuan,9999,0,9999,0
1653637152786,ECE 200,059,091061,Wang; Edward Jay,9999,0,9999,0
1653637152786,ECE 200,060,091062,Zheng; Yang,9999,0,9999,0
1653637153310,ECE 201,A00,095526,Lo; Yu-Hwa,0,0,0,0
1653637153833,ECE 203,A00,091065,Mercier; Patrick Philip,0,0,0,0
1653637154362,ECE 207A,A00,091605,Liu; Thomas Tao-Ming,0,0,0,0
1653637154888,ECE 212AN,A00,091068,Nomura; Kenji,0,0,0,0
1653637155412,ECE 222A,A00,091069,Rebeiz; Gabriel,0,0,0,0
1653637155935,ECE 225A,A00,091070,Orlitsky; Alon,0,0,0,0
1653637156459,ECE 230A,A00,091071,Nomura; Kenji,0,0,0,0
1653637156988,ECE 236A,A00,091072,Dayeh; Shadi Ahmad,0,0,0,0
1653637157512,ECE 238A,A00,091073,Luo; Jian,0,0,0,0
1653637157512,ECE 238A,B00,091074,Luo; Jian,0,0,0,0
1653637158041,ECE 240A,A00,091075,Radic; Stojan,0,0,0,0
1653637158570,ECE 247A,A00,091592,Shi; Lingyan,0,0,0,0
1653637159095,ECE 250,A00,091076,Touri; Behrouz,0,0,0,0
1653637159623,ECE 251C,A00,091078,Nguyen; Truong Quang,0,0,0,0
1653637160147,ECE 253,A00,091079,Cosman; Pamela C.,0,0,0,0
1653637160680,ECE 255A,A00,091080,Orlitsky; Alon,0,0,0,0
1653637161205,ECE 257A,A00,091081,Zhang; Xinyu,0,0,0,0
1653637161733,ECE 260A,A01,091084,Eldon; John,0,0,0,0
1653637162258,ECE 264C,A00,091085,Galton; Ian A,0,0,0,0
1653637162786,ECE 265C,A00,094889,Presti; Calogero Davide,0,0,0,9
1653637163310,ECE 266,A01,091087,Hall; Drew A.,0,0,0,0
1653637164374,ECE 271A,A00,091090,Vasconcelos; Nuno,0,0,0,0
1653637164901,ECE 272B,A00,091091,Sworder; David D.,0,0,0,0
1653637165431,ECE 275A,A00,091092,Meyer; Florian,0,0,0,0
1653637165955,ECE 277,A00,091093,An; Cheolhong,0,0,0,0
1653637166483,ECE 283,A00,091094,Le; Hanh-Phuc,0,0,0,0
1653637167011,ECE 284,A00,091095,Kang; Mingu,0,0,0,0
1653637167011,ECE 284,B00,091096,Wang; Edward Jay,0,0,0,0
1653637167543,ECE 285,A00,094334,Touri; Behrouz,0,0,0,0
1653637168071,ECE 289,A00,091097,Whelan; David Arthur,0,0,0,0
1653637168610,MATH 200A,A00,087414,Salehi Golsefidy; Alireza,7,0,8,1
1653637169134,MATH 202A,A00,087415,Gill; Philip E.,2,0,8,6
1653637169664,MATH 203A,A00,087416,Oprea; Dragos N.,6,0,8,2
1653637170191,MATH 204A,A00,087417,Kedlaya; Kiran S.,6,0,8,2
1653637170716,MATH 205,A00,087418,Sorensen; Claus M,6,0,8,2
1653637171241,MATH 206A,A00,087419,Izadi; Elham,6,0,8,2
1653637171766,MATH 207A,A00,087420,Mohammadi; Amir,5,0,8,3
1653637172291,MATH 208,A00,087421,Staff,8,0,10,2
1653637172814,MATH 209,A00,087422,Staff,10,0,10,0
1653637173340,MATH 218,A00,087423,Staff,10,0,10,0
1653637173864,MATH 220A,A00,087424,Novak; Jonathan I,6,0,8,2
1653637174390,MATH 231A,A00,087425,Bejenaru; Ioan,3,0,8,5
1653637174916,MATH 240A,A00,087426,Ebenfelt; Peter F,5,0,8,3
1653637175442,MATH 243,A00,087427,Staff,9,0,10,1
1653637175965,MATH 248,A00,087429,Staff,10,0,10,0
1653637176489,MATH 250A,A00,087430,Spolaor; Luca,4,0,8,4
1653637177021,MATH 257A,A00,087431,Spolaor; Luca,7,0,8,1
1653637177548,MATH 258,A00,087432,Staff,9,0,10,1
1653637178073,MATH 264A,A00,087433,Warnke; Lutz Peter,5,0,8,3
1653637178596,MATH 268,A00,087434,Staff,15,0,15,0
1653637179118,MATH 269,A00,087435,Staff,14,0,15,1
1653637179642,MATH 270A,A00,087436,Nie; Jiawang,0,0,8,8
1653637180171,MATH 272A,A00,087437,Tian; Xiaochuan,0,0,8,8
1653637180702,MATH 274,A01,087439,Cheng; Li-Tien,9,0,10,1
1653637180702,MATH 274,A02,087440,Cheng; Li-Tien,10,0,10,0
1653637181242,MATH 278A,A00,087441,Staff,8,0,10,2
1653637181769,MATH 278B,A00,087442,Staff,8,0,10,2
1653637182291,MATH 278C,A00,087443,Staff,8,0,10,2
1653637182819,MATH 280A,A00,087444,Zheng; Tianyi,0,0,8,8
1653637183348,MATH 281A,A00,087445,Bradic; Jelena,0,0,8,9
1653637183875,MATH 282A,A00,087446,Zhang; Danna,0,0,8,8
1653637184399,MATH 283,A00,087447,Tesler; Glenn,0,0,0,16
1653637184941,MATH 286,B00,095535,Kemp; Todd Aahron,5,0,8,3
1653637185474,MATH 287D,B00,095536,Bradic; Jelena,5,0,8,3
1653637185998,MATH 288,A00,087450,Staff,14,0,15,1
1653637185998,MATH 288,B00,087451,Staff,15,0,15,0
1653637185998,MATH 288,C00,087452,Staff,15,0,15,0
1653637186521,MATH 290A,A00,087453,Xu; Zhouli,6,0,8,2
1653637187046,MATH 291A,A00,087454,Xu; Zhouli,7,0,8,1
1653637187570,MATH 292,A00,087455,Staff,10,0,10,0
1653637188094,MATH 295,A00,087456,Staff,50,0,50,0
1653637188621,MATH 297,001,087457,Staff,997,0,999,2
1653637749839,COGS 200,A01,087991,Staff,47,0,50,3
1653637750365,COGS 201,A01,094504,Rangel; Lara M,16,0,25,9
1653637750902,COGS 203,A00,087992,Coulson; Seana M,18,0,20,2
1653637751430,COGS 210A,001,087993,Greene; Deanna Jacquelyn,9998,0,9999,1
1653637751430,COGS 210A,002,087994,Saygin; Ayse P,9999,0,9999,0
1653637751430,COGS 210A,003,087995,Xia; Haijun,9999,0,9999,0
1653637751430,COGS 210A,004,087996,Nitz; Douglas A.,9999,0,9999,0
1653637751430,COGS 210A,005,087997,Hollan; James D.,9999,0,9999,0
1653637751430,COGS 210A,006,087998,Deak; Gedeon O.,9998,0,9999,1
1653637751430,COGS 210A,007,087999,Rossano; Federico,9999,0,9999,0
1653637751955,COGS 211A,A00,088000,Coulson; Seana M,9997,0,9999,2
1653637752480,COGS 229,A00,088002,Staff,22,0,25,3
1653637753008,COGS 260,B00,094231,Staff,17,0,20,3
1653637753008,COGS 260,A00,088004,Nitz; Douglas A.,9998,0,9999,1
1653637753534,CSE 202,A00,090110,Paturi; Ramamohan,0,0,0,0
1653637753534,CSE 202,B00,090111,Paturi; Ramamohan,0,0,0,0
1653637754058,CSE 207B,A00,090112,Heninger; Nadia A,0,0,0,0
1653637754584,CSE 208,A00,094858,Micciancio; Daniele,0,0,0,0
1653637755109,CSE 210,A00,090113,Powell; Thomas Allan,0,0,0,0
1653637755641,CSE 219,A00,090898,Staff,0,0,0,0
1653637756170,CSE 221,A00,090114,Zhou; Yuan-Yuan,0,0,0,0
1653637756706,CSE 229A,A00,090115,Porter; George M,0,0,0,0
1653637757230,CSE 229C,A00,090116,Savage; Stefan,0,0,0,0
1653637757756,CSE 230,A00,090117,Jhala; Ranjit,0,0,0,0
1653637758286,CSE 232,A00,090118,Papakonstantinou; Yannis,0,0,0,0
1653637758814,CSE 239A,A00,090121,Kumar; Arun Kumar,0,0,0,0
1653637759341,CSE 239B,A00,090122,Jhala; Ranjit,0,0,0,0
1653637759868,CSE 240A,A00,090123,Zhao; Jishen,0,0,189,189
1653637760392,CSE 243A,A00,090124,Orailoglu; Alex,0,0,15,15
1653637760918,CSE 249B,A00,090125,Kahng; Andrew Byun,12,0,20,8
1653637761446,CSE 250A,A00,090126,Berg-Kirkpatrick; Taylor D,0,0,0,0
1653637761969,CSE 252A,A00,090127,Ochoa; Benjamin Lawrence,0,0,0,0
1653637762498,CSE 258,A01,090129,McAuley; Julian John,0,0,0,0
1653637763026,CSE 258R,A01,090131,McAuley; Julian John,0,0,0,0
1653637763549,CSE 274,A00,090132,Ramamoorthi; Ravi,0,0,0,0
1653637764074,CSE 276A,A00,090133,Christensen; Henrik I,0,0,0,0
1653637764600,CSE 276C,A00,090134,Christensen; Henrik I,0,0,0,0
1653637765131,CSE 290,A00,090135,Bafna; Vineet,0,0,0,0
1653637765131,CSE 290,B00,090136,Ramamoorthi; Ravi,0,0,0,0
1653637765131,CSE 290,C00,090137,Li; Tzumao,7,0,10,3
1653637765131,CSE 290,D00,090138,Zhou; Yuan-Yuan,9,0,10,1
1653637765131,CSE 290,E00,090139,Christensen; Henrik I,8,0,10,2
1653637765131,CSE 290,F00,094053,Shalev; Aaron D,0,0,0,0
1653637765662,CSE 291,A00,090140,Munyaka; Imani N. S.,0,0,0,0
1653637765662,CSE 291,B00,094880,Yu; Qi,0,0,0,0
1653637765662,CSE 291,C00,090142,Pannuto; Patrick William,0,0,0,0
1653637765662,CSE 291,D00,094881,Zhang; Yiying,0,0,0,0
1653637765662,CSE 291,E00,095118,Su; Hao,0,0,0,0
1653637766202,CSE 293,001,094905,Bafna; Vineet,9999,0,9999,0
1653637766202,CSE 293,002,094906,Bellare; Mihir,9999,0,9999,0
1653637766202,CSE 293,003,094907,Berg-Kirkpatrick; Taylor D,9999,0,9999,0
1653637766202,CSE 293,004,094908,Christensen; Henrik I,9999,0,9999,0
1653637766202,CSE 293,005,094909,Cottrell; Garrison W,9999,0,9999,0
1653637766202,CSE 293,006,094910,Deutsch; Alin Bernard,9999,0,9999,0
1653637766202,CSE 293,007,094911,Esmaeilzadeh; Hadi,9999,0,9999,0
1653637766202,CSE 293,008,094912,Freund; Yoav,9999,0,9999,0
1653637766202,CSE 293,009,094913,Griswold; William G.,9999,0,9999,0
1653637766202,CSE 293,010,094914,Gymrek; Melissa Ann,9999,0,9999,0
1653637766202,CSE 293,011,094915,Heninger; Nadia A,9999,0,9999,0
1653637766202,CSE 293,012,094916,Impagliazzo; Russell,9999,0,9999,0
1653637766202,CSE 293,013,094917,Jhala; Ranjit,9999,0,9999,0
1653637766202,CSE 293,014,094918,Kahng; Andrew Byun,9999,0,9999,0
1653637766202,CSE 293,015,094919,Kane; Daniel Mertz,9999,0,9999,0
1653637766202,CSE 293,016,094920,Kriegman; David J,9999,0,9999,0
1653637766202,CSE 293,017,094921,Kumar; Arun Kumar,9999,0,9999,0
1653637766202,CSE 293,018,094922,Lerner; Sorin,9999,0,9999,0
1653637766202,CSE 293,019,094923,Lovett; Shachar,9999,0,9999,0
1653637766202,CSE 293,020,094924,McAuley; Julian John,9999,0,9999,0
1653637766202,CSE 293,021,094925,Micciancio; Daniele,9999,0,9999,0
1653637766202,CSE 293,022,094926,Orailoglu; Alex,9999,0,9999,0
1653637766202,CSE 293,023,094927,Paturi; Ramamohan,9999,0,9999,0
1653637766202,CSE 293,024,094928,Polikarpova; Nadezhda,9999,0,9999,0
1653637766202,CSE 293,025,094929,Politz; Joseph Gibbs,9999,0,9999,0
1653637766202,CSE 293,026,094930,Porter; George M,9999,0,9999,0
1653637766202,CSE 293,027,094931,Porter; Leonard Emerson,9999,0,9999,0
1653637766202,CSE 293,028,094932,Ramamoorthi; Ravi,9999,0,9999,0
1653637766202,CSE 293,029,094933,Sahoo; Debashis,9999,0,9999,0
1653637766202,CSE 293,030,094934,Saul; Lawrence,9999,0,9999,0
1653637766202,CSE 293,031,094935,Savage; Stefan,9999,0,9999,0
1653637766202,CSE 293,032,094936,Schulze; Jurgen P.,9999,0,9999,0
1653637766202,CSE 293,033,094937,Snoeren; Alex C.,9999,0,9999,0
1653637766202,CSE 293,034,094938,Shang; Jingbo,9999,0,9999,0
1653637766202,CSE 293,035,094939,Stefan; Deian,9999,0,9999,0
1653637766202,CSE 293,036,094940,Su; Hao,9999,0,9999,0
1653637766202,CSE 293,037,094941,Swanson; Steven James,9999,0,9999,0
1653637766202,CSE 293,038,094942,Tullsen; Dean Michael,9999,0,9999,0
1653637766202,CSE 293,039,094943,Voelker; Geoffrey M.,9999,0,9999,0
1653637766202,CSE 293,040,094944,Zhao; Jishen,9999,0,9999,0
1653637766202,CSE 293,041,094945,Zhou; Yuan-Yuan,9999,0,9999,0
1653637766202,CSE 293,042,094946,Gao; Sicun,9998,0,9999,1
1653637766202,CSE 293,043,094947,Weibel; Nadir,9999,0,9999,0
1653637766202,CSE 293,044,094948,Gupta; Rajesh K.,9999,0,9999,0
1653637766732,CSE 294,A00,090143,Porter; George M,9,0,10,1
1653637767260,DSE 200,A00,091799,Staff,50,0,50,0
1653637767792,DSE 203,A00,091800,Gupta; Amarnath,30,0,30,0
1653637768320,DSE 250,A00,091801,Deutsch; Alin Bernard,30,0,30,0
1653637768858,DSE 290,A00,091802,Altintas De Callaf; Ilkay,50,0,50,0
1653637769416,ECE 200,001,091003,Antipa; Nicholas A,9999,0,9999,0
1653637769416,ECE 200,002,091004,Atanasov; Nikolay A.,9999,0,9999,0
1653637769416,ECE 200,003,091005,Bharadia; Dinesh,9999,0,9999,0
1653637769416,ECE 200,004,091006,Cheng; Chung Kuan,9999,0,9999,0
1653637769416,ECE 200,005,091007,Cosman; Pamela C.,9999,0,9999,0
1653637769416,ECE 200,006,091008,Staff,9999,0,9999,0
1653637769416,ECE 200,007,091009,Dayeh; Shadi Ahmad,9999,0,9999,0
1653637769416,ECE 200,008,091010,Fainman; Yeshaiahu,9999,0,9999,0
1653637769416,ECE 200,009,091011,Ford; Joseph Earl,9999,0,9999,0
1653637769416,ECE 200,010,091012,Franceschetti; Massimo,9999,0,9999,0
1653637769416,ECE 200,011,091013,Fullerton; Eric E,9999,0,9999,0
1653637769416,ECE 200,012,091014,Galton; Ian A,9999,0,9999,0
1653637769416,ECE 200,013,091015,Gilja; Vikash,9999,0,9999,0
1653637769416,ECE 200,014,091016,Hall; Drew A.,9999,0,9999,0
1653637769416,ECE 200,015,091017,Hsueh; Tzu-Chien,9999,0,9999,0
1653637769416,ECE 200,016,091018,Javidi; Tara,9999,0,9999,0
1653637769416,ECE 200,017,091019,Kahng; Andrew Byun,9999,0,9999,0
1653637769416,ECE 200,018,091020,Kim; Young-Han,9999,0,9999,0
1653637769416,ECE 200,019,091021,Koushanfar; Farinaz,9999,0,9999,0
1653637769416,ECE 200,020,091022,Kuzum; Duygu,9999,0,9999,0
1653637769416,ECE 200,021,091023,Le; Hanh-Phuc,9999,0,9999,0
1653637769416,ECE 200,022,091024,Lin; Bill,9999,0,9999,0
1653637769416,ECE 200,023,091025,Liu; Zhaowei,9999,0,9999,0
1653637769416,ECE 200,024,091026,Lo; Yu-Hwa,9999,0,9999,0
1653637769416,ECE 200,025,091027,Lomakin; Vitaliy,9999,0,9999,0
1653637769416,ECE 200,026,091028,Mercier; Patrick Philip,9999,0,9999,0
1653637769416,ECE 200,027,091029,Meyer; Florian,9999,0,9999,0
1653637769416,ECE 200,028,091030,Milstein; Laurence B.,9999,0,9999,0
1653637769416,ECE 200,029,091031,Mir Arabbaygi; Siavash,9999,0,9999,0
1653637769416,ECE 200,030,091032,Mookherjea; Shayan,9999,0,9999,0
1653637769416,ECE 200,031,091033,Morris; Karcher William,9999,0,9999,0
1653637769416,ECE 200,032,091034,Ng; Tse Nga,9999,0,9999,0
1653637769416,ECE 200,033,091035,Nguyen; Truong Quang,9999,0,9999,0
1653637769416,ECE 200,034,091036,Nomura; Kenji,9999,0,9999,0
1653637769416,ECE 200,035,091037,Orlitsky; Alon,9999,0,9999,0
1653637769416,ECE 200,036,091038,Pal; Piya,9999,0,9999,0
1653637769416,ECE 200,037,091039,Papen; George C.,9999,0,9999,0
1653637769416,ECE 200,038,091040,Radic; Stojan,9999,0,9999,0
1653637769416,ECE 200,039,091041,Rao; Bhaskar D.,9999,0,9999,0
1653637769416,ECE 200,040,091042,Rao; Ramesh R,9999,0,9999,0
1653637769416,ECE 200,041,091043,Rebeiz; Gabriel,9999,0,9999,0
1653637769416,ECE 200,042,091044,Sanford; John R,9999,0,9999,0
1653637769416,ECE 200,043,091045,Siegel; Paul H.,9999,0,9999,0
1653637769416,ECE 200,044,091046,Sievenpiper; Daniel F.,9999,0,9999,0
1653637769416,ECE 200,045,091047,Sworder; David D.,9999,0,9999,0
1653637769416,ECE 200,046,091048,Taur; Yuan,9999,0,9999,0
1653637769416,ECE 200,047,091049,Touri; Behrouz,9999,0,9999,0
1653637769416,ECE 200,048,091050,Trivedi; Mohan M.,9999,0,9999,0
1653637769416,ECE 200,049,091051,Vardy; Alexander,9999,0,9999,0
1653637769416,ECE 200,050,091052,Vasconcelos; Nuno,9999,0,9999,0
1653637769416,ECE 200,051,091053,Wang; Xiaolong,9999,0,9999,0
1653637769416,ECE 200,052,091054,Xie; Pengtao,9999,0,9999,0
1653637769416,ECE 200,053,091055,Yip; Michael,9999,0,9999,0
1653637769416,ECE 200,054,091056,Zeger; Kenneth A.,9999,0,9999,0
1653637769416,ECE 200,055,091057,Zhang; Xinyu,9999,0,9999,0
1653637769416,ECE 200,056,091058,Turakhia; Yatish Girish,9999,0,9999,0
1653637769416,ECE 200,057,091059,Kang; Mingu,9999,0,9999,0
1653637769416,ECE 200,058,091060,Shi; Yuanyuan,9999,0,9999,0
1653637769416,ECE 200,059,091061,Wang; Edward Jay,9999,0,9999,0
1653637769416,ECE 200,060,091062,Zheng; Yang,9999,0,9999,0
1653637769940,ECE 201,A00,095526,Lo; Yu-Hwa,0,0,0,0
1653637770470,ECE 203,A00,091065,Mercier; Patrick Philip,0,0,0,0
1653637771004,ECE 207A,A00,091605,Liu; Thomas Tao-Ming,0,0,0,0
1653637771528,ECE 212AN,A00,091068,Nomura; Kenji,0,0,0,0
1653637772053,ECE 222A,A00,091069,Rebeiz; Gabriel,0,0,0,0
1653637772582,ECE 225A,A00,091070,Orlitsky; Alon,0,0,0,0
1653637773108,ECE 230A,A00,091071,Nomura; Kenji,0,0,0,0
1653637773648,ECE 236A,A00,091072,Dayeh; Shadi Ahmad,0,0,0,0
1653637774173,ECE 238A,A00,091073,Luo; Jian,0,0,0,0
1653637774173,ECE 238A,B00,091074,Luo; Jian,0,0,0,0
1653637774698,ECE 240A,A00,091075,Radic; Stojan,0,0,0,0
1653637775222,ECE 247A,A00,091592,Shi; Lingyan,0,0,0,0
1653637775745,ECE 250,A00,091076,Touri; Behrouz,0,0,0,0
1653637776269,ECE 251C,A00,091078,Nguyen; Truong Quang,0,0,0,0
1653637776799,ECE 253,A00,091079,Cosman; Pamela C.,0,0,0,0
1653637777324,ECE 255A,A00,091080,Orlitsky; Alon,0,0,0,0
1653637777847,ECE 257A,A00,091081,Zhang; Xinyu,0,0,0,0
1653637778371,ECE 260A,A01,091084,Eldon; John,0,0,0,0
1653637778898,ECE 264C,A00,091085,Galton; Ian A,0,0,0,0
1653637779430,ECE 265C,A00,094889,Presti; Calogero Davide,0,0,0,9
1653637779955,ECE 266,A01,091087,Hall; Drew A.,0,0,0,0
1653637781092,ECE 271A,A00,091090,Vasconcelos; Nuno,0,0,0,0
1653637781615,ECE 272B,A00,091091,Sworder; David D.,0,0,0,0
1653637782143,ECE 275A,A00,091092,Meyer; Florian,0,0,0,0
1653637782675,ECE 277,A00,091093,An; Cheolhong,0,0,0,0
1653637783200,ECE 283,A00,091094,Le; Hanh-Phuc,0,0,0,0
1653637783732,ECE 284,A00,091095,Kang; Mingu,0,0,0,0
1653637783732,ECE 284,B00,091096,Wang; Edward Jay,0,0,0,0
1653637784265,ECE 285,A00,094334,Touri; Behrouz,0,0,0,0
1653637784789,ECE 289,A00,091097,Whelan; David Arthur,0,0,0,0
1653637785320,MATH 200A,A00,087414,Salehi Golsefidy; Alireza,7,0,8,1
1653637785853,MATH 202A,A00,087415,Gill; Philip E.,2,0,8,6
1653637786377,MATH 203A,A00,087416,Oprea; Dragos N.,6,0,8,2
1653637786904,MATH 204A,A00,087417,Kedlaya; Kiran S.,6,0,8,2
1653637787431,MATH 205,A00,087418,Sorensen; Claus M,6,0,8,2
1653637787960,MATH 206A,A00,087419,Izadi; Elham,6,0,8,2
1653637788483,MATH 207A,A00,087420,Mohammadi; Amir,5,0,8,3
1653637789007,MATH 208,A00,087421,Staff,8,0,10,2
1653637789532,MATH 209,A00,087422,Staff,10,0,10,0
1653637790064,MATH 218,A00,087423,Staff,10,0,10,0
1653637790588,MATH 220A,A00,087424,Novak; Jonathan I,6,0,8,2
1653637791117,MATH 231A,A00,087425,Bejenaru; Ioan,3,0,8,5
1653637791644,MATH 240A,A00,087426,Ebenfelt; Peter F,5,0,8,3
1653637792168,MATH 243,A00,087427,Staff,9,0,10,1
1653637792692,MATH 248,A00,087429,Staff,10,0,10,0
1653637793219,MATH 250A,A00,087430,Spolaor; Luca,4,0,8,4
1653637793742,MATH 257A,A00,087431,Spolaor; Luca,7,0,8,1
1653637794270,MATH 258,A00,087432,Staff,9,0,10,1
1653637794808,MATH 264A,A00,087433,Warnke; Lutz Peter,5,0,8,3
1653637795331,MATH 268,A00,087434,Staff,15,0,15,0
1653637795855,MATH 269,A00,087435,Staff,14,0,15,1
1653637796381,MATH 270A,A00,087436,Nie; Jiawang,0,0,8,8
1653637796911,MATH 272A,A00,087437,Tian; Xiaochuan,0,0,8,8
1653637797436,MATH 274,A01,087439,Cheng; Li-Tien,9,0,10,1
1653637797436,MATH 274,A02,087440,Cheng; Li-Tien,10,0,10,0
1653637797962,MATH 278A,A00,087441,Staff,8,0,10,2
1653637798485,MATH 278B,A00,087442,Staff,8,0,10,2
1653637799009,MATH 278C,A00,087443,Staff,8,0,10,2
1653637799533,MATH 280A,A00,087444,Zheng; Tianyi,0,0,8,8
1653637800060,MATH 281A,A00,087445,Bradic; Jelena,0,0,8,9
1653637800589,MATH 282A,A00,087446,Zhang; Danna,0,0,8,8
1653637801115,MATH 283,A00,087447,Tesler; Glenn,0,0,0,16
1653637801641,MATH 286,B00,095535,Kemp; Todd Aahron,5,0,8,3
1653637802165,MATH 287D,B00,095536,Bradic; Jelena,5,0,8,3
1653637802697,MATH 288,A00,087450,Staff,14,0,15,1
1653637802697,MATH 288,B00,087451,Staff,15,0,15,0
1653637802697,MATH 288,C00,087452,Staff,15,0,15,0
1653637803220,MATH 290A,A00,087453,Xu; Zhouli,6,0,8,2
1653637803749,MATH 291A,A00,087454,Xu; Zhouli,7,0,8,1
1653637804274,MATH 292,A00,087455,Staff,10,0,10,0
1653637804800,MATH 295,A00,087456,Staff,50,0,50,0
1653637805329,MATH 297,001,087457,Staff,997,0,999,2
1653638367255,COGS 200,A01,087991,Staff,47,0,50,3
1653638367781,COGS 201,A01,094504,Rangel; Lara M,16,0,25,9
1653638368305,COGS 203,A00,087992,Coulson; Seana M,18,0,20,2
1653638368832,COGS 210A,001,087993,Greene; Deanna Jacquelyn,9998,0,9999,1
1653638368832,COGS 210A,002,087994,Saygin; Ayse P,9999,0,9999,0
1653638368832,COGS 210A,003,087995,Xia; Haijun,9999,0,9999,0
1653638368832,COGS 210A,004,087996,Nitz; Douglas A.,9999,0,9999,0
1653638368832,COGS 210A,005,087997,Hollan; James D.,9999,0,9999,0
1653638368832,COGS 210A,006,087998,Deak; Gedeon O.,9998,0,9999,1
1653638368832,COGS 210A,007,087999,Rossano; Federico,9999,0,9999,0
1653638369359,COGS 211A,A00,088000,Coulson; Seana M,9997,0,9999,2
1653638369955,COGS 229,A00,088002,Staff,22,0,25,3
1653638370481,COGS 260,B00,094231,Staff,17,0,20,3
1653638370481,COGS 260,A00,088004,Nitz; Douglas A.,9998,0,9999,1
1653638371008,CSE 202,A00,090110,Paturi; Ramamohan,0,0,0,0
1653638371008,CSE 202,B00,090111,Paturi; Ramamohan,0,0,0,0
1653638371534,CSE 207B,A00,090112,Heninger; Nadia A,0,0,0,0
1653638372061,CSE 208,A00,094858,Micciancio; Daniele,0,0,0,0
1653638372585,CSE 210,A00,090113,Powell; Thomas Allan,0,0,0,0
1653638373115,CSE 219,A00,090898,Staff,0,0,0,0
1653638373647,CSE 221,A00,090114,Zhou; Yuan-Yuan,0,0,0,0
1653638374181,CSE 229A,A00,090115,Porter; George M,0,0,0,0
1653638374709,CSE 229C,A00,090116,Savage; Stefan,0,0,0,0
1653638375236,CSE 230,A00,090117,Jhala; Ranjit,0,0,0,0
1653638375765,CSE 232,A00,090118,Papakonstantinou; Yannis,0,0,0,0
1653638376290,CSE 239A,A00,090121,Kumar; Arun Kumar,0,0,0,0
1653638376814,CSE 239B,A00,090122,Jhala; Ranjit,0,0,0,0
1653638377341,CSE 240A,A00,090123,Zhao; Jishen,0,0,189,189
1653638377873,CSE 243A,A00,090124,Orailoglu; Alex,0,0,15,15
1653638378402,CSE 249B,A00,090125,Kahng; Andrew Byun,12,0,20,8
1653638378927,CSE 250A,A00,090126,Berg-Kirkpatrick; Taylor D,0,0,0,0
1653638379456,CSE 252A,A00,090127,Ochoa; Benjamin Lawrence,0,0,0,0
1653638379984,CSE 258,A01,090129,McAuley; Julian John,0,0,0,0
1653638380508,CSE 258R,A01,090131,McAuley; Julian John,0,0,0,0
1653638381032,CSE 274,A00,090132,Ramamoorthi; Ravi,0,0,0,0
1653638381561,CSE 276A,A00,090133,Christensen; Henrik I,0,0,0,0
1653638382087,CSE 276C,A00,090134,Christensen; Henrik I,0,0,0,0
1653638382614,CSE 290,A00,090135,Bafna; Vineet,0,0,0,0
1653638382614,CSE 290,B00,090136,Ramamoorthi; Ravi,0,0,0,0
1653638382614,CSE 290,C00,090137,Li; Tzumao,7,0,10,3
1653638382614,CSE 290,D00,090138,Zhou; Yuan-Yuan,9,0,10,1
1653638382614,CSE 290,E00,090139,Christensen; Henrik I,8,0,10,2
1653638382614,CSE 290,F00,094053,Shalev; Aaron D,0,0,0,0
1653638383142,CSE 291,A00,090140,Munyaka; Imani N. S.,0,0,0,0
1653638383142,CSE 291,B00,094880,Yu; Qi,0,0,0,0
1653638383142,CSE 291,C00,090142,Pannuto; Patrick William,0,0,0,0
1653638383142,CSE 291,D00,094881,Zhang; Yiying,0,0,0,0
1653638383142,CSE 291,E00,095118,Su; Hao,0,0,0,0
1653638383680,CSE 293,001,094905,Bafna; Vineet,9999,0,9999,0
1653638383680,CSE 293,002,094906,Bellare; Mihir,9999,0,9999,0
1653638383680,CSE 293,003,094907,Berg-Kirkpatrick; Taylor D,9999,0,9999,0
1653638383680,CSE 293,004,094908,Christensen; Henrik I,9999,0,9999,0
1653638383680,CSE 293,005,094909,Cottrell; Garrison W,9999,0,9999,0
1653638383680,CSE 293,006,094910,Deutsch; Alin Bernard,9999,0,9999,0
1653638383680,CSE 293,007,094911,Esmaeilzadeh; Hadi,9999,0,9999,0
1653638383680,CSE 293,008,094912,Freund; Yoav,9999,0,9999,0
1653638383680,CSE 293,009,094913,Griswold; William G.,9999,0,9999,0
1653638383680,CSE 293,010,094914,Gymrek; Melissa Ann,9999,0,9999,0
1653638383680,CSE 293,011,094915,Heninger; Nadia A,9999,0,9999,0
1653638383680,CSE 293,012,094916,Impagliazzo; Russell,9999,0,9999,0
1653638383680,CSE 293,013,094917,Jhala; Ranjit,9999,0,9999,0
1653638383680,CSE 293,014,094918,Kahng; Andrew Byun,9999,0,9999,0
1653638383680,CSE 293,015,094919,Kane; Daniel Mertz,9999,0,9999,0
1653638383680,CSE 293,016,094920,Kriegman; David J,9999,0,9999,0
1653638383680,CSE 293,017,094921,Kumar; Arun Kumar,9999,0,9999,0
1653638383680,CSE 293,018,094922,Lerner; Sorin,9999,0,9999,0
1653638383680,CSE 293,019,094923,Lovett; Shachar,9999,0,9999,0
1653638383680,CSE 293,020,094924,McAuley; Julian John,9999,0,9999,0
1653638383680,CSE 293,021,094925,Micciancio; Daniele,9999,0,9999,0
1653638383680,CSE 293,022,094926,Orailoglu; Alex,9999,0,9999,0
1653638383680,CSE 293,023,094927,Paturi; Ramamohan,9999,0,9999,0
1653638383680,CSE 293,024,094928,Polikarpova; Nadezhda,9999,0,9999,0
1653638383680,CSE 293,025,094929,Politz; Joseph Gibbs,9999,0,9999,0
1653638383680,CSE 293,026,094930,Porter; George M,9999,0,9999,0
1653638383680,CSE 293,027,094931,Porter; Leonard Emerson,9999,0,9999,0
1653638383680,CSE 293,028,094932,Ramamoorthi; Ravi,9999,0,9999,0
1653638383680,CSE 293,029,094933,Sahoo; Debashis,9999,0,9999,0
1653638383680,CSE 293,030,094934,Saul; Lawrence,9999,0,9999,0
1653638383680,CSE 293,031,094935,Savage; Stefan,9999,0,9999,0
1653638383680,CSE 293,032,094936,Schulze; Jurgen P.,9999,0,9999,0
1653638383680,CSE 293,033,094937,Snoeren; Alex C.,9999,0,9999,0
1653638383680,CSE 293,034,094938,Shang; Jingbo,9999,0,9999,0
1653638383680,CSE 293,035,094939,Stefan; Deian,9999,0,9999,0
1653638383680,CSE 293,036,094940,Su; Hao,9999,0,9999,0
1653638383680,CSE 293,037,094941,Swanson; Steven James,9999,0,9999,0
1653638383680,CSE 293,038,094942,Tullsen; Dean Michael,9999,0,9999,0
1653638383680,CSE 293,039,094943,Voelker; Geoffrey M.,9999,0,9999,0
1653638383680,CSE 293,040,094944,Zhao; Jishen,9999,0,9999,0
1653638383680,CSE 293,041,094945,Zhou; Yuan-Yuan,9999,0,9999,0
1653638383680,CSE 293,042,094946,Gao; Sicun,9998,0,9999,1
1653638383680,CSE 293,043,094947,Weibel; Nadir,9999,0,9999,0
1653638383680,CSE 293,044,094948,Gupta; Rajesh K.,9999,0,9999,0
1653638384204,CSE 294,A00,090143,Porter; George M,9,0,10,1
1653638384733,DSE 200,A00,091799,Staff,50,0,50,0
1653638385266,DSE 203,A00,091800,Gupta; Amarnath,30,0,30,0
1653638385789,DSE 250,A00,091801,Deutsch; Alin Bernard,30,0,30,0
1653638386314,DSE 290,A00,091802,Altintas De Callaf; Ilkay,50,0,50,0
1653638386870,ECE 200,001,091003,Antipa; Nicholas A,9999,0,9999,0
1653638386870,ECE 200,002,091004,Atanasov; Nikolay A.,9999,0,9999,0
1653638386870,ECE 200,003,091005,Bharadia; Dinesh,9999,0,9999,0
1653638386870,ECE 200,004,091006,Cheng; Chung Kuan,9999,0,9999,0
1653638386870,ECE 200,005,091007,Cosman; Pamela C.,9999,0,9999,0
1653638386870,ECE 200,006,091008,Staff,9999,0,9999,0
1653638386870,ECE 200,007,091009,Dayeh; Shadi Ahmad,9999,0,9999,0
1653638386870,ECE 200,008,091010,Fainman; Yeshaiahu,9999,0,9999,0
1653638386870,ECE 200,009,091011,Ford; Joseph Earl,9999,0,9999,0
1653638386870,ECE 200,010,091012,Franceschetti; Massimo,9999,0,9999,0
1653638386870,ECE 200,011,091013,Fullerton; Eric E,9999,0,9999,0
1653638386870,ECE 200,012,091014,Galton; Ian A,9999,0,9999,0
1653638386870,ECE 200,013,091015,Gilja; Vikash,9999,0,9999,0
1653638386870,ECE 200,014,091016,Hall; Drew A.,9999,0,9999,0
1653638386870,ECE 200,015,091017,Hsueh; Tzu-Chien,9999,0,9999,0
1653638386870,ECE 200,016,091018,Javidi; Tara,9999,0,9999,0
1653638386870,ECE 200,017,091019,Kahng; Andrew Byun,9999,0,9999,0
1653638386870,ECE 200,018,091020,Kim; Young-Han,9999,0,9999,0
1653638386870,ECE 200,019,091021,Koushanfar; Farinaz,9999,0,9999,0
1653638386870,ECE 200,020,091022,Kuzum; Duygu,9999,0,9999,0
1653638386870,ECE 200,021,091023,Le; Hanh-Phuc,9999,0,9999,0
1653638386870,ECE 200,022,091024,Lin; Bill,9999,0,9999,0
1653638386870,ECE 200,023,091025,Liu; Zhaowei,9999,0,9999,0
1653638386870,ECE 200,024,091026,Lo; Yu-Hwa,9999,0,9999,0
1653638386870,ECE 200,025,091027,Lomakin; Vitaliy,9999,0,9999,0
1653638386870,ECE 200,026,091028,Mercier; Patrick Philip,9999,0,9999,0
1653638386870,ECE 200,027,091029,Meyer; Florian,9999,0,9999,0
1653638386870,ECE 200,028,091030,Milstein; Laurence B.,9999,0,9999,0
1653638386870,ECE 200,029,091031,Mir Arabbaygi; Siavash,9999,0,9999,0
1653638386870,ECE 200,030,091032,Mookherjea; Shayan,9999,0,9999,0
1653638386870,ECE 200,031,091033,Morris; Karcher William,9999,0,9999,0
1653638386870,ECE 200,032,091034,Ng; Tse Nga,9999,0,9999,0
1653638386870,ECE 200,033,091035,Nguyen; Truong Quang,9999,0,9999,0
1653638386870,ECE 200,034,091036,Nomura; Kenji,9999,0,9999,0
1653638386870,ECE 200,035,091037,Orlitsky; Alon,9999,0,9999,0
1653638386870,ECE 200,036,091038,Pal; Piya,9999,0,9999,0
1653638386870,ECE 200,037,091039,Papen; George C.,9999,0,9999,0
1653638386870,ECE 200,038,091040,Radic; Stojan,9999,0,9999,0
1653638386870,ECE 200,039,091041,Rao; Bhaskar D.,9999,0,9999,0
1653638386870,ECE 200,040,091042,Rao; Ramesh R,9999,0,9999,0
1653638386870,ECE 200,041,091043,Rebeiz; Gabriel,9999,0,9999,0
1653638386870,ECE 200,042,091044,Sanford; John R,9999,0,9999,0
1653638386870,ECE 200,043,091045,Siegel; Paul H.,9999,0,9999,0
1653638386870,ECE 200,044,091046,Sievenpiper; Daniel F.,9999,0,9999,0
1653638386870,ECE 200,045,091047,Sworder; David D.,9999,0,9999,0
1653638386870,ECE 200,046,091048,Taur; Yuan,9999,0,9999,0
1653638386870,ECE 200,047,091049,Touri; Behrouz,9999,0,9999,0
1653638386870,ECE 200,048,091050,Trivedi; Mohan M.,9999,0,9999,0
1653638386870,ECE 200,049,091051,Vardy; Alexander,9999,0,9999,0
1653638386870,ECE 200,050,091052,Vasconcelos; Nuno,9999,0,9999,0
1653638386870,ECE 200,051,091053,Wang; Xiaolong,9999,0,9999,0
1653638386870,ECE 200,052,091054,Xie; Pengtao,9999,0,9999,0
1653638386870,ECE 200,053,091055,Yip; Michael,9999,0,9999,0
1653638386870,ECE 200,054,091056,Zeger; Kenneth A.,9999,0,9999,0
1653638386870,ECE 200,055,091057,Zhang; Xinyu,9999,0,9999,0
1653638386870,ECE 200,056,091058,Turakhia; Yatish Girish,9999,0,9999,0
1653638386870,ECE 200,057,091059,Kang; Mingu,9999,0,9999,0
1653638386870,ECE 200,058,091060,Shi; Yuanyuan,9999,0,9999,0
1653638386870,ECE 200,059,091061,Wang; Edward Jay,9999,0,9999,0
1653638386870,ECE 200,060,091062,Zheng; Yang,9999,0,9999,0
1653638387401,ECE 201,A00,095526,Lo; Yu-Hwa,0,0,0,0
1653638387926,ECE 203,A00,091065,Mercier; Patrick Philip,0,0,0,0
1653638388451,ECE 207A,A00,091605,Liu; Thomas Tao-Ming,0,0,0,0
1653638388983,ECE 212AN,A00,091068,Nomura; Kenji,0,0,0,0
1653638389507,ECE 222A,A00,091069,Rebeiz; Gabriel,0,0,0,0
1653638390035,ECE 225A,A00,091070,Orlitsky; Alon,0,0,0,0
1653638390559,ECE 230A,A00,091071,Nomura; Kenji,0,0,0,0
1653638391093,ECE 236A,A00,091072,Dayeh; Shadi Ahmad,0,0,0,0
1653638391616,ECE 238A,A00,091073,Luo; Jian,0,0,0,0
1653638391616,ECE 238A,B00,091074,Luo; Jian,0,0,0,0
1653638392153,ECE 240A,A00,091075,Radic; Stojan,0,0,0,0
1653638392677,ECE 247A,A00,091592,Shi; Lingyan,0,0,0,0
1653638393206,ECE 250,A00,091076,Touri; Behrouz,0,0,0,0
1653638393732,ECE 251C,A00,091078,Nguyen; Truong Quang,0,0,0,0
1653638394256,ECE 253,A00,091079,Cosman; Pamela C.,0,0,0,0
1653638394784,ECE 255A,A00,091080,Orlitsky; Alon,0,0,0,0
1653638395308,ECE 257A,A00,091081,Zhang; Xinyu,0,0,0,0
1653638395836,ECE 260A,A01,091084,Eldon; John,0,0,0,0
1653638396362,ECE 264C,A00,091085,Galton; Ian A,0,0,0,0
1653638396893,ECE 265C,A00,094889,Presti; Calogero Davide,0,0,0,9
1653638397417,ECE 266,A01,091087,Hall; Drew A.,0,0,0,0
1653638398474,ECE 271A,A00,091090,Vasconcelos; Nuno,0,0,0,0
1653638398999,ECE 272B,A00,091091,Sworder; David D.,0,0,0,0
1653638399522,ECE 275A,A00,091092,Meyer; Florian,0,0,0,0
1653638400046,ECE 277,A00,091093,An; Cheolhong,0,0,0,0
1653638400576,ECE 283,A00,091094,Le; Hanh-Phuc,0,0,0,0
1653638401102,ECE 284,A00,091095,Kang; Mingu,0,0,0,0
1653638401102,ECE 284,B00,091096,Wang; Edward Jay,0,0,0,0
1653638401631,ECE 285,A00,094334,Touri; Behrouz,0,0,0,0
1653638402155,ECE 289,A00,091097,Whelan; David Arthur,0,0,0,0
1653638402687,MATH 200A,A00,087414,Salehi Golsefidy; Alireza,7,0,8,1
1653638403211,MATH 202A,A00,087415,Gill; Philip E.,2,0,8,6
1653638403737,MATH 203A,A00,087416,Oprea; Dragos N.,6,0,8,2
1653638404260,MATH 204A,A00,087417,Kedlaya; Kiran S.,6,0,8,2
1653638404783,MATH 205,A00,087418,Sorensen; Claus M,6,0,8,2
1653638405314,MATH 206A,A00,087419,Izadi; Elham,6,0,8,2
1653638405839,MATH 207A,A00,087420,Mohammadi; Amir,5,0,8,3
1653638406363,MATH 208,A00,087421,Staff,8,0,10,2
1653638406889,MATH 209,A00,087422,Staff,10,0,10,0
1653638407411,MATH 218,A00,087423,Staff,10,0,10,0
1653638407939,MATH 220A,A00,087424,Novak; Jonathan I,6,0,8,2
1653638408469,MATH 231A,A00,087425,Bejenaru; Ioan,3,0,8,5
1653638408993,MATH 240A,A00,087426,Ebenfelt; Peter F,5,0,8,3
1653638409515,MATH 243,A00,087427,Staff,9,0,10,1
1653638410043,MATH 248,A00,087429,Staff,10,0,10,0
1653638410565,MATH 250A,A00,087430,Spolaor; Luca,4,0,8,4
1653638411089,MATH 257A,A00,087431,Spolaor; Luca,7,0,8,1
1653638411611,MATH 258,A00,087432,Staff,9,0,10,1
1653638412134,MATH 264A,A00,087433,Warnke; Lutz Peter,5,0,8,3
1653638412657,MATH 268,A00,087434,Staff,15,0,15,0
1653638413179,MATH 269,A00,087435,Staff,14,0,15,1
1653638413710,MATH 270A,A00,087436,Nie; Jiawang,0,0,8,8
1653638414234,MATH 272A,A00,087437,Tian; Xiaochuan,0,0,8,8
1653638414765,MATH 274,A01,087439,Cheng; Li-Tien,9,0,10,1
1653638414765,MATH 274,A02,087440,Cheng; Li-Tien,10,0,10,0
1653638415289,MATH 278A,A00,087441,Staff,8,0,10,2
1653638415816,MATH 278B,A00,087442,Staff,8,0,10,2
1653638416341,MATH 278C,A00,087443,Staff,8,0,10,2
1653638416873,MATH 280A,A00,087444,Zheng; Tianyi,0,0,8,8
1653638417397,MATH 281A,A00,087445,Bradic; Jelena,0,0,8,9
1653638417926,MATH 282A,A00,087446,Zhang; Danna,0,0,8,8
1653638418448,MATH 283,A00,087447,Tesler; Glenn,0,0,0,16
1653638418972,MATH 286,B00,095535,Kemp; Todd Aahron,5,0,8,3
1653638419496,MATH 287D,B00,095536,Bradic; Jelena,5,0,8,3
1653638420020,MATH 288,A00,087450,Staff,14,0,15,1
1653638420020,MATH 288,B00,087451,Staff,15,0,15,0
1653638420020,MATH 288,C00,087452,Staff,15,0,15,0
1653638420549,MATH 290A,A00,087453,Xu; Zhouli,6,0,8,2
1653638421084,MATH 291A,A00,087454,Xu; Zhouli,7,0,8,1
1653638421617,MATH 292,A00,087455,Staff,10,0,10,0
1653638422140,MATH 295,A00,087456,Staff,50,0,50,0
1653638422666,MATH 297,001,087457,Staff,997,0,999,2
1653638983247,COGS 200,A01,087991,Staff,47,0,50,3
1653638983775,COGS 201,A01,094504,Rangel; Lara M,16,0,25,9
1653638984303,COGS 203,A00,087992,Coulson; Seana M,18,0,20,2
1653638984841,COGS 210A,001,087993,Greene; Deanna Jacquelyn,9998,0,9999,1
1653638984841,COGS 210A,002,087994,Saygin; Ayse P,9999,0,9999,0
1653638984841,COGS 210A,003,087995,Xia; Haijun,9999,0,9999,0
1653638984841,COGS 210A,004,087996,Nitz; Douglas A.,9999,0,9999,0
1653638984841,COGS 210A,005,087997,Hollan; James D.,9999,0,9999,0
1653638984841,COGS 210A,006,087998,Deak; Gedeon O.,9998,0,9999,1
1653638984841,COGS 210A,007,087999,Rossano; Federico,9999,0,9999,0
1653638985364,COGS 211A,A00,088000,Coulson; Seana M,9997,0,9999,2
1653638985888,COGS 229,A00,088002,Staff,22,0,25,3
1653638986426,COGS 260,B00,094231,Staff,17,0,20,3
1653638986426,COGS 260,A00,088004,Nitz; Douglas A.,9998,0,9999,1
1653638986952,CSE 202,A00,090110,Paturi; Ramamohan,0,0,0,0
1653638986952,CSE 202,B00,090111,Paturi; Ramamohan,0,0,0,0
1653638987479,CSE 207B,A00,090112,Heninger; Nadia A,0,0,0,0
1653638988003,CSE 208,A00,094858,Micciancio; Daniele,0,0,0,0
1653638988532,CSE 210,A00,090113,Powell; Thomas Allan,0,0,0,0
1653638989056,CSE 219,A00,090898,Staff,0,0,0,0
1653638989581,CSE 221,A00,090114,Zhou; Yuan-Yuan,0,0,0,0
1653638990109,CSE 229A,A00,090115,Porter; George M,0,0,0,0
1653638990632,CSE 229C,A00,090116,Savage; Stefan,0,0,0,0
1653638991160,CSE 230,A00,090117,Jhala; Ranjit,0,0,0,0
1653638991684,CSE 232,A00,090118,Papakonstantinou; Yannis,0,0,0,0
1653638992209,CSE 239A,A00,090121,Kumar; Arun Kumar,0,0,0,0
1653638992733,CSE 239B,A00,090122,Jhala; Ranjit,0,0,0,0
1653638993269,CSE 240A,A00,090123,Zhao; Jishen,0,0,189,189
1653638993796,CSE 243A,A00,090124,Orailoglu; Alex,0,0,15,15
1653638994320,CSE 249B,A00,090125,Kahng; Andrew Byun,12,0,20,8
1653638994844,CSE 250A,A00,090126,Berg-Kirkpatrick; Taylor D,0,0,0,0
1653638995378,CSE 252A,A00,090127,Ochoa; Benjamin Lawrence,0,0,0,0
1653638995903,CSE 258,A01,090129,McAuley; Julian John,0,0,0,0
1653638996426,CSE 258R,A01,090131,McAuley; Julian John,0,0,0,0
1653638996958,CSE 274,A00,090132,Ramamoorthi; Ravi,0,0,0,0
1653638997482,CSE 276A,A00,090133,Christensen; Henrik I,0,0,0,0
1653638998030,CSE 276C,A00,090134,Christensen; Henrik I,0,0,0,0
1653638998554,CSE 290,A00,090135,Bafna; Vineet,0,0,0,0
1653638998554,CSE 290,B00,090136,Ramamoorthi; Ravi,0,0,0,0
1653638998554,CSE 290,C00,090137,Li; Tzumao,7,0,10,3
1653638998554,CSE 290,D00,090138,Zhou; Yuan-Yuan,9,0,10,1
1653638998554,CSE 290,E00,090139,Christensen; Henrik I,8,0,10,2
1653638998554,CSE 290,F00,094053,Shalev; Aaron D,0,0,0,0
1653638999096,CSE 291,A00,090140,Munyaka; Imani N. S.,0,0,0,0
1653638999096,CSE 291,B00,094880,Yu; Qi,0,0,0,0
1653638999096,CSE 291,C00,090142,Pannuto; Patrick William,0,0,0,0
1653638999096,CSE 291,D00,094881,Zhang; Yiying,0,0,0,0
1653638999096,CSE 291,E00,095118,Su; Hao,0,0,0,0
1653638999648,CSE 293,001,094905,Bafna; Vineet,9999,0,9999,0
1653638999648,CSE 293,002,094906,Bellare; Mihir,9999,0,9999,0
1653638999648,CSE 293,003,094907,Berg-Kirkpatrick; Taylor D,9999,0,9999,0
1653638999648,CSE 293,004,094908,Christensen; Henrik I,9999,0,9999,0
1653638999648,CSE 293,005,094909,Cottrell; Garrison W,9999,0,9999,0
1653638999648,CSE 293,006,094910,Deutsch; Alin Bernard,9999,0,9999,0
1653638999648,CSE 293,007,094911,Esmaeilzadeh; Hadi,9999,0,9999,0
1653638999648,CSE 293,008,094912,Freund; Yoav,9999,0,9999,0
1653638999648,CSE 293,009,094913,Griswold; William G.,9999,0,9999,0
1653638999648,CSE 293,010,094914,Gymrek; Melissa Ann,9999,0,9999,0
1653638999648,CSE 293,011,094915,Heninger; Nadia A,9999,0,9999,0
1653638999648,CSE 293,012,094916,Impagliazzo; Russell,9999,0,9999,0
1653638999648,CSE 293,013,094917,Jhala; Ranjit,9999,0,9999,0
1653638999648,CSE 293,014,094918,Kahng; Andrew Byun,9999,0,9999,0
1653638999648,CSE 293,015,094919,Kane; Daniel Mertz,9999,0,9999,0
1653638999648,CSE 293,016,094920,Kriegman; David J,9999,0,9999,0
1653638999648,CSE 293,017,094921,Kumar; Arun Kumar,9999,0,9999,0
1653638999648,CSE 293,018,094922,Lerner; Sorin,9999,0,9999,0
1653638999648,CSE 293,019,094923,Lovett; Shachar,9999,0,9999,0
1653638999648,CSE 293,020,094924,McAuley; Julian John,9999,0,9999,0
1653638999648,CSE 293,021,094925,Micciancio; Daniele,9999,0,9999,0
1653638999648,CSE 293,022,094926,Orailoglu; Alex,9999,0,9999,0
1653638999648,CSE 293,023,094927,Paturi; Ramamohan,9999,0,9999,0
1653638999648,CSE 293,024,094928,Polikarpova; Nadezhda,9999,0,9999,0
1653638999648,CSE 293,025,094929,Politz; Joseph Gibbs,9999,0,9999,0
1653638999648,CSE 293,026,094930,Porter; George M,9999,0,9999,0
1653638999648,CSE 293,027,094931,Porter; Leonard Emerson,9999,0,9999,0
1653638999648,CSE 293,028,094932,Ramamoorthi; Ravi,9999,0,9999,0
1653638999648,CSE 293,029,094933,Sahoo; Debashis,9999,0,9999,0
1653638999648,CSE 293,030,094934,Saul; Lawrence,9999,0,9999,0
1653638999648,CSE 293,031,094935,Savage; Stefan,9999,0,9999,0
1653638999648,CSE 293,032,094936,Schulze; Jurgen P.,9999,0,9999,0
1653638999648,CSE 293,033,094937,Snoeren; Alex C.,9999,0,9999,0
1653638999648,CSE 293,034,094938,Shang; Jingbo,9999,0,9999,0
1653638999648,CSE 293,035,094939,Stefan; Deian,9999,0,9999,0
1653638999648,CSE 293,036,094940,Su; Hao,9999,0,9999,0
1653638999648,CSE 293,037,094941,Swanson; Steven James,9999,0,9999,0
1653638999648,CSE 293,038,094942,Tullsen; Dean Michael,9999,0,9999,0
1653638999648,CSE 293,039,094943,Voelker; Geoffrey M.,9999,0,9999,0
1653638999648,CSE 293,040,094944,Zhao; Jishen,9999,0,9999,0
1653638999648,CSE 293,041,094945,Zhou; Yuan-Yuan,9999,0,9999,0
1653638999648,CSE 293,042,094946,Gao; Sicun,9998,0,9999,1
1653638999648,CSE 293,043,094947,Weibel; Nadir,9999,0,9999,0
1653638999648,CSE 293,044,094948,Gupta; Rajesh K.,9999,0,9999,0
1653639000172,CSE 294,A00,090143,Porter; George M,9,0,10,1
1653639000699,DSE 200,A00,091799,Staff,50,0,50,0
1653639001225,DSE 203,A00,091800,Gupta; Amarnath,30,0,30,0
1653639001749,DSE 250,A00,091801,Deutsch; Alin Bernard,30,0,30,0
1653639002273,DSE 290,A00,091802,Altintas De Callaf; Ilkay,50,0,50,0
1653639002924,ECE 200,001,091003,Antipa; Nicholas A,9999,0,9999,0
1653639002924,ECE 200,002,091004,Atanasov; Nikolay A.,9999,0,9999,0
1653639002924,ECE 200,003,091005,Bharadia; Dinesh,9999,0,9999,0
1653639002924,ECE 200,004,091006,Cheng; Chung Kuan,9999,0,9999,0
1653639002924,ECE 200,005,091007,Cosman; Pamela C.,9999,0,9999,0
1653639002924,ECE 200,006,091008,Staff,9999,0,9999,0
1653639002924,ECE 200,007,091009,Dayeh; Shadi Ahmad,9999,0,9999,0
1653639002924,ECE 200,008,091010,Fainman; Yeshaiahu,9999,0,9999,0
1653639002924,ECE 200,009,091011,Ford; Joseph Earl,9999,0,9999,0
1653639002924,ECE 200,010,091012,Franceschetti; Massimo,9999,0,9999,0
1653639002924,ECE 200,011,091013,Fullerton; Eric E,9999,0,9999,0
1653639002924,ECE 200,012,091014,Galton; Ian A,9999,0,9999,0
1653639002924,ECE 200,013,091015,Gilja; Vikash,9999,0,9999,0
1653639002924,ECE 200,014,091016,Hall; Drew A.,9999,0,9999,0
1653639002924,ECE 200,015,091017,Hsueh; Tzu-Chien,9999,0,9999,0
1653639002924,ECE 200,016,091018,Javidi; Tara,9999,0,9999,0
1653639002924,ECE 200,017,091019,Kahng; Andrew Byun,9999,0,9999,0
1653639002924,ECE 200,018,091020,Kim; Young-Han,9999,0,9999,0
1653639002924,ECE 200,019,091021,Koushanfar; Farinaz,9999,0,9999,0
1653639002924,ECE 200,020,091022,Kuzum; Duygu,9999,0,9999,0
1653639002924,ECE 200,021,091023,Le; Hanh-Phuc,9999,0,9999,0
1653639002924,ECE 200,022,091024,Lin; Bill,9999,0,9999,0
1653639002924,ECE 200,023,091025,Liu; Zhaowei,9999,0,9999,0
1653639002924,ECE 200,024,091026,Lo; Yu-Hwa,9999,0,9999,0
1653639002924,ECE 200,025,091027,Lomakin; Vitaliy,9999,0,9999,0
1653639002924,ECE 200,026,091028,Mercier; Patrick Philip,9999,0,9999,0
1653639002924,ECE 200,027,091029,Meyer; Florian,9999,0,9999,0
1653639002924,ECE 200,028,091030,Milstein; Laurence B.,9999,0,9999,0
1653639002924,ECE 200,029,091031,Mir Arabbaygi; Siavash,9999,0,9999,0
1653639002924,ECE 200,030,091032,Mookherjea; Shayan,9999,0,9999,0
1653639002924,ECE 200,031,091033,Morris; Karcher William,9999,0,9999,0
1653639002924,ECE 200,032,091034,Ng; Tse Nga,9999,0,9999,0
1653639002924,ECE 200,033,091035,Nguyen; Truong Quang,9999,0,9999,0
1653639002924,ECE 200,034,091036,Nomura; Kenji,9999,0,9999,0
1653639002924,ECE 200,035,091037,Orlitsky; Alon,9999,0,9999,0
1653639002924,ECE 200,036,091038,Pal; Piya,9999,0,9999,0
1653639002924,ECE 200,037,091039,Papen; George C.,9999,0,9999,0
1653639002924,ECE 200,038,091040,Radic; Stojan,9999,0,9999,0
1653639002924,ECE 200,039,091041,Rao; Bhaskar D.,9999,0,9999,0
1653639002924,ECE 200,040,091042,Rao; Ramesh R,9999,0,9999,0
1653639002924,ECE 200,041,091043,Rebeiz; Gabriel,9999,0,9999,0
1653639002924,ECE 200,042,091044,Sanford; John R,9999,0,9999,0
1653639002924,ECE 200,043,091045,Siegel; Paul H.,9999,0,9999,0
1653639002924,ECE 200,044,091046,Sievenpiper; Daniel F.,9999,0,9999,0
1653639002924,ECE 200,045,091047,Sworder; David D.,9999,0,9999,0
1653639002924,ECE 200,046,091048,Taur; Yuan,9999,0,9999,0
1653639002924,ECE 200,047,091049,Touri; Behrouz,9999,0,9999,0
1653639002924,ECE 200,048,091050,Trivedi; Mohan M.,9999,0,9999,0
1653639002924,ECE 200,049,091051,Vardy; Alexander,9999,0,9999,0
1653639002924,ECE 200,050,091052,Vasconcelos; Nuno,9999,0,9999,0
1653639002924,ECE 200,051,091053,Wang; Xiaolong,9999,0,9999,0
1653639002924,ECE 200,052,091054,Xie; Pengtao,9999,0,9999,0
1653639002924,ECE 200,053,091055,Yip; Michael,9999,0,9999,0
1653639002924,ECE 200,054,091056,Zeger; Kenneth A.,9999,0,9999,0
1653639002924,ECE 200,055,091057,Zhang; Xinyu,9999,0,9999,0
1653639002924,ECE 200,056,091058,Turakhia; Yatish Girish,9999,0,9999,0
1653639002924,ECE 200,057,091059,Kang; Mingu,9999,0,9999,0
1653639002924,ECE 200,058,091060,Shi; Yuanyuan,9999,0,9999,0
1653639002924,ECE 200,059,091061,Wang; Edward Jay,9999,0,9999,0
1653639002924,ECE 200,060,091062,Zheng; Yang,9999,0,9999,0
1653639003460,ECE 201,A00,095526,Lo; Yu-Hwa,0,0,0,0
1653639003984,ECE 203,A00,091065,Mercier; Patrick Philip,0,0,0,0
1653639004513,ECE 207A,A00,091605,Liu; Thomas Tao-Ming,0,0,0,0
1653639005036,ECE 212AN,A00,091068,Nomura; Kenji,0,0,0,0
1653639005564,ECE 222A,A00,091069,Rebeiz; Gabriel,0,0,0,0
1653639006088,ECE 225A,A00,091070,Orlitsky; Alon,0,0,0,0
1653639006619,ECE 230A,A00,091071,Nomura; Kenji,0,0,0,0
1653639007143,ECE 236A,A00,091072,Dayeh; Shadi Ahmad,0,0,0,0
1653639007667,ECE 238A,A00,091073,Luo; Jian,0,0,0,0
1653639007667,ECE 238A,B00,091074,Luo; Jian,0,0,0,0
1653639008192,ECE 240A,A00,091075,Radic; Stojan,0,0,0,0
1653639008718,ECE 247A,A00,091592,Shi; Lingyan,0,0,0,0
1653639009243,ECE 250,A00,091076,Touri; Behrouz,0,0,0,0
1653639009766,ECE 251C,A00,091078,Nguyen; Truong Quang,0,0,0,0
1653639010289,ECE 253,A00,091079,Cosman; Pamela C.,0,0,0,0
1653639010812,ECE 255A,A00,091080,Orlitsky; Alon,0,0,0,0
1653639011439,ECE 257A,A00,091081,Zhang; Xinyu,0,0,0,0
1653639011963,ECE 260A,A01,091084,Eldon; John,0,0,0,0
1653639012490,ECE 264C,A00,091085,Galton; Ian A,0,0,0,0
1653639013025,ECE 265C,A00,094889,Presti; Calogero Davide,0,0,0,9
1653639013555,ECE 266,A01,091087,Hall; Drew A.,0,0,0,0
1653639014608,ECE 271A,A00,091090,Vasconcelos; Nuno,0,0,0,0
1653639015134,ECE 272B,A00,091091,Sworder; David D.,0,0,0,0
1653639015658,ECE 275A,A00,091092,Meyer; Florian,0,0,0,0
1653639016181,ECE 277,A00,091093,An; Cheolhong,0,0,0,0
1653639016711,ECE 283,A00,091094,Le; Hanh-Phuc,0,0,0,0
1653639017234,ECE 284,A00,091095,Kang; Mingu,0,0,0,0
1653639017234,ECE 284,B00,091096,Wang; Edward Jay,0,0,0,0
1653639017757,ECE 285,A00,094334,Touri; Behrouz,0,0,0,0
1653639018281,ECE 289,A00,091097,Whelan; David Arthur,0,0,0,0
1653639018805,MATH 200A,A00,087414,Salehi Golsefidy; Alireza,7,0,8,1
1653639019329,MATH 202A,A00,087415,Gill; Philip E.,2,0,8,6
1653639019860,MATH 203A,A00,087416,Oprea; Dragos N.,6,0,8,2
1653639020386,MATH 204A,A00,087417,Kedlaya; Kiran S.,6,0,8,2
1653639020913,MATH 205,A00,087418,Sorensen; Claus M,6,0,8,2
1653639021442,MATH 206A,A00,087419,Izadi; Elham,6,0,8,2
1653639021967,MATH 207A,A00,087420,Mohammadi; Amir,5,0,8,3
1653639022498,MATH 208,A00,087421,Staff,8,0,10,2
1653639023027,MATH 209,A00,087422,Staff,10,0,10,0
1653639023552,MATH 218,A00,087423,Staff,10,0,10,0
1653639024080,MATH 220A,A00,087424,Novak; Jonathan I,6,0,8,2
1653639024610,MATH 231A,A00,087425,Bejenaru; Ioan,3,0,8,5
1653639025139,MATH 240A,A00,087426,Ebenfelt; Peter F,5,0,8,3
1653639025673,MATH 243,A00,087427,Staff,9,0,10,1
1653639026197,MATH 248,A00,087429,Staff,10,0,10,0
1653639026721,MATH 250A,A00,087430,Spolaor; Luca,4,0,8,4
1653639027248,MATH 257A,A00,087431,Spolaor; Luca,7,0,8,1
1653639027772,MATH 258,A00,087432,Staff,9,0,10,1
1653639028299,MATH 264A,A00,087433,Warnke; Lutz Peter,5,0,8,3
1653639028822,MATH 268,A00,087434,Staff,15,0,15,0
1653639029346,MATH 269,A00,087435,Staff,14,0,15,1
1653639029874,MATH 270A,A00,087436,Nie; Jiawang,0,0,8,8
1653639030403,MATH 272A,A00,087437,Tian; Xiaochuan,0,0,8,8
1653639030932,MATH 274,A01,087439,Cheng; Li-Tien,9,0,10,1
1653639030932,MATH 274,A02,087440,Cheng; Li-Tien,10,0,10,0
1653639031457,MATH 278A,A00,087441,Staff,8,0,10,2
1653639031981,MATH 278B,A00,087442,Staff,8,0,10,2
1653639032509,MATH 278C,A00,087443,Staff,8,0,10,2
1653639033032,MATH 280A,A00,087444,Zheng; Tianyi,0,0,8,8
1653639033558,MATH 281A,A00,087445,Bradic; Jelena,0,0,8,9
1653639034089,MATH 282A,A00,087446,Zhang; Danna,0,0,8,8
1653639034613,MATH 283,A00,087447,Tesler; Glenn,0,0,0,16
1653639035136,MATH 286,B00,095535,Kemp; Todd Aahron,5,0,8,3
1653639035663,MATH 287D,B00,095536,Bradic; Jelena,5,0,8,3
1653639036189,MATH 288,A00,087450,Staff,14,0,15,1
1653639036189,MATH 288,B00,087451,Staff,15,0,15,0
1653639036189,MATH 288,C00,087452,Staff,15,0,15,0
1653639036714,MATH 290A,A00,087453,Xu; Zhouli,6,0,8,2
1653639037237,MATH 291A,A00,087454,Xu; Zhouli,7,0,8,1
1653639037766,MATH 292,A00,087455,Staff,10,0,10,0
1653639038290,MATH 295,A00,087456,Staff,50,0,50,0
1653639038814,MATH 297,001,087457,Staff,997,0,999,2
1653639599767,COGS 200,A01,087991,Staff,47,0,50,3
1653639600292,COGS 201,A01,094504,Rangel; Lara M,16,0,25,9
1653639600816,COGS 203,A00,087992,Coulson; Seana M,18,0,20,2
1653639601342,COGS 210A,001,087993,Greene; Deanna Jacquelyn,9998,0,9999,1
1653639601342,COGS 210A,002,087994,Saygin; Ayse P,9999,0,9999,0
1653639601342,COGS 210A,003,087995,Xia; Haijun,9999,0,9999,0
1653639601342,COGS 210A,004,087996,Nitz; Douglas A.,9999,0,9999,0
1653639601342,COGS 210A,005,087997,Hollan; James D.,9999,0,9999,0
1653639601342,COGS 210A,006,087998,Deak; Gedeon O.,9998,0,9999,1
1653639601342,COGS 210A,007,087999,Rossano; Federico,9999,0,9999,0
1653639601868,COGS 211A,A00,088000,Coulson; Seana M,9997,0,9999,2
1653639602402,COGS 229,A00,088002,Staff,22,0,25,3
1653639602925,COGS 260,B00,094231,Staff,17,0,20,3
1653639602925,COGS 260,A00,088004,Nitz; Douglas A.,9998,0,9999,1
1653639603449,CSE 202,A00,090110,Paturi; Ramamohan,0,0,0,0
1653639603449,CSE 202,B00,090111,Paturi; Ramamohan,0,0,0,0
1653639603972,CSE 207B,A00,090112,Heninger; Nadia A,0,0,0,0
1653639604501,CSE 208,A00,094858,Micciancio; Daniele,0,0,0,0
1653639605027,CSE 210,A00,090113,Powell; Thomas Allan,0,0,0,0
1653639605566,CSE 219,A00,090898,Staff,0,0,0,0
1653639606095,CSE 221,A00,090114,Zhou; Yuan-Yuan,0,0,0,0
1653639606626,CSE 229A,A00,090115,Porter; George M,0,0,0,0
1653639607150,CSE 229C,A00,090116,Savage; Stefan,0,0,0,0
1653639607677,CSE 230,A00,090117,Jhala; Ranjit,0,0,0,0
1653639608201,CSE 232,A00,090118,Papakonstantinou; Yannis,0,0,0,0
1653639608722,CSE 239A,A00,090121,Kumar; Arun Kumar,0,0,0,0
1653639609246,CSE 239B,A00,090122,Jhala; Ranjit,0,0,0,0
1653639609769,CSE 240A,A00,090123,Zhao; Jishen,0,0,189,189
1653639610297,CSE 243A,A00,090124,Orailoglu; Alex,0,0,15,15
1653639610823,CSE 249B,A00,090125,Kahng; Andrew Byun,12,0,20,8
1653639611347,CSE 250A,A00,090126,Berg-Kirkpatrick; Taylor D,0,0,0,0
1653639611870,CSE 252A,A00,090127,Ochoa; Benjamin Lawrence,0,0,0,0
1653639612404,CSE 258,A01,090129,McAuley; Julian John,0,0,0,0
1653639612930,CSE 258R,A01,090131,McAuley; Julian John,0,0,0,0
1653639613455,CSE 274,A00,090132,Ramamoorthi; Ravi,0,0,0,0
1653639613980,CSE 276A,A00,090133,Christensen; Henrik I,0,0,0,0
1653639614515,CSE 276C,A00,090134,Christensen; Henrik I,0,0,0,0
1653639615039,CSE 290,A00,090135,Bafna; Vineet,0,0,0,0
1653639615039,CSE 290,B00,090136,Ramamoorthi; Ravi,0,0,0,0
1653639615039,CSE 290,C00,090137,Li; Tzumao,7,0,10,3
1653639615039,CSE 290,D00,090138,Zhou; Yuan-Yuan,9,0,10,1
1653639615039,CSE 290,E00,090139,Christensen; Henrik I,8,0,10,2
1653639615039,CSE 290,F00,094053,Shalev; Aaron D,0,0,0,0
1653639615571,CSE 291,A00,090140,Munyaka; Imani N. S.,0,0,0,0
1653639615571,CSE 291,B00,094880,Yu; Qi,0,0,0,0
1653639615571,CSE 291,C00,090142,Pannuto; Patrick William,0,0,0,0
1653639615571,CSE 291,D00,094881,Zhang; Yiying,0,0,0,0
1653639615571,CSE 291,E00,095118,Su; Hao,0,0,0,0
1653639616116,CSE 293,001,094905,Bafna; Vineet,9999,0,9999,0
1653639616116,CSE 293,002,094906,Bellare; Mihir,9999,0,9999,0
1653639616116,CSE 293,003,094907,Berg-Kirkpatrick; Taylor D,9999,0,9999,0
1653639616116,CSE 293,004,094908,Christensen; Henrik I,9999,0,9999,0
1653639616116,CSE 293,005,094909,Cottrell; Garrison W,9999,0,9999,0
1653639616116,CSE 293,006,094910,Deutsch; Alin Bernard,9999,0,9999,0
1653639616116,CSE 293,007,094911,Esmaeilzadeh; Hadi,9999,0,9999,0
1653639616116,CSE 293,008,094912,Freund; Yoav,9999,0,9999,0
1653639616116,CSE 293,009,094913,Griswold; William G.,9999,0,9999,0
1653639616116,CSE 293,010,094914,Gymrek; Melissa Ann,9999,0,9999,0
1653639616116,CSE 293,011,094915,Heninger; Nadia A,9999,0,9999,0
1653639616116,CSE 293,012,094916,Impagliazzo; Russell,9999,0,9999,0
1653639616116,CSE 293,013,094917,Jhala; Ranjit,9999,0,9999,0
1653639616116,CSE 293,014,094918,Kahng; Andrew Byun,9999,0,9999,0
1653639616116,CSE 293,015,094919,Kane; Daniel Mertz,9999,0,9999,0
1653639616116,CSE 293,016,094920,Kriegman; David J,9999,0,9999,0
1653639616116,CSE 293,017,094921,Kumar; Arun Kumar,9999,0,9999,0
1653639616116,CSE 293,018,094922,Lerner; Sorin,9999,0,9999,0
1653639616116,CSE 293,019,094923,Lovett; Shachar,9999,0,9999,0
1653639616116,CSE 293,020,094924,McAuley; Julian John,9999,0,9999,0
1653639616116,CSE 293,021,094925,Micciancio; Daniele,9999,0,9999,0
1653639616116,CSE 293,022,094926,Orailoglu; Alex,9999,0,9999,0
1653639616116,CSE 293,023,094927,Paturi; Ramamohan,9999,0,9999,0
1653639616116,CSE 293,024,094928,Polikarpova; Nadezhda,9999,0,9999,0
1653639616116,CSE 293,025,094929,Politz; Joseph Gibbs,9999,0,9999,0
1653639616116,CSE 293,026,094930,Porter; George M,9999,0,9999,0
1653639616116,CSE 293,027,094931,Porter; Leonard Emerson,9999,0,9999,0
1653639616116,CSE 293,028,094932,Ramamoorthi; Ravi,9999,0,9999,0
1653639616116,CSE 293,029,094933,Sahoo; Debashis,9999,0,9999,0
1653639616116,CSE 293,030,094934,Saul; Lawrence,9999,0,9999,0
1653639616116,CSE 293,031,094935,Savage; Stefan,9999,0,9999,0
1653639616116,CSE 293,032,094936,Schulze; Jurgen P.,9999,0,9999,0
1653639616116,CSE 293,033,094937,Snoeren; Alex C.,9999,0,9999,0
1653639616116,CSE 293,034,094938,Shang; Jingbo,9999,0,9999,0
1653639616116,CSE 293,035,094939,Stefan; Deian,9999,0,9999,0
1653639616116,CSE 293,036,094940,Su; Hao,9999,0,9999,0
1653639616116,CSE 293,037,094941,Swanson; Steven James,9999,0,9999,0
1653639616116,CSE 293,038,094942,Tullsen; Dean Michael,9999,0,9999,0
1653639616116,CSE 293,039,094943,Voelker; Geoffrey M.,9999,0,9999,0
1653639616116,CSE 293,040,094944,Zhao; Jishen,9999,0,9999,0
1653639616116,CSE 293,041,094945,Zhou; Yuan-Yuan,9999,0,9999,0
1653639616116,CSE 293,042,094946,Gao; Sicun,9998,0,9999,1
1653639616116,CSE 293,043,094947,Weibel; Nadir,9999,0,9999,0
1653639616116,CSE 293,044,094948,Gupta; Rajesh K.,9999,0,9999,0
1653639616640,CSE 294,A00,090143,Porter; George M,9,0,10,1
1653639617165,DSE 200,A00,091799,Staff,50,0,50,0
1653639617689,DSE 203,A00,091800,Gupta; Amarnath,30,0,30,0
1653639618215,DSE 250,A00,091801,Deutsch; Alin Bernard,30,0,30,0
1653639618742,DSE 290,A00,091802,Altintas De Callaf; Ilkay,50,0,50,0
1653639619317,ECE 200,001,091003,Antipa; Nicholas A,9999,0,9999,0
1653639619317,ECE 200,002,091004,Atanasov; Nikolay A.,9999,0,9999,0
1653639619317,ECE 200,003,091005,Bharadia; Dinesh,9999,0,9999,0
1653639619317,ECE 200,004,091006,Cheng; Chung Kuan,9999,0,9999,0
1653639619317,ECE 200,005,091007,Cosman; Pamela C.,9999,0,9999,0
1653639619317,ECE 200,006,091008,Staff,9999,0,9999,0
1653639619317,ECE 200,007,091009,Dayeh; Shadi Ahmad,9999,0,9999,0
1653639619317,ECE 200,008,091010,Fainman; Yeshaiahu,9999,0,9999,0
1653639619317,ECE 200,009,091011,Ford; Joseph Earl,9999,0,9999,0
1653639619317,ECE 200,010,091012,Franceschetti; Massimo,9999,0,9999,0
1653639619317,ECE 200,011,091013,Fullerton; Eric E,9999,0,9999,0
1653639619317,ECE 200,012,091014,Galton; Ian A,9999,0,9999,0
1653639619317,ECE 200,013,091015,Gilja; Vikash,9999,0,9999,0
1653639619317,ECE 200,014,091016,Hall; Drew A.,9999,0,9999,0
1653639619317,ECE 200,015,091017,Hsueh; Tzu-Chien,9999,0,9999,0
1653639619317,ECE 200,016,091018,Javidi; Tara,9999,0,9999,0
1653639619317,ECE 200,017,091019,Kahng; Andrew Byun,9999,0,9999,0
1653639619317,ECE 200,018,091020,Kim; Young-Han,9999,0,9999,0
1653639619317,ECE 200,019,091021,Koushanfar; Farinaz,9999,0,9999,0
1653639619317,ECE 200,020,091022,Kuzum; Duygu,9999,0,9999,0
1653639619317,ECE 200,021,091023,Le; Hanh-Phuc,9999,0,9999,0
1653639619317,ECE 200,022,091024,Lin; Bill,9999,0,9999,0
1653639619317,ECE 200,023,091025,Liu; Zhaowei,9999,0,9999,0
1653639619317,ECE 200,024,091026,Lo; Yu-Hwa,9999,0,9999,0
1653639619317,ECE 200,025,091027,Lomakin; Vitaliy,9999,0,9999,0
1653639619317,ECE 200,026,091028,Mercier; Patrick Philip,9999,0,9999,0
1653639619317,ECE 200,027,091029,Meyer; Florian,9999,0,9999,0
1653639619317,ECE 200,028,091030,Milstein; Laurence B.,9999,0,9999,0
1653639619317,ECE 200,029,091031,Mir Arabbaygi; Siavash,9999,0,9999,0
1653639619317,ECE 200,030,091032,Mookherjea; Shayan,9999,0,9999,0
1653639619317,ECE 200,031,091033,Morris; Karcher William,9999,0,9999,0
1653639619317,ECE 200,032,091034,Ng; Tse Nga,9999,0,9999,0
1653639619317,ECE 200,033,091035,Nguyen; Truong Quang,9999,0,9999,0
1653639619317,ECE 200,034,091036,Nomura; Kenji,9999,0,9999,0
1653639619317,ECE 200,035,091037,Orlitsky; Alon,9999,0,9999,0
1653639619317,ECE 200,036,091038,Pal; Piya,9999,0,9999,0
1653639619317,ECE 200,037,091039,Papen; George C.,9999,0,9999,0
1653639619317,ECE 200,038,091040,Radic; Stojan,9999,0,9999,0
1653639619317,ECE 200,039,091041,Rao; Bhaskar D.,9999,0,9999,0
1653639619317,ECE 200,040,091042,Rao; Ramesh R,9999,0,9999,0
1653639619317,ECE 200,041,091043,Rebeiz; Gabriel,9999,0,9999,0
1653639619317,ECE 200,042,091044,Sanford; John R,9999,0,9999,0
1653639619317,ECE 200,043,091045,Siegel; Paul H.,9999,0,9999,0
1653639619317,ECE 200,044,091046,Sievenpiper; Daniel F.,9999,0,9999,0
1653639619317,ECE 200,045,091047,Sworder; David D.,9999,0,9999,0
1653639619317,ECE 200,046,091048,Taur; Yuan,9999,0,9999,0
1653639619317,ECE 200,047,091049,Touri; Behrouz,9999,0,9999,0
1653639619317,ECE 200,048,091050,Trivedi; Mohan M.,9999,0,9999,0
1653639619317,ECE 200,049,091051,Vardy; Alexander,9999,0,9999,0
1653639619317,ECE 200,050,091052,Vasconcelos; Nuno,9999,0,9999,0
1653639619317,ECE 200,051,091053,Wang; Xiaolong,9999,0,9999,0
1653639619317,ECE 200,052,091054,Xie; Pengtao,9999,0,9999,0
1653639619317,ECE 200,053,091055,Yip; Michael,9999,0,9999,0
1653639619317,ECE 200,054,091056,Zeger; Kenneth A.,9999,0,9999,0
1653639619317,ECE 200,055,091057,Zhang; Xinyu,9999,0,9999,0
1653639619317,ECE 200,056,091058,Turakhia; Yatish Girish,9999,0,9999,0
1653639619317,ECE 200,057,091059,Kang; Mingu,9999,0,9999,0
1653639619317,ECE 200,058,091060,Shi; Yuanyuan,9999,0,9999,0
1653639619317,ECE 200,059,091061,Wang; Edward Jay,9999,0,9999,0
1653639619317,ECE 200,060,091062,Zheng; Yang,9999,0,9999,0
1653639619844,ECE 201,A00,095526,Lo; Yu-Hwa,0,0,0,0
1653639620368,ECE 203,A00,091065,Mercier; Patrick Philip,0,0,0,0
1653639620893,ECE 207A,A00,091605,Liu; Thomas Tao-Ming,0,0,0,0
1653639621419,ECE 212AN,A00,091068,Nomura; Kenji,0,0,0,0
1653639621943,ECE 222A,A00,091069,Rebeiz; Gabriel,0,0,0,0
1653639622466,ECE 225A,A00,091070,Orlitsky; Alon,0,0,0,0
1653639622992,ECE 230A,A00,091071,Nomura; Kenji,0,0,0,0
1653639623519,ECE 236A,A00,091072,Dayeh; Shadi Ahmad,0,0,0,0
1653639624047,ECE 238A,A00,091073,Luo; Jian,0,0,0,0
1653639624047,ECE 238A,B00,091074,Luo; Jian,0,0,0,0
1653639624572,ECE 240A,A00,091075,Radic; Stojan,0,0,0,0
1653639625098,ECE 247A,A00,091592,Shi; Lingyan,0,0,0,0
1653639625625,ECE 250,A00,091076,Touri; Behrouz,0,0,0,0
1653639626149,ECE 251C,A00,091078,Nguyen; Truong Quang,0,0,0,0
1653639626676,ECE 253,A00,091079,Cosman; Pamela C.,0,0,0,0
1653639627199,ECE 255A,A00,091080,Orlitsky; Alon,0,0,0,0
1653639627727,ECE 257A,A00,091081,Zhang; Xinyu,0,0,0,0
1653639628254,ECE 260A,A01,091084,Eldon; John,0,0,0,0
1653639628776,ECE 264C,A00,091085,Galton; Ian A,0,0,0,0
1653639629301,ECE 265C,A00,094889,Presti; Calogero Davide,0,0,0,9
1653639629825,ECE 266,A01,091087,Hall; Drew A.,0,0,0,0
1653639630876,ECE 271A,A00,091090,Vasconcelos; Nuno,0,0,0,0
1653639631400,ECE 272B,A00,091091,Sworder; David D.,0,0,0,0
1653639631923,ECE 275A,A00,091092,Meyer; Florian,0,0,0,0
1653639632449,ECE 277,A00,091093,An; Cheolhong,0,0,0,0
1653639632976,ECE 283,A00,091094,Le; Hanh-Phuc,0,0,0,0
1653639633500,ECE 284,A00,091095,Kang; Mingu,0,0,0,0
1653639633500,ECE 284,B00,091096,Wang; Edward Jay,0,0,0,0
1653639634023,ECE 285,A00,094334,Touri; Behrouz,0,0,0,0
1653639634548,ECE 289,A00,091097,Whelan; David Arthur,0,0,0,0
1653639635076,MATH 200A,A00,087414,Salehi Golsefidy; Alireza,7,0,8,1
1653639635603,MATH 202A,A00,087415,Gill; Philip E.,2,0,8,6
1653639636126,MATH 203A,A00,087416,Oprea; Dragos N.,6,0,8,2
1653639636649,MATH 204A,A00,087417,Kedlaya; Kiran S.,6,0,8,2
1653639637172,MATH 205,A00,087418,Sorensen; Claus M,6,0,8,2
1653639637699,MATH 206A,A00,087419,Izadi; Elham,6,0,8,2
1653639638222,MATH 207A,A00,087420,Mohammadi; Amir,5,0,8,3
1653639638745,MATH 208,A00,087421,Staff,8,0,10,2
1653639639266,MATH 209,A00,087422,Staff,10,0,10,0
1653639639790,MATH 218,A00,087423,Staff,10,0,10,0
1653639640314,MATH 220A,A00,087424,Novak; Jonathan I,6,0,8,2
1653639640843,MATH 231A,A00,087425,Bejenaru; Ioan,3,0,8,5
1653639641367,MATH 240A,A00,087426,Ebenfelt; Peter F,5,0,8,3
1653639641889,MATH 243,A00,087427,Staff,9,0,10,1
1653639642416,MATH 248,A00,087429,Staff,10,0,10,0
1653639642943,MATH 250A,A00,087430,Spolaor; Luca,4,0,8,4
1653639643467,MATH 257A,A00,087431,Spolaor; Luca,7,0,8,1
1653639643993,MATH 258,A00,087432,Staff,9,0,10,1
1653639644527,MATH 264A,A00,087433,Warnke; Lutz Peter,5,0,8,3
1653639645053,MATH 268,A00,087434,Staff,15,0,15,0
1653639645575,MATH 269,A00,087435,Staff,14,0,15,1
1653639646102,MATH 270A,A00,087436,Nie; Jiawang,0,0,8,8
1653639646630,MATH 272A,A00,087437,Tian; Xiaochuan,0,0,8,8
1653639647156,MATH 274,A01,087439,Cheng; Li-Tien,9,0,10,1
1653639647156,MATH 274,A02,087440,Cheng; Li-Tien,10,0,10,0
1653639647679,MATH 278A,A00,087441,Staff,8,0,10,2
1653639648206,MATH 278B,A00,087442,Staff,8,0,10,2
1653639648729,MATH 278C,A00,087443,Staff,8,0,10,2
1653639649254,MATH 280A,A00,087444,Zheng; Tianyi,0,0,8,8
1653639649779,MATH 281A,A00,087445,Bradic; Jelena,0,0,8,9
1653639650303,MATH 282A,A00,087446,Zhang; Danna,0,0,8,8
1653639650827,MATH 283,A00,087447,Tesler; Glenn,0,0,0,16
1653639651360,MATH 286,B00,095535,Kemp; Todd Aahron,5,0,8,3
1653639651883,MATH 287D,B00,095536,Bradic; Jelena,5,0,8,3
1653639652412,MATH 288,A00,087450,Staff,14,0,15,1
1653639652412,MATH 288,B00,087451,Staff,15,0,15,0
1653639652412,MATH 288,C00,087452,Staff,15,0,15,0
1653639653011,MATH 290A,A00,087453,Xu; Zhouli,6,0,8,2
1653639653540,MATH 291A,A00,087454,Xu; Zhouli,7,0,8,1
1653639654063,MATH 292,A00,087455,Staff,10,0,10,0
1653639654587,MATH 295,A00,087456,Staff,50,0,50,0
1653639655114,MATH 297,001,087457,Staff,997,0,999,2
1653640215863,COGS 200,A01,087991,Staff,47,0,50,3
1653640216388,COGS 201,A01,094504,Rangel; Lara M,16,0,25,9
1653640216915,COGS 203,A00,087992,Coulson; Seana M,18,0,20,2
1653640217441,COGS 210A,001,087993,Greene; Deanna Jacquelyn,9998,0,9999,1
1653640217441,COGS 210A,002,087994,Saygin; Ayse P,9999,0,9999,0
1653640217441,COGS 210A,003,087995,Xia; Haijun,9999,0,9999,0
1653640217441,COGS 210A,004,087996,Nitz; Douglas A.,9999,0,9999,0
1653640217441,COGS 210A,005,087997,Hollan; James D.,9999,0,9999,0
1653640217441,COGS 210A,006,087998,Deak; Gedeon O.,9998,0,9999,1
1653640217441,COGS 210A,007,087999,Rossano; Federico,9999,0,9999,0
1653640217966,COGS 211A,A00,088000,Coulson; Seana M,9997,0,9999,2
1653640218489,COGS 229,A00,088002,Staff,22,0,25,3
1653640219012,COGS 260,B00,094231,Staff,17,0,20,3
1653640219012,COGS 260,A00,088004,Nitz; Douglas A.,9998,0,9999,1
1653640219536,CSE 202,A00,090110,Paturi; Ramamohan,0,0,0,0
1653640219536,CSE 202,B00,090111,Paturi; Ramamohan,0,0,0,0
1653640220065,CSE 207B,A00,090112,Heninger; Nadia A,0,0,0,0
1653640220589,CSE 208,A00,094858,Micciancio; Daniele,0,0,0,0
1653640221116,CSE 210,A00,090113,Powell; Thomas Allan,0,0,0,0
1653640221641,CSE 219,A00,090898,Staff,0,0,0,0
1653640222167,CSE 221,A00,090114,Zhou; Yuan-Yuan,0,0,0,0
1653640222690,CSE 229A,A00,090115,Porter; George M,0,0,0,0
1653640223213,CSE 229C,A00,090116,Savage; Stefan,0,0,0,0
1653640223743,CSE 230,A00,090117,Jhala; Ranjit,0,0,0,0
1653640224267,CSE 232,A00,090118,Papakonstantinou; Yannis,0,0,0,0
1653640224790,CSE 239A,A00,090121,Kumar; Arun Kumar,0,0,0,0
1653640225316,CSE 239B,A00,090122,Jhala; Ranjit,0,0,0,0
1653640225843,CSE 240A,A00,090123,Zhao; Jishen,0,0,189,189
1653640226369,CSE 243A,A00,090124,Orailoglu; Alex,0,0,15,15
1653640226895,CSE 249B,A00,090125,Kahng; Andrew Byun,12,0,20,8
1653640227420,CSE 250A,A00,090126,Berg-Kirkpatrick; Taylor D,0,0,0,0
1653640227943,CSE 252A,A00,090127,Ochoa; Benjamin Lawrence,0,0,0,0
1653640228466,CSE 258,A01,090129,McAuley; Julian John,0,0,0,0
1653640228989,CSE 258R,A01,090131,McAuley; Julian John,0,0,0,0
1653640229512,CSE 274,A00,090132,Ramamoorthi; Ravi,0,0,0,0
1653640230038,CSE 276A,A00,090133,Christensen; Henrik I,0,0,0,0
1653640230569,CSE 276C,A00,090134,Christensen; Henrik I,0,0,0,0
1653640231096,CSE 290,A00,090135,Bafna; Vineet,0,0,0,0
1653640231096,CSE 290,B00,090136,Ramamoorthi; Ravi,0,0,0,0
1653640231096,CSE 290,C00,090137,Li; Tzumao,7,0,10,3
1653640231096,CSE 290,D00,090138,Zhou; Yuan-Yuan,9,0,10,1
1653640231096,CSE 290,E00,090139,Christensen; Henrik I,8,0,10,2
1653640231096,CSE 290,F00,094053,Shalev; Aaron D,0,0,0,0
1653640231619,CSE 291,A00,090140,Munyaka; Imani N. S.,0,0,0,0
1653640231619,CSE 291,B00,094880,Yu; Qi,0,0,0,0
1653640231619,CSE 291,C00,090142,Pannuto; Patrick William,0,0,0,0
1653640231619,CSE 291,D00,094881,Zhang; Yiying,0,0,0,0
1653640231619,CSE 291,E00,095118,Su; Hao,0,0,0,0
1653640232159,CSE 293,001,094905,Bafna; Vineet,9999,0,9999,0
1653640232159,CSE 293,002,094906,Bellare; Mihir,9999,0,9999,0
1653640232159,CSE 293,003,094907,Berg-Kirkpatrick; Taylor D,9999,0,9999,0
1653640232159,CSE 293,004,094908,Christensen; Henrik I,9999,0,9999,0
1653640232159,CSE 293,005,094909,Cottrell; Garrison W,9999,0,9999,0
1653640232159,CSE 293,006,094910,Deutsch; Alin Bernard,9999,0,9999,0
1653640232159,CSE 293,007,094911,Esmaeilzadeh; Hadi,9999,0,9999,0
1653640232159,CSE 293,008,094912,Freund; Yoav,9999,0,9999,0
1653640232159,CSE 293,009,094913,Griswold; William G.,9999,0,9999,0
1653640232159,CSE 293,010,094914,Gymrek; Melissa Ann,9999,0,9999,0
1653640232159,CSE 293,011,094915,Heninger; Nadia A,9999,0,9999,0
1653640232159,CSE 293,012,094916,Impagliazzo; Russell,9999,0,9999,0
1653640232159,CSE 293,013,094917,Jhala; Ranjit,9999,0,9999,0
1653640232159,CSE 293,014,094918,Kahng; Andrew Byun,9999,0,9999,0
1653640232159,CSE 293,015,094919,Kane; Daniel Mertz,9999,0,9999,0
1653640232159,CSE 293,016,094920,Kriegman; David J,9999,0,9999,0
1653640232159,CSE 293,017,094921,Kumar; Arun Kumar,9999,0,9999,0
1653640232159,CSE 293,018,094922,Lerner; Sorin,9999,0,9999,0
1653640232159,CSE 293,019,094923,Lovett; Shachar,9999,0,9999,0
1653640232159,CSE 293,020,094924,McAuley; Julian John,9999,0,9999,0
1653640232159,CSE 293,021,094925,Micciancio; Daniele,9999,0,9999,0
1653640232159,CSE 293,022,094926,Orailoglu; Alex,9999,0,9999,0
1653640232159,CSE 293,023,094927,Paturi; Ramamohan,9999,0,9999,0
1653640232159,CSE 293,024,094928,Polikarpova; Nadezhda,9999,0,9999,0
1653640232159,CSE 293,025,094929,Politz; Joseph Gibbs,9999,0,9999,0
1653640232159,CSE 293,026,094930,Porter; George M,9999,0,9999,0
1653640232159,CSE 293,027,094931,Porter; Leonard Emerson,9999,0,9999,0
1653640232159,CSE 293,028,094932,Ramamoorthi; Ravi,9999,0,9999,0
1653640232159,CSE 293,029,094933,Sahoo; Debashis,9999,0,9999,0
1653640232159,CSE 293,030,094934,Saul; Lawrence,9999,0,9999,0
1653640232159,CSE 293,031,094935,Savage; Stefan,9999,0,9999,0
1653640232159,CSE 293,032,094936,Schulze; Jurgen P.,9999,0,9999,0
1653640232159,CSE 293,033,094937,Snoeren; Alex C.,9999,0,9999,0
1653640232159,CSE 293,034,094938,Shang; Jingbo,9999,0,9999,0
1653640232159,CSE 293,035,094939,Stefan; Deian,9999,0,9999,0
1653640232159,CSE 293,036,094940,Su; Hao,9999,0,9999,0
1653640232159,CSE 293,037,094941,Swanson; Steven James,9999,0,9999,0
1653640232159,CSE 293,038,094942,Tullsen; Dean Michael,9999,0,9999,0
1653640232159,CSE 293,039,094943,Voelker; Geoffrey M.,9999,0,9999,0
1653640232159,CSE 293,040,094944,Zhao; Jishen,9999,0,9999,0
1653640232159,CSE 293,041,094945,Zhou; Yuan-Yuan,9999,0,9999,0
1653640232159,CSE 293,042,094946,Gao; Sicun,9998,0,9999,1
1653640232159,CSE 293,043,094947,Weibel; Nadir,9999,0,9999,0
1653640232159,CSE 293,044,094948,Gupta; Rajesh K.,9999,0,9999,0
1653640232682,CSE 294,A00,090143,Porter; George M,9,0,10,1
1653640233218,DSE 200,A00,091799,Staff,50,0,50,0
1653640233812,DSE 203,A00,091800,Gupta; Amarnath,30,0,30,0
1653640234339,DSE 250,A00,091801,Deutsch; Alin Bernard,30,0,30,0
1653640234862,DSE 290,A00,091802,Altintas De Callaf; Ilkay,50,0,50,0
1653640235418,ECE 200,001,091003,Antipa; Nicholas A,9999,0,9999,0
1653640235418,ECE 200,002,091004,Atanasov; Nikolay A.,9999,0,9999,0
1653640235418,ECE 200,003,091005,Bharadia; Dinesh,9999,0,9999,0
1653640235418,ECE 200,004,091006,Cheng; Chung Kuan,9999,0,9999,0
1653640235418,ECE 200,005,091007,Cosman; Pamela C.,9999,0,9999,0
1653640235418,ECE 200,006,091008,Staff,9999,0,9999,0
1653640235418,ECE 200,007,091009,Dayeh; Shadi Ahmad,9999,0,9999,0
1653640235418,ECE 200,008,091010,Fainman; Yeshaiahu,9999,0,9999,0
1653640235418,ECE 200,009,091011,Ford; Joseph Earl,9999,0,9999,0
1653640235418,ECE 200,010,091012,Franceschetti; Massimo,9999,0,9999,0
1653640235418,ECE 200,011,091013,Fullerton; Eric E,9999,0,9999,0
1653640235418,ECE 200,012,091014,Galton; Ian A,9999,0,9999,0
1653640235418,ECE 200,013,091015,Gilja; Vikash,9999,0,9999,0
1653640235418,ECE 200,014,091016,Hall; Drew A.,9999,0,9999,0
1653640235418,ECE 200,015,091017,Hsueh; Tzu-Chien,9999,0,9999,0
1653640235418,ECE 200,016,091018,Javidi; Tara,9999,0,9999,0
1653640235418,ECE 200,017,091019,Kahng; Andrew Byun,9999,0,9999,0
1653640235418,ECE 200,018,091020,Kim; Young-Han,9999,0,9999,0
1653640235418,ECE 200,019,091021,Koushanfar; Farinaz,9999,0,9999,0
1653640235418,ECE 200,020,091022,Kuzum; Duygu,9999,0,9999,0
1653640235418,ECE 200,021,091023,Le; Hanh-Phuc,9999,0,9999,0
1653640235418,ECE 200,022,091024,Lin; Bill,9999,0,9999,0
1653640235418,ECE 200,023,091025,Liu; Zhaowei,9999,0,9999,0
1653640235418,ECE 200,024,091026,Lo; Yu-Hwa,9999,0,9999,0
1653640235418,ECE 200,025,091027,Lomakin; Vitaliy,9999,0,9999,0
1653640235418,ECE 200,026,091028,Mercier; Patrick Philip,9999,0,9999,0
1653640235418,ECE 200,027,091029,Meyer; Florian,9999,0,9999,0
1653640235418,ECE 200,028,091030,Milstein; Laurence B.,9999,0,9999,0
1653640235418,ECE 200,029,091031,Mir Arabbaygi; Siavash,9999,0,9999,0
1653640235418,ECE 200,030,091032,Mookherjea; Shayan,9999,0,9999,0
1653640235418,ECE 200,031,091033,Morris; Karcher William,9999,0,9999,0
1653640235418,ECE 200,032,091034,Ng; Tse Nga,9999,0,9999,0
1653640235418,ECE 200,033,091035,Nguyen; Truong Quang,9999,0,9999,0
1653640235418,ECE 200,034,091036,Nomura; Kenji,9999,0,9999,0
1653640235418,ECE 200,035,091037,Orlitsky; Alon,9999,0,9999,0
1653640235418,ECE 200,036,091038,Pal; Piya,9999,0,9999,0
1653640235418,ECE 200,037,091039,Papen; George C.,9999,0,9999,0
1653640235418,ECE 200,038,091040,Radic; Stojan,9999,0,9999,0
1653640235418,ECE 200,039,091041,Rao; Bhaskar D.,9999,0,9999,0
1653640235418,ECE 200,040,091042,Rao; Ramesh R,9999,0,9999,0
1653640235418,ECE 200,041,091043,Rebeiz; Gabriel,9999,0,9999,0
1653640235418,ECE 200,042,091044,Sanford; John R,9999,0,9999,0
1653640235418,ECE 200,043,091045,Siegel; Paul H.,9999,0,9999,0
1653640235418,ECE 200,044,091046,Sievenpiper; Daniel F.,9999,0,9999,0
1653640235418,ECE 200,045,091047,Sworder; David D.,9999,0,9999,0
1653640235418,ECE 200,046,091048,Taur; Yuan,9999,0,9999,0
1653640235418,ECE 200,047,091049,Touri; Behrouz,9999,0,9999,0
1653640235418,ECE 200,048,091050,Trivedi; Mohan M.,9999,0,9999,0
1653640235418,ECE 200,049,091051,Vardy; Alexander,9999,0,9999,0
1653640235418,ECE 200,050,091052,Vasconcelos; Nuno,9999,0,9999,0
1653640235418,ECE 200,051,091053,Wang; Xiaolong,9999,0,9999,0
1653640235418,ECE 200,052,091054,Xie; Pengtao,9999,0,9999,0
1653640235418,ECE 200,053,091055,Yip; Michael,9999,0,9999,0
1653640235418,ECE 200,054,091056,Zeger; Kenneth A.,9999,0,9999,0
1653640235418,ECE 200,055,091057,Zhang; Xinyu,9999,0,9999,0
1653640235418,ECE 200,056,091058,Turakhia; Yatish Girish,9999,0,9999,0
1653640235418,ECE 200,057,091059,Kang; Mingu,9999,0,9999,0
1653640235418,ECE 200,058,091060,Shi; Yuanyuan,9999,0,9999,0
1653640235418,ECE 200,059,091061,Wang; Edward Jay,9999,0,9999,0
1653640235418,ECE 200,060,091062,Zheng; Yang,9999,0,9999,0
1653640235943,ECE 201,A00,095526,Lo; Yu-Hwa,0,0,0,0
1653640236466,ECE 203,A00,091065,Mercier; Patrick Philip,0,0,0,0
1653640236996,ECE 207A,A00,091605,Liu; Thomas Tao-Ming,0,0,0,0
1653640237555,ECE 212AN,A00,091068,Nomura; Kenji,0,0,0,0
1653640238079,ECE 222A,A00,091069,Rebeiz; Gabriel,0,0,0,0
1653640238605,ECE 225A,A00,091070,Orlitsky; Alon,0,0,0,0
1653640239131,ECE 230A,A00,091071,Nomura; Kenji,0,0,0,0
1653640239655,ECE 236A,A00,091072,Dayeh; Shadi Ahmad,0,0,0,0
1653640240184,ECE 238A,A00,091073,Luo; Jian,0,0,0,0
1653640240184,ECE 238A,B00,091074,Luo; Jian,0,0,0,0
1653640240715,ECE 240A,A00,091075,Radic; Stojan,0,0,0,0
1653640241330,ECE 247A,A00,091592,Shi; Lingyan,0,0,0,0
1653640241854,ECE 250,A00,091076,Touri; Behrouz,0,0,0,0
1653640242377,ECE 251C,A00,091078,Nguyen; Truong Quang,0,0,0,0
1653640242901,ECE 253,A00,091079,Cosman; Pamela C.,0,0,0,0
1653640243435,ECE 255A,A00,091080,Orlitsky; Alon,0,0,0,0
1653640243959,ECE 257A,A00,091081,Zhang; Xinyu,0,0,0,0
1653640244486,ECE 260A,A01,091084,Eldon; John,0,0,0,0
1653640245016,ECE 264C,A00,091085,Galton; Ian A,0,0,0,0
1653640245540,ECE 265C,A00,094889,Presti; Calogero Davide,0,0,0,9
1653640246065,ECE 266,A01,091087,Hall; Drew A.,0,0,0,0
1653640247123,ECE 271A,A00,091090,Vasconcelos; Nuno,0,0,0,0
1653640247658,ECE 272B,A00,091091,Sworder; David D.,0,0,0,0
1653640248184,ECE 275A,A00,091092,Meyer; Florian,0,0,0,0
1653640248710,ECE 277,A00,091093,An; Cheolhong,0,0,0,0
1653640249233,ECE 283,A00,091094,Le; Hanh-Phuc,0,0,0,0
1653640249756,ECE 284,A00,091095,Kang; Mingu,0,0,0,0
1653640249756,ECE 284,B00,091096,Wang; Edward Jay,0,0,0,0
1653640250282,ECE 285,A00,094334,Touri; Behrouz,0,0,0,0
1653640250806,ECE 289,A00,091097,Whelan; David Arthur,0,0,0,0
1653640251329,MATH 200A,A00,087414,Salehi Golsefidy; Alireza,7,0,8,1
1653640251853,MATH 202A,A00,087415,Gill; Philip E.,2,0,8,6
1653640252377,MATH 203A,A00,087416,Oprea; Dragos N.,6,0,8,2
1653640252903,MATH 204A,A00,087417,Kedlaya; Kiran S.,6,0,8,2
1653640253426,MATH 205,A00,087418,Sorensen; Claus M,6,0,8,2
1653640253952,MATH 206A,A00,087419,Izadi; Elham,6,0,8,2
1653640254476,MATH 207A,A00,087420,Mohammadi; Amir,5,0,8,3
1653640255004,MATH 208,A00,087421,Staff,8,0,10,2
1653640255534,MATH 209,A00,087422,Staff,10,0,10,0
1653640256058,MATH 218,A00,087423,Staff,10,0,10,0
1653640256582,MATH 220A,A00,087424,Novak; Jonathan I,6,0,8,2
1653640257111,MATH 231A,A00,087425,Bejenaru; Ioan,3,0,8,5
1653640257638,MATH 240A,A00,087426,Ebenfelt; Peter F,5,0,8,3
1653640258163,MATH 243,A00,087427,Staff,9,0,10,1
1653640258689,MATH 248,A00,087429,Staff,10,0,10,0
1653640259212,MATH 250A,A00,087430,Spolaor; Luca,4,0,8,4
1653640259736,MATH 257A,A00,087431,Spolaor; Luca,7,0,8,1
1653640260261,MATH 258,A00,087432,Staff,9,0,10,1
1653640260788,MATH 264A,A00,087433,Warnke; Lutz Peter,5,0,8,3
1653640261317,MATH 268,A00,087434,Staff,15,0,15,0
1653640261840,MATH 269,A00,087435,Staff,14,0,15,1
1653640262365,MATH 270A,A00,087436,Nie; Jiawang,0,0,8,8
1653640262900,MATH 272A,A00,087437,Tian; Xiaochuan,0,0,8,8
1653640263422,MATH 274,A01,087439,Cheng; Li-Tien,9,0,10,1
1653640263422,MATH 274,A02,087440,Cheng; Li-Tien,10,0,10,0
1653640263949,MATH 278A,A00,087441,Staff,8,0,10,2
1653640264472,MATH 278B,A00,087442,Staff,8,0,10,2
1653640264996,MATH 278C,A00,087443,Staff,8,0,10,2
1653640265520,MATH 280A,A00,087444,Zheng; Tianyi,0,0,8,8
1653640266044,MATH 281A,A00,087445,Bradic; Jelena,0,0,8,9
1653640266573,MATH 282A,A00,087446,Zhang; Danna,0,0,8,8
1653640267097,MATH 283,A00,087447,Tesler; Glenn,0,0,0,16
1653640267624,MATH 286,B00,095535,Kemp; Todd Aahron,5,0,8,3
1653640268148,MATH 287D,B00,095536,Bradic; Jelena,5,0,8,3
1653640268673,MATH 288,A00,087450,Staff,14,0,15,1
1653640268673,MATH 288,B00,087451,Staff,15,0,15,0
1653640268673,MATH 288,C00,087452,Staff,15,0,15,0
1653640269200,MATH 290A,A00,087453,Xu; Zhouli,6,0,8,2
1653640269724,MATH 291A,A00,087454,Xu; Zhouli,7,0,8,1
1653640270247,MATH 292,A00,087455,Staff,10,0,10,0
1653640270770,MATH 295,A00,087456,Staff,50,0,50,0
1653640271293,MATH 297,001,087457,Staff,997,0,999,2
1653640831302,COGS 200,A01,087991,Staff,47,0,50,3
1653640831825,COGS 201,A01,094504,Rangel; Lara M,16,0,25,9
1653640832348,COGS 203,A00,087992,Coulson; Seana M,18,0,20,2
1653640832878,COGS 210A,001,087993,Greene; Deanna Jacquelyn,9998,0,9999,1
1653640832878,COGS 210A,002,087994,Saygin; Ayse P,9999,0,9999,0
1653640832878,COGS 210A,003,087995,Xia; Haijun,9999,0,9999,0
1653640832878,COGS 210A,004,087996,Nitz; Douglas A.,9999,0,9999,0
1653640832878,COGS 210A,005,087997,Hollan; James D.,9999,0,9999,0
1653640832878,COGS 210A,006,087998,Deak; Gedeon O.,9998,0,9999,1
1653640832878,COGS 210A,007,087999,Rossano; Federico,9999,0,9999,0
1653640833401,COGS 211A,A00,088000,Coulson; Seana M,9997,0,9999,2
1653640833924,COGS 229,A00,088002,Staff,22,0,25,3
1653640834447,COGS 260,B00,094231,Staff,17,0,20,3
1653640834447,COGS 260,A00,088004,Nitz; Douglas A.,9998,0,9999,1
1653640834974,CSE 202,A00,090110,Paturi; Ramamohan,0,0,0,0
1653640834974,CSE 202,B00,090111,Paturi; Ramamohan,0,0,0,0
1653640835498,CSE 207B,A00,090112,Heninger; Nadia A,0,0,0,0
1653640836024,CSE 208,A00,094858,Micciancio; Daniele,0,0,0,0
1653640836549,CSE 210,A00,090113,Powell; Thomas Allan,0,0,0,0
1653640837074,CSE 219,A00,090898,Staff,0,0,0,0
1653640837602,CSE 221,A00,090114,Zhou; Yuan-Yuan,0,0,0,0
1653640838129,CSE 229A,A00,090115,Porter; George M,0,0,0,0
1653640838656,CSE 229C,A00,090116,Savage; Stefan,0,0,0,0
1653640839177,CSE 230,A00,090117,Jhala; Ranjit,0,0,0,0
1653640839701,CSE 232,A00,090118,Papakonstantinou; Yannis,0,0,0,0
1653640840223,CSE 239A,A00,090121,Kumar; Arun Kumar,0,0,0,0
1653640840746,CSE 239B,A00,090122,Jhala; Ranjit,0,0,0,0
1653640841268,CSE 240A,A00,090123,Zhao; Jishen,0,0,189,189
1653640841794,CSE 243A,A00,090124,Orailoglu; Alex,0,0,15,15
1653640842321,CSE 249B,A00,090125,Kahng; Andrew Byun,12,0,20,8
1653640842845,CSE 250A,A00,090126,Berg-Kirkpatrick; Taylor D,0,0,0,0
1653640843383,CSE 252A,A00,090127,Ochoa; Benjamin Lawrence,0,0,0,0
1653640843909,CSE 258,A01,090129,McAuley; Julian John,0,0,0,0
1653640844432,CSE 258R,A01,090131,McAuley; Julian John,0,0,0,0
1653640844959,CSE 274,A00,090132,Ramamoorthi; Ravi,0,0,0,0
1653640845485,CSE 276A,A00,090133,Christensen; Henrik I,0,0,0,0
1653640846008,CSE 276C,A00,090134,Christensen; Henrik I,0,0,0,0
1653640846536,CSE 290,A00,090135,Bafna; Vineet,0,0,0,0
1653640846536,CSE 290,B00,090136,Ramamoorthi; Ravi,0,0,0,0
1653640846536,CSE 290,C00,090137,Li; Tzumao,7,0,10,3
1653640846536,CSE 290,D00,090138,Zhou; Yuan-Yuan,9,0,10,1
1653640846536,CSE 290,E00,090139,Christensen; Henrik I,8,0,10,2
1653640846536,CSE 290,F00,094053,Shalev; Aaron D,0,0,0,0
1653640847062,CSE 291,A00,090140,Munyaka; Imani N. S.,0,0,0,0
1653640847062,CSE 291,B00,094880,Yu; Qi,0,0,0,0
1653640847062,CSE 291,C00,090142,Pannuto; Patrick William,0,0,0,0
1653640847062,CSE 291,D00,094881,Zhang; Yiying,0,0,0,0
1653640847062,CSE 291,E00,095118,Su; Hao,0,0,0,0
1653640847596,CSE 293,001,094905,Bafna; Vineet,9999,0,9999,0
1653640847596,CSE 293,002,094906,Bellare; Mihir,9999,0,9999,0
1653640847596,CSE 293,003,094907,Berg-Kirkpatrick; Taylor D,9999,0,9999,0
1653640847596,CSE 293,004,094908,Christensen; Henrik I,9999,0,9999,0
1653640847596,CSE 293,005,094909,Cottrell; Garrison W,9999,0,9999,0
1653640847596,CSE 293,006,094910,Deutsch; Alin Bernard,9999,0,9999,0
1653640847596,CSE 293,007,094911,Esmaeilzadeh; Hadi,9999,0,9999,0
1653640847596,CSE 293,008,094912,Freund; Yoav,9999,0,9999,0
1653640847596,CSE 293,009,094913,Griswold; William G.,9999,0,9999,0
1653640847596,CSE 293,010,094914,Gymrek; Melissa Ann,9999,0,9999,0
1653640847596,CSE 293,011,094915,Heninger; Nadia A,9999,0,9999,0
1653640847596,CSE 293,012,094916,Impagliazzo; Russell,9999,0,9999,0
1653640847596,CSE 293,013,094917,Jhala; Ranjit,9999,0,9999,0
1653640847596,CSE 293,014,094918,Kahng; Andrew Byun,9999,0,9999,0
1653640847596,CSE 293,015,094919,Kane; Daniel Mertz,9999,0,9999,0
1653640847596,CSE 293,016,094920,Kriegman; David J,9999,0,9999,0
1653640847596,CSE 293,017,094921,Kumar; Arun Kumar,9999,0,9999,0
1653640847596,CSE 293,018,094922,Lerner; Sorin,9999,0,9999,0
1653640847596,CSE 293,019,094923,Lovett; Shachar,9999,0,9999,0
1653640847596,CSE 293,020,094924,McAuley; Julian John,9999,0,9999,0
1653640847596,CSE 293,021,094925,Micciancio; Daniele,9999,0,9999,0
1653640847596,CSE 293,022,094926,Orailoglu; Alex,9999,0,9999,0
1653640847596,CSE 293,023,094927,Paturi; Ramamohan,9999,0,9999,0
1653640847596,CSE 293,024,094928,Polikarpova; Nadezhda,9999,0,9999,0
1653640847596,CSE 293,025,094929,Politz; Joseph Gibbs,9999,0,9999,0
1653640847596,CSE 293,026,094930,Porter; George M,9999,0,9999,0
1653640847596,CSE 293,027,094931,Porter; Leonard Emerson,9999,0,9999,0
1653640847596,CSE 293,028,094932,Ramamoorthi; Ravi,9999,0,9999,0
1653640847596,CSE 293,029,094933,Sahoo; Debashis,9999,0,9999,0
1653640847596,CSE 293,030,094934,Saul; Lawrence,9999,0,9999,0
1653640847596,CSE 293,031,094935,Savage; Stefan,9999,0,9999,0
1653640847596,CSE 293,032,094936,Schulze; Jurgen P.,9999,0,9999,0
1653640847596,CSE 293,033,094937,Snoeren; Alex C.,9999,0,9999,0
1653640847596,CSE 293,034,094938,Shang; Jingbo,9999,0,9999,0
1653640847596,CSE 293,035,094939,Stefan; Deian,9999,0,9999,0
1653640847596,CSE 293,036,094940,Su; Hao,9999,0,9999,0
1653640847596,CSE 293,037,094941,Swanson; Steven James,9999,0,9999,0
1653640847596,CSE 293,038,094942,Tullsen; Dean Michael,9999,0,9999,0
1653640847596,CSE 293,039,094943,Voelker; Geoffrey M.,9999,0,9999,0
1653640847596,CSE 293,040,094944,Zhao; Jishen,9999,0,9999,0
1653640847596,CSE 293,041,094945,Zhou; Yuan-Yuan,9999,0,9999,0
1653640847596,CSE 293,042,094946,Gao; Sicun,9998,0,9999,1
1653640847596,CSE 293,043,094947,Weibel; Nadir,9999,0,9999,0
1653640847596,CSE 293,044,094948,Gupta; Rajesh K.,9999,0,9999,0
1653640848121,CSE 294,A00,090143,Porter; George M,9,0,10,1
1653640848645,DSE 200,A00,091799,Staff,50,0,50,0
1653640849169,DSE 203,A00,091800,Gupta; Amarnath,30,0,30,0
1653640849694,DSE 250,A00,091801,Deutsch; Alin Bernard,30,0,30,0
1653640850223,DSE 290,A00,091802,Altintas De Callaf; Ilkay,50,0,50,0
1653640850788,ECE 200,001,091003,Antipa; Nicholas A,9999,0,9999,0
1653640850788,ECE 200,002,091004,Atanasov; Nikolay A.,9999,0,9999,0
1653640850788,ECE 200,003,091005,Bharadia; Dinesh,9999,0,9999,0
1653640850788,ECE 200,004,091006,Cheng; Chung Kuan,9999,0,9999,0
1653640850788,ECE 200,005,091007,Cosman; Pamela C.,9999,0,9999,0
1653640850788,ECE 200,006,091008,Staff,9999,0,9999,0
1653640850788,ECE 200,007,091009,Dayeh; Shadi Ahmad,9999,0,9999,0
1653640850788,ECE 200,008,091010,Fainman; Yeshaiahu,9999,0,9999,0
1653640850788,ECE 200,009,091011,Ford; Joseph Earl,9999,0,9999,0
1653640850788,ECE 200,010,091012,Franceschetti; Massimo,9999,0,9999,0
1653640850788,ECE 200,011,091013,Fullerton; Eric E,9999,0,9999,0
1653640850788,ECE 200,012,091014,Galton; Ian A,9999,0,9999,0
1653640850788,ECE 200,013,091015,Gilja; Vikash,9999,0,9999,0
1653640850788,ECE 200,014,091016,Hall; Drew A.,9999,0,9999,0
1653640850788,ECE 200,015,091017,Hsueh; Tzu-Chien,9999,0,9999,0
1653640850788,ECE 200,016,091018,Javidi; Tara,9999,0,9999,0
1653640850788,ECE 200,017,091019,Kahng; Andrew Byun,9999,0,9999,0
1653640850788,ECE 200,018,091020,Kim; Young-Han,9999,0,9999,0
1653640850788,ECE 200,019,091021,Koushanfar; Farinaz,9999,0,9999,0
1653640850788,ECE 200,020,091022,Kuzum; Duygu,9999,0,9999,0
1653640850788,ECE 200,021,091023,Le; Hanh-Phuc,9999,0,9999,0
1653640850788,ECE 200,022,091024,Lin; Bill,9999,0,9999,0
1653640850788,ECE 200,023,091025,Liu; Zhaowei,9999,0,9999,0
1653640850788,ECE 200,024,091026,Lo; Yu-Hwa,9999,0,9999,0
1653640850788,ECE 200,025,091027,Lomakin; Vitaliy,9999,0,9999,0
1653640850788,ECE 200,026,091028,Mercier; Patrick Philip,9999,0,9999,0
1653640850788,ECE 200,027,091029,Meyer; Florian,9999,0,9999,0
1653640850788,ECE 200,028,091030,Milstein; Laurence B.,9999,0,9999,0
1653640850788,ECE 200,029,091031,Mir Arabbaygi; Siavash,9999,0,9999,0
1653640850788,ECE 200,030,091032,Mookherjea; Shayan,9999,0,9999,0
1653640850788,ECE 200,031,091033,Morris; Karcher William,9999,0,9999,0
1653640850788,ECE 200,032,091034,Ng; Tse Nga,9999,0,9999,0
1653640850788,ECE 200,033,091035,Nguyen; Truong Quang,9999,0,9999,0
1653640850788,ECE 200,034,091036,Nomura; Kenji,9999,0,9999,0
1653640850788,ECE 200,035,091037,Orlitsky; Alon,9999,0,9999,0
1653640850788,ECE 200,036,091038,Pal; Piya,9999,0,9999,0
1653640850788,ECE 200,037,091039,Papen; George C.,9999,0,9999,0
1653640850788,ECE 200,038,091040,Radic; Stojan,9999,0,9999,0
1653640850788,ECE 200,039,091041,Rao; Bhaskar D.,9999,0,9999,0
1653640850788,ECE 200,040,091042,Rao; Ramesh R,9999,0,9999,0
1653640850788,ECE 200,041,091043,Rebeiz; Gabriel,9999,0,9999,0
1653640850788,ECE 200,042,091044,Sanford; John R,9999,0,9999,0
1653640850788,ECE 200,043,091045,Siegel; Paul H.,9999,0,9999,0
1653640850788,ECE 200,044,091046,Sievenpiper; Daniel F.,9999,0,9999,0
1653640850788,ECE 200,045,091047,Sworder; David D.,9999,0,9999,0
1653640850788,ECE 200,046,091048,Taur; Yuan,9999,0,9999,0
1653640850788,ECE 200,047,091049,Touri; Behrouz,9999,0,9999,0
1653640850788,ECE 200,048,091050,Trivedi; Mohan M.,9999,0,9999,0
1653640850788,ECE 200,049,091051,Vardy; Alexander,9999,0,9999,0
1653640850788,ECE 200,050,091052,Vasconcelos; Nuno,9999,0,9999,0
1653640850788,ECE 200,051,091053,Wang; Xiaolong,9999,0,9999,0
1653640850788,ECE 200,052,091054,Xie; Pengtao,9999,0,9999,0
1653640850788,ECE 200,053,091055,Yip; Michael,9999,0,9999,0
1653640850788,ECE 200,054,091056,Zeger; Kenneth A.,9999,0,9999,0
1653640850788,ECE 200,055,091057,Zhang; Xinyu,9999,0,9999,0
1653640850788,ECE 200,056,091058,Turakhia; Yatish Girish,9999,0,9999,0
1653640850788,ECE 200,057,091059,Kang; Mingu,9999,0,9999,0
1653640850788,ECE 200,058,091060,Shi; Yuanyuan,9999,0,9999,0
1653640850788,ECE 200,059,091061,Wang; Edward Jay,9999,0,9999,0
1653640850788,ECE 200,060,091062,Zheng; Yang,9999,0,9999,0
1653640851314,ECE 201,A00,095526,Lo; Yu-Hwa,0,0,0,0
1653640851837,ECE 203,A00,091065,Mercier; Patrick Philip,0,0,0,0
1653640852364,ECE 207A,A00,091605,Liu; Thomas Tao-Ming,0,0,0,0
1653640852887,ECE 212AN,A00,091068,Nomura; Kenji,0,0,0,0
1653640853413,ECE 222A,A00,091069,Rebeiz; Gabriel,0,0,0,0
1653640853939,ECE 225A,A00,091070,Orlitsky; Alon,0,0,0,0
1653640854462,ECE 230A,A00,091071,Nomura; Kenji,0,0,0,0
1653640854987,ECE 236A,A00,091072,Dayeh; Shadi Ahmad,0,0,0,0
1653640855514,ECE 238A,A00,091073,Luo; Jian,0,0,0,0
1653640855514,ECE 238A,B00,091074,Luo; Jian,0,0,0,0
1653640856038,ECE 240A,A00,091075,Radic; Stojan,0,0,0,0
1653640856561,ECE 247A,A00,091592,Shi; Lingyan,0,0,0,0
1653640857083,ECE 250,A00,091076,Touri; Behrouz,0,0,0,0
1653640857606,ECE 251C,A00,091078,Nguyen; Truong Quang,0,0,0,0
1653640858129,ECE 253,A00,091079,Cosman; Pamela C.,0,0,0,0
1653640858652,ECE 255A,A00,091080,Orlitsky; Alon,0,0,0,0
1653640859180,ECE 257A,A00,091081,Zhang; Xinyu,0,0,0,0
1653640859703,ECE 260A,A01,091084,Eldon; John,0,0,0,0
1653640860230,ECE 264C,A00,091085,Galton; Ian A,0,0,0,0
1653640860757,ECE 265C,A00,094889,Presti; Calogero Davide,0,0,0,9
1653640861282,ECE 266,A01,091087,Hall; Drew A.,0,0,0,0
1653640862328,ECE 271A,A00,091090,Vasconcelos; Nuno,0,0,0,0
1653640862855,ECE 272B,A00,091091,Sworder; David D.,0,0,0,0
1653640863380,ECE 275A,A00,091092,Meyer; Florian,0,0,0,0
1653640863903,ECE 277,A00,091093,An; Cheolhong,0,0,0,0
1653640864431,ECE 283,A00,091094,Le; Hanh-Phuc,0,0,0,0
1653640864954,ECE 284,A00,091095,Kang; Mingu,0,0,0,0
1653640864954,ECE 284,B00,091096,Wang; Edward Jay,0,0,0,0
1653640865481,ECE 285,A00,094334,Touri; Behrouz,0,0,0,0
1653640866014,ECE 289,A00,091097,Whelan; David Arthur,0,0,0,0
1653640866538,MATH 200A,A00,087414,Salehi Golsefidy; Alireza,7,0,8,1
1653640867061,MATH 202A,A00,087415,Gill; Philip E.,2,0,8,6
1653640867589,MATH 203A,A00,087416,Oprea; Dragos N.,6,0,8,2
1653640868112,MATH 204A,A00,087417,Kedlaya; Kiran S.,6,0,8,2
1653640868640,MATH 205,A00,087418,Sorensen; Claus M,6,0,8,2
1653640869166,MATH 206A,A00,087419,Izadi; Elham,6,0,8,2
1653640869693,MATH 207A,A00,087420,Mohammadi; Amir,5,0,8,3
1653640870223,MATH 208,A00,087421,Staff,8,0,10,2
1653640870756,MATH 209,A00,087422,Staff,10,0,10,0
1653640871279,MATH 218,A00,087423,Staff,10,0,10,0
1653640871814,MATH 220A,A00,087424,Novak; Jonathan I,6,0,8,2
1653640872342,MATH 231A,A00,087425,Bejenaru; Ioan,3,0,8,5
1653640872875,MATH 240A,A00,087426,Ebenfelt; Peter F,5,0,8,3
1653640873403,MATH 243,A00,087427,Staff,9,0,10,1
1653640873938,MATH 248,A00,087429,Staff,10,0,10,0
1653640874462,MATH 250A,A00,087430,Spolaor; Luca,4,0,8,4
1653640874986,MATH 257A,A00,087431,Spolaor; Luca,7,0,8,1
1653640875512,MATH 258,A00,087432,Staff,9,0,10,1
1653640876038,MATH 264A,A00,087433,Warnke; Lutz Peter,5,0,8,3
1653640876561,MATH 268,A00,087434,Staff,15,0,15,0
1653640877088,MATH 269,A00,087435,Staff,14,0,15,1
1653640877611,MATH 270A,A00,087436,Nie; Jiawang,0,0,8,8
1653640878138,MATH 272A,A00,087437,Tian; Xiaochuan,0,0,8,8
1653640878667,MATH 274,A01,087439,Cheng; Li-Tien,9,0,10,1
1653640878667,MATH 274,A02,087440,Cheng; Li-Tien,10,0,10,0
1653640879194,MATH 278A,A00,087441,Staff,8,0,10,2
1653640879725,MATH 278B,A00,087442,Staff,8,0,10,2
1653640880257,MATH 278C,A00,087443,Staff,8,0,10,2
1653640880787,MATH 280A,A00,087444,Zheng; Tianyi,0,0,8,8
1653640881314,MATH 281A,A00,087445,Bradic; Jelena,0,0,8,9
1653640881908,MATH 282A,A00,087446,Zhang; Danna,0,0,8,8
1653640882436,MATH 283,A00,087447,Tesler; Glenn,0,0,0,16
1653640882962,MATH 286,B00,095535,Kemp; Todd Aahron,5,0,8,3
1653640883486,MATH 287D,B00,095536,Bradic; Jelena,5,0,8,3
1653640884010,MATH 288,A00,087450,Staff,14,0,15,1
1653640884010,MATH 288,B00,087451,Staff,15,0,15,0
1653640884010,MATH 288,C00,087452,Staff,15,0,15,0
1653640884533,MATH 290A,A00,087453,Xu; Zhouli,6,0,8,2
1653640885057,MATH 291A,A00,087454,Xu; Zhouli,7,0,8,1
1653640885583,MATH 292,A00,087455,Staff,10,0,10,0
1653640886107,MATH 295,A00,087456,Staff,50,0,50,0
1653640886630,MATH 297,001,087457,Staff,997,0,999,2
1653641457063,COGS 200,A01,087991,Staff,47,0,50,3
1653641457600,COGS 201,A01,094504,Rangel; Lara M,16,0,25,9
1653641458128,COGS 203,A00,087992,Coulson; Seana M,18,0,20,2
1653641458659,COGS 210A,001,087993,Greene; Deanna Jacquelyn,9998,0,9999,1
1653641458659,COGS 210A,002,087994,Saygin; Ayse P,9999,0,9999,0
1653641458659,COGS 210A,003,087995,Xia; Haijun,9999,0,9999,0
1653641458659,COGS 210A,004,087996,Nitz; Douglas A.,9999,0,9999,0
1653641458659,COGS 210A,005,087997,Hollan; James D.,9999,0,9999,0
1653641458659,COGS 210A,006,087998,Deak; Gedeon O.,9998,0,9999,1
1653641458659,COGS 210A,007,087999,Rossano; Federico,9999,0,9999,0
1653641459183,COGS 211A,A00,088000,Coulson; Seana M,9997,0,9999,2
1653641459709,COGS 229,A00,088002,Staff,22,0,25,3
1653641460243,COGS 260,B00,094231,Staff,17,0,20,3
1653641460243,COGS 260,A00,088004,Nitz; Douglas A.,9998,0,9999,1
1653641460768,CSE 202,A00,090110,Paturi; Ramamohan,0,0,0,0
1653641460768,CSE 202,B00,090111,Paturi; Ramamohan,0,0,0,0
1653641461292,CSE 207B,A00,090112,Heninger; Nadia A,0,0,0,0
1653641461819,CSE 208,A00,094858,Micciancio; Daniele,0,0,0,0
1653641462349,CSE 210,A00,090113,Powell; Thomas Allan,0,0,0,0
1653641462872,CSE 219,A00,090898,Staff,0,0,0,0
1653641463415,CSE 221,A00,090114,Zhou; Yuan-Yuan,0,0,0,0
1653641463939,CSE 229A,A00,090115,Porter; George M,0,0,0,0
1653641464462,CSE 229C,A00,090116,Savage; Stefan,0,0,0,0
1653641464986,CSE 230,A00,090117,Jhala; Ranjit,0,0,0,0
1653641465513,CSE 232,A00,090118,Papakonstantinou; Yannis,0,0,0,0
1653641466037,CSE 239A,A00,090121,Kumar; Arun Kumar,0,0,0,0
1653641466564,CSE 239B,A00,090122,Jhala; Ranjit,0,0,0,0
1653641467090,CSE 240A,A00,090123,Zhao; Jishen,0,0,189,189
1653641467613,CSE 243A,A00,090124,Orailoglu; Alex,0,0,15,15
1653641468137,CSE 249B,A00,090125,Kahng; Andrew Byun,12,0,20,8
1653641468663,CSE 250A,A00,090126,Berg-Kirkpatrick; Taylor D,0,0,0,0
1653641469190,CSE 252A,A00,090127,Ochoa; Benjamin Lawrence,0,0,0,0
1653641469715,CSE 258,A01,090129,McAuley; Julian John,0,0,0,0
1653641470251,CSE 258R,A01,090131,McAuley; Julian John,0,0,0,0
1653641470785,CSE 274,A00,090132,Ramamoorthi; Ravi,0,0,0,0
1653641471310,CSE 276A,A00,090133,Christensen; Henrik I,0,0,0,0
1653641471839,CSE 276C,A00,090134,Christensen; Henrik I,0,0,0,0
1653641472370,CSE 290,A00,090135,Bafna; Vineet,0,0,0,0
1653641472370,CSE 290,B00,090136,Ramamoorthi; Ravi,0,0,0,0
1653641472370,CSE 290,C00,090137,Li; Tzumao,7,0,10,3
1653641472370,CSE 290,D00,090138,Zhou; Yuan-Yuan,9,0,10,1
1653641472370,CSE 290,E00,090139,Christensen; Henrik I,8,0,10,2
1653641472370,CSE 290,F00,094053,Shalev; Aaron D,0,0,0,0
1653641472915,CSE 291,A00,090140,Munyaka; Imani N. S.,0,0,0,0
1653641472915,CSE 291,B00,094880,Yu; Qi,0,0,0,0
1653641472915,CSE 291,C00,090142,Pannuto; Patrick William,0,0,0,0
1653641472915,CSE 291,D00,094881,Zhang; Yiying,0,0,0,0
1653641472915,CSE 291,E00,095118,Su; Hao,0,0,0,0
1653641473479,CSE 293,001,094905,Bafna; Vineet,9999,0,9999,0
1653641473479,CSE 293,002,094906,Bellare; Mihir,9999,0,9999,0
1653641473479,CSE 293,003,094907,Berg-Kirkpatrick; Taylor D,9999,0,9999,0
1653641473479,CSE 293,004,094908,Christensen; Henrik I,9999,0,9999,0
1653641473479,CSE 293,005,094909,Cottrell; Garrison W,9999,0,9999,0
1653641473479,CSE 293,006,094910,Deutsch; Alin Bernard,9999,0,9999,0
1653641473479,CSE 293,007,094911,Esmaeilzadeh; Hadi,9999,0,9999,0
1653641473479,CSE 293,008,094912,Freund; Yoav,9999,0,9999,0
1653641473479,CSE 293,009,094913,Griswold; William G.,9999,0,9999,0
1653641473479,CSE 293,010,094914,Gymrek; Melissa Ann,9999,0,9999,0
1653641473479,CSE 293,011,094915,Heninger; Nadia A,9999,0,9999,0
1653641473479,CSE 293,012,094916,Impagliazzo; Russell,9999,0,9999,0
1653641473479,CSE 293,013,094917,Jhala; Ranjit,9999,0,9999,0
1653641473479,CSE 293,014,094918,Kahng; Andrew Byun,9999,0,9999,0
1653641473479,CSE 293,015,094919,Kane; Daniel Mertz,9999,0,9999,0
1653641473479,CSE 293,016,094920,Kriegman; David J,9999,0,9999,0
1653641473479,CSE 293,017,094921,Kumar; Arun Kumar,9999,0,9999,0
1653641473479,CSE 293,018,094922,Lerner; Sorin,9999,0,9999,0
1653641473479,CSE 293,019,094923,Lovett; Shachar,9999,0,9999,0
1653641473479,CSE 293,020,094924,McAuley; Julian John,9999,0,9999,0
1653641473479,CSE 293,021,094925,Micciancio; Daniele,9999,0,9999,0
1653641473479,CSE 293,022,094926,Orailoglu; Alex,9999,0,9999,0
1653641473479,CSE 293,023,094927,Paturi; Ramamohan,9999,0,9999,0
1653641473479,CSE 293,024,094928,Polikarpova; Nadezhda,9999,0,9999,0
1653641473479,CSE 293,025,094929,Politz; Joseph Gibbs,9999,0,9999,0
1653641473479,CSE 293,026,094930,Porter; George M,9999,0,9999,0
1653641473479,CSE 293,027,094931,Porter; Leonard Emerson,9999,0,9999,0
1653641473479,CSE 293,028,094932,Ramamoorthi; Ravi,9999,0,9999,0
1653641473479,CSE 293,029,094933,Sahoo; Debashis,9999,0,9999,0
1653641473479,CSE 293,030,094934,Saul; Lawrence,9999,0,9999,0
1653641473479,CSE 293,031,094935,Savage; Stefan,9999,0,9999,0
1653641473479,CSE 293,032,094936,Schulze; Jurgen P.,9999,0,9999,0
1653641473479,CSE 293,033,094937,Snoeren; Alex C.,9999,0,9999,0
1653641473479,CSE 293,034,094938,Shang; Jingbo,9999,0,9999,0
1653641473479,CSE 293,035,094939,Stefan; Deian,9999,0,9999,0
1653641473479,CSE 293,036,094940,Su; Hao,9999,0,9999,0
1653641473479,CSE 293,037,094941,Swanson; Steven James,9999,0,9999,0
1653641473479,CSE 293,038,094942,Tullsen; Dean Michael,9999,0,9999,0
1653641473479,CSE 293,039,094943,Voelker; Geoffrey M.,9999,0,9999,0
1653641473479,CSE 293,040,094944,Zhao; Jishen,9999,0,9999,0
1653641473479,CSE 293,041,094945,Zhou; Yuan-Yuan,9999,0,9999,0
1653641473479,CSE 293,042,094946,Gao; Sicun,9998,0,9999,1
1653641473479,CSE 293,043,094947,Weibel; Nadir,9999,0,9999,0
1653641473479,CSE 293,044,094948,Gupta; Rajesh K.,9999,0,9999,0
1653641474002,CSE 294,A00,090143,Porter; George M,9,0,10,1
1653641474571,DSE 200,A00,091799,Staff,50,0,50,0
1653641475094,DSE 203,A00,091800,Gupta; Amarnath,30,0,30,0
1653641475622,DSE 250,A00,091801,Deutsch; Alin Bernard,30,0,30,0
1653641476146,DSE 290,A00,091802,Altintas De Callaf; Ilkay,50,0,50,0
1653641476700,ECE 200,001,091003,Antipa; Nicholas A,9999,0,9999,0
1653641476700,ECE 200,002,091004,Atanasov; Nikolay A.,9999,0,9999,0
1653641476700,ECE 200,003,091005,Bharadia; Dinesh,9999,0,9999,0
1653641476700,ECE 200,004,091006,Cheng; Chung Kuan,9999,0,9999,0
1653641476700,ECE 200,005,091007,Cosman; Pamela C.,9999,0,9999,0
1653641476700,ECE 200,006,091008,Staff,9999,0,9999,0
1653641476700,ECE 200,007,091009,Dayeh; Shadi Ahmad,9999,0,9999,0
1653641476700,ECE 200,008,091010,Fainman; Yeshaiahu,9999,0,9999,0
1653641476700,ECE 200,009,091011,Ford; Joseph Earl,9999,0,9999,0
1653641476700,ECE 200,010,091012,Franceschetti; Massimo,9999,0,9999,0
1653641476700,ECE 200,011,091013,Fullerton; Eric E,9999,0,9999,0
1653641476700,ECE 200,012,091014,Galton; Ian A,9999,0,9999,0
1653641476700,ECE 200,013,091015,Gilja; Vikash,9999,0,9999,0
1653641476700,ECE 200,014,091016,Hall; Drew A.,9999,0,9999,0
1653641476700,ECE 200,015,091017,Hsueh; Tzu-Chien,9999,0,9999,0
1653641476700,ECE 200,016,091018,Javidi; Tara,9999,0,9999,0
1653641476700,ECE 200,017,091019,Kahng; Andrew Byun,9999,0,9999,0
1653641476700,ECE 200,018,091020,Kim; Young-Han,9999,0,9999,0
1653641476700,ECE 200,019,091021,Koushanfar; Farinaz,9999,0,9999,0
1653641476700,ECE 200,020,091022,Kuzum; Duygu,9999,0,9999,0
1653641476700,ECE 200,021,091023,Le; Hanh-Phuc,9999,0,9999,0
1653641476700,ECE 200,022,091024,Lin; Bill,9999,0,9999,0
1653641476700,ECE 200,023,091025,Liu; Zhaowei,9999,0,9999,0
1653641476700,ECE 200,024,091026,Lo; Yu-Hwa,9999,0,9999,0
1653641476700,ECE 200,025,091027,Lomakin; Vitaliy,9999,0,9999,0
1653641476700,ECE 200,026,091028,Mercier; Patrick Philip,9999,0,9999,0
1653641476700,ECE 200,027,091029,Meyer; Florian,9999,0,9999,0
1653641476700,ECE 200,028,091030,Milstein; Laurence B.,9999,0,9999,0
1653641476700,ECE 200,029,091031,Mir Arabbaygi; Siavash,9999,0,9999,0
1653641476700,ECE 200,030,091032,Mookherjea; Shayan,9999,0,9999,0
1653641476700,ECE 200,031,091033,Morris; Karcher William,9999,0,9999,0
1653641476700,ECE 200,032,091034,Ng; Tse Nga,9999,0,9999,0
1653641476700,ECE 200,033,091035,Nguyen; Truong Quang,9999,0,9999,0
1653641476700,ECE 200,034,091036,Nomura; Kenji,9999,0,9999,0
1653641476700,ECE 200,035,091037,Orlitsky; Alon,9999,0,9999,0
1653641476700,ECE 200,036,091038,Pal; Piya,9999,0,9999,0
1653641476700,ECE 200,037,091039,Papen; George C.,9999,0,9999,0
1653641476700,ECE 200,038,091040,Radic; Stojan,9999,0,9999,0
1653641476700,ECE 200,039,091041,Rao; Bhaskar D.,9999,0,9999,0
1653641476700,ECE 200,040,091042,Rao; Ramesh R,9999,0,9999,0
1653641476700,ECE 200,041,091043,Rebeiz; Gabriel,9999,0,9999,0
1653641476700,ECE 200,042,091044,Sanford; John R,9999,0,9999,0
1653641476700,ECE 200,043,091045,Siegel; Paul H.,9999,0,9999,0
1653641476700,ECE 200,044,091046,Sievenpiper; Daniel F.,9999,0,9999,0
1653641476700,ECE 200,045,091047,Sworder; David D.,9999,0,9999,0
1653641476700,ECE 200,046,091048,Taur; Yuan,9999,0,9999,0
1653641476700,ECE 200,047,091049,Touri; Behrouz,9999,0,9999,0
1653641476700,ECE 200,048,091050,Trivedi; Mohan M.,9999,0,9999,0
1653641476700,ECE 200,049,091051,Vardy; Alexander,9999,0,9999,0
1653641476700,ECE 200,050,091052,Vasconcelos; Nuno,9999,0,9999,0
1653641476700,ECE 200,051,091053,Wang; Xiaolong,9999,0,9999,0
1653641476700,ECE 200,052,091054,Xie; Pengtao,9999,0,9999,0
1653641476700,ECE 200,053,091055,Yip; Michael,9999,0,9999,0
1653641476700,ECE 200,054,091056,Zeger; Kenneth A.,9999,0,9999,0
1653641476700,ECE 200,055,091057,Zhang; Xinyu,9999,0,9999,0
1653641476700,ECE 200,056,091058,Turakhia; Yatish Girish,9999,0,9999,0
1653641476700,ECE 200,057,091059,Kang; Mingu,9999,0,9999,0
1653641476700,ECE 200,058,091060,Shi; Yuanyuan,9999,0,9999,0
1653641476700,ECE 200,059,091061,Wang; Edward Jay,9999,0,9999,0
1653641476700,ECE 200,060,091062,Zheng; Yang,9999,0,9999,0
1653641477231,ECE 201,A00,095526,Lo; Yu-Hwa,0,0,0,0
1653641477756,ECE 203,A00,091065,Mercier; Patrick Philip,0,0,0,0
1653641478314,ECE 207A,A00,091605,Liu; Thomas Tao-Ming,0,0,0,0
1653641478860,ECE 212AN,A00,091068,Nomura; Kenji,0,0,0,0
1653641479387,ECE 222A,A00,091069,Rebeiz; Gabriel,0,0,0,0
1653641480004,ECE 225A,A00,091070,Orlitsky; Alon,0,0,0,0
1653641480533,ECE 230A,A00,091071,Nomura; Kenji,0,0,0,0
1653641481055,ECE 236A,A00,091072,Dayeh; Shadi Ahmad,0,0,0,0
1653641481581,ECE 238A,A00,091073,Luo; Jian,0,0,0,0
1653641481581,ECE 238A,B00,091074,Luo; Jian,0,0,0,0
1653641482110,ECE 240A,A00,091075,Radic; Stojan,0,0,0,0
1653641482636,ECE 247A,A00,091592,Shi; Lingyan,0,0,0,0
1653641483165,ECE 250,A00,091076,Touri; Behrouz,0,0,0,0
1653641483689,ECE 251C,A00,091078,Nguyen; Truong Quang,0,0,0,0
1653641484246,ECE 253,A00,091079,Cosman; Pamela C.,0,0,0,0
1653641484776,ECE 255A,A00,091080,Orlitsky; Alon,0,0,0,0
1653641485300,ECE 257A,A00,091081,Zhang; Xinyu,0,0,0,0
1653641485824,ECE 260A,A01,091084,Eldon; John,0,0,0,0
1653641486348,ECE 264C,A00,091085,Galton; Ian A,0,0,0,0
1653641486878,ECE 265C,A00,094889,Presti; Calogero Davide,0,0,0,9
1653641487407,ECE 266,A01,091087,Hall; Drew A.,0,0,0,0
1653641488467,ECE 271A,A00,091090,Vasconcelos; Nuno,0,0,0,0
1653641488994,ECE 272B,A00,091091,Sworder; David D.,0,0,0,0
1653641489518,ECE 275A,A00,091092,Meyer; Florian,0,0,0,0
1653641490042,ECE 277,A00,091093,An; Cheolhong,0,0,0,0
1653641490566,ECE 283,A00,091094,Le; Hanh-Phuc,0,0,0,0
1653641491097,ECE 284,A00,091095,Kang; Mingu,0,0,0,0
1653641491097,ECE 284,B00,091096,Wang; Edward Jay,0,0,0,0
1653641491622,ECE 285,A00,094334,Touri; Behrouz,0,0,0,0
1653641492152,ECE 289,A00,091097,Whelan; David Arthur,0,0,0,0
1653641492677,MATH 200A,A00,087414,Salehi Golsefidy; Alireza,7,0,8,1
1653641493201,MATH 202A,A00,087415,Gill; Philip E.,2,0,8,6
1653641493728,MATH 203A,A00,087416,Oprea; Dragos N.,6,0,8,2
1653641494253,MATH 204A,A00,087417,Kedlaya; Kiran S.,6,0,8,2
1653641494779,MATH 205,A00,087418,Sorensen; Claus M,6,0,8,2
1653641495311,MATH 206A,A00,087419,Izadi; Elham,6,0,8,2
1653641495836,MATH 207A,A00,087420,Mohammadi; Amir,5,0,8,3
1653641496361,MATH 208,A00,087421,Staff,8,0,10,2
1653641496890,MATH 209,A00,087422,Staff,10,0,10,0
1653641497418,MATH 218,A00,087423,Staff,10,0,10,0
1653641497943,MATH 220A,A00,087424,Novak; Jonathan I,6,0,8,2
1653641498473,MATH 231A,A00,087425,Bejenaru; Ioan,3,0,8,5
1653641498997,MATH 240A,A00,087426,Ebenfelt; Peter F,5,0,8,3
1653641499521,MATH 243,A00,087427,Staff,9,0,10,1
1653641500047,MATH 248,A00,087429,Staff,10,0,10,0
1653641500575,MATH 250A,A00,087430,Spolaor; Luca,4,0,8,4
1653641501105,MATH 257A,A00,087431,Spolaor; Luca,7,0,8,1
1653641501631,MATH 258,A00,087432,Staff,9,0,10,1
1653641502154,MATH 264A,A00,087433,Warnke; Lutz Peter,5,0,8,3
1653641502679,MATH 268,A00,087434,Staff,15,0,15,0
1653641503205,MATH 269,A00,087435,Staff,14,0,15,1
1653641503730,MATH 270A,A00,087436,Nie; Jiawang,0,0,8,8
1653641504255,MATH 272A,A00,087437,Tian; Xiaochuan,0,0,8,8
1653641504803,MATH 274,A01,087439,Cheng; Li-Tien,9,0,10,1
1653641504803,MATH 274,A02,087440,Cheng; Li-Tien,10,0,10,0
1653641505330,MATH 278A,A00,087441,Staff,8,0,10,2
1653641505853,MATH 278B,A00,087442,Staff,8,0,10,2
1653641506377,MATH 278C,A00,087443,Staff,8,0,10,2
1653641506901,MATH 280A,A00,087444,Zheng; Tianyi,0,0,8,8
1653641507435,MATH 281A,A00,087445,Bradic; Jelena,0,0,8,9
1653641507959,MATH 282A,A00,087446,Zhang; Danna,0,0,8,8
1653641508483,MATH 283,A00,087447,Tesler; Glenn,0,0,0,16
1653641509064,MATH 286,B00,095535,Kemp; Todd Aahron,5,0,8,3
1653641509591,MATH 287D,B00,095536,Bradic; Jelena,5,0,8,3
1653641510117,MATH 288,A00,087450,Staff,14,0,15,1
1653641510117,MATH 288,B00,087451,Staff,15,0,15,0
1653641510117,MATH 288,C00,087452,Staff,15,0,15,0
1653641510640,MATH 290A,A00,087453,Xu; Zhouli,6,0,8,2
1653641511168,MATH 291A,A00,087454,Xu; Zhouli,7,0,8,1
1653641511691,MATH 292,A00,087455,Staff,10,0,10,0
1653641512217,MATH 295,A00,087456,Staff,50,0,50,0
1653641512741,MATH 297,001,087457,Staff,997,0,999,2
1653642073728,COGS 200,A01,087991,Staff,47,0,50,3
1653642074265,COGS 201,A01,094504,Rangel; Lara M,16,0,25,9
1653642074789,COGS 203,A00,087992,Coulson; Seana M,18,0,20,2
1653642075314,COGS 210A,001,087993,Greene; Deanna Jacquelyn,9998,0,9999,1
1653642075314,COGS 210A,002,087994,Saygin; Ayse P,9999,0,9999,0
1653642075314,COGS 210A,003,087995,Xia; Haijun,9999,0,9999,0
1653642075314,COGS 210A,004,087996,Nitz; Douglas A.,9999,0,9999,0
1653642075314,COGS 210A,005,087997,Hollan; James D.,9999,0,9999,0
1653642075314,COGS 210A,006,087998,Deak; Gedeon O.,9998,0,9999,1
1653642075314,COGS 210A,007,087999,Rossano; Federico,9999,0,9999,0
1653642075839,COGS 211A,A00,088000,Coulson; Seana M,9997,0,9999,2
1653642076372,COGS 229,A00,088002,Staff,22,0,25,3
1653642076900,COGS 260,B00,094231,Staff,17,0,20,3
1653642076900,COGS 260,A00,088004,Nitz; Douglas A.,9998,0,9999,1
1653642077434,CSE 202,A00,090110,Paturi; Ramamohan,0,0,0,0
1653642077434,CSE 202,B00,090111,Paturi; Ramamohan,0,0,0,0
1653642077971,CSE 207B,A00,090112,Heninger; Nadia A,0,0,0,0
1653642078500,CSE 208,A00,094858,Micciancio; Daniele,0,0,0,0
1653642079029,CSE 210,A00,090113,Powell; Thomas Allan,0,0,0,0
1653642079555,CSE 219,A00,090898,Staff,0,0,0,0
1653642080079,CSE 221,A00,090114,Zhou; Yuan-Yuan,0,0,0,0
1653642080612,CSE 229A,A00,090115,Porter; George M,0,0,0,0
1653642081140,CSE 229C,A00,090116,Savage; Stefan,0,0,0,0
1653642081670,CSE 230,A00,090117,Jhala; Ranjit,0,0,0,0
1653642082198,CSE 232,A00,090118,Papakonstantinou; Yannis,0,0,0,0
1653642082726,CSE 239A,A00,090121,Kumar; Arun Kumar,0,0,0,0
1653642083255,CSE 239B,A00,090122,Jhala; Ranjit,0,0,0,0
1653642083780,CSE 240A,A00,090123,Zhao; Jishen,0,0,189,189
1653642084308,CSE 243A,A00,090124,Orailoglu; Alex,0,0,15,15
1653642084832,CSE 249B,A00,090125,Kahng; Andrew Byun,12,0,20,8
1653642085361,CSE 250A,A00,090126,Berg-Kirkpatrick; Taylor D,0,0,0,0
1653642085885,CSE 252A,A00,090127,Ochoa; Benjamin Lawrence,0,0,0,0
1653642086414,CSE 258,A01,090129,McAuley; Julian John,0,0,0,0
1653642086940,CSE 258R,A01,090131,McAuley; Julian John,0,0,0,0
1653642087468,CSE 274,A00,090132,Ramamoorthi; Ravi,0,0,0,0
1653642087992,CSE 276A,A00,090133,Christensen; Henrik I,0,0,0,0
1653642088519,CSE 276C,A00,090134,Christensen; Henrik I,0,0,0,0
1653642089046,CSE 290,A00,090135,Bafna; Vineet,0,0,0,0
1653642089046,CSE 290,B00,090136,Ramamoorthi; Ravi,0,0,0,0
1653642089046,CSE 290,C00,090137,Li; Tzumao,7,0,10,3
1653642089046,CSE 290,D00,090138,Zhou; Yuan-Yuan,9,0,10,1
1653642089046,CSE 290,E00,090139,Christensen; Henrik I,8,0,10,2
1653642089046,CSE 290,F00,094053,Shalev; Aaron D,0,0,0,0
1653642089573,CSE 291,A00,090140,Munyaka; Imani N. S.,0,0,0,0
1653642089573,CSE 291,B00,094880,Yu; Qi,0,0,0,0
1653642089573,CSE 291,C00,090142,Pannuto; Patrick William,0,0,0,0
1653642089573,CSE 291,D00,094881,Zhang; Yiying,0,0,0,0
1653642089573,CSE 291,E00,095118,Su; Hao,0,0,0,0
1653642090110,CSE 293,001,094905,Bafna; Vineet,9999,0,9999,0
1653642090110,CSE 293,002,094906,Bellare; Mihir,9999,0,9999,0
1653642090110,CSE 293,003,094907,Berg-Kirkpatrick; Taylor D,9999,0,9999,0
1653642090110,CSE 293,004,094908,Christensen; Henrik I,9999,0,9999,0
1653642090110,CSE 293,005,094909,Cottrell; Garrison W,9999,0,9999,0
1653642090110,CSE 293,006,094910,Deutsch; Alin Bernard,9999,0,9999,0
1653642090110,CSE 293,007,094911,Esmaeilzadeh; Hadi,9999,0,9999,0
1653642090110,CSE 293,008,094912,Freund; Yoav,9999,0,9999,0
1653642090110,CSE 293,009,094913,Griswold; William G.,9999,0,9999,0
1653642090110,CSE 293,010,094914,Gymrek; Melissa Ann,9999,0,9999,0
1653642090110,CSE 293,011,094915,Heninger; Nadia A,9999,0,9999,0
1653642090110,CSE 293,012,094916,Impagliazzo; Russell,9999,0,9999,0
1653642090110,CSE 293,013,094917,Jhala; Ranjit,9999,0,9999,0
1653642090110,CSE 293,014,094918,Kahng; Andrew Byun,9999,0,9999,0
1653642090110,CSE 293,015,094919,Kane; Daniel Mertz,9999,0,9999,0
1653642090110,CSE 293,016,094920,Kriegman; David J,9999,0,9999,0
1653642090110,CSE 293,017,094921,Kumar; Arun Kumar,9999,0,9999,0
1653642090110,CSE 293,018,094922,Lerner; Sorin,9999,0,9999,0
1653642090110,CSE 293,019,094923,Lovett; Shachar,9999,0,9999,0
1653642090110,CSE 293,020,094924,McAuley; Julian John,9999,0,9999,0
1653642090110,CSE 293,021,094925,Micciancio; Daniele,9999,0,9999,0
1653642090110,CSE 293,022,094926,Orailoglu; Alex,9999,0,9999,0
1653642090110,CSE 293,023,094927,Paturi; Ramamohan,9999,0,9999,0
1653642090110,CSE 293,024,094928,Polikarpova; Nadezhda,9999,0,9999,0
1653642090110,CSE 293,025,094929,Politz; Joseph Gibbs,9999,0,9999,0
1653642090110,CSE 293,026,094930,Porter; George M,9999,0,9999,0
1653642090110,CSE 293,027,094931,Porter; Leonard Emerson,9999,0,9999,0
1653642090110,CSE 293,028,094932,Ramamoorthi; Ravi,9999,0,9999,0
1653642090110,CSE 293,029,094933,Sahoo; Debashis,9999,0,9999,0
1653642090110,CSE 293,030,094934,Saul; Lawrence,9999,0,9999,0
1653642090110,CSE 293,031,094935,Savage; Stefan,9999,0,9999,0
1653642090110,CSE 293,032,094936,Schulze; Jurgen P.,9999,0,9999,0
1653642090110,CSE 293,033,094937,Snoeren; Alex C.,9999,0,9999,0
1653642090110,CSE 293,034,094938,Shang; Jingbo,9999,0,9999,0
1653642090110,CSE 293,035,094939,Stefan; Deian,9999,0,9999,0
1653642090110,CSE 293,036,094940,Su; Hao,9999,0,9999,0
1653642090110,CSE 293,037,094941,Swanson; Steven James,9999,0,9999,0
1653642090110,CSE 293,038,094942,Tullsen; Dean Michael,9999,0,9999,0
1653642090110,CSE 293,039,094943,Voelker; Geoffrey M.,9999,0,9999,0
1653642090110,CSE 293,040,094944,Zhao; Jishen,9999,0,9999,0
1653642090110,CSE 293,041,094945,Zhou; Yuan-Yuan,9999,0,9999,0
1653642090110,CSE 293,042,094946,Gao; Sicun,9998,0,9999,1
1653642090110,CSE 293,043,094947,Weibel; Nadir,9999,0,9999,0
1653642090110,CSE 293,044,094948,Gupta; Rajesh K.,9999,0,9999,0
1653642090637,CSE 294,A00,090143,Porter; George M,9,0,10,1
1653642091166,DSE 200,A00,091799,Staff,50,0,50,0
1653642091691,DSE 203,A00,091800,Gupta; Amarnath,30,0,30,0
1653642092218,DSE 250,A00,091801,Deutsch; Alin Bernard,30,0,30,0
1653642092742,DSE 290,A00,091802,Altintas De Callaf; Ilkay,50,0,50,0
1653642093324,ECE 200,001,091003,Antipa; Nicholas A,9999,0,9999,0
1653642093324,ECE 200,002,091004,Atanasov; Nikolay A.,9999,0,9999,0
1653642093324,ECE 200,003,091005,Bharadia; Dinesh,9999,0,9999,0
1653642093324,ECE 200,004,091006,Cheng; Chung Kuan,9999,0,9999,0
1653642093324,ECE 200,005,091007,Cosman; Pamela C.,9999,0,9999,0
1653642093324,ECE 200,006,091008,Staff,9999,0,9999,0
1653642093324,ECE 200,007,091009,Dayeh; Shadi Ahmad,9999,0,9999,0
1653642093324,ECE 200,008,091010,Fainman; Yeshaiahu,9999,0,9999,0
1653642093324,ECE 200,009,091011,Ford; Joseph Earl,9999,0,9999,0
1653642093324,ECE 200,010,091012,Franceschetti; Massimo,9999,0,9999,0
1653642093324,ECE 200,011,091013,Fullerton; Eric E,9999,0,9999,0
1653642093324,ECE 200,012,091014,Galton; Ian A,9999,0,9999,0
1653642093324,ECE 200,013,091015,Gilja; Vikash,9999,0,9999,0
1653642093324,ECE 200,014,091016,Hall; Drew A.,9999,0,9999,0
1653642093324,ECE 200,015,091017,Hsueh; Tzu-Chien,9999,0,9999,0
1653642093324,ECE 200,016,091018,Javidi; Tara,9999,0,9999,0
1653642093324,ECE 200,017,091019,Kahng; Andrew Byun,9999,0,9999,0
1653642093324,ECE 200,018,091020,Kim; Young-Han,9999,0,9999,0
1653642093324,ECE 200,019,091021,Koushanfar; Farinaz,9999,0,9999,0
1653642093324,ECE 200,020,091022,Kuzum; Duygu,9999,0,9999,0
1653642093324,ECE 200,021,091023,Le; Hanh-Phuc,9999,0,9999,0
1653642093324,ECE 200,022,091024,Lin; Bill,9999,0,9999,0
1653642093324,ECE 200,023,091025,Liu; Zhaowei,9999,0,9999,0
1653642093324,ECE 200,024,091026,Lo; Yu-Hwa,9999,0,9999,0
1653642093324,ECE 200,025,091027,Lomakin; Vitaliy,9999,0,9999,0
1653642093324,ECE 200,026,091028,Mercier; Patrick Philip,9999,0,9999,0
1653642093324,ECE 200,027,091029,Meyer; Florian,9999,0,9999,0
1653642093324,ECE 200,028,091030,Milstein; Laurence B.,9999,0,9999,0
1653642093324,ECE 200,029,091031,Mir Arabbaygi; Siavash,9999,0,9999,0
1653642093324,ECE 200,030,091032,Mookherjea; Shayan,9999,0,9999,0
1653642093324,ECE 200,031,091033,Morris; Karcher William,9999,0,9999,0
1653642093324,ECE 200,032,091034,Ng; Tse Nga,9999,0,9999,0
1653642093324,ECE 200,033,091035,Nguyen; Truong Quang,9999,0,9999,0
1653642093324,ECE 200,034,091036,Nomura; Kenji,9999,0,9999,0
1653642093324,ECE 200,035,091037,Orlitsky; Alon,9999,0,9999,0
1653642093324,ECE 200,036,091038,Pal; Piya,9999,0,9999,0
1653642093324,ECE 200,037,091039,Papen; George C.,9999,0,9999,0
1653642093324,ECE 200,038,091040,Radic; Stojan,9999,0,9999,0
1653642093324,ECE 200,039,091041,Rao; Bhaskar D.,9999,0,9999,0
1653642093324,ECE 200,040,091042,Rao; Ramesh R,9999,0,9999,0
1653642093324,ECE 200,041,091043,Rebeiz; Gabriel,9999,0,9999,0
1653642093324,ECE 200,042,091044,Sanford; John R,9999,0,9999,0
1653642093324,ECE 200,043,091045,Siegel; Paul H.,9999,0,9999,0
1653642093324,ECE 200,044,091046,Sievenpiper; Daniel F.,9999,0,9999,0
1653642093324,ECE 200,045,091047,Sworder; David D.,9999,0,9999,0
1653642093324,ECE 200,046,091048,Taur; Yuan,9999,0,9999,0
1653642093324,ECE 200,047,091049,Touri; Behrouz,9999,0,9999,0
1653642093324,ECE 200,048,091050,Trivedi; Mohan M.,9999,0,9999,0
1653642093324,ECE 200,049,091051,Vardy; Alexander,9999,0,9999,0
1653642093324,ECE 200,050,091052,Vasconcelos; Nuno,9999,0,9999,0
1653642093324,ECE 200,051,091053,Wang; Xiaolong,9999,0,9999,0
1653642093324,ECE 200,052,091054,Xie; Pengtao,9999,0,9999,0
1653642093324,ECE 200,053,091055,Yip; Michael,9999,0,9999,0
1653642093324,ECE 200,054,091056,Zeger; Kenneth A.,9999,0,9999,0
1653642093324,ECE 200,055,091057,Zhang; Xinyu,9999,0,9999,0
1653642093324,ECE 200,056,091058,Turakhia; Yatish Girish,9999,0,9999,0
1653642093324,ECE 200,057,091059,Kang; Mingu,9999,0,9999,0
1653642093324,ECE 200,058,091060,Shi; Yuanyuan,9999,0,9999,0
1653642093324,ECE 200,059,091061,Wang; Edward Jay,9999,0,9999,0
1653642093324,ECE 200,060,091062,Zheng; Yang,9999,0,9999,0
1653642093853,ECE 201,A00,095526,Lo; Yu-Hwa,0,0,0,0
1653642094384,ECE 203,A00,091065,Mercier; Patrick Philip,0,0,0,0
1653642094909,ECE 207A,A00,091605,Liu; Thomas Tao-Ming,0,0,0,0
1653642095434,ECE 212AN,A00,091068,Nomura; Kenji,0,0,0,0
1653642095961,ECE 222A,A00,091069,Rebeiz; Gabriel,0,0,0,0
1653642096485,ECE 225A,A00,091070,Orlitsky; Alon,0,0,0,0
1653642097009,ECE 230A,A00,091071,Nomura; Kenji,0,0,0,0
1653642097535,ECE 236A,A00,091072,Dayeh; Shadi Ahmad,0,0,0,0
1653642098071,ECE 238A,A00,091073,Luo; Jian,0,0,0,0
1653642098071,ECE 238A,B00,091074,Luo; Jian,0,0,0,0
1653642098595,ECE 240A,A00,091075,Radic; Stojan,0,0,0,0
1653642099123,ECE 247A,A00,091592,Shi; Lingyan,0,0,0,0
1653642099654,ECE 250,A00,091076,Touri; Behrouz,0,0,0,0
1653642100180,ECE 251C,A00,091078,Nguyen; Truong Quang,0,0,0,0
1653642100708,ECE 253,A00,091079,Cosman; Pamela C.,0,0,0,0
1653642101235,ECE 255A,A00,091080,Orlitsky; Alon,0,0,0,0
1653642101761,ECE 257A,A00,091081,Zhang; Xinyu,0,0,0,0
1653642102289,ECE 260A,A01,091084,Eldon; John,0,0,0,0
1653642102816,ECE 264C,A00,091085,Galton; Ian A,0,0,0,0
1653642103348,ECE 265C,A00,094889,Presti; Calogero Davide,0,0,0,9
1653642103873,ECE 266,A01,091087,Hall; Drew A.,0,0,0,0
1653642104934,ECE 271A,A00,091090,Vasconcelos; Nuno,0,0,0,0
1653642105458,ECE 272B,A00,091091,Sworder; David D.,0,0,0,0
1653642105983,ECE 275A,A00,091092,Meyer; Florian,0,0,0,0
1653642106508,ECE 277,A00,091093,An; Cheolhong,0,0,0,0
1653642107032,ECE 283,A00,091094,Le; Hanh-Phuc,0,0,0,0
1653642107573,ECE 284,A00,091095,Kang; Mingu,0,0,0,0
1653642107573,ECE 284,B00,091096,Wang; Edward Jay,0,0,0,0
1653642108096,ECE 285,A00,094334,Touri; Behrouz,0,0,0,0
1653642108621,ECE 289,A00,091097,Whelan; David Arthur,0,0,0,0
1653642109150,MATH 200A,A00,087414,Salehi Golsefidy; Alireza,7,0,8,1
1653642109676,MATH 202A,A00,087415,Gill; Philip E.,2,0,8,6
1653642110200,MATH 203A,A00,087416,Oprea; Dragos N.,6,0,8,2
1653642110726,MATH 204A,A00,087417,Kedlaya; Kiran S.,6,0,8,2
1653642111253,MATH 205,A00,087418,Sorensen; Claus M,6,0,8,2
1653642111778,MATH 206A,A00,087419,Izadi; Elham,6,0,8,2
1653642112302,MATH 207A,A00,087420,Mohammadi; Amir,5,0,8,3
1653642112826,MATH 208,A00,087421,Staff,8,0,10,2
1653642113351,MATH 209,A00,087422,Staff,10,0,10,0
1653642113877,MATH 218,A00,087423,Staff,10,0,10,0
1653642114405,MATH 220A,A00,087424,Novak; Jonathan I,6,0,8,2
1653642114929,MATH 231A,A00,087425,Bejenaru; Ioan,3,0,8,5
1653642115464,MATH 240A,A00,087426,Ebenfelt; Peter F,5,0,8,3
1653642115988,MATH 243,A00,087427,Staff,9,0,10,1
1653642116514,MATH 248,A00,087429,Staff,10,0,10,0
1653642117039,MATH 250A,A00,087430,Spolaor; Luca,4,0,8,4
1653642117563,MATH 257A,A00,087431,Spolaor; Luca,7,0,8,1
1653642118089,MATH 258,A00,087432,Staff,9,0,10,1
1653642118613,MATH 264A,A00,087433,Warnke; Lutz Peter,5,0,8,3
1653642119137,MATH 268,A00,087434,Staff,15,0,15,0
1653642119661,MATH 269,A00,087435,Staff,14,0,15,1
1653642120184,MATH 270A,A00,087436,Nie; Jiawang,0,0,8,8
1653642120708,MATH 272A,A00,087437,Tian; Xiaochuan,0,0,8,8
1653642121235,MATH 274,A01,087439,Cheng; Li-Tien,9,0,10,1
1653642121235,MATH 274,A02,087440,Cheng; Li-Tien,10,0,10,0
1653642121849,MATH 278A,A00,087441,Staff,8,0,10,2
1653642122372,MATH 278B,A00,087442,Staff,8,0,10,2
1653642122898,MATH 278C,A00,087443,Staff,8,0,10,2
1653642123422,MATH 280A,A00,087444,Zheng; Tianyi,0,0,8,8
1653642123946,MATH 281A,A00,087445,Bradic; Jelena,0,0,8,9
1653642124476,MATH 282A,A00,087446,Zhang; Danna,0,0,8,8
1653642125006,MATH 283,A00,087447,Tesler; Glenn,0,0,0,16
1653642125535,MATH 286,B00,095535,Kemp; Todd Aahron,5,0,8,3
1653642126062,MATH 287D,B00,095536,Bradic; Jelena,5,0,8,3
1653642126585,MATH 288,A00,087450,Staff,14,0,15,1
1653642126585,MATH 288,B00,087451,Staff,15,0,15,0
1653642126585,MATH 288,C00,087452,Staff,15,0,15,0
1653642127107,MATH 290A,A00,087453,Xu; Zhouli,6,0,8,2
1653642127636,MATH 291A,A00,087454,Xu; Zhouli,7,0,8,1
1653642128162,MATH 292,A00,087455,Staff,10,0,10,0
1653642128688,MATH 295,A00,087456,Staff,50,0,50,0
1653642129213,MATH 297,001,087457,Staff,997,0,999,2
1653642689233,COGS 200,A01,087991,Staff,47,0,50,3
1653642689763,COGS 201,A01,094504,Rangel; Lara M,16,0,25,9
1653642690288,COGS 203,A00,087992,Coulson; Seana M,18,0,20,2
1653642690814,COGS 210A,001,087993,Greene; Deanna Jacquelyn,9998,0,9999,1
1653642690814,COGS 210A,002,087994,Saygin; Ayse P,9999,0,9999,0
1653642690814,COGS 210A,003,087995,Xia; Haijun,9999,0,9999,0
1653642690814,COGS 210A,004,087996,Nitz; Douglas A.,9999,0,9999,0
1653642690814,COGS 210A,005,087997,Hollan; James D.,9999,0,9999,0
1653642690814,COGS 210A,006,087998,Deak; Gedeon O.,9998,0,9999,1
1653642690814,COGS 210A,007,087999,Rossano; Federico,9999,0,9999,0
1653642691338,COGS 211A,A00,088000,Coulson; Seana M,9997,0,9999,2
1653642691873,COGS 229,A00,088002,Staff,22,0,25,3
1653642692396,COGS 260,B00,094231,Staff,17,0,20,3
1653642692396,COGS 260,A00,088004,Nitz; Douglas A.,9998,0,9999,1
1653642692920,CSE 202,A00,090110,Paturi; Ramamohan,0,0,0,0
1653642692920,CSE 202,B00,090111,Paturi; Ramamohan,0,0,0,0
1653642693443,CSE 207B,A00,090112,Heninger; Nadia A,0,0,0,0
1653642693970,CSE 208,A00,094858,Micciancio; Daniele,0,0,0,0
1653642694493,CSE 210,A00,090113,Powell; Thomas Allan,0,0,0,0
1653642695019,CSE 219,A00,090898,Staff,0,0,0,0
1653642695544,CSE 221,A00,090114,Zhou; Yuan-Yuan,0,0,0,0
1653642696067,CSE 229A,A00,090115,Porter; George M,0,0,0,0
1653642696590,CSE 229C,A00,090116,Savage; Stefan,0,0,0,0
1653642697114,CSE 230,A00,090117,Jhala; Ranjit,0,0,0,0
1653642697642,CSE 232,A00,090118,Papakonstantinou; Yannis,0,0,0,0
1653642698169,CSE 239A,A00,090121,Kumar; Arun Kumar,0,0,0,0
1653642698697,CSE 239B,A00,090122,Jhala; Ranjit,0,0,0,0
1653642699222,CSE 240A,A00,090123,Zhao; Jishen,0,0,189,189
1653642699745,CSE 243A,A00,090124,Orailoglu; Alex,0,0,15,15
1653642700283,CSE 249B,A00,090125,Kahng; Andrew Byun,12,0,20,8
1653642700807,CSE 250A,A00,090126,Berg-Kirkpatrick; Taylor D,0,0,0,0
1653642701335,CSE 252A,A00,090127,Ochoa; Benjamin Lawrence,0,0,0,0
1653642701858,CSE 258,A01,090129,McAuley; Julian John,0,0,0,0
1653642702381,CSE 258R,A01,090131,McAuley; Julian John,0,0,0,0
1653642702908,CSE 274,A00,090132,Ramamoorthi; Ravi,0,0,0,0
1653642703433,CSE 276A,A00,090133,Christensen; Henrik I,0,0,0,0
1653642703972,CSE 276C,A00,090134,Christensen; Henrik I,0,0,0,0
1653642704504,CSE 290,A00,090135,Bafna; Vineet,0,0,0,0
1653642704504,CSE 290,B00,090136,Ramamoorthi; Ravi,0,0,0,0
1653642704504,CSE 290,C00,090137,Li; Tzumao,7,0,10,3
1653642704504,CSE 290,D00,090138,Zhou; Yuan-Yuan,9,0,10,1
1653642704504,CSE 290,E00,090139,Christensen; Henrik I,8,0,10,2
1653642704504,CSE 290,F00,094053,Shalev; Aaron D,0,0,0,0
1653642705029,CSE 291,A00,090140,Munyaka; Imani N. S.,0,0,0,0
1653642705029,CSE 291,B00,094880,Yu; Qi,0,0,0,0
1653642705029,CSE 291,C00,090142,Pannuto; Patrick William,0,0,0,0
1653642705029,CSE 291,D00,094881,Zhang; Yiying,0,0,0,0
1653642705029,CSE 291,E00,095118,Su; Hao,0,0,0,0
1653642705574,CSE 293,001,094905,Bafna; Vineet,9999,0,9999,0
1653642705574,CSE 293,002,094906,Bellare; Mihir,9999,0,9999,0
1653642705574,CSE 293,003,094907,Berg-Kirkpatrick; Taylor D,9999,0,9999,0
1653642705574,CSE 293,004,094908,Christensen; Henrik I,9999,0,9999,0
1653642705574,CSE 293,005,094909,Cottrell; Garrison W,9999,0,9999,0
1653642705574,CSE 293,006,094910,Deutsch; Alin Bernard,9999,0,9999,0
1653642705574,CSE 293,007,094911,Esmaeilzadeh; Hadi,9999,0,9999,0
1653642705574,CSE 293,008,094912,Freund; Yoav,9999,0,9999,0
1653642705574,CSE 293,009,094913,Griswold; William G.,9999,0,9999,0
1653642705574,CSE 293,010,094914,Gymrek; Melissa Ann,9999,0,9999,0
1653642705574,CSE 293,011,094915,Heninger; Nadia A,9999,0,9999,0
1653642705574,CSE 293,012,094916,Impagliazzo; Russell,9999,0,9999,0
1653642705574,CSE 293,013,094917,Jhala; Ranjit,9999,0,9999,0
1653642705574,CSE 293,014,094918,Kahng; Andrew Byun,9999,0,9999,0
1653642705574,CSE 293,015,094919,Kane; Daniel Mertz,9999,0,9999,0
1653642705574,CSE 293,016,094920,Kriegman; David J,9999,0,9999,0
1653642705574,CSE 293,017,094921,Kumar; Arun Kumar,9999,0,9999,0
1653642705574,CSE 293,018,094922,Lerner; Sorin,9999,0,9999,0
1653642705574,CSE 293,019,094923,Lovett; Shachar,9999,0,9999,0
1653642705574,CSE 293,020,094924,McAuley; Julian John,9999,0,9999,0
1653642705574,CSE 293,021,094925,Micciancio; Daniele,9999,0,9999,0
1653642705574,CSE 293,022,094926,Orailoglu; Alex,9999,0,9999,0
1653642705574,CSE 293,023,094927,Paturi; Ramamohan,9999,0,9999,0
1653642705574,CSE 293,024,094928,Polikarpova; Nadezhda,9999,0,9999,0
1653642705574,CSE 293,025,094929,Politz; Joseph Gibbs,9999,0,9999,0
1653642705574,CSE 293,026,094930,Porter; George M,9999,0,9999,0
1653642705574,CSE 293,027,094931,Porter; Leonard Emerson,9999,0,9999,0
1653642705574,CSE 293,028,094932,Ramamoorthi; Ravi,9999,0,9999,0
1653642705574,CSE 293,029,094933,Sahoo; Debashis,9999,0,9999,0
1653642705574,CSE 293,030,094934,Saul; Lawrence,9999,0,9999,0
1653642705574,CSE 293,031,094935,Savage; Stefan,9999,0,9999,0
1653642705574,CSE 293,032,094936,Schulze; Jurgen P.,9999,0,9999,0
1653642705574,CSE 293,033,094937,Snoeren; Alex C.,9999,0,9999,0
1653642705574,CSE 293,034,094938,Shang; Jingbo,9999,0,9999,0
1653642705574,CSE 293,035,094939,Stefan; Deian,9999,0,9999,0
1653642705574,CSE 293,036,094940,Su; Hao,9999,0,9999,0
1653642705574,CSE 293,037,094941,Swanson; Steven James,9999,0,9999,0
1653642705574,CSE 293,038,094942,Tullsen; Dean Michael,9999,0,9999,0
1653642705574,CSE 293,039,094943,Voelker; Geoffrey M.,9999,0,9999,0
1653642705574,CSE 293,040,094944,Zhao; Jishen,9999,0,9999,0
1653642705574,CSE 293,041,094945,Zhou; Yuan-Yuan,9999,0,9999,0
1653642705574,CSE 293,042,094946,Gao; Sicun,9998,0,9999,1
1653642705574,CSE 293,043,094947,Weibel; Nadir,9999,0,9999,0
1653642705574,CSE 293,044,094948,Gupta; Rajesh K.,9999,0,9999,0
1653642706098,CSE 294,A00,090143,Porter; George M,9,0,10,1
1653642706625,DSE 200,A00,091799,Staff,50,0,50,0
1653642707150,DSE 203,A00,091800,Gupta; Amarnath,30,0,30,0
1653642707676,DSE 250,A00,091801,Deutsch; Alin Bernard,30,0,30,0
1653642708199,DSE 290,A00,091802,Altintas De Callaf; Ilkay,50,0,50,0
1653642708753,ECE 200,001,091003,Antipa; Nicholas A,9999,0,9999,0
1653642708753,ECE 200,002,091004,Atanasov; Nikolay A.,9999,0,9999,0
1653642708753,ECE 200,003,091005,Bharadia; Dinesh,9999,0,9999,0
1653642708753,ECE 200,004,091006,Cheng; Chung Kuan,9999,0,9999,0
1653642708753,ECE 200,005,091007,Cosman; Pamela C.,9999,0,9999,0
1653642708753,ECE 200,006,091008,Staff,9999,0,9999,0
1653642708753,ECE 200,007,091009,Dayeh; Shadi Ahmad,9999,0,9999,0
1653642708753,ECE 200,008,091010,Fainman; Yeshaiahu,9999,0,9999,0
1653642708753,ECE 200,009,091011,Ford; Joseph Earl,9999,0,9999,0
1653642708753,ECE 200,010,091012,Franceschetti; Massimo,9999,0,9999,0
1653642708753,ECE 200,011,091013,Fullerton; Eric E,9999,0,9999,0
1653642708753,ECE 200,012,091014,Galton; Ian A,9999,0,9999,0
1653642708753,ECE 200,013,091015,Gilja; Vikash,9999,0,9999,0
1653642708753,ECE 200,014,091016,Hall; Drew A.,9999,0,9999,0
1653642708753,ECE 200,015,091017,Hsueh; Tzu-Chien,9999,0,9999,0
1653642708753,ECE 200,016,091018,Javidi; Tara,9999,0,9999,0
1653642708753,ECE 200,017,091019,Kahng; Andrew Byun,9999,0,9999,0
1653642708753,ECE 200,018,091020,Kim; Young-Han,9999,0,9999,0
1653642708753,ECE 200,019,091021,Koushanfar; Farinaz,9999,0,9999,0
1653642708753,ECE 200,020,091022,Kuzum; Duygu,9999,0,9999,0
1653642708753,ECE 200,021,091023,Le; Hanh-Phuc,9999,0,9999,0
1653642708753,ECE 200,022,091024,Lin; Bill,9999,0,9999,0
1653642708753,ECE 200,023,091025,Liu; Zhaowei,9999,0,9999,0
1653642708753,ECE 200,024,091026,Lo; Yu-Hwa,9999,0,9999,0
1653642708753,ECE 200,025,091027,Lomakin; Vitaliy,9999,0,9999,0
1653642708753,ECE 200,026,091028,Mercier; Patrick Philip,9999,0,9999,0
1653642708753,ECE 200,027,091029,Meyer; Florian,9999,0,9999,0
1653642708753,ECE 200,028,091030,Milstein; Laurence B.,9999,0,9999,0
1653642708753,ECE 200,029,091031,Mir Arabbaygi; Siavash,9999,0,9999,0
1653642708753,ECE 200,030,091032,Mookherjea; Shayan,9999,0,9999,0
1653642708753,ECE 200,031,091033,Morris; Karcher William,9999,0,9999,0
1653642708753,ECE 200,032,091034,Ng; Tse Nga,9999,0,9999,0
1653642708753,ECE 200,033,091035,Nguyen; Truong Quang,9999,0,9999,0
1653642708753,ECE 200,034,091036,Nomura; Kenji,9999,0,9999,0
1653642708753,ECE 200,035,091037,Orlitsky; Alon,9999,0,9999,0
1653642708753,ECE 200,036,091038,Pal; Piya,9999,0,9999,0
1653642708753,ECE 200,037,091039,Papen; George C.,9999,0,9999,0
1653642708753,ECE 200,038,091040,Radic; Stojan,9999,0,9999,0
1653642708753,ECE 200,039,091041,Rao; Bhaskar D.,9999,0,9999,0
1653642708753,ECE 200,040,091042,Rao; Ramesh R,9999,0,9999,0
1653642708753,ECE 200,041,091043,Rebeiz; Gabriel,9999,0,9999,0
1653642708753,ECE 200,042,091044,Sanford; John R,9999,0,9999,0
1653642708753,ECE 200,043,091045,Siegel; Paul H.,9999,0,9999,0
1653642708753,ECE 200,044,091046,Sievenpiper; Daniel F.,9999,0,9999,0
1653642708753,ECE 200,045,091047,Sworder; David D.,9999,0,9999,0
1653642708753,ECE 200,046,091048,Taur; Yuan,9999,0,9999,0
1653642708753,ECE 200,047,091049,Touri; Behrouz,9999,0,9999,0
1653642708753,ECE 200,048,091050,Trivedi; Mohan M.,9999,0,9999,0
1653642708753,ECE 200,049,091051,Vardy; Alexander,9999,0,9999,0
1653642708753,ECE 200,050,091052,Vasconcelos; Nuno,9999,0,9999,0
1653642708753,ECE 200,051,091053,Wang; Xiaolong,9999,0,9999,0
1653642708753,ECE 200,052,091054,Xie; Pengtao,9999,0,9999,0
1653642708753,ECE 200,053,091055,Yip; Michael,9999,0,9999,0
1653642708753,ECE 200,054,091056,Zeger; Kenneth A.,9999,0,9999,0
1653642708753,ECE 200,055,091057,Zhang; Xinyu,9999,0,9999,0
1653642708753,ECE 200,056,091058,Turakhia; Yatish Girish,9999,0,9999,0
1653642708753,ECE 200,057,091059,Kang; Mingu,9999,0,9999,0
1653642708753,ECE 200,058,091060,Shi; Yuanyuan,9999,0,9999,0
1653642708753,ECE 200,059,091061,Wang; Edward Jay,9999,0,9999,0
1653642708753,ECE 200,060,091062,Zheng; Yang,9999,0,9999,0
1653642709349,ECE 201,A00,095526,Lo; Yu-Hwa,0,0,0,0
1653642709874,ECE 203,A00,091065,Mercier; Patrick Philip,0,0,0,0
1653642710398,ECE 207A,A00,091605,Liu; Thomas Tao-Ming,0,0,0,0
1653642710923,ECE 212AN,A00,091068,Nomura; Kenji,0,0,0,0
1653642711450,ECE 222A,A00,091069,Rebeiz; Gabriel,0,0,0,0
1653642711977,ECE 225A,A00,091070,Orlitsky; Alon,0,0,0,0
1653642712499,ECE 230A,A00,091071,Nomura; Kenji,0,0,0,0
1653642713025,ECE 236A,A00,091072,Dayeh; Shadi Ahmad,0,0,0,0
1653642713549,ECE 238A,A00,091073,Luo; Jian,0,0,0,0
1653642713549,ECE 238A,B00,091074,Luo; Jian,0,0,0,0
1653642714072,ECE 240A,A00,091075,Radic; Stojan,0,0,0,0
1653642714598,ECE 247A,A00,091592,Shi; Lingyan,0,0,0,0
1653642715125,ECE 250,A00,091076,Touri; Behrouz,0,0,0,0
1653642715651,ECE 251C,A00,091078,Nguyen; Truong Quang,0,0,0,0
1653642716175,ECE 253,A00,091079,Cosman; Pamela C.,0,0,0,0
1653642716698,ECE 255A,A00,091080,Orlitsky; Alon,0,0,0,0
1653642717220,ECE 257A,A00,091081,Zhang; Xinyu,0,0,0,0
1653642717743,ECE 260A,A01,091084,Eldon; John,0,0,0,0
1653642718269,ECE 264C,A00,091085,Galton; Ian A,0,0,0,0
1653642718793,ECE 265C,A00,094889,Presti; Calogero Davide,0,0,0,9
1653642719320,ECE 266,A01,091087,Hall; Drew A.,0,0,0,0
1653642720371,ECE 271A,A00,091090,Vasconcelos; Nuno,0,0,0,0
1653642720895,ECE 272B,A00,091091,Sworder; David D.,0,0,0,0
1653642721430,ECE 275A,A00,091092,Meyer; Florian,0,0,0,0
1653642721959,ECE 277,A00,091093,An; Cheolhong,0,0,0,0
1653642722486,ECE 283,A00,091094,Le; Hanh-Phuc,0,0,0,0
1653642723012,ECE 284,A00,091095,Kang; Mingu,0,0,0,0
1653642723012,ECE 284,B00,091096,Wang; Edward Jay,0,0,0,0
1653642723536,ECE 285,A00,094334,Touri; Behrouz,0,0,0,0
1653642724073,ECE 289,A00,091097,Whelan; David Arthur,0,0,0,0
1653642724596,MATH 200A,A00,087414,Salehi Golsefidy; Alireza,7,0,8,1
1653642725120,MATH 202A,A00,087415,Gill; Philip E.,2,0,8,6
1653642725649,MATH 203A,A00,087416,Oprea; Dragos N.,6,0,8,2
1653642726180,MATH 204A,A00,087417,Kedlaya; Kiran S.,6,0,8,2
1653642726703,MATH 205,A00,087418,Sorensen; Claus M,6,0,8,2
1653642727227,MATH 206A,A00,087419,Izadi; Elham,6,0,8,2
1653642727751,MATH 207A,A00,087420,Mohammadi; Amir,5,0,8,3
1653642728275,MATH 208,A00,087421,Staff,8,0,10,2
1653642728801,MATH 209,A00,087422,Staff,10,0,10,0
1653642729324,MATH 218,A00,087423,Staff,10,0,10,0
1653642729847,MATH 220A,A00,087424,Novak; Jonathan I,6,0,8,2
1653642730374,MATH 231A,A00,087425,Bejenaru; Ioan,3,0,8,5
1653642730899,MATH 240A,A00,087426,Ebenfelt; Peter F,5,0,8,3
1653642731424,MATH 243,A00,087427,Staff,9,0,10,1
1653642731947,MATH 248,A00,087429,Staff,10,0,10,0
1653642732473,MATH 250A,A00,087430,Spolaor; Luca,4,0,8,4
1653642732997,MATH 257A,A00,087431,Spolaor; Luca,7,0,8,1
1653642733522,MATH 258,A00,087432,Staff,9,0,10,1
1653642734047,MATH 264A,A00,087433,Warnke; Lutz Peter,5,0,8,3
1653642734572,MATH 268,A00,087434,Staff,15,0,15,0
1653642735097,MATH 269,A00,087435,Staff,14,0,15,1
1653642735620,MATH 270A,A00,087436,Nie; Jiawang,0,0,8,8
1653642736151,MATH 272A,A00,087437,Tian; Xiaochuan,0,0,8,8
1653642736675,MATH 274,A01,087439,Cheng; Li-Tien,9,0,10,1
1653642736675,MATH 274,A02,087440,Cheng; Li-Tien,10,0,10,0
1653642737200,MATH 278A,A00,087441,Staff,8,0,10,2
1653642737723,MATH 278B,A00,087442,Staff,8,0,10,2
1653642738246,MATH 278C,A00,087443,Staff,8,0,10,2
1653642738769,MATH 280A,A00,087444,Zheng; Tianyi,0,0,8,8
1653642739295,MATH 281A,A00,087445,Bradic; Jelena,0,0,8,9
1653642739819,MATH 282A,A00,087446,Zhang; Danna,0,0,8,8
1653642740357,MATH 283,A00,087447,Tesler; Glenn,0,0,0,16
1653642740884,MATH 286,B00,095535,Kemp; Todd Aahron,5,0,8,3
1653642741421,MATH 287D,B00,095536,Bradic; Jelena,5,0,8,3
1653642741944,MATH 288,A00,087450,Staff,14,0,15,1
1653642741944,MATH 288,B00,087451,Staff,15,0,15,0
1653642741944,MATH 288,C00,087452,Staff,15,0,15,0
1653642742470,MATH 290A,A00,087453,Xu; Zhouli,6,0,8,2
1653642742993,MATH 291A,A00,087454,Xu; Zhouli,7,0,8,1
1653642743518,MATH 292,A00,087455,Staff,10,0,10,0
1653642744040,MATH 295,A00,087456,Staff,50,0,50,0
1653642744577,MATH 297,001,087457,Staff,997,0,999,2
1653643304168,COGS 200,A01,087991,Staff,47,0,50,3
1653643304696,COGS 201,A01,094504,Rangel; Lara M,16,0,25,9
1653643305221,COGS 203,A00,087992,Coulson; Seana M,18,0,20,2
1653643305749,COGS 210A,001,087993,Greene; Deanna Jacquelyn,9998,0,9999,1
1653643305749,COGS 210A,002,087994,Saygin; Ayse P,9999,0,9999,0
1653643305749,COGS 210A,003,087995,Xia; Haijun,9999,0,9999,0
1653643305749,COGS 210A,004,087996,Nitz; Douglas A.,9999,0,9999,0
1653643305749,COGS 210A,005,087997,Hollan; James D.,9999,0,9999,0
1653643305749,COGS 210A,006,087998,Deak; Gedeon O.,9998,0,9999,1
1653643305749,COGS 210A,007,087999,Rossano; Federico,9999,0,9999,0
1653643306272,COGS 211A,A00,088000,Coulson; Seana M,9997,0,9999,2
1653643306795,COGS 229,A00,088002,Staff,22,0,25,3
1653643307319,COGS 260,B00,094231,Staff,17,0,20,3
1653643307319,COGS 260,A00,088004,Nitz; Douglas A.,9998,0,9999,1
1653643307852,CSE 202,A00,090110,Paturi; Ramamohan,0,0,0,0
1653643307852,CSE 202,B00,090111,Paturi; Ramamohan,0,0,0,0
1653643308377,CSE 207B,A00,090112,Heninger; Nadia A,0,0,0,0
1653643308907,CSE 208,A00,094858,Micciancio; Daniele,0,0,0,0
1653643309433,CSE 210,A00,090113,Powell; Thomas Allan,0,0,0,0
1653643309961,CSE 219,A00,090898,Staff,0,0,0,0
1653643310485,CSE 221,A00,090114,Zhou; Yuan-Yuan,0,0,0,0
1653643311015,CSE 229A,A00,090115,Porter; George M,0,0,0,0
1653643311548,CSE 229C,A00,090116,Savage; Stefan,0,0,0,0
1653643312075,CSE 230,A00,090117,Jhala; Ranjit,0,0,0,0
1653643312600,CSE 232,A00,090118,Papakonstantinou; Yannis,0,0,0,0
1653643313127,CSE 239A,A00,090121,Kumar; Arun Kumar,0,0,0,0
1653643313651,CSE 239B,A00,090122,Jhala; Ranjit,0,0,0,0
1653643314175,CSE 240A,A00,090123,Zhao; Jishen,0,0,189,189
1653643314701,CSE 243A,A00,090124,Orailoglu; Alex,0,0,15,15
1653643315229,CSE 249B,A00,090125,Kahng; Andrew Byun,12,0,20,8
1653643315755,CSE 250A,A00,090126,Berg-Kirkpatrick; Taylor D,0,0,0,0
1653643316287,CSE 252A,A00,090127,Ochoa; Benjamin Lawrence,0,0,0,0
1653643316813,CSE 258,A01,090129,McAuley; Julian John,0,0,0,0
1653643317349,CSE 258R,A01,090131,McAuley; Julian John,0,0,0,0
1653643317877,CSE 274,A00,090132,Ramamoorthi; Ravi,0,0,0,0
1653643318407,CSE 276A,A00,090133,Christensen; Henrik I,0,0,0,0
1653643318930,CSE 276C,A00,090134,Christensen; Henrik I,0,0,0,0
1653643319463,CSE 290,A00,090135,Bafna; Vineet,0,0,0,0
1653643319463,CSE 290,B00,090136,Ramamoorthi; Ravi,0,0,0,0
1653643319463,CSE 290,C00,090137,Li; Tzumao,7,0,10,3
1653643319463,CSE 290,D00,090138,Zhou; Yuan-Yuan,9,0,10,1
1653643319463,CSE 290,E00,090139,Christensen; Henrik I,8,0,10,2
1653643319463,CSE 290,F00,094053,Shalev; Aaron D,0,0,0,0
1653643319991,CSE 291,A00,090140,Munyaka; Imani N. S.,0,0,0,0
1653643319991,CSE 291,B00,094880,Yu; Qi,0,0,0,0
1653643319991,CSE 291,C00,090142,Pannuto; Patrick William,0,0,0,0
1653643319991,CSE 291,D00,094881,Zhang; Yiying,0,0,0,0
1653643319991,CSE 291,E00,095118,Su; Hao,0,0,0,0
1653643320533,CSE 293,001,094905,Bafna; Vineet,9999,0,9999,0
1653643320533,CSE 293,002,094906,Bellare; Mihir,9999,0,9999,0
1653643320533,CSE 293,003,094907,Berg-Kirkpatrick; Taylor D,9999,0,9999,0
1653643320533,CSE 293,004,094908,Christensen; Henrik I,9999,0,9999,0
1653643320533,CSE 293,005,094909,Cottrell; Garrison W,9999,0,9999,0
1653643320533,CSE 293,006,094910,Deutsch; Alin Bernard,9999,0,9999,0
1653643320533,CSE 293,007,094911,Esmaeilzadeh; Hadi,9999,0,9999,0
1653643320533,CSE 293,008,094912,Freund; Yoav,9999,0,9999,0
1653643320533,CSE 293,009,094913,Griswold; William G.,9999,0,9999,0
1653643320533,CSE 293,010,094914,Gymrek; Melissa Ann,9999,0,9999,0
1653643320533,CSE 293,011,094915,Heninger; Nadia A,9999,0,9999,0
1653643320533,CSE 293,012,094916,Impagliazzo; Russell,9999,0,9999,0
1653643320533,CSE 293,013,094917,Jhala; Ranjit,9999,0,9999,0
1653643320533,CSE 293,014,094918,Kahng; Andrew Byun,9999,0,9999,0
1653643320533,CSE 293,015,094919,Kane; Daniel Mertz,9999,0,9999,0
1653643320533,CSE 293,016,094920,Kriegman; David J,9999,0,9999,0
1653643320533,CSE 293,017,094921,Kumar; Arun Kumar,9999,0,9999,0
1653643320533,CSE 293,018,094922,Lerner; Sorin,9999,0,9999,0
1653643320533,CSE 293,019,094923,Lovett; Shachar,9999,0,9999,0
1653643320533,CSE 293,020,094924,McAuley; Julian John,9999,0,9999,0
1653643320533,CSE 293,021,094925,Micciancio; Daniele,9999,0,9999,0
1653643320533,CSE 293,022,094926,Orailoglu; Alex,9999,0,9999,0
1653643320533,CSE 293,023,094927,Paturi; Ramamohan,9999,0,9999,0
1653643320533,CSE 293,024,094928,Polikarpova; Nadezhda,9999,0,9999,0
1653643320533,CSE 293,025,094929,Politz; Joseph Gibbs,9999,0,9999,0
1653643320533,CSE 293,026,094930,Porter; George M,9999,0,9999,0
1653643320533,CSE 293,027,094931,Porter; Leonard Emerson,9999,0,9999,0
1653643320533,CSE 293,028,094932,Ramamoorthi; Ravi,9999,0,9999,0
1653643320533,CSE 293,029,094933,Sahoo; Debashis,9999,0,9999,0
1653643320533,CSE 293,030,094934,Saul; Lawrence,9999,0,9999,0
1653643320533,CSE 293,031,094935,Savage; Stefan,9999,0,9999,0
1653643320533,CSE 293,032,094936,Schulze; Jurgen P.,9999,0,9999,0
1653643320533,CSE 293,033,094937,Snoeren; Alex C.,9999,0,9999,0
1653643320533,CSE 293,034,094938,Shang; Jingbo,9999,0,9999,0
1653643320533,CSE 293,035,094939,Stefan; Deian,9999,0,9999,0
1653643320533,CSE 293,036,094940,Su; Hao,9999,0,9999,0
1653643320533,CSE 293,037,094941,Swanson; Steven James,9999,0,9999,0
1653643320533,CSE 293,038,094942,Tullsen; Dean Michael,9999,0,9999,0
1653643320533,CSE 293,039,094943,Voelker; Geoffrey M.,9999,0,9999,0
1653643320533,CSE 293,040,094944,Zhao; Jishen,9999,0,9999,0
1653643320533,CSE 293,041,094945,Zhou; Yuan-Yuan,9999,0,9999,0
1653643320533,CSE 293,042,094946,Gao; Sicun,9998,0,9999,1
1653643320533,CSE 293,043,094947,Weibel; Nadir,9999,0,9999,0
1653643320533,CSE 293,044,094948,Gupta; Rajesh K.,9999,0,9999,0
1653643321060,CSE 294,A00,090143,Porter; George M,9,0,10,1
1653643321588,DSE 200,A00,091799,Staff,50,0,50,0
1653643322111,DSE 203,A00,091800,Gupta; Amarnath,30,0,30,0
1653643322635,DSE 250,A00,091801,Deutsch; Alin Bernard,30,0,30,0
1653643323160,DSE 290,A00,091802,Altintas De Callaf; Ilkay,50,0,50,0
1653643323726,ECE 200,001,091003,Antipa; Nicholas A,9999,0,9999,0
1653643323726,ECE 200,002,091004,Atanasov; Nikolay A.,9999,0,9999,0
1653643323726,ECE 200,003,091005,Bharadia; Dinesh,9999,0,9999,0
1653643323726,ECE 200,004,091006,Cheng; Chung Kuan,9999,0,9999,0
1653643323726,ECE 200,005,091007,Cosman; Pamela C.,9999,0,9999,0
1653643323726,ECE 200,006,091008,Staff,9999,0,9999,0
1653643323726,ECE 200,007,091009,Dayeh; Shadi Ahmad,9999,0,9999,0
1653643323726,ECE 200,008,091010,Fainman; Yeshaiahu,9999,0,9999,0
1653643323726,ECE 200,009,091011,Ford; Joseph Earl,9999,0,9999,0
1653643323726,ECE 200,010,091012,Franceschetti; Massimo,9999,0,9999,0
1653643323726,ECE 200,011,091013,Fullerton; Eric E,9999,0,9999,0
1653643323726,ECE 200,012,091014,Galton; Ian A,9999,0,9999,0
1653643323726,ECE 200,013,091015,Gilja; Vikash,9999,0,9999,0
1653643323726,ECE 200,014,091016,Hall; Drew A.,9999,0,9999,0
1653643323726,ECE 200,015,091017,Hsueh; Tzu-Chien,9999,0,9999,0
1653643323726,ECE 200,016,091018,Javidi; Tara,9999,0,9999,0
1653643323726,ECE 200,017,091019,Kahng; Andrew Byun,9999,0,9999,0
1653643323726,ECE 200,018,091020,Kim; Young-Han,9999,0,9999,0
1653643323726,ECE 200,019,091021,Koushanfar; Farinaz,9999,0,9999,0
1653643323726,ECE 200,020,091022,Kuzum; Duygu,9999,0,9999,0
1653643323726,ECE 200,021,091023,Le; Hanh-Phuc,9999,0,9999,0
1653643323726,ECE 200,022,091024,Lin; Bill,9999,0,9999,0
1653643323726,ECE 200,023,091025,Liu; Zhaowei,9999,0,9999,0
1653643323726,ECE 200,024,091026,Lo; Yu-Hwa,9999,0,9999,0
1653643323726,ECE 200,025,091027,Lomakin; Vitaliy,9999,0,9999,0
1653643323726,ECE 200,026,091028,Mercier; Patrick Philip,9999,0,9999,0
1653643323726,ECE 200,027,091029,Meyer; Florian,9999,0,9999,0
1653643323726,ECE 200,028,091030,Milstein; Laurence B.,9999,0,9999,0
1653643323726,ECE 200,029,091031,Mir Arabbaygi; Siavash,9999,0,9999,0
1653643323726,ECE 200,030,091032,Mookherjea; Shayan,9999,0,9999,0
1653643323726,ECE 200,031,091033,Morris; Karcher William,9999,0,9999,0
1653643323726,ECE 200,032,091034,Ng; Tse Nga,9999,0,9999,0
1653643323726,ECE 200,033,091035,Nguyen; Truong Quang,9999,0,9999,0
1653643323726,ECE 200,034,091036,Nomura; Kenji,9999,0,9999,0
1653643323726,ECE 200,035,091037,Orlitsky; Alon,9999,0,9999,0
1653643323726,ECE 200,036,091038,Pal; Piya,9999,0,9999,0
1653643323726,ECE 200,037,091039,Papen; George C.,9999,0,9999,0
1653643323726,ECE 200,038,091040,Radic; Stojan,9999,0,9999,0
1653643323726,ECE 200,039,091041,Rao; Bhaskar D.,9999,0,9999,0
1653643323726,ECE 200,040,091042,Rao; Ramesh R,9999,0,9999,0
1653643323726,ECE 200,041,091043,Rebeiz; Gabriel,9999,0,9999,0
1653643323726,ECE 200,042,091044,Sanford; John R,9999,0,9999,0
1653643323726,ECE 200,043,091045,Siegel; Paul H.,9999,0,9999,0
1653643323726,ECE 200,044,091046,Sievenpiper; Daniel F.,9999,0,9999,0
1653643323726,ECE 200,045,091047,Sworder; David D.,9999,0,9999,0
1653643323726,ECE 200,046,091048,Taur; Yuan,9999,0,9999,0
1653643323726,ECE 200,047,091049,Touri; Behrouz,9999,0,9999,0
1653643323726,ECE 200,048,091050,Trivedi; Mohan M.,9999,0,9999,0
1653643323726,ECE 200,049,091051,Vardy; Alexander,9999,0,9999,0
1653643323726,ECE 200,050,091052,Vasconcelos; Nuno,9999,0,9999,0
1653643323726,ECE 200,051,091053,Wang; Xiaolong,9999,0,9999,0
1653643323726,ECE 200,052,091054,Xie; Pengtao,9999,0,9999,0
1653643323726,ECE 200,053,091055,Yip; Michael,9999,0,9999,0
1653643323726,ECE 200,054,091056,Zeger; Kenneth A.,9999,0,9999,0
1653643323726,ECE 200,055,091057,Zhang; Xinyu,9999,0,9999,0
1653643323726,ECE 200,056,091058,Turakhia; Yatish Girish,9999,0,9999,0
1653643323726,ECE 200,057,091059,Kang; Mingu,9999,0,9999,0
1653643323726,ECE 200,058,091060,Shi; Yuanyuan,9999,0,9999,0
1653643323726,ECE 200,059,091061,Wang; Edward Jay,9999,0,9999,0
1653643323726,ECE 200,060,091062,Zheng; Yang,9999,0,9999,0
1653643324259,ECE 201,A00,095526,Lo; Yu-Hwa,0,0,0,0
1653643324785,ECE 203,A00,091065,Mercier; Patrick Philip,0,0,0,0
1653643325318,ECE 207A,A00,091605,Liu; Thomas Tao-Ming,0,0,0,0
1653643325848,ECE 212AN,A00,091068,Nomura; Kenji,0,0,0,0
1653643326373,ECE 222A,A00,091069,Rebeiz; Gabriel,0,0,0,0
1653643326897,ECE 225A,A00,091070,Orlitsky; Alon,0,0,0,0
1653643327421,ECE 230A,A00,091071,Nomura; Kenji,0,0,0,0
1653643327945,ECE 236A,A00,091072,Dayeh; Shadi Ahmad,0,0,0,0
1653643328475,ECE 238A,A00,091073,Luo; Jian,0,0,0,0
1653643328475,ECE 238A,B00,091074,Luo; Jian,0,0,0,0
1653643328999,ECE 240A,A00,091075,Radic; Stojan,0,0,0,0
1653643329524,ECE 247A,A00,091592,Shi; Lingyan,0,0,0,0
1653643330051,ECE 250,A00,091076,Touri; Behrouz,0,0,0,0
1653643330575,ECE 251C,A00,091078,Nguyen; Truong Quang,0,0,0,0
1653643331106,ECE 253,A00,091079,Cosman; Pamela C.,0,0,0,0
1653643331632,ECE 255A,A00,091080,Orlitsky; Alon,0,0,0,0
1653643332156,ECE 257A,A00,091081,Zhang; Xinyu,0,0,0,0
1653643332683,ECE 260A,A01,091084,Eldon; John,0,0,0,0
1653643333210,ECE 264C,A00,091085,Galton; Ian A,0,0,0,0
1653643333739,ECE 265C,A00,094889,Presti; Calogero Davide,0,0,0,9
1653643334265,ECE 266,A01,091087,Hall; Drew A.,0,0,0,0
1653643335313,ECE 271A,A00,091090,Vasconcelos; Nuno,0,0,0,0
1653643335837,ECE 272B,A00,091091,Sworder; David D.,0,0,0,0
1653643336361,ECE 275A,A00,091092,Meyer; Florian,0,0,0,0
1653643336887,ECE 277,A00,091093,An; Cheolhong,0,0,0,0
1653643337411,ECE 283,A00,091094,Le; Hanh-Phuc,0,0,0,0
1653643337958,ECE 284,A00,091095,Kang; Mingu,0,0,0,0
1653643337958,ECE 284,B00,091096,Wang; Edward Jay,0,0,0,0
1653643338482,ECE 285,A00,094334,Touri; Behrouz,0,0,0,0
1653643339014,ECE 289,A00,091097,Whelan; David Arthur,0,0,0,0
1653643339545,MATH 200A,A00,087414,Salehi Golsefidy; Alireza,7,0,8,1
1653643340070,MATH 202A,A00,087415,Gill; Philip E.,2,0,8,6
1653643340601,MATH 203A,A00,087416,Oprea; Dragos N.,6,0,8,2
1653643341127,MATH 204A,A00,087417,Kedlaya; Kiran S.,6,0,8,2
1653643341654,MATH 205,A00,087418,Sorensen; Claus M,6,0,8,2
1653643342183,MATH 206A,A00,087419,Izadi; Elham,6,0,8,2
1653643342707,MATH 207A,A00,087420,Mohammadi; Amir,5,0,8,3
1653643343229,MATH 208,A00,087421,Staff,8,0,10,2
1653643343757,MATH 209,A00,087422,Staff,10,0,10,0
1653643344290,MATH 218,A00,087423,Staff,10,0,10,0
1653643344815,MATH 220A,A00,087424,Novak; Jonathan I,6,0,8,2
1653643345340,MATH 231A,A00,087425,Bejenaru; Ioan,3,0,8,5
1653643345865,MATH 240A,A00,087426,Ebenfelt; Peter F,5,0,8,3
1653643346388,MATH 243,A00,087427,Staff,9,0,10,1
1653643346916,MATH 248,A00,087429,Staff,10,0,10,0
1653643347446,MATH 250A,A00,087430,Spolaor; Luca,4,0,8,4
1653643347975,MATH 257A,A00,087431,Spolaor; Luca,7,0,8,1
1653643348500,MATH 258,A00,087432,Staff,9,0,10,1
1653643349025,MATH 264A,A00,087433,Warnke; Lutz Peter,5,0,8,3
1653643349638,MATH 268,A00,087434,Staff,15,0,15,0
1653643350160,MATH 269,A00,087435,Staff,14,0,15,1
1653643350695,MATH 270A,A00,087436,Nie; Jiawang,0,0,8,8
1653643351222,MATH 272A,A00,087437,Tian; Xiaochuan,0,0,8,8
1653643351750,MATH 274,A01,087439,Cheng; Li-Tien,9,0,10,1
1653643351750,MATH 274,A02,087440,Cheng; Li-Tien,10,0,10,0
1653643352275,MATH 278A,A00,087441,Staff,8,0,10,2
1653643352798,MATH 278B,A00,087442,Staff,8,0,10,2
1653643353322,MATH 278C,A00,087443,Staff,8,0,10,2
1653643353847,MATH 280A,A00,087444,Zheng; Tianyi,0,0,8,8
1653643354374,MATH 281A,A00,087445,Bradic; Jelena,0,0,8,9
1653643354898,MATH 282A,A00,087446,Zhang; Danna,0,0,8,8
1653643355425,MATH 283,A00,087447,Tesler; Glenn,0,0,0,16
1653643355955,MATH 286,B00,095535,Kemp; Todd Aahron,5,0,8,3
1653643356481,MATH 287D,B00,095536,Bradic; Jelena,5,0,8,3
1653643357004,MATH 288,A00,087450,Staff,14,0,15,1
1653643357004,MATH 288,B00,087451,Staff,15,0,15,0
1653643357004,MATH 288,C00,087452,Staff,15,0,15,0
1653643357525,MATH 290A,A00,087453,Xu; Zhouli,6,0,8,2
1653643358050,MATH 291A,A00,087454,Xu; Zhouli,7,0,8,1
1653643358583,MATH 292,A00,087455,Staff,10,0,10,0
1653643359109,MATH 295,A00,087456,Staff,50,0,50,0
1653643359635,MATH 297,001,087457,Staff,997,0,999,2
1653643929346,COGS 200,A01,087991,Staff,47,0,50,3
1653643929876,COGS 201,A01,094504,Rangel; Lara M,16,0,25,9
1653643930401,COGS 203,A00,087992,Coulson; Seana M,18,0,20,2
1653643930929,COGS 210A,001,087993,Greene; Deanna Jacquelyn,9998,0,9999,1
1653643930929,COGS 210A,002,087994,Saygin; Ayse P,9999,0,9999,0
1653643930929,COGS 210A,003,087995,Xia; Haijun,9999,0,9999,0
1653643930929,COGS 210A,004,087996,Nitz; Douglas A.,9999,0,9999,0
1653643930929,COGS 210A,005,087997,Hollan; James D.,9999,0,9999,0
1653643930929,COGS 210A,006,087998,Deak; Gedeon O.,9998,0,9999,1
1653643930929,COGS 210A,007,087999,Rossano; Federico,9999,0,9999,0
1653643931454,COGS 211A,A00,088000,Coulson; Seana M,9997,0,9999,2
1653643931981,COGS 229,A00,088002,Staff,22,0,25,3
1653643932506,COGS 260,B00,094231,Staff,17,0,20,3
1653643932506,COGS 260,A00,088004,Nitz; Douglas A.,9998,0,9999,1
1653643933032,CSE 202,A00,090110,Paturi; Ramamohan,0,0,0,0
1653643933032,CSE 202,B00,090111,Paturi; Ramamohan,0,0,0,0
1653643933560,CSE 207B,A00,090112,Heninger; Nadia A,0,0,0,0
1653643934087,CSE 208,A00,094858,Micciancio; Daniele,0,0,0,0
1653643934613,CSE 210,A00,090113,Powell; Thomas Allan,0,0,0,0
1653643935135,CSE 219,A00,090898,Staff,0,0,0,0
1653643935665,CSE 221,A00,090114,Zhou; Yuan-Yuan,0,0,0,0
1653643936189,CSE 229A,A00,090115,Porter; George M,0,0,0,0
1653643936712,CSE 229C,A00,090116,Savage; Stefan,0,0,0,0
1653643937242,CSE 230,A00,090117,Jhala; Ranjit,0,0,0,0
1653643937767,CSE 232,A00,090118,Papakonstantinou; Yannis,0,0,0,0
1653643938292,CSE 239A,A00,090121,Kumar; Arun Kumar,0,0,0,0
1653643938816,CSE 239B,A00,090122,Jhala; Ranjit,0,0,0,0
1653643939348,CSE 240A,A00,090123,Zhao; Jishen,0,0,189,189
1653643939872,CSE 243A,A00,090124,Orailoglu; Alex,0,0,15,15
1653643940400,CSE 249B,A00,090125,Kahng; Andrew Byun,12,0,20,8
1653643940924,CSE 250A,A00,090126,Berg-Kirkpatrick; Taylor D,0,0,0,0
1653643941448,CSE 252A,A00,090127,Ochoa; Benjamin Lawrence,0,0,0,0
1653643941973,CSE 258,A01,090129,McAuley; Julian John,0,0,0,0
1653643942495,CSE 258R,A01,090131,McAuley; Julian John,0,0,0,0
1653643943019,CSE 274,A00,090132,Ramamoorthi; Ravi,0,0,0,0
1653643943546,CSE 276A,A00,090133,Christensen; Henrik I,0,0,0,0
1653643944069,CSE 276C,A00,090134,Christensen; Henrik I,0,0,0,0
1653643944601,CSE 290,A00,090135,Bafna; Vineet,0,0,0,0
1653643944601,CSE 290,B00,090136,Ramamoorthi; Ravi,0,0,0,0
1653643944601,CSE 290,C00,090137,Li; Tzumao,7,0,10,3
1653643944601,CSE 290,D00,090138,Zhou; Yuan-Yuan,9,0,10,1
1653643944601,CSE 290,E00,090139,Christensen; Henrik I,8,0,10,2
1653643944601,CSE 290,F00,094053,Shalev; Aaron D,0,0,0,0
1653643945129,CSE 291,A00,090140,Munyaka; Imani N. S.,0,0,0,0
1653643945129,CSE 291,B00,094880,Yu; Qi,0,0,0,0
1653643945129,CSE 291,C00,090142,Pannuto; Patrick William,0,0,0,0
1653643945129,CSE 291,D00,094881,Zhang; Yiying,0,0,0,0
1653643945129,CSE 291,E00,095118,Su; Hao,0,0,0,0
1653643945682,CSE 293,001,094905,Bafna; Vineet,9999,0,9999,0
1653643945682,CSE 293,002,094906,Bellare; Mihir,9999,0,9999,0
1653643945682,CSE 293,003,094907,Berg-Kirkpatrick; Taylor D,9999,0,9999,0
1653643945682,CSE 293,004,094908,Christensen; Henrik I,9999,0,9999,0
1653643945682,CSE 293,005,094909,Cottrell; Garrison W,9999,0,9999,0
1653643945682,CSE 293,006,094910,Deutsch; Alin Bernard,9999,0,9999,0
1653643945682,CSE 293,007,094911,Esmaeilzadeh; Hadi,9999,0,9999,0
1653643945682,CSE 293,008,094912,Freund; Yoav,9999,0,9999,0
1653643945682,CSE 293,009,094913,Griswold; William G.,9999,0,9999,0
1653643945682,CSE 293,010,094914,Gymrek; Melissa Ann,9999,0,9999,0
1653643945682,CSE 293,011,094915,Heninger; Nadia A,9999,0,9999,0
1653643945682,CSE 293,012,094916,Impagliazzo; Russell,9999,0,9999,0
1653643945682,CSE 293,013,094917,Jhala; Ranjit,9999,0,9999,0
1653643945682,CSE 293,014,094918,Kahng; Andrew Byun,9999,0,9999,0
1653643945682,CSE 293,015,094919,Kane; Daniel Mertz,9999,0,9999,0
1653643945682,CSE 293,016,094920,Kriegman; David J,9999,0,9999,0
1653643945682,CSE 293,017,094921,Kumar; Arun Kumar,9999,0,9999,0
1653643945682,CSE 293,018,094922,Lerner; Sorin,9999,0,9999,0
1653643945682,CSE 293,019,094923,Lovett; Shachar,9999,0,9999,0
1653643945682,CSE 293,020,094924,McAuley; Julian John,9999,0,9999,0
1653643945682,CSE 293,021,094925,Micciancio; Daniele,9999,0,9999,0
1653643945682,CSE 293,022,094926,Orailoglu; Alex,9999,0,9999,0
1653643945682,CSE 293,023,094927,Paturi; Ramamohan,9999,0,9999,0
1653643945682,CSE 293,024,094928,Polikarpova; Nadezhda,9999,0,9999,0
1653643945682,CSE 293,025,094929,Politz; Joseph Gibbs,9999,0,9999,0
1653643945682,CSE 293,026,094930,Porter; George M,9999,0,9999,0
1653643945682,CSE 293,027,094931,Porter; Leonard Emerson,9999,0,9999,0
1653643945682,CSE 293,028,094932,Ramamoorthi; Ravi,9999,0,9999,0
1653643945682,CSE 293,029,094933,Sahoo; Debashis,9999,0,9999,0
1653643945682,CSE 293,030,094934,Saul; Lawrence,9999,0,9999,0
1653643945682,CSE 293,031,094935,Savage; Stefan,9999,0,9999,0
1653643945682,CSE 293,032,094936,Schulze; Jurgen P.,9999,0,9999,0
1653643945682,CSE 293,033,094937,Snoeren; Alex C.,9999,0,9999,0
1653643945682,CSE 293,034,094938,Shang; Jingbo,9999,0,9999,0
1653643945682,CSE 293,035,094939,Stefan; Deian,9999,0,9999,0
1653643945682,CSE 293,036,094940,Su; Hao,9999,0,9999,0
1653643945682,CSE 293,037,094941,Swanson; Steven James,9999,0,9999,0
1653643945682,CSE 293,038,094942,Tullsen; Dean Michael,9999,0,9999,0
1653643945682,CSE 293,039,094943,Voelker; Geoffrey M.,9999,0,9999,0
1653643945682,CSE 293,040,094944,Zhao; Jishen,9999,0,9999,0
1653643945682,CSE 293,041,094945,Zhou; Yuan-Yuan,9999,0,9999,0
1653643945682,CSE 293,042,094946,Gao; Sicun,9998,0,9999,1
1653643945682,CSE 293,043,094947,Weibel; Nadir,9999,0,9999,0
1653643945682,CSE 293,044,094948,Gupta; Rajesh K.,9999,0,9999,0
1653643946206,CSE 294,A00,090143,Porter; George M,9,0,10,1
1653643946823,DSE 200,A00,091799,Staff,50,0,50,0
1653643947345,DSE 203,A00,091800,Gupta; Amarnath,30,0,30,0
1653643947870,DSE 250,A00,091801,Deutsch; Alin Bernard,30,0,30,0
1653643948397,DSE 290,A00,091802,Altintas De Callaf; Ilkay,50,0,50,0
1653643948950,ECE 200,001,091003,Antipa; Nicholas A,9999,0,9999,0
1653643948950,ECE 200,002,091004,Atanasov; Nikolay A.,9999,0,9999,0
1653643948950,ECE 200,003,091005,Bharadia; Dinesh,9999,0,9999,0
1653643948950,ECE 200,004,091006,Cheng; Chung Kuan,9999,0,9999,0
1653643948950,ECE 200,005,091007,Cosman; Pamela C.,9999,0,9999,0
1653643948950,ECE 200,006,091008,Staff,9999,0,9999,0
1653643948950,ECE 200,007,091009,Dayeh; Shadi Ahmad,9999,0,9999,0
1653643948950,ECE 200,008,091010,Fainman; Yeshaiahu,9999,0,9999,0
1653643948950,ECE 200,009,091011,Ford; Joseph Earl,9999,0,9999,0
1653643948950,ECE 200,010,091012,Franceschetti; Massimo,9999,0,9999,0
1653643948950,ECE 200,011,091013,Fullerton; Eric E,9999,0,9999,0
1653643948950,ECE 200,012,091014,Galton; Ian A,9999,0,9999,0
1653643948950,ECE 200,013,091015,Gilja; Vikash,9999,0,9999,0
1653643948950,ECE 200,014,091016,Hall; Drew A.,9999,0,9999,0
1653643948950,ECE 200,015,091017,Hsueh; Tzu-Chien,9999,0,9999,0
1653643948950,ECE 200,016,091018,Javidi; Tara,9999,0,9999,0
1653643948950,ECE 200,017,091019,Kahng; Andrew Byun,9999,0,9999,0
1653643948950,ECE 200,018,091020,Kim; Young-Han,9999,0,9999,0
1653643948950,ECE 200,019,091021,Koushanfar; Farinaz,9999,0,9999,0
1653643948950,ECE 200,020,091022,Kuzum; Duygu,9999,0,9999,0
1653643948950,ECE 200,021,091023,Le; Hanh-Phuc,9999,0,9999,0
1653643948950,ECE 200,022,091024,Lin; Bill,9999,0,9999,0
1653643948950,ECE 200,023,091025,Liu; Zhaowei,9999,0,9999,0
1653643948950,ECE 200,024,091026,Lo; Yu-Hwa,9999,0,9999,0
1653643948950,ECE 200,025,091027,Lomakin; Vitaliy,9999,0,9999,0
1653643948950,ECE 200,026,091028,Mercier; Patrick Philip,9999,0,9999,0
1653643948950,ECE 200,027,091029,Meyer; Florian,9999,0,9999,0
1653643948950,ECE 200,028,091030,Milstein; Laurence B.,9999,0,9999,0
1653643948950,ECE 200,029,091031,Mir Arabbaygi; Siavash,9999,0,9999,0
1653643948950,ECE 200,030,091032,Mookherjea; Shayan,9999,0,9999,0
1653643948950,ECE 200,031,091033,Morris; Karcher William,9999,0,9999,0
1653643948950,ECE 200,032,091034,Ng; Tse Nga,9999,0,9999,0
1653643948950,ECE 200,033,091035,Nguyen; Truong Quang,9999,0,9999,0
1653643948950,ECE 200,034,091036,Nomura; Kenji,9999,0,9999,0
1653643948950,ECE 200,035,091037,Orlitsky; Alon,9999,0,9999,0
1653643948950,ECE 200,036,091038,Pal; Piya,9999,0,9999,0
1653643948950,ECE 200,037,091039,Papen; George C.,9999,0,9999,0
1653643948950,ECE 200,038,091040,Radic; Stojan,9999,0,9999,0
1653643948950,ECE 200,039,091041,Rao; Bhaskar D.,9999,0,9999,0
1653643948950,ECE 200,040,091042,Rao; Ramesh R,9999,0,9999,0
1653643948950,ECE 200,041,091043,Rebeiz; Gabriel,9999,0,9999,0
1653643948950,ECE 200,042,091044,Sanford; John R,9999,0,9999,0
1653643948950,ECE 200,043,091045,Siegel; Paul H.,9999,0,9999,0
1653643948950,ECE 200,044,091046,Sievenpiper; Daniel F.,9999,0,9999,0
1653643948950,ECE 200,045,091047,Sworder; David D.,9999,0,9999,0
1653643948950,ECE 200,046,091048,Taur; Yuan,9999,0,9999,0
1653643948950,ECE 200,047,091049,Touri; Behrouz,9999,0,9999,0
1653643948950,ECE 200,048,091050,Trivedi; Mohan M.,9999,0,9999,0
1653643948950,ECE 200,049,091051,Vardy; Alexander,9999,0,9999,0
1653643948950,ECE 200,050,091052,Vasconcelos; Nuno,9999,0,9999,0
1653643948950,ECE 200,051,091053,Wang; Xiaolong,9999,0,9999,0
1653643948950,ECE 200,052,091054,Xie; Pengtao,9999,0,9999,0
1653643948950,ECE 200,053,091055,Yip; Michael,9999,0,9999,0
1653643948950,ECE 200,054,091056,Zeger; Kenneth A.,9999,0,9999,0
1653643948950,ECE 200,055,091057,Zhang; Xinyu,9999,0,9999,0
1653643948950,ECE 200,056,091058,Turakhia; Yatish Girish,9999,0,9999,0
1653643948950,ECE 200,057,091059,Kang; Mingu,9999,0,9999,0
1653643948950,ECE 200,058,091060,Shi; Yuanyuan,9999,0,9999,0
1653643948950,ECE 200,059,091061,Wang; Edward Jay,9999,0,9999,0
1653643948950,ECE 200,060,091062,Zheng; Yang,9999,0,9999,0
1653643949473,ECE 201,A00,095526,Lo; Yu-Hwa,0,0,0,0
1653643949997,ECE 203,A00,091065,Mercier; Patrick Philip,0,0,0,0
1653643950529,ECE 207A,A00,091605,Liu; Thomas Tao-Ming,0,0,0,0
1653643951058,ECE 212AN,A00,091068,Nomura; Kenji,0,0,0,0
1653643951589,ECE 222A,A00,091069,Rebeiz; Gabriel,0,0,0,0
1653643952128,ECE 225A,A00,091070,Orlitsky; Alon,0,0,0,0
1653643952654,ECE 230A,A00,091071,Nomura; Kenji,0,0,0,0
1653643953183,ECE 236A,A00,091072,Dayeh; Shadi Ahmad,0,0,0,0
1653643953707,ECE 238A,A00,091073,Luo; Jian,0,0,0,0
1653643953707,ECE 238A,B00,091074,Luo; Jian,0,0,0,0
1653643954238,ECE 240A,A00,091075,Radic; Stojan,0,0,0,0
1653643954767,ECE 247A,A00,091592,Shi; Lingyan,0,0,0,0
1653643955297,ECE 250,A00,091076,Touri; Behrouz,0,0,0,0
1653643955821,ECE 251C,A00,091078,Nguyen; Truong Quang,0,0,0,0
1653643956347,ECE 253,A00,091079,Cosman; Pamela C.,0,0,0,0
1653643956877,ECE 255A,A00,091080,Orlitsky; Alon,0,0,0,0
1653643957401,ECE 257A,A00,091081,Zhang; Xinyu,0,0,0,0
1653643957931,ECE 260A,A01,091084,Eldon; John,0,0,0,0
1653643958459,ECE 264C,A00,091085,Galton; Ian A,0,0,0,0
1653643958992,ECE 265C,A00,094889,Presti; Calogero Davide,0,0,0,9
1653643959516,ECE 266,A01,091087,Hall; Drew A.,0,0,0,0
1653643960572,ECE 271A,A00,091090,Vasconcelos; Nuno,0,0,0,0
1653643961096,ECE 272B,A00,091091,Sworder; David D.,0,0,0,0
1653643961623,ECE 275A,A00,091092,Meyer; Florian,0,0,0,0
1653643962145,ECE 277,A00,091093,An; Cheolhong,0,0,0,0
1653643962673,ECE 283,A00,091094,Le; Hanh-Phuc,0,0,0,0
1653643963198,ECE 284,A00,091095,Kang; Mingu,0,0,0,0
1653643963198,ECE 284,B00,091096,Wang; Edward Jay,0,0,0,0
1653643963729,ECE 285,A00,094334,Touri; Behrouz,0,0,0,0
1653643964254,ECE 289,A00,091097,Whelan; David Arthur,0,0,0,0
1653643964782,MATH 200A,A00,087414,Salehi Golsefidy; Alireza,7,0,8,1
1653643965305,MATH 202A,A00,087415,Gill; Philip E.,2,0,8,6
1653643965834,MATH 203A,A00,087416,Oprea; Dragos N.,6,0,8,2
1653643966358,MATH 204A,A00,087417,Kedlaya; Kiran S.,6,0,8,2
1653643966882,MATH 205,A00,087418,Sorensen; Claus M,6,0,8,2
1653643967411,MATH 206A,A00,087419,Izadi; Elham,6,0,8,2
1653643967949,MATH 207A,A00,087420,Mohammadi; Amir,5,0,8,3
1653643968477,MATH 208,A00,087421,Staff,8,0,10,2
1653643969002,MATH 209,A00,087422,Staff,10,0,10,0
1653643969526,MATH 218,A00,087423,Staff,10,0,10,0
1653643970056,MATH 220A,A00,087424,Novak; Jonathan I,6,0,8,2
1653643970585,MATH 231A,A00,087425,Bejenaru; Ioan,3,0,8,5
1653643971114,MATH 240A,A00,087426,Ebenfelt; Peter F,5,0,8,3
1653643971639,MATH 243,A00,087427,Staff,9,0,10,1
1653643972162,MATH 248,A00,087429,Staff,10,0,10,0
1653643972685,MATH 250A,A00,087430,Spolaor; Luca,4,0,8,4
1653643973212,MATH 257A,A00,087431,Spolaor; Luca,7,0,8,1
1653643973743,MATH 258,A00,087432,Staff,9,0,10,1
1653643974267,MATH 264A,A00,087433,Warnke; Lutz Peter,5,0,8,3
1653643974799,MATH 268,A00,087434,Staff,15,0,15,0
1653643975325,MATH 269,A00,087435,Staff,14,0,15,1
1653643975854,MATH 270A,A00,087436,Nie; Jiawang,0,0,8,8
1653643976400,MATH 272A,A00,087437,Tian; Xiaochuan,0,0,8,8
1653643976931,MATH 274,A01,087439,Cheng; Li-Tien,9,0,10,1
1653643976931,MATH 274,A02,087440,Cheng; Li-Tien,10,0,10,0
1653643977454,MATH 278A,A00,087441,Staff,8,0,10,2
1653643977982,MATH 278B,A00,087442,Staff,8,0,10,2
1653643978505,MATH 278C,A00,087443,Staff,8,0,10,2
1653643979028,MATH 280A,A00,087444,Zheng; Tianyi,0,0,8,8
1653643979552,MATH 281A,A00,087445,Bradic; Jelena,0,0,8,9
1653643980080,MATH 282A,A00,087446,Zhang; Danna,0,0,8,8
1653643980615,MATH 283,A00,087447,Tesler; Glenn,0,0,0,16
1653643981147,MATH 286,B00,095535,Kemp; Todd Aahron,5,0,8,3
1653643981674,MATH 287D,B00,095536,Bradic; Jelena,5,0,8,3
1653643982201,MATH 288,A00,087450,Staff,14,0,15,1
1653643982201,MATH 288,B00,087451,Staff,15,0,15,0
1653643982201,MATH 288,C00,087452,Staff,15,0,15,0
1653643982734,MATH 290A,A00,087453,Xu; Zhouli,6,0,8,2
1653643983263,MATH 291A,A00,087454,Xu; Zhouli,7,0,8,1
1653643983787,MATH 292,A00,087455,Staff,10,0,10,0
1653643984313,MATH 295,A00,087456,Staff,50,0,50,0
1653643984841,MATH 297,001,087457,Staff,997,0,999,2
1653644545306,COGS 200,A01,087991,Staff,47,0,50,3
1653644545832,COGS 201,A01,094504,Rangel; Lara M,16,0,25,9
1653644546357,COGS 203,A00,087992,Coulson; Seana M,18,0,20,2
1653644546889,COGS 210A,001,087993,Greene; Deanna Jacquelyn,9998,0,9999,1
1653644546889,COGS 210A,002,087994,Saygin; Ayse P,9999,0,9999,0
1653644546889,COGS 210A,003,087995,Xia; Haijun,9999,0,9999,0
1653644546889,COGS 210A,004,087996,Nitz; Douglas A.,9999,0,9999,0
1653644546889,COGS 210A,005,087997,Hollan; James D.,9999,0,9999,0
1653644546889,COGS 210A,006,087998,Deak; Gedeon O.,9998,0,9999,1
1653644546889,COGS 210A,007,087999,Rossano; Federico,9999,0,9999,0
1653644547416,COGS 211A,A00,088000,Coulson; Seana M,9997,0,9999,2
1653644547940,COGS 229,A00,088002,Staff,22,0,25,3
1653644548463,COGS 260,B00,094231,Staff,17,0,20,3
1653644548463,COGS 260,A00,088004,Nitz; Douglas A.,9998,0,9999,1
1653644548988,CSE 202,A00,090110,Paturi; Ramamohan,0,0,0,0
1653644548988,CSE 202,B00,090111,Paturi; Ramamohan,0,0,0,0
1653644549514,CSE 207B,A00,090112,Heninger; Nadia A,0,0,0,0
1653644550037,CSE 208,A00,094858,Micciancio; Daniele,0,0,0,0
1653644550559,CSE 210,A00,090113,Powell; Thomas Allan,0,0,0,0
1653644551088,CSE 219,A00,090898,Staff,0,0,0,0
1653644551613,CSE 221,A00,090114,Zhou; Yuan-Yuan,0,0,0,0
1653644552138,CSE 229A,A00,090115,Porter; George M,0,0,0,0
1653644552667,CSE 229C,A00,090116,Savage; Stefan,0,0,0,0
1653644553191,CSE 230,A00,090117,Jhala; Ranjit,0,0,0,0
1653644553714,CSE 232,A00,090118,Papakonstantinou; Yannis,0,0,0,0
1653644554238,CSE 239A,A00,090121,Kumar; Arun Kumar,0,0,0,0
1653644554761,CSE 239B,A00,090122,Jhala; Ranjit,0,0,0,0
1653644555288,CSE 240A,A00,090123,Zhao; Jishen,0,0,189,189
1653644555815,CSE 243A,A00,090124,Orailoglu; Alex,0,0,15,15
1653644556341,CSE 249B,A00,090125,Kahng; Andrew Byun,12,0,20,8
1653644556868,CSE 250A,A00,090126,Berg-Kirkpatrick; Taylor D,0,0,0,0
1653644557391,CSE 252A,A00,090127,Ochoa; Benjamin Lawrence,0,0,0,0
1653644557917,CSE 258,A01,090129,McAuley; Julian John,0,0,0,0
1653644558441,CSE 258R,A01,090131,McAuley; Julian John,0,0,0,0
1653644558967,CSE 274,A00,090132,Ramamoorthi; Ravi,0,0,0,0
1653644559491,CSE 276A,A00,090133,Christensen; Henrik I,0,0,0,0
1653644560019,CSE 276C,A00,090134,Christensen; Henrik I,0,0,0,0
1653644560546,CSE 290,A00,090135,Bafna; Vineet,0,0,0,0
1653644560546,CSE 290,B00,090136,Ramamoorthi; Ravi,0,0,0,0
1653644560546,CSE 290,C00,090137,Li; Tzumao,7,0,10,3
1653644560546,CSE 290,D00,090138,Zhou; Yuan-Yuan,9,0,10,1
1653644560546,CSE 290,E00,090139,Christensen; Henrik I,8,0,10,2
1653644560546,CSE 290,F00,094053,Shalev; Aaron D,0,0,0,0
1653644561073,CSE 291,A00,090140,Munyaka; Imani N. S.,0,0,0,0
1653644561073,CSE 291,B00,094880,Yu; Qi,0,0,0,0
1653644561073,CSE 291,C00,090142,Pannuto; Patrick William,0,0,0,0
1653644561073,CSE 291,D00,094881,Zhang; Yiying,0,0,0,0
1653644561073,CSE 291,E00,095118,Su; Hao,0,0,0,0
1653644561609,CSE 293,001,094905,Bafna; Vineet,9999,0,9999,0
1653644561609,CSE 293,002,094906,Bellare; Mihir,9999,0,9999,0
1653644561609,CSE 293,003,094907,Berg-Kirkpatrick; Taylor D,9999,0,9999,0
1653644561609,CSE 293,004,094908,Christensen; Henrik I,9999,0,9999,0
1653644561609,CSE 293,005,094909,Cottrell; Garrison W,9999,0,9999,0
1653644561609,CSE 293,006,094910,Deutsch; Alin Bernard,9999,0,9999,0
1653644561609,CSE 293,007,094911,Esmaeilzadeh; Hadi,9999,0,9999,0
1653644561609,CSE 293,008,094912,Freund; Yoav,9999,0,9999,0
1653644561609,CSE 293,009,094913,Griswold; William G.,9999,0,9999,0
1653644561609,CSE 293,010,094914,Gymrek; Melissa Ann,9999,0,9999,0
1653644561609,CSE 293,011,094915,Heninger; Nadia A,9999,0,9999,0
1653644561609,CSE 293,012,094916,Impagliazzo; Russell,9999,0,9999,0
1653644561609,CSE 293,013,094917,Jhala; Ranjit,9999,0,9999,0
1653644561609,CSE 293,014,094918,Kahng; Andrew Byun,9999,0,9999,0
1653644561609,CSE 293,015,094919,Kane; Daniel Mertz,9999,0,9999,0
1653644561609,CSE 293,016,094920,Kriegman; David J,9999,0,9999,0
1653644561609,CSE 293,017,094921,Kumar; Arun Kumar,9999,0,9999,0
1653644561609,CSE 293,018,094922,Lerner; Sorin,9999,0,9999,0
1653644561609,CSE 293,019,094923,Lovett; Shachar,9999,0,9999,0
1653644561609,CSE 293,020,094924,McAuley; Julian John,9999,0,9999,0
1653644561609,CSE 293,021,094925,Micciancio; Daniele,9999,0,9999,0
1653644561609,CSE 293,022,094926,Orailoglu; Alex,9999,0,9999,0
1653644561609,CSE 293,023,094927,Paturi; Ramamohan,9999,0,9999,0
1653644561609,CSE 293,024,094928,Polikarpova; Nadezhda,9999,0,9999,0
1653644561609,CSE 293,025,094929,Politz; Joseph Gibbs,9999,0,9999,0
1653644561609,CSE 293,026,094930,Porter; George M,9999,0,9999,0
1653644561609,CSE 293,027,094931,Porter; Leonard Emerson,9999,0,9999,0
1653644561609,CSE 293,028,094932,Ramamoorthi; Ravi,9999,0,9999,0
1653644561609,CSE 293,029,094933,Sahoo; Debashis,9999,0,9999,0
1653644561609,CSE 293,030,094934,Saul; Lawrence,9999,0,9999,0
1653644561609,CSE 293,031,094935,Savage; Stefan,9999,0,9999,0
1653644561609,CSE 293,032,094936,Schulze; Jurgen P.,9999,0,9999,0
1653644561609,CSE 293,033,094937,Snoeren; Alex C.,9999,0,9999,0
1653644561609,CSE 293,034,094938,Shang; Jingbo,9999,0,9999,0
1653644561609,CSE 293,035,094939,Stefan; Deian,9999,0,9999,0
1653644561609,CSE 293,036,094940,Su; Hao,9999,0,9999,0
1653644561609,CSE 293,037,094941,Swanson; Steven James,9999,0,9999,0
1653644561609,CSE 293,038,094942,Tullsen; Dean Michael,9999,0,9999,0
1653644561609,CSE 293,039,094943,Voelker; Geoffrey M.,9999,0,9999,0
1653644561609,CSE 293,040,094944,Zhao; Jishen,9999,0,9999,0
1653644561609,CSE 293,041,094945,Zhou; Yuan-Yuan,9999,0,9999,0
1653644561609,CSE 293,042,094946,Gao; Sicun,9998,0,9999,1
1653644561609,CSE 293,043,094947,Weibel; Nadir,9999,0,9999,0
1653644561609,CSE 293,044,094948,Gupta; Rajesh K.,9999,0,9999,0
1653644562136,CSE 294,A00,090143,Porter; George M,9,0,10,1
1653644562666,DSE 200,A00,091799,Staff,50,0,50,0
1653644563194,DSE 203,A00,091800,Gupta; Amarnath,30,0,30,0
1653644563718,DSE 250,A00,091801,Deutsch; Alin Bernard,30,0,30,0
1653644564244,DSE 290,A00,091802,Altintas De Callaf; Ilkay,50,0,50,0
1653644564831,ECE 200,001,091003,Antipa; Nicholas A,9999,0,9999,0
1653644564831,ECE 200,002,091004,Atanasov; Nikolay A.,9999,0,9999,0
1653644564831,ECE 200,003,091005,Bharadia; Dinesh,9999,0,9999,0
1653644564831,ECE 200,004,091006,Cheng; Chung Kuan,9999,0,9999,0
1653644564831,ECE 200,005,091007,Cosman; Pamela C.,9999,0,9999,0
1653644564831,ECE 200,006,091008,Staff,9999,0,9999,0
1653644564831,ECE 200,007,091009,Dayeh; Shadi Ahmad,9999,0,9999,0
1653644564831,ECE 200,008,091010,Fainman; Yeshaiahu,9999,0,9999,0
1653644564831,ECE 200,009,091011,Ford; Joseph Earl,9999,0,9999,0
1653644564831,ECE 200,010,091012,Franceschetti; Massimo,9999,0,9999,0
1653644564831,ECE 200,011,091013,Fullerton; Eric E,9999,0,9999,0
1653644564831,ECE 200,012,091014,Galton; Ian A,9999,0,9999,0
1653644564831,ECE 200,013,091015,Gilja; Vikash,9999,0,9999,0
1653644564831,ECE 200,014,091016,Hall; Drew A.,9999,0,9999,0
1653644564831,ECE 200,015,091017,Hsueh; Tzu-Chien,9999,0,9999,0
1653644564831,ECE 200,016,091018,Javidi; Tara,9999,0,9999,0
1653644564831,ECE 200,017,091019,Kahng; Andrew Byun,9999,0,9999,0
1653644564831,ECE 200,018,091020,Kim; Young-Han,9999,0,9999,0
1653644564831,ECE 200,019,091021,Koushanfar; Farinaz,9999,0,9999,0
1653644564831,ECE 200,020,091022,Kuzum; Duygu,9999,0,9999,0
1653644564831,ECE 200,021,091023,Le; Hanh-Phuc,9999,0,9999,0
1653644564831,ECE 200,022,091024,Lin; Bill,9999,0,9999,0
1653644564831,ECE 200,023,091025,Liu; Zhaowei,9999,0,9999,0
1653644564831,ECE 200,024,091026,Lo; Yu-Hwa,9999,0,9999,0
1653644564831,ECE 200,025,091027,Lomakin; Vitaliy,9999,0,9999,0
1653644564831,ECE 200,026,091028,Mercier; Patrick Philip,9999,0,9999,0
1653644564831,ECE 200,027,091029,Meyer; Florian,9999,0,9999,0
1653644564831,ECE 200,028,091030,Milstein; Laurence B.,9999,0,9999,0
1653644564831,ECE 200,029,091031,Mir Arabbaygi; Siavash,9999,0,9999,0
1653644564831,ECE 200,030,091032,Mookherjea; Shayan,9999,0,9999,0
1653644564831,ECE 200,031,091033,Morris; Karcher William,9999,0,9999,0
1653644564831,ECE 200,032,091034,Ng; Tse Nga,9999,0,9999,0
1653644564831,ECE 200,033,091035,Nguyen; Truong Quang,9999,0,9999,0
1653644564831,ECE 200,034,091036,Nomura; Kenji,9999,0,9999,0
1653644564831,ECE 200,035,091037,Orlitsky; Alon,9999,0,9999,0
1653644564831,ECE 200,036,091038,Pal; Piya,9999,0,9999,0
1653644564831,ECE 200,037,091039,Papen; George C.,9999,0,9999,0
1653644564831,ECE 200,038,091040,Radic; Stojan,9999,0,9999,0
1653644564831,ECE 200,039,091041,Rao; Bhaskar D.,9999,0,9999,0
1653644564831,ECE 200,040,091042,Rao; Ramesh R,9999,0,9999,0
1653644564831,ECE 200,041,091043,Rebeiz; Gabriel,9999,0,9999,0
1653644564831,ECE 200,042,091044,Sanford; John R,9999,0,9999,0
1653644564831,ECE 200,043,091045,Siegel; Paul H.,9999,0,9999,0
1653644564831,ECE 200,044,091046,Sievenpiper; Daniel F.,9999,0,9999,0
1653644564831,ECE 200,045,091047,Sworder; David D.,9999,0,9999,0
1653644564831,ECE 200,046,091048,Taur; Yuan,9999,0,9999,0
1653644564831,ECE 200,047,091049,Touri; Behrouz,9999,0,9999,0
1653644564831,ECE 200,048,091050,Trivedi; Mohan M.,9999,0,9999,0
1653644564831,ECE 200,049,091051,Vardy; Alexander,9999,0,9999,0
1653644564831,ECE 200,050,091052,Vasconcelos; Nuno,9999,0,9999,0
1653644564831,ECE 200,051,091053,Wang; Xiaolong,9999,0,9999,0
1653644564831,ECE 200,052,091054,Xie; Pengtao,9999,0,9999,0
1653644564831,ECE 200,053,091055,Yip; Michael,9999,0,9999,0
1653644564831,ECE 200,054,091056,Zeger; Kenneth A.,9999,0,9999,0
1653644564831,ECE 200,055,091057,Zhang; Xinyu,9999,0,9999,0
1653644564831,ECE 200,056,091058,Turakhia; Yatish Girish,9999,0,9999,0
1653644564831,ECE 200,057,091059,Kang; Mingu,9999,0,9999,0
1653644564831,ECE 200,058,091060,Shi; Yuanyuan,9999,0,9999,0
1653644564831,ECE 200,059,091061,Wang; Edward Jay,9999,0,9999,0
1653644564831,ECE 200,060,091062,Zheng; Yang,9999,0,9999,0
1653644565355,ECE 201,A00,095526,Lo; Yu-Hwa,0,0,0,0
1653644565883,ECE 203,A00,091065,Mercier; Patrick Philip,0,0,0,0
1653644566408,ECE 207A,A00,091605,Liu; Thomas Tao-Ming,0,0,0,0
1653644566931,ECE 212AN,A00,091068,Nomura; Kenji,0,0,0,0
1653644567454,ECE 222A,A00,091069,Rebeiz; Gabriel,0,0,0,0
1653644567977,ECE 225A,A00,091070,Orlitsky; Alon,0,0,0,0
1653644568504,ECE 230A,A00,091071,Nomura; Kenji,0,0,0,0
1653644569028,ECE 236A,A00,091072,Dayeh; Shadi Ahmad,0,0,0,0
1653644569554,ECE 238A,A00,091073,Luo; Jian,0,0,0,0
1653644569554,ECE 238A,B00,091074,Luo; Jian,0,0,0,0
1653644570078,ECE 240A,A00,091075,Radic; Stojan,0,0,0,0
1653644570610,ECE 247A,A00,091592,Shi; Lingyan,0,0,0,0
1653644571133,ECE 250,A00,091076,Touri; Behrouz,0,0,0,0
1653644571656,ECE 251C,A00,091078,Nguyen; Truong Quang,0,0,0,0
1653644572184,ECE 253,A00,091079,Cosman; Pamela C.,0,0,0,0
1653644572710,ECE 255A,A00,091080,Orlitsky; Alon,0,0,0,0
1653644573232,ECE 257A,A00,091081,Zhang; Xinyu,0,0,0,0
1653644573765,ECE 260A,A01,091084,Eldon; John,0,0,0,0
1653644574294,ECE 264C,A00,091085,Galton; Ian A,0,0,0,0
1653644574820,ECE 265C,A00,094889,Presti; Calogero Davide,0,0,0,9
1653644575349,ECE 266,A01,091087,Hall; Drew A.,0,0,0,0
1653644576400,ECE 271A,A00,091090,Vasconcelos; Nuno,0,0,0,0
1653644576924,ECE 272B,A00,091091,Sworder; David D.,0,0,0,0
1653644577447,ECE 275A,A00,091092,Meyer; Florian,0,0,0,0
1653644577973,ECE 277,A00,091093,An; Cheolhong,0,0,0,0
1653644578496,ECE 283,A00,091094,Le; Hanh-Phuc,0,0,0,0
1653644579027,ECE 284,A00,091095,Kang; Mingu,0,0,0,0
1653644579027,ECE 284,B00,091096,Wang; Edward Jay,0,0,0,0
1653644579551,ECE 285,A00,094334,Touri; Behrouz,0,0,0,0
1653644580078,ECE 289,A00,091097,Whelan; David Arthur,0,0,0,0
1653644580608,MATH 200A,A00,087414,Salehi Golsefidy; Alireza,7,0,8,1
1653644581131,MATH 202A,A00,087415,Gill; Philip E.,2,0,8,6
1653644581657,MATH 203A,A00,087416,Oprea; Dragos N.,6,0,8,2
1653644582180,MATH 204A,A00,087417,Kedlaya; Kiran S.,6,0,8,2
1653644582705,MATH 205,A00,087418,Sorensen; Claus M,6,0,8,2
1653644583229,MATH 206A,A00,087419,Izadi; Elham,6,0,8,2
1653644583758,MATH 207A,A00,087420,Mohammadi; Amir,5,0,8,3
1653644584282,MATH 208,A00,087421,Staff,8,0,10,2
1653644584810,MATH 209,A00,087422,Staff,10,0,10,0
1653644585337,MATH 218,A00,087423,Staff,10,0,10,0
1653644585866,MATH 220A,A00,087424,Novak; Jonathan I,6,0,8,2
1653644586391,MATH 231A,A00,087425,Bejenaru; Ioan,3,0,8,5
1653644586917,MATH 240A,A00,087426,Ebenfelt; Peter F,5,0,8,3
1653644587443,MATH 243,A00,087427,Staff,9,0,10,1
1653644588053,MATH 248,A00,087429,Staff,10,0,10,0
1653644588577,MATH 250A,A00,087430,Spolaor; Luca,4,0,8,4
1653644589101,MATH 257A,A00,087431,Spolaor; Luca,7,0,8,1
1653644589626,MATH 258,A00,087432,Staff,9,0,10,1
1653644590154,MATH 264A,A00,087433,Warnke; Lutz Peter,5,0,8,3
1653644590680,MATH 268,A00,087434,Staff,15,0,15,0
1653644591209,MATH 269,A00,087435,Staff,14,0,15,1
1653644591738,MATH 270A,A00,087436,Nie; Jiawang,0,0,8,8
1653644592262,MATH 272A,A00,087437,Tian; Xiaochuan,0,0,8,8
1653644592786,MATH 274,A01,087439,Cheng; Li-Tien,9,0,10,1
1653644592786,MATH 274,A02,087440,Cheng; Li-Tien,10,0,10,0
1653644593308,MATH 278A,A00,087441,Staff,8,0,10,2
1653644593833,MATH 278B,A00,087442,Staff,8,0,10,2
1653644594363,MATH 278C,A00,087443,Staff,8,0,10,2
1653644594886,MATH 280A,A00,087444,Zheng; Tianyi,0,0,8,8
1653644595423,MATH 281A,A00,087445,Bradic; Jelena,0,0,8,9
1653644595946,MATH 282A,A00,087446,Zhang; Danna,0,0,8,8
1653644596470,MATH 283,A00,087447,Tesler; Glenn,0,0,0,16
1653644596999,MATH 286,B00,095535,Kemp; Todd Aahron,5,0,8,3
1653644597523,MATH 287D,B00,095536,Bradic; Jelena,5,0,8,3
1653644598051,MATH 288,A00,087450,Staff,14,0,15,1
1653644598051,MATH 288,B00,087451,Staff,15,0,15,0
1653644598051,MATH 288,C00,087452,Staff,15,0,15,0
1653644598574,MATH 290A,A00,087453,Xu; Zhouli,6,0,8,2
1653644599099,MATH 291A,A00,087454,Xu; Zhouli,7,0,8,1
1653644599622,MATH 292,A00,087455,Staff,10,0,10,0
1653644600158,MATH 295,A00,087456,Staff,50,0,50,0
1653644600681,MATH 297,001,087457,Staff,997,0,999,2
1653645161696,COGS 200,A01,087991,Staff,47,0,50,3
1653645162224,COGS 201,A01,094504,Rangel; Lara M,16,0,25,9
1653645162752,COGS 203,A00,087992,Coulson; Seana M,18,0,20,2
1653645163287,COGS 210A,001,087993,Greene; Deanna Jacquelyn,9998,0,9999,1
1653645163287,COGS 210A,002,087994,Saygin; Ayse P,9999,0,9999,0
1653645163287,COGS 210A,003,087995,Xia; Haijun,9999,0,9999,0
1653645163287,COGS 210A,004,087996,Nitz; Douglas A.,9999,0,9999,0
1653645163287,COGS 210A,005,087997,Hollan; James D.,9999,0,9999,0
1653645163287,COGS 210A,006,087998,Deak; Gedeon O.,9998,0,9999,1
1653645163287,COGS 210A,007,087999,Rossano; Federico,9999,0,9999,0
1653645163809,COGS 211A,A00,088000,Coulson; Seana M,9997,0,9999,2
1653645164336,COGS 229,A00,088002,Staff,22,0,25,3
1653645164858,COGS 260,B00,094231,Staff,17,0,20,3
1653645164858,COGS 260,A00,088004,Nitz; Douglas A.,9998,0,9999,1
1653645165382,CSE 202,A00,090110,Paturi; Ramamohan,0,0,0,0
1653645165382,CSE 202,B00,090111,Paturi; Ramamohan,0,0,0,0
1653645165907,CSE 207B,A00,090112,Heninger; Nadia A,0,0,0,0
1653645166431,CSE 208,A00,094858,Micciancio; Daniele,0,0,0,0
1653645166954,CSE 210,A00,090113,Powell; Thomas Allan,0,0,0,0
1653645167480,CSE 219,A00,090898,Staff,0,0,0,0
1653645168010,CSE 221,A00,090114,Zhou; Yuan-Yuan,0,0,0,0
1653645168534,CSE 229A,A00,090115,Porter; George M,0,0,0,0
1653645169057,CSE 229C,A00,090116,Savage; Stefan,0,0,0,0
1653645169585,CSE 230,A00,090117,Jhala; Ranjit,0,0,0,0
1653645170110,CSE 232,A00,090118,Papakonstantinou; Yannis,0,0,0,0
1653645170633,CSE 239A,A00,090121,Kumar; Arun Kumar,0,0,0,0
1653645171159,CSE 239B,A00,090122,Jhala; Ranjit,0,0,0,0
1653645171683,CSE 240A,A00,090123,Zhao; Jishen,0,0,189,189
1653645172207,CSE 243A,A00,090124,Orailoglu; Alex,0,0,15,15
1653645172730,CSE 249B,A00,090125,Kahng; Andrew Byun,12,0,20,8
1653645173259,CSE 250A,A00,090126,Berg-Kirkpatrick; Taylor D,0,0,0,0
1653645173784,CSE 252A,A00,090127,Ochoa; Benjamin Lawrence,0,0,0,0
1653645174306,CSE 258,A01,090129,McAuley; Julian John,0,0,0,0
1653645174829,CSE 258R,A01,090131,McAuley; Julian John,0,0,0,0
1653645175352,CSE 274,A00,090132,Ramamoorthi; Ravi,0,0,0,0
1653645175879,CSE 276A,A00,090133,Christensen; Henrik I,0,0,0,0
1653645176475,CSE 276C,A00,090134,Christensen; Henrik I,0,0,0,0
1653645177008,CSE 290,A00,090135,Bafna; Vineet,0,0,0,0
1653645177008,CSE 290,B00,090136,Ramamoorthi; Ravi,0,0,0,0
1653645177008,CSE 290,C00,090137,Li; Tzumao,7,0,10,3
1653645177008,CSE 290,D00,090138,Zhou; Yuan-Yuan,9,0,10,1
1653645177008,CSE 290,E00,090139,Christensen; Henrik I,8,0,10,2
1653645177008,CSE 290,F00,094053,Shalev; Aaron D,0,0,0,0
1653645177542,CSE 291,A00,090140,Munyaka; Imani N. S.,0,0,0,0
1653645177542,CSE 291,B00,094880,Yu; Qi,0,0,0,0
1653645177542,CSE 291,C00,090142,Pannuto; Patrick William,0,0,0,0
1653645177542,CSE 291,D00,094881,Zhang; Yiying,0,0,0,0
1653645177542,CSE 291,E00,095118,Su; Hao,0,0,0,0
1653645178090,CSE 293,001,094905,Bafna; Vineet,9999,0,9999,0
1653645178090,CSE 293,002,094906,Bellare; Mihir,9999,0,9999,0
1653645178090,CSE 293,003,094907,Berg-Kirkpatrick; Taylor D,9999,0,9999,0
1653645178090,CSE 293,004,094908,Christensen; Henrik I,9999,0,9999,0
1653645178090,CSE 293,005,094909,Cottrell; Garrison W,9999,0,9999,0
1653645178090,CSE 293,006,094910,Deutsch; Alin Bernard,9999,0,9999,0
1653645178090,CSE 293,007,094911,Esmaeilzadeh; Hadi,9999,0,9999,0
1653645178090,CSE 293,008,094912,Freund; Yoav,9999,0,9999,0
1653645178090,CSE 293,009,094913,Griswold; William G.,9999,0,9999,0
1653645178090,CSE 293,010,094914,Gymrek; Melissa Ann,9999,0,9999,0
1653645178090,CSE 293,011,094915,Heninger; Nadia A,9999,0,9999,0
1653645178090,CSE 293,012,094916,Impagliazzo; Russell,9999,0,9999,0
1653645178090,CSE 293,013,094917,Jhala; Ranjit,9999,0,9999,0
1653645178090,CSE 293,014,094918,Kahng; Andrew Byun,9999,0,9999,0
1653645178090,CSE 293,015,094919,Kane; Daniel Mertz,9999,0,9999,0
1653645178090,CSE 293,016,094920,Kriegman; David J,9999,0,9999,0
1653645178090,CSE 293,017,094921,Kumar; Arun Kumar,9999,0,9999,0
1653645178090,CSE 293,018,094922,Lerner; Sorin,9999,0,9999,0
1653645178090,CSE 293,019,094923,Lovett; Shachar,9999,0,9999,0
1653645178090,CSE 293,020,094924,McAuley; Julian John,9999,0,9999,0
1653645178090,CSE 293,021,094925,Micciancio; Daniele,9999,0,9999,0
1653645178090,CSE 293,022,094926,Orailoglu; Alex,9999,0,9999,0
1653645178090,CSE 293,023,094927,Paturi; Ramamohan,9999,0,9999,0
1653645178090,CSE 293,024,094928,Polikarpova; Nadezhda,9999,0,9999,0
1653645178090,CSE 293,025,094929,Politz; Joseph Gibbs,9999,0,9999,0
1653645178090,CSE 293,026,094930,Porter; George M,9999,0,9999,0
1653645178090,CSE 293,027,094931,Porter; Leonard Emerson,9999,0,9999,0
1653645178090,CSE 293,028,094932,Ramamoorthi; Ravi,9999,0,9999,0
1653645178090,CSE 293,029,094933,Sahoo; Debashis,9999,0,9999,0
1653645178090,CSE 293,030,094934,Saul; Lawrence,9999,0,9999,0
1653645178090,CSE 293,031,094935,Savage; Stefan,9999,0,9999,0
1653645178090,CSE 293,032,094936,Schulze; Jurgen P.,9999,0,9999,0
1653645178090,CSE 293,033,094937,Snoeren; Alex C.,9999,0,9999,0
1653645178090,CSE 293,034,094938,Shang; Jingbo,9999,0,9999,0
1653645178090,CSE 293,035,094939,Stefan; Deian,9999,0,9999,0
1653645178090,CSE 293,036,094940,Su; Hao,9999,0,9999,0
1653645178090,CSE 293,037,094941,Swanson; Steven James,9999,0,9999,0
1653645178090,CSE 293,038,094942,Tullsen; Dean Michael,9999,0,9999,0
1653645178090,CSE 293,039,094943,Voelker; Geoffrey M.,9999,0,9999,0
1653645178090,CSE 293,040,094944,Zhao; Jishen,9999,0,9999,0
1653645178090,CSE 293,041,094945,Zhou; Yuan-Yuan,9999,0,9999,0
1653645178090,CSE 293,042,094946,Gao; Sicun,9998,0,9999,1
1653645178090,CSE 293,043,094947,Weibel; Nadir,9999,0,9999,0
1653645178090,CSE 293,044,094948,Gupta; Rajesh K.,9999,0,9999,0
1653645178616,CSE 294,A00,090143,Porter; George M,9,0,10,1
1653645179138,DSE 200,A00,091799,Staff,50,0,50,0
1653645179661,DSE 203,A00,091800,Gupta; Amarnath,30,0,30,0
1653645180182,DSE 250,A00,091801,Deutsch; Alin Bernard,30,0,30,0
1653645180706,DSE 290,A00,091802,Altintas De Callaf; Ilkay,50,0,50,0
1653645181295,ECE 200,001,091003,Antipa; Nicholas A,9999,0,9999,0
1653645181295,ECE 200,002,091004,Atanasov; Nikolay A.,9999,0,9999,0
1653645181295,ECE 200,003,091005,Bharadia; Dinesh,9999,0,9999,0
1653645181295,ECE 200,004,091006,Cheng; Chung Kuan,9999,0,9999,0
1653645181295,ECE 200,005,091007,Cosman; Pamela C.,9999,0,9999,0
1653645181295,ECE 200,006,091008,Staff,9999,0,9999,0
1653645181295,ECE 200,007,091009,Dayeh; Shadi Ahmad,9999,0,9999,0
1653645181295,ECE 200,008,091010,Fainman; Yeshaiahu,9999,0,9999,0
1653645181295,ECE 200,009,091011,Ford; Joseph Earl,9999,0,9999,0
1653645181295,ECE 200,010,091012,Franceschetti; Massimo,9999,0,9999,0
1653645181295,ECE 200,011,091013,Fullerton; Eric E,9999,0,9999,0
1653645181295,ECE 200,012,091014,Galton; Ian A,9999,0,9999,0
1653645181295,ECE 200,013,091015,Gilja; Vikash,9999,0,9999,0
1653645181295,ECE 200,014,091016,Hall; Drew A.,9999,0,9999,0
1653645181295,ECE 200,015,091017,Hsueh; Tzu-Chien,9999,0,9999,0
1653645181295,ECE 200,016,091018,Javidi; Tara,9999,0,9999,0
1653645181295,ECE 200,017,091019,Kahng; Andrew Byun,9999,0,9999,0
1653645181295,ECE 200,018,091020,Kim; Young-Han,9999,0,9999,0
1653645181295,ECE 200,019,091021,Koushanfar; Farinaz,9999,0,9999,0
1653645181295,ECE 200,020,091022,Kuzum; Duygu,9999,0,9999,0
1653645181295,ECE 200,021,091023,Le; Hanh-Phuc,9999,0,9999,0
1653645181295,ECE 200,022,091024,Lin; Bill,9999,0,9999,0
1653645181295,ECE 200,023,091025,Liu; Zhaowei,9999,0,9999,0
1653645181295,ECE 200,024,091026,Lo; Yu-Hwa,9999,0,9999,0
1653645181295,ECE 200,025,091027,Lomakin; Vitaliy,9999,0,9999,0
1653645181295,ECE 200,026,091028,Mercier; Patrick Philip,9999,0,9999,0
1653645181295,ECE 200,027,091029,Meyer; Florian,9999,0,9999,0
1653645181295,ECE 200,028,091030,Milstein; Laurence B.,9999,0,9999,0
1653645181295,ECE 200,029,091031,Mir Arabbaygi; Siavash,9999,0,9999,0
1653645181295,ECE 200,030,091032,Mookherjea; Shayan,9999,0,9999,0
1653645181295,ECE 200,031,091033,Morris; Karcher William,9999,0,9999,0
1653645181295,ECE 200,032,091034,Ng; Tse Nga,9999,0,9999,0
1653645181295,ECE 200,033,091035,Nguyen; Truong Quang,9999,0,9999,0
1653645181295,ECE 200,034,091036,Nomura; Kenji,9999,0,9999,0
1653645181295,ECE 200,035,091037,Orlitsky; Alon,9999,0,9999,0
1653645181295,ECE 200,036,091038,Pal; Piya,9999,0,9999,0
1653645181295,ECE 200,037,091039,Papen; George C.,9999,0,9999,0
1653645181295,ECE 200,038,091040,Radic; Stojan,9999,0,9999,0
1653645181295,ECE 200,039,091041,Rao; Bhaskar D.,9999,0,9999,0
1653645181295,ECE 200,040,091042,Rao; Ramesh R,9999,0,9999,0
1653645181295,ECE 200,041,091043,Rebeiz; Gabriel,9999,0,9999,0
1653645181295,ECE 200,042,091044,Sanford; John R,9999,0,9999,0
1653645181295,ECE 200,043,091045,Siegel; Paul H.,9999,0,9999,0
1653645181295,ECE 200,044,091046,Sievenpiper; Daniel F.,9999,0,9999,0
1653645181295,ECE 200,045,091047,Sworder; David D.,9999,0,9999,0
1653645181295,ECE 200,046,091048,Taur; Yuan,9999,0,9999,0
1653645181295,ECE 200,047,091049,Touri; Behrouz,9999,0,9999,0
1653645181295,ECE 200,048,091050,Trivedi; Mohan M.,9999,0,9999,0
1653645181295,ECE 200,049,091051,Vardy; Alexander,9999,0,9999,0
1653645181295,ECE 200,050,091052,Vasconcelos; Nuno,9999,0,9999,0
1653645181295,ECE 200,051,091053,Wang; Xiaolong,9999,0,9999,0
1653645181295,ECE 200,052,091054,Xie; Pengtao,9999,0,9999,0
1653645181295,ECE 200,053,091055,Yip; Michael,9999,0,9999,0
1653645181295,ECE 200,054,091056,Zeger; Kenneth A.,9999,0,9999,0
1653645181295,ECE 200,055,091057,Zhang; Xinyu,9999,0,9999,0
1653645181295,ECE 200,056,091058,Turakhia; Yatish Girish,9999,0,9999,0
1653645181295,ECE 200,057,091059,Kang; Mingu,9999,0,9999,0
1653645181295,ECE 200,058,091060,Shi; Yuanyuan,9999,0,9999,0
1653645181295,ECE 200,059,091061,Wang; Edward Jay,9999,0,9999,0
1653645181295,ECE 200,060,091062,Zheng; Yang,9999,0,9999,0
1653645181821,ECE 201,A00,095526,Lo; Yu-Hwa,0,0,0,0
1653645182347,ECE 203,A00,091065,Mercier; Patrick Philip,0,0,0,0
1653645182872,ECE 207A,A00,091605,Liu; Thomas Tao-Ming,0,0,0,0
1653645183395,ECE 212AN,A00,091068,Nomura; Kenji,0,0,0,0
1653645183919,ECE 222A,A00,091069,Rebeiz; Gabriel,0,0,0,0
1653645184450,ECE 225A,A00,091070,Orlitsky; Alon,0,0,0,0
1653645184973,ECE 230A,A00,091071,Nomura; Kenji,0,0,0,0
1653645185505,ECE 236A,A00,091072,Dayeh; Shadi Ahmad,0,0,0,0
1653645186039,ECE 238A,A00,091073,Luo; Jian,0,0,0,0
1653645186039,ECE 238A,B00,091074,Luo; Jian,0,0,0,0
1653645186574,ECE 240A,A00,091075,Radic; Stojan,0,0,0,0
1653645187099,ECE 247A,A00,091592,Shi; Lingyan,0,0,0,0
1653645187623,ECE 250,A00,091076,Touri; Behrouz,0,0,0,0
1653645188146,ECE 251C,A00,091078,Nguyen; Truong Quang,0,0,0,0
1653645188669,ECE 253,A00,091079,Cosman; Pamela C.,0,0,0,0
1653645189191,ECE 255A,A00,091080,Orlitsky; Alon,0,0,0,0
1653645189718,ECE 257A,A00,091081,Zhang; Xinyu,0,0,0,0
1653645190242,ECE 260A,A01,091084,Eldon; John,0,0,0,0
1653645190766,ECE 264C,A00,091085,Galton; Ian A,0,0,0,0
1653645191290,ECE 265C,A00,094889,Presti; Calogero Davide,0,0,0,9
1653645191812,ECE 266,A01,091087,Hall; Drew A.,0,0,0,0
1653645192861,ECE 271A,A00,091090,Vasconcelos; Nuno,0,0,0,0
1653645193392,ECE 272B,A00,091091,Sworder; David D.,0,0,0,0
1653645193919,ECE 275A,A00,091092,Meyer; Florian,0,0,0,0
1653645194443,ECE 277,A00,091093,An; Cheolhong,0,0,0,0
1653645194972,ECE 283,A00,091094,Le; Hanh-Phuc,0,0,0,0
1653645195494,ECE 284,A00,091095,Kang; Mingu,0,0,0,0
1653645195494,ECE 284,B00,091096,Wang; Edward Jay,0,0,0,0
1653645196023,ECE 285,A00,094334,Touri; Behrouz,0,0,0,0
1653645196592,ECE 289,A00,091097,Whelan; David Arthur,0,0,0,0
1653645197115,MATH 200A,A00,087414,Salehi Golsefidy; Alireza,7,0,8,1
1653645197643,MATH 202A,A00,087415,Gill; Philip E.,2,0,8,6
1653645198171,MATH 203A,A00,087416,Oprea; Dragos N.,6,0,8,2
1653645198692,MATH 204A,A00,087417,Kedlaya; Kiran S.,6,0,8,2
1653645199217,MATH 205,A00,087418,Sorensen; Claus M,6,0,8,2
1653645199740,MATH 206A,A00,087419,Izadi; Elham,6,0,8,2
1653645200264,MATH 207A,A00,087420,Mohammadi; Amir,5,0,8,3
1653645200788,MATH 208,A00,087421,Staff,8,0,10,2
1653645201314,MATH 209,A00,087422,Staff,10,0,10,0
1653645201837,MATH 218,A00,087423,Staff,10,0,10,0
1653645202364,MATH 220A,A00,087424,Novak; Jonathan I,6,0,8,2
1653645202889,MATH 231A,A00,087425,Bejenaru; Ioan,3,0,8,5
1653645203413,MATH 240A,A00,087426,Ebenfelt; Peter F,5,0,8,3
1653645203940,MATH 243,A00,087427,Staff,9,0,10,1
1653645204462,MATH 248,A00,087429,Staff,10,0,10,0
1653645204987,MATH 250A,A00,087430,Spolaor; Luca,4,0,8,4
1653645205510,MATH 257A,A00,087431,Spolaor; Luca,7,0,8,1
1653645206037,MATH 258,A00,087432,Staff,9,0,10,1
1653645206565,MATH 264A,A00,087433,Warnke; Lutz Peter,5,0,8,3
1653645207087,MATH 268,A00,087434,Staff,15,0,15,0
1653645207610,MATH 269,A00,087435,Staff,14,0,15,1
1653645208134,MATH 270A,A00,087436,Nie; Jiawang,0,0,8,8
1653645208661,MATH 272A,A00,087437,Tian; Xiaochuan,0,0,8,8
1653645209185,MATH 274,A01,087439,Cheng; Li-Tien,9,0,10,1
1653645209185,MATH 274,A02,087440,Cheng; Li-Tien,10,0,10,0
1653645209708,MATH 278A,A00,087441,Staff,8,0,10,2
1653645210231,MATH 278B,A00,087442,Staff,8,0,10,2
1653645210752,MATH 278C,A00,087443,Staff,8,0,10,2
1653645211275,MATH 280A,A00,087444,Zheng; Tianyi,0,0,8,8
1653645211799,MATH 281A,A00,087445,Bradic; Jelena,0,0,8,9
1653645212327,MATH 282A,A00,087446,Zhang; Danna,0,0,8,8
1653645212851,MATH 283,A00,087447,Tesler; Glenn,0,0,0,16
1653645213376,MATH 286,B00,095535,Kemp; Todd Aahron,5,0,8,3
1653645213901,MATH 287D,B00,095536,Bradic; Jelena,5,0,8,3
1653645214424,MATH 288,A00,087450,Staff,14,0,15,1
1653645214424,MATH 288,B00,087451,Staff,15,0,15,0
1653645214424,MATH 288,C00,087452,Staff,15,0,15,0
1653645214953,MATH 290A,A00,087453,Xu; Zhouli,6,0,8,2
1653645215480,MATH 291A,A00,087454,Xu; Zhouli,7,0,8,1
1653645216006,MATH 292,A00,087455,Staff,10,0,10,0
1653645216530,MATH 295,A00,087456,Staff,50,0,50,0
1653645217052,MATH 297,001,087457,Staff,997,0,999,2
1653645776744,COGS 200,A01,087991,Staff,47,0,50,3
1653645777271,COGS 201,A01,094504,Rangel; Lara M,16,0,25,9
1653645777798,COGS 203,A00,087992,Coulson; Seana M,18,0,20,2
1653645778324,COGS 210A,001,087993,Greene; Deanna Jacquelyn,9998,0,9999,1
1653645778324,COGS 210A,002,087994,Saygin; Ayse P,9999,0,9999,0
1653645778324,COGS 210A,003,087995,Xia; Haijun,9999,0,9999,0
1653645778324,COGS 210A,004,087996,Nitz; Douglas A.,9999,0,9999,0
1653645778324,COGS 210A,005,087997,Hollan; James D.,9999,0,9999,0
1653645778324,COGS 210A,006,087998,Deak; Gedeon O.,9998,0,9999,1
1653645778324,COGS 210A,007,087999,Rossano; Federico,9999,0,9999,0
1653645778846,COGS 211A,A00,088000,Coulson; Seana M,9997,0,9999,2
1653645779372,COGS 229,A00,088002,Staff,22,0,25,3
1653645779895,COGS 260,B00,094231,Staff,17,0,20,3
1653645779895,COGS 260,A00,088004,Nitz; Douglas A.,9998,0,9999,1
1653645780422,CSE 202,A00,090110,Paturi; Ramamohan,0,0,0,0
1653645780422,CSE 202,B00,090111,Paturi; Ramamohan,0,0,0,0
1653645780946,CSE 207B,A00,090112,Heninger; Nadia A,0,0,0,0
1653645781470,CSE 208,A00,094858,Micciancio; Daniele,0,0,0,0
1653645781996,CSE 210,A00,090113,Powell; Thomas Allan,0,0,0,0
1653645782518,CSE 219,A00,090898,Staff,0,0,0,0
1653645783046,CSE 221,A00,090114,Zhou; Yuan-Yuan,0,0,0,0
1653645783573,CSE 229A,A00,090115,Porter; George M,0,0,0,0
1653645784103,CSE 229C,A00,090116,Savage; Stefan,0,0,0,0
1653645784626,CSE 230,A00,090117,Jhala; Ranjit,0,0,0,0
1653645785155,CSE 232,A00,090118,Papakonstantinou; Yannis,0,0,0,0
1653645785678,CSE 239A,A00,090121,Kumar; Arun Kumar,0,0,0,0
1653645786205,CSE 239B,A00,090122,Jhala; Ranjit,0,0,0,0
1653645786732,CSE 240A,A00,090123,Zhao; Jishen,0,0,189,189
1653645787255,CSE 243A,A00,090124,Orailoglu; Alex,0,0,15,15
1653645787784,CSE 249B,A00,090125,Kahng; Andrew Byun,12,0,20,8
1653645788308,CSE 250A,A00,090126,Berg-Kirkpatrick; Taylor D,0,0,0,0
1653645788830,CSE 252A,A00,090127,Ochoa; Benjamin Lawrence,0,0,0,0
1653645789355,CSE 258,A01,090129,McAuley; Julian John,0,0,0,0
1653645789881,CSE 258R,A01,090131,McAuley; Julian John,0,0,0,0
1653645790405,CSE 274,A00,090132,Ramamoorthi; Ravi,0,0,0,0
1653645790928,CSE 276A,A00,090133,Christensen; Henrik I,0,0,0,0
1653645791451,CSE 276C,A00,090134,Christensen; Henrik I,0,0,0,0
1653645791977,CSE 290,A00,090135,Bafna; Vineet,0,0,0,0
1653645791977,CSE 290,B00,090136,Ramamoorthi; Ravi,0,0,0,0
1653645791977,CSE 290,C00,090137,Li; Tzumao,7,0,10,3
1653645791977,CSE 290,D00,090138,Zhou; Yuan-Yuan,9,0,10,1
1653645791977,CSE 290,E00,090139,Christensen; Henrik I,8,0,10,2
1653645791977,CSE 290,F00,094053,Shalev; Aaron D,0,0,0,0
1653645792504,CSE 291,A00,090140,Munyaka; Imani N. S.,0,0,0,0
1653645792504,CSE 291,B00,094880,Yu; Qi,0,0,0,0
1653645792504,CSE 291,C00,090142,Pannuto; Patrick William,0,0,0,0
1653645792504,CSE 291,D00,094881,Zhang; Yiying,0,0,0,0
1653645792504,CSE 291,E00,095118,Su; Hao,0,0,0,0
1653645793057,CSE 293,001,094905,Bafna; Vineet,9999,0,9999,0
1653645793057,CSE 293,002,094906,Bellare; Mihir,9999,0,9999,0
1653645793057,CSE 293,003,094907,Berg-Kirkpatrick; Taylor D,9999,0,9999,0
1653645793057,CSE 293,004,094908,Christensen; Henrik I,9999,0,9999,0
1653645793057,CSE 293,005,094909,Cottrell; Garrison W,9999,0,9999,0
1653645793057,CSE 293,006,094910,Deutsch; Alin Bernard,9999,0,9999,0
1653645793057,CSE 293,007,094911,Esmaeilzadeh; Hadi,9999,0,9999,0
1653645793057,CSE 293,008,094912,Freund; Yoav,9999,0,9999,0
1653645793057,CSE 293,009,094913,Griswold; William G.,9999,0,9999,0
1653645793057,CSE 293,010,094914,Gymrek; Melissa Ann,9999,0,9999,0
1653645793057,CSE 293,011,094915,Heninger; Nadia A,9999,0,9999,0
1653645793057,CSE 293,012,094916,Impagliazzo; Russell,9999,0,9999,0
1653645793057,CSE 293,013,094917,Jhala; Ranjit,9999,0,9999,0
1653645793057,CSE 293,014,094918,Kahng; Andrew Byun,9999,0,9999,0
1653645793057,CSE 293,015,094919,Kane; Daniel Mertz,9999,0,9999,0
1653645793057,CSE 293,016,094920,Kriegman; David J,9999,0,9999,0
1653645793057,CSE 293,017,094921,Kumar; Arun Kumar,9999,0,9999,0
1653645793057,CSE 293,018,094922,Lerner; Sorin,9999,0,9999,0
1653645793057,CSE 293,019,094923,Lovett; Shachar,9999,0,9999,0
1653645793057,CSE 293,020,094924,McAuley; Julian John,9999,0,9999,0
1653645793057,CSE 293,021,094925,Micciancio; Daniele,9999,0,9999,0
1653645793057,CSE 293,022,094926,Orailoglu; Alex,9999,0,9999,0
1653645793057,CSE 293,023,094927,Paturi; Ramamohan,9999,0,9999,0
1653645793057,CSE 293,024,094928,Polikarpova; Nadezhda,9999,0,9999,0
1653645793057,CSE 293,025,094929,Politz; Joseph Gibbs,9999,0,9999,0
1653645793057,CSE 293,026,094930,Porter; George M,9999,0,9999,0
1653645793057,CSE 293,027,094931,Porter; Leonard Emerson,9999,0,9999,0
1653645793057,CSE 293,028,094932,Ramamoorthi; Ravi,9999,0,9999,0
1653645793057,CSE 293,029,094933,Sahoo; Debashis,9999,0,9999,0
1653645793057,CSE 293,030,094934,Saul; Lawrence,9999,0,9999,0
1653645793057,CSE 293,031,094935,Savage; Stefan,9999,0,9999,0
1653645793057,CSE 293,032,094936,Schulze; Jurgen P.,9999,0,9999,0
1653645793057,CSE 293,033,094937,Snoeren; Alex C.,9999,0,9999,0
1653645793057,CSE 293,034,094938,Shang; Jingbo,9999,0,9999,0
1653645793057,CSE 293,035,094939,Stefan; Deian,9999,0,9999,0
1653645793057,CSE 293,036,094940,Su; Hao,9999,0,9999,0
1653645793057,CSE 293,037,094941,Swanson; Steven James,9999,0,9999,0
1653645793057,CSE 293,038,094942,Tullsen; Dean Michael,9999,0,9999,0
1653645793057,CSE 293,039,094943,Voelker; Geoffrey M.,9999,0,9999,0
1653645793057,CSE 293,040,094944,Zhao; Jishen,9999,0,9999,0
1653645793057,CSE 293,041,094945,Zhou; Yuan-Yuan,9999,0,9999,0
1653645793057,CSE 293,042,094946,Gao; Sicun,9998,0,9999,1
1653645793057,CSE 293,043,094947,Weibel; Nadir,9999,0,9999,0
1653645793057,CSE 293,044,094948,Gupta; Rajesh K.,9999,0,9999,0
1653645793581,CSE 294,A00,090143,Porter; George M,9,0,10,1
1653645794107,DSE 200,A00,091799,Staff,50,0,50,0
1653645794629,DSE 203,A00,091800,Gupta; Amarnath,30,0,30,0
1653645795155,DSE 250,A00,091801,Deutsch; Alin Bernard,30,0,30,0
1653645795683,DSE 290,A00,091802,Altintas De Callaf; Ilkay,50,0,50,0
1653645796250,ECE 200,001,091003,Antipa; Nicholas A,9999,0,9999,0
1653645796250,ECE 200,002,091004,Atanasov; Nikolay A.,9999,0,9999,0
1653645796250,ECE 200,003,091005,Bharadia; Dinesh,9999,0,9999,0
1653645796250,ECE 200,004,091006,Cheng; Chung Kuan,9999,0,9999,0
1653645796250,ECE 200,005,091007,Cosman; Pamela C.,9999,0,9999,0
1653645796250,ECE 200,006,091008,Staff,9999,0,9999,0
1653645796250,ECE 200,007,091009,Dayeh; Shadi Ahmad,9999,0,9999,0
1653645796250,ECE 200,008,091010,Fainman; Yeshaiahu,9999,0,9999,0
1653645796250,ECE 200,009,091011,Ford; Joseph Earl,9999,0,9999,0
1653645796250,ECE 200,010,091012,Franceschetti; Massimo,9999,0,9999,0
1653645796250,ECE 200,011,091013,Fullerton; Eric E,9999,0,9999,0
1653645796250,ECE 200,012,091014,Galton; Ian A,9999,0,9999,0
1653645796250,ECE 200,013,091015,Gilja; Vikash,9999,0,9999,0
1653645796250,ECE 200,014,091016,Hall; Drew A.,9999,0,9999,0
1653645796250,ECE 200,015,091017,Hsueh; Tzu-Chien,9999,0,9999,0
1653645796250,ECE 200,016,091018,Javidi; Tara,9999,0,9999,0
1653645796250,ECE 200,017,091019,Kahng; Andrew Byun,9999,0,9999,0
1653645796250,ECE 200,018,091020,Kim; Young-Han,9999,0,9999,0
1653645796250,ECE 200,019,091021,Koushanfar; Farinaz,9999,0,9999,0
1653645796250,ECE 200,020,091022,Kuzum; Duygu,9999,0,9999,0
1653645796250,ECE 200,021,091023,Le; Hanh-Phuc,9999,0,9999,0
1653645796250,ECE 200,022,091024,Lin; Bill,9999,0,9999,0
1653645796250,ECE 200,023,091025,Liu; Zhaowei,9999,0,9999,0
1653645796250,ECE 200,024,091026,Lo; Yu-Hwa,9999,0,9999,0
1653645796250,ECE 200,025,091027,Lomakin; Vitaliy,9999,0,9999,0
1653645796250,ECE 200,026,091028,Mercier; Patrick Philip,9999,0,9999,0
1653645796250,ECE 200,027,091029,Meyer; Florian,9999,0,9999,0
1653645796250,ECE 200,028,091030,Milstein; Laurence B.,9999,0,9999,0
1653645796250,ECE 200,029,091031,Mir Arabbaygi; Siavash,9999,0,9999,0
1653645796250,ECE 200,030,091032,Mookherjea; Shayan,9999,0,9999,0
1653645796250,ECE 200,031,091033,Morris; Karcher William,9999,0,9999,0
1653645796250,ECE 200,032,091034,Ng; Tse Nga,9999,0,9999,0
1653645796250,ECE 200,033,091035,Nguyen; Truong Quang,9999,0,9999,0
1653645796250,ECE 200,034,091036,Nomura; Kenji,9999,0,9999,0
1653645796250,ECE 200,035,091037,Orlitsky; Alon,9999,0,9999,0
1653645796250,ECE 200,036,091038,Pal; Piya,9999,0,9999,0
1653645796250,ECE 200,037,091039,Papen; George C.,9999,0,9999,0
1653645796250,ECE 200,038,091040,Radic; Stojan,9999,0,9999,0
1653645796250,ECE 200,039,091041,Rao; Bhaskar D.,9999,0,9999,0
1653645796250,ECE 200,040,091042,Rao; Ramesh R,9999,0,9999,0
1653645796250,ECE 200,041,091043,Rebeiz; Gabriel,9999,0,9999,0
1653645796250,ECE 200,042,091044,Sanford; John R,9999,0,9999,0
1653645796250,ECE 200,043,091045,Siegel; Paul H.,9999,0,9999,0
1653645796250,ECE 200,044,091046,Sievenpiper; Daniel F.,9999,0,9999,0
1653645796250,ECE 200,045,091047,Sworder; David D.,9999,0,9999,0
1653645796250,ECE 200,046,091048,Taur; Yuan,9999,0,9999,0
1653645796250,ECE 200,047,091049,Touri; Behrouz,9999,0,9999,0
1653645796250,ECE 200,048,091050,Trivedi; Mohan M.,9999,0,9999,0
1653645796250,ECE 200,049,091051,Vardy; Alexander,9999,0,9999,0
1653645796250,ECE 200,050,091052,Vasconcelos; Nuno,9999,0,9999,0
1653645796250,ECE 200,051,091053,Wang; Xiaolong,9999,0,9999,0
1653645796250,ECE 200,052,091054,Xie; Pengtao,9999,0,9999,0
1653645796250,ECE 200,053,091055,Yip; Michael,9999,0,9999,0
1653645796250,ECE 200,054,091056,Zeger; Kenneth A.,9999,0,9999,0
1653645796250,ECE 200,055,091057,Zhang; Xinyu,9999,0,9999,0
1653645796250,ECE 200,056,091058,Turakhia; Yatish Girish,9999,0,9999,0
1653645796250,ECE 200,057,091059,Kang; Mingu,9999,0,9999,0
1653645796250,ECE 200,058,091060,Shi; Yuanyuan,9999,0,9999,0
1653645796250,ECE 200,059,091061,Wang; Edward Jay,9999,0,9999,0
1653645796250,ECE 200,060,091062,Zheng; Yang,9999,0,9999,0
1653645796776,ECE 201,A00,095526,Lo; Yu-Hwa,0,0,0,0
1653645797300,ECE 203,A00,091065,Mercier; Patrick Philip,0,0,0,0
1653645797823,ECE 207A,A00,091605,Liu; Thomas Tao-Ming,0,0,0,0
1653645798350,ECE 212AN,A00,091068,Nomura; Kenji,0,0,0,0
1653645798871,ECE 222A,A00,091069,Rebeiz; Gabriel,0,0,0,0
1653645799405,ECE 225A,A00,091070,Orlitsky; Alon,0,0,0,0
1653645799931,ECE 230A,A00,091071,Nomura; Kenji,0,0,0,0
1653645800459,ECE 236A,A00,091072,Dayeh; Shadi Ahmad,0,0,0,0
1653645800982,ECE 238A,A00,091073,Luo; Jian,0,0,0,0
1653645800982,ECE 238A,B00,091074,Luo; Jian,0,0,0,0
1653645801505,ECE 240A,A00,091075,Radic; Stojan,0,0,0,0
1653645802029,ECE 247A,A00,091592,Shi; Lingyan,0,0,0,0
1653645802555,ECE 250,A00,091076,Touri; Behrouz,0,0,0,0
1653645803082,ECE 251C,A00,091078,Nguyen; Truong Quang,0,0,0,0
1653645803607,ECE 253,A00,091079,Cosman; Pamela C.,0,0,0,0
1653645804130,ECE 255A,A00,091080,Orlitsky; Alon,0,0,0,0
1653645804657,ECE 257A,A00,091081,Zhang; Xinyu,0,0,0,0
1653645805184,ECE 260A,A01,091084,Eldon; John,0,0,0,0
1653645805719,ECE 264C,A00,091085,Galton; Ian A,0,0,0,0
1653645806246,ECE 265C,A00,094889,Presti; Calogero Davide,0,0,0,9
1653645806768,ECE 266,A01,091087,Hall; Drew A.,0,0,0,0
1653645807820,ECE 271A,A00,091090,Vasconcelos; Nuno,0,0,0,0
1653645808348,ECE 272B,A00,091091,Sworder; David D.,0,0,0,0
1653645808910,ECE 275A,A00,091092,Meyer; Florian,0,0,0,0
1653645809444,ECE 277,A00,091093,An; Cheolhong,0,0,0,0
1653645809972,ECE 283,A00,091094,Le; Hanh-Phuc,0,0,0,0
1653645810499,ECE 284,A00,091095,Kang; Mingu,0,0,0,0
1653645810499,ECE 284,B00,091096,Wang; Edward Jay,0,0,0,0
1653645811023,ECE 285,A00,094334,Touri; Behrouz,0,0,0,0
1653645811552,ECE 289,A00,091097,Whelan; David Arthur,0,0,0,0
1653645812075,MATH 200A,A00,087414,Salehi Golsefidy; Alireza,7,0,8,1
1653645812599,MATH 202A,A00,087415,Gill; Philip E.,2,0,8,6
1653645813123,MATH 203A,A00,087416,Oprea; Dragos N.,6,0,8,2
1653645813653,MATH 204A,A00,087417,Kedlaya; Kiran S.,6,0,8,2
1653645814175,MATH 205,A00,087418,Sorensen; Claus M,6,0,8,2
1653645814700,MATH 206A,A00,087419,Izadi; Elham,6,0,8,2
1653645815223,MATH 207A,A00,087420,Mohammadi; Amir,5,0,8,3
1653645815747,MATH 208,A00,087421,Staff,8,0,10,2
1653645816272,MATH 209,A00,087422,Staff,10,0,10,0
1653645816885,MATH 218,A00,087423,Staff,10,0,10,0
1653645817407,MATH 220A,A00,087424,Novak; Jonathan I,6,0,8,2
1653645817932,MATH 231A,A00,087425,Bejenaru; Ioan,3,0,8,5
1653645818455,MATH 240A,A00,087426,Ebenfelt; Peter F,5,0,8,3
1653645818979,MATH 243,A00,087427,Staff,9,0,10,1
1653645819506,MATH 248,A00,087429,Staff,10,0,10,0
1653645820045,MATH 250A,A00,087430,Spolaor; Luca,4,0,8,4
1653645820568,MATH 257A,A00,087431,Spolaor; Luca,7,0,8,1
1653645821094,MATH 258,A00,087432,Staff,9,0,10,1
1653645821628,MATH 264A,A00,087433,Warnke; Lutz Peter,5,0,8,3
1653645822152,MATH 268,A00,087434,Staff,15,0,15,0
1653645822676,MATH 269,A00,087435,Staff,14,0,15,1
1653645823198,MATH 270A,A00,087436,Nie; Jiawang,0,0,8,8
1653645823724,MATH 272A,A00,087437,Tian; Xiaochuan,0,0,8,8
1653645824249,MATH 274,A01,087439,Cheng; Li-Tien,9,0,10,1
1653645824249,MATH 274,A02,087440,Cheng; Li-Tien,10,0,10,0
1653645824770,MATH 278A,A00,087441,Staff,8,0,10,2
1653645825353,MATH 278B,A00,087442,Staff,8,0,10,2
1653645825876,MATH 278C,A00,087443,Staff,8,0,10,2
1653645826399,MATH 280A,A00,087444,Zheng; Tianyi,0,0,8,8
1653645826934,MATH 281A,A00,087445,Bradic; Jelena,0,0,8,9
1653645827457,MATH 282A,A00,087446,Zhang; Danna,0,0,8,8
1653645827984,MATH 283,A00,087447,Tesler; Glenn,0,0,0,16
1653645828509,MATH 286,B00,095535,Kemp; Todd Aahron,5,0,8,3
1653645829035,MATH 287D,B00,095536,Bradic; Jelena,5,0,8,3
1653645829557,MATH 288,A00,087450,Staff,14,0,15,1
1653645829557,MATH 288,B00,087451,Staff,15,0,15,0
1653645829557,MATH 288,C00,087452,Staff,15,0,15,0
1653645830079,MATH 290A,A00,087453,Xu; Zhouli,6,0,8,2
1653645830602,MATH 291A,A00,087454,Xu; Zhouli,7,0,8,1
1653645831130,MATH 292,A00,087455,Staff,10,0,10,0
1653645831660,MATH 295,A00,087456,Staff,50,0,50,0
1653645832196,MATH 297,001,087457,Staff,997,0,999,2
1653646392334,COGS 200,A01,087991,Staff,47,0,50,3
1653646392867,COGS 201,A01,094504,Rangel; Lara M,16,0,25,9
1653646393391,COGS 203,A00,087992,Coulson; Seana M,18,0,20,2
1653646393915,COGS 210A,001,087993,Greene; Deanna Jacquelyn,9998,0,9999,1
1653646393915,COGS 210A,002,087994,Saygin; Ayse P,9999,0,9999,0
1653646393915,COGS 210A,003,087995,Xia; Haijun,9999,0,9999,0
1653646393915,COGS 210A,004,087996,Nitz; Douglas A.,9999,0,9999,0
1653646393915,COGS 210A,005,087997,Hollan; James D.,9999,0,9999,0
1653646393915,COGS 210A,006,087998,Deak; Gedeon O.,9998,0,9999,1
1653646393915,COGS 210A,007,087999,Rossano; Federico,9999,0,9999,0
1653646394442,COGS 211A,A00,088000,Coulson; Seana M,9997,0,9999,2
1653646394965,COGS 229,A00,088002,Staff,22,0,25,3
1653646395493,COGS 260,B00,094231,Staff,17,0,20,3
1653646395493,COGS 260,A00,088004,Nitz; Douglas A.,9998,0,9999,1
1653646396019,CSE 202,A00,090110,Paturi; Ramamohan,0,0,0,0
1653646396019,CSE 202,B00,090111,Paturi; Ramamohan,0,0,0,0
1653646396541,CSE 207B,A00,090112,Heninger; Nadia A,0,0,0,0
1653646397069,CSE 208,A00,094858,Micciancio; Daniele,0,0,0,0
1653646397596,CSE 210,A00,090113,Powell; Thomas Allan,0,0,0,0
1653646398121,CSE 219,A00,090898,Staff,0,0,0,0
1653646398647,CSE 221,A00,090114,Zhou; Yuan-Yuan,0,0,0,0
1653646399173,CSE 229A,A00,090115,Porter; George M,0,0,0,0
1653646399700,CSE 229C,A00,090116,Savage; Stefan,0,0,0,0
1653646400225,CSE 230,A00,090117,Jhala; Ranjit,0,0,0,0
1653646400752,CSE 232,A00,090118,Papakonstantinou; Yannis,0,0,0,0
1653646401275,CSE 239A,A00,090121,Kumar; Arun Kumar,0,0,0,0
1653646401803,CSE 239B,A00,090122,Jhala; Ranjit,0,0,0,0
1653646402330,CSE 240A,A00,090123,Zhao; Jishen,0,0,189,189
1653646402857,CSE 243A,A00,090124,Orailoglu; Alex,0,0,15,15
1653646403380,CSE 249B,A00,090125,Kahng; Andrew Byun,12,0,20,8
1653646403905,CSE 250A,A00,090126,Berg-Kirkpatrick; Taylor D,0,0,0,0
1653646404528,CSE 252A,A00,090127,Ochoa; Benjamin Lawrence,0,0,0,0
1653646405054,CSE 258,A01,090129,McAuley; Julian John,0,0,0,0
1653646405584,CSE 258R,A01,090131,McAuley; Julian John,0,0,0,0
1653646406107,CSE 274,A00,090132,Ramamoorthi; Ravi,0,0,0,0
1653646406633,CSE 276A,A00,090133,Christensen; Henrik I,0,0,0,0
1653646407158,CSE 276C,A00,090134,Christensen; Henrik I,0,0,0,0
1653646407682,CSE 290,A00,090135,Bafna; Vineet,0,0,0,0
1653646407682,CSE 290,B00,090136,Ramamoorthi; Ravi,0,0,0,0
1653646407682,CSE 290,C00,090137,Li; Tzumao,7,0,10,3
1653646407682,CSE 290,D00,090138,Zhou; Yuan-Yuan,9,0,10,1
1653646407682,CSE 290,E00,090139,Christensen; Henrik I,8,0,10,2
1653646407682,CSE 290,F00,094053,Shalev; Aaron D,0,0,0,0
1653646408212,CSE 291,A00,090140,Munyaka; Imani N. S.,0,0,0,0
1653646408212,CSE 291,B00,094880,Yu; Qi,0,0,0,0
1653646408212,CSE 291,C00,090142,Pannuto; Patrick William,0,0,0,0
1653646408212,CSE 291,D00,094881,Zhang; Yiying,0,0,0,0
1653646408212,CSE 291,E00,095118,Su; Hao,0,0,0,0
1653646408742,CSE 293,001,094905,Bafna; Vineet,9999,0,9999,0
1653646408742,CSE 293,002,094906,Bellare; Mihir,9999,0,9999,0
1653646408742,CSE 293,003,094907,Berg-Kirkpatrick; Taylor D,9999,0,9999,0
1653646408742,CSE 293,004,094908,Christensen; Henrik I,9999,0,9999,0
1653646408742,CSE 293,005,094909,Cottrell; Garrison W,9999,0,9999,0
1653646408742,CSE 293,006,094910,Deutsch; Alin Bernard,9999,0,9999,0
1653646408742,CSE 293,007,094911,Esmaeilzadeh; Hadi,9999,0,9999,0
1653646408742,CSE 293,008,094912,Freund; Yoav,9999,0,9999,0
1653646408742,CSE 293,009,094913,Griswold; William G.,9999,0,9999,0
1653646408742,CSE 293,010,094914,Gymrek; Melissa Ann,9999,0,9999,0
1653646408742,CSE 293,011,094915,Heninger; Nadia A,9999,0,9999,0
1653646408742,CSE 293,012,094916,Impagliazzo; Russell,9999,0,9999,0
1653646408742,CSE 293,013,094917,Jhala; Ranjit,9999,0,9999,0
1653646408742,CSE 293,014,094918,Kahng; Andrew Byun,9999,0,9999,0
1653646408742,CSE 293,015,094919,Kane; Daniel Mertz,9999,0,9999,0
1653646408742,CSE 293,016,094920,Kriegman; David J,9999,0,9999,0
1653646408742,CSE 293,017,094921,Kumar; Arun Kumar,9999,0,9999,0
1653646408742,CSE 293,018,094922,Lerner; Sorin,9999,0,9999,0
1653646408742,CSE 293,019,094923,Lovett; Shachar,9999,0,9999,0
1653646408742,CSE 293,020,094924,McAuley; Julian John,9999,0,9999,0
1653646408742,CSE 293,021,094925,Micciancio; Daniele,9999,0,9999,0
1653646408742,CSE 293,022,094926,Orailoglu; Alex,9999,0,9999,0
1653646408742,CSE 293,023,094927,Paturi; Ramamohan,9999,0,9999,0
1653646408742,CSE 293,024,094928,Polikarpova; Nadezhda,9999,0,9999,0
1653646408742,CSE 293,025,094929,Politz; Joseph Gibbs,9999,0,9999,0
1653646408742,CSE 293,026,094930,Porter; George M,9999,0,9999,0
1653646408742,CSE 293,027,094931,Porter; Leonard Emerson,9999,0,9999,0
1653646408742,CSE 293,028,094932,Ramamoorthi; Ravi,9999,0,9999,0
1653646408742,CSE 293,029,094933,Sahoo; Debashis,9999,0,9999,0
1653646408742,CSE 293,030,094934,Saul; Lawrence,9999,0,9999,0
1653646408742,CSE 293,031,094935,Savage; Stefan,9999,0,9999,0
1653646408742,CSE 293,032,094936,Schulze; Jurgen P.,9999,0,9999,0
1653646408742,CSE 293,033,094937,Snoeren; Alex C.,9999,0,9999,0
1653646408742,CSE 293,034,094938,Shang; Jingbo,9999,0,9999,0
1653646408742,CSE 293,035,094939,Stefan; Deian,9999,0,9999,0
1653646408742,CSE 293,036,094940,Su; Hao,9999,0,9999,0
1653646408742,CSE 293,037,094941,Swanson; Steven James,9999,0,9999,0
1653646408742,CSE 293,038,094942,Tullsen; Dean Michael,9999,0,9999,0
1653646408742,CSE 293,039,094943,Voelker; Geoffrey M.,9999,0,9999,0
1653646408742,CSE 293,040,094944,Zhao; Jishen,9999,0,9999,0
1653646408742,CSE 293,041,094945,Zhou; Yuan-Yuan,9999,0,9999,0
1653646408742,CSE 293,042,094946,Gao; Sicun,9998,0,9999,1
1653646408742,CSE 293,043,094947,Weibel; Nadir,9999,0,9999,0
1653646408742,CSE 293,044,094948,Gupta; Rajesh K.,9999,0,9999,0
1653646409266,CSE 294,A00,090143,Porter; George M,9,0,10,1
1653646409790,DSE 200,A00,091799,Staff,50,0,50,0
1653646410322,DSE 203,A00,091800,Gupta; Amarnath,30,0,30,0
1653646410845,DSE 250,A00,091801,Deutsch; Alin Bernard,30,0,30,0
1653646411375,DSE 290,A00,091802,Altintas De Callaf; Ilkay,50,0,50,0
1653646411934,ECE 200,001,091003,Antipa; Nicholas A,9999,0,9999,0
1653646411934,ECE 200,002,091004,Atanasov; Nikolay A.,9999,0,9999,0
1653646411934,ECE 200,003,091005,Bharadia; Dinesh,9999,0,9999,0
1653646411934,ECE 200,004,091006,Cheng; Chung Kuan,9999,0,9999,0
1653646411934,ECE 200,005,091007,Cosman; Pamela C.,9999,0,9999,0
1653646411934,ECE 200,006,091008,Staff,9999,0,9999,0
1653646411934,ECE 200,007,091009,Dayeh; Shadi Ahmad,9999,0,9999,0
1653646411934,ECE 200,008,091010,Fainman; Yeshaiahu,9999,0,9999,0
1653646411934,ECE 200,009,091011,Ford; Joseph Earl,9999,0,9999,0
1653646411934,ECE 200,010,091012,Franceschetti; Massimo,9999,0,9999,0
1653646411934,ECE 200,011,091013,Fullerton; Eric E,9999,0,9999,0
1653646411934,ECE 200,012,091014,Galton; Ian A,9999,0,9999,0
1653646411934,ECE 200,013,091015,Gilja; Vikash,9999,0,9999,0
1653646411934,ECE 200,014,091016,Hall; Drew A.,9999,0,9999,0
1653646411934,ECE 200,015,091017,Hsueh; Tzu-Chien,9999,0,9999,0
1653646411934,ECE 200,016,091018,Javidi; Tara,9999,0,9999,0
1653646411934,ECE 200,017,091019,Kahng; Andrew Byun,9999,0,9999,0
1653646411934,ECE 200,018,091020,Kim; Young-Han,9999,0,9999,0
1653646411934,ECE 200,019,091021,Koushanfar; Farinaz,9999,0,9999,0
1653646411934,ECE 200,020,091022,Kuzum; Duygu,9999,0,9999,0
1653646411934,ECE 200,021,091023,Le; Hanh-Phuc,9999,0,9999,0
1653646411934,ECE 200,022,091024,Lin; Bill,9999,0,9999,0
1653646411934,ECE 200,023,091025,Liu; Zhaowei,9999,0,9999,0
1653646411934,ECE 200,024,091026,Lo; Yu-Hwa,9999,0,9999,0
1653646411934,ECE 200,025,091027,Lomakin; Vitaliy,9999,0,9999,0
1653646411934,ECE 200,026,091028,Mercier; Patrick Philip,9999,0,9999,0
1653646411934,ECE 200,027,091029,Meyer; Florian,9999,0,9999,0
1653646411934,ECE 200,028,091030,Milstein; Laurence B.,9999,0,9999,0
1653646411934,ECE 200,029,091031,Mir Arabbaygi; Siavash,9999,0,9999,0
1653646411934,ECE 200,030,091032,Mookherjea; Shayan,9999,0,9999,0
1653646411934,ECE 200,031,091033,Morris; Karcher William,9999,0,9999,0
1653646411934,ECE 200,032,091034,Ng; Tse Nga,9999,0,9999,0
1653646411934,ECE 200,033,091035,Nguyen; Truong Quang,9999,0,9999,0
1653646411934,ECE 200,034,091036,Nomura; Kenji,9999,0,9999,0
1653646411934,ECE 200,035,091037,Orlitsky; Alon,9999,0,9999,0
1653646411934,ECE 200,036,091038,Pal; Piya,9999,0,9999,0
1653646411934,ECE 200,037,091039,Papen; George C.,9999,0,9999,0
1653646411934,ECE 200,038,091040,Radic; Stojan,9999,0,9999,0
1653646411934,ECE 200,039,091041,Rao; Bhaskar D.,9999,0,9999,0
1653646411934,ECE 200,040,091042,Rao; Ramesh R,9999,0,9999,0
1653646411934,ECE 200,041,091043,Rebeiz; Gabriel,9999,0,9999,0
1653646411934,ECE 200,042,091044,Sanford; John R,9999,0,9999,0
1653646411934,ECE 200,043,091045,Siegel; Paul H.,9999,0,9999,0
1653646411934,ECE 200,044,091046,Sievenpiper; Daniel F.,9999,0,9999,0
1653646411934,ECE 200,045,091047,Sworder; David D.,9999,0,9999,0
1653646411934,ECE 200,046,091048,Taur; Yuan,9999,0,9999,0
1653646411934,ECE 200,047,091049,Touri; Behrouz,9999,0,9999,0
1653646411934,ECE 200,048,091050,Trivedi; Mohan M.,9999,0,9999,0
1653646411934,ECE 200,049,091051,Vardy; Alexander,9999,0,9999,0
1653646411934,ECE 200,050,091052,Vasconcelos; Nuno,9999,0,9999,0
1653646411934,ECE 200,051,091053,Wang; Xiaolong,9999,0,9999,0
1653646411934,ECE 200,052,091054,Xie; Pengtao,9999,0,9999,0
1653646411934,ECE 200,053,091055,Yip; Michael,9999,0,9999,0
1653646411934,ECE 200,054,091056,Zeger; Kenneth A.,9999,0,9999,0
1653646411934,ECE 200,055,091057,Zhang; Xinyu,9999,0,9999,0
1653646411934,ECE 200,056,091058,Turakhia; Yatish Girish,9999,0,9999,0
1653646411934,ECE 200,057,091059,Kang; Mingu,9999,0,9999,0
1653646411934,ECE 200,058,091060,Shi; Yuanyuan,9999,0,9999,0
1653646411934,ECE 200,059,091061,Wang; Edward Jay,9999,0,9999,0
1653646411934,ECE 200,060,091062,Zheng; Yang,9999,0,9999,0
1653646412463,ECE 201,A00,095526,Lo; Yu-Hwa,0,0,0,0
1653646412987,ECE 203,A00,091065,Mercier; Patrick Philip,0,0,0,0
1653646413514,ECE 207A,A00,091605,Liu; Thomas Tao-Ming,0,0,0,0
1653646414040,ECE 212AN,A00,091068,Nomura; Kenji,0,0,0,0
1653646414578,ECE 222A,A00,091069,Rebeiz; Gabriel,0,0,0,0
1653646415101,ECE 225A,A00,091070,Orlitsky; Alon,0,0,0,0
1653646415627,ECE 230A,A00,091071,Nomura; Kenji,0,0,0,0
1653646416151,ECE 236A,A00,091072,Dayeh; Shadi Ahmad,0,0,0,0
1653646416678,ECE 238A,A00,091073,Luo; Jian,0,0,0,0
1653646416678,ECE 238A,B00,091074,Luo; Jian,0,0,0,0
1653646417207,ECE 240A,A00,091075,Radic; Stojan,0,0,0,0
1653646417735,ECE 247A,A00,091592,Shi; Lingyan,0,0,0,0
1653646418259,ECE 250,A00,091076,Touri; Behrouz,0,0,0,0
1653646418786,ECE 251C,A00,091078,Nguyen; Truong Quang,0,0,0,0
1653646419309,ECE 253,A00,091079,Cosman; Pamela C.,0,0,0,0
1653646419838,ECE 255A,A00,091080,Orlitsky; Alon,0,0,0,0
1653646420365,ECE 257A,A00,091081,Zhang; Xinyu,0,0,0,0
1653646420888,ECE 260A,A01,091084,Eldon; John,0,0,0,0
1653646421416,ECE 264C,A00,091085,Galton; Ian A,0,0,0,0
1653646421941,ECE 265C,A00,094889,Presti; Calogero Davide,0,0,0,9
1653646422464,ECE 266,A01,091087,Hall; Drew A.,0,0,0,0
1653646423512,ECE 271A,A00,091090,Vasconcelos; Nuno,0,0,0,0
1653646424039,ECE 272B,A00,091091,Sworder; David D.,0,0,0,0
1653646424565,ECE 275A,A00,091092,Meyer; Florian,0,0,0,0
1653646425104,ECE 277,A00,091093,An; Cheolhong,0,0,0,0
1653646425628,ECE 283,A00,091094,Le; Hanh-Phuc,0,0,0,0
1653646426153,ECE 284,A00,091095,Kang; Mingu,0,0,0,0
1653646426153,ECE 284,B00,091096,Wang; Edward Jay,0,0,0,0
1653646426676,ECE 285,A00,094334,Touri; Behrouz,0,0,0,0
1653646427201,ECE 289,A00,091097,Whelan; David Arthur,0,0,0,0
1653646427730,MATH 200A,A00,087414,Salehi Golsefidy; Alireza,7,0,8,1
1653646428253,MATH 202A,A00,087415,Gill; Philip E.,2,0,8,6
1653646428778,MATH 203A,A00,087416,Oprea; Dragos N.,6,0,8,2
1653646429304,MATH 204A,A00,087417,Kedlaya; Kiran S.,6,0,8,2
1653646429830,MATH 205,A00,087418,Sorensen; Claus M,6,0,8,2
1653646430354,MATH 206A,A00,087419,Izadi; Elham,6,0,8,2
1653646430880,MATH 207A,A00,087420,Mohammadi; Amir,5,0,8,3
1653646431404,MATH 208,A00,087421,Staff,8,0,10,2
1653646431929,MATH 209,A00,087422,Staff,10,0,10,0
1653646432451,MATH 218,A00,087423,Staff,10,0,10,0
1653646432975,MATH 220A,A00,087424,Novak; Jonathan I,6,0,8,2
1653646433505,MATH 231A,A00,087425,Bejenaru; Ioan,3,0,8,5
1653646434032,MATH 240A,A00,087426,Ebenfelt; Peter F,5,0,8,3
1653646434556,MATH 243,A00,087427,Staff,9,0,10,1
1653646435081,MATH 248,A00,087429,Staff,10,0,10,0
1653646435609,MATH 250A,A00,087430,Spolaor; Luca,4,0,8,4
1653646436133,MATH 257A,A00,087431,Spolaor; Luca,7,0,8,1
1653646436658,MATH 258,A00,087432,Staff,9,0,10,1
1653646437180,MATH 264A,A00,087433,Warnke; Lutz Peter,5,0,8,3
1653646437704,MATH 268,A00,087434,Staff,15,0,15,0
1653646438236,MATH 269,A00,087435,Staff,14,0,15,1
1653646438763,MATH 270A,A00,087436,Nie; Jiawang,0,0,8,8
1653646439286,MATH 272A,A00,087437,Tian; Xiaochuan,0,0,8,8
1653646439812,MATH 274,A01,087439,Cheng; Li-Tien,9,0,10,1
1653646439812,MATH 274,A02,087440,Cheng; Li-Tien,10,0,10,0
1653646440334,MATH 278A,A00,087441,Staff,8,0,10,2
1653646440857,MATH 278B,A00,087442,Staff,8,0,10,2
1653646441382,MATH 278C,A00,087443,Staff,8,0,10,2
1653646441913,MATH 280A,A00,087444,Zheng; Tianyi,0,0,8,8
1653646442442,MATH 281A,A00,087445,Bradic; Jelena,0,0,8,9
1653646442965,MATH 282A,A00,087446,Zhang; Danna,0,0,8,8
1653646443492,MATH 283,A00,087447,Tesler; Glenn,0,0,0,16
1653646444017,MATH 286,B00,095535,Kemp; Todd Aahron,5,0,8,3
1653646444540,MATH 287D,B00,095536,Bradic; Jelena,5,0,8,3
1653646445068,MATH 288,A00,087450,Staff,14,0,15,1
1653646445068,MATH 288,B00,087451,Staff,15,0,15,0
1653646445068,MATH 288,C00,087452,Staff,15,0,15,0
1653646445592,MATH 290A,A00,087453,Xu; Zhouli,6,0,8,2
1653646446114,MATH 291A,A00,087454,Xu; Zhouli,7,0,8,1
1653646446640,MATH 292,A00,087455,Staff,10,0,10,0
1653646447165,MATH 295,A00,087456,Staff,50,0,50,0
1653646447688,MATH 297,001,087457,Staff,997,0,999,2
1653647007112,COGS 200,A01,087991,Staff,47,0,50,3
1653647007637,COGS 201,A01,094504,Rangel; Lara M,16,0,25,9
1653647008160,COGS 203,A00,087992,Coulson; Seana M,18,0,20,2
1653647008690,COGS 210A,001,087993,Greene; Deanna Jacquelyn,9998,0,9999,1
1653647008690,COGS 210A,002,087994,Saygin; Ayse P,9999,0,9999,0
1653647008690,COGS 210A,003,087995,Xia; Haijun,9999,0,9999,0
1653647008690,COGS 210A,004,087996,Nitz; Douglas A.,9999,0,9999,0
1653647008690,COGS 210A,005,087997,Hollan; James D.,9999,0,9999,0
1653647008690,COGS 210A,006,087998,Deak; Gedeon O.,9998,0,9999,1
1653647008690,COGS 210A,007,087999,Rossano; Federico,9999,0,9999,0
1653647009215,COGS 211A,A00,088000,Coulson; Seana M,9997,0,9999,2
1653647009738,COGS 229,A00,088002,Staff,22,0,25,3
1653647010260,COGS 260,B00,094231,Staff,17,0,20,3
1653647010260,COGS 260,A00,088004,Nitz; Douglas A.,9998,0,9999,1
1653647010784,CSE 202,A00,090110,Paturi; Ramamohan,0,0,0,0
1653647010784,CSE 202,B00,090111,Paturi; Ramamohan,0,0,0,0
1653647011307,CSE 207B,A00,090112,Heninger; Nadia A,0,0,0,0
1653647011830,CSE 208,A00,094858,Micciancio; Daniele,0,0,0,0
1653647012354,CSE 210,A00,090113,Powell; Thomas Allan,0,0,0,0
1653647012877,CSE 219,A00,090898,Staff,0,0,0,0
1653647013403,CSE 221,A00,090114,Zhou; Yuan-Yuan,0,0,0,0
1653647013927,CSE 229A,A00,090115,Porter; George M,0,0,0,0
1653647014453,CSE 229C,A00,090116,Savage; Stefan,0,0,0,0
1653647014976,CSE 230,A00,090117,Jhala; Ranjit,0,0,0,0
1653647015501,CSE 232,A00,090118,Papakonstantinou; Yannis,0,0,0,0
1653647016030,CSE 239A,A00,090121,Kumar; Arun Kumar,0,0,0,0
1653647016553,CSE 239B,A00,090122,Jhala; Ranjit,0,0,0,0
1653647017080,CSE 240A,A00,090123,Zhao; Jishen,0,0,189,189
1653647017605,CSE 243A,A00,090124,Orailoglu; Alex,0,0,15,15
1653647018128,CSE 249B,A00,090125,Kahng; Andrew Byun,12,0,20,8
1653647018655,CSE 250A,A00,090126,Berg-Kirkpatrick; Taylor D,0,0,0,0
1653647019177,CSE 252A,A00,090127,Ochoa; Benjamin Lawrence,0,0,0,0
1653647019701,CSE 258,A01,090129,McAuley; Julian John,0,0,0,0
1653647020224,CSE 258R,A01,090131,McAuley; Julian John,0,0,0,0
1653647020751,CSE 274,A00,090132,Ramamoorthi; Ravi,0,0,0,0
1653647021274,CSE 276A,A00,090133,Christensen; Henrik I,0,0,0,0
1653647021800,CSE 276C,A00,090134,Christensen; Henrik I,0,0,0,0
1653647022325,CSE 290,A00,090135,Bafna; Vineet,0,0,0,0
1653647022325,CSE 290,B00,090136,Ramamoorthi; Ravi,0,0,0,0
1653647022325,CSE 290,C00,090137,Li; Tzumao,7,0,10,3
1653647022325,CSE 290,D00,090138,Zhou; Yuan-Yuan,9,0,10,1
1653647022325,CSE 290,E00,090139,Christensen; Henrik I,8,0,10,2
1653647022325,CSE 290,F00,094053,Shalev; Aaron D,0,0,0,0
1653647022849,CSE 291,A00,090140,Munyaka; Imani N. S.,0,0,0,0
1653647022849,CSE 291,B00,094880,Yu; Qi,0,0,0,0
1653647022849,CSE 291,C00,090142,Pannuto; Patrick William,0,0,0,0
1653647022849,CSE 291,D00,094881,Zhang; Yiying,0,0,0,0
1653647022849,CSE 291,E00,095118,Su; Hao,0,0,0,0
1653647023391,CSE 293,001,094905,Bafna; Vineet,9999,0,9999,0
1653647023391,CSE 293,002,094906,Bellare; Mihir,9999,0,9999,0
1653647023391,CSE 293,003,094907,Berg-Kirkpatrick; Taylor D,9999,0,9999,0
1653647023391,CSE 293,004,094908,Christensen; Henrik I,9999,0,9999,0
1653647023391,CSE 293,005,094909,Cottrell; Garrison W,9999,0,9999,0
1653647023391,CSE 293,006,094910,Deutsch; Alin Bernard,9999,0,9999,0
1653647023391,CSE 293,007,094911,Esmaeilzadeh; Hadi,9999,0,9999,0
1653647023391,CSE 293,008,094912,Freund; Yoav,9999,0,9999,0
1653647023391,CSE 293,009,094913,Griswold; William G.,9999,0,9999,0
1653647023391,CSE 293,010,094914,Gymrek; Melissa Ann,9999,0,9999,0
1653647023391,CSE 293,011,094915,Heninger; Nadia A,9999,0,9999,0
1653647023391,CSE 293,012,094916,Impagliazzo; Russell,9999,0,9999,0
1653647023391,CSE 293,013,094917,Jhala; Ranjit,9999,0,9999,0
1653647023391,CSE 293,014,094918,Kahng; Andrew Byun,9999,0,9999,0
1653647023391,CSE 293,015,094919,Kane; Daniel Mertz,9999,0,9999,0
1653647023391,CSE 293,016,094920,Kriegman; David J,9999,0,9999,0
1653647023391,CSE 293,017,094921,Kumar; Arun Kumar,9999,0,9999,0
1653647023391,CSE 293,018,094922,Lerner; Sorin,9999,0,9999,0
1653647023391,CSE 293,019,094923,Lovett; Shachar,9999,0,9999,0
1653647023391,CSE 293,020,094924,McAuley; Julian John,9999,0,9999,0
1653647023391,CSE 293,021,094925,Micciancio; Daniele,9999,0,9999,0
1653647023391,CSE 293,022,094926,Orailoglu; Alex,9999,0,9999,0
1653647023391,CSE 293,023,094927,Paturi; Ramamohan,9999,0,9999,0
1653647023391,CSE 293,024,094928,Polikarpova; Nadezhda,9999,0,9999,0
1653647023391,CSE 293,025,094929,Politz; Joseph Gibbs,9999,0,9999,0
1653647023391,CSE 293,026,094930,Porter; George M,9999,0,9999,0
1653647023391,CSE 293,027,094931,Porter; Leonard Emerson,9999,0,9999,0
1653647023391,CSE 293,028,094932,Ramamoorthi; Ravi,9999,0,9999,0
1653647023391,CSE 293,029,094933,Sahoo; Debashis,9999,0,9999,0
1653647023391,CSE 293,030,094934,Saul; Lawrence,9999,0,9999,0
1653647023391,CSE 293,031,094935,Savage; Stefan,9999,0,9999,0
1653647023391,CSE 293,032,094936,Schulze; Jurgen P.,9999,0,9999,0
1653647023391,CSE 293,033,094937,Snoeren; Alex C.,9999,0,9999,0
1653647023391,CSE 293,034,094938,Shang; Jingbo,9999,0,9999,0
1653647023391,CSE 293,035,094939,Stefan; Deian,9999,0,9999,0
1653647023391,CSE 293,036,094940,Su; Hao,9999,0,9999,0
1653647023391,CSE 293,037,094941,Swanson; Steven James,9999,0,9999,0
1653647023391,CSE 293,038,094942,Tullsen; Dean Michael,9999,0,9999,0
1653647023391,CSE 293,039,094943,Voelker; Geoffrey M.,9999,0,9999,0
1653647023391,CSE 293,040,094944,Zhao; Jishen,9999,0,9999,0
1653647023391,CSE 293,041,094945,Zhou; Yuan-Yuan,9999,0,9999,0
1653647023391,CSE 293,042,094946,Gao; Sicun,9998,0,9999,1
1653647023391,CSE 293,043,094947,Weibel; Nadir,9999,0,9999,0
1653647023391,CSE 293,044,094948,Gupta; Rajesh K.,9999,0,9999,0
1653647023913,CSE 294,A00,090143,Porter; George M,9,0,10,1
1653647024439,DSE 200,A00,091799,Staff,50,0,50,0
1653647024962,DSE 203,A00,091800,Gupta; Amarnath,30,0,30,0
1653647025489,DSE 250,A00,091801,Deutsch; Alin Bernard,30,0,30,0
1653647026013,DSE 290,A00,091802,Altintas De Callaf; Ilkay,50,0,50,0
1653647026550,ECE 200,001,091003,Antipa; Nicholas A,9999,0,9999,0
1653647026550,ECE 200,002,091004,Atanasov; Nikolay A.,9999,0,9999,0
1653647026550,ECE 200,003,091005,Bharadia; Dinesh,9999,0,9999,0
1653647026550,ECE 200,004,091006,Cheng; Chung Kuan,9999,0,9999,0
1653647026550,ECE 200,005,091007,Cosman; Pamela C.,9999,0,9999,0
1653647026550,ECE 200,006,091008,Staff,9999,0,9999,0
1653647026550,ECE 200,007,091009,Dayeh; Shadi Ahmad,9999,0,9999,0
1653647026550,ECE 200,008,091010,Fainman; Yeshaiahu,9999,0,9999,0
1653647026550,ECE 200,009,091011,Ford; Joseph Earl,9999,0,9999,0
1653647026550,ECE 200,010,091012,Franceschetti; Massimo,9999,0,9999,0
1653647026550,ECE 200,011,091013,Fullerton; Eric E,9999,0,9999,0
1653647026550,ECE 200,012,091014,Galton; Ian A,9999,0,9999,0
1653647026550,ECE 200,013,091015,Gilja; Vikash,9999,0,9999,0
1653647026550,ECE 200,014,091016,Hall; Drew A.,9999,0,9999,0
1653647026550,ECE 200,015,091017,Hsueh; Tzu-Chien,9999,0,9999,0
1653647026550,ECE 200,016,091018,Javidi; Tara,9999,0,9999,0
1653647026550,ECE 200,017,091019,Kahng; Andrew Byun,9999,0,9999,0
1653647026550,ECE 200,018,091020,Kim; Young-Han,9999,0,9999,0
1653647026550,ECE 200,019,091021,Koushanfar; Farinaz,9999,0,9999,0
1653647026550,ECE 200,020,091022,Kuzum; Duygu,9999,0,9999,0
1653647026550,ECE 200,021,091023,Le; Hanh-Phuc,9999,0,9999,0
1653647026550,ECE 200,022,091024,Lin; Bill,9999,0,9999,0
1653647026550,ECE 200,023,091025,Liu; Zhaowei,9999,0,9999,0
1653647026550,ECE 200,024,091026,Lo; Yu-Hwa,9999,0,9999,0
1653647026550,ECE 200,025,091027,Lomakin; Vitaliy,9999,0,9999,0
1653647026550,ECE 200,026,091028,Mercier; Patrick Philip,9999,0,9999,0
1653647026550,ECE 200,027,091029,Meyer; Florian,9999,0,9999,0
1653647026550,ECE 200,028,091030,Milstein; Laurence B.,9999,0,9999,0
1653647026550,ECE 200,029,091031,Mir Arabbaygi; Siavash,9999,0,9999,0
1653647026550,ECE 200,030,091032,Mookherjea; Shayan,9999,0,9999,0
1653647026550,ECE 200,031,091033,Morris; Karcher William,9999,0,9999,0
1653647026550,ECE 200,032,091034,Ng; Tse Nga,9999,0,9999,0
1653647026550,ECE 200,033,091035,Nguyen; Truong Quang,9999,0,9999,0
1653647026550,ECE 200,034,091036,Nomura; Kenji,9999,0,9999,0
1653647026550,ECE 200,035,091037,Orlitsky; Alon,9999,0,9999,0
1653647026550,ECE 200,036,091038,Pal; Piya,9999,0,9999,0
1653647026550,ECE 200,037,091039,Papen; George C.,9999,0,9999,0
1653647026550,ECE 200,038,091040,Radic; Stojan,9999,0,9999,0
1653647026550,ECE 200,039,091041,Rao; Bhaskar D.,9999,0,9999,0
1653647026550,ECE 200,040,091042,Rao; Ramesh R,9999,0,9999,0
1653647026550,ECE 200,041,091043,Rebeiz; Gabriel,9999,0,9999,0
1653647026550,ECE 200,042,091044,Sanford; John R,9999,0,9999,0
1653647026550,ECE 200,043,091045,Siegel; Paul H.,9999,0,9999,0
1653647026550,ECE 200,044,091046,Sievenpiper; Daniel F.,9999,0,9999,0
1653647026550,ECE 200,045,091047,Sworder; David D.,9999,0,9999,0
1653647026550,ECE 200,046,091048,Taur; Yuan,9999,0,9999,0
1653647026550,ECE 200,047,091049,Touri; Behrouz,9999,0,9999,0
1653647026550,ECE 200,048,091050,Trivedi; Mohan M.,9999,0,9999,0
1653647026550,ECE 200,049,091051,Vardy; Alexander,9999,0,9999,0
1653647026550,ECE 200,050,091052,Vasconcelos; Nuno,9999,0,9999,0
1653647026550,ECE 200,051,091053,Wang; Xiaolong,9999,0,9999,0
1653647026550,ECE 200,052,091054,Xie; Pengtao,9999,0,9999,0
1653647026550,ECE 200,053,091055,Yip; Michael,9999,0,9999,0
1653647026550,ECE 200,054,091056,Zeger; Kenneth A.,9999,0,9999,0
1653647026550,ECE 200,055,091057,Zhang; Xinyu,9999,0,9999,0
1653647026550,ECE 200,056,091058,Turakhia; Yatish Girish,9999,0,9999,0
1653647026550,ECE 200,057,091059,Kang; Mingu,9999,0,9999,0
1653647026550,ECE 200,058,091060,Shi; Yuanyuan,9999,0,9999,0
1653647026550,ECE 200,059,091061,Wang; Edward Jay,9999,0,9999,0
1653647026550,ECE 200,060,091062,Zheng; Yang,9999,0,9999,0
1653647027078,ECE 201,A00,095526,Lo; Yu-Hwa,0,0,0,0
1653647027604,ECE 203,A00,091065,Mercier; Patrick Philip,0,0,0,0
1653647028127,ECE 207A,A00,091605,Liu; Thomas Tao-Ming,0,0,0,0
1653647028650,ECE 212AN,A00,091068,Nomura; Kenji,0,0,0,0
1653647029174,ECE 222A,A00,091069,Rebeiz; Gabriel,0,0,0,0
1653647029700,ECE 225A,A00,091070,Orlitsky; Alon,0,0,0,0
1653647030223,ECE 230A,A00,091071,Nomura; Kenji,0,0,0,0
1653647030747,ECE 236A,A00,091072,Dayeh; Shadi Ahmad,0,0,0,0
1653647031270,ECE 238A,A00,091073,Luo; Jian,0,0,0,0
1653647031270,ECE 238A,B00,091074,Luo; Jian,0,0,0,0
1653647031793,ECE 240A,A00,091075,Radic; Stojan,0,0,0,0
1653647032332,ECE 247A,A00,091592,Shi; Lingyan,0,0,0,0
1653647032856,ECE 250,A00,091076,Touri; Behrouz,0,0,0,0
1653647033384,ECE 251C,A00,091078,Nguyen; Truong Quang,0,0,0,0
1653647033910,ECE 253,A00,091079,Cosman; Pamela C.,0,0,0,0
1653647034436,ECE 255A,A00,091080,Orlitsky; Alon,0,0,0,0
1653647034960,ECE 257A,A00,091081,Zhang; Xinyu,0,0,0,0
1653647035485,ECE 260A,A01,091084,Eldon; John,0,0,0,0
1653647036013,ECE 264C,A00,091085,Galton; Ian A,0,0,0,0
1653647036541,ECE 265C,A00,094889,Presti; Calogero Davide,0,0,0,9
1653647037065,ECE 266,A01,091087,Hall; Drew A.,0,0,0,0
1653647038113,ECE 271A,A00,091090,Vasconcelos; Nuno,0,0,0,0
1653647038639,ECE 272B,A00,091091,Sworder; David D.,0,0,0,0
1653647039165,ECE 275A,A00,091092,Meyer; Florian,0,0,0,0
1653647039688,ECE 277,A00,091093,An; Cheolhong,0,0,0,0
1653647040219,ECE 283,A00,091094,Le; Hanh-Phuc,0,0,0,0
1653647040748,ECE 284,A00,091095,Kang; Mingu,0,0,0,0
1653647040748,ECE 284,B00,091096,Wang; Edward Jay,0,0,0,0
1653647041273,ECE 285,A00,094334,Touri; Behrouz,0,0,0,0
1653647041803,ECE 289,A00,091097,Whelan; David Arthur,0,0,0,0
1653647042329,MATH 200A,A00,087414,Salehi Golsefidy; Alireza,7,0,8,1
1653647042853,MATH 202A,A00,087415,Gill; Philip E.,2,0,8,6
1653647043381,MATH 203A,A00,087416,Oprea; Dragos N.,6,0,8,2
1653647043905,MATH 204A,A00,087417,Kedlaya; Kiran S.,6,0,8,2
1653647044513,MATH 205,A00,087418,Sorensen; Claus M,6,0,8,2
1653647045037,MATH 206A,A00,087419,Izadi; Elham,6,0,8,2
1653647045563,MATH 207A,A00,087420,Mohammadi; Amir,5,0,8,3
1653647046087,MATH 208,A00,087421,Staff,8,0,10,2
1653647046611,MATH 209,A00,087422,Staff,10,0,10,0
1653647047135,MATH 218,A00,087423,Staff,10,0,10,0
1653647047657,MATH 220A,A00,087424,Novak; Jonathan I,6,0,8,2
1653647048184,MATH 231A,A00,087425,Bejenaru; Ioan,3,0,8,5
1653647048708,MATH 240A,A00,087426,Ebenfelt; Peter F,5,0,8,3
1653647049230,MATH 243,A00,087427,Staff,9,0,10,1
1653647049758,MATH 248,A00,087429,Staff,10,0,10,0
1653647050284,MATH 250A,A00,087430,Spolaor; Luca,4,0,8,4
1653647050807,MATH 257A,A00,087431,Spolaor; Luca,7,0,8,1
1653647051333,MATH 258,A00,087432,Staff,9,0,10,1
1653647051859,MATH 264A,A00,087433,Warnke; Lutz Peter,5,0,8,3
1653647052384,MATH 268,A00,087434,Staff,15,0,15,0
1653647052909,MATH 269,A00,087435,Staff,14,0,15,1
1653647053433,MATH 270A,A00,087436,Nie; Jiawang,0,0,8,8
1653647053962,MATH 272A,A00,087437,Tian; Xiaochuan,0,0,8,8
1653647054489,MATH 274,A01,087439,Cheng; Li-Tien,9,0,10,1
1653647054489,MATH 274,A02,087440,Cheng; Li-Tien,10,0,10,0
1653647055017,MATH 278A,A00,087441,Staff,8,0,10,2
1653647055541,MATH 278B,A00,087442,Staff,8,0,10,2
1653647056065,MATH 278C,A00,087443,Staff,8,0,10,2
1653647056588,MATH 280A,A00,087444,Zheng; Tianyi,0,0,8,8
1653647057112,MATH 281A,A00,087445,Bradic; Jelena,0,0,8,9
1653647057639,MATH 282A,A00,087446,Zhang; Danna,0,0,8,8
1653647058162,MATH 283,A00,087447,Tesler; Glenn,0,0,0,16
1653647058685,MATH 286,B00,095535,Kemp; Todd Aahron,5,0,8,3
1653647059214,MATH 287D,B00,095536,Bradic; Jelena,5,0,8,3
1653647059749,MATH 288,A00,087450,Staff,14,0,15,1
1653647059749,MATH 288,B00,087451,Staff,15,0,15,0
1653647059749,MATH 288,C00,087452,Staff,15,0,15,0
1653647060273,MATH 290A,A00,087453,Xu; Zhouli,6,0,8,2
1653647060800,MATH 291A,A00,087454,Xu; Zhouli,7,0,8,1
1653647061323,MATH 292,A00,087455,Staff,10,0,10,0
1653647061849,MATH 295,A00,087456,Staff,50,0,50,0
1653647062373,MATH 297,001,087457,Staff,997,0,999,2
1653647621503,COGS 200,A01,087991,Staff,47,0,50,3
1653647622030,COGS 201,A01,094504,Rangel; Lara M,16,0,25,9
1653647622555,COGS 203,A00,087992,Coulson; Seana M,18,0,20,2
1653647623080,COGS 210A,001,087993,Greene; Deanna Jacquelyn,9998,0,9999,1
1653647623080,COGS 210A,002,087994,Saygin; Ayse P,9999,0,9999,0
1653647623080,COGS 210A,003,087995,Xia; Haijun,9999,0,9999,0
1653647623080,COGS 210A,004,087996,Nitz; Douglas A.,9999,0,9999,0
1653647623080,COGS 210A,005,087997,Hollan; James D.,9999,0,9999,0
1653647623080,COGS 210A,006,087998,Deak; Gedeon O.,9998,0,9999,1
1653647623080,COGS 210A,007,087999,Rossano; Federico,9999,0,9999,0
1653647623603,COGS 211A,A00,088000,Coulson; Seana M,9997,0,9999,2
1653647624129,COGS 229,A00,088002,Staff,22,0,25,3
1653647624653,COGS 260,B00,094231,Staff,17,0,20,3
1653647624653,COGS 260,A00,088004,Nitz; Douglas A.,9998,0,9999,1
1653647625180,CSE 202,A00,090110,Paturi; Ramamohan,0,0,0,0
1653647625180,CSE 202,B00,090111,Paturi; Ramamohan,0,0,0,0
1653647625705,CSE 207B,A00,090112,Heninger; Nadia A,0,0,0,0
1653647626233,CSE 208,A00,094858,Micciancio; Daniele,0,0,0,0
1653647626761,CSE 210,A00,090113,Powell; Thomas Allan,0,0,0,0
1653647627286,CSE 219,A00,090898,Staff,0,0,0,0
1653647627809,CSE 221,A00,090114,Zhou; Yuan-Yuan,0,0,0,0
1653647628342,CSE 229A,A00,090115,Porter; George M,0,0,0,0
1653647628865,CSE 229C,A00,090116,Savage; Stefan,0,0,0,0
1653647629388,CSE 230,A00,090117,Jhala; Ranjit,0,0,0,0
1653647629911,CSE 232,A00,090118,Papakonstantinou; Yannis,0,0,0,0
1653647630435,CSE 239A,A00,090121,Kumar; Arun Kumar,0,0,0,0
1653647631032,CSE 239B,A00,090122,Jhala; Ranjit,0,0,0,0
1653647631562,CSE 240A,A00,090123,Zhao; Jishen,0,0,189,189
1653647632087,CSE 243A,A00,090124,Orailoglu; Alex,0,0,15,15
1653647632609,CSE 249B,A00,090125,Kahng; Andrew Byun,12,0,20,8
1653647633132,CSE 250A,A00,090126,Berg-Kirkpatrick; Taylor D,0,0,0,0
1653647633655,CSE 252A,A00,090127,Ochoa; Benjamin Lawrence,0,0,0,0
1653647634181,CSE 258,A01,090129,McAuley; Julian John,0,0,0,0
1653647634705,CSE 258R,A01,090131,McAuley; Julian John,0,0,0,0
1653647635228,CSE 274,A00,090132,Ramamoorthi; Ravi,0,0,0,0
1653647635751,CSE 276A,A00,090133,Christensen; Henrik I,0,0,0,0
1653647636276,CSE 276C,A00,090134,Christensen; Henrik I,0,0,0,0
1653647636799,CSE 290,A00,090135,Bafna; Vineet,0,0,0,0
1653647636799,CSE 290,B00,090136,Ramamoorthi; Ravi,0,0,0,0
1653647636799,CSE 290,C00,090137,Li; Tzumao,7,0,10,3
1653647636799,CSE 290,D00,090138,Zhou; Yuan-Yuan,9,0,10,1
1653647636799,CSE 290,E00,090139,Christensen; Henrik I,8,0,10,2
1653647636799,CSE 290,F00,094053,Shalev; Aaron D,0,0,0,0
1653647637331,CSE 291,A00,090140,Munyaka; Imani N. S.,0,0,0,0
1653647637331,CSE 291,B00,094880,Yu; Qi,0,0,0,0
1653647637331,CSE 291,C00,090142,Pannuto; Patrick William,0,0,0,0
1653647637331,CSE 291,D00,094881,Zhang; Yiying,0,0,0,0
1653647637331,CSE 291,E00,095118,Su; Hao,0,0,0,0
1653647637863,CSE 293,001,094905,Bafna; Vineet,9999,0,9999,0
1653647637863,CSE 293,002,094906,Bellare; Mihir,9999,0,9999,0
1653647637863,CSE 293,003,094907,Berg-Kirkpatrick; Taylor D,9999,0,9999,0
1653647637863,CSE 293,004,094908,Christensen; Henrik I,9999,0,9999,0
1653647637863,CSE 293,005,094909,Cottrell; Garrison W,9999,0,9999,0
1653647637863,CSE 293,006,094910,Deutsch; Alin Bernard,9999,0,9999,0
1653647637863,CSE 293,007,094911,Esmaeilzadeh; Hadi,9999,0,9999,0
1653647637863,CSE 293,008,094912,Freund; Yoav,9999,0,9999,0
1653647637863,CSE 293,009,094913,Griswold; William G.,9999,0,9999,0
1653647637863,CSE 293,010,094914,Gymrek; Melissa Ann,9999,0,9999,0
1653647637863,CSE 293,011,094915,Heninger; Nadia A,9999,0,9999,0
1653647637863,CSE 293,012,094916,Impagliazzo; Russell,9999,0,9999,0
1653647637863,CSE 293,013,094917,Jhala; Ranjit,9999,0,9999,0
1653647637863,CSE 293,014,094918,Kahng; Andrew Byun,9999,0,9999,0
1653647637863,CSE 293,015,094919,Kane; Daniel Mertz,9999,0,9999,0
1653647637863,CSE 293,016,094920,Kriegman; David J,9999,0,9999,0
1653647637863,CSE 293,017,094921,Kumar; Arun Kumar,9999,0,9999,0
1653647637863,CSE 293,018,094922,Lerner; Sorin,9999,0,9999,0
1653647637863,CSE 293,019,094923,Lovett; Shachar,9999,0,9999,0
1653647637863,CSE 293,020,094924,McAuley; Julian John,9999,0,9999,0
1653647637863,CSE 293,021,094925,Micciancio; Daniele,9999,0,9999,0
1653647637863,CSE 293,022,094926,Orailoglu; Alex,9999,0,9999,0
1653647637863,CSE 293,023,094927,Paturi; Ramamohan,9999,0,9999,0
1653647637863,CSE 293,024,094928,Polikarpova; Nadezhda,9999,0,9999,0
1653647637863,CSE 293,025,094929,Politz; Joseph Gibbs,9999,0,9999,0
1653647637863,CSE 293,026,094930,Porter; George M,9999,0,9999,0
1653647637863,CSE 293,027,094931,Porter; Leonard Emerson,9999,0,9999,0
1653647637863,CSE 293,028,094932,Ramamoorthi; Ravi,9999,0,9999,0
1653647637863,CSE 293,029,094933,Sahoo; Debashis,9999,0,9999,0
1653647637863,CSE 293,030,094934,Saul; Lawrence,9999,0,9999,0
1653647637863,CSE 293,031,094935,Savage; Stefan,9999,0,9999,0
1653647637863,CSE 293,032,094936,Schulze; Jurgen P.,9999,0,9999,0
1653647637863,CSE 293,033,094937,Snoeren; Alex C.,9999,0,9999,0
1653647637863,CSE 293,034,094938,Shang; Jingbo,9999,0,9999,0
1653647637863,CSE 293,035,094939,Stefan; Deian,9999,0,9999,0
1653647637863,CSE 293,036,094940,Su; Hao,9999,0,9999,0
1653647637863,CSE 293,037,094941,Swanson; Steven James,9999,0,9999,0
1653647637863,CSE 293,038,094942,Tullsen; Dean Michael,9999,0,9999,0
1653647637863,CSE 293,039,094943,Voelker; Geoffrey M.,9999,0,9999,0
1653647637863,CSE 293,040,094944,Zhao; Jishen,9999,0,9999,0
1653647637863,CSE 293,041,094945,Zhou; Yuan-Yuan,9999,0,9999,0
1653647637863,CSE 293,042,094946,Gao; Sicun,9998,0,9999,1
1653647637863,CSE 293,043,094947,Weibel; Nadir,9999,0,9999,0
1653647637863,CSE 293,044,094948,Gupta; Rajesh K.,9999,0,9999,0
1653647638385,CSE 294,A00,090143,Porter; George M,9,0,10,1
1653647638909,DSE 200,A00,091799,Staff,50,0,50,0
1653647639454,DSE 203,A00,091800,Gupta; Amarnath,30,0,30,0
1653647639979,DSE 250,A00,091801,Deutsch; Alin Bernard,30,0,30,0
1653647640519,DSE 290,A00,091802,Altintas De Callaf; Ilkay,50,0,50,0
1653647641075,ECE 200,001,091003,Antipa; Nicholas A,9999,0,9999,0
1653647641075,ECE 200,002,091004,Atanasov; Nikolay A.,9999,0,9999,0
1653647641075,ECE 200,003,091005,Bharadia; Dinesh,9999,0,9999,0
1653647641075,ECE 200,004,091006,Cheng; Chung Kuan,9999,0,9999,0
1653647641075,ECE 200,005,091007,Cosman; Pamela C.,9999,0,9999,0
1653647641075,ECE 200,006,091008,Staff,9999,0,9999,0
1653647641075,ECE 200,007,091009,Dayeh; Shadi Ahmad,9999,0,9999,0
1653647641075,ECE 200,008,091010,Fainman; Yeshaiahu,9999,0,9999,0
1653647641075,ECE 200,009,091011,Ford; Joseph Earl,9999,0,9999,0
1653647641075,ECE 200,010,091012,Franceschetti; Massimo,9999,0,9999,0
1653647641075,ECE 200,011,091013,Fullerton; Eric E,9999,0,9999,0
1653647641075,ECE 200,012,091014,Galton; Ian A,9999,0,9999,0
1653647641075,ECE 200,013,091015,Gilja; Vikash,9999,0,9999,0
1653647641075,ECE 200,014,091016,Hall; Drew A.,9999,0,9999,0
1653647641075,ECE 200,015,091017,Hsueh; Tzu-Chien,9999,0,9999,0
1653647641075,ECE 200,016,091018,Javidi; Tara,9999,0,9999,0
1653647641075,ECE 200,017,091019,Kahng; Andrew Byun,9999,0,9999,0
1653647641075,ECE 200,018,091020,Kim; Young-Han,9999,0,9999,0
1653647641075,ECE 200,019,091021,Koushanfar; Farinaz,9999,0,9999,0
1653647641075,ECE 200,020,091022,Kuzum; Duygu,9999,0,9999,0
1653647641075,ECE 200,021,091023,Le; Hanh-Phuc,9999,0,9999,0
1653647641075,ECE 200,022,091024,Lin; Bill,9999,0,9999,0
1653647641075,ECE 200,023,091025,Liu; Zhaowei,9999,0,9999,0
1653647641075,ECE 200,024,091026,Lo; Yu-Hwa,9999,0,9999,0
1653647641075,ECE 200,025,091027,Lomakin; Vitaliy,9999,0,9999,0
1653647641075,ECE 200,026,091028,Mercier; Patrick Philip,9999,0,9999,0
1653647641075,ECE 200,027,091029,Meyer; Florian,9999,0,9999,0
1653647641075,ECE 200,028,091030,Milstein; Laurence B.,9999,0,9999,0
1653647641075,ECE 200,029,091031,Mir Arabbaygi; Siavash,9999,0,9999,0
1653647641075,ECE 200,030,091032,Mookherjea; Shayan,9999,0,9999,0
1653647641075,ECE 200,031,091033,Morris; Karcher William,9999,0,9999,0
1653647641075,ECE 200,032,091034,Ng; Tse Nga,9999,0,9999,0
1653647641075,ECE 200,033,091035,Nguyen; Truong Quang,9999,0,9999,0
1653647641075,ECE 200,034,091036,Nomura; Kenji,9999,0,9999,0
1653647641075,ECE 200,035,091037,Orlitsky; Alon,9999,0,9999,0
1653647641075,ECE 200,036,091038,Pal; Piya,9999,0,9999,0
1653647641075,ECE 200,037,091039,Papen; George C.,9999,0,9999,0
1653647641075,ECE 200,038,091040,Radic; Stojan,9999,0,9999,0
1653647641075,ECE 200,039,091041,Rao; Bhaskar D.,9999,0,9999,0
1653647641075,ECE 200,040,091042,Rao; Ramesh R,9999,0,9999,0
1653647641075,ECE 200,041,091043,Rebeiz; Gabriel,9999,0,9999,0
1653647641075,ECE 200,042,091044,Sanford; John R,9999,0,9999,0
1653647641075,ECE 200,043,091045,Siegel; Paul H.,9999,0,9999,0
1653647641075,ECE 200,044,091046,Sievenpiper; Daniel F.,9999,0,9999,0
1653647641075,ECE 200,045,091047,Sworder; David D.,9999,0,9999,0
1653647641075,ECE 200,046,091048,Taur; Yuan,9999,0,9999,0
1653647641075,ECE 200,047,091049,Touri; Behrouz,9999,0,9999,0
1653647641075,ECE 200,048,091050,Trivedi; Mohan M.,9999,0,9999,0
1653647641075,ECE 200,049,091051,Vardy; Alexander,9999,0,9999,0
1653647641075,ECE 200,050,091052,Vasconcelos; Nuno,9999,0,9999,0
1653647641075,ECE 200,051,091053,Wang; Xiaolong,9999,0,9999,0
1653647641075,ECE 200,052,091054,Xie; Pengtao,9999,0,9999,0
1653647641075,ECE 200,053,091055,Yip; Michael,9999,0,9999,0
1653647641075,ECE 200,054,091056,Zeger; Kenneth A.,9999,0,9999,0
1653647641075,ECE 200,055,091057,Zhang; Xinyu,9999,0,9999,0
1653647641075,ECE 200,056,091058,Turakhia; Yatish Girish,9999,0,9999,0
1653647641075,ECE 200,057,091059,Kang; Mingu,9999,0,9999,0
1653647641075,ECE 200,058,091060,Shi; Yuanyuan,9999,0,9999,0
1653647641075,ECE 200,059,091061,Wang; Edward Jay,9999,0,9999,0
1653647641075,ECE 200,060,091062,Zheng; Yang,9999,0,9999,0
1653647641602,ECE 201,A00,095526,Lo; Yu-Hwa,0,0,0,0
1653647642126,ECE 203,A00,091065,Mercier; Patrick Philip,0,0,0,0
1653647642665,ECE 207A,A00,091605,Liu; Thomas Tao-Ming,0,0,0,0
1653647643201,ECE 212AN,A00,091068,Nomura; Kenji,0,0,0,0
1653647643725,ECE 222A,A00,091069,Rebeiz; Gabriel,0,0,0,0
1653647644249,ECE 225A,A00,091070,Orlitsky; Alon,0,0,0,0
1653647644776,ECE 230A,A00,091071,Nomura; Kenji,0,0,0,0
1653647645303,ECE 236A,A00,091072,Dayeh; Shadi Ahmad,0,0,0,0
1653647645833,ECE 238A,A00,091073,Luo; Jian,0,0,0,0
1653647645833,ECE 238A,B00,091074,Luo; Jian,0,0,0,0
1653647646359,ECE 240A,A00,091075,Radic; Stojan,0,0,0,0
1653647646886,ECE 247A,A00,091592,Shi; Lingyan,0,0,0,0
1653647647409,ECE 250,A00,091076,Touri; Behrouz,0,0,0,0
1653647647932,ECE 251C,A00,091078,Nguyen; Truong Quang,0,0,0,0
1653647648456,ECE 253,A00,091079,Cosman; Pamela C.,0,0,0,0
1653647648978,ECE 255A,A00,091080,Orlitsky; Alon,0,0,0,0
1653647649501,ECE 257A,A00,091081,Zhang; Xinyu,0,0,0,0
1653647650025,ECE 260A,A01,091084,Eldon; John,0,0,0,0
1653647650551,ECE 264C,A00,091085,Galton; Ian A,0,0,0,0
1653647651074,ECE 265C,A00,094889,Presti; Calogero Davide,0,0,0,9
1653647651596,ECE 266,A01,091087,Hall; Drew A.,0,0,0,0
1653647652648,ECE 271A,A00,091090,Vasconcelos; Nuno,0,0,0,0
1653647653171,ECE 272B,A00,091091,Sworder; David D.,0,0,0,0
1653647653698,ECE 275A,A00,091092,Meyer; Florian,0,0,0,0
1653647654222,ECE 277,A00,091093,An; Cheolhong,0,0,0,0
1653647654749,ECE 283,A00,091094,Le; Hanh-Phuc,0,0,0,0
1653647655271,ECE 284,A00,091095,Kang; Mingu,0,0,0,0
1653647655271,ECE 284,B00,091096,Wang; Edward Jay,0,0,0,0
1653647655797,ECE 285,A00,094334,Touri; Behrouz,0,0,0,0
1653647656327,ECE 289,A00,091097,Whelan; David Arthur,0,0,0,0
1653647656853,MATH 200A,A00,087414,Salehi Golsefidy; Alireza,7,0,8,1
1653647657378,MATH 202A,A00,087415,Gill; Philip E.,2,0,8,6
1653647657904,MATH 203A,A00,087416,Oprea; Dragos N.,6,0,8,2
1653647658427,MATH 204A,A00,087417,Kedlaya; Kiran S.,6,0,8,2
1653647658953,MATH 205,A00,087418,Sorensen; Claus M,6,0,8,2
1653647659477,MATH 206A,A00,087419,Izadi; Elham,6,0,8,2
1653647660004,MATH 207A,A00,087420,Mohammadi; Amir,5,0,8,3
1653647660527,MATH 208,A00,087421,Staff,8,0,10,2
1653647661054,MATH 209,A00,087422,Staff,10,0,10,0
1653647661577,MATH 218,A00,087423,Staff,10,0,10,0
1653647662100,MATH 220A,A00,087424,Novak; Jonathan I,6,0,8,2
1653647662625,MATH 231A,A00,087425,Bejenaru; Ioan,3,0,8,5
1653647663151,MATH 240A,A00,087426,Ebenfelt; Peter F,5,0,8,3
1653647663674,MATH 243,A00,087427,Staff,9,0,10,1
1653647664196,MATH 248,A00,087429,Staff,10,0,10,0
1653647664727,MATH 250A,A00,087430,Spolaor; Luca,4,0,8,4
1653647665251,MATH 257A,A00,087431,Spolaor; Luca,7,0,8,1
1653647665779,MATH 258,A00,087432,Staff,9,0,10,1
1653647666307,MATH 264A,A00,087433,Warnke; Lutz Peter,5,0,8,3
1653647666831,MATH 268,A00,087434,Staff,15,0,15,0
1653647667354,MATH 269,A00,087435,Staff,14,0,15,1
1653647667877,MATH 270A,A00,087436,Nie; Jiawang,0,0,8,8
1653647668404,MATH 272A,A00,087437,Tian; Xiaochuan,0,0,8,8
1653647668927,MATH 274,A01,087439,Cheng; Li-Tien,9,0,10,1
1653647668927,MATH 274,A02,087440,Cheng; Li-Tien,10,0,10,0
1653647669458,MATH 278A,A00,087441,Staff,8,0,10,2
1653647669981,MATH 278B,A00,087442,Staff,8,0,10,2
1653647670504,MATH 278C,A00,087443,Staff,8,0,10,2
1653647671028,MATH 280A,A00,087444,Zheng; Tianyi,0,0,8,8
1653647671551,MATH 281A,A00,087445,Bradic; Jelena,0,0,8,9
1653647672075,MATH 282A,A00,087446,Zhang; Danna,0,0,8,8
1653647672600,MATH 283,A00,087447,Tesler; Glenn,0,0,0,16
1653647673134,MATH 286,B00,095535,Kemp; Todd Aahron,5,0,8,3
1653647673662,MATH 287D,B00,095536,Bradic; Jelena,5,0,8,3
1653647674190,MATH 288,A00,087450,Staff,14,0,15,1
1653647674190,MATH 288,B00,087451,Staff,15,0,15,0
1653647674190,MATH 288,C00,087452,Staff,15,0,15,0
1653647674717,MATH 290A,A00,087453,Xu; Zhouli,6,0,8,2
1653647675240,MATH 291A,A00,087454,Xu; Zhouli,7,0,8,1
1653647675763,MATH 292,A00,087455,Staff,10,0,10,0
1653647676289,MATH 295,A00,087456,Staff,50,0,50,0
1653647676814,MATH 297,001,087457,Staff,997,0,999,2
1653648237438,COGS 200,A01,087991,Staff,47,0,50,3
1653648237964,COGS 201,A01,094504,Rangel; Lara M,16,0,25,9
1653648238488,COGS 203,A00,087992,Coulson; Seana M,18,0,20,2
1653648239025,COGS 210A,001,087993,Greene; Deanna Jacquelyn,9998,0,9999,1
1653648239025,COGS 210A,002,087994,Saygin; Ayse P,9999,0,9999,0
1653648239025,COGS 210A,003,087995,Xia; Haijun,9999,0,9999,0
1653648239025,COGS 210A,004,087996,Nitz; Douglas A.,9999,0,9999,0
1653648239025,COGS 210A,005,087997,Hollan; James D.,9999,0,9999,0
1653648239025,COGS 210A,006,087998,Deak; Gedeon O.,9998,0,9999,1
1653648239025,COGS 210A,007,087999,Rossano; Federico,9999,0,9999,0
1653648239549,COGS 211A,A00,088000,Coulson; Seana M,9997,0,9999,2
1653648240071,COGS 229,A00,088002,Staff,22,0,25,3
1653648240610,COGS 260,B00,094231,Staff,17,0,20,3
1653648240610,COGS 260,A00,088004,Nitz; Douglas A.,9998,0,9999,1
1653648241136,CSE 202,A00,090110,Paturi; Ramamohan,0,0,0,0
1653648241136,CSE 202,B00,090111,Paturi; Ramamohan,0,0,0,0
1653648241659,CSE 207B,A00,090112,Heninger; Nadia A,0,0,0,0
1653648242189,CSE 208,A00,094858,Micciancio; Daniele,0,0,0,0
1653648242713,CSE 210,A00,090113,Powell; Thomas Allan,0,0,0,0
1653648243237,CSE 219,A00,090898,Staff,0,0,0,0
1653648243766,CSE 221,A00,090114,Zhou; Yuan-Yuan,0,0,0,0
1653648244291,CSE 229A,A00,090115,Porter; George M,0,0,0,0
1653648244817,CSE 229C,A00,090116,Savage; Stefan,0,0,0,0
1653648245350,CSE 230,A00,090117,Jhala; Ranjit,0,0,0,0
1653648245874,CSE 232,A00,090118,Papakonstantinou; Yannis,0,0,0,0
1653648246397,CSE 239A,A00,090121,Kumar; Arun Kumar,0,0,0,0
1653648246921,CSE 239B,A00,090122,Jhala; Ranjit,0,0,0,0
1653648247457,CSE 240A,A00,090123,Zhao; Jishen,0,0,189,189
1653648247984,CSE 243A,A00,090124,Orailoglu; Alex,0,0,15,15
1653648248507,CSE 249B,A00,090125,Kahng; Andrew Byun,12,0,20,8
1653648249034,CSE 250A,A00,090126,Berg-Kirkpatrick; Taylor D,0,0,0,0
1653648249557,CSE 252A,A00,090127,Ochoa; Benjamin Lawrence,0,0,0,0
1653648250083,CSE 258,A01,090129,McAuley; Julian John,0,0,0,0
1653648250610,CSE 258R,A01,090131,McAuley; Julian John,0,0,0,0
1653648251134,CSE 274,A00,090132,Ramamoorthi; Ravi,0,0,0,0
1653648251660,CSE 276A,A00,090133,Christensen; Henrik I,0,0,0,0
1653648252182,CSE 276C,A00,090134,Christensen; Henrik I,0,0,0,0
1653648252719,CSE 290,A00,090135,Bafna; Vineet,0,0,0,0
1653648252719,CSE 290,B00,090136,Ramamoorthi; Ravi,0,0,0,0
1653648252719,CSE 290,C00,090137,Li; Tzumao,7,0,10,3
1653648252719,CSE 290,D00,090138,Zhou; Yuan-Yuan,9,0,10,1
1653648252719,CSE 290,E00,090139,Christensen; Henrik I,8,0,10,2
1653648252719,CSE 290,F00,094053,Shalev; Aaron D,0,0,0,0
1653648253253,CSE 291,A00,090140,Munyaka; Imani N. S.,0,0,0,0
1653648253253,CSE 291,B00,094880,Yu; Qi,0,0,0,0
1653648253253,CSE 291,C00,090142,Pannuto; Patrick William,0,0,0,0
1653648253253,CSE 291,D00,094881,Zhang; Yiying,0,0,0,0
1653648253253,CSE 291,E00,095118,Su; Hao,0,0,0,0
1653648253791,CSE 293,001,094905,Bafna; Vineet,9999,0,9999,0
1653648253791,CSE 293,002,094906,Bellare; Mihir,9999,0,9999,0
1653648253791,CSE 293,003,094907,Berg-Kirkpatrick; Taylor D,9999,0,9999,0
1653648253791,CSE 293,004,094908,Christensen; Henrik I,9999,0,9999,0
1653648253791,CSE 293,005,094909,Cottrell; Garrison W,9999,0,9999,0
1653648253791,CSE 293,006,094910,Deutsch; Alin Bernard,9999,0,9999,0
1653648253791,CSE 293,007,094911,Esmaeilzadeh; Hadi,9999,0,9999,0
1653648253791,CSE 293,008,094912,Freund; Yoav,9999,0,9999,0
1653648253791,CSE 293,009,094913,Griswold; William G.,9999,0,9999,0
1653648253791,CSE 293,010,094914,Gymrek; Melissa Ann,9999,0,9999,0
1653648253791,CSE 293,011,094915,Heninger; Nadia A,9999,0,9999,0
1653648253791,CSE 293,012,094916,Impagliazzo; Russell,9999,0,9999,0
1653648253791,CSE 293,013,094917,Jhala; Ranjit,9999,0,9999,0
1653648253791,CSE 293,014,094918,Kahng; Andrew Byun,9999,0,9999,0
1653648253791,CSE 293,015,094919,Kane; Daniel Mertz,9999,0,9999,0
1653648253791,CSE 293,016,094920,Kriegman; David J,9999,0,9999,0
1653648253791,CSE 293,017,094921,Kumar; Arun Kumar,9999,0,9999,0
1653648253791,CSE 293,018,094922,Lerner; Sorin,9999,0,9999,0
1653648253791,CSE 293,019,094923,Lovett; Shachar,9999,0,9999,0
1653648253791,CSE 293,020,094924,McAuley; Julian John,9999,0,9999,0
1653648253791,CSE 293,021,094925,Micciancio; Daniele,9999,0,9999,0
1653648253791,CSE 293,022,094926,Orailoglu; Alex,9999,0,9999,0
1653648253791,CSE 293,023,094927,Paturi; Ramamohan,9999,0,9999,0
1653648253791,CSE 293,024,094928,Polikarpova; Nadezhda,9999,0,9999,0
1653648253791,CSE 293,025,094929,Politz; Joseph Gibbs,9999,0,9999,0
1653648253791,CSE 293,026,094930,Porter; George M,9999,0,9999,0
1653648253791,CSE 293,027,094931,Porter; Leonard Emerson,9999,0,9999,0
1653648253791,CSE 293,028,094932,Ramamoorthi; Ravi,9999,0,9999,0
1653648253791,CSE 293,029,094933,Sahoo; Debashis,9999,0,9999,0
1653648253791,CSE 293,030,094934,Saul; Lawrence,9999,0,9999,0
1653648253791,CSE 293,031,094935,Savage; Stefan,9999,0,9999,0
1653648253791,CSE 293,032,094936,Schulze; Jurgen P.,9999,0,9999,0
1653648253791,CSE 293,033,094937,Snoeren; Alex C.,9999,0,9999,0
1653648253791,CSE 293,034,094938,Shang; Jingbo,9999,0,9999,0
1653648253791,CSE 293,035,094939,Stefan; Deian,9999,0,9999,0
1653648253791,CSE 293,036,094940,Su; Hao,9999,0,9999,0
1653648253791,CSE 293,037,094941,Swanson; Steven James,9999,0,9999,0
1653648253791,CSE 293,038,094942,Tullsen; Dean Michael,9999,0,9999,0
1653648253791,CSE 293,039,094943,Voelker; Geoffrey M.,9999,0,9999,0
1653648253791,CSE 293,040,094944,Zhao; Jishen,9999,0,9999,0
1653648253791,CSE 293,041,094945,Zhou; Yuan-Yuan,9999,0,9999,0
1653648253791,CSE 293,042,094946,Gao; Sicun,9998,0,9999,1
1653648253791,CSE 293,043,094947,Weibel; Nadir,9999,0,9999,0
1653648253791,CSE 293,044,094948,Gupta; Rajesh K.,9999,0,9999,0
1653648254323,CSE 294,A00,090143,Porter; George M,9,0,10,1
1653648254851,DSE 200,A00,091799,Staff,50,0,50,0
1653648255382,DSE 203,A00,091800,Gupta; Amarnath,30,0,30,0
1653648255907,DSE 250,A00,091801,Deutsch; Alin Bernard,30,0,30,0
1653648256432,DSE 290,A00,091802,Altintas De Callaf; Ilkay,50,0,50,0
1653648257002,ECE 200,001,091003,Antipa; Nicholas A,9999,0,9999,0
1653648257002,ECE 200,002,091004,Atanasov; Nikolay A.,9999,0,9999,0
1653648257002,ECE 200,003,091005,Bharadia; Dinesh,9999,0,9999,0
1653648257002,ECE 200,004,091006,Cheng; Chung Kuan,9999,0,9999,0
1653648257002,ECE 200,005,091007,Cosman; Pamela C.,9999,0,9999,0
1653648257002,ECE 200,006,091008,Staff,9999,0,9999,0
1653648257002,ECE 200,007,091009,Dayeh; Shadi Ahmad,9999,0,9999,0
1653648257002,ECE 200,008,091010,Fainman; Yeshaiahu,9999,0,9999,0
1653648257002,ECE 200,009,091011,Ford; Joseph Earl,9999,0,9999,0
1653648257002,ECE 200,010,091012,Franceschetti; Massimo,9999,0,9999,0
1653648257002,ECE 200,011,091013,Fullerton; Eric E,9999,0,9999,0
1653648257002,ECE 200,012,091014,Galton; Ian A,9999,0,9999,0
1653648257002,ECE 200,013,091015,Gilja; Vikash,9999,0,9999,0
1653648257002,ECE 200,014,091016,Hall; Drew A.,9999,0,9999,0
1653648257002,ECE 200,015,091017,Hsueh; Tzu-Chien,9999,0,9999,0
1653648257002,ECE 200,016,091018,Javidi; Tara,9999,0,9999,0
1653648257002,ECE 200,017,091019,Kahng; Andrew Byun,9999,0,9999,0
1653648257002,ECE 200,018,091020,Kim; Young-Han,9999,0,9999,0
1653648257002,ECE 200,019,091021,Koushanfar; Farinaz,9999,0,9999,0
1653648257002,ECE 200,020,091022,Kuzum; Duygu,9999,0,9999,0
1653648257002,ECE 200,021,091023,Le; Hanh-Phuc,9999,0,9999,0
1653648257002,ECE 200,022,091024,Lin; Bill,9999,0,9999,0
1653648257002,ECE 200,023,091025,Liu; Zhaowei,9999,0,9999,0
1653648257002,ECE 200,024,091026,Lo; Yu-Hwa,9999,0,9999,0
1653648257002,ECE 200,025,091027,Lomakin; Vitaliy,9999,0,9999,0
1653648257002,ECE 200,026,091028,Mercier; Patrick Philip,9999,0,9999,0
1653648257002,ECE 200,027,091029,Meyer; Florian,9999,0,9999,0
1653648257002,ECE 200,028,091030,Milstein; Laurence B.,9999,0,9999,0
1653648257002,ECE 200,029,091031,Mir Arabbaygi; Siavash,9999,0,9999,0
1653648257002,ECE 200,030,091032,Mookherjea; Shayan,9999,0,9999,0
1653648257002,ECE 200,031,091033,Morris; Karcher William,9999,0,9999,0
1653648257002,ECE 200,032,091034,Ng; Tse Nga,9999,0,9999,0
1653648257002,ECE 200,033,091035,Nguyen; Truong Quang,9999,0,9999,0
1653648257002,ECE 200,034,091036,Nomura; Kenji,9999,0,9999,0
1653648257002,ECE 200,035,091037,Orlitsky; Alon,9999,0,9999,0
1653648257002,ECE 200,036,091038,Pal; Piya,9999,0,9999,0
1653648257002,ECE 200,037,091039,Papen; George C.,9999,0,9999,0
1653648257002,ECE 200,038,091040,Radic; Stojan,9999,0,9999,0
1653648257002,ECE 200,039,091041,Rao; Bhaskar D.,9999,0,9999,0
1653648257002,ECE 200,040,091042,Rao; Ramesh R,9999,0,9999,0
1653648257002,ECE 200,041,091043,Rebeiz; Gabriel,9999,0,9999,0
1653648257002,ECE 200,042,091044,Sanford; John R,9999,0,9999,0
1653648257002,ECE 200,043,091045,Siegel; Paul H.,9999,0,9999,0
1653648257002,ECE 200,044,091046,Sievenpiper; Daniel F.,9999,0,9999,0
1653648257002,ECE 200,045,091047,Sworder; David D.,9999,0,9999,0
1653648257002,ECE 200,046,091048,Taur; Yuan,9999,0,9999,0
1653648257002,ECE 200,047,091049,Touri; Behrouz,9999,0,9999,0
1653648257002,ECE 200,048,091050,Trivedi; Mohan M.,9999,0,9999,0
1653648257002,ECE 200,049,091051,Vardy; Alexander,9999,0,9999,0
1653648257002,ECE 200,050,091052,Vasconcelos; Nuno,9999,0,9999,0
1653648257002,ECE 200,051,091053,Wang; Xiaolong,9999,0,9999,0
1653648257002,ECE 200,052,091054,Xie; Pengtao,9999,0,9999,0
1653648257002,ECE 200,053,091055,Yip; Michael,9999,0,9999,0
1653648257002,ECE 200,054,091056,Zeger; Kenneth A.,9999,0,9999,0
1653648257002,ECE 200,055,091057,Zhang; Xinyu,9999,0,9999,0
1653648257002,ECE 200,056,091058,Turakhia; Yatish Girish,9999,0,9999,0
1653648257002,ECE 200,057,091059,Kang; Mingu,9999,0,9999,0
1653648257002,ECE 200,058,091060,Shi; Yuanyuan,9999,0,9999,0
1653648257002,ECE 200,059,091061,Wang; Edward Jay,9999,0,9999,0
1653648257002,ECE 200,060,091062,Zheng; Yang,9999,0,9999,0
1653648257526,ECE 201,A00,095526,Lo; Yu-Hwa,0,0,0,0
1653648258053,ECE 203,A00,091065,Mercier; Patrick Philip,0,0,0,0
1653648258583,ECE 207A,A00,091605,Liu; Thomas Tao-Ming,0,0,0,0
1653648259112,ECE 212AN,A00,091068,Nomura; Kenji,0,0,0,0
1653648259637,ECE 222A,A00,091069,Rebeiz; Gabriel,0,0,0,0
1653648260176,ECE 225A,A00,091070,Orlitsky; Alon,0,0,0,0
1653648260701,ECE 230A,A00,091071,Nomura; Kenji,0,0,0,0
1653648261229,ECE 236A,A00,091072,Dayeh; Shadi Ahmad,0,0,0,0
1653648261760,ECE 238A,A00,091073,Luo; Jian,0,0,0,0
1653648261760,ECE 238A,B00,091074,Luo; Jian,0,0,0,0
1653648262287,ECE 240A,A00,091075,Radic; Stojan,0,0,0,0
1653648262812,ECE 247A,A00,091592,Shi; Lingyan,0,0,0,0
1653648263336,ECE 250,A00,091076,Touri; Behrouz,0,0,0,0
1653648263863,ECE 251C,A00,091078,Nguyen; Truong Quang,0,0,0,0
1653648264389,ECE 253,A00,091079,Cosman; Pamela C.,0,0,0,0
1653648264914,ECE 255A,A00,091080,Orlitsky; Alon,0,0,0,0
1653648265437,ECE 257A,A00,091081,Zhang; Xinyu,0,0,0,0
1653648265962,ECE 260A,A01,091084,Eldon; John,0,0,0,0
1653648266485,ECE 264C,A00,091085,Galton; Ian A,0,0,0,0
1653648267008,ECE 265C,A00,094889,Presti; Calogero Davide,0,0,0,9
1653648267537,ECE 266,A01,091087,Hall; Drew A.,0,0,0,0
1653648268593,ECE 271A,A00,091090,Vasconcelos; Nuno,0,0,0,0
1653648269116,ECE 272B,A00,091091,Sworder; David D.,0,0,0,0
1653648269639,ECE 275A,A00,091092,Meyer; Florian,0,0,0,0
1653648270165,ECE 277,A00,091093,An; Cheolhong,0,0,0,0
1653648270699,ECE 283,A00,091094,Le; Hanh-Phuc,0,0,0,0
1653648271230,ECE 284,A00,091095,Kang; Mingu,0,0,0,0
1653648271230,ECE 284,B00,091096,Wang; Edward Jay,0,0,0,0
1653648271758,ECE 285,A00,094334,Touri; Behrouz,0,0,0,0
1653648272362,ECE 289,A00,091097,Whelan; David Arthur,0,0,0,0
1653648272905,MATH 200A,A00,087414,Salehi Golsefidy; Alireza,7,0,8,1
1653648273433,MATH 202A,A00,087415,Gill; Philip E.,2,0,8,6
1653648273962,MATH 203A,A00,087416,Oprea; Dragos N.,6,0,8,2
1653648274485,MATH 204A,A00,087417,Kedlaya; Kiran S.,6,0,8,2
1653648275011,MATH 205,A00,087418,Sorensen; Claus M,6,0,8,2
1653648275537,MATH 206A,A00,087419,Izadi; Elham,6,0,8,2
1653648276061,MATH 207A,A00,087420,Mohammadi; Amir,5,0,8,3
1653648276586,MATH 208,A00,087421,Staff,8,0,10,2
1653648277111,MATH 209,A00,087422,Staff,10,0,10,0
1653648277641,MATH 218,A00,087423,Staff,10,0,10,0
1653648278168,MATH 220A,A00,087424,Novak; Jonathan I,6,0,8,2
1653648278692,MATH 231A,A00,087425,Bejenaru; Ioan,3,0,8,5
1653648279214,MATH 240A,A00,087426,Ebenfelt; Peter F,5,0,8,3
1653648279738,MATH 243,A00,087427,Staff,9,0,10,1
1653648280263,MATH 248,A00,087429,Staff,10,0,10,0
1653648280799,MATH 250A,A00,087430,Spolaor; Luca,4,0,8,4
1653648281326,MATH 257A,A00,087431,Spolaor; Luca,7,0,8,1
1653648281857,MATH 258,A00,087432,Staff,9,0,10,1
1653648282380,MATH 264A,A00,087433,Warnke; Lutz Peter,5,0,8,3
1653648282906,MATH 268,A00,087434,Staff,15,0,15,0
1653648283432,MATH 269,A00,087435,Staff,14,0,15,1
1653648283971,MATH 270A,A00,087436,Nie; Jiawang,0,0,8,8
1653648284500,MATH 272A,A00,087437,Tian; Xiaochuan,0,0,8,8
1653648285029,MATH 274,A01,087439,Cheng; Li-Tien,9,0,10,1
1653648285029,MATH 274,A02,087440,Cheng; Li-Tien,10,0,10,0
1653648285554,MATH 278A,A00,087441,Staff,8,0,10,2
1653648286076,MATH 278B,A00,087442,Staff,8,0,10,2
1653648286602,MATH 278C,A00,087443,Staff,8,0,10,2
1653648287128,MATH 280A,A00,087444,Zheng; Tianyi,0,0,8,8
1653648287657,MATH 281A,A00,087445,Bradic; Jelena,0,0,8,9
1653648288179,MATH 282A,A00,087446,Zhang; Danna,0,0,8,8
1653648288703,MATH 283,A00,087447,Tesler; Glenn,0,0,0,16
1653648289232,MATH 286,B00,095535,Kemp; Todd Aahron,5,0,8,3
1653648289755,MATH 287D,B00,095536,Bradic; Jelena,5,0,8,3
1653648290281,MATH 288,A00,087450,Staff,14,0,15,1
1653648290281,MATH 288,B00,087451,Staff,15,0,15,0
1653648290281,MATH 288,C00,087452,Staff,15,0,15,0
1653648290808,MATH 290A,A00,087453,Xu; Zhouli,6,0,8,2
1653648291332,MATH 291A,A00,087454,Xu; Zhouli,7,0,8,1
1653648291856,MATH 292,A00,087455,Staff,10,0,10,0
1653648292381,MATH 295,A00,087456,Staff,50,0,50,0
1653648292906,MATH 297,001,087457,Staff,997,0,999,2
1653648853262,COGS 200,A01,087991,Staff,47,0,50,3
1653648853787,COGS 201,A01,094504,Rangel; Lara M,16,0,25,9
1653648854315,COGS 203,A00,087992,Coulson; Seana M,18,0,20,2
1653648854846,COGS 210A,001,087993,Greene; Deanna Jacquelyn,9998,0,9999,1
1653648854846,COGS 210A,002,087994,Saygin; Ayse P,9999,0,9999,0
1653648854846,COGS 210A,003,087995,Xia; Haijun,9999,0,9999,0
1653648854846,COGS 210A,004,087996,Nitz; Douglas A.,9999,0,9999,0
1653648854846,COGS 210A,005,087997,Hollan; James D.,9999,0,9999,0
1653648854846,COGS 210A,006,087998,Deak; Gedeon O.,9998,0,9999,1
1653648854846,COGS 210A,007,087999,Rossano; Federico,9999,0,9999,0
1653648855370,COGS 211A,A00,088000,Coulson; Seana M,9997,0,9999,2
1653648855893,COGS 229,A00,088002,Staff,22,0,25,3
1653648856416,COGS 260,B00,094231,Staff,17,0,20,3
1653648856416,COGS 260,A00,088004,Nitz; Douglas A.,9998,0,9999,1
1653648856943,CSE 202,A00,090110,Paturi; Ramamohan,0,0,0,0
1653648856943,CSE 202,B00,090111,Paturi; Ramamohan,0,0,0,0
1653648857473,CSE 207B,A00,090112,Heninger; Nadia A,0,0,0,0
1653648857997,CSE 208,A00,094858,Micciancio; Daniele,0,0,0,0
1653648858524,CSE 210,A00,090113,Powell; Thomas Allan,0,0,0,0
1653648859048,CSE 219,A00,090898,Staff,0,0,0,0
1653648859573,CSE 221,A00,090114,Zhou; Yuan-Yuan,0,0,0,0
1653648860187,CSE 229A,A00,090115,Porter; George M,0,0,0,0
1653648860711,CSE 229C,A00,090116,Savage; Stefan,0,0,0,0
1653648861240,CSE 230,A00,090117,Jhala; Ranjit,0,0,0,0
1653648861768,CSE 232,A00,090118,Papakonstantinou; Yannis,0,0,0,0
1653648862293,CSE 239A,A00,090121,Kumar; Arun Kumar,0,0,0,0
1653648862819,CSE 239B,A00,090122,Jhala; Ranjit,0,0,0,0
1653648863343,CSE 240A,A00,090123,Zhao; Jishen,0,0,189,189
1653648863872,CSE 243A,A00,090124,Orailoglu; Alex,0,0,15,15
1653648864404,CSE 249B,A00,090125,Kahng; Andrew Byun,12,0,20,8
1653648864927,CSE 250A,A00,090126,Berg-Kirkpatrick; Taylor D,0,0,0,0
1653648865455,CSE 252A,A00,090127,Ochoa; Benjamin Lawrence,0,0,0,0
1653648865978,CSE 258,A01,090129,McAuley; Julian John,0,0,0,0
1653648866505,CSE 258R,A01,090131,McAuley; Julian John,0,0,0,0
1653648867028,CSE 274,A00,090132,Ramamoorthi; Ravi,0,0,0,0
1653648867552,CSE 276A,A00,090133,Christensen; Henrik I,0,0,0,0
1653648868075,CSE 276C,A00,090134,Christensen; Henrik I,0,0,0,0
1653648868602,CSE 290,A00,090135,Bafna; Vineet,0,0,0,0
1653648868602,CSE 290,B00,090136,Ramamoorthi; Ravi,0,0,0,0
1653648868602,CSE 290,C00,090137,Li; Tzumao,7,0,10,3
1653648868602,CSE 290,D00,090138,Zhou; Yuan-Yuan,9,0,10,1
1653648868602,CSE 290,E00,090139,Christensen; Henrik I,8,0,10,2
1653648868602,CSE 290,F00,094053,Shalev; Aaron D,0,0,0,0
1653648869130,CSE 291,A00,090140,Munyaka; Imani N. S.,0,0,0,0
1653648869130,CSE 291,B00,094880,Yu; Qi,0,0,0,0
1653648869130,CSE 291,C00,090142,Pannuto; Patrick William,0,0,0,0
1653648869130,CSE 291,D00,094881,Zhang; Yiying,0,0,0,0
1653648869130,CSE 291,E00,095118,Su; Hao,0,0,0,0
1653648869667,CSE 293,001,094905,Bafna; Vineet,9999,0,9999,0
1653648869667,CSE 293,002,094906,Bellare; Mihir,9999,0,9999,0
1653648869667,CSE 293,003,094907,Berg-Kirkpatrick; Taylor D,9999,0,9999,0
1653648869667,CSE 293,004,094908,Christensen; Henrik I,9999,0,9999,0
1653648869667,CSE 293,005,094909,Cottrell; Garrison W,9999,0,9999,0
1653648869667,CSE 293,006,094910,Deutsch; Alin Bernard,9999,0,9999,0
1653648869667,CSE 293,007,094911,Esmaeilzadeh; Hadi,9999,0,9999,0
1653648869667,CSE 293,008,094912,Freund; Yoav,9999,0,9999,0
1653648869667,CSE 293,009,094913,Griswold; William G.,9999,0,9999,0
1653648869667,CSE 293,010,094914,Gymrek; Melissa Ann,9999,0,9999,0
1653648869667,CSE 293,011,094915,Heninger; Nadia A,9999,0,9999,0
1653648869667,CSE 293,012,094916,Impagliazzo; Russell,9999,0,9999,0
1653648869667,CSE 293,013,094917,Jhala; Ranjit,9999,0,9999,0
1653648869667,CSE 293,014,094918,Kahng; Andrew Byun,9999,0,9999,0
1653648869667,CSE 293,015,094919,Kane; Daniel Mertz,9999,0,9999,0
1653648869667,CSE 293,016,094920,Kriegman; David J,9999,0,9999,0
1653648869667,CSE 293,017,094921,Kumar; Arun Kumar,9999,0,9999,0
1653648869667,CSE 293,018,094922,Lerner; Sorin,9999,0,9999,0
1653648869667,CSE 293,019,094923,Lovett; Shachar,9999,0,9999,0
1653648869667,CSE 293,020,094924,McAuley; Julian John,9999,0,9999,0
1653648869667,CSE 293,021,094925,Micciancio; Daniele,9999,0,9999,0
1653648869667,CSE 293,022,094926,Orailoglu; Alex,9999,0,9999,0
1653648869667,CSE 293,023,094927,Paturi; Ramamohan,9999,0,9999,0
1653648869667,CSE 293,024,094928,Polikarpova; Nadezhda,9999,0,9999,0
1653648869667,CSE 293,025,094929,Politz; Joseph Gibbs,9999,0,9999,0
1653648869667,CSE 293,026,094930,Porter; George M,9999,0,9999,0
1653648869667,CSE 293,027,094931,Porter; Leonard Emerson,9999,0,9999,0
1653648869667,CSE 293,028,094932,Ramamoorthi; Ravi,9999,0,9999,0
1653648869667,CSE 293,029,094933,Sahoo; Debashis,9999,0,9999,0
1653648869667,CSE 293,030,094934,Saul; Lawrence,9999,0,9999,0
1653648869667,CSE 293,031,094935,Savage; Stefan,9999,0,9999,0
1653648869667,CSE 293,032,094936,Schulze; Jurgen P.,9999,0,9999,0
1653648869667,CSE 293,033,094937,Snoeren; Alex C.,9999,0,9999,0
1653648869667,CSE 293,034,094938,Shang; Jingbo,9999,0,9999,0
1653648869667,CSE 293,035,094939,Stefan; Deian,9999,0,9999,0
1653648869667,CSE 293,036,094940,Su; Hao,9999,0,9999,0
1653648869667,CSE 293,037,094941,Swanson; Steven James,9999,0,9999,0
1653648869667,CSE 293,038,094942,Tullsen; Dean Michael,9999,0,9999,0
1653648869667,CSE 293,039,094943,Voelker; Geoffrey M.,9999,0,9999,0
1653648869667,CSE 293,040,094944,Zhao; Jishen,9999,0,9999,0
1653648869667,CSE 293,041,094945,Zhou; Yuan-Yuan,9999,0,9999,0
1653648869667,CSE 293,042,094946,Gao; Sicun,9998,0,9999,1
1653648869667,CSE 293,043,094947,Weibel; Nadir,9999,0,9999,0
1653648869667,CSE 293,044,094948,Gupta; Rajesh K.,9999,0,9999,0
1653648870189,CSE 294,A00,090143,Porter; George M,9,0,10,1
1653648870718,DSE 200,A00,091799,Staff,50,0,50,0
1653648871249,DSE 203,A00,091800,Gupta; Amarnath,30,0,30,0
1653648871775,DSE 250,A00,091801,Deutsch; Alin Bernard,30,0,30,0
1653648872302,DSE 290,A00,091802,Altintas De Callaf; Ilkay,50,0,50,0
1653648872852,ECE 200,001,091003,Antipa; Nicholas A,9999,0,9999,0
1653648872852,ECE 200,002,091004,Atanasov; Nikolay A.,9999,0,9999,0
1653648872852,ECE 200,003,091005,Bharadia; Dinesh,9999,0,9999,0
1653648872852,ECE 200,004,091006,Cheng; Chung Kuan,9999,0,9999,0
1653648872852,ECE 200,005,091007,Cosman; Pamela C.,9999,0,9999,0
1653648872852,ECE 200,006,091008,Staff,9999,0,9999,0
1653648872852,ECE 200,007,091009,Dayeh; Shadi Ahmad,9999,0,9999,0
1653648872852,ECE 200,008,091010,Fainman; Yeshaiahu,9999,0,9999,0
1653648872852,ECE 200,009,091011,Ford; Joseph Earl,9999,0,9999,0
1653648872852,ECE 200,010,091012,Franceschetti; Massimo,9999,0,9999,0
1653648872852,ECE 200,011,091013,Fullerton; Eric E,9999,0,9999,0
1653648872852,ECE 200,012,091014,Galton; Ian A,9999,0,9999,0
1653648872852,ECE 200,013,091015,Gilja; Vikash,9999,0,9999,0
1653648872852,ECE 200,014,091016,Hall; Drew A.,9999,0,9999,0
1653648872852,ECE 200,015,091017,Hsueh; Tzu-Chien,9999,0,9999,0
1653648872852,ECE 200,016,091018,Javidi; Tara,9999,0,9999,0
1653648872852,ECE 200,017,091019,Kahng; Andrew Byun,9999,0,9999,0
1653648872852,ECE 200,018,091020,Kim; Young-Han,9999,0,9999,0
1653648872852,ECE 200,019,091021,Koushanfar; Farinaz,9999,0,9999,0
1653648872852,ECE 200,020,091022,Kuzum; Duygu,9999,0,9999,0
1653648872852,ECE 200,021,091023,Le; Hanh-Phuc,9999,0,9999,0
1653648872852,ECE 200,022,091024,Lin; Bill,9999,0,9999,0
1653648872852,ECE 200,023,091025,Liu; Zhaowei,9999,0,9999,0
1653648872852,ECE 200,024,091026,Lo; Yu-Hwa,9999,0,9999,0
1653648872852,ECE 200,025,091027,Lomakin; Vitaliy,9999,0,9999,0
1653648872852,ECE 200,026,091028,Mercier; Patrick Philip,9999,0,9999,0
1653648872852,ECE 200,027,091029,Meyer; Florian,9999,0,9999,0
1653648872852,ECE 200,028,091030,Milstein; Laurence B.,9999,0,9999,0
1653648872852,ECE 200,029,091031,Mir Arabbaygi; Siavash,9999,0,9999,0
1653648872852,ECE 200,030,091032,Mookherjea; Shayan,9999,0,9999,0
1653648872852,ECE 200,031,091033,Morris; Karcher William,9999,0,9999,0
1653648872852,ECE 200,032,091034,Ng; Tse Nga,9999,0,9999,0
1653648872852,ECE 200,033,091035,Nguyen; Truong Quang,9999,0,9999,0
1653648872852,ECE 200,034,091036,Nomura; Kenji,9999,0,9999,0
1653648872852,ECE 200,035,091037,Orlitsky; Alon,9999,0,9999,0
1653648872852,ECE 200,036,091038,Pal; Piya,9999,0,9999,0
1653648872852,ECE 200,037,091039,Papen; George C.,9999,0,9999,0
1653648872852,ECE 200,038,091040,Radic; Stojan,9999,0,9999,0
1653648872852,ECE 200,039,091041,Rao; Bhaskar D.,9999,0,9999,0
1653648872852,ECE 200,040,091042,Rao; Ramesh R,9999,0,9999,0
1653648872852,ECE 200,041,091043,Rebeiz; Gabriel,9999,0,9999,0
1653648872852,ECE 200,042,091044,Sanford; John R,9999,0,9999,0
1653648872852,ECE 200,043,091045,Siegel; Paul H.,9999,0,9999,0
1653648872852,ECE 200,044,091046,Sievenpiper; Daniel F.,9999,0,9999,0
1653648872852,ECE 200,045,091047,Sworder; David D.,9999,0,9999,0
1653648872852,ECE 200,046,091048,Taur; Yuan,9999,0,9999,0
1653648872852,ECE 200,047,091049,Touri; Behrouz,9999,0,9999,0
1653648872852,ECE 200,048,091050,Trivedi; Mohan M.,9999,0,9999,0
1653648872852,ECE 200,049,091051,Vardy; Alexander,9999,0,9999,0
1653648872852,ECE 200,050,091052,Vasconcelos; Nuno,9999,0,9999,0
1653648872852,ECE 200,051,091053,Wang; Xiaolong,9999,0,9999,0
1653648872852,ECE 200,052,091054,Xie; Pengtao,9999,0,9999,0
1653648872852,ECE 200,053,091055,Yip; Michael,9999,0,9999,0
1653648872852,ECE 200,054,091056,Zeger; Kenneth A.,9999,0,9999,0
1653648872852,ECE 200,055,091057,Zhang; Xinyu,9999,0,9999,0
1653648872852,ECE 200,056,091058,Turakhia; Yatish Girish,9999,0,9999,0
1653648872852,ECE 200,057,091059,Kang; Mingu,9999,0,9999,0
1653648872852,ECE 200,058,091060,Shi; Yuanyuan,9999,0,9999,0
1653648872852,ECE 200,059,091061,Wang; Edward Jay,9999,0,9999,0
1653648872852,ECE 200,060,091062,Zheng; Yang,9999,0,9999,0
1653648873382,ECE 201,A00,095526,Lo; Yu-Hwa,0,0,0,0
1653648873906,ECE 203,A00,091065,Mercier; Patrick Philip,0,0,0,0
1653648874436,ECE 207A,A00,091605,Liu; Thomas Tao-Ming,0,0,0,0
1653648874960,ECE 212AN,A00,091068,Nomura; Kenji,0,0,0,0
1653648875488,ECE 222A,A00,091069,Rebeiz; Gabriel,0,0,0,0
1653648876011,ECE 225A,A00,091070,Orlitsky; Alon,0,0,0,0
1653648876534,ECE 230A,A00,091071,Nomura; Kenji,0,0,0,0
1653648877062,ECE 236A,A00,091072,Dayeh; Shadi Ahmad,0,0,0,0
1653648877593,ECE 238A,A00,091073,Luo; Jian,0,0,0,0
1653648877593,ECE 238A,B00,091074,Luo; Jian,0,0,0,0
1653648878117,ECE 240A,A00,091075,Radic; Stojan,0,0,0,0
1653648878641,ECE 247A,A00,091592,Shi; Lingyan,0,0,0,0
1653648879168,ECE 250,A00,091076,Touri; Behrouz,0,0,0,0
1653648879691,ECE 251C,A00,091078,Nguyen; Truong Quang,0,0,0,0
1653648880219,ECE 253,A00,091079,Cosman; Pamela C.,0,0,0,0
1653648880746,ECE 255A,A00,091080,Orlitsky; Alon,0,0,0,0
1653648881270,ECE 257A,A00,091081,Zhang; Xinyu,0,0,0,0
1653648881794,ECE 260A,A01,091084,Eldon; John,0,0,0,0
1653648882319,ECE 264C,A00,091085,Galton; Ian A,0,0,0,0
1653648882843,ECE 265C,A00,094889,Presti; Calogero Davide,0,0,0,9
1653648883366,ECE 266,A01,091087,Hall; Drew A.,0,0,0,0
1653648884418,ECE 271A,A00,091090,Vasconcelos; Nuno,0,0,0,0
1653648884941,ECE 272B,A00,091091,Sworder; David D.,0,0,0,0
1653648885480,ECE 275A,A00,091092,Meyer; Florian,0,0,0,0
1653648886004,ECE 277,A00,091093,An; Cheolhong,0,0,0,0
1653648886534,ECE 283,A00,091094,Le; Hanh-Phuc,0,0,0,0
1653648887062,ECE 284,A00,091095,Kang; Mingu,0,0,0,0
1653648887062,ECE 284,B00,091096,Wang; Edward Jay,0,0,0,0
1653648887592,ECE 285,A00,094334,Touri; Behrouz,0,0,0,0
1653648888123,ECE 289,A00,091097,Whelan; David Arthur,0,0,0,0
1653648888648,MATH 200A,A00,087414,Salehi Golsefidy; Alireza,7,0,8,1
1653648889175,MATH 202A,A00,087415,Gill; Philip E.,2,0,8,6
1653648889699,MATH 203A,A00,087416,Oprea; Dragos N.,6,0,8,2
1653648890223,MATH 204A,A00,087417,Kedlaya; Kiran S.,6,0,8,2
1653648890754,MATH 205,A00,087418,Sorensen; Claus M,6,0,8,2
1653648891278,MATH 206A,A00,087419,Izadi; Elham,6,0,8,2
1653648891802,MATH 207A,A00,087420,Mohammadi; Amir,5,0,8,3
1653648892324,MATH 208,A00,087421,Staff,8,0,10,2
1653648892849,MATH 209,A00,087422,Staff,10,0,10,0
1653648893375,MATH 218,A00,087423,Staff,10,0,10,0
1653648893900,MATH 220A,A00,087424,Novak; Jonathan I,6,0,8,2
1653648894428,MATH 231A,A00,087425,Bejenaru; Ioan,3,0,8,5
1653648894956,MATH 240A,A00,087426,Ebenfelt; Peter F,5,0,8,3
1653648895479,MATH 243,A00,087427,Staff,9,0,10,1
1653648896002,MATH 248,A00,087429,Staff,10,0,10,0
1653648896531,MATH 250A,A00,087430,Spolaor; Luca,4,0,8,4
1653648897053,MATH 257A,A00,087431,Spolaor; Luca,7,0,8,1
1653648897578,MATH 258,A00,087432,Staff,9,0,10,1
1653648898108,MATH 264A,A00,087433,Warnke; Lutz Peter,5,0,8,3
1653648898634,MATH 268,A00,087434,Staff,15,0,15,0
1653648899157,MATH 269,A00,087435,Staff,14,0,15,1
1653648899681,MATH 270A,A00,087436,Nie; Jiawang,0,0,8,8
1653648900204,MATH 272A,A00,087437,Tian; Xiaochuan,0,0,8,8
1653648900735,MATH 274,A01,087439,Cheng; Li-Tien,9,0,10,1
1653648900735,MATH 274,A02,087440,Cheng; Li-Tien,10,0,10,0
1653648901259,MATH 278A,A00,087441,Staff,8,0,10,2
1653648901785,MATH 278B,A00,087442,Staff,8,0,10,2
1653648902310,MATH 278C,A00,087443,Staff,8,0,10,2
1653648902833,MATH 280A,A00,087444,Zheng; Tianyi,0,0,8,8
1653648903357,MATH 281A,A00,087445,Bradic; Jelena,0,0,8,9
1653648903891,MATH 282A,A00,087446,Zhang; Danna,0,0,8,8
1653648904414,MATH 283,A00,087447,Tesler; Glenn,0,0,0,16
1653648904938,MATH 286,B00,095535,Kemp; Todd Aahron,5,0,8,3
1653648905464,MATH 287D,B00,095536,Bradic; Jelena,5,0,8,3
1653648905993,MATH 288,A00,087450,Staff,14,0,15,1
1653648905993,MATH 288,B00,087451,Staff,15,0,15,0
1653648905993,MATH 288,C00,087452,Staff,15,0,15,0
1653648906515,MATH 290A,A00,087453,Xu; Zhouli,6,0,8,2
1653648907044,MATH 291A,A00,087454,Xu; Zhouli,7,0,8,1
1653648907567,MATH 292,A00,087455,Staff,10,0,10,0
1653648908093,MATH 295,A00,087456,Staff,50,0,50,0
1653648908616,MATH 297,001,087457,Staff,997,0,999,2
1653649469442,COGS 200,A01,087991,Staff,47,0,50,3
1653649469966,COGS 201,A01,094504,Rangel; Lara M,16,0,25,9
1653649470493,COGS 203,A00,087992,Coulson; Seana M,18,0,20,2
1653649471017,COGS 210A,001,087993,Greene; Deanna Jacquelyn,9998,0,9999,1
1653649471017,COGS 210A,002,087994,Saygin; Ayse P,9999,0,9999,0
1653649471017,COGS 210A,003,087995,Xia; Haijun,9999,0,9999,0
1653649471017,COGS 210A,004,087996,Nitz; Douglas A.,9999,0,9999,0
1653649471017,COGS 210A,005,087997,Hollan; James D.,9999,0,9999,0
1653649471017,COGS 210A,006,087998,Deak; Gedeon O.,9998,0,9999,1
1653649471017,COGS 210A,007,087999,Rossano; Federico,9999,0,9999,0
1653649471540,COGS 211A,A00,088000,Coulson; Seana M,9997,0,9999,2
1653649472078,COGS 229,A00,088002,Staff,22,0,25,3
1653649472605,COGS 260,B00,094231,Staff,17,0,20,3
1653649472605,COGS 260,A00,088004,Nitz; Douglas A.,9998,0,9999,1
1653649473130,CSE 202,A00,090110,Paturi; Ramamohan,0,0,0,0
1653649473130,CSE 202,B00,090111,Paturi; Ramamohan,0,0,0,0
1653649473654,CSE 207B,A00,090112,Heninger; Nadia A,0,0,0,0
1653649474182,CSE 208,A00,094858,Micciancio; Daniele,0,0,0,0
1653649474705,CSE 210,A00,090113,Powell; Thomas Allan,0,0,0,0
1653649475229,CSE 219,A00,090898,Staff,0,0,0,0
1653649475754,CSE 221,A00,090114,Zhou; Yuan-Yuan,0,0,0,0
1653649476276,CSE 229A,A00,090115,Porter; George M,0,0,0,0
1653649476800,CSE 229C,A00,090116,Savage; Stefan,0,0,0,0
1653649477328,CSE 230,A00,090117,Jhala; Ranjit,0,0,0,0
1653649477852,CSE 232,A00,090118,Papakonstantinou; Yannis,0,0,0,0
1653649478375,CSE 239A,A00,090121,Kumar; Arun Kumar,0,0,0,0
1653649478903,CSE 239B,A00,090122,Jhala; Ranjit,0,0,0,0
1653649479428,CSE 240A,A00,090123,Zhao; Jishen,0,0,189,189
1653649479952,CSE 243A,A00,090124,Orailoglu; Alex,0,0,15,15
1653649480475,CSE 249B,A00,090125,Kahng; Andrew Byun,12,0,20,8
1653649481001,CSE 250A,A00,090126,Berg-Kirkpatrick; Taylor D,0,0,0,0
1653649481528,CSE 252A,A00,090127,Ochoa; Benjamin Lawrence,0,0,0,0
1653649482051,CSE 258,A01,090129,McAuley; Julian John,0,0,0,0
1653649482574,CSE 258R,A01,090131,McAuley; Julian John,0,0,0,0
1653649483096,CSE 274,A00,090132,Ramamoorthi; Ravi,0,0,0,0
1653649483619,CSE 276A,A00,090133,Christensen; Henrik I,0,0,0,0
1653649484159,CSE 276C,A00,090134,Christensen; Henrik I,0,0,0,0
1653649484695,CSE 290,A00,090135,Bafna; Vineet,0,0,0,0
1653649484695,CSE 290,B00,090136,Ramamoorthi; Ravi,0,0,0,0
1653649484695,CSE 290,C00,090137,Li; Tzumao,7,0,10,3
1653649484695,CSE 290,D00,090138,Zhou; Yuan-Yuan,9,0,10,1
1653649484695,CSE 290,E00,090139,Christensen; Henrik I,8,0,10,2
1653649484695,CSE 290,F00,094053,Shalev; Aaron D,0,0,0,0
1653649485226,CSE 291,A00,090140,Munyaka; Imani N. S.,0,0,0,0
1653649485226,CSE 291,B00,094880,Yu; Qi,0,0,0,0
1653649485226,CSE 291,C00,090142,Pannuto; Patrick William,0,0,0,0
1653649485226,CSE 291,D00,094881,Zhang; Yiying,0,0,0,0
1653649485226,CSE 291,E00,095118,Su; Hao,0,0,0,0
1653649485759,CSE 293,001,094905,Bafna; Vineet,9999,0,9999,0
1653649485759,CSE 293,002,094906,Bellare; Mihir,9999,0,9999,0
1653649485759,CSE 293,003,094907,Berg-Kirkpatrick; Taylor D,9999,0,9999,0
1653649485759,CSE 293,004,094908,Christensen; Henrik I,9999,0,9999,0
1653649485759,CSE 293,005,094909,Cottrell; Garrison W,9999,0,9999,0
1653649485759,CSE 293,006,094910,Deutsch; Alin Bernard,9999,0,9999,0
1653649485759,CSE 293,007,094911,Esmaeilzadeh; Hadi,9999,0,9999,0
1653649485759,CSE 293,008,094912,Freund; Yoav,9999,0,9999,0
1653649485759,CSE 293,009,094913,Griswold; William G.,9999,0,9999,0
1653649485759,CSE 293,010,094914,Gymrek; Melissa Ann,9999,0,9999,0
1653649485759,CSE 293,011,094915,Heninger; Nadia A,9999,0,9999,0
1653649485759,CSE 293,012,094916,Impagliazzo; Russell,9999,0,9999,0
1653649485759,CSE 293,013,094917,Jhala; Ranjit,9999,0,9999,0
1653649485759,CSE 293,014,094918,Kahng; Andrew Byun,9999,0,9999,0
1653649485759,CSE 293,015,094919,Kane; Daniel Mertz,9999,0,9999,0
1653649485759,CSE 293,016,094920,Kriegman; David J,9999,0,9999,0
1653649485759,CSE 293,017,094921,Kumar; Arun Kumar,9999,0,9999,0
1653649485759,CSE 293,018,094922,Lerner; Sorin,9999,0,9999,0
1653649485759,CSE 293,019,094923,Lovett; Shachar,9999,0,9999,0
1653649485759,CSE 293,020,094924,McAuley; Julian John,9999,0,9999,0
1653649485759,CSE 293,021,094925,Micciancio; Daniele,9999,0,9999,0
1653649485759,CSE 293,022,094926,Orailoglu; Alex,9999,0,9999,0
1653649485759,CSE 293,023,094927,Paturi; Ramamohan,9999,0,9999,0
1653649485759,CSE 293,024,094928,Polikarpova; Nadezhda,9999,0,9999,0
1653649485759,CSE 293,025,094929,Politz; Joseph Gibbs,9999,0,9999,0
1653649485759,CSE 293,026,094930,Porter; George M,9999,0,9999,0
1653649485759,CSE 293,027,094931,Porter; Leonard Emerson,9999,0,9999,0
1653649485759,CSE 293,028,094932,Ramamoorthi; Ravi,9999,0,9999,0
1653649485759,CSE 293,029,094933,Sahoo; Debashis,9999,0,9999,0
1653649485759,CSE 293,030,094934,Saul; Lawrence,9999,0,9999,0
1653649485759,CSE 293,031,094935,Savage; Stefan,9999,0,9999,0
1653649485759,CSE 293,032,094936,Schulze; Jurgen P.,9999,0,9999,0
1653649485759,CSE 293,033,094937,Snoeren; Alex C.,9999,0,9999,0
1653649485759,CSE 293,034,094938,Shang; Jingbo,9999,0,9999,0
1653649485759,CSE 293,035,094939,Stefan; Deian,9999,0,9999,0
1653649485759,CSE 293,036,094940,Su; Hao,9999,0,9999,0
1653649485759,CSE 293,037,094941,Swanson; Steven James,9999,0,9999,0
1653649485759,CSE 293,038,094942,Tullsen; Dean Michael,9999,0,9999,0
1653649485759,CSE 293,039,094943,Voelker; Geoffrey M.,9999,0,9999,0
1653649485759,CSE 293,040,094944,Zhao; Jishen,9999,0,9999,0
1653649485759,CSE 293,041,094945,Zhou; Yuan-Yuan,9999,0,9999,0
1653649485759,CSE 293,042,094946,Gao; Sicun,9998,0,9999,1
1653649485759,CSE 293,043,094947,Weibel; Nadir,9999,0,9999,0
1653649485759,CSE 293,044,094948,Gupta; Rajesh K.,9999,0,9999,0
1653649486282,CSE 294,A00,090143,Porter; George M,9,0,10,1
1653649486806,DSE 200,A00,091799,Staff,50,0,50,0
1653649487328,DSE 203,A00,091800,Gupta; Amarnath,30,0,30,0
1653649487850,DSE 250,A00,091801,Deutsch; Alin Bernard,30,0,30,0
1653649488373,DSE 290,A00,091802,Altintas De Callaf; Ilkay,50,0,50,0
1653649488939,ECE 200,001,091003,Antipa; Nicholas A,9999,0,9999,0
1653649488939,ECE 200,002,091004,Atanasov; Nikolay A.,9999,0,9999,0
1653649488939,ECE 200,003,091005,Bharadia; Dinesh,9999,0,9999,0
1653649488939,ECE 200,004,091006,Cheng; Chung Kuan,9999,0,9999,0
1653649488939,ECE 200,005,091007,Cosman; Pamela C.,9999,0,9999,0
1653649488939,ECE 200,006,091008,Staff,9999,0,9999,0
1653649488939,ECE 200,007,091009,Dayeh; Shadi Ahmad,9999,0,9999,0
1653649488939,ECE 200,008,091010,Fainman; Yeshaiahu,9999,0,9999,0
1653649488939,ECE 200,009,091011,Ford; Joseph Earl,9999,0,9999,0
1653649488939,ECE 200,010,091012,Franceschetti; Massimo,9999,0,9999,0
1653649488939,ECE 200,011,091013,Fullerton; Eric E,9999,0,9999,0
1653649488939,ECE 200,012,091014,Galton; Ian A,9999,0,9999,0
1653649488939,ECE 200,013,091015,Gilja; Vikash,9999,0,9999,0
1653649488939,ECE 200,014,091016,Hall; Drew A.,9999,0,9999,0
1653649488939,ECE 200,015,091017,Hsueh; Tzu-Chien,9999,0,9999,0
1653649488939,ECE 200,016,091018,Javidi; Tara,9999,0,9999,0
1653649488939,ECE 200,017,091019,Kahng; Andrew Byun,9999,0,9999,0
1653649488939,ECE 200,018,091020,Kim; Young-Han,9999,0,9999,0
1653649488939,ECE 200,019,091021,Koushanfar; Farinaz,9999,0,9999,0
1653649488939,ECE 200,020,091022,Kuzum; Duygu,9999,0,9999,0
1653649488939,ECE 200,021,091023,Le; Hanh-Phuc,9999,0,9999,0
1653649488939,ECE 200,022,091024,Lin; Bill,9999,0,9999,0
1653649488939,ECE 200,023,091025,Liu; Zhaowei,9999,0,9999,0
1653649488939,ECE 200,024,091026,Lo; Yu-Hwa,9999,0,9999,0
1653649488939,ECE 200,025,091027,Lomakin; Vitaliy,9999,0,9999,0
1653649488939,ECE 200,026,091028,Mercier; Patrick Philip,9999,0,9999,0
1653649488939,ECE 200,027,091029,Meyer; Florian,9999,0,9999,0
1653649488939,ECE 200,028,091030,Milstein; Laurence B.,9999,0,9999,0
1653649488939,ECE 200,029,091031,Mir Arabbaygi; Siavash,9999,0,9999,0
1653649488939,ECE 200,030,091032,Mookherjea; Shayan,9999,0,9999,0
1653649488939,ECE 200,031,091033,Morris; Karcher William,9999,0,9999,0
1653649488939,ECE 200,032,091034,Ng; Tse Nga,9999,0,9999,0
1653649488939,ECE 200,033,091035,Nguyen; Truong Quang,9999,0,9999,0
1653649488939,ECE 200,034,091036,Nomura; Kenji,9999,0,9999,0
1653649488939,ECE 200,035,091037,Orlitsky; Alon,9999,0,9999,0
1653649488939,ECE 200,036,091038,Pal; Piya,9999,0,9999,0
1653649488939,ECE 200,037,091039,Papen; George C.,9999,0,9999,0
1653649488939,ECE 200,038,091040,Radic; Stojan,9999,0,9999,0
1653649488939,ECE 200,039,091041,Rao; Bhaskar D.,9999,0,9999,0
1653649488939,ECE 200,040,091042,Rao; Ramesh R,9999,0,9999,0
1653649488939,ECE 200,041,091043,Rebeiz; Gabriel,9999,0,9999,0
1653649488939,ECE 200,042,091044,Sanford; John R,9999,0,9999,0
1653649488939,ECE 200,043,091045,Siegel; Paul H.,9999,0,9999,0
1653649488939,ECE 200,044,091046,Sievenpiper; Daniel F.,9999,0,9999,0
1653649488939,ECE 200,045,091047,Sworder; David D.,9999,0,9999,0
1653649488939,ECE 200,046,091048,Taur; Yuan,9999,0,9999,0
1653649488939,ECE 200,047,091049,Touri; Behrouz,9999,0,9999,0
1653649488939,ECE 200,048,091050,Trivedi; Mohan M.,9999,0,9999,0
1653649488939,ECE 200,049,091051,Vardy; Alexander,9999,0,9999,0
1653649488939,ECE 200,050,091052,Vasconcelos; Nuno,9999,0,9999,0
1653649488939,ECE 200,051,091053,Wang; Xiaolong,9999,0,9999,0
1653649488939,ECE 200,052,091054,Xie; Pengtao,9999,0,9999,0
1653649488939,ECE 200,053,091055,Yip; Michael,9999,0,9999,0
1653649488939,ECE 200,054,091056,Zeger; Kenneth A.,9999,0,9999,0
1653649488939,ECE 200,055,091057,Zhang; Xinyu,9999,0,9999,0
1653649488939,ECE 200,056,091058,Turakhia; Yatish Girish,9999,0,9999,0
1653649488939,ECE 200,057,091059,Kang; Mingu,9999,0,9999,0
1653649488939,ECE 200,058,091060,Shi; Yuanyuan,9999,0,9999,0
1653649488939,ECE 200,059,091061,Wang; Edward Jay,9999,0,9999,0
1653649488939,ECE 200,060,091062,Zheng; Yang,9999,0,9999,0
1653649489467,ECE 201,A00,095526,Lo; Yu-Hwa,0,0,0,0
1653649489992,ECE 203,A00,091065,Mercier; Patrick Philip,0,0,0,0
1653649490517,ECE 207A,A00,091605,Liu; Thomas Tao-Ming,0,0,0,0
1653649491045,ECE 212AN,A00,091068,Nomura; Kenji,0,0,0,0
1653649491571,ECE 222A,A00,091069,Rebeiz; Gabriel,0,0,0,0
1653649492094,ECE 225A,A00,091070,Orlitsky; Alon,0,0,0,0
1653649492619,ECE 230A,A00,091071,Nomura; Kenji,0,0,0,0
1653649493144,ECE 236A,A00,091072,Dayeh; Shadi Ahmad,0,0,0,0
1653649493667,ECE 238A,A00,091073,Luo; Jian,0,0,0,0
1653649493667,ECE 238A,B00,091074,Luo; Jian,0,0,0,0
1653649494201,ECE 240A,A00,091075,Radic; Stojan,0,0,0,0
1653649494733,ECE 247A,A00,091592,Shi; Lingyan,0,0,0,0
1653649495259,ECE 250,A00,091076,Touri; Behrouz,0,0,0,0
1653649495785,ECE 251C,A00,091078,Nguyen; Truong Quang,0,0,0,0
1653649496310,ECE 253,A00,091079,Cosman; Pamela C.,0,0,0,0
1653649496833,ECE 255A,A00,091080,Orlitsky; Alon,0,0,0,0
1653649497355,ECE 257A,A00,091081,Zhang; Xinyu,0,0,0,0
1653649497878,ECE 260A,A01,091084,Eldon; John,0,0,0,0
1653649498407,ECE 264C,A00,091085,Galton; Ian A,0,0,0,0
1653649498935,ECE 265C,A00,094889,Presti; Calogero Davide,0,0,0,9
1653649499463,ECE 266,A01,091087,Hall; Drew A.,0,0,0,0
1653649500510,ECE 271A,A00,091090,Vasconcelos; Nuno,0,0,0,0
1653649501032,ECE 272B,A00,091091,Sworder; David D.,0,0,0,0
1653649501638,ECE 275A,A00,091092,Meyer; Florian,0,0,0,0
1653649502165,ECE 277,A00,091093,An; Cheolhong,0,0,0,0
1653649502691,ECE 283,A00,091094,Le; Hanh-Phuc,0,0,0,0
1653649503221,ECE 284,A00,091095,Kang; Mingu,0,0,0,0
1653649503221,ECE 284,B00,091096,Wang; Edward Jay,0,0,0,0
1653649503750,ECE 285,A00,094334,Touri; Behrouz,0,0,0,0
1653649504280,ECE 289,A00,091097,Whelan; David Arthur,0,0,0,0
1653649504804,MATH 200A,A00,087414,Salehi Golsefidy; Alireza,7,0,8,1
1653649505336,MATH 202A,A00,087415,Gill; Philip E.,2,0,8,6
1653649505871,MATH 203A,A00,087416,Oprea; Dragos N.,6,0,8,2
1653649506397,MATH 204A,A00,087417,Kedlaya; Kiran S.,6,0,8,2
1653649506923,MATH 205,A00,087418,Sorensen; Claus M,6,0,8,2
1653649507447,MATH 206A,A00,087419,Izadi; Elham,6,0,8,2
1653649507980,MATH 207A,A00,087420,Mohammadi; Amir,5,0,8,3
1653649508501,MATH 208,A00,087421,Staff,8,0,10,2
1653649509029,MATH 209,A00,087422,Staff,10,0,10,0
1653649509551,MATH 218,A00,087423,Staff,10,0,10,0
1653649510074,MATH 220A,A00,087424,Novak; Jonathan I,6,0,8,2
1653649510597,MATH 231A,A00,087425,Bejenaru; Ioan,3,0,8,5
1653649511126,MATH 240A,A00,087426,Ebenfelt; Peter F,5,0,8,3
1653649511653,MATH 243,A00,087427,Staff,9,0,10,1
1653649512175,MATH 248,A00,087429,Staff,10,0,10,0
1653649512700,MATH 250A,A00,087430,Spolaor; Luca,4,0,8,4
1653649513228,MATH 257A,A00,087431,Spolaor; Luca,7,0,8,1
1653649513750,MATH 258,A00,087432,Staff,9,0,10,1
1653649514276,MATH 264A,A00,087433,Warnke; Lutz Peter,5,0,8,3
1653649514802,MATH 268,A00,087434,Staff,15,0,15,0
1653649515326,MATH 269,A00,087435,Staff,14,0,15,1
1653649516453,MATH 272A,A00,087437,Tian; Xiaochuan,0,0,8,8
1653649517003,MATH 274,A01,087439,Cheng; Li-Tien,9,0,10,1
1653649517003,MATH 274,A02,087440,Cheng; Li-Tien,10,0,10,0
1653649517528,MATH 278A,A00,087441,Staff,8,0,10,2
1653649518051,MATH 278B,A00,087442,Staff,8,0,10,2
1653649518573,MATH 278C,A00,087443,Staff,8,0,10,2
1653649519103,MATH 280A,A00,087444,Zheng; Tianyi,0,0,8,8
1653649519627,MATH 281A,A00,087445,Bradic; Jelena,0,0,8,9
1653649520150,MATH 282A,A00,087446,Zhang; Danna,0,0,8,8
1653649520679,MATH 283,A00,087447,Tesler; Glenn,0,0,0,16
1653649521209,MATH 286,B00,095535,Kemp; Todd Aahron,5,0,8,3
1653649521732,MATH 287D,B00,095536,Bradic; Jelena,5,0,8,3
1653649522255,MATH 288,A00,087450,Staff,14,0,15,1
1653649522255,MATH 288,B00,087451,Staff,15,0,15,0
1653649522255,MATH 288,C00,087452,Staff,15,0,15,0
1653649522779,MATH 290A,A00,087453,Xu; Zhouli,6,0,8,2
1653649523309,MATH 291A,A00,087454,Xu; Zhouli,7,0,8,1
1653649523841,MATH 292,A00,087455,Staff,10,0,10,0
1653649524365,MATH 295,A00,087456,Staff,50,0,50,0
1653649524892,MATH 297,001,087457,Staff,997,0,999,2
1653650218933,COGS 200,A01,087991,Staff,47,0,50,3
1653650219458,COGS 201,A01,094504,Rangel; Lara M,16,0,25,9
1653650219987,COGS 203,A00,087992,Coulson; Seana M,18,0,20,2
1653650220524,COGS 210A,001,087993,Greene; Deanna Jacquelyn,9998,0,9999,1
1653650220524,COGS 210A,002,087994,Saygin; Ayse P,9999,0,9999,0
1653650220524,COGS 210A,003,087995,Xia; Haijun,9999,0,9999,0
1653650220524,COGS 210A,004,087996,Nitz; Douglas A.,9999,0,9999,0
1653650220524,COGS 210A,005,087997,Hollan; James D.,9999,0,9999,0
1653650220524,COGS 210A,006,087998,Deak; Gedeon O.,9998,0,9999,1
1653650220524,COGS 210A,007,087999,Rossano; Federico,9999,0,9999,0
1653650221048,COGS 211A,A00,088000,Coulson; Seana M,9997,0,9999,2
1653650221575,COGS 229,A00,088002,Staff,22,0,25,3
1653650222100,COGS 260,B00,094231,Staff,17,0,20,3
1653650222100,COGS 260,A00,088004,Nitz; Douglas A.,9998,0,9999,1
1653650222635,CSE 202,A00,090110,Paturi; Ramamohan,0,0,0,0
1653650222635,CSE 202,B00,090111,Paturi; Ramamohan,0,0,0,0
1653650223158,CSE 207B,A00,090112,Heninger; Nadia A,0,0,0,0
1653650223683,CSE 208,A00,094858,Micciancio; Daniele,0,0,0,0
1653650224207,CSE 210,A00,090113,Powell; Thomas Allan,0,0,0,0
1653650224733,CSE 219,A00,090898,Staff,0,0,0,0
1653650225258,CSE 221,A00,090114,Zhou; Yuan-Yuan,0,0,0,0
1653650225788,CSE 229A,A00,090115,Porter; George M,0,0,0,0
1653650226312,CSE 229C,A00,090116,Savage; Stefan,0,0,0,0
1653650226843,CSE 230,A00,090117,Jhala; Ranjit,0,0,0,0
1653650227372,CSE 232,A00,090118,Papakonstantinou; Yannis,0,0,0,0
1653650227897,CSE 239A,A00,090121,Kumar; Arun Kumar,0,0,0,0
1653650228421,CSE 239B,A00,090122,Jhala; Ranjit,0,0,0,0
1653650228946,CSE 240A,A00,090123,Zhao; Jishen,0,0,189,189
1653650229469,CSE 243A,A00,090124,Orailoglu; Alex,0,0,15,15
1653650229997,CSE 249B,A00,090125,Kahng; Andrew Byun,12,0,20,8
1653650230522,CSE 250A,A00,090126,Berg-Kirkpatrick; Taylor D,0,0,0,0
1653650231053,CSE 252A,A00,090127,Ochoa; Benjamin Lawrence,0,0,0,0
1653650231584,CSE 258,A01,090129,McAuley; Julian John,0,0,0,0
1653650232108,CSE 258R,A01,090131,McAuley; Julian John,0,0,0,0
1653650232632,CSE 274,A00,090132,Ramamoorthi; Ravi,0,0,0,0
1653650233161,CSE 276A,A00,090133,Christensen; Henrik I,0,0,0,0
1653650233684,CSE 276C,A00,090134,Christensen; Henrik I,0,0,0,0
1653650234212,CSE 290,A00,090135,Bafna; Vineet,0,0,0,0
1653650234212,CSE 290,B00,090136,Ramamoorthi; Ravi,0,0,0,0
1653650234212,CSE 290,C00,090137,Li; Tzumao,7,0,10,3
1653650234212,CSE 290,D00,090138,Zhou; Yuan-Yuan,9,0,10,1
1653650234212,CSE 290,E00,090139,Christensen; Henrik I,8,0,10,2
1653650234212,CSE 290,F00,094053,Shalev; Aaron D,0,0,0,0
1653650234740,CSE 291,A00,090140,Munyaka; Imani N. S.,0,0,0,0
1653650234740,CSE 291,B00,094880,Yu; Qi,0,0,0,0
1653650234740,CSE 291,C00,090142,Pannuto; Patrick William,0,0,0,0
1653650234740,CSE 291,D00,094881,Zhang; Yiying,0,0,0,0
1653650234740,CSE 291,E00,095118,Su; Hao,0,0,0,0
1653650235279,CSE 293,001,094905,Bafna; Vineet,9999,0,9999,0
1653650235279,CSE 293,002,094906,Bellare; Mihir,9999,0,9999,0
1653650235279,CSE 293,003,094907,Berg-Kirkpatrick; Taylor D,9999,0,9999,0
1653650235279,CSE 293,004,094908,Christensen; Henrik I,9999,0,9999,0
1653650235279,CSE 293,005,094909,Cottrell; Garrison W,9999,0,9999,0
1653650235279,CSE 293,006,094910,Deutsch; Alin Bernard,9999,0,9999,0
1653650235279,CSE 293,007,094911,Esmaeilzadeh; Hadi,9999,0,9999,0
1653650235279,CSE 293,008,094912,Freund; Yoav,9999,0,9999,0
1653650235279,CSE 293,009,094913,Griswold; William G.,9999,0,9999,0
1653650235279,CSE 293,010,094914,Gymrek; Melissa Ann,9999,0,9999,0
1653650235279,CSE 293,011,094915,Heninger; Nadia A,9999,0,9999,0
1653650235279,CSE 293,012,094916,Impagliazzo; Russell,9999,0,9999,0
1653650235279,CSE 293,013,094917,Jhala; Ranjit,9999,0,9999,0
1653650235279,CSE 293,014,094918,Kahng; Andrew Byun,9999,0,9999,0
1653650235279,CSE 293,015,094919,Kane; Daniel Mertz,9999,0,9999,0
1653650235279,CSE 293,016,094920,Kriegman; David J,9999,0,9999,0
1653650235279,CSE 293,017,094921,Kumar; Arun Kumar,9999,0,9999,0
1653650235279,CSE 293,018,094922,Lerner; Sorin,9999,0,9999,0
1653650235279,CSE 293,019,094923,Lovett; Shachar,9999,0,9999,0
1653650235279,CSE 293,020,094924,McAuley; Julian John,9999,0,9999,0
1653650235279,CSE 293,021,094925,Micciancio; Daniele,9999,0,9999,0
1653650235279,CSE 293,022,094926,Orailoglu; Alex,9999,0,9999,0
1653650235279,CSE 293,023,094927,Paturi; Ramamohan,9999,0,9999,0
1653650235279,CSE 293,024,094928,Polikarpova; Nadezhda,9999,0,9999,0
1653650235279,CSE 293,025,094929,Politz; Joseph Gibbs,9999,0,9999,0
1653650235279,CSE 293,026,094930,Porter; George M,9999,0,9999,0
1653650235279,CSE 293,027,094931,Porter; Leonard Emerson,9999,0,9999,0
1653650235279,CSE 293,028,094932,Ramamoorthi; Ravi,9999,0,9999,0
1653650235279,CSE 293,029,094933,Sahoo; Debashis,9999,0,9999,0
1653650235279,CSE 293,030,094934,Saul; Lawrence,9999,0,9999,0
1653650235279,CSE 293,031,094935,Savage; Stefan,9999,0,9999,0
1653650235279,CSE 293,032,094936,Schulze; Jurgen P.,9999,0,9999,0
1653650235279,CSE 293,033,094937,Snoeren; Alex C.,9999,0,9999,0
1653650235279,CSE 293,034,094938,Shang; Jingbo,9999,0,9999,0
1653650235279,CSE 293,035,094939,Stefan; Deian,9999,0,9999,0
1653650235279,CSE 293,036,094940,Su; Hao,9999,0,9999,0
1653650235279,CSE 293,037,094941,Swanson; Steven James,9999,0,9999,0
1653650235279,CSE 293,038,094942,Tullsen; Dean Michael,9999,0,9999,0
1653650235279,CSE 293,039,094943,Voelker; Geoffrey M.,9999,0,9999,0
1653650235279,CSE 293,040,094944,Zhao; Jishen,9999,0,9999,0
1653650235279,CSE 293,041,094945,Zhou; Yuan-Yuan,9999,0,9999,0
1653650235279,CSE 293,042,094946,Gao; Sicun,9998,0,9999,1
1653650235279,CSE 293,043,094947,Weibel; Nadir,9999,0,9999,0
1653650235279,CSE 293,044,094948,Gupta; Rajesh K.,9999,0,9999,0
1653650235805,CSE 294,A00,090143,Porter; George M,9,0,10,1
1653650236329,DSE 200,A00,091799,Staff,50,0,50,0
1653650236853,DSE 203,A00,091800,Gupta; Amarnath,30,0,30,0
1653650237377,DSE 250,A00,091801,Deutsch; Alin Bernard,30,0,30,0
1653650237976,DSE 290,A00,091802,Altintas De Callaf; Ilkay,50,0,50,0
1653650238549,ECE 200,001,091003,Antipa; Nicholas A,9999,0,9999,0
1653650238549,ECE 200,002,091004,Atanasov; Nikolay A.,9999,0,9999,0
1653650238549,ECE 200,003,091005,Bharadia; Dinesh,9999,0,9999,0
1653650238549,ECE 200,004,091006,Cheng; Chung Kuan,9999,0,9999,0
1653650238549,ECE 200,005,091007,Cosman; Pamela C.,9999,0,9999,0
1653650238549,ECE 200,006,091008,Staff,9999,0,9999,0
1653650238549,ECE 200,007,091009,Dayeh; Shadi Ahmad,9999,0,9999,0
1653650238549,ECE 200,008,091010,Fainman; Yeshaiahu,9999,0,9999,0
1653650238549,ECE 200,009,091011,Ford; Joseph Earl,9999,0,9999,0
1653650238549,ECE 200,010,091012,Franceschetti; Massimo,9999,0,9999,0
1653650238549,ECE 200,011,091013,Fullerton; Eric E,9999,0,9999,0
1653650238549,ECE 200,012,091014,Galton; Ian A,9999,0,9999,0
1653650238549,ECE 200,013,091015,Gilja; Vikash,9999,0,9999,0
1653650238549,ECE 200,014,091016,Hall; Drew A.,9999,0,9999,0
1653650238549,ECE 200,015,091017,Hsueh; Tzu-Chien,9999,0,9999,0
1653650238549,ECE 200,016,091018,Javidi; Tara,9999,0,9999,0
1653650238549,ECE 200,017,091019,Kahng; Andrew Byun,9999,0,9999,0
1653650238549,ECE 200,018,091020,Kim; Young-Han,9999,0,9999,0
1653650238549,ECE 200,019,091021,Koushanfar; Farinaz,9999,0,9999,0
1653650238549,ECE 200,020,091022,Kuzum; Duygu,9999,0,9999,0
1653650238549,ECE 200,021,091023,Le; Hanh-Phuc,9999,0,9999,0
1653650238549,ECE 200,022,091024,Lin; Bill,9999,0,9999,0
1653650238549,ECE 200,023,091025,Liu; Zhaowei,9999,0,9999,0
1653650238549,ECE 200,024,091026,Lo; Yu-Hwa,9999,0,9999,0
1653650238549,ECE 200,025,091027,Lomakin; Vitaliy,9999,0,9999,0
1653650238549,ECE 200,026,091028,Mercier; Patrick Philip,9999,0,9999,0
1653650238549,ECE 200,027,091029,Meyer; Florian,9999,0,9999,0
1653650238549,ECE 200,028,091030,Milstein; Laurence B.,9999,0,9999,0
1653650238549,ECE 200,029,091031,Mir Arabbaygi; Siavash,9999,0,9999,0
1653650238549,ECE 200,030,091032,Mookherjea; Shayan,9999,0,9999,0
1653650238549,ECE 200,031,091033,Morris; Karcher William,9999,0,9999,0
1653650238549,ECE 200,032,091034,Ng; Tse Nga,9999,0,9999,0
1653650238549,ECE 200,033,091035,Nguyen; Truong Quang,9999,0,9999,0
1653650238549,ECE 200,034,091036,Nomura; Kenji,9999,0,9999,0
1653650238549,ECE 200,035,091037,Orlitsky; Alon,9999,0,9999,0
1653650238549,ECE 200,036,091038,Pal; Piya,9999,0,9999,0
1653650238549,ECE 200,037,091039,Papen; George C.,9999,0,9999,0
1653650238549,ECE 200,038,091040,Radic; Stojan,9999,0,9999,0
1653650238549,ECE 200,039,091041,Rao; Bhaskar D.,9999,0,9999,0
1653650238549,ECE 200,040,091042,Rao; Ramesh R,9999,0,9999,0
1653650238549,ECE 200,041,091043,Rebeiz; Gabriel,9999,0,9999,0
1653650238549,ECE 200,042,091044,Sanford; John R,9999,0,9999,0
1653650238549,ECE 200,043,091045,Siegel; Paul H.,9999,0,9999,0
1653650238549,ECE 200,044,091046,Sievenpiper; Daniel F.,9999,0,9999,0
1653650238549,ECE 200,045,091047,Sworder; David D.,9999,0,9999,0
1653650238549,ECE 200,046,091048,Taur; Yuan,9999,0,9999,0
1653650238549,ECE 200,047,091049,Touri; Behrouz,9999,0,9999,0
1653650238549,ECE 200,048,091050,Trivedi; Mohan M.,9999,0,9999,0
1653650238549,ECE 200,049,091051,Vardy; Alexander,9999,0,9999,0
1653650238549,ECE 200,050,091052,Vasconcelos; Nuno,9999,0,9999,0
1653650238549,ECE 200,051,091053,Wang; Xiaolong,9999,0,9999,0
1653650238549,ECE 200,052,091054,Xie; Pengtao,9999,0,9999,0
1653650238549,ECE 200,053,091055,Yip; Michael,9999,0,9999,0
1653650238549,ECE 200,054,091056,Zeger; Kenneth A.,9999,0,9999,0
1653650238549,ECE 200,055,091057,Zhang; Xinyu,9999,0,9999,0
1653650238549,ECE 200,056,091058,Turakhia; Yatish Girish,9999,0,9999,0
1653650238549,ECE 200,057,091059,Kang; Mingu,9999,0,9999,0
1653650238549,ECE 200,058,091060,Shi; Yuanyuan,9999,0,9999,0
1653650238549,ECE 200,059,091061,Wang; Edward Jay,9999,0,9999,0
1653650238549,ECE 200,060,091062,Zheng; Yang,9999,0,9999,0
1653650239073,ECE 201,A00,095526,Lo; Yu-Hwa,0,0,0,0
1653650239602,ECE 203,A00,091065,Mercier; Patrick Philip,0,0,0,0
1653650240127,ECE 207A,A00,091605,Liu; Thomas Tao-Ming,0,0,0,0
1653650240656,ECE 212AN,A00,091068,Nomura; Kenji,0,0,0,0
1653650241182,ECE 222A,A00,091069,Rebeiz; Gabriel,0,0,0,0
1653650241710,ECE 225A,A00,091070,Orlitsky; Alon,0,0,0,0
1653650242239,ECE 230A,A00,091071,Nomura; Kenji,0,0,0,0
1653650242767,ECE 236A,A00,091072,Dayeh; Shadi Ahmad,0,0,0,0
1653650243293,ECE 238A,A00,091073,Luo; Jian,0,0,0,0
1653650243293,ECE 238A,B00,091074,Luo; Jian,0,0,0,0
1653650243830,ECE 240A,A00,091075,Radic; Stojan,0,0,0,0
